"county","collection_dt","ALL PCR tests performed","Running total of all PCR tests","All PCR positive tests","Running total of all PCR tests","7 day percent positive","14 day percent positive"
"Georgia","2020-02-01","0","0","0","0",".","."
"Georgia","2020-02-02","0","0","0","0",".","."
"Georgia","2020-02-03","2","2","1","1",".","."
"Georgia","2020-02-04","2","4","0","1",".","."
"Georgia","2020-02-05","1","5","0","1",".","."
"Georgia","2020-02-06","1","6","0","1",".","."
"Georgia","2020-02-07","1","7","0","1","7.1","."
"Georgia","2020-02-08","0","7","0","1","7.1","."
"Georgia","2020-02-09","0","7","0","1","7.1","."
"Georgia","2020-02-10","2","9","0","1","0","."
"Georgia","2020-02-11","0","9","0","1","0","."
"Georgia","2020-02-12","0","9","0","1","0","."
"Georgia","2020-02-13","1","10","0","1","0","."
"Georgia","2020-02-14","1","11","0","1","0","3.6"
"Georgia","2020-02-15","1","12","0","1","0","3.6"
"Georgia","2020-02-16","0","12","0","1","0","3.6"
"Georgia","2020-02-17","0","12","0","1","0","0"
"Georgia","2020-02-18","1","13","1","2","14.3","7.1"
"Georgia","2020-02-19","1","14","0","2","14.3","7.1"
"Georgia","2020-02-20","1","15","0","2","14.3","7.1"
"Georgia","2020-02-21","0","15","0","2","14.3","7.1"
"Georgia","2020-02-22","0","15","0","2","14.3","7.1"
"Georgia","2020-02-23","0","15","0","2","14.3","7.1"
"Georgia","2020-02-24","0","15","0","2","14.3","7.1"
"Georgia","2020-02-25","2","17","0","2","0","7.1"
"Georgia","2020-02-26","0","17","0","2","0","7.1"
"Georgia","2020-02-27","3","20","1","3","4.8","9.5"
"Georgia","2020-02-28","0","20","0","3","4.8","9.5"
"Georgia","2020-02-29","1","21","0","3","4.8","9.5"
"Georgia","2020-03-01","1","22","0","3","4.8","9.5"
"Georgia","2020-03-02","4","26","2","5","11.9","13.1"
"Georgia","2020-03-03","6","32","2","7","16.7","8.3"
"Georgia","2020-03-04","16","48","2","9","18.5","9.2"
"Georgia","2020-03-05","26","74","4","13","15.9","10.3"
"Georgia","2020-03-06","52","126","4","17","17","10.9"
"Georgia","2020-03-07","28","154","5","22","19.5","12.2"
"Georgia","2020-03-08","54","208","11","33","22.4","13.6"
"Georgia","2020-03-09","187","395","9","42","16","13.9"
"Georgia","2020-03-10","265","660","19","61","12.3","14.5"
"Georgia","2020-03-11","389","1049","49","110","12.3","15.4"
"Georgia","2020-03-12","674","1723","72","182","11.6","13.7"
"Georgia","2020-03-13","776","2499","149","331","13.2","15.1"
"Georgia","2020-03-14","376","2875","83","414","13.8","16.7"
"Georgia","2020-03-15","545","3420","118","532","14","18.2"
"Georgia","2020-03-16","1654","5074","220","752","15.2","15.6"
"Georgia","2020-03-17","2098","7172","287","1039","16.2","14.2"
"Georgia","2020-03-18","1920","9092","283","1322","16.5","14.4"
"Georgia","2020-03-19","2120","11212","308","1630","17","14.3"
"Georgia","2020-03-20","2387","13599","389","2019","16.6","14.9"
"Georgia","2020-03-21","895","14494","187","2206","16.4","15.1"
"Georgia","2020-03-22","915","15409","218","2424","16.8","15.4"
"Georgia","2020-03-23","3014","18423","615","3039","17.8","16.5"
"Georgia","2020-03-24","3344","21767","649","3688","18.6","17.4"
"Georgia","2020-03-25","3335","25102","645","4333","19.2","17.9"
"Georgia","2020-03-26","3145","28247","609","4942","19.9","18.5"
"Georgia","2020-03-27","3031","31278","646","5588","20.6","18.6"
"Georgia","2020-03-28","1134","32412","340","5928","21.9","19.2"
"Georgia","2020-03-29","954","33366","308","6236","23.2","20"
"Georgia","2020-03-30","3407","36773","752","6988","23.4","20.6"
"Georgia","2020-03-31","2855","39628","615","7603","23.7","21.1"
"Georgia","2020-04-01","3340","42968","677","8280","23.8","21.5"
"Georgia","2020-04-02","3284","46252","554","8834","23.5","21.7"
"Georgia","2020-04-03","3458","49710","640","9474","23.1","21.9"
"Georgia","2020-04-04","1650","51360","297","9771","21.4","21.7"
"Georgia","2020-04-05","860","52220","173","9944","19.6","21.4"
"Georgia","2020-04-06","4066","56286","733","10677","19","21.2"
"Georgia","2020-04-07","4698","60984","664","11341","18","20.8"
"Georgia","2020-04-08","4865","65849","687","12028","17.1","20.5"
"Georgia","2020-04-09","4590","70439","774","12802","17.1","20.3"
"Georgia","2020-04-10","5204","75643","900","13702","16.9","20"
"Georgia","2020-04-11","2467","78110","341","14043","16.3","18.9"
"Georgia","2020-04-12","966","79076","224","14267","16.8","18.2"
"Georgia","2020-04-13","4690","83766","786","15053","16.6","17.8"
"Georgia","2020-04-14","5610","89376","801","15854","16.6","17.3"
"Georgia","2020-04-15","5436","94812","712","16566","16.5","16.8"
"Georgia","2020-04-16","6332","101144","793","17359","15.9","16.5"
"Georgia","2020-04-17","6870","108014","804","18163","15.1","16"
"Georgia","2020-04-18","3524","111538","449","18612","14.9","15.6"
"Georgia","2020-04-19","2087","113625","421","19033","14.5","15.6"
"Georgia","2020-04-20","7994","121619","889","19922","13.7","15.1"
"Georgia","2020-04-21","8929","130548","917","20839","13.1","14.9"
"Georgia","2020-04-22","8723","139271","870","21709","12.6","14.6"
"Georgia","2020-04-23","6547","145818","654","22363","12.3","14.1"
"Georgia","2020-04-24","9497","155315","720","23083","11.7","13.4"
"Georgia","2020-04-25","4848","160163","348","23431","10.9","12.9"
"Georgia","2020-04-26","2124","162287","260","23691","9.8","12.1"
"Georgia","2020-04-27","8473","170760","901","24592","9.7","11.7"
"Georgia","2020-04-28","10115","180875","906","25498","9.5","11.3"
"Georgia","2020-04-29","10790","191665","887","26385","9.3","11"
"Georgia","2020-04-30","11172","202837","807","27192","8.9","10.6"
"Georgia","2020-05-01","10714","213551","886","28078","9","10.3"
"Georgia","2020-05-02","5695","219246","452","28530","9.1","10"
"Georgia","2020-05-03","3544","222790","289","28819","8.5","9.1"
"Georgia","2020-05-04","10928","233718","962","29781","8.2","9"
"Georgia","2020-05-05","9677","243395","588","30369","7.8","8.7"
"Georgia","2020-05-06","11027","254422","590","30959","7.4","8.3"
"Georgia","2020-05-07","9173","263595","597","31556","7.3","8.1"
"Georgia","2020-05-08","11784","275379","754","32310","7","8"
"Georgia","2020-05-09","6468","281847","403","32713","6.8","7.9"
"Georgia","2020-05-10","2277","284124","254","32967","7.2","7.9"
"Georgia","2020-05-11","13579","297703","833","33800","6.8","7.5"
"Georgia","2020-05-12","13715","311418","710","34510","6.7","7.3"
"Georgia","2020-05-13","12727","324145","679","35189","6.7","7.1"
"Georgia","2020-05-14","13495","337640","793","35982","6.6","7"
"Georgia","2020-05-15","15216","352856","930","36912","6.6","6.8"
"Georgia","2020-05-16","7326","360182","551","37463","6.8","6.8"
"Georgia","2020-05-17","3707","363889","306","37769","6.3","6.8"
"Georgia","2020-05-18","12603","376492","922","38691","6.5","6.7"
"Georgia","2020-05-19","14795","391287","923","39614","6.7","6.7"
"Georgia","2020-05-20","14401","405688","768","40382","6.7","6.7"
"Georgia","2020-05-21","13232","418920","762","41144","6.6","6.6"
"Georgia","2020-05-22","12949","431869","751","41895","6.6","6.6"
"Georgia","2020-05-23","6391","438260","441","42336","6.5","6.6"
"Georgia","2020-05-24","3343","441603","265","42601","6.5","6.4"
"Georgia","2020-05-25","3165","444768","205","42806","6.3","6.4"
"Georgia","2020-05-26","15631","460399","1100","43906","6.5","6.6"
"Georgia","2020-05-27","15106","475505","801","44707","6.5","6.6"
"Georgia","2020-05-28","14348","489853","742","45449","6.4","6.5"
"Georgia","2020-05-29","13147","503000","747","46196","6.4","6.5"
"Georgia","2020-05-30","6389","509389","417","46613","6.3","6.4"
"Georgia","2020-05-31","3382","512771","231","46844","6.1","6.3"
"Georgia","2020-06-01","13584","526355","939","47783","6.2","6.3"
"Georgia","2020-06-02","14187","540542","913","48696","6.1","6.3"
"Georgia","2020-06-03","15111","555653","905","49601","6.2","6.3"
"Georgia","2020-06-04","14547","570200","878","50479","6.3","6.4"
"Georgia","2020-06-05","13154","583354","818","51297","6.4","6.4"
"Georgia","2020-06-06","7721","591075","515","51812","6.4","6.4"
"Georgia","2020-06-07","3524","594599","336","52148","6.8","6.5"
"Georgia","2020-06-08","14884","609483","1083","53231","6.9","6.5"
"Georgia","2020-06-09","14602","624085","907","54138","6.8","6.5"
"Georgia","2020-06-10","15374","639459","1158","55296","7.1","6.6"
"Georgia","2020-06-11","16681","656140","1174","56470","7.2","6.8"
"Georgia","2020-06-12","14533","670673","954","57424","7.3","6.8"
"Georgia","2020-06-13","7480","678153","658","58082","7.6","7"
"Georgia","2020-06-14","4043","682196","420","58502","7.7","7.3"
"Georgia","2020-06-15","17974","700170","1465","59967","7.8","7.3"
"Georgia","2020-06-16","18061","718231","1439","61406","8.1","7.5"
"Georgia","2020-06-17","16954","735185","1707","63113","8.4","7.7"
"Georgia","2020-06-18","17703","752888","1768","64881","8.8","8"
"Georgia","2020-06-19","18493","771381","1811","66692","9.3","8.3"
"Georgia","2020-06-20","9640","781021","1180","67872","9.8","8.7"
"Georgia","2020-06-21","3904","784925","562","68434","10.4","9"
"Georgia","2020-06-22","24516","809441","3125","71559","11","9.4"
"Georgia","2020-06-23","22435","831876","2584","74143","11.5","9.8"
"Georgia","2020-06-24","23183","855059","2798","76941","11.8","10.1"
"Georgia","2020-06-25","25411","880470","3195","80136","12.2","10.5"
"Georgia","2020-06-26","28111","908581","3141","83277","12.4","10.8"
"Georgia","2020-06-27","14127","922708","1896","85173","12.6","11.2"
"Georgia","2020-06-28","5822","928530","1000","86173","13","11.7"
"Georgia","2020-06-29","32396","960926","4051","90224","12.9","12"
"Georgia","2020-06-30","33337","994263","4189","94413","13.1","12.3"
"Georgia","2020-07-01","31871","1026134","3915","98328","13.1","12.5"
"Georgia","2020-07-02","33775","1059909","4085","102413","13","12.6"
"Georgia","2020-07-03","14562","1074471","2166","104579","13.6","13"
"Georgia","2020-07-04","5479","1079950","904","105483","14","13.3"
"Georgia","2020-07-05","6325","1086275","1230","106713","14.3","13.6"
"Georgia","2020-07-06","35756","1122031","5434","112147","14.7","13.8"
"Georgia","2020-07-07","35780","1157811","4804","116951","14.8","14"
"Georgia","2020-07-08","35922","1193733","4782","121733","15","14"
"Georgia","2020-07-09","35578","1229311","4657","126390","15.1","14.1"
"Georgia","2020-07-10","34662","1263973","4526","130916","14.9","14.2"
"Georgia","2020-07-11","14636","1278609","2464","133380","14.9","14.5"
"Georgia","2020-07-12","7931","1286540","1472","134852","14.8","14.6"
"Georgia","2020-07-13","35271","1321811","5203","140055","14.7","14.7"
"Georgia","2020-07-14","34003","1355814","4714","144769","14.8","14.8"
"Georgia","2020-07-15","33980","1389794","4538","149307","14.8","14.9"
"Georgia","2020-07-16","36604","1426398","4698","154005","14.8","14.9"
"Georgia","2020-07-17","31301","1457699","3931","157936","14.7","14.8"
"Georgia","2020-07-18","14308","1472007","2092","160028","14.4","14.6"
"Georgia","2020-07-19","7481","1479488","1199","161227","14","14.4"
"Georgia","2020-07-20","33773","1513261","4748","165975","13.9","14.3"
"Georgia","2020-07-21","29603","1542864","3881","169856","13.8","14.3"
"Georgia","2020-07-22","31568","1574432","3933","173789","13.7","14.2"
"Georgia","2020-07-23","32284","1606716","3944","177733","13.6","14.2"
"Georgia","2020-07-24","30278","1636994","3838","181571","13.6","14.1"
"Georgia","2020-07-25","15405","1652399","2264","183835","13.6","14"
"Georgia","2020-07-26","6306","1658705","1069","184904","13.7","13.9"
"Georgia","2020-07-27","34327","1693032","4208","189112","13.5","13.7"
"Georgia","2020-07-28","29531","1722563","3638","192750","13.4","13.6"
"Georgia","2020-07-29","30029","1752592","3724","196474","13.4","13.5"
"Georgia","2020-07-30","29558","1782150","3665","200139","13.4","13.5"
"Georgia","2020-07-31","28968","1811118","3192","203331","13.1","13.4"
"Georgia","2020-08-01","14858","1825976","1966","205297","12.9","13.3"
"Georgia","2020-08-02","6403","1832379","996","206293","12.7","13.2"
"Georgia","2020-08-03","27981","1860360","2970","209263","12.5","13"
"Georgia","2020-08-04","28681","1889041","3330","212593","12.4","12.9"
"Georgia","2020-08-05","30067","1919108","3433","216026","12.3","12.8"
"Georgia","2020-08-06","28050","1947158","3029","219055","12","12.7"
"Georgia","2020-08-07","28139","1975297","2812","221867","11.9","12.5"
"Georgia","2020-08-08","14656","1989953","1456","223323","11.4","12.2"
"Georgia","2020-08-09","7355","1997308","1007","224330","11.2","11.9"
"Georgia","2020-08-10","29675","2026983","3118","227448","11.1","11.8"
"Georgia","2020-08-11","26795","2053778","2648","230096","10.9","11.6"
"Georgia","2020-08-12","26497","2080275","2502","232598","10.6","11.4"
"Georgia","2020-08-13","25505","2105780","2182","234780","10.3","11.2"
"Georgia","2020-08-14","27996","2133776","2285","237065","10","11"
"Georgia","2020-08-15","11633","2145409","1201","238266","10.1","10.7"
"Georgia","2020-08-16","9584","2154993","1055","239321","9.7","10.4"
"Georgia","2020-08-17","19869","2174862","1817","241138","9.5","10.3"
"Georgia","2020-08-18","24802","2199664","2219","243357","9.4","10.1"
"Georgia","2020-08-19","27017","2226681","2248","245605","9.2","9.9"
"Georgia","2020-08-20","24084","2250765","2008","247613","9.2","9.7"
"Georgia","2020-08-21","26419","2277184","2077","249690","9.1","9.6"
"Georgia","2020-08-22","12902","2290086","1096","250786","8.9","9.5"
"Georgia","2020-08-23","6448","2296534","710","251496","8.9","9.3"
"Georgia","2020-08-24","25495","2322029","2303","253799","8.9","9.2"
"Georgia","2020-08-25","23445","2345474","1955","255754","8.8","9.1"
"Georgia","2020-08-26","26548","2372022","2261","258015","8.8","9"
"Georgia","2020-08-27","24550","2396572","1942","259957","8.7","9"
"Georgia","2020-08-28","25250","2421822","2060","262017","8.8","9"
"Georgia","2020-08-29","12170","2433992","1041","263058","8.8","8.8"
"Georgia","2020-08-30","6778","2440770","788","263846","8.9","8.9"
"Georgia","2020-08-31","24753","2465523","2159","266005","8.8","8.8"
"Georgia","2020-09-01","24025","2489548","1949","267954","8.8","8.8"
"Georgia","2020-09-02","24731","2514279","1953","269907","8.7","8.8"
"Georgia","2020-09-03","23424","2537703","1842","271749","8.7","8.7"
"Georgia","2020-09-04","23551","2561254","1911","273660","8.7","8.7"
"Georgia","2020-09-05","11533","2572787","816","274476","8.5","8.6"
"Georgia","2020-09-06","5950","2578737","578","275054","8.2","8.5"
"Georgia","2020-09-07","7255","2585992","675","275729","8.3","8.6"
"Georgia","2020-09-08","26256","2612248","2102","277831","8.3","8.5"
"Georgia","2020-09-09","25586","2637834","1893","279724","8.2","8.5"
"Georgia","2020-09-10","25015","2662849","1765","281489","8.1","8.4"
"Georgia","2020-09-11","23835","2686684","1623","283112","7.9","8.3"
"Georgia","2020-09-12","10448","2697132","802","283914","8","8.2"
"Georgia","2020-09-13","5625","2702757","591","284505","8.1","8.2"
"Georgia","2020-09-14","25152","2727909","1745","286250","7.8","8"
"Georgia","2020-09-15","23105","2751014","1497","287747","7.6","7.9"
"Georgia","2020-09-16","23341","2774355","1283","289030","7.3","7.7"
"Georgia","2020-09-17","18987","2793342","1135","290165","7.1","7.6"
"Georgia","2020-09-18","23334","2816676","1357","291522","7","7.4"
"Georgia","2020-09-19","12050","2828726","774","292296","6.8","7.4"
"Georgia","2020-09-20","4880","2833606","417","292713","6.5","7.3"
"Georgia","2020-09-21","23300","2856906","1447","294160","6.4","7.1"
"Georgia","2020-09-22","21559","2878465","1272","295432","6.3","6.9"
"Georgia","2020-09-23","22789","2901254","1331","296763","6.4","6.8"
"Georgia","2020-09-24","21406","2922660","1198","297961","6.3","6.7"
"Georgia","2020-09-25","21741","2944401","1214","299175","6.3","6.6"
"Georgia","2020-09-26","8869","2953270","670","299845","6.5","6.6"
"Georgia","2020-09-27","4764","2958034","385","300230","6.4","6.5"
"Georgia","2020-09-28","22299","2980333","1301","301531","6.3","6.4"
"Georgia","2020-09-29","21346","3001679","1105","302636","6.2","6.3"
"Georgia","2020-09-30","22432","3024111","1244","303880","6.2","6.3"
"Georgia","2020-10-01","24017","3048128","1174","305054","6.1","6.2"
"Georgia","2020-10-02","22946","3071074","1217","306271","6.1","6.2"
"Georgia","2020-10-03","12334","3083408","714","306985","5.8","6.1"
"Georgia","2020-10-04","6115","3089523","434","307419","5.7","6"
"Georgia","2020-10-05","25937","3115460","1529","308948","5.7","6"
"Georgia","2020-10-06","27421","3142881","1326","310274","5.6","5.9"
"Georgia","2020-10-07","28447","3171328","1385","311659","5.5","5.9"
"Georgia","2020-10-08","24967","3196295","1385","313044","5.6","5.9"
"Georgia","2020-10-09","25282","3221577","1313","314357","5.6","5.8"
"Georgia","2020-10-10","11716","3233293","738","315095","5.7","5.7"
"Georgia","2020-10-11","5513","3238806","468","315563","5.9","5.8"
"Georgia","2020-10-12","19357","3258163","1242","316805","5.9","5.8"
"Georgia","2020-10-13","25901","3284064","1541","318346","6.1","5.9"
"Georgia","2020-10-14","23757","3307821","1362","319708","6.2","5.9"
"Georgia","2020-10-15","23743","3331564","1475","321183","6.3","6"
"Georgia","2020-10-16","23400","3354964","1464","322647","6.5","6"
"Georgia","2020-10-17","11370","3366334","743","323390","6.5","6.1"
"Georgia","2020-10-18","5259","3371593","470","323860","6.6","6.2"
"Georgia","2020-10-19","26213","3397806","1725","325585","6.6","6.3"
"Georgia","2020-10-20","24283","3422089","1529","327114","6.7","6.4"
"Georgia","2020-10-21","27343","3449432","1715","328829","6.7","6.5"
"Georgia","2020-10-22","23328","3472760","1658","330487","6.9","6.6"
"Georgia","2020-10-23","25238","3497998","1631","332118","6.9","6.7"
"Georgia","2020-10-24","12099","3510097","967","333085","7.1","6.8"
"Georgia","2020-10-25","7170","3517267","678","333763","7.2","6.9"
"Georgia","2020-10-26","27411","3544678","1962","335725","7.2","6.9"
"Georgia","2020-10-27","26210","3570888","1679","337404","7.3","7"
"Georgia","2020-10-28","27994","3598882","1823","339227","7.3","7"
"Georgia","2020-10-29","20021","3618903","1413","340640","7.3","7.1"
"Georgia","2020-10-30","26838","3645741","1761","342401","7.3","7.1"
"Georgia","2020-10-31","12645","3658386","1035","343436","7.3","7.2"
"Georgia","2020-11-01","6972","3665358","735","344171","7.5","7.3"
"Georgia","2020-11-02","29138","3694496","2186","346357","7.5","7.4"
"Georgia","2020-11-03","24448","3718944","1687","348044","7.6","7.4"
"Georgia","2020-11-04","26393","3745337","1867","349911","7.7","7.5"
"Georgia","2020-11-05","27735","3773072","1821","351732","7.6","7.5"
"Georgia","2020-11-06","27540","3800612","1919","353651","7.7","7.5"
"Georgia","2020-11-07","13983","3814595","1380","355031","7.9","7.6"
"Georgia","2020-11-08","7434","3822029","838","355869","8","7.8"
"Georgia","2020-11-09","30546","3852575","2737","358606","8.2","7.9"
"Georgia","2020-11-10","31309","3883884","2470","361076","8.4","8"
"Georgia","2020-11-11","25719","3909603","2068","363144","8.5","8.1"
"Georgia","2020-11-12","32744","3942347","2676","365820","8.7","8.2"
"Georgia","2020-11-13","33365","3975712","2513","368333","8.8","8.2"
"Georgia","2020-11-14","17227","3992939","1583","369916","8.7","8.3"
"Georgia","2020-11-15","8461","4001400","979","370895","8.8","8.4"
"Georgia","2020-11-16","36339","4037739","3097","373992","8.7","8.5"
"Georgia","2020-11-17","36340","4074079","2686","376678","8.6","8.5"
"Georgia","2020-11-18","39859","4113938","2678","379356","8.4","8.5"
"Georgia","2020-11-19","40188","4154126","2790","382146","8.3","8.5"
"Georgia","2020-11-20","40637","4194763","2742","384888","8.2","8.5"
"Georgia","2020-11-21","20990","4215753","1618","386506","7.9","8.3"
"Georgia","2020-11-22","10755","4226508","988","387494","7.6","8.2"
"Georgia","2020-11-23","43147","4269655","3294","390788","7.5","8.1"
"Georgia","2020-11-24","37536","4307191","3195","393983","7.6","8.1"
"Georgia","2020-11-25","33495","4340686","3207","397190","8","8.2"
"Georgia","2020-11-26","5599","4346285","459","397649","8.2","8.2"
"Georgia","2020-11-27","18625","4364910","2504","400153","9.2","8.7"
"Georgia","2020-11-28","14727","4379637","2268","402421","10.3","9.1"
"Georgia","2020-11-29","11036","4390673","1668","404089","11.1","9.4"
"Georgia","2020-11-30","41682","4432355","5199","409288","11.8","9.6"
"Georgia","2020-12-01","38133","4470488","4664","413952","12.3","10"
"Georgia","2020-12-02","39291","4509779","4584","418536","12.6","10.3"
"Georgia","2020-12-03","37516","4547295","4573","423109","13.2","10.7"
"Georgia","2020-12-04","37300","4584595","4337","427446","13","11.1"
"Georgia","2020-12-05","20344","4604939","2762","430208","12.7","11.5"
"Georgia","2020-12-06","10250","4615189","1640","431848","12.8","12"
"Georgia","2020-12-07","41395","4656584","5261","437109","12.9","12.3"
"Georgia","2020-12-08","40971","4697555","5076","442185","12.9","12.6"
"Georgia","2020-12-09","41993","4739548","5043","447228","12.9","12.8"
"Georgia","2020-12-10","40697","4780245","5248","452476","13","13.1"
"Georgia","2020-12-11","41694","4821939","5219","457695","13.2","13.1"
"Georgia","2020-12-12","22927","4844866","3404","461099","13.3","13"
"Georgia","2020-12-13","10947","4855813","2097","463196","13.8","13.3"
"Georgia","2020-12-14","48635","4904448","6863","470059","14","13.4"
"Georgia","2020-12-15","48391","4952839","6641","476700","14.2","13.5"
"Georgia","2020-12-16","46686","4999525","6033","482733","14.3","13.6"
"Georgia","2020-12-17","49577","5049102","6676","489409","14.4","13.7"
"Georgia","2020-12-18","48081","5097183","6306","495715","14.5","13.8"
"Georgia","2020-12-19","25795","5122978","3765","499480","14.4","13.9"
"Georgia","2020-12-20","13770","5136748","2586","502066","14.4","14.1"
"Georgia","2020-12-21","53568","5190316","7967","510033","14.5","14.2"
"Georgia","2020-12-22","50878","5241194","7628","517661","14.7","14.4"
"Georgia","2020-12-23","47264","5288458","6836","524497","14.9","14.6"
"Georgia","2020-12-24","22269","5310727","3873","528370","15.5","14.9"
"Georgia","2020-12-25","4029","5314756","814","529184","16.5","15.5"
"Georgia","2020-12-26","20071","5334827","4570","533754","17.6","16"
"Georgia","2020-12-27","13510","5348337","3390","537144","18.5","16.5"
"Georgia","2020-12-28","52297","5400634","9882","547026","19.1","16.8"
"Georgia","2020-12-29","49025","5449659","9741","556767","19.8","17.2"
"Georgia","2020-12-30","49905","5499564","9049","565816","20.3","17.6"
"Georgia","2020-12-31","36205","5535769","6485","572301","20.4","17.9"
"Georgia","2021-01-01","6732","5542501","1658","573959","21","18.8"
"Georgia","2021-01-02","20114","5562615","4426","578385","20.9","19.3"
"Georgia","2021-01-03","11548","5574163","2930","581315","21","19.8"
"Georgia","2021-01-04","49459","5623622","10056","591371","21.2","20.1"
"Georgia","2021-01-05","65787","5689409","12280","603651","21","20.4"
"Georgia","2021-01-06","53233","5742642","9352","613003","20.9","20.6"
"Georgia","2021-01-07","52506","5795148","9789","622792","21","20.7"
"Georgia","2021-01-08","43647","5838795","7565","630357","20","20.5"
"Georgia","2021-01-09","24856","5863651","5074","635431","19.8","20.3"
"Georgia","2021-01-10","13767","5877418","3080","638511","19.3","20.2"
"Georgia","2021-01-11","45822","5923240","7829","646340","18.9","20"
"Georgia","2021-01-12","48723","5971963","7684","654024","18.5","19.7"
"Georgia","2021-01-13","44973","6016936","6768","660792","18.1","19.5"
"Georgia","2021-01-14","44735","6061671","6839","667631","17.6","19.3"
"Georgia","2021-01-15","41667","6103338","6531","674162","17.4","18.7"
"Georgia","2021-01-16","22165","6125503","4214","678376","17.2","18.5"
"Georgia","2021-01-17","12697","6138200","2682","681058","17","18.2"
"Georgia","2021-01-18","32493","6170693","5180","686238","16.8","17.9"
"Georgia","2021-01-19","44513","6215206","6282","692520","16.6","17.5"
"Georgia","2021-01-20","41676","6256882","5590","698110","16.4","17.2"
"Georgia","2021-01-21","39729","6296611","5616","703726","16.2","16.9"
"Georgia","2021-01-22","38955","6335566","5175","708901","15.9","16.6"
"Georgia","2021-01-23","19761","6355327","3327","712228","15.5","16.4"
"Georgia","2021-01-24","12241","6367568","2340","714568","15.3","16.1"
"Georgia","2021-01-25","42437","6410005","5862","720430","15","15.9"
"Georgia","2021-01-26","41103","6451108","5326","725756","14.8","15.7"
"Georgia","2021-01-27","36918","6488026","4568","730324","14.6","15.5"
"Georgia","2021-01-28","37227","6525253","4645","734969","14.4","15.3"
"Georgia","2021-01-29","35229","6560482","4130","739099","14.2","15"
"Georgia","2021-01-30","17619","6578101","2476","741575","13.8","14.7"
"Georgia","2021-01-31","11211","6589312","1876","743451","13.4","14.4"
"Georgia","2021-02-01","36255","6625567","4273","747724","13.2","14.1"
"Georgia","2021-02-02","34743","6660310","3591","751315","12.8","13.8"
"Georgia","2021-02-03","32708","6693018","3209","754524","12.4","13.5"
"Georgia","2021-02-04","29037","6722055","3053","757577","12.1","13.3"
"Georgia","2021-02-05","22195","6744250","2173","759750","11.9","13"
"Georgia","2021-02-06","5158","6749408","649","760399","11.7","12.7"
"Georgia","2021-02-07","715","6750123","106","760505","11.4","12.4"
"Georgia","2021-02-08","0","6750123","0","760505","9.7","11.4"
"Appling","2020-02-01","0","0","0","0",".","."
"Appling","2020-02-02","0","0","0","0",".","."
"Appling","2020-02-03","0","0","0","0",".","."
"Appling","2020-02-04","0","0","0","0",".","."
"Appling","2020-02-05","0","0","0","0",".","."
"Appling","2020-02-06","0","0","0","0",".","."
"Appling","2020-02-07","0","0","0","0","0","."
"Appling","2020-02-08","0","0","0","0","0","."
"Appling","2020-02-09","0","0","0","0","0","."
"Appling","2020-02-10","0","0","0","0","0","."
"Appling","2020-02-11","0","0","0","0","0","."
"Appling","2020-02-12","0","0","0","0","0","."
"Appling","2020-02-13","0","0","0","0","0","."
"Appling","2020-02-14","0","0","0","0","0","0"
"Appling","2020-02-15","0","0","0","0","0","0"
"Appling","2020-02-16","0","0","0","0","0","0"
"Appling","2020-02-17","0","0","0","0","0","0"
"Appling","2020-02-18","0","0","0","0","0","0"
"Appling","2020-02-19","0","0","0","0","0","0"
"Appling","2020-02-20","0","0","0","0","0","0"
"Appling","2020-02-21","0","0","0","0","0","0"
"Appling","2020-02-22","0","0","0","0","0","0"
"Appling","2020-02-23","0","0","0","0","0","0"
"Appling","2020-02-24","0","0","0","0","0","0"
"Appling","2020-02-25","0","0","0","0","0","0"
"Appling","2020-02-26","0","0","0","0","0","0"
"Appling","2020-02-27","0","0","0","0","0","0"
"Appling","2020-02-28","0","0","0","0","0","0"
"Appling","2020-02-29","0","0","0","0","0","0"
"Appling","2020-03-01","0","0","0","0","0","0"
"Appling","2020-03-02","0","0","0","0","0","0"
"Appling","2020-03-03","0","0","0","0","0","0"
"Appling","2020-03-04","0","0","0","0","0","0"
"Appling","2020-03-05","0","0","0","0","0","0"
"Appling","2020-03-06","0","0","0","0","0","0"
"Appling","2020-03-07","0","0","0","0","0","0"
"Appling","2020-03-08","0","0","0","0","0","0"
"Appling","2020-03-09","0","0","0","0","0","0"
"Appling","2020-03-10","0","0","0","0","0","0"
"Appling","2020-03-11","0","0","0","0","0","0"
"Appling","2020-03-12","0","0","0","0","0","0"
"Appling","2020-03-13","1","1","0","0","0","0"
"Appling","2020-03-14","0","1","0","0","0","0"
"Appling","2020-03-15","0","1","0","0","0","0"
"Appling","2020-03-16","3","4","0","0","0","0"
"Appling","2020-03-17","3","7","0","0","0","0"
"Appling","2020-03-18","3","10","0","0","0","0"
"Appling","2020-03-19","3","13","0","0","0","0"
"Appling","2020-03-20","2","15","0","0","0","0"
"Appling","2020-03-21","1","16","0","0","0","0"
"Appling","2020-03-22","1","17","0","0","0","0"
"Appling","2020-03-23","1","18","0","0","0","0"
"Appling","2020-03-24","4","22","0","0","0","0"
"Appling","2020-03-25","6","28","0","0","0","0"
"Appling","2020-03-26","3","31","0","0","0","0"
"Appling","2020-03-27","2","33","1","1","7.1","3.6"
"Appling","2020-03-28","3","36","2","3","16.7","8.3"
"Appling","2020-03-29","0","36","0","3","16.7","8.3"
"Appling","2020-03-30","8","44","2","5","20.2","10.1"
"Appling","2020-03-31","5","49","1","6","23.1","11.5"
"Appling","2020-04-01","4","53","0","6","23.1","11.5"
"Appling","2020-04-02","3","56","0","6","23.1","11.5"
"Appling","2020-04-03","1","57","1","7","30.2","18.7"
"Appling","2020-04-04","0","57","0","7","20.7","18.7"
"Appling","2020-04-05","2","59","0","7","20.7","18.7"
"Appling","2020-04-06","7","66","1","8","19.2","19.7"
"Appling","2020-04-07","5","71","0","8","16.3","19.7"
"Appling","2020-04-08","5","76","2","10","22","22.6"
"Appling","2020-04-09","1","77","0","10","22","22.6"
"Appling","2020-04-10","1","78","0","10","7.8","19"
"Appling","2020-04-11","3","81","3","13","22","21.4"
"Appling","2020-04-12","0","81","0","13","22","21.4"
"Appling","2020-04-13","10","91","5","18","27.1","23.2"
"Appling","2020-04-14","3","94","1","19","31.9","24.1"
"Appling","2020-04-15","4","98","0","19","26.2","24.1"
"Appling","2020-04-16","4","102","0","19","26.2","24.1"
"Appling","2020-04-17","57","159","47","66","38","22.9"
"Appling","2020-04-18","1","160","0","66","23.7","22.9"
"Appling","2020-04-19","0","160","0","66","23.7","22.9"
"Appling","2020-04-20","5","165","1","67","19.4","23.3"
"Appling","2020-04-21","3","168","0","67","14.6","23.3"
"Appling","2020-04-22","54","222","12","79","17.8","22"
"Appling","2020-04-23","80","302","0","79","17.8","22"
"Appling","2020-04-24","2","304","1","80","13.2","25.6"
"Appling","2020-04-25","6","310","0","80","13.2","18.4"
"Appling","2020-04-26","1","311","0","80","13.2","18.4"
"Appling","2020-04-27","10","321","0","80","10.3","14.9"
"Appling","2020-04-28","5","326","1","81","13.2","13.9"
"Appling","2020-04-29","6","332","0","81","10","13.9"
"Appling","2020-04-30","13","345","1","82","11.1","14.5"
"Appling","2020-05-01","5","350","0","82","4","8.6"
"Appling","2020-05-02","2","352","0","82","4","8.6"
"Appling","2020-05-03","0","352","0","82","4","8.6"
"Appling","2020-05-04","8","360","0","82","4","7.1"
"Appling","2020-05-05","7","367","0","82","1.1","7.1"
"Appling","2020-05-06","4","371","0","82","1.1","5.5"
"Appling","2020-05-07","8","379","0","82","0","5.5"
"Appling","2020-05-08","7","386","2","84","4.1","4"
"Appling","2020-05-09","3","389","0","84","4.1","4"
"Appling","2020-05-10","1","390","1","85","18.4","11.2"
"Appling","2020-05-11","7","397","0","85","18.4","11.2"
"Appling","2020-05-12","7","404","0","85","18.4","9.7"
"Appling","2020-05-13","7","411","2","87","22.4","11.8"
"Appling","2020-05-14","8","419","0","87","22.4","11.2"
"Appling","2020-05-15","4","423","3","90","29.1","16.6"
"Appling","2020-05-16","1","424","0","90","29.1","16.6"
"Appling","2020-05-17","1","425","1","91","29.1","23.7"
"Appling","2020-05-18","5","430","1","92","31.9","25.2"
"Appling","2020-05-19","13","443","2","94","34.1","26.3"
"Appling","2020-05-20","11","454","2","96","32.7","27.6"
"Appling","2020-05-21","38","492","2","98","33.4","27.9"
"Appling","2020-05-22","30","522","1","99","23.2","26.1"
"Appling","2020-05-23","2","524","1","100","30.3","29.7"
"Appling","2020-05-24","4","528","0","100","16","22.6"
"Appling","2020-05-25","2","530","0","100","13.2","22.6"
"Appling","2020-05-26","28","558","5","105","13.5","23.8"
"Appling","2020-05-27","5","563","0","105","10.9","21.8"
"Appling","2020-05-28","10","573","1","106","11.6","22.5"
"Appling","2020-05-29","3","576","0","106","11.1","17.1"
"Appling","2020-05-30","2","578","1","107","11.1","20.7"
"Appling","2020-05-31","0","578","0","107","11.1","13.6"
"Appling","2020-06-01","23","601","5","112","14.2","13.7"
"Appling","2020-06-02","8","609","5","117","20.6","17.1"
"Appling","2020-06-03","5","614","3","120","29.2","20"
"Appling","2020-06-04","11","625","4","124","32.9","22.3"
"Appling","2020-06-05","5","630","0","124","32.9","22"
"Appling","2020-06-06","0","630","0","124","25.8","18.5"
"Appling","2020-06-07","2","632","0","124","25.8","18.5"
"Appling","2020-06-08","6","638","1","125","25.1","19.7"
"Appling","2020-06-09","6","644","2","127","20.9","20.8"
"Appling","2020-06-10","10","654","2","129","15.2","22.2"
"Appling","2020-06-11","12","666","1","130","11.2","22.1"
"Appling","2020-06-12","5","671","1","131","14","23.5"
"Appling","2020-06-13","2","673","0","131","14","19.9"
"Appling","2020-06-14","5","678","1","132","16.9","21.4"
"Appling","2020-06-15","14","692","3","135","17.6","21.3"
"Appling","2020-06-16","14","706","3","138","15.9","18.4"
"Appling","2020-06-17","7","713","1","139","15.1","15.1"
"Appling","2020-06-18","12","725","0","139","13.9","12.5"
"Appling","2020-06-19","9","734","2","141","14.2","14.1"
"Appling","2020-06-20","4","738","2","143","21.3","17.7"
"Appling","2020-06-21","1","739","1","144","32.8","24.8"
"Appling","2020-06-22","19","758","2","146","31.2","24.4"
"Appling","2020-06-23","11","769","3","149","32","24"
"Appling","2020-06-24","34","803","2","151","30.8","23"
"Appling","2020-06-25","22","825","3","154","32.8","23.3"
"Appling","2020-06-26","30","855","1","155","30.1","22.1"
"Appling","2020-06-27","13","868","2","157","25.1","23.2"
"Appling","2020-06-28","9","877","1","158","12.4","22.6"
"Appling","2020-06-29","40","917","5","163","12.7","22"
"Appling","2020-06-30","30","947","9","172","13.1","22.6"
"Appling","2020-07-01","31","978","7","179","15.5","23.2"
"Appling","2020-07-02","34","1012","3","182","14.8","23.8"
"Appling","2020-07-03","22","1034","5","187","17.6","23.8"
"Appling","2020-07-04","10","1044","1","188","16.8","21"
"Appling","2020-07-05","12","1056","3","191","18.8","15.6"
"Appling","2020-07-06","60","1116","14","205","20.4","16.5"
"Appling","2020-07-07","37","1153","10","215","19.9","16.5"
"Appling","2020-07-08","32","1185","6","221","19.4","17.4"
"Appling","2020-07-09","30","1215","10","231","22.9","18.9"
"Appling","2020-07-10","38","1253","8","239","22.6","20.1"
"Appling","2020-07-11","25","1278","4","243","23.5","20.2"
"Appling","2020-07-12","8","1286","2","245","23.5","21.2"
"Appling","2020-07-13","38","1324","7","252","22.8","21.6"
"Appling","2020-07-14","48","1372","14","266","23.1","21.5"
"Appling","2020-07-15","35","1407","6","272","22.9","21.1"
"Appling","2020-07-16","38","1445","7","279","20.7","21.8"
"Appling","2020-07-17","22","1467","2","281","19","20.8"
"Appling","2020-07-18","8","1475","3","284","22.1","22.8"
"Appling","2020-07-19","5","1480","2","286","24.2","23.9"
"Appling","2020-07-20","18","1498","5","291","25.6","24.2"
"Appling","2020-07-21","40","1538","6","297","23.6","23.3"
"Appling","2020-07-22","39","1577","9","306","24.4","23.6"
"Appling","2020-07-23","21","1598","8","314","27.2","24"
"Appling","2020-07-24","18","1616","3","317","28.3","23.7"
"Appling","2020-07-25","13","1629","2","319","25.1","23.6"
"Appling","2020-07-26","8","1637","2","321","23","23.6"
"Appling","2020-07-27","26","1663","9","330","24","24.8"
"Appling","2020-07-28","21","1684","5","335","25.2","24.4"
"Appling","2020-07-29","34","1718","5","340","24","24.2"
"Appling","2020-07-30","25","1743","3","343","20.3","23.8"
"Appling","2020-07-31","16","1759","4","347","21.5","24.9"
"Appling","2020-08-01","6","1765","1","348","21.7","23.4"
"Appling","2020-08-02","9","1774","1","349","19.7","21.4"
"Appling","2020-08-03","37","1811","7","356","17.5","20.7"
"Appling","2020-08-04","23","1834","4","360","16.5","20.9"
"Appling","2020-08-05","33","1867","10","370","18.8","21.4"
"Appling","2020-08-06","37","1904","11","381","21.3","20.8"
"Appling","2020-08-07","21","1925","4","385","20.5","21"
"Appling","2020-08-08","5","1930","1","386","20.9","21.3"
"Appling","2020-08-09","4","1934","0","386","19.3","19.5"
"Appling","2020-08-10","39","1973","9","395","19.9","18.7"
"Appling","2020-08-11","29","2002","9","404","21.9","19.2"
"Appling","2020-08-12","22","2024","4","408","20.2","19.5"
"Appling","2020-08-13","28","2052","5","413","18.5","19.9"
"Appling","2020-08-14","37","2089","5","418","17.7","19.1"
"Appling","2020-08-15","10","2099","2","420","17.7","19.3"
"Appling","2020-08-16","8","2107","3","423","23","21.2"
"Appling","2020-08-17","43","2150","8","431","22.4","21.2"
"Appling","2020-08-18","49","2199","6","437","19.7","20.8"
"Appling","2020-08-19","33","2232","5","442","19.3","19.7"
"Appling","2020-08-20","35","2267","5","447","18.8","18.6"
"Appling","2020-08-21","35","2302","4","451","18.5","18.1"
"Appling","2020-08-22","13","2315","0","451","15.6","16.6"
"Appling","2020-08-23","5","2320","0","451","10.2","16.6"
"Appling","2020-08-24","70","2390","9","460","9.4","15.9"
"Appling","2020-08-25","42","2432","5","465","9.4","14.5"
"Appling","2020-08-26","50","2482","5","470","8.6","14"
"Appling","2020-08-27","42","2524","3","473","7.6","13.2"
"Appling","2020-08-28","19","2543","3","476","8.2","13.4"
"Appling","2020-08-29","10","2553","1","477","9.7","12.6"
"Appling","2020-08-30","6","2559","0","477","9.7","10"
"Appling","2020-08-31","43","2602","8","485","10.5","10"
"Appling","2020-09-01","41","2643","6","491","10.9","10.1"
"Appling","2020-09-02","22","2665","4","495","12.1","10.3"
"Appling","2020-09-03","43","2708","3","498","12","9.8"
"Appling","2020-09-04","38","2746","5","503","11.7","9.9"
"Appling","2020-09-05","9","2755","1","504","11.8","10.7"
"Appling","2020-09-06","13","2768","0","504","11.8","10.7"
"Appling","2020-09-07","11","2779","2","506","11.7","11.1"
"Appling","2020-09-08","49","2828","1","507","10","10.4"
"Appling","2020-09-09","47","2875","5","512","8.9","10.5"
"Appling","2020-09-10","28","2903","1","513","8.4","10.2"
"Appling","2020-09-11","12","2915","2","515","8.9","10.3"
"Appling","2020-09-12","7","2922","0","515","7.3","9.6"
"Appling","2020-09-13","8","2930","3","518","12.7","12.2"
"Appling","2020-09-14","37","2967","7","525","12.8","12.3"
"Appling","2020-09-15","11","2978","0","525","12.5","11.2"
"Appling","2020-09-16","40","3018","2","527","11.7","10.3"
"Appling","2020-09-17","33","3051","2","529","12","10.2"
"Appling","2020-09-18","18","3069","2","531","11.2","10.1"
"Appling","2020-09-19","5","3074","1","532","14.1","10.7"
"Appling","2020-09-20","4","3078","1","533","12.3","12.5"
"Appling","2020-09-21","29","3107","3","536","11.1","11.9"
"Appling","2020-09-22","29","3136","3","539","12.6","12.5"
"Appling","2020-09-23","36","3172","2","541","12.6","12.1"
"Appling","2020-09-24","24","3196","7","548","15.9","14"
"Appling","2020-09-25","15","3211","1","549","15.3","13.3"
"Appling","2020-09-26","6","3217","1","550","14.8","14.5"
"Appling","2020-09-27","2","3219","1","551","18.4","15.3"
"Appling","2020-09-28","22","3241","4","555","19.5","15.3"
"Appling","2020-09-29","23","3264","4","559","20.5","16.5"
"Appling","2020-09-30","33","3297","7","566","22.8","17.7"
"Appling","2020-10-01","16","3313","4","570","22.2","19"
"Appling","2020-10-02","15","3328","5","575","26","20.6"
"Appling","2020-10-03","9","3337","4","579","29.9","22.4"
"Appling","2020-10-04","6","3343","1","580","25.2","21.8"
"Appling","2020-10-05","34","3377","5","585","24.7","22.1"
"Appling","2020-10-06","16","3393","1","586","23.1","21.8"
"Appling","2020-10-07","29","3422","4","590","22","22.4"
"Appling","2020-10-08","42","3464","14","604","23.2","22.7"
"Appling","2020-10-09","10","3474","1","605","19.9","22.9"
"Appling","2020-10-10","7","3481","2","607","17.6","23.8"
"Appling","2020-10-11","0","3481","0","607","15.2","20.2"
"Appling","2020-10-12","18","3499","3","610","15.5","20.1"
"Appling","2020-10-13","22","3521","4","614","17.2","20.2"
"Appling","2020-10-14","16","3537","0","614","15.3","18.6"
"Appling","2020-10-15","14","3551","0","614","10.5","16.9"
"Appling","2020-10-16","14","3565","5","619","14.2","17"
"Appling","2020-10-17","4","3569","1","620","13.7","15.6"
"Appling","2020-10-18","4","3573","2","622","20.8","18"
"Appling","2020-10-19","43","3616","6","628","20.4","18"
"Appling","2020-10-20","16","3632","0","628","17.8","17.5"
"Appling","2020-10-21","31","3663","2","630","18.7","17"
"Appling","2020-10-22","21","3684","2","632","20.1","15.3"
"Appling","2020-10-23","8","3692","0","632","15","14.6"
"Appling","2020-10-24","6","3698","1","633","13.8","13.7"
"Appling","2020-10-25","5","3703","1","634","9.5","15.2"
"Appling","2020-10-26","38","3741","4","638","9","14.7"
"Appling","2020-10-27","25","3766","5","643","11.9","14.8"
"Appling","2020-10-28","23","3789","1","644","11.6","15.2"
"Appling","2020-10-29","16","3805","1","645","11.1","15.6"
"Appling","2020-10-30","12","3817","2","647","13.5","14.2"
"Appling","2020-10-31","9","3826","3","650","15.9","14.8"
"Appling","2020-11-01","1","3827","0","650","13","11.3"
"Appling","2020-11-02","25","3852","4","654","13.8","11.4"
"Appling","2020-11-03","17","3869","0","654","10.9","11.4"
"Appling","2020-11-04","26","3895","0","654","10.3","11"
"Appling","2020-11-05","16","3911","1","655","10.3","10.7"
"Appling","2020-11-06","15","3926","1","656","8.9","11.2"
"Appling","2020-11-07","4","3930","0","656","4.1","10"
"Appling","2020-11-08","4","3934","0","656","4.1","8.6"
"Appling","2020-11-09","22","3956","1","657","2.5","8.1"
"Appling","2020-11-10","17","3973","1","658","3.3","7.1"
"Appling","2020-11-11","17","3990","3","661","5.9","8.1"
"Appling","2020-11-12","9","3999","1","662","6.6","8.4"
"Appling","2020-11-13","13","4012","1","663","6.7","7.8"
"Appling","2020-11-14","2","4014","0","663","6.7","5.4"
"Appling","2020-11-15","4","4018","0","663","6.7","5.4"
"Appling","2020-11-16","24","4042","2","665","7.2","4.9"
"Appling","2020-11-17","11","4053","1","666","7.7","5.5"
"Appling","2020-11-18","21","4074","0","666","5.2","5.5"
"Appling","2020-11-19","13","4087","1","667","4.7","5.6"
"Appling","2020-11-20","17","4104","4","671","6.9","6.8"
"Appling","2020-11-21","5","4109","1","672","9.8","8.3"
"Appling","2020-11-22","4","4113","0","672","9.8","8.3"
"Appling","2020-11-23","25","4138","1","673","9.2","8.2"
"Appling","2020-11-24","17","4155","1","674","8.7","8.2"
"Appling","2020-11-25","19","4174","1","675","9.5","7.3"
"Appling","2020-11-26","3","4177","0","675","8.4","6.5"
"Appling","2020-11-27","8","4185","2","677","8.6","7.8"
"Appling","2020-11-28","9","4194","0","677","5.7","7.8"
"Appling","2020-11-29","5","4199","0","677","5.7","7.8"
"Appling","2020-11-30","34","4233","4","681","6.8","8"
"Appling","2020-12-01","22","4255","2","683","7.3","8"
"Appling","2020-12-02","30","4285","4","687","8.5","9"
"Appling","2020-12-03","20","4305","0","687","8.5","8.4"
"Appling","2020-12-04","24","4329","1","688","5.5","7"
"Appling","2020-12-05","9","4338","0","688","5.5","5.6"
"Appling","2020-12-06","3","4341","0","688","5.5","5.6"
"Appling","2020-12-07","28","4369","2","690","4.8","5.8"
"Appling","2020-12-08","26","4395","5","695","6.3","6.8"
"Appling","2020-12-09","28","4423","4","699","6.4","7.4"
"Appling","2020-12-10","24","4447","6","705","10","9.2"
"Appling","2020-12-11","18","4465","2","707","11","8.2"
"Appling","2020-12-12","4","4469","1","708","14.5","10"
"Appling","2020-12-13","3","4472","1","709","19.3","12.4"
"Appling","2020-12-14","51","4523","11","720","21.4","13.1"
"Appling","2020-12-15","43","4566","12","732","22.6","14.4"
"Appling","2020-12-16","62","4628","16","748","24.2","15.3"
"Appling","2020-12-17","25","4653","6","754","24.1","17"
"Appling","2020-12-18","24","4677","4","758","24.9","17.9"
"Appling","2020-12-19","4","4681","0","758","21.3","17.9"
"Appling","2020-12-20","7","4688","1","759","18.6","19"
"Appling","2020-12-21","44","4732","7","766","17.8","19.6"
"Appling","2020-12-22","37","4769","9","775","17.3","19.9"
"Appling","2020-12-23","35","4804","8","783","16.9","20.6"
"Appling","2020-12-24","16","4820","4","787","17","20.6"
"Appling","2020-12-25","10","4830","2","789","17.5","21.2"
"Appling","2020-12-26","14","4844","8","797","25.6","23.5"
"Appling","2020-12-27","5","4849","2","799","29.3","24"
"Appling","2020-12-28","58","4907","11","810","29.8","23.8"
"Appling","2020-12-29","31","4938","8","818","30","23.6"
"Appling","2020-12-30","65","5003","13","831","29.6","23.2"
"Appling","2020-12-31","17","5020","3","834","28.5","22.8"
"Appling","2021-01-01","3","5023","0","834","25.7","21.6"
"Appling","2021-01-02","9","5032","2","836","20.7","23.2"
"Appling","2021-01-03","11","5043","2","838","17.5","23.4"
"Appling","2021-01-04","78","5121","23","861","19","24.4"
"Appling","2021-01-05","48","5169","12","873","18.9","24.5"
"Appling","2021-01-06","51","5220","7","880","18","23.8"
"Appling","2021-01-07","36","5256","2","882","16.3","22.4"
"Appling","2021-01-08","28","5284","2","884","17.3","21.5"
"Appling","2021-01-09","16","5300","5","889","18.6","19.6"
"Appling","2021-01-10","11","5311","3","892","19.9","18.7"
"Appling","2021-01-11","67","5378","11","903","18.1","18.6"
"Appling","2021-01-12","62","5440","7","910","16.1","17.5"
"Appling","2021-01-13","39","5479","9","919","17.4","17.7"
"Appling","2021-01-14","34","5513","5","924","18.7","17.5"
"Appling","2021-01-15","32","5545","4","928","19.5","18.4"
"Appling","2021-01-16","14","5559","5","933","20.1","19.4"
"Appling","2021-01-17","6","5565","0","933","16.2","18.1"
"Appling","2021-01-18","23","5588","5","938","17","17.5"
"Appling","2021-01-19","53","5641","5","943","16.7","16.4"
"Appling","2021-01-20","38","5679","6","949","15.7","16.6"
"Appling","2021-01-21","34","5713","5","954","15.7","17.2"
"Appling","2021-01-22","41","5754","9","963","17","18.3"
"Appling","2021-01-23","7","5761","3","966","18.1","19.1"
"Appling","2021-01-24","11","5772","2","968","20.7","18.5"
"Appling","2021-01-25","46","5818","5","973","19.1","18.1"
"Appling","2021-01-26","54","5872","11","984","20.7","18.7"
"Appling","2021-01-27","92","5964","18","1002","21.2","18.5"
"Appling","2021-01-28","33","5997","5","1007","21.3","18.5"
"Appling","2021-01-29","32","6029","4","1011","19.9","18.5"
"Appling","2021-01-30","10","6039","1","1012","15.2","16.7"
"Appling","2021-01-31","13","6052","4","1016","17","18.8"
"Appling","2021-02-01","30","6082","4","1020","17.4","18.2"
"Appling","2021-02-02","54","6136","11","1031","17.4","19"
"Appling","2021-02-03","29","6165","3","1034","16.1","18.6"
"Appling","2021-02-04","43","6208","7","1041","16.2","18.8"
"Appling","2021-02-05","25","6233","0","1041","14.4","17.2"
"Appling","2021-02-06","2","6235","1","1042","20.2","17.7"
"Appling","2021-02-07","1","6236","0","1042","15.8","16.4"
"Appling","2021-02-08","0","6236","0","1042","13.9","15.6"
"Atkinson","2020-02-01","0","0","0","0",".","."
"Atkinson","2020-02-02","0","0","0","0",".","."
"Atkinson","2020-02-03","0","0","0","0",".","."
"Atkinson","2020-02-04","0","0","0","0",".","."
"Atkinson","2020-02-05","0","0","0","0",".","."
"Atkinson","2020-02-06","0","0","0","0",".","."
"Atkinson","2020-02-07","0","0","0","0","0","."
"Atkinson","2020-02-08","0","0","0","0","0","."
"Atkinson","2020-02-09","0","0","0","0","0","."
"Atkinson","2020-02-10","0","0","0","0","0","."
"Atkinson","2020-02-11","0","0","0","0","0","."
"Atkinson","2020-02-12","0","0","0","0","0","."
"Atkinson","2020-02-13","0","0","0","0","0","."
"Atkinson","2020-02-14","0","0","0","0","0","0"
"Atkinson","2020-02-15","0","0","0","0","0","0"
"Atkinson","2020-02-16","0","0","0","0","0","0"
"Atkinson","2020-02-17","0","0","0","0","0","0"
"Atkinson","2020-02-18","0","0","0","0","0","0"
"Atkinson","2020-02-19","0","0","0","0","0","0"
"Atkinson","2020-02-20","0","0","0","0","0","0"
"Atkinson","2020-02-21","0","0","0","0","0","0"
"Atkinson","2020-02-22","0","0","0","0","0","0"
"Atkinson","2020-02-23","0","0","0","0","0","0"
"Atkinson","2020-02-24","0","0","0","0","0","0"
"Atkinson","2020-02-25","0","0","0","0","0","0"
"Atkinson","2020-02-26","0","0","0","0","0","0"
"Atkinson","2020-02-27","0","0","0","0","0","0"
"Atkinson","2020-02-28","0","0","0","0","0","0"
"Atkinson","2020-02-29","0","0","0","0","0","0"
"Atkinson","2020-03-01","0","0","0","0","0","0"
"Atkinson","2020-03-02","0","0","0","0","0","0"
"Atkinson","2020-03-03","0","0","0","0","0","0"
"Atkinson","2020-03-04","0","0","0","0","0","0"
"Atkinson","2020-03-05","0","0","0","0","0","0"
"Atkinson","2020-03-06","0","0","0","0","0","0"
"Atkinson","2020-03-07","0","0","0","0","0","0"
"Atkinson","2020-03-08","0","0","0","0","0","0"
"Atkinson","2020-03-09","0","0","0","0","0","0"
"Atkinson","2020-03-10","0","0","0","0","0","0"
"Atkinson","2020-03-11","0","0","0","0","0","0"
"Atkinson","2020-03-12","0","0","0","0","0","0"
"Atkinson","2020-03-13","0","0","0","0","0","0"
"Atkinson","2020-03-14","0","0","0","0","0","0"
"Atkinson","2020-03-15","0","0","0","0","0","0"
"Atkinson","2020-03-16","0","0","0","0","0","0"
"Atkinson","2020-03-17","0","0","0","0","0","0"
"Atkinson","2020-03-18","0","0","0","0","0","0"
"Atkinson","2020-03-19","0","0","0","0","0","0"
"Atkinson","2020-03-20","0","0","0","0","0","0"
"Atkinson","2020-03-21","0","0","0","0","0","0"
"Atkinson","2020-03-22","0","0","0","0","0","0"
"Atkinson","2020-03-23","1","1","0","0","0","0"
"Atkinson","2020-03-24","4","5","0","0","0","0"
"Atkinson","2020-03-25","5","10","0","0","0","0"
"Atkinson","2020-03-26","1","11","0","0","0","0"
"Atkinson","2020-03-27","1","12","0","0","0","0"
"Atkinson","2020-03-28","0","12","0","0","0","0"
"Atkinson","2020-03-29","0","12","0","0","0","0"
"Atkinson","2020-03-30","1","13","0","0","0","0"
"Atkinson","2020-03-31","3","16","0","0","0","0"
"Atkinson","2020-04-01","0","16","0","0","0","0"
"Atkinson","2020-04-02","3","19","0","0","0","0"
"Atkinson","2020-04-03","4","23","1","1","3.6","1.8"
"Atkinson","2020-04-04","0","23","0","1","3.6","1.8"
"Atkinson","2020-04-05","0","23","0","1","3.6","1.8"
"Atkinson","2020-04-06","6","29","0","1","3.6","1.8"
"Atkinson","2020-04-07","4","33","0","1","3.6","1.8"
"Atkinson","2020-04-08","4","37","0","1","3.6","1.8"
"Atkinson","2020-04-09","2","39","0","1","3.6","1.8"
"Atkinson","2020-04-10","0","39","0","1","0","1.8"
"Atkinson","2020-04-11","0","39","0","1","0","1.8"
"Atkinson","2020-04-12","0","39","0","1","0","1.8"
"Atkinson","2020-04-13","2","41","0","1","0","1.8"
"Atkinson","2020-04-14","1","42","0","1","0","1.8"
"Atkinson","2020-04-15","3","45","0","1","0","1.8"
"Atkinson","2020-04-16","3","48","0","1","0","1.8"
"Atkinson","2020-04-17","0","48","0","1","0","0"
"Atkinson","2020-04-18","0","48","0","1","0","0"
"Atkinson","2020-04-19","0","48","0","1","0","0"
"Atkinson","2020-04-20","0","48","0","1","0","0"
"Atkinson","2020-04-21","2","50","2","3","14.3","7.1"
"Atkinson","2020-04-22","0","50","0","3","14.3","7.1"
"Atkinson","2020-04-23","4","54","1","4","17.9","8.9"
"Atkinson","2020-04-24","0","54","0","4","17.9","8.9"
"Atkinson","2020-04-25","0","54","0","4","17.9","8.9"
"Atkinson","2020-04-26","0","54","0","4","17.9","8.9"
"Atkinson","2020-04-27","1","55","0","4","17.9","8.9"
"Atkinson","2020-04-28","3","58","0","4","3.6","8.9"
"Atkinson","2020-04-29","2","60","0","4","3.6","8.9"
"Atkinson","2020-04-30","6","66","1","5","2.4","10.1"
"Atkinson","2020-05-01","0","66","0","5","2.4","10.1"
"Atkinson","2020-05-02","1","67","0","5","2.4","10.1"
"Atkinson","2020-05-03","0","67","0","5","2.4","10.1"
"Atkinson","2020-05-04","6","73","4","9","11.9","14.9"
"Atkinson","2020-05-05","4","77","1","10","15.5","9.5"
"Atkinson","2020-05-06","2","79","0","10","15.5","9.5"
"Atkinson","2020-05-07","3","82","0","10","13.1","7.7"
"Atkinson","2020-05-08","0","82","0","10","13.1","7.7"
"Atkinson","2020-05-09","0","82","0","10","13.1","7.7"
"Atkinson","2020-05-10","0","82","0","10","13.1","7.7"
"Atkinson","2020-05-11","3","85","0","10","3.6","7.7"
"Atkinson","2020-05-12","3","88","0","10","0","7.7"
"Atkinson","2020-05-13","0","88","0","10","0","7.7"
"Atkinson","2020-05-14","3","91","0","10","0","6.5"
"Atkinson","2020-05-15","3","94","0","10","0","6.5"
"Atkinson","2020-05-16","1","95","0","10","0","6.5"
"Atkinson","2020-05-17","2","97","0","10","0","6.5"
"Atkinson","2020-05-18","4","101","0","10","0","1.8"
"Atkinson","2020-05-19","3","104","3","13","14.3","7.1"
"Atkinson","2020-05-20","3","107","1","14","19","9.5"
"Atkinson","2020-05-21","11","118","0","14","19","9.5"
"Atkinson","2020-05-22","20","138","2","16","20.5","10.2"
"Atkinson","2020-05-23","10","148","1","17","21.9","11"
"Atkinson","2020-05-24","1","149","1","18","36.2","18.1"
"Atkinson","2020-05-25","1","150","1","19","50.5","25.2"
"Atkinson","2020-05-26","8","158","0","19","36.2","25.2"
"Atkinson","2020-05-27","0","158","0","19","31.4","25.2"
"Atkinson","2020-05-28","0","158","0","19","31.4","25.2"
"Atkinson","2020-05-29","2","160","1","20","37.1","28.8"
"Atkinson","2020-05-30","2","162","0","20","35.7","28.8"
"Atkinson","2020-05-31","1","163","0","20","21.4","28.8"
"Atkinson","2020-06-01","4","167","2","22","14.3","32.4"
"Atkinson","2020-06-02","1","168","0","22","14.3","25.2"
"Atkinson","2020-06-03","2","170","0","22","14.3","22.9"
"Atkinson","2020-06-04","4","174","1","23","17.9","24.6"
"Atkinson","2020-06-05","8","182","1","24","12.5","24.8"
"Atkinson","2020-06-06","1","183","0","24","12.5","24.1"
"Atkinson","2020-06-07","0","183","0","24","12.5","17"
"Atkinson","2020-06-08","7","190","1","25","7.4","10.8"
"Atkinson","2020-06-09","3","193","0","25","7.4","10.8"
"Atkinson","2020-06-10","3","196","1","26","12.2","13.2"
"Atkinson","2020-06-11","31","227","1","27","9","13.5"
"Atkinson","2020-06-12","2","229","0","27","7.3","9.9"
"Atkinson","2020-06-13","0","229","0","27","7.3","9.9"
"Atkinson","2020-06-14","0","229","0","27","7.3","9.9"
"Atkinson","2020-06-15","4","233","0","27","5.2","6.3"
"Atkinson","2020-06-16","7","240","1","28","7.3","7.3"
"Atkinson","2020-06-17","1","241","0","28","2.5","7.3"
"Atkinson","2020-06-18","6","247","2","30","6.8","7.9"
"Atkinson","2020-06-19","9","256","3","33","11.6","9.4"
"Atkinson","2020-06-20","1","257","0","33","11.6","9.4"
"Atkinson","2020-06-21","0","257","0","33","11.6","9.4"
"Atkinson","2020-06-22","5","262","2","35","17.3","11.3"
"Atkinson","2020-06-23","9","271","4","39","21.6","14.4"
"Atkinson","2020-06-24","4","275","2","41","28.7","15.6"
"Atkinson","2020-06-25","7","282","3","44","30.1","18.4"
"Atkinson","2020-06-26","5","287","1","45","28.2","19.9"
"Atkinson","2020-06-27","2","289","0","45","28.2","19.9"
"Atkinson","2020-06-28","0","289","0","45","28.2","19.9"
"Atkinson","2020-06-29","9","298","1","46","24.1","20.7"
"Atkinson","2020-06-30","9","307","3","49","22.5","22"
"Atkinson","2020-07-01","4","311","0","49","15.3","22"
"Atkinson","2020-07-02","10","321","1","50","10.6","20.4"
"Atkinson","2020-07-03","2","323","0","50","7.8","18"
"Atkinson","2020-07-04","4","327","2","52","14.9","21.6"
"Atkinson","2020-07-05","2","329","1","53","22.1","25.1"
"Atkinson","2020-07-06","8","337","0","53","20.5","22.3"
"Atkinson","2020-07-07","5","342","3","56","24.3","23.4"
"Atkinson","2020-07-08","3","345","3","59","38.6","27"
"Atkinson","2020-07-09","7","352","0","59","37.1","23.9"
"Atkinson","2020-07-10","4","356","2","61","44.3","26"
"Atkinson","2020-07-11","5","361","1","62","40","27.5"
"Atkinson","2020-07-12","5","366","1","63","35.7","28.9"
"Atkinson","2020-07-13","5","371","3","66","44.3","32.4"
"Atkinson","2020-07-14","4","375","1","67","39.3","31.8"
"Atkinson","2020-07-15","2","377","0","67","25","31.8"
"Atkinson","2020-07-16","9","386","0","67","25","31.1"
"Atkinson","2020-07-17","30","416","6","73","20.7","32.5"
"Atkinson","2020-07-18","0","416","0","73","17.9","28.9"
"Atkinson","2020-07-19","0","416","0","73","15","25.4"
"Atkinson","2020-07-20","2","418","0","73","6.4","25.4"
"Atkinson","2020-07-21","8","426","2","75","6.4","22.9"
"Atkinson","2020-07-22","5","431","0","75","6.4","15.7"
"Atkinson","2020-07-23","5","436","0","75","6.4","15.7"
"Atkinson","2020-07-24","2","438","0","75","3.6","12.1"
"Atkinson","2020-07-25","1","439","0","75","3.6","10.7"
"Atkinson","2020-07-26","0","439","0","75","3.6","9.3"
"Atkinson","2020-07-27","2","441","0","75","3.6","5"
"Atkinson","2020-07-28","3","444","0","75","0","3.2"
"Atkinson","2020-07-29","9","453","0","75","0","3.2"
"Atkinson","2020-07-30","4","457","2","77","7.1","6.8"
"Atkinson","2020-07-31","2","459","1","78","14.3","8.9"
"Atkinson","2020-08-01","1","460","0","78","14.3","8.9"
"Atkinson","2020-08-02","2","462","1","79","21.4","12.5"
"Atkinson","2020-08-03","6","468","5","84","33.3","18.5"
"Atkinson","2020-08-04","5","473","1","85","36.2","18.1"
"Atkinson","2020-08-05","4","477","0","85","36.2","18.1"
"Atkinson","2020-08-06","2","479","1","86","36.2","21.7"
"Atkinson","2020-08-07","2","481","0","86","29","21.7"
"Atkinson","2020-08-08","3","484","2","88","38.6","26.4"
"Atkinson","2020-08-09","0","484","0","88","31.4","26.4"
"Atkinson","2020-08-10","2","486","0","88","19.5","26.4"
"Atkinson","2020-08-11","7","493","0","88","16.7","26.4"
"Atkinson","2020-08-12","5","498","0","88","16.7","26.4"
"Atkinson","2020-08-13","8","506","1","89","11.3","23.8"
"Atkinson","2020-08-14","2","508","0","89","11.3","20.2"
"Atkinson","2020-08-15","1","509","0","89","1.8","20.2"
"Atkinson","2020-08-16","1","510","0","89","1.8","16.6"
"Atkinson","2020-08-17","3","513","0","89","1.8","10.7"
"Atkinson","2020-08-18","4","517","1","90","5.4","11"
"Atkinson","2020-08-19","4","521","0","90","5.4","11"
"Atkinson","2020-08-20","2","523","1","91","10.7","11"
"Atkinson","2020-08-21","9","532","0","91","10.7","11"
"Atkinson","2020-08-22","1","533","0","91","10.7","6.3"
"Atkinson","2020-08-23","3","536","1","92","15.5","8.6"
"Atkinson","2020-08-24","11","547","0","92","15.5","8.6"
"Atkinson","2020-08-25","9","556","0","92","11.9","8.6"
"Atkinson","2020-08-26","9","565","1","93","13.5","9.4"
"Atkinson","2020-08-27","8","573","2","95","9.9","10.3"
"Atkinson","2020-08-28","3","576","0","95","9.9","10.3"
"Atkinson","2020-08-29","1","577","0","95","9.9","10.3"
"Atkinson","2020-08-30","0","577","0","95","5.2","10.3"
"Atkinson","2020-08-31","6","583","0","95","5.2","10.3"
"Atkinson","2020-09-01","5","588","0","95","5.2","8.5"
"Atkinson","2020-09-02","26","614","0","95","3.6","8.5"
"Atkinson","2020-09-03","3","617","1","96","4.8","7.3"
"Atkinson","2020-09-04","2","619","1","97","11.9","10.9"
"Atkinson","2020-09-05","2","621","0","97","11.9","10.9"
"Atkinson","2020-09-06","1","622","1","98","26.2","15.7"
"Atkinson","2020-09-07","1","623","0","98","26.2","15.7"
"Atkinson","2020-09-08","7","630","2","100","30.3","17.7"
"Atkinson","2020-09-09","12","642","1","101","31.5","17.5"
"Atkinson","2020-09-10","8","650","0","101","26.7","15.7"
"Atkinson","2020-09-11","5","655","0","101","19.6","15.7"
"Atkinson","2020-09-12","3","658","1","102","24.3","18.1"
"Atkinson","2020-09-13","1","659","1","103","24.3","25.3"
"Atkinson","2020-09-14","7","666","0","103","24.3","25.3"
"Atkinson","2020-09-15","6","672","0","103","20.2","25.3"
"Atkinson","2020-09-16","2","674","0","103","19","25.3"
"Atkinson","2020-09-17","4","678","0","103","19","22.9"
"Atkinson","2020-09-18","2","680","0","103","19","19.3"
"Atkinson","2020-09-19","2","682","1","104","21.4","22.9"
"Atkinson","2020-09-20","1","683","0","104","7.1","15.7"
"Atkinson","2020-09-21","2","685","0","104","7.1","15.7"
"Atkinson","2020-09-22","5","690","0","104","7.1","13.7"
"Atkinson","2020-09-23","11","701","0","104","7.1","13.1"
"Atkinson","2020-09-24","6","707","0","104","7.1","13.1"
"Atkinson","2020-09-25","2","709","0","104","7.1","13.1"
"Atkinson","2020-09-26","1","710","0","104","0","10.7"
"Atkinson","2020-09-27","0","710","0","104","0","3.6"
"Atkinson","2020-09-28","7","717","0","104","0","3.6"
"Atkinson","2020-09-29","1","718","0","104","0","3.6"
"Atkinson","2020-09-30","9","727","0","104","0","3.6"
"Atkinson","2020-10-01","8","735","2","106","3.6","5.4"
"Atkinson","2020-10-02","4","739","0","106","3.6","5.4"
"Atkinson","2020-10-03","4","743","1","107","7.1","3.6"
"Atkinson","2020-10-04","1","744","0","107","7.1","3.6"
"Atkinson","2020-10-05","7","751","0","107","7.1","3.6"
"Atkinson","2020-10-06","8","759","1","108","8.9","4.5"
"Atkinson","2020-10-07","9","768","1","109","10.5","5.3"
"Atkinson","2020-10-08","2","770","0","109","6.9","5.3"
"Atkinson","2020-10-09","5","775","0","109","6.9","5.3"
"Atkinson","2020-10-10","1","776","1","110","17.7","12.4"
"Atkinson","2020-10-11","2","778","0","110","17.7","12.4"
"Atkinson","2020-10-12","6","784","0","110","17.7","12.4"
"Atkinson","2020-10-13","4","788","0","110","15.9","12.4"
"Atkinson","2020-10-14","5","793","2","112","20","15.3"
"Atkinson","2020-10-15","3","796","0","112","20","13.5"
"Atkinson","2020-10-16","2","798","0","112","20","13.5"
"Atkinson","2020-10-17","0","798","0","112","5.7","11.7"
"Atkinson","2020-10-18","2","800","0","112","5.7","11.7"
"Atkinson","2020-10-19","5","805","0","112","5.7","11.7"
"Atkinson","2020-10-20","5","810","0","112","5.7","10.8"
"Atkinson","2020-10-21","13","823","1","113","1.1","10.5"
"Atkinson","2020-10-22","5","828","1","114","4","12"
"Atkinson","2020-10-23","4","832","0","114","4","12"
"Atkinson","2020-10-24","2","834","0","114","4","4.8"
"Atkinson","2020-10-25","1","835","0","114","4","4.8"
"Atkinson","2020-10-26","10","845","1","115","5.4","5.5"
"Atkinson","2020-10-27","2","847","0","115","5.4","5.5"
"Atkinson","2020-10-28","8","855","2","117","7.9","4.5"
"Atkinson","2020-10-29","4","859","0","117","5","4.5"
"Atkinson","2020-10-30","2","861","0","117","5","4.5"
"Atkinson","2020-10-31","0","861","0","117","5","4.5"
"Atkinson","2020-11-01","0","861","0","117","5","4.5"
"Atkinson","2020-11-02","2","863","0","117","3.6","4.5"
"Atkinson","2020-11-03","4","867","0","117","3.6","4.5"
"Atkinson","2020-11-04","7","874","1","118","2","4.9"
"Atkinson","2020-11-05","0","874","0","118","2","3.5"
"Atkinson","2020-11-06","6","880","0","118","2","3.5"
"Atkinson","2020-11-07","1","881","0","118","2","3.5"
"Atkinson","2020-11-08","2","883","1","119","9.2","7.1"
"Atkinson","2020-11-09","3","886","0","119","9.2","6.4"
"Atkinson","2020-11-10","8","894","0","119","9.2","6.4"
"Atkinson","2020-11-11","5","899","0","119","7.1","4.6"
"Atkinson","2020-11-12","4","903","0","119","7.1","4.6"
"Atkinson","2020-11-13","4","907","0","119","7.1","4.6"
"Atkinson","2020-11-14","3","910","1","120","11.9","7"
"Atkinson","2020-11-15","2","912","1","121","11.9","10.5"
"Atkinson","2020-11-16","11","923","2","123","14.5","11.8"
"Atkinson","2020-11-17","2","925","0","123","14.5","11.8"
"Atkinson","2020-11-18","16","941","3","126","17.2","12.2"
"Atkinson","2020-11-19","4","945","0","126","17.2","12.2"
"Atkinson","2020-11-20","2","947","0","126","17.2","12.2"
"Atkinson","2020-11-21","0","947","0","126","12.4","12.2"
"Atkinson","2020-11-22","2","949","2","128","19.6","15.7"
"Atkinson","2020-11-23","3","952","1","129","21.7","18.1"
"Atkinson","2020-11-24","5","957","0","129","21.7","18.1"
"Atkinson","2020-11-25","9","966","2","131","22.2","19.7"
"Atkinson","2020-11-26","0","966","0","131","22.2","19.7"
"Atkinson","2020-11-27","2","968","1","132","29.4","23.3"
"Atkinson","2020-11-28","2","970","1","133","36.5","24.5"
"Atkinson","2020-11-29","7","977","2","135","26.3","22.9"
"Atkinson","2020-11-30","4","981","0","135","21.5","21.6"
"Atkinson","2020-12-01","3","984","0","135","21.5","21.6"
"Atkinson","2020-12-02","20","1004","3","138","20.5","21.4"
"Atkinson","2020-12-03","6","1010","1","139","22.9","22.6"
"Atkinson","2020-12-04","4","1014","0","139","15.7","22.6"
"Atkinson","2020-12-05","5","1019","2","141","14.3","25.4"
"Atkinson","2020-12-06","3","1022","0","141","10.2","18.3"
"Atkinson","2020-12-07","11","1033","1","142","11.5","16.5"
"Atkinson","2020-12-08","3","1036","2","144","21.1","21.3"
"Atkinson","2020-12-09","31","1067","7","151","22.1","21.3"
"Atkinson","2020-12-10","3","1070","0","151","19.8","21.3"
"Atkinson","2020-12-11","10","1080","3","154","24","19.9"
"Atkinson","2020-12-12","2","1082","0","154","18.3","16.3"
"Atkinson","2020-12-13","1","1083","0","154","18.3","14.3"
"Atkinson","2020-12-14","7","1090","1","155","19.1","15.3"
"Atkinson","2020-12-15","6","1096","2","157","14.3","17.7"
"Atkinson","2020-12-16","35","1131","8","165","14.4","18.2"
"Atkinson","2020-12-17","4","1135","1","166","17.9","18.8"
"Atkinson","2020-12-18","3","1138","1","167","18.4","21.2"
"Atkinson","2020-12-19","3","1141","2","169","27.9","23.1"
"Atkinson","2020-12-20","2","1143","2","171","42.2","30.3"
"Atkinson","2020-12-21","11","1154","6","177","48","33.5"
"Atkinson","2020-12-22","5","1159","2","179","48.9","31.6"
"Atkinson","2020-12-23","30","1189","11","190","50.9","32.6"
"Atkinson","2020-12-24","10","1199","8","198","58.7","38.3"
"Atkinson","2020-12-25","0","1199","0","198","54","36.2"
"Atkinson","2020-12-26","2","1201","2","200","58.7","43.3"
"Atkinson","2020-12-27","0","1201","0","200","44.5","43.3"
"Atkinson","2020-12-28","7","1208","1","201","38.7","43.3"
"Atkinson","2020-12-29","6","1214","1","202","35.4","42.1"
"Atkinson","2020-12-30","33","1247","7","209","33.2","42"
"Atkinson","2020-12-31","12","1259","3","212","25.3","42"
"Atkinson","2021-01-01","0","1259","0","212","25.3","39.6"
"Atkinson","2021-01-02","3","1262","2","214","20.5","39.6"
"Atkinson","2021-01-03","1","1263","1","215","34.8","39.6"
"Atkinson","2021-01-04","20","1283","8","223","38.5","38.6"
"Atkinson","2021-01-05","18","1301","4","227","39.3","37.3"
"Atkinson","2021-01-06","41","1342","7","234","38.7","35.9"
"Atkinson","2021-01-07","22","1364","2","236","36.4","30.9"
"Atkinson","2021-01-08","11","1375","0","236","36.4","30.9"
"Atkinson","2021-01-09","2","1377","0","236","26.9","23.7"
"Atkinson","2021-01-10","6","1383","3","239","19.8","27.3"
"Atkinson","2021-01-11","8","1391","3","242","19.4","29"
"Atkinson","2021-01-12","28","1419","3","245","17.8","28.5"
"Atkinson","2021-01-13","9","1428","4","249","21.7","30.2"
"Atkinson","2021-01-14","11","1439","1","250","21.7","29.1"
"Atkinson","2021-01-15","9","1448","2","252","24.9","30.6"
"Atkinson","2021-01-16","4","1452","3","255","35.6","31.2"
"Atkinson","2021-01-17","0","1452","0","255","28.4","24.1"
"Atkinson","2021-01-18","3","1455","0","255","23.1","21.2"
"Atkinson","2021-01-19","25","1480","4","259","23.8","20.8"
"Atkinson","2021-01-20","15","1495","3","262","20.3","21"
"Atkinson","2021-01-21","18","1513","1","263","19.8","20.8"
"Atkinson","2021-01-22","7","1520","1","264","18.7","21.8"
"Atkinson","2021-01-23","3","1523","0","264","8","21.8"
"Atkinson","2021-01-24","0","1523","0","264","8","18.2"
"Atkinson","2021-01-25","15","1538","4","268","11.8","17.4"
"Atkinson","2021-01-26","25","1563","2","270","10.6","17.2"
"Atkinson","2021-01-27","4","1567","1","271","11.4","15.8"
"Atkinson","2021-01-28","13","1580","0","271","10.6","15.2"
"Atkinson","2021-01-29","10","1590","2","273","11.4","15"
"Atkinson","2021-01-30","4","1594","0","273","11.4","9.7"
"Atkinson","2021-01-31","2","1596","0","273","11.4","9.7"
"Atkinson","2021-02-01","21","1617","1","274","8.3","10"
"Atkinson","2021-02-02","9","1626","1","275","8.7","9.7"
"Atkinson","2021-02-03","9","1635","1","276","6.7","9"
"Atkinson","2021-02-04","10","1645","1","277","8.1","9.4"
"Atkinson","2021-02-05","3","1648","0","277","5.3","8.3"
"Atkinson","2021-02-06","0","1648","0","277","5.3","8.3"
"Atkinson","2021-02-07","0","1648","0","277","5.3","8.3"
"Atkinson","2021-02-08","0","1648","0","277","4.6","6.4"
"Bacon","2020-02-01","0","0","0","0",".","."
"Bacon","2020-02-02","0","0","0","0",".","."
"Bacon","2020-02-03","0","0","0","0",".","."
"Bacon","2020-02-04","0","0","0","0",".","."
"Bacon","2020-02-05","0","0","0","0",".","."
"Bacon","2020-02-06","0","0","0","0",".","."
"Bacon","2020-02-07","0","0","0","0","0","."
"Bacon","2020-02-08","0","0","0","0","0","."
"Bacon","2020-02-09","0","0","0","0","0","."
"Bacon","2020-02-10","0","0","0","0","0","."
"Bacon","2020-02-11","0","0","0","0","0","."
"Bacon","2020-02-12","0","0","0","0","0","."
"Bacon","2020-02-13","0","0","0","0","0","."
"Bacon","2020-02-14","0","0","0","0","0","0"
"Bacon","2020-02-15","0","0","0","0","0","0"
"Bacon","2020-02-16","0","0","0","0","0","0"
"Bacon","2020-02-17","0","0","0","0","0","0"
"Bacon","2020-02-18","0","0","0","0","0","0"
"Bacon","2020-02-19","0","0","0","0","0","0"
"Bacon","2020-02-20","0","0","0","0","0","0"
"Bacon","2020-02-21","0","0","0","0","0","0"
"Bacon","2020-02-22","0","0","0","0","0","0"
"Bacon","2020-02-23","0","0","0","0","0","0"
"Bacon","2020-02-24","0","0","0","0","0","0"
"Bacon","2020-02-25","0","0","0","0","0","0"
"Bacon","2020-02-26","0","0","0","0","0","0"
"Bacon","2020-02-27","0","0","0","0","0","0"
"Bacon","2020-02-28","0","0","0","0","0","0"
"Bacon","2020-02-29","0","0","0","0","0","0"
"Bacon","2020-03-01","0","0","0","0","0","0"
"Bacon","2020-03-02","0","0","0","0","0","0"
"Bacon","2020-03-03","0","0","0","0","0","0"
"Bacon","2020-03-04","0","0","0","0","0","0"
"Bacon","2020-03-05","0","0","0","0","0","0"
"Bacon","2020-03-06","0","0","0","0","0","0"
"Bacon","2020-03-07","0","0","0","0","0","0"
"Bacon","2020-03-08","0","0","0","0","0","0"
"Bacon","2020-03-09","0","0","0","0","0","0"
"Bacon","2020-03-10","0","0","0","0","0","0"
"Bacon","2020-03-11","0","0","0","0","0","0"
"Bacon","2020-03-12","1","1","0","0","0","0"
"Bacon","2020-03-13","0","1","0","0","0","0"
"Bacon","2020-03-14","0","1","0","0","0","0"
"Bacon","2020-03-15","0","1","0","0","0","0"
"Bacon","2020-03-16","1","2","0","0","0","0"
"Bacon","2020-03-17","1","3","0","0","0","0"
"Bacon","2020-03-18","1","4","0","0","0","0"
"Bacon","2020-03-19","3","7","1","1","4.8","2.4"
"Bacon","2020-03-20","2","9","1","2","11.9","6"
"Bacon","2020-03-21","0","9","0","2","11.9","6"
"Bacon","2020-03-22","0","9","0","2","11.9","6"
"Bacon","2020-03-23","0","9","0","2","11.9","6"
"Bacon","2020-03-24","0","9","0","2","11.9","6"
"Bacon","2020-03-25","4","13","0","2","11.9","6"
"Bacon","2020-03-26","1","14","0","2","7.1","6"
"Bacon","2020-03-27","4","18","1","3","3.6","7.7"
"Bacon","2020-03-28","1","19","1","4","17.9","14.9"
"Bacon","2020-03-29","0","19","0","4","17.9","14.9"
"Bacon","2020-03-30","0","19","0","4","17.9","14.9"
"Bacon","2020-03-31","6","25","2","6","22.6","17.3"
"Bacon","2020-04-01","4","29","2","8","29.8","20.8"
"Bacon","2020-04-02","2","31","0","8","29.8","18.5"
"Bacon","2020-04-03","2","33","0","8","26.2","14.9"
"Bacon","2020-04-04","0","33","0","8","11.9","14.9"
"Bacon","2020-04-05","0","33","0","8","11.9","14.9"
"Bacon","2020-04-06","1","34","0","8","11.9","14.9"
"Bacon","2020-04-07","3","37","0","8","7.1","14.9"
"Bacon","2020-04-08","0","37","0","8","0","14.9"
"Bacon","2020-04-09","0","37","0","8","0","14.9"
"Bacon","2020-04-10","1","38","0","8","0","13.1"
"Bacon","2020-04-11","0","38","0","8","0","6"
"Bacon","2020-04-12","0","38","0","8","0","6"
"Bacon","2020-04-13","1","39","0","8","0","6"
"Bacon","2020-04-14","1","40","0","8","0","3.6"
"Bacon","2020-04-15","2","42","0","8","0","0"
"Bacon","2020-04-16","0","42","0","8","0","0"
"Bacon","2020-04-17","6","48","0","8","0","0"
"Bacon","2020-04-18","0","48","0","8","0","0"
"Bacon","2020-04-19","0","48","0","8","0","0"
"Bacon","2020-04-20","0","48","0","8","0","0"
"Bacon","2020-04-21","1","49","0","8","0","0"
"Bacon","2020-04-22","1","50","0","8","0","0"
"Bacon","2020-04-23","4","54","0","8","0","0"
"Bacon","2020-04-24","2","56","0","8","0","0"
"Bacon","2020-04-25","1","57","0","8","0","0"
"Bacon","2020-04-26","0","57","0","8","0","0"
"Bacon","2020-04-27","1","58","0","8","0","0"
"Bacon","2020-04-28","2","60","1","9","7.1","3.6"
"Bacon","2020-04-29","4","64","2","11","14.3","7.1"
"Bacon","2020-04-30","7","71","0","11","14.3","7.1"
"Bacon","2020-05-01","3","74","0","11","14.3","7.1"
"Bacon","2020-05-02","2","76","0","11","14.3","7.1"
"Bacon","2020-05-03","0","76","0","11","14.3","7.1"
"Bacon","2020-05-04","1","77","0","11","14.3","7.1"
"Bacon","2020-05-05","3","80","2","13","16.7","11.9"
"Bacon","2020-05-06","1","81","0","13","9.5","11.9"
"Bacon","2020-05-07","5","86","3","16","18.1","16.2"
"Bacon","2020-05-08","3","89","0","16","18.1","16.2"
"Bacon","2020-05-09","7","96","0","16","18.1","16.2"
"Bacon","2020-05-10","0","96","0","16","18.1","16.2"
"Bacon","2020-05-11","124","220","79","95","27.2","20.7"
"Bacon","2020-05-12","3","223","0","95","17.7","17.2"
"Bacon","2020-05-13","4","227","0","95","17.7","13.6"
"Bacon","2020-05-14","4","231","0","95","9.1","13.6"
"Bacon","2020-05-15","1","232","0","95","9.1","13.6"
"Bacon","2020-05-16","0","232","0","95","9.1","13.6"
"Bacon","2020-05-17","0","232","0","95","9.1","13.6"
"Bacon","2020-05-18","2","234","0","95","0","13.6"
"Bacon","2020-05-19","7","241","0","95","0","8.8"
"Bacon","2020-05-20","5","246","0","95","0","8.8"
"Bacon","2020-05-21","55","301","3","98","0.8","4.9"
"Bacon","2020-05-22","4","305","0","98","0.8","4.9"
"Bacon","2020-05-23","1","306","0","98","0.8","4.9"
"Bacon","2020-05-24","1","307","0","98","0.8","4.9"
"Bacon","2020-05-25","1","308","0","98","0.8","0.4"
"Bacon","2020-05-26","5","313","2","100","6.5","3.2"
"Bacon","2020-05-27","5","318","0","100","6.5","3.2"
"Bacon","2020-05-28","6","324","0","100","5.7","3.2"
"Bacon","2020-05-29","10","334","4","104","11.4","6.1"
"Bacon","2020-05-30","1","335","0","104","11.4","6.1"
"Bacon","2020-05-31","0","335","0","104","11.4","6.1"
"Bacon","2020-06-01","2","337","0","104","11.4","6.1"
"Bacon","2020-06-02","9","346","0","104","5.7","6.1"
"Bacon","2020-06-03","2","348","1","105","12.9","9.7"
"Bacon","2020-06-04","2","350","0","105","12.9","9.3"
"Bacon","2020-06-05","2","352","0","105","7.1","9.3"
"Bacon","2020-06-06","0","352","0","105","7.1","9.3"
"Bacon","2020-06-07","1","353","0","105","7.1","9.3"
"Bacon","2020-06-08","5","358","1","106","10","10.7"
"Bacon","2020-06-09","3","361","0","106","10","7.9"
"Bacon","2020-06-10","1","362","0","106","2.9","7.9"
"Bacon","2020-06-11","7","369","0","106","2.9","7.9"
"Bacon","2020-06-12","2","371","1","107","10","8.6"
"Bacon","2020-06-13","0","371","0","107","10","8.6"
"Bacon","2020-06-14","2","373","1","108","17.1","12.1"
"Bacon","2020-06-15","5","378","1","109","17.1","13.6"
"Bacon","2020-06-16","12","390","4","113","21.9","16"
"Bacon","2020-06-17","7","397","0","113","21.9","12.4"
"Bacon","2020-06-18","7","404","1","114","23.9","13.4"
"Bacon","2020-06-19","10","414","1","115","18.2","14.1"
"Bacon","2020-06-20","12","426","2","117","20.6","15.3"
"Bacon","2020-06-21","2","428","0","117","13.5","15.3"
"Bacon","2020-06-22","5","433","0","117","10.6","13.9"
"Bacon","2020-06-23","20","453","0","117","5.9","13.9"
"Bacon","2020-06-24","4","457","0","117","5.9","13.9"
"Bacon","2020-06-25","9","466","1","118","5.4","14.7"
"Bacon","2020-06-26","8","474","1","119","5.8","12"
"Bacon","2020-06-27","3","477","0","119","3.4","12"
"Bacon","2020-06-28","0","477","0","119","3.4","8.4"
"Bacon","2020-06-29","9","486","0","119","3.4","7"
"Bacon","2020-06-30","17","503","0","119","3.4","4.6"
"Bacon","2020-07-01","12","515","2","121","5.8","5.8"
"Bacon","2020-07-02","13","528","0","121","4.2","4.8"
"Bacon","2020-07-03","5","533","1","122","5.2","5.5"
"Bacon","2020-07-04","7","540","1","123","7.3","5.3"
"Bacon","2020-07-05","1","541","0","123","7.3","5.3"
"Bacon","2020-07-06","18","559","2","125","8.9","6.1"
"Bacon","2020-07-07","10","569","2","127","11.7","7.5"
"Bacon","2020-07-08","10","579","1","128","10.8","8.3"
"Bacon","2020-07-09","20","599","6","134","15.1","9.6"
"Bacon","2020-07-10","8","607","1","135","14","9.6"
"Bacon","2020-07-11","9","616","0","135","11.9","9.6"
"Bacon","2020-07-12","3","619","0","135","11.9","9.6"
"Bacon","2020-07-13","13","632","0","135","10.4","9.6"
"Bacon","2020-07-14","11","643","3","138","11.4","11.6"
"Bacon","2020-07-15","13","656","6","144","16.6","13.7"
"Bacon","2020-07-16","15","671","1","145","13.2","14.1"
"Bacon","2020-07-17","12","683","2","147","13.8","13.9"
"Bacon","2020-07-18","8","691","3","150","19.2","15.6"
"Bacon","2020-07-19","1","692","0","150","19.2","15.6"
"Bacon","2020-07-20","3","695","1","151","23.9","17.1"
"Bacon","2020-07-21","13","708","4","155","24.4","17.9"
"Bacon","2020-07-22","3","711","1","156","22.6","19.6"
"Bacon","2020-07-23","10","721","1","157","23.1","18.2"
"Bacon","2020-07-24","9","730","0","157","20.7","17.3"
"Bacon","2020-07-25","2","732","0","157","15.3","17.3"
"Bacon","2020-07-26","0","732","0","157","15.3","17.3"
"Bacon","2020-07-27","7","739","2","159","14.7","19.3"
"Bacon","2020-07-28","12","751","1","160","11.5","18"
"Bacon","2020-07-29","3","754","0","160","6.7","14.7"
"Bacon","2020-07-30","9","763","0","160","5.3","14.2"
"Bacon","2020-07-31","8","771","0","160","5.3","13"
"Bacon","2020-08-01","1","772","0","160","5.3","10.3"
"Bacon","2020-08-02","1","773","0","160","5.3","10.3"
"Bacon","2020-08-03","6","779","1","161","3.6","9.1"
"Bacon","2020-08-04","7","786","0","161","2.4","6.9"
"Bacon","2020-08-05","8","794","1","162","4.2","5.4"
"Bacon","2020-08-06","16","810","1","163","5.1","5.2"
"Bacon","2020-08-07","4","814","1","164","8.6","7"
"Bacon","2020-08-08","2","816","1","165","15.8","10.5"
"Bacon","2020-08-09","0","816","0","165","15.8","10.5"
"Bacon","2020-08-10","7","823","0","165","13.4","8.5"
"Bacon","2020-08-11","9","832","0","165","13.4","7.9"
"Bacon","2020-08-12","8","840","1","166","13.4","8.8"
"Bacon","2020-08-13","12","852","0","166","12.5","8.8"
"Bacon","2020-08-14","4","856","0","166","8.9","8.8"
"Bacon","2020-08-15","4","860","0","166","1.8","8.8"
"Bacon","2020-08-16","0","860","0","166","1.8","8.8"
"Bacon","2020-08-17","8","868","0","166","1.8","7.6"
"Bacon","2020-08-18","12","880","2","168","4.2","8.8"
"Bacon","2020-08-19","12","892","2","170","4.8","9.1"
"Bacon","2020-08-20","8","900","2","172","8.3","10.4"
"Bacon","2020-08-21","9","909","0","172","8.3","8.6"
"Bacon","2020-08-22","2","911","0","172","8.3","5.1"
"Bacon","2020-08-23","0","911","0","172","8.3","5.1"
"Bacon","2020-08-24","14","925","1","173","9.4","5.6"
"Bacon","2020-08-25","23","948","4","177","9.5","6.8"
"Bacon","2020-08-26","10","958","0","177","7.1","5.9"
"Bacon","2020-08-27","5","963","0","177","3.5","5.9"
"Bacon","2020-08-28","28","991","0","177","3.5","5.9"
"Bacon","2020-08-29","10","1001","0","177","3.5","5.9"
"Bacon","2020-08-30","1","1002","0","177","3.5","5.9"
"Bacon","2020-08-31","10","1012","0","177","2.5","5.9"
"Bacon","2020-09-01","14","1026","1","178","1","5.2"
"Bacon","2020-09-02","24","1050","1","179","1.6","4.3"
"Bacon","2020-09-03","9","1059","2","181","4.8","4.1"
"Bacon","2020-09-04","18","1077","0","181","4.8","4.1"
"Bacon","2020-09-05","1","1078","0","181","4.8","4.1"
"Bacon","2020-09-06","3","1081","1","182","9.6","6.5"
"Bacon","2020-09-07","1","1082","0","182","9.6","6"
"Bacon","2020-09-08","14","1096","3","185","11.6","6.3"
"Bacon","2020-09-09","11","1107","1","186","12.3","7"
"Bacon","2020-09-10","15","1122","2","188","11","7.9"
"Bacon","2020-09-11","8","1130","1","189","12.8","8.8"
"Bacon","2020-09-12","3","1133","1","190","17.6","11.2"
"Bacon","2020-09-13","1","1134","0","190","12.8","11.2"
"Bacon","2020-09-14","9","1143","2","192","16","12.8"
"Bacon","2020-09-15","14","1157","0","192","12.9","12.3"
"Bacon","2020-09-16","6","1163","2","194","16.4","14.3"
"Bacon","2020-09-17","11","1174","1","195","15.8","13.4"
"Bacon","2020-09-18","2","1176","0","195","14","13.4"
"Bacon","2020-09-19","1","1177","0","195","9.2","13.4"
"Bacon","2020-09-20","0","1177","0","195","9.2","11"
"Bacon","2020-09-21","5","1182","0","195","6.1","11"
"Bacon","2020-09-22","9","1191","0","195","6.1","9.5"
"Bacon","2020-09-23","9","1200","1","196","2.9","9.6"
"Bacon","2020-09-24","7","1207","0","196","1.6","8.7"
"Bacon","2020-09-25","10","1217","1","197","3","8.5"
"Bacon","2020-09-26","2","1219","1","198","10.2","9.7"
"Bacon","2020-09-27","2","1221","0","198","10.2","9.7"
"Bacon","2020-09-28","15","1236","1","199","11.1","8.6"
"Bacon","2020-09-29","9","1245","1","200","12.7","9.4"
"Bacon","2020-09-30","13","1258","0","200","11.1","7"
"Bacon","2020-10-01","12","1270","0","200","11.1","6.3"
"Bacon","2020-10-02","5","1275","0","200","9.7","6.3"
"Bacon","2020-10-03","2","1277","0","200","2.5","6.3"
"Bacon","2020-10-04","3","1280","0","200","2.5","6.3"
"Bacon","2020-10-05","12","1292","1","201","2.8","6.9"
"Bacon","2020-10-06","10","1302","0","201","1.2","6.9"
"Bacon","2020-10-07","14","1316","0","201","1.2","6.2"
"Bacon","2020-10-08","9","1325","1","202","2.8","6.9"
"Bacon","2020-10-09","9","1334","0","202","2.8","6.2"
"Bacon","2020-10-10","2","1336","0","202","2.8","2.7"
"Bacon","2020-10-11","2","1338","0","202","2.8","2.7"
"Bacon","2020-10-12","5","1343","0","202","1.6","2.2"
"Bacon","2020-10-13","9","1352","0","202","1.6","1.4"
"Bacon","2020-10-14","10","1362","0","202","1.6","1.4"
"Bacon","2020-10-15","6","1368","0","202","0","1.4"
"Bacon","2020-10-16","3","1371","0","202","0","1.4"
"Bacon","2020-10-17","0","1371","0","202","0","1.4"
"Bacon","2020-10-18","1","1372","0","202","0","1.4"
"Bacon","2020-10-19","2","1374","0","202","0","0.8"
"Bacon","2020-10-20","10","1384","0","202","0","0.8"
"Bacon","2020-10-21","8","1392","0","202","0","0.8"
"Bacon","2020-10-22","6","1398","0","202","0","0"
"Bacon","2020-10-23","3","1401","0","202","0","0"
"Bacon","2020-10-24","1","1402","1","203","14.3","7.1"
"Bacon","2020-10-25","0","1402","0","203","14.3","7.1"
"Bacon","2020-10-26","6","1408","0","203","14.3","7.1"
"Bacon","2020-10-27","7","1415","0","203","14.3","7.1"
"Bacon","2020-10-28","6","1421","0","203","14.3","7.1"
"Bacon","2020-10-29","12","1433","0","203","14.3","7.1"
"Bacon","2020-10-30","3","1436","0","203","14.3","7.1"
"Bacon","2020-10-31","3","1439","0","203","0","7.1"
"Bacon","2020-11-01","0","1439","0","203","0","7.1"
"Bacon","2020-11-02","9","1448","0","203","0","7.1"
"Bacon","2020-11-03","8","1456","1","204","1.8","8"
"Bacon","2020-11-04","5","1461","0","204","1.8","8"
"Bacon","2020-11-05","8","1469","1","205","3.6","8.9"
"Bacon","2020-11-06","9","1478","0","205","3.6","8.9"
"Bacon","2020-11-07","8","1486","0","205","3.6","1.8"
"Bacon","2020-11-08","6","1492","0","205","3.6","1.8"
"Bacon","2020-11-09","10","1502","1","206","5","2.5"
"Bacon","2020-11-10","12","1514","1","207","4.4","3.1"
"Bacon","2020-11-11","5","1519","0","207","4.4","3.1"
"Bacon","2020-11-12","9","1528","0","207","2.6","3.1"
"Bacon","2020-11-13","7","1535","0","207","2.6","3.1"
"Bacon","2020-11-14","2","1537","0","207","2.6","3.1"
"Bacon","2020-11-15","5","1542","0","207","2.6","3.1"
"Bacon","2020-11-16","7","1549","1","208","3.2","4.1"
"Bacon","2020-11-17","12","1561","0","208","2","3.2"
"Bacon","2020-11-18","7","1568","0","208","2","3.2"
"Bacon","2020-11-19","8","1576","0","208","2","2.3"
"Bacon","2020-11-20","10","1586","1","209","3.5","3"
"Bacon","2020-11-21","3","1589","0","209","3.5","3"
"Bacon","2020-11-22","5","1594","0","209","3.5","3"
"Bacon","2020-11-23","15","1609","1","210","2.4","2.8"
"Bacon","2020-11-24","8","1617","0","210","2.4","2.2"
"Bacon","2020-11-25","37","1654","1","211","2.8","2.4"
"Bacon","2020-11-26","2","1656","1","212","9.9","6"
"Bacon","2020-11-27","4","1660","0","212","8.5","6"
"Bacon","2020-11-28","2","1662","0","212","8.5","6"
"Bacon","2020-11-29","2","1664","0","212","8.5","6"
"Bacon","2020-11-30","17","1681","2","214","9.2","5.8"
"Bacon","2020-12-01","11","1692","2","216","11.8","7.1"
"Bacon","2020-12-02","11","1703","0","216","11.4","7.1"
"Bacon","2020-12-03","13","1716","0","216","4.3","7.1"
"Bacon","2020-12-04","6","1722","1","217","6.7","7.6"
"Bacon","2020-12-05","2","1724","1","218","13.8","11.1"
"Bacon","2020-12-06","3","1727","2","220","23.3","15.9"
"Bacon","2020-12-07","12","1739","5","225","27.6","18.4"
"Bacon","2020-12-08","13","1752","1","226","26.1","19"
"Bacon","2020-12-09","21","1773","2","228","27.5","19.4"
"Bacon","2020-12-10","14","1787","0","228","27.5","15.9"
"Bacon","2020-12-11","14","1801","1","229","26.1","16.4"
"Bacon","2020-12-12","3","1804","0","229","19","16.4"
"Bacon","2020-12-13","0","1804","0","229","9.4","16.4"
"Bacon","2020-12-14","19","1823","6","235","8","17.8"
"Bacon","2020-12-15","14","1837","0","235","6.9","16.5"
"Bacon","2020-12-16","26","1863","10","245","11","19.2"
"Bacon","2020-12-17","14","1877","2","247","13.1","20.3"
"Bacon","2020-12-18","13","1890","7","254","19.7","22.9"
"Bacon","2020-12-19","3","1893","2","256","29.3","24.1"
"Bacon","2020-12-20","1","1894","0","256","29.3","19.3"
"Bacon","2020-12-21","18","1912","3","259","27.1","17.6"
"Bacon","2020-12-22","56","1968","9","268","29.4","18.2"
"Bacon","2020-12-23","17","1985","4","272","27.3","19.2"
"Bacon","2020-12-24","3","1988","0","272","25.3","19.2"
"Bacon","2020-12-25","1","1989","0","272","17.6","18.7"
"Bacon","2020-12-26","8","1997","4","276","15.2","22.2"
"Bacon","2020-12-27","6","2003","0","276","15.2","22.2"
"Bacon","2020-12-28","40","2043","12","288","17.1","22.1"
"Bacon","2020-12-29","25","2068","8","296","19.4","24.4"
"Bacon","2020-12-30","15","2083","7","303","22.7","25"
"Bacon","2020-12-31","12","2095","2","305","25","25.2"
"Bacon","2021-01-01","3","2098","0","305","25","21.3"
"Bacon","2021-01-02","6","2104","2","307","22.7","18.9"
"Bacon","2021-01-03","5","2109","0","307","22.7","18.9"
"Bacon","2021-01-04","26","2135","11","318","24.4","20.8"
"Bacon","2021-01-05","44","2179","4","322","21.2","20.3"
"Bacon","2021-01-06","20","2199","1","323","15.2","18.9"
"Bacon","2021-01-07","23","2222","2","325","14.1","19.6"
"Bacon","2021-01-08","30","2252","4","329","16","20.5"
"Bacon","2021-01-09","6","2258","0","329","11.2","16.9"
"Bacon","2021-01-10","6","2264","3","332","18.3","20.5"
"Bacon","2021-01-11","16","2280","2","334","14.1","19.3"
"Bacon","2021-01-12","25","2305","1","335","13.4","17.3"
"Bacon","2021-01-13","10","2315","2","337","15.5","15.4"
"Bacon","2021-01-14","34","2349","3","340","15.5","14.8"
"Bacon","2021-01-15","8","2357","0","340","13.6","14.8"
"Bacon","2021-01-16","8","2365","2","342","17.2","14.2"
"Bacon","2021-01-17","3","2368","0","342","10","14.2"
"Bacon","2021-01-18","19","2387","2","344","9.8","11.9"
"Bacon","2021-01-19","12","2399","3","347","12.8","13.1"
"Bacon","2021-01-20","54","2453","24","371","16.3","15.9"
"Bacon","2021-01-21","32","2485","4","375","16.8","16.2"
"Bacon","2021-01-22","13","2498","1","376","17.9","15.7"
"Bacon","2021-01-23","2","2500","0","376","14.3","15.7"
"Bacon","2021-01-24","0","2500","0","376","14.3","12.2"
"Bacon","2021-01-25","12","2512","4","380","17.6","13.7"
"Bacon","2021-01-26","21","2533","0","380","14","13.4"
"Bacon","2021-01-27","10","2543","0","380","7.6","12"
"Bacon","2021-01-28","16","2559","1","381","6.8","11.8"
"Bacon","2021-01-29","16","2575","3","384","8.3","13.1"
"Bacon","2021-01-30","2","2577","0","384","8.3","11.3"
"Bacon","2021-01-31","3","2580","0","384","8.3","11.3"
"Bacon","2021-02-01","10","2590","2","386","6.4","12"
"Bacon","2021-02-02","20","2610","4","390","9.3","11.6"
"Bacon","2021-02-03","49","2659","2","392","9.9","8.8"
"Bacon","2021-02-04","19","2678","0","392","9","7.9"
"Bacon","2021-02-05","7","2685","1","393","8.3","8.3"
"Bacon","2021-02-06","1","2686","0","393","8.3","8.3"
"Bacon","2021-02-07","0","2686","0","393","8.3","8.3"
"Bacon","2021-02-08","0","2686","0","393","5.5","6"
"Baker","2020-02-01","0","0","0","0",".","."
"Baker","2020-02-02","0","0","0","0",".","."
"Baker","2020-02-03","0","0","0","0",".","."
"Baker","2020-02-04","0","0","0","0",".","."
"Baker","2020-02-05","0","0","0","0",".","."
"Baker","2020-02-06","0","0","0","0",".","."
"Baker","2020-02-07","0","0","0","0","0","."
"Baker","2020-02-08","0","0","0","0","0","."
"Baker","2020-02-09","0","0","0","0","0","."
"Baker","2020-02-10","0","0","0","0","0","."
"Baker","2020-02-11","0","0","0","0","0","."
"Baker","2020-02-12","0","0","0","0","0","."
"Baker","2020-02-13","0","0","0","0","0","."
"Baker","2020-02-14","0","0","0","0","0","0"
"Baker","2020-02-15","0","0","0","0","0","0"
"Baker","2020-02-16","0","0","0","0","0","0"
"Baker","2020-02-17","0","0","0","0","0","0"
"Baker","2020-02-18","0","0","0","0","0","0"
"Baker","2020-02-19","0","0","0","0","0","0"
"Baker","2020-02-20","0","0","0","0","0","0"
"Baker","2020-02-21","0","0","0","0","0","0"
"Baker","2020-02-22","0","0","0","0","0","0"
"Baker","2020-02-23","0","0","0","0","0","0"
"Baker","2020-02-24","0","0","0","0","0","0"
"Baker","2020-02-25","0","0","0","0","0","0"
"Baker","2020-02-26","0","0","0","0","0","0"
"Baker","2020-02-27","0","0","0","0","0","0"
"Baker","2020-02-28","0","0","0","0","0","0"
"Baker","2020-02-29","0","0","0","0","0","0"
"Baker","2020-03-01","0","0","0","0","0","0"
"Baker","2020-03-02","0","0","0","0","0","0"
"Baker","2020-03-03","0","0","0","0","0","0"
"Baker","2020-03-04","0","0","0","0","0","0"
"Baker","2020-03-05","0","0","0","0","0","0"
"Baker","2020-03-06","0","0","0","0","0","0"
"Baker","2020-03-07","0","0","0","0","0","0"
"Baker","2020-03-08","0","0","0","0","0","0"
"Baker","2020-03-09","0","0","0","0","0","0"
"Baker","2020-03-10","0","0","0","0","0","0"
"Baker","2020-03-11","0","0","0","0","0","0"
"Baker","2020-03-12","0","0","0","0","0","0"
"Baker","2020-03-13","1","1","0","0","0","0"
"Baker","2020-03-14","0","1","0","0","0","0"
"Baker","2020-03-15","1","2","1","1","14.3","7.1"
"Baker","2020-03-16","0","2","0","1","14.3","7.1"
"Baker","2020-03-17","2","4","0","1","14.3","7.1"
"Baker","2020-03-18","0","4","0","1","14.3","7.1"
"Baker","2020-03-19","0","4","0","1","14.3","7.1"
"Baker","2020-03-20","4","8","0","1","14.3","7.1"
"Baker","2020-03-21","0","8","0","1","14.3","7.1"
"Baker","2020-03-22","0","8","0","1","0","7.1"
"Baker","2020-03-23","5","13","0","1","0","7.1"
"Baker","2020-03-24","1","14","0","1","0","7.1"
"Baker","2020-03-25","2","16","0","1","0","7.1"
"Baker","2020-03-26","2","18","2","3","14.3","14.3"
"Baker","2020-03-27","0","18","0","3","14.3","14.3"
"Baker","2020-03-28","5","23","1","4","17.1","15.7"
"Baker","2020-03-29","1","24","1","5","31.4","15.7"
"Baker","2020-03-30","1","25","1","6","45.7","22.9"
"Baker","2020-03-31","2","27","2","8","60","30"
"Baker","2020-04-01","4","31","2","10","67.1","33.6"
"Baker","2020-04-02","0","31","0","10","52.9","33.6"
"Baker","2020-04-03","2","33","1","11","60","37.1"
"Baker","2020-04-04","1","34","0","11","57.1","37.1"
"Baker","2020-04-05","0","34","0","11","42.9","37.1"
"Baker","2020-04-06","3","37","2","13","38.1","41.9"
"Baker","2020-04-07","2","39","1","14","31","45.5"
"Baker","2020-04-08","0","39","0","14","23.8","45.5"
"Baker","2020-04-09","0","39","0","14","23.8","38.3"
"Baker","2020-04-10","6","45","2","16","21.4","40.7"
"Baker","2020-04-11","0","45","0","16","21.4","39.3"
"Baker","2020-04-12","0","45","0","16","21.4","32.1"
"Baker","2020-04-13","2","47","1","17","19","28.6"
"Baker","2020-04-14","8","55","0","17","11.9","21.4"
"Baker","2020-04-15","2","57","1","18","19","21.4"
"Baker","2020-04-16","4","61","1","19","22.6","23.2"
"Baker","2020-04-17","2","63","0","19","17.9","19.6"
"Baker","2020-04-18","2","65","0","19","17.9","19.6"
"Baker","2020-04-19","0","65","0","19","17.9","19.6"
"Baker","2020-04-20","3","68","0","19","10.7","14.9"
"Baker","2020-04-21","1","69","1","20","25","18.5"
"Baker","2020-04-22","0","69","0","20","17.9","18.5"
"Baker","2020-04-23","2","71","0","20","14.3","18.5"
"Baker","2020-04-24","2","73","0","20","14.3","16.1"
"Baker","2020-04-25","2","75","0","20","14.3","16.1"
"Baker","2020-04-26","2","77","1","21","21.4","19.6"
"Baker","2020-04-27","5","82","0","21","21.4","16.1"
"Baker","2020-04-28","1","83","0","21","7.1","16.1"
"Baker","2020-04-29","6","89","1","22","9.5","13.7"
"Baker","2020-04-30","0","89","0","22","9.5","11.9"
"Baker","2020-05-01","5","94","0","22","9.5","11.9"
"Baker","2020-05-02","0","94","0","22","9.5","11.9"
"Baker","2020-05-03","3","97","1","23","7.1","14.3"
"Baker","2020-05-04","4","101","1","24","10.7","16.1"
"Baker","2020-05-05","1","102","1","25","25","16.1"
"Baker","2020-05-06","3","105","1","26","27.4","18.5"
"Baker","2020-05-07","1","106","0","26","27.4","18.5"
"Baker","2020-05-08","0","106","0","26","27.4","18.5"
"Baker","2020-05-09","2","108","0","26","27.4","18.5"
"Baker","2020-05-10","0","108","0","26","22.6","14.9"
"Baker","2020-05-11","0","108","0","26","19","14.9"
"Baker","2020-05-12","1","109","0","26","4.8","14.9"
"Baker","2020-05-13","8","117","1","27","1.8","14.6"
"Baker","2020-05-14","5","122","0","27","1.8","14.6"
"Baker","2020-05-15","2","124","0","27","1.8","14.6"
"Baker","2020-05-16","2","126","0","27","1.8","14.6"
"Baker","2020-05-17","0","126","0","27","1.8","12.2"
"Baker","2020-05-18","5","131","0","27","1.8","10.4"
"Baker","2020-05-19","1","132","0","27","1.8","3.3"
"Baker","2020-05-20","2","134","2","29","14.3","8"
"Baker","2020-05-21","2","136","0","29","14.3","8"
"Baker","2020-05-22","7","143","0","29","14.3","8"
"Baker","2020-05-23","0","143","0","29","14.3","8"
"Baker","2020-05-24","0","143","0","29","14.3","8"
"Baker","2020-05-25","2","145","0","29","14.3","8"
"Baker","2020-05-26","2","147","0","29","14.3","8"
"Baker","2020-05-27","3","150","0","29","0","7.1"
"Baker","2020-05-28","2","152","0","29","0","7.1"
"Baker","2020-05-29","2","154","2","31","14.3","14.3"
"Baker","2020-05-30","0","154","0","31","14.3","14.3"
"Baker","2020-05-31","0","154","0","31","14.3","14.3"
"Baker","2020-06-01","1","155","0","31","14.3","14.3"
"Baker","2020-06-02","0","155","0","31","14.3","14.3"
"Baker","2020-06-03","0","155","0","31","14.3","7.1"
"Baker","2020-06-04","0","155","0","31","14.3","7.1"
"Baker","2020-06-05","2","157","0","31","0","7.1"
"Baker","2020-06-06","4","161","0","31","0","7.1"
"Baker","2020-06-07","0","161","0","31","0","7.1"
"Baker","2020-06-08","6","167","0","31","0","7.1"
"Baker","2020-06-09","1","168","0","31","0","7.1"
"Baker","2020-06-10","1","169","0","31","0","7.1"
"Baker","2020-06-11","3","172","0","31","0","7.1"
"Baker","2020-06-12","0","172","0","31","0","0"
"Baker","2020-06-13","0","172","0","31","0","0"
"Baker","2020-06-14","0","172","0","31","0","0"
"Baker","2020-06-15","2","174","0","31","0","0"
"Baker","2020-06-16","1","175","0","31","0","0"
"Baker","2020-06-17","3","178","0","31","0","0"
"Baker","2020-06-18","2","180","1","32","7.1","3.6"
"Baker","2020-06-19","0","180","0","32","7.1","3.6"
"Baker","2020-06-20","1","181","0","32","7.1","3.6"
"Baker","2020-06-21","0","181","0","32","7.1","3.6"
"Baker","2020-06-22","6","187","0","32","7.1","3.6"
"Baker","2020-06-23","0","187","0","32","7.1","3.6"
"Baker","2020-06-24","0","187","0","32","7.1","3.6"
"Baker","2020-06-25","2","189","0","32","0","3.6"
"Baker","2020-06-26","2","191","0","32","0","3.6"
"Baker","2020-06-27","1","192","0","32","0","3.6"
"Baker","2020-06-28","0","192","0","32","0","3.6"
"Baker","2020-06-29","1","193","0","32","0","3.6"
"Baker","2020-06-30","3","196","0","32","0","3.6"
"Baker","2020-07-01","4","200","0","32","0","3.6"
"Baker","2020-07-02","7","207","0","32","0","0"
"Baker","2020-07-03","0","207","0","32","0","0"
"Baker","2020-07-04","0","207","0","32","0","0"
"Baker","2020-07-05","0","207","0","32","0","0"
"Baker","2020-07-06","6","213","2","34","4.8","2.4"
"Baker","2020-07-07","4","217","0","34","4.8","2.4"
"Baker","2020-07-08","3","220","0","34","4.8","2.4"
"Baker","2020-07-09","2","222","0","34","4.8","2.4"
"Baker","2020-07-10","2","224","0","34","4.8","2.4"
"Baker","2020-07-11","0","224","0","34","4.8","2.4"
"Baker","2020-07-12","0","224","0","34","4.8","2.4"
"Baker","2020-07-13","8","232","0","34","0","2.4"
"Baker","2020-07-14","6","238","0","34","0","2.4"
"Baker","2020-07-15","2","240","0","34","0","2.4"
"Baker","2020-07-16","4","244","0","34","0","2.4"
"Baker","2020-07-17","1","245","0","34","0","2.4"
"Baker","2020-07-18","0","245","0","34","0","2.4"
"Baker","2020-07-19","3","248","0","34","0","2.4"
"Baker","2020-07-20","1","249","0","34","0","0"
"Baker","2020-07-21","9","258","0","34","0","0"
"Baker","2020-07-22","3","261","0","34","0","0"
"Baker","2020-07-23","6","267","1","35","2.4","1.2"
"Baker","2020-07-24","4","271","1","36","6","3"
"Baker","2020-07-25","3","274","1","37","10.7","5.4"
"Baker","2020-07-26","2","276","0","37","10.7","5.4"
"Baker","2020-07-27","3","279","2","39","20.2","10.1"
"Baker","2020-07-28","6","285","1","40","22.6","11.3"
"Baker","2020-07-29","9","294","0","40","22.6","11.3"
"Baker","2020-07-30","3","297","0","40","20.2","11.3"
"Baker","2020-07-31","4","301","1","41","20.2","13.1"
"Baker","2020-08-01","0","301","0","41","15.5","13.1"
"Baker","2020-08-02","0","301","0","41","15.5","13.1"
"Baker","2020-08-03","7","308","1","42","8","14.1"
"Baker","2020-08-04","4","312","0","42","5.6","14.1"
"Baker","2020-08-05","5","317","0","42","5.6","14.1"
"Baker","2020-08-06","4","321","0","42","5.6","12.9"
"Baker","2020-08-07","4","325","2","44","9.2","14.7"
"Baker","2020-08-08","1","326","0","44","9.2","12.3"
"Baker","2020-08-09","2","328","1","45","16.3","15.9"
"Baker","2020-08-10","2","330","0","45","14.3","11.1"
"Baker","2020-08-11","2","332","0","45","14.3","9.9"
"Baker","2020-08-12","3","335","1","46","19","12.3"
"Baker","2020-08-13","3","338","0","46","19","12.3"
"Baker","2020-08-14","4","342","0","46","11.9","10.5"
"Baker","2020-08-15","1","343","1","47","26.2","17.7"
"Baker","2020-08-16","0","343","0","47","19","17.7"
"Baker","2020-08-17","1","344","0","47","19","16.7"
"Baker","2020-08-18","4","348","0","47","19","16.7"
"Baker","2020-08-19","2","350","0","47","14.3","16.7"
"Baker","2020-08-20","4","354","1","48","17.9","18.5"
"Baker","2020-08-21","0","354","0","48","17.9","14.9"
"Baker","2020-08-22","1","355","0","48","3.6","14.9"
"Baker","2020-08-23","0","355","0","48","3.6","11.3"
"Baker","2020-08-24","3","358","0","48","3.6","11.3"
"Baker","2020-08-25","7","365","1","49","5.6","12.3"
"Baker","2020-08-26","3","368","0","49","5.6","9.9"
"Baker","2020-08-27","1","369","0","49","2","9.9"
"Baker","2020-08-28","2","371","0","49","2","9.9"
"Baker","2020-08-29","2","373","0","49","2","2.8"
"Baker","2020-08-30","0","373","0","49","2","2.8"
"Baker","2020-08-31","1","374","0","49","2","2.8"
"Baker","2020-09-01","6","380","0","49","0","2.8"
"Baker","2020-09-02","7","387","0","49","0","2.8"
"Baker","2020-09-03","1","388","0","49","0","1"
"Baker","2020-09-04","3","391","0","49","0","1"
"Baker","2020-09-05","1","392","0","49","0","1"
"Baker","2020-09-06","0","392","0","49","0","1"
"Baker","2020-09-07","0","392","0","49","0","1"
"Baker","2020-09-08","8","400","0","49","0","0"
"Baker","2020-09-09","5","405","1","50","2.9","1.4"
"Baker","2020-09-10","5","410","0","50","2.9","1.4"
"Baker","2020-09-11","1","411","0","50","2.9","1.4"
"Baker","2020-09-12","1","412","0","50","2.9","1.4"
"Baker","2020-09-13","3","415","0","50","2.9","1.4"
"Baker","2020-09-14","8","423","1","51","4.6","2.3"
"Baker","2020-09-15","8","431","0","51","4.6","2.3"
"Baker","2020-09-16","3","434","1","52","6.5","4.7"
"Baker","2020-09-17","4","438","0","52","6.5","4.7"
"Baker","2020-09-18","4","442","0","52","6.5","4.7"
"Baker","2020-09-19","1","443","0","52","6.5","4.7"
"Baker","2020-09-20","0","443","0","52","6.5","4.7"
"Baker","2020-09-21","5","448","1","53","7.6","6.1"
"Baker","2020-09-22","1","449","0","53","7.6","6.1"
"Baker","2020-09-23","1","450","0","53","2.9","4.7"
"Baker","2020-09-24","4","454","1","54","6.4","6.5"
"Baker","2020-09-25","2","456","0","54","6.4","6.5"
"Baker","2020-09-26","1","457","0","54","6.4","6.5"
"Baker","2020-09-27","0","457","0","54","6.4","6.5"
"Baker","2020-09-28","5","462","0","54","3.6","5.6"
"Baker","2020-09-29","5","467","0","54","3.6","5.6"
"Baker","2020-09-30","1","468","0","54","3.6","3.2"
"Baker","2020-10-01","4","472","0","54","0","3.2"
"Baker","2020-10-02","6","478","0","54","0","3.2"
"Baker","2020-10-03","0","478","0","54","0","3.2"
"Baker","2020-10-04","0","478","0","54","0","3.2"
"Baker","2020-10-05","1","479","0","54","0","1.8"
"Baker","2020-10-06","2","481","0","54","0","1.8"
"Baker","2020-10-07","3","484","0","54","0","1.8"
"Baker","2020-10-08","5","489","1","55","2.9","1.4"
"Baker","2020-10-09","2","491","0","55","2.9","1.4"
"Baker","2020-10-10","0","491","0","55","2.9","1.4"
"Baker","2020-10-11","1","492","0","55","2.9","1.4"
"Baker","2020-10-12","4","496","0","55","2.9","1.4"
"Baker","2020-10-13","3","499","0","55","2.9","1.4"
"Baker","2020-10-14","3","502","0","55","2.9","1.4"
"Baker","2020-10-15","4","506","0","55","0","1.4"
"Baker","2020-10-16","3","509","1","56","4.8","3.8"
"Baker","2020-10-17","0","509","0","56","4.8","3.8"
"Baker","2020-10-18","0","509","0","56","4.8","3.8"
"Baker","2020-10-19","2","511","0","56","4.8","3.8"
"Baker","2020-10-20","3","514","1","57","9.5","6.2"
"Baker","2020-10-21","3","517","0","57","9.5","6.2"
"Baker","2020-10-22","1","518","0","57","9.5","4.8"
"Baker","2020-10-23","4","522","0","57","4.8","4.8"
"Baker","2020-10-24","1","523","0","57","4.8","4.8"
"Baker","2020-10-25","0","523","0","57","4.8","4.8"
"Baker","2020-10-26","0","523","0","57","4.8","4.8"
"Baker","2020-10-27","2","525","0","57","0","4.8"
"Baker","2020-10-28","5","530","0","57","0","4.8"
"Baker","2020-10-29","2","532","0","57","0","4.8"
"Baker","2020-10-30","4","536","0","57","0","2.4"
"Baker","2020-10-31","0","536","0","57","0","2.4"
"Baker","2020-11-01","2","538","1","58","7.1","6"
"Baker","2020-11-02","4","542","0","58","7.1","6"
"Baker","2020-11-03","4","546","0","58","7.1","3.6"
"Baker","2020-11-04","1","547","1","59","21.4","10.7"
"Baker","2020-11-05","4","551","0","59","21.4","10.7"
"Baker","2020-11-06","1","552","1","60","35.7","17.9"
"Baker","2020-11-07","2","554","1","61","42.9","21.4"
"Baker","2020-11-08","3","557","0","61","35.7","21.4"
"Baker","2020-11-09","6","563","0","61","35.7","21.4"
"Baker","2020-11-10","8","571","3","64","41.1","24.1"
"Baker","2020-11-11","5","576","1","65","29.6","25.5"
"Baker","2020-11-12","2","578","0","65","29.6","25.5"
"Baker","2020-11-13","1","579","0","65","15.4","25.5"
"Baker","2020-11-14","3","582","0","65","8.2","25.5"
"Baker","2020-11-15","3","585","1","66","13","24.3"
"Baker","2020-11-16","1","586","0","66","13","24.3"
"Baker","2020-11-17","7","593","1","67","9.7","25.4"
"Baker","2020-11-18","0","593","0","67","6.8","18.2"
"Baker","2020-11-19","3","596","0","67","6.8","18.2"
"Baker","2020-11-20","1","597","0","67","6.8","11.1"
"Baker","2020-11-21","1","598","1","68","21.1","14.7"
"Baker","2020-11-22","0","598","0","68","16.3","14.7"
"Baker","2020-11-23","7","605","2","70","20.4","16.7"
"Baker","2020-11-24","4","609","0","70","18.4","14"
"Baker","2020-11-25","5","614","0","70","18.4","12.6"
"Baker","2020-11-26","0","614","0","70","18.4","12.6"
"Baker","2020-11-27","0","614","0","70","18.4","12.6"
"Baker","2020-11-28","2","616","0","70","4.1","12.6"
"Baker","2020-11-29","3","619","0","70","4.1","10.2"
"Baker","2020-11-30","4","623","1","71","3.6","12"
"Baker","2020-12-01","3","626","0","71","3.6","11"
"Baker","2020-12-02","2","628","0","71","3.6","11"
"Baker","2020-12-03","2","630","0","71","3.6","11"
"Baker","2020-12-04","3","633","2","73","13.1","15.7"
"Baker","2020-12-05","0","633","0","73","13.1","8.6"
"Baker","2020-12-06","0","633","0","73","13.1","8.6"
"Baker","2020-12-07","5","638","0","73","9.5","6.5"
"Baker","2020-12-08","7","645","2","75","13.6","8.6"
"Baker","2020-12-09","5","650","1","76","16.5","10"
"Baker","2020-12-10","6","656","1","77","18.8","11.2"
"Baker","2020-12-11","8","664","0","77","9.3","11.2"
"Baker","2020-12-12","1","665","0","77","9.3","11.2"
"Baker","2020-12-13","1","666","0","77","9.3","11.2"
"Baker","2020-12-14","4","670","2","79","16.5","13"
"Baker","2020-12-15","6","676","2","81","17.1","15.4"
"Baker","2020-12-16","8","684","4","85","21.4","18.9"
"Baker","2020-12-17","1","685","0","85","19","18.9"
"Baker","2020-12-18","7","692","0","85","19","14.2"
"Baker","2020-12-19","0","692","0","85","19","14.2"
"Baker","2020-12-20","2","694","1","86","26.2","17.8"
"Baker","2020-12-21","11","705","1","87","20.3","18.4"
"Baker","2020-12-22","14","719","4","91","19.7","18.4"
"Baker","2020-12-23","8","727","1","92","14.3","17.9"
"Baker","2020-12-24","1","728","0","92","14.3","16.7"
"Baker","2020-12-25","0","728","0","92","14.3","16.7"
"Baker","2020-12-26","0","728","0","92","14.3","16.7"
"Baker","2020-12-27","2","730","1","93","14.3","20.2"
"Baker","2020-12-28","7","737","1","94","15.1","17.7"
"Baker","2020-12-29","6","743","2","96","15.7","17.7"
"Baker","2020-12-30","7","750","0","96","13.9","14.1"
"Baker","2020-12-31","8","758","0","96","13.9","14.1"
"Baker","2021-01-01","0","758","0","96","13.9","14.1"
"Baker","2021-01-02","2","760","0","96","13.9","14.1"
"Baker","2021-01-03","1","761","0","96","6.8","10.6"
"Baker","2021-01-04","8","769","1","97","6.5","10.8"
"Baker","2021-01-05","9","778","0","97","1.8","8.8"
"Baker","2021-01-06","6","784","1","98","4.2","9.1"
"Baker","2021-01-07","3","787","0","98","4.2","9.1"
"Baker","2021-01-08","6","793","0","98","4.2","9.1"
"Baker","2021-01-09","1","794","0","98","4.2","9.1"
"Baker","2021-01-10","0","794","0","98","4.2","5.5"
"Baker","2021-01-11","5","799","1","99","5.2","5.9"
"Baker","2021-01-12","9","808","1","100","6.8","4.3"
"Baker","2021-01-13","9","817","1","101","6","5.1"
"Baker","2021-01-14","5","822","0","101","6","5.1"
"Baker","2021-01-15","4","826","1","102","9.6","6.9"
"Baker","2021-01-16","1","827","0","102","9.6","6.9"
"Baker","2021-01-17","3","830","1","103","14.4","9.3"
"Baker","2021-01-18","6","836","1","104","13.9","9.6"
"Baker","2021-01-19","5","841","0","104","12.3","9.6"
"Baker","2021-01-20","2","843","0","104","10.7","8.4"
"Baker","2021-01-21","7","850","1","105","12.8","9.4"
"Baker","2021-01-22","4","854","1","106","12.8","11.2"
"Baker","2021-01-23","3","857","0","106","12.8","11.2"
"Baker","2021-01-24","1","858","0","106","8","11.2"
"Baker","2021-01-25","3","861","1","107","10.4","12.1"
"Baker","2021-01-26","7","868","1","108","12.4","12.4"
"Baker","2021-01-27","4","872","2","110","19.6","15.1"
"Baker","2021-01-28","3","875","0","110","17.5","15.1"
"Baker","2021-01-29","3","878","0","110","13.9","13.4"
"Baker","2021-01-30","5","883","0","110","13.9","13.4"
"Baker","2021-01-31","2","885","2","112","28.2","18.1"
"Baker","2021-02-01","3","888","1","113","28.2","19.3"
"Baker","2021-02-02","4","892","0","113","26.2","19.3"
"Baker","2021-02-03","5","897","1","114","21.9","20.7"
"Baker","2021-02-04","3","900","0","114","21.9","19.7"
"Baker","2021-02-05","4","904","1","115","25.5","19.7"
"Baker","2021-02-06","0","904","0","115","25.5","19.7"
"Baker","2021-02-07","1","905","0","115","11.2","19.7"
"Baker","2021-02-08","0","905","0","115","6.4","17.3"
"Baldwin","2020-02-01","0","0","0","0",".","."
"Baldwin","2020-02-02","0","0","0","0",".","."
"Baldwin","2020-02-03","0","0","0","0",".","."
"Baldwin","2020-02-04","0","0","0","0",".","."
"Baldwin","2020-02-05","0","0","0","0",".","."
"Baldwin","2020-02-06","0","0","0","0",".","."
"Baldwin","2020-02-07","0","0","0","0","0","."
"Baldwin","2020-02-08","0","0","0","0","0","."
"Baldwin","2020-02-09","0","0","0","0","0","."
"Baldwin","2020-02-10","0","0","0","0","0","."
"Baldwin","2020-02-11","0","0","0","0","0","."
"Baldwin","2020-02-12","0","0","0","0","0","."
"Baldwin","2020-02-13","0","0","0","0","0","."
"Baldwin","2020-02-14","0","0","0","0","0","0"
"Baldwin","2020-02-15","0","0","0","0","0","0"
"Baldwin","2020-02-16","0","0","0","0","0","0"
"Baldwin","2020-02-17","0","0","0","0","0","0"
"Baldwin","2020-02-18","0","0","0","0","0","0"
"Baldwin","2020-02-19","0","0","0","0","0","0"
"Baldwin","2020-02-20","0","0","0","0","0","0"
"Baldwin","2020-02-21","0","0","0","0","0","0"
"Baldwin","2020-02-22","0","0","0","0","0","0"
"Baldwin","2020-02-23","0","0","0","0","0","0"
"Baldwin","2020-02-24","0","0","0","0","0","0"
"Baldwin","2020-02-25","0","0","0","0","0","0"
"Baldwin","2020-02-26","0","0","0","0","0","0"
"Baldwin","2020-02-27","0","0","0","0","0","0"
"Baldwin","2020-02-28","0","0","0","0","0","0"
"Baldwin","2020-02-29","0","0","0","0","0","0"
"Baldwin","2020-03-01","0","0","0","0","0","0"
"Baldwin","2020-03-02","0","0","0","0","0","0"
"Baldwin","2020-03-03","0","0","0","0","0","0"
"Baldwin","2020-03-04","0","0","0","0","0","0"
"Baldwin","2020-03-05","0","0","0","0","0","0"
"Baldwin","2020-03-06","0","0","0","0","0","0"
"Baldwin","2020-03-07","0","0","0","0","0","0"
"Baldwin","2020-03-08","3","3","0","0","0","0"
"Baldwin","2020-03-09","1","4","1","1","14.3","7.1"
"Baldwin","2020-03-10","0","4","0","1","14.3","7.1"
"Baldwin","2020-03-11","1","5","0","1","14.3","7.1"
"Baldwin","2020-03-12","1","6","0","1","14.3","7.1"
"Baldwin","2020-03-13","1","7","0","1","14.3","7.1"
"Baldwin","2020-03-14","2","9","0","1","14.3","7.1"
"Baldwin","2020-03-15","2","11","0","1","14.3","7.1"
"Baldwin","2020-03-16","1","12","0","1","0","7.1"
"Baldwin","2020-03-17","2","14","0","1","0","7.1"
"Baldwin","2020-03-18","1","15","0","1","0","7.1"
"Baldwin","2020-03-19","4","19","1","2","3.6","8.9"
"Baldwin","2020-03-20","7","26","3","5","9.7","12"
"Baldwin","2020-03-21","2","28","0","5","9.7","12"
"Baldwin","2020-03-22","5","33","1","6","12.6","13.4"
"Baldwin","2020-03-23","3","36","1","7","17.3","8.7"
"Baldwin","2020-03-24","6","42","0","7","17.3","8.7"
"Baldwin","2020-03-25","1","43","0","7","17.3","8.7"
"Baldwin","2020-03-26","9","52","2","9","16.9","10.2"
"Baldwin","2020-03-27","9","61","2","11","14","11.8"
"Baldwin","2020-03-28","6","67","1","12","16.3","13"
"Baldwin","2020-03-29","7","74","3","15","19.6","16.1"
"Baldwin","2020-03-30","8","82","1","16","16.6","17"
"Baldwin","2020-03-31","11","93","3","19","20.5","18.9"
"Baldwin","2020-04-01","20","113","8","27","26.2","21.8"
"Baldwin","2020-04-02","22","135","2","29","24.4","20.6"
"Baldwin","2020-04-03","17","152","5","34","25.4","19.7"
"Baldwin","2020-04-04","11","163","2","36","25.6","21"
"Baldwin","2020-04-05","2","165","1","37","26.6","23.1"
"Baldwin","2020-04-06","22","187","6","43","28.7","22.7"
"Baldwin","2020-04-07","24","211","10","53","30.8","25.7"
"Baldwin","2020-04-08","22","233","4","57","27.7","27"
"Baldwin","2020-04-09","13","246","2","59","28.6","26.5"
"Baldwin","2020-04-10","51","297","27","86","31.9","28.7"
"Baldwin","2020-04-11","23","320","11","97","36.2","30.9"
"Baldwin","2020-04-12","10","330","1","98","30.5","28.6"
"Baldwin","2020-04-13","32","362","7","105","29.7","29.2"
"Baldwin","2020-04-14","55","417","20","125","28.9","29.9"
"Baldwin","2020-04-15","36","453","16","141","32.7","30.2"
"Baldwin","2020-04-16","48","501","9","150","33.2","30.9"
"Baldwin","2020-04-17","39","540","8","158","28.5","30.2"
"Baldwin","2020-04-18","8","548","2","160","25.3","30.7"
"Baldwin","2020-04-19","5","553","2","162","29.6","30"
"Baldwin","2020-04-20","38","591","10","172","30.2","29.9"
"Baldwin","2020-04-21","41","632","7","179","27.4","28.2"
"Baldwin","2020-04-22","31","663","2","181","22","27.4"
"Baldwin","2020-04-23","22","685","5","186","22.6","27.9"
"Baldwin","2020-04-24","38","723","7","193","22.3","25.4"
"Baldwin","2020-04-25","96","819","4","197","19.3","22.3"
"Baldwin","2020-04-26","69","888","7","204","15","22.3"
"Baldwin","2020-04-27","93","981","9","213","12.7","21.4"
"Baldwin","2020-04-28","40","1021","6","219","12.4","19.9"
"Baldwin","2020-04-29","56","1077","7","226","13.2","17.6"
"Baldwin","2020-04-30","28","1105","3","229","11.5","17.1"
"Baldwin","2020-05-01","24","1129","6","235","12.5","17.4"
"Baldwin","2020-05-02","16","1145","3","238","14.5","16.9"
"Baldwin","2020-05-03","10","1155","2","240","15.9","15.5"
"Baldwin","2020-05-04","85","1240","12","252","16.6","14.6"
"Baldwin","2020-05-05","38","1278","5","257","16.3","14.3"
"Baldwin","2020-05-06","24","1302","4","261","16.9","15.1"
"Baldwin","2020-05-07","40","1342","7","268","17.9","14.7"
"Baldwin","2020-05-08","41","1383","8","276","17.1","14.8"
"Baldwin","2020-05-09","6","1389","1","277","16.8","15.7"
"Baldwin","2020-05-10","10","1399","1","278","15.4","15.7"
"Baldwin","2020-05-11","33","1432","7","285","16.4","16.5"
"Baldwin","2020-05-12","32","1464","6","291","17.2","16.8"
"Baldwin","2020-05-13","56","1520","11","302","17.6","17.3"
"Baldwin","2020-05-14","29","1549","4","306","17.1","17.5"
"Baldwin","2020-05-15","64","1613","6","312","15.6","16.4"
"Baldwin","2020-05-16","20","1633","2","314","14.7","15.7"
"Baldwin","2020-05-17","28","1661","2","316","14.3","14.8"
"Baldwin","2020-05-18","33","1694","6","322","13.8","15.1"
"Baldwin","2020-05-19","43","1737","3","325","12.2","14.7"
"Baldwin","2020-05-20","26","1763","3","328","11","14.3"
"Baldwin","2020-05-21","32","1795","5","333","11.3","14.2"
"Baldwin","2020-05-22","112","1907","5","338","10.6","13.1"
"Baldwin","2020-05-23","28","1935","2","340","10.2","12.4"
"Baldwin","2020-05-24","26","1961","1","341","9.7","12"
"Baldwin","2020-05-25","12","1973","2","343","9.5","11.7"
"Baldwin","2020-05-26","48","2021","4","347","9.7","10.9"
"Baldwin","2020-05-27","66","2087","4","351","8.9","9.9"
"Baldwin","2020-05-28","45","2132","2","353","7.3","9.3"
"Baldwin","2020-05-29","24","2156","2","355","7.8","9.2"
"Baldwin","2020-05-30","9","2165","1","356","8.4","9.3"
"Baldwin","2020-05-31","7","2172","4","360","16","12.8"
"Baldwin","2020-06-01","27","2199","3","363","15.2","12.3"
"Baldwin","2020-06-02","46","2245","5","368","15.6","12.6"
"Baldwin","2020-06-03","71","2316","9","377","16.5","12.7"
"Baldwin","2020-06-04","53","2369","7","384","17.8","12.5"
"Baldwin","2020-06-05","148","2517","11","395","17.7","12.7"
"Baldwin","2020-06-06","11","2528","1","396","17.4","12.9"
"Baldwin","2020-06-07","4","2532","0","396","9.2","12.6"
"Baldwin","2020-06-08","48","2580","7","403","9.7","12.5"
"Baldwin","2020-06-09","38","2618","7","410","10.8","13.2"
"Baldwin","2020-06-10","54","2672","5","415","10.3","13.4"
"Baldwin","2020-06-11","32","2704","2","417","9.3","13.5"
"Baldwin","2020-06-12","84","2788","4","421","8.9","13.3"
"Baldwin","2020-06-13","6","2794","0","421","7.6","12.5"
"Baldwin","2020-06-14","8","2802","0","421","7.6","8.4"
"Baldwin","2020-06-15","83","2885","9","430","7.1","8.4"
"Baldwin","2020-06-16","49","2934","3","433","5.3","8"
"Baldwin","2020-06-17","67","3001","12","445","6.6","8.4"
"Baldwin","2020-06-18","51","3052","4","449","6.8","8"
"Baldwin","2020-06-19","82","3134","12","461","8.2","8.6"
"Baldwin","2020-06-20","16","3150","4","465","11.8","9.7"
"Baldwin","2020-06-21","14","3164","2","467","13.8","10.7"
"Baldwin","2020-06-22","83","3247","10","477","14","10.5"
"Baldwin","2020-06-23","43","3290","6","483","15.1","10.2"
"Baldwin","2020-06-24","105","3395","12","495","14.2","10.4"
"Baldwin","2020-06-25","49","3444","4","499","14.2","10.5"
"Baldwin","2020-06-26","371","3815","22","521","13","10.6"
"Baldwin","2020-06-27","73","3888","11","532","11.6","11.7"
"Baldwin","2020-06-28","18","3906","5","537","13.5","13.6"
"Baldwin","2020-06-29","147","4053","14","551","13.1","13.5"
"Baldwin","2020-06-30","124","4177","13","564","12.6","13.9"
"Baldwin","2020-07-01","193","4370","27","591","13","13.6"
"Baldwin","2020-07-02","70","4440","11","602","14.1","14.1"
"Baldwin","2020-07-03","81","4521","9","611","14.8","13.9"
"Baldwin","2020-07-04","41","4562","5","616","14.4","13"
"Baldwin","2020-07-05","12","4574","1","617","11.6","12.6"
"Baldwin","2020-07-06","230","4804","20","637","11.5","12.3"
"Baldwin","2020-07-07","81","4885","9","646","11.6","12.1"
"Baldwin","2020-07-08","171","5056","17","663","11","12"
"Baldwin","2020-07-09","63","5119","9","672","10.8","12.4"
"Baldwin","2020-07-10","197","5316","12","684","10.1","12.5"
"Baldwin","2020-07-11","59","5375","11","695","11","12.7"
"Baldwin","2020-07-12","33","5408","10","705","14.2","12.9"
"Baldwin","2020-07-13","144","5552","11","716","14","12.8"
"Baldwin","2020-07-14","93","5645","9","725","13.8","12.7"
"Baldwin","2020-07-15","238","5883","16","741","13.3","12.2"
"Baldwin","2020-07-16","83","5966","8","749","12.7","11.7"
"Baldwin","2020-07-17","182","6148","15","764","13","11.5"
"Baldwin","2020-07-18","18","6166","4","768","13.5","12.3"
"Baldwin","2020-07-19","26","6192","9","777","14.1","14.1"
"Baldwin","2020-07-20","184","6376","21","798","14.6","14.3"
"Baldwin","2020-07-21","121","6497","23","821","16","14.9"
"Baldwin","2020-07-22","123","6620","11","832","16.3","14.8"
"Baldwin","2020-07-23","79","6699","18","850","18.2","15.4"
"Baldwin","2020-07-24","227","6926","27","877","18.7","15.8"
"Baldwin","2020-07-25","170","7096","18","895","17","15.3"
"Baldwin","2020-07-26","43","7139","8","903","14.7","14.4"
"Baldwin","2020-07-27","141","7280","29","932","16.1","15.4"
"Baldwin","2020-07-28","117","7397","20","952","15.8","15.9"
"Baldwin","2020-07-29","125","7522","14","966","16.1","16.2"
"Baldwin","2020-07-30","149","7671","13","979","14.1","16.1"
"Baldwin","2020-07-31","243","7914","28","1007","14","16.4"
"Baldwin","2020-08-01","111","8025","7","1014","13.4","15.2"
"Baldwin","2020-08-02","44","8069","6","1020","12.7","13.7"
"Baldwin","2020-08-03","135","8204","11","1031","10.9","13.5"
"Baldwin","2020-08-04","55","8259","8","1039","10.6","13.2"
"Baldwin","2020-08-05","154","8413","18","1057","10.7","13.4"
"Baldwin","2020-08-06","95","8508","14","1071","11.5","12.8"
"Baldwin","2020-08-07","199","8707","9","1080","10.5","12.3"
"Baldwin","2020-08-08","60","8767","8","1088","11.5","12.5"
"Baldwin","2020-08-09","35","8802","5","1093","11.6","12.2"
"Baldwin","2020-08-10","120","8922","11","1104","11.8","11.4"
"Baldwin","2020-08-11","53","8975","9","1113","12.1","11.3"
"Baldwin","2020-08-12","147","9122","10","1123","11.4","11"
"Baldwin","2020-08-13","58","9180","6","1129","10.8","11.1"
"Baldwin","2020-08-14","229","9409","11","1140","10.8","10.7"
"Baldwin","2020-08-15","78","9487","7","1147","10.2","10.9"
"Baldwin","2020-08-16","28","9515","4","1151","10.2","10.9"
"Baldwin","2020-08-17","82","9597","16","1167","11.7","11.7"
"Baldwin","2020-08-18","69","9666","8","1175","10.9","11.5"
"Baldwin","2020-08-19","162","9828","29","1204","12.5","11.9"
"Baldwin","2020-08-20","79","9907","19","1223","14.4","12.6"
"Baldwin","2020-08-21","421","10328","36","1259","15","12.9"
"Baldwin","2020-08-22","45","10373","10","1269","16.9","13.5"
"Baldwin","2020-08-23","41","10414","12","1281","19","14.6"
"Baldwin","2020-08-24","90","10504","10","1291","17.8","14.7"
"Baldwin","2020-08-25","106","10610","17","1308","18.4","14.7"
"Baldwin","2020-08-26","150","10760","18","1326","17.6","15"
"Baldwin","2020-08-27","83","10843","8","1334","15.5","15"
"Baldwin","2020-08-28","144","10987","10","1344","15.3","15.1"
"Baldwin","2020-08-29","22","11009","4","1348","14.7","15.8"
"Baldwin","2020-08-30","15","11024","3","1351","13.4","16.2"
"Baldwin","2020-08-31","329","11353","13","1364","12.4","15.1"
"Baldwin","2020-09-01","46","11399","8","1372","12.6","15.5"
"Baldwin","2020-09-02","104","11503","19","1391","13.5","15.5"
"Baldwin","2020-09-03","74","11577","7","1398","13.5","14.5"
"Baldwin","2020-09-04","138","11715","23","1421","14.8","15.1"
"Baldwin","2020-09-05","164","11879","5","1426","12.7","13.7"
"Baldwin","2020-09-06","71","11950","9","1435","11.6","12.5"
"Baldwin","2020-09-07","19","11969","4","1439","14.1","13.2"
"Baldwin","2020-09-08","65","12034","9","1448","13.6","13.1"
"Baldwin","2020-09-09","93","12127","19","1467","13.9","13.7"
"Baldwin","2020-09-10","53","12180","4","1471","13.6","13.5"
"Baldwin","2020-09-11","131","12311","13","1484","12.6","13.7"
"Baldwin","2020-09-12","23","12334","4","1488","14.7","13.7"
"Baldwin","2020-09-13","25","12359","7","1495","16.9","14.3"
"Baldwin","2020-09-14","110","12469","12","1507","15.4","14.8"
"Baldwin","2020-09-15","46","12515","5","1512","15","14.3"
"Baldwin","2020-09-16","201","12716","12","1524","12.9","13.4"
"Baldwin","2020-09-17","146","12862","9","1533","12.7","13.2"
"Baldwin","2020-09-18","81","12943","4","1537","12","12.3"
"Baldwin","2020-09-19","25","12968","3","1540","11.3","13"
"Baldwin","2020-09-20","20","12988","0","1540","7.3","12.1"
"Baldwin","2020-09-21","65","13053","11","1551","8.1","11.8"
"Baldwin","2020-09-22","63","13116","9","1560","8.6","11.8"
"Baldwin","2020-09-23","75","13191","5","1565","8.7","10.8"
"Baldwin","2020-09-24","49","13240","4","1569","9","10.9"
"Baldwin","2020-09-25","101","13341","1","1570","8.4","10.2"
"Baldwin","2020-09-26","36","13377","6","1576","9.1","10.2"
"Baldwin","2020-09-27","18","13395","2","1578","10.7","9"
"Baldwin","2020-09-28","77","13472","8","1586","9.8","8.9"
"Baldwin","2020-09-29","39","13511","1","1587","8.1","8.3"
"Baldwin","2020-09-30","107","13618","7","1594","8.1","8.4"
"Baldwin","2020-10-01","85","13703","3","1597","7.4","8.2"
"Baldwin","2020-10-02","159","13862","3","1600","7.5","8"
"Baldwin","2020-10-03","346","14208","1","1601","5.2","7.1"
"Baldwin","2020-10-04","14","14222","3","1604","6.7","8.7"
"Baldwin","2020-10-05","72","14294","3","1607","5.8","7.8"
"Baldwin","2020-10-06","63","14357","6","1613","6.8","7.4"
"Baldwin","2020-10-07","71","14428","9","1622","7.6","7.9"
"Baldwin","2020-10-08","41","14469","2","1624","7.8","7.6"
"Baldwin","2020-10-09","391","14860","5","1629","7.7","7.6"
"Baldwin","2020-10-10","26","14886","1","1630","8.3","6.7"
"Baldwin","2020-10-11","27","14913","1","1631","5.7","6.2"
"Baldwin","2020-10-12","76","14989","6","1637","6.3","6"
"Baldwin","2020-10-13","72","15061","9","1646","6.7","6.7"
"Baldwin","2020-10-14","108","15169","11","1657","6.3","7"
"Baldwin","2020-10-15","99","15268","6","1663","6.5","7.2"
"Baldwin","2020-10-16","252","15520","7","1670","6.7","7.2"
"Baldwin","2020-10-17","34","15554","1","1671","6.6","7.4"
"Baldwin","2020-10-18","18","15572","3","1674","8.4","7.1"
"Baldwin","2020-10-19","73","15645","7","1681","8.7","7.5"
"Baldwin","2020-10-20","51","15696","1","1682","7.2","6.9"
"Baldwin","2020-10-21","101","15797","10","1692","7.1","6.7"
"Baldwin","2020-10-22","70","15867","4","1696","7.1","6.8"
"Baldwin","2020-10-23","298","16165","2","1698","6.8","6.7"
"Baldwin","2020-10-24","37","16202","3","1701","7.5","7"
"Baldwin","2020-10-25","27","16229","2","1703","6.2","7.3"
"Baldwin","2020-10-26","94","16323","6","1709","5.7","7.2"
"Baldwin","2020-10-27","55","16378","7","1716","7.3","7.2"
"Baldwin","2020-10-28","93","16471","10","1726","7.4","7.3"
"Baldwin","2020-10-29","57","16528","3","1729","7.3","7.2"
"Baldwin","2020-10-30","120","16648","3","1732","7.6","7.2"
"Baldwin","2020-10-31","130","16778","0","1732","6.4","7"
"Baldwin","2020-11-01","19","16797","4","1736","8.4","7.3"
"Baldwin","2020-11-02","106","16903","14","1750","9.4","7.5"
"Baldwin","2020-11-03","51","16954","2","1752","8.1","7.7"
"Baldwin","2020-11-04","93","17047","5","1757","7.3","7.4"
"Baldwin","2020-11-05","174","17221","5","1762","7","7.2"
"Baldwin","2020-11-06","159","17380","8","1770","7.4","7.5"
"Baldwin","2020-11-07","68","17448","3","1773","8","7.2"
"Baldwin","2020-11-08","24","17472","1","1774","5.6","7"
"Baldwin","2020-11-09","75","17547","5","1779","4.6","7"
"Baldwin","2020-11-10","69","17616","7","1786","5.5","6.8"
"Baldwin","2020-11-11","69","17685","5","1791","5.8","6.6"
"Baldwin","2020-11-12","62","17747","1","1792","5.6","6.3"
"Baldwin","2020-11-13","272","18019","10","1802","5.4","6.4"
"Baldwin","2020-11-14","58","18077","6","1808","6.3","7.1"
"Baldwin","2020-11-15","48","18125","3","1811","6.6","6.1"
"Baldwin","2020-11-16","113","18238","6","1817","6.4","5.5"
"Baldwin","2020-11-17","72","18310","2","1819","5.3","5.4"
"Baldwin","2020-11-18","129","18439","14","1833","5.8","5.8"
"Baldwin","2020-11-19","93","18532","7","1840","6.7","6.1"
"Baldwin","2020-11-20","107","18639","8","1848","7.2","6.3"
"Baldwin","2020-11-21","56","18695","5","1853","7","6.6"
"Baldwin","2020-11-22","56","18751","5","1858","7.4","7"
"Baldwin","2020-11-23","99","18850","4","1862","7.2","6.8"
"Baldwin","2020-11-24","52","18902","4","1866","7.9","6.6"
"Baldwin","2020-11-25","153","19055","16","1882","7.9","6.8"
"Baldwin","2020-11-26","22","19077","5","1887","10","8.4"
"Baldwin","2020-11-27","167","19244","8","1895","9.7","8.4"
"Baldwin","2020-11-28","50","19294","8","1903","10.7","8.8"
"Baldwin","2020-11-29","73","19367","5","1908","10.4","8.9"
"Baldwin","2020-11-30","113","19480","11","1919","11.2","9.2"
"Baldwin","2020-12-01","72","19552","12","1931","12.5","10.2"
"Baldwin","2020-12-02","104","19656","13","1944","12.8","10.3"
"Baldwin","2020-12-03","86","19742","6","1950","10.5","10.3"
"Baldwin","2020-12-04","163","19905","7","1957","10.4","10"
"Baldwin","2020-12-05","84","19989","2","1959","8.5","9.6"
"Baldwin","2020-12-06","47","20036","8","1967","9.9","10.2"
"Baldwin","2020-12-07","118","20154","14","1981","10.2","10.7"
"Baldwin","2020-12-08","91","20245","6","1987","8.8","10.6"
"Baldwin","2020-12-09","112","20357","14","2001","8.8","10.8"
"Baldwin","2020-12-10","106","20463","5","2006","8.5","9.5"
"Baldwin","2020-12-11","154","20617","12","2018","9","9.7"
"Baldwin","2020-12-12","22","20639","3","2021","10.6","9.5"
"Baldwin","2020-12-13","46","20685","5","2026","9.7","9.8"
"Baldwin","2020-12-14","118","20803","12","2038","9.5","9.9"
"Baldwin","2020-12-15","102","20905","14","2052","10.5","9.6"
"Baldwin","2020-12-16","143","21048","29","2081","11.6","10.2"
"Baldwin","2020-12-17","122","21170","16","2097","12.8","10.6"
"Baldwin","2020-12-18","146","21316","23","2120","13.9","11.5"
"Baldwin","2020-12-19","133","21449","16","2136","13.7","12.1"
"Baldwin","2020-12-20","48","21497","19","2155","17.8","13.8"
"Baldwin","2020-12-21","113","21610","18","2173","18.6","14"
"Baldwin","2020-12-22","79","21689","10","2183","18.5","14.5"
"Baldwin","2020-12-23","210","21899","35","2218","18","14.8"
"Baldwin","2020-12-24","62","21961","12","2230","18.9","15.8"
"Baldwin","2020-12-25","15","21976","4","2234","20.4","17.2"
"Baldwin","2020-12-26","127","22103","18","2252","20.7","17.2"
"Baldwin","2020-12-27","43","22146","16","2268","20.4","19.1"
"Baldwin","2020-12-28","198","22344","31","2299","20.3","19.5"
"Baldwin","2020-12-29","93","22437","13","2312","20.5","19.5"
"Baldwin","2020-12-30","159","22596","38","2350","21.6","19.8"
"Baldwin","2020-12-31","173","22769","12","2362","19.8","19.3"
"Baldwin","2021-01-01","26","22795","9","2371","20.9","20.7"
"Baldwin","2021-01-02","74","22869","17","2388","22.2","21.5"
"Baldwin","2021-01-03","50","22919","7","2395","18.9","19.6"
"Baldwin","2021-01-04","100","23019","23","2418","19.9","20.1"
"Baldwin","2021-01-05","198","23217","27","2445","19.9","20.2"
"Baldwin","2021-01-06","196","23413","27","2472","18.4","20"
"Baldwin","2021-01-07","182","23595","25","2497","19.4","19.6"
"Baldwin","2021-01-08","101","23696","15","2512","16.6","18.7"
"Baldwin","2021-01-09","68","23764","15","2527","16.4","19.3"
"Baldwin","2021-01-10","56","23820","14","2541","18","18.4"
"Baldwin","2021-01-11","163","23983","29","2570","17.3","18.6"
"Baldwin","2021-01-12","172","24155","25","2595","17.4","18.6"
"Baldwin","2021-01-13","109","24264","19","2614","17.9","18.2"
"Baldwin","2021-01-14","173","24437","15","2629","17.2","18.3"
"Baldwin","2021-01-15","151","24588","17","2646","16.7","16.6"
"Baldwin","2021-01-16","52","24640","6","2652","15.2","15.8"
"Baldwin","2021-01-17","48","24688","8","2660","14","16"
"Baldwin","2021-01-18","119","24807","22","2682","14.1","15.7"
"Baldwin","2021-01-19","100","24907","9","2691","13.3","15.3"
"Baldwin","2021-01-20","153","25060","13","2704","12","15"
"Baldwin","2021-01-21","123","25183","16","2720","12.6","14.9"
"Baldwin","2021-01-22","185","25368","28","2748","13.2","14.9"
"Baldwin","2021-01-23","41","25409","13","2761","16.1","15.6"
"Baldwin","2021-01-24","35","25444","5","2766","15.7","14.9"
"Baldwin","2021-01-25","176","25620","30","2796","15.5","14.8"
"Baldwin","2021-01-26","143","25763","19","2815","16.1","14.7"
"Baldwin","2021-01-27","112","25875","28","2843","18.5","15.3"
"Baldwin","2021-01-28","172","26047","12","2855","17.6","15.1"
"Baldwin","2021-01-29","161","26208","25","2880","17.7","15.4"
"Baldwin","2021-01-30","43","26251","12","2892","17.1","16.6"
"Baldwin","2021-01-31","32","26283","7","2899","18.2","17"
"Baldwin","2021-02-01","121","26404","27","2926","19","17.3"
"Baldwin","2021-02-02","104","26508","12","2938","18.7","17.4"
"Baldwin","2021-02-03","104","26612","11","2949","16.7","17.6"
"Baldwin","2021-02-04","143","26755","6","2955","16.3","17"
"Baldwin","2021-02-05","105","26860","8","2963","15.1","16.4"
"Baldwin","2021-02-06","10","26870","1","2964","12.6","14.9"
"Baldwin","2021-02-07","7","26877","0","2964","9.5","13.8"
"Baldwin","2021-02-08","0","26877","0","2964","6.3","12.6"
"Banks","2020-02-01","0","0","0","0",".","."
"Banks","2020-02-02","0","0","0","0",".","."
"Banks","2020-02-03","0","0","0","0",".","."
"Banks","2020-02-04","0","0","0","0",".","."
"Banks","2020-02-05","0","0","0","0",".","."
"Banks","2020-02-06","0","0","0","0",".","."
"Banks","2020-02-07","0","0","0","0","0","."
"Banks","2020-02-08","0","0","0","0","0","."
"Banks","2020-02-09","0","0","0","0","0","."
"Banks","2020-02-10","0","0","0","0","0","."
"Banks","2020-02-11","0","0","0","0","0","."
"Banks","2020-02-12","0","0","0","0","0","."
"Banks","2020-02-13","0","0","0","0","0","."
"Banks","2020-02-14","0","0","0","0","0","0"
"Banks","2020-02-15","0","0","0","0","0","0"
"Banks","2020-02-16","0","0","0","0","0","0"
"Banks","2020-02-17","0","0","0","0","0","0"
"Banks","2020-02-18","0","0","0","0","0","0"
"Banks","2020-02-19","0","0","0","0","0","0"
"Banks","2020-02-20","0","0","0","0","0","0"
"Banks","2020-02-21","0","0","0","0","0","0"
"Banks","2020-02-22","0","0","0","0","0","0"
"Banks","2020-02-23","0","0","0","0","0","0"
"Banks","2020-02-24","0","0","0","0","0","0"
"Banks","2020-02-25","0","0","0","0","0","0"
"Banks","2020-02-26","0","0","0","0","0","0"
"Banks","2020-02-27","0","0","0","0","0","0"
"Banks","2020-02-28","0","0","0","0","0","0"
"Banks","2020-02-29","0","0","0","0","0","0"
"Banks","2020-03-01","0","0","0","0","0","0"
"Banks","2020-03-02","0","0","0","0","0","0"
"Banks","2020-03-03","0","0","0","0","0","0"
"Banks","2020-03-04","0","0","0","0","0","0"
"Banks","2020-03-05","0","0","0","0","0","0"
"Banks","2020-03-06","0","0","0","0","0","0"
"Banks","2020-03-07","0","0","0","0","0","0"
"Banks","2020-03-08","0","0","0","0","0","0"
"Banks","2020-03-09","0","0","0","0","0","0"
"Banks","2020-03-10","0","0","0","0","0","0"
"Banks","2020-03-11","0","0","0","0","0","0"
"Banks","2020-03-12","1","1","0","0","0","0"
"Banks","2020-03-13","0","1","0","0","0","0"
"Banks","2020-03-14","0","1","0","0","0","0"
"Banks","2020-03-15","0","1","0","0","0","0"
"Banks","2020-03-16","3","4","0","0","0","0"
"Banks","2020-03-17","3","7","0","0","0","0"
"Banks","2020-03-18","1","8","0","0","0","0"
"Banks","2020-03-19","3","11","0","0","0","0"
"Banks","2020-03-20","2","13","0","0","0","0"
"Banks","2020-03-21","2","15","0","0","0","0"
"Banks","2020-03-22","2","17","0","0","0","0"
"Banks","2020-03-23","1","18","0","0","0","0"
"Banks","2020-03-24","2","20","0","0","0","0"
"Banks","2020-03-25","4","24","0","0","0","0"
"Banks","2020-03-26","3","27","0","0","0","0"
"Banks","2020-03-27","4","31","0","0","0","0"
"Banks","2020-03-28","1","32","0","0","0","0"
"Banks","2020-03-29","1","33","0","0","0","0"
"Banks","2020-03-30","2","35","0","0","0","0"
"Banks","2020-03-31","3","38","0","0","0","0"
"Banks","2020-04-01","3","41","0","0","0","0"
"Banks","2020-04-02","0","41","0","0","0","0"
"Banks","2020-04-03","0","41","0","0","0","0"
"Banks","2020-04-04","2","43","0","0","0","0"
"Banks","2020-04-05","0","43","0","0","0","0"
"Banks","2020-04-06","1","44","0","0","0","0"
"Banks","2020-04-07","1","45","0","0","0","0"
"Banks","2020-04-08","1","46","0","0","0","0"
"Banks","2020-04-09","0","46","0","0","0","0"
"Banks","2020-04-10","4","50","2","2","7.1","3.6"
"Banks","2020-04-11","3","53","0","2","7.1","3.6"
"Banks","2020-04-12","0","53","0","2","7.1","3.6"
"Banks","2020-04-13","1","54","1","3","21.4","10.7"
"Banks","2020-04-14","4","58","0","3","21.4","10.7"
"Banks","2020-04-15","4","62","0","3","21.4","10.7"
"Banks","2020-04-16","1","63","1","4","35.7","17.9"
"Banks","2020-04-17","3","66","0","4","28.6","17.9"
"Banks","2020-04-18","2","68","0","4","28.6","17.9"
"Banks","2020-04-19","0","68","0","4","28.6","17.9"
"Banks","2020-04-20","6","74","3","7","21.4","21.4"
"Banks","2020-04-21","10","84","0","7","21.4","21.4"
"Banks","2020-04-22","4","88","1","8","25","23.2"
"Banks","2020-04-23","5","93","0","8","10.7","23.2"
"Banks","2020-04-24","9","102","0","8","10.7","19.6"
"Banks","2020-04-25","4","106","0","8","10.7","19.6"
"Banks","2020-04-26","0","106","0","8","10.7","19.6"
"Banks","2020-04-27","1","107","0","8","3.6","12.5"
"Banks","2020-04-28","8","115","1","9","5.4","13.4"
"Banks","2020-04-29","30","145","5","14","4.2","14.6"
"Banks","2020-04-30","30","175","5","19","6.5","8.6"
"Banks","2020-05-01","7","182","0","19","6.5","8.6"
"Banks","2020-05-02","4","186","0","19","6.5","8.6"
"Banks","2020-05-03","3","189","0","19","6.5","8.6"
"Banks","2020-05-04","7","196","0","19","6.5","5.1"
"Banks","2020-05-05","7","203","0","19","4.8","5.1"
"Banks","2020-05-06","4","207","1","20","6","5.1"
"Banks","2020-05-07","4","211","0","20","3.6","5.1"
"Banks","2020-05-08","6","217","0","20","3.6","5.1"
"Banks","2020-05-09","3","220","0","20","3.6","5.1"
"Banks","2020-05-10","1","221","0","20","3.6","5.1"
"Banks","2020-05-11","8","229","0","20","3.6","5.1"
"Banks","2020-05-12","9","238","0","20","3.6","4.2"
"Banks","2020-05-13","10","248","0","20","0","3"
"Banks","2020-05-14","2","250","0","20","0","1.8"
"Banks","2020-05-15","8","258","0","20","0","1.8"
"Banks","2020-05-16","32","290","17","37","7.6","5.6"
"Banks","2020-05-17","5","295","0","37","7.6","5.6"
"Banks","2020-05-18","57","352","18","55","12.1","7.8"
"Banks","2020-05-19","6","358","1","56","14.5","9"
"Banks","2020-05-20","8","366","1","57","16.3","8.1"
"Banks","2020-05-21","8","374","1","58","18.1","9"
"Banks","2020-05-22","7","381","1","59","20.1","10"
"Banks","2020-05-23","5","386","0","59","12.5","10"
"Banks","2020-05-24","0","386","0","59","12.5","10"
"Banks","2020-05-25","2","388","0","59","8","10"
"Banks","2020-05-26","8","396","1","60","7.4","10.9"
"Banks","2020-05-27","10","406","1","61","7","11.7"
"Banks","2020-05-28","5","411","0","61","5.3","11.7"
"Banks","2020-05-29","2","413","0","61","3.2","11.7"
"Banks","2020-05-30","10","423","0","61","3.2","7.9"
"Banks","2020-05-31","1","424","0","61","3.2","7.9"
"Banks","2020-06-01","7","431","0","61","3.2","5.6"
"Banks","2020-06-02","14","445","1","62","2.4","4.9"
"Banks","2020-06-03","9","454","2","64","4.2","5.6"
"Banks","2020-06-04","13","467","0","64","4.2","4.7"
"Banks","2020-06-05","40","507","2","66","4.9","4.1"
"Banks","2020-06-06","5","512","0","66","4.9","4.1"
"Banks","2020-06-07","1","513","0","66","4.9","4.1"
"Banks","2020-06-08","4","517","1","67","8.5","5.8"
"Banks","2020-06-09","13","530","0","67","7.5","5"
"Banks","2020-06-10","44","574","1","68","4.6","4.4"
"Banks","2020-06-11","10","584","0","68","4.6","4.4"
"Banks","2020-06-12","26","610","0","68","3.9","4.4"
"Banks","2020-06-13","14","624","1","69","4.9","4.9"
"Banks","2020-06-14","1","625","0","69","4.9","4.9"
"Banks","2020-06-15","13","638","0","69","1.3","4.9"
"Banks","2020-06-16","5","643","0","69","1.3","4.4"
"Banks","2020-06-17","9","652","1","70","2.6","3.6"
"Banks","2020-06-18","9","661","1","71","4.2","4.4"
"Banks","2020-06-19","8","669","2","73","7.8","5.8"
"Banks","2020-06-20","2","671","0","73","6.7","5.8"
"Banks","2020-06-21","2","673","2","75","21","13"
"Banks","2020-06-22","15","688","2","77","22.9","12.1"
"Banks","2020-06-23","10","698","6","83","31.5","16.4"
"Banks","2020-06-24","7","705","0","83","29.9","16.3"
"Banks","2020-06-25","24","729","3","86","30.1","17.2"
"Banks","2020-06-26","11","740","1","87","27.8","17.8"
"Banks","2020-06-27","26","766","1","88","28.4","17.6"
"Banks","2020-06-28","5","771","0","88","14.1","17.6"
"Banks","2020-06-29","22","793","0","88","12.2","17.6"
"Banks","2020-06-30","20","813","3","91","5.8","18.6"
"Banks","2020-07-01","18","831","2","93","7.4","18.6"
"Banks","2020-07-02","20","851","1","94","6.3","18.2"
"Banks","2020-07-03","6","857","1","95","7.4","17.6"
"Banks","2020-07-04","8","865","2","97","10.4","19.4"
"Banks","2020-07-05","8","873","2","99","14","14"
"Banks","2020-07-06","7","880","2","101","18","15.1"
"Banks","2020-07-07","14","894","4","105","20","12.9"
"Banks","2020-07-08","18","912","1","106","19.2","13.3"
"Banks","2020-07-09","20","932","7","113","23.5","14.9"
"Banks","2020-07-10","15","947","2","115","23","15.2"
"Banks","2020-07-11","4","951","3","118","30.1","20.3"
"Banks","2020-07-12","2","953","0","118","26.6","20.3"
"Banks","2020-07-13","14","967","0","118","22.5","20.3"
"Banks","2020-07-14","16","983","4","122","22","21"
"Banks","2020-07-15","21","1004","5","127","24.6","21.9"
"Banks","2020-07-16","10","1014","2","129","22.4","23"
"Banks","2020-07-17","20","1034","3","132","22.7","22.8"
"Banks","2020-07-18","4","1038","0","132","12","21.1"
"Banks","2020-07-19","7","1045","0","132","12","19.3"
"Banks","2020-07-20","18","1063","5","137","15.9","19.2"
"Banks","2020-07-21","11","1074","3","140","16.3","19.1"
"Banks","2020-07-22","16","1090","4","144","16.4","20.5"
"Banks","2020-07-23","19","1109","10","154","21.1","21.8"
"Banks","2020-07-24","23","1132","3","157","20.8","21.8"
"Banks","2020-07-25","10","1142","1","158","22.2","17.1"
"Banks","2020-07-26","3","1145","0","158","22.2","17.1"
"Banks","2020-07-27","12","1157","2","160","20.7","18.3"
"Banks","2020-07-28","19","1176","3","163","19","17.6"
"Banks","2020-07-29","63","1239","7","170","17","16.7"
"Banks","2020-07-30","12","1251","1","171","10.7","15.9"
"Banks","2020-07-31","12","1263","3","174","12.4","16.6"
"Banks","2020-08-01","4","1267","1","175","14.6","18.4"
"Banks","2020-08-02","8","1275","0","175","14.6","18.4"
"Banks","2020-08-03","16","1291","0","175","12.2","16.4"
"Banks","2020-08-04","53","1344","3","178","10.7","14.9"
"Banks","2020-08-05","20","1364","4","182","12","14.5"
"Banks","2020-08-06","61","1425","3","185","11.5","11.1"
"Banks","2020-08-07","22","1447","2","187","9.2","10.8"
"Banks","2020-08-08","10","1457","2","189","8.5","11.5"
"Banks","2020-08-09","5","1462","2","191","14.2","14.4"
"Banks","2020-08-10","12","1474","2","193","16.6","14.4"
"Banks","2020-08-11","13","1487","3","196","19.1","14.9"
"Banks","2020-08-12","14","1501","0","196","16.3","14.1"
"Banks","2020-08-13","16","1517","2","198","17.3","14.4"
"Banks","2020-08-14","17","1534","4","202","19.4","14.3"
"Banks","2020-08-15","6","1540","2","204","21.3","14.9"
"Banks","2020-08-16","3","1543","2","206","25.1","19.7"
"Banks","2020-08-17","16","1559","4","210","26.3","21.5"
"Banks","2020-08-18","14","1573","2","212","25","22.1"
"Banks","2020-08-19","26","1599","8","220","29.4","22.8"
"Banks","2020-08-20","16","1615","2","222","29.4","23.4"
"Banks","2020-08-21","22","1637","1","223","26.7","23.1"
"Banks","2020-08-22","15","1652","7","230","28.6","25"
"Banks","2020-08-23","7","1659","3","233","25.2","25.2"
"Banks","2020-08-24","17","1676","4","237","25","25.7"
"Banks","2020-08-25","28","1704","4","241","25","25"
"Banks","2020-08-26","27","1731","2","243","21.7","25.6"
"Banks","2020-08-27","16","1747","1","244","20.8","25.1"
"Banks","2020-08-28","26","1773","3","247","21.8","24.3"
"Banks","2020-08-29","23","1796","4","251","17.6","23.1"
"Banks","2020-08-30","8","1804","1","252","13.3","19.3"
"Banks","2020-08-31","16","1820","1","253","10.8","17.9"
"Banks","2020-09-01","18","1838","0","253","8.8","16.9"
"Banks","2020-09-02","12","1850","0","253","7.7","14.7"
"Banks","2020-09-03","20","1870","6","259","11.1","15.9"
"Banks","2020-09-04","20","1890","1","260","10.2","16"
"Banks","2020-09-05","13","1903","1","261","8.8","13.2"
"Banks","2020-09-06","5","1908","2","263","12.7","13"
"Banks","2020-09-07","7","1915","3","266","17.9","14.4"
"Banks","2020-09-08","18","1933","0","266","17.9","13.3"
"Banks","2020-09-09","21","1954","3","269","20","13.8"
"Banks","2020-09-10","64","2018","1","270","15.9","13.5"
"Banks","2020-09-11","23","2041","1","271","15.8","13"
"Banks","2020-09-12","10","2051","3","274","19","13.9"
"Banks","2020-09-13","1","2052","0","274","13.3","13"
"Banks","2020-09-14","22","2074","3","277","9.1","13.5"
"Banks","2020-09-15","14","2088","1","278","10.1","14"
"Banks","2020-09-16","56","2144","2","280","8.6","14.3"
"Banks","2020-09-17","25","2169","2","282","9.5","12.7"
"Banks","2020-09-18","20","2189","1","283","9.6","12.7"
"Banks","2020-09-19","9","2198","0","283","5.3","12.2"
"Banks","2020-09-20","7","2205","1","284","7.4","10.3"
"Banks","2020-09-21","12","2217","1","285","6.6","7.9"
"Banks","2020-09-22","13","2230","3","288","8.9","9.5"
"Banks","2020-09-23","18","2248","5","293","12.4","10.5"
"Banks","2020-09-24","19","2267","2","295","12.7","11.1"
"Banks","2020-09-25","28","2295","1","296","12.5","11.1"
"Banks","2020-09-26","7","2302","2","298","16.6","11"
"Banks","2020-09-27","88","2390","2","300","14.9","11.1"
"Banks","2020-09-28","81","2471","5","305","14.6","10.6"
"Banks","2020-09-29","12","2483","1","306","12.5","10.7"
"Banks","2020-09-30","13","2496","0","306","8.5","10.4"
"Banks","2020-10-01","11","2507","2","308","9.6","11.2"
"Banks","2020-10-02","11","2518","2","310","11.7","12.1"
"Banks","2020-10-03","4","2522","0","310","7.6","12.1"
"Banks","2020-10-04","3","2525","0","310","7.3","11.1"
"Banks","2020-10-05","22","2547","8","318","11.6","13.1"
"Banks","2020-10-06","16","2563","2","320","12.2","12.3"
"Banks","2020-10-07","17","2580","2","322","13.9","11.2"
"Banks","2020-10-08","26","2606","2","324","12.4","11"
"Banks","2020-10-09","27","2633","1","325","10.3","11"
"Banks","2020-10-10","18","2651","1","326","11.1","9.3"
"Banks","2020-10-11","4","2655","1","327","14.7","11"
"Banks","2020-10-12","11","2666","2","329","12.1","11.8"
"Banks","2020-10-13","19","2685","2","331","11.8","12"
"Banks","2020-10-14","23","2708","3","334","12","12.9"
"Banks","2020-10-15","30","2738","2","336","11.8","12.1"
"Banks","2020-10-16","22","2760","0","336","11.3","10.8"
"Banks","2020-10-17","6","2766","0","336","10.5","10.8"
"Banks","2020-10-18","2","2768","1","337","14.1","14.4"
"Banks","2020-10-19","13","2781","0","337","11.5","11.8"
"Banks","2020-10-20","23","2804","5","342","13.1","12.4"
"Banks","2020-10-21","19","2823","4","346","14.2","13.1"
"Banks","2020-10-22","15","2838","1","347","14.2","13"
"Banks","2020-10-23","26","2864","5","352","17","14.1"
"Banks","2020-10-24","11","2875","3","355","20.9","15.7"
"Banks","2020-10-25","4","2879","1","356","17.3","15.7"
"Banks","2020-10-26","19","2898","2","358","18.8","15.1"
"Banks","2020-10-27","25","2923","4","362","18","15.5"
"Banks","2020-10-28","18","2941","4","366","18.1","16.2"
"Banks","2020-10-29","16","2957","2","368","19","16.6"
"Banks","2020-10-30","21","2978","2","370","17.6","17.3"
"Banks","2020-10-31","11","2989","2","372","16.3","18.6"
"Banks","2020-11-01","11","3000","0","372","12.7","15"
"Banks","2020-11-02","20","3020","3","375","13.3","16.1"
"Banks","2020-11-03","25","3045","1","376","11.6","14.8"
"Banks","2020-11-04","14","3059","2","378","10.5","14.3"
"Banks","2020-11-05","54","3113","3","381","9.5","14.2"
"Banks","2020-11-06","29","3142","8","389","12.1","14.8"
"Banks","2020-11-07","11","3153","8","397","19.9","18.1"
"Banks","2020-11-08","13","3166","5","402","25.4","19"
"Banks","2020-11-09","27","3193","2","404","24.3","18.8"
"Banks","2020-11-10","32","3225","5","409","25.9","18.8"
"Banks","2020-11-11","31","3256","9","418","28.1","19.3"
"Banks","2020-11-12","28","3284","9","427","31.9","20.7"
"Banks","2020-11-13","35","3319","10","437","32","22"
"Banks","2020-11-14","21","3340","6","443","25.7","22.8"
"Banks","2020-11-15","18","3358","2","445","21.8","23.6"
"Banks","2020-11-16","49","3407","13","458","24.5","24.4"
"Banks","2020-11-17","48","3455","6","464","24.1","25"
"Banks","2020-11-18","30","3485","5","469","22.3","25.2"
"Banks","2020-11-19","31","3516","6","475","20.5","26.2"
"Banks","2020-11-20","29","3545","8","483","20.3","26.2"
"Banks","2020-11-21","24","3569","8","491","21","23.3"
"Banks","2020-11-22","20","3589","7","498","24.4","23.1"
"Banks","2020-11-23","41","3630","7","505","23.1","23.8"
"Banks","2020-11-24","23","3653","3","508","23.2","23.6"
"Banks","2020-11-25","25","3678","9","517","25.9","24.1"
"Banks","2020-11-26","2","3680","0","517","23.1","21.8"
"Banks","2020-11-27","18","3698","5","522","23.2","21.8"
"Banks","2020-11-28","17","3715","6","528","23.5","22.2"
"Banks","2020-11-29","21","3736","5","533","21.9","23.1"
"Banks","2020-11-30","49","3785","12","545","22.9","23"
"Banks","2020-12-01","52","3837","7","552","23","23.1"
"Banks","2020-12-02","48","3885","14","566","22","24"
"Banks","2020-12-03","52","3937","9","575","24.5","23.8"
"Banks","2020-12-04","50","3987","10","585","23.4","23.3"
"Banks","2020-12-05","22","4009","5","590","21.6","22.5"
"Banks","2020-12-06","12","4021","3","593","21.7","21.8"
"Banks","2020-12-07","77","4098","5","598","19.2","21"
"Banks","2020-12-08","42","4140","7","605","19.6","21.3"
"Banks","2020-12-09","77","4217","13","618","17.9","19.9"
"Banks","2020-12-10","56","4273","5","623","16.7","20.6"
"Banks","2020-12-11","51","4324","15","638","18","20.7"
"Banks","2020-12-12","20","4344","4","642","17.6","19.6"
"Banks","2020-12-13","13","4357","5","647","19.5","20.6"
"Banks","2020-12-14","76","4433","18","665","22","20.6"
"Banks","2020-12-15","75","4508","13","678","22.1","20.9"
"Banks","2020-12-16","132","4640","15","693","21.3","19.6"
"Banks","2020-12-17","121","4761","10","703","21.2","18.9"
"Banks","2020-12-18","63","4824","18","721","21.1","19.6"
"Banks","2020-12-19","17","4841","4","725","21.6","19.6"
"Banks","2020-12-20","19","4860","4","729","19.1","19.3"
"Banks","2020-12-21","53","4913","12","741","19","20.5"
"Banks","2020-12-22","51","4964","6","747","18.2","20.1"
"Banks","2020-12-23","44","5008","3","750","17.5","19.4"
"Banks","2020-12-24","24","5032","13","763","24.1","22.6"
"Banks","2020-12-25","2","5034","0","763","20","20.5"
"Banks","2020-12-26","24","5058","4","767","19","20.3"
"Banks","2020-12-27","19","5077","9","776","22.8","20.9"
"Banks","2020-12-28","61","5138","12","788","22.4","20.7"
"Banks","2020-12-29","69","5207","21","809","25","21.6"
"Banks","2020-12-30","62","5269","16","825","27.7","22.6"
"Banks","2020-12-31","51","5320","9","834","22.5","23.3"
"Banks","2021-01-01","9","5329","3","837","27.3","23.6"
"Banks","2021-01-02","23","5352","3","840","26.8","22.9"
"Banks","2021-01-03","27","5379","11","851","25.8","24.3"
"Banks","2021-01-04","80","5459","20","871","26.6","24.5"
"Banks","2021-01-05","74","5533","19","890","25.9","25.5"
"Banks","2021-01-06","129","5662","26","916","25.1","26.4"
"Banks","2021-01-07","75","5737","16","932","25.6","24.1"
"Banks","2021-01-08","55","5792","6","938","22.4","24.8"
"Banks","2021-01-09","34","5826","9","947","24.3","25.5"
"Banks","2021-01-10","27","5853","7","954","22.2","24"
"Banks","2021-01-11","45","5898","8","962","21.2","23.9"
"Banks","2021-01-12","34","5932","11","973","22.1","24"
"Banks","2021-01-13","52","5984","13","986","22.8","24"
"Banks","2021-01-14","50","6034","13","999","23.5","24.6"
"Banks","2021-01-15","40","6074","7","1006","24.4","23.4"
"Banks","2021-01-16","24","6098","3","1009","22.4","23.4"
"Banks","2021-01-17","27","6125","5","1014","21.4","21.8"
"Banks","2021-01-18","32","6157","4","1018","20.6","20.9"
"Banks","2021-01-19","31","6188","2","1020","16.9","19.5"
"Banks","2021-01-20","35","6223","5","1025","15.4","19.1"
"Banks","2021-01-21","31","6254","7","1032","14.9","19.2"
"Banks","2021-01-22","40","6294","6","1038","14.5","19.5"
"Banks","2021-01-23","10","6304","2","1040","15.6","19"
"Banks","2021-01-24","14","6318","5","1045","18.1","19.7"
"Banks","2021-01-25","36","6354","5","1050","18.3","19.4"
"Banks","2021-01-26","33","6387","2","1052","18.2","17.6"
"Banks","2021-01-27","38","6425","9","1061","19.6","17.5"
"Banks","2021-01-28","42","6467","6","1067","18.4","16.6"
"Banks","2021-01-29","24","6491","3","1070","18","16.3"
"Banks","2021-01-30","5","6496","0","1070","15.2","15.4"
"Banks","2021-01-31","12","6508","2","1072","12.4","15.3"
"Banks","2021-02-01","42","6550","6","1078","12.5","15.4"
"Banks","2021-02-02","42","6592","6","1084","13.7","15.9"
"Banks","2021-02-03","36","6628","7","1091","13.1","16.3"
"Banks","2021-02-04","48","6676","4","1095","12.2","15.3"
"Banks","2021-02-05","21","6697","4","1099","13.2","15.6"
"Banks","2021-02-06","4","6701","0","1099","13.2","14.2"
"Banks","2021-02-07","0","6701","0","1099","10.8","11.6"
"Banks","2021-02-08","0","6701","0","1099","8.7","10.6"
"Barrow","2020-02-01","0","0","0","0",".","."
"Barrow","2020-02-02","0","0","0","0",".","."
"Barrow","2020-02-03","0","0","0","0",".","."
"Barrow","2020-02-04","0","0","0","0",".","."
"Barrow","2020-02-05","0","0","0","0",".","."
"Barrow","2020-02-06","0","0","0","0",".","."
"Barrow","2020-02-07","0","0","0","0","0","."
"Barrow","2020-02-08","0","0","0","0","0","."
"Barrow","2020-02-09","0","0","0","0","0","."
"Barrow","2020-02-10","0","0","0","0","0","."
"Barrow","2020-02-11","0","0","0","0","0","."
"Barrow","2020-02-12","0","0","0","0","0","."
"Barrow","2020-02-13","0","0","0","0","0","."
"Barrow","2020-02-14","0","0","0","0","0","0"
"Barrow","2020-02-15","0","0","0","0","0","0"
"Barrow","2020-02-16","0","0","0","0","0","0"
"Barrow","2020-02-17","0","0","0","0","0","0"
"Barrow","2020-02-18","0","0","0","0","0","0"
"Barrow","2020-02-19","0","0","0","0","0","0"
"Barrow","2020-02-20","0","0","0","0","0","0"
"Barrow","2020-02-21","0","0","0","0","0","0"
"Barrow","2020-02-22","0","0","0","0","0","0"
"Barrow","2020-02-23","0","0","0","0","0","0"
"Barrow","2020-02-24","0","0","0","0","0","0"
"Barrow","2020-02-25","0","0","0","0","0","0"
"Barrow","2020-02-26","0","0","0","0","0","0"
"Barrow","2020-02-27","0","0","0","0","0","0"
"Barrow","2020-02-28","0","0","0","0","0","0"
"Barrow","2020-02-29","0","0","0","0","0","0"
"Barrow","2020-03-01","0","0","0","0","0","0"
"Barrow","2020-03-02","0","0","0","0","0","0"
"Barrow","2020-03-03","0","0","0","0","0","0"
"Barrow","2020-03-04","0","0","0","0","0","0"
"Barrow","2020-03-05","0","0","0","0","0","0"
"Barrow","2020-03-06","0","0","0","0","0","0"
"Barrow","2020-03-07","0","0","0","0","0","0"
"Barrow","2020-03-08","0","0","0","0","0","0"
"Barrow","2020-03-09","0","0","0","0","0","0"
"Barrow","2020-03-10","0","0","0","0","0","0"
"Barrow","2020-03-11","0","0","0","0","0","0"
"Barrow","2020-03-12","2","2","0","0","0","0"
"Barrow","2020-03-13","5","7","0","0","0","0"
"Barrow","2020-03-14","1","8","0","0","0","0"
"Barrow","2020-03-15","0","8","0","0","0","0"
"Barrow","2020-03-16","12","20","0","0","0","0"
"Barrow","2020-03-17","17","37","2","2","1.7","0.8"
"Barrow","2020-03-18","18","55","1","3","2.5","1.2"
"Barrow","2020-03-19","24","79","3","6","4.3","2.1"
"Barrow","2020-03-20","29","108","1","7","4.8","2.4"
"Barrow","2020-03-21","8","116","1","8","6.5","3.3"
"Barrow","2020-03-22","8","124","0","8","6.5","3.3"
"Barrow","2020-03-23","14","138","0","8","6.5","3.3"
"Barrow","2020-03-24","23","161","1","9","5.5","3.6"
"Barrow","2020-03-25","22","183","2","11","6","4.2"
"Barrow","2020-03-26","21","204","1","12","4.9","4.6"
"Barrow","2020-03-27","12","216","2","14","6.8","5.8"
"Barrow","2020-03-28","1","217","1","15","19.3","12.9"
"Barrow","2020-03-29","2","219","0","15","19.3","12.9"
"Barrow","2020-03-30","19","238","1","16","20","13.3"
"Barrow","2020-03-31","10","248","0","16","19.4","12.4"
"Barrow","2020-04-01","15","263","0","16","18.1","12"
"Barrow","2020-04-02","9","272","0","16","17.4","11.1"
"Barrow","2020-04-03","6","278","2","18","19.8","13.3"
"Barrow","2020-04-04","8","286","1","19","7.3","13.3"
"Barrow","2020-04-05","2","288","0","19","7.3","13.3"
"Barrow","2020-04-06","12","300","0","19","6.5","13.3"
"Barrow","2020-04-07","9","309","0","19","6.5","13"
"Barrow","2020-04-08","13","322","1","20","7.6","12.9"
"Barrow","2020-04-09","18","340","4","24","10.8","14.1"
"Barrow","2020-04-10","10","350","2","26","8.9","14.4"
"Barrow","2020-04-11","6","356","1","27","9.5","8.4"
"Barrow","2020-04-12","3","359","0","27","9.5","8.4"
"Barrow","2020-04-13","21","380","3","30","11.6","9.1"
"Barrow","2020-04-14","18","398","2","32","13.1","9.8"
"Barrow","2020-04-15","27","425","6","38","15.2","11.4"
"Barrow","2020-04-16","35","460","4","42","13.7","12.2"
"Barrow","2020-04-17","17","477","3","45","13.3","11.1"
"Barrow","2020-04-18","4","481","2","47","18.1","13.8"
"Barrow","2020-04-19","8","489","0","47","18.1","13.8"
"Barrow","2020-04-20","38","527","1","48","16.4","14"
"Barrow","2020-04-21","31","558","4","52","16.7","14.9"
"Barrow","2020-04-22","30","588","4","56","15.4","15.3"
"Barrow","2020-04-23","29","617","1","57","14.3","14"
"Barrow","2020-04-24","31","648","2","59","12.7","13"
"Barrow","2020-04-25","14","662","4","63","9.6","13.9"
"Barrow","2020-04-26","6","668","0","63","9.6","13.9"
"Barrow","2020-04-27","20","688","1","64","10","13.2"
"Barrow","2020-04-28","23","711","2","66","9.4","13"
"Barrow","2020-04-29","47","758","14","80","11.7","13.6"
"Barrow","2020-04-30","44","802","2","82","11.9","13.1"
"Barrow","2020-05-01","71","873","2","84","11.3","12"
"Barrow","2020-05-02","15","888","1","85","8.2","8.9"
"Barrow","2020-05-03","15","903","0","85","8.2","8.9"
"Barrow","2020-05-04","34","937","1","86","7.9","8.9"
"Barrow","2020-05-05","39","976","1","87","7","8.2"
"Barrow","2020-05-06","44","1020","3","90","3.8","7.7"
"Barrow","2020-05-07","34","1054","1","91","3.5","7.7"
"Barrow","2020-05-08","35","1089","2","93","3.9","7.6"
"Barrow","2020-05-09","15","1104","3","96","5.9","7"
"Barrow","2020-05-10","8","1112","1","97","7.6","7.9"
"Barrow","2020-05-11","35","1147","1","98","7.6","7.8"
"Barrow","2020-05-12","27","1174","0","98","7.3","7.2"
"Barrow","2020-05-13","34","1208","1","99","6.7","5.2"
"Barrow","2020-05-14","34","1242","1","100","6.7","5.1"
"Barrow","2020-05-15","45","1287","1","101","6.2","5.1"
"Barrow","2020-05-16","19","1306","1","102","4.1","5"
"Barrow","2020-05-17","10","1316","1","103","3.7","5.7"
"Barrow","2020-05-18","44","1360","3","106","4.3","6"
"Barrow","2020-05-19","70","1430","7","113","5.7","6.5"
"Barrow","2020-05-20","56","1486","0","113","5.3","6"
"Barrow","2020-05-21","89","1575","2","115","5.2","6"
"Barrow","2020-05-22","32","1607","3","118","6.2","6.2"
"Barrow","2020-05-23","15","1622","0","118","5.5","4.8"
"Barrow","2020-05-24","15","1637","1","119","5","4.4"
"Barrow","2020-05-25","12","1649","0","119","4","4.2"
"Barrow","2020-05-26","57","1706","3","122","3.4","4.6"
"Barrow","2020-05-27","60","1766","3","125","4.1","4.7"
"Barrow","2020-05-28","40","1806","1","126","4.1","4.7"
"Barrow","2020-05-29","39","1845","1","127","3.1","4.7"
"Barrow","2020-05-30","29","1874","0","127","3.1","4.3"
"Barrow","2020-05-31","16","1890","3","130","4.9","4.9"
"Barrow","2020-06-01","58","1948","4","134","5.9","4.9"
"Barrow","2020-06-02","69","2017","3","137","5.7","4.5"
"Barrow","2020-06-03","43","2060","4","141","6.3","5.2"
"Barrow","2020-06-04","66","2126","7","148","7.5","5.8"
"Barrow","2020-06-05","59","2185","4","152","8.1","5.6"
"Barrow","2020-06-06","28","2213","1","153","8.6","5.9"
"Barrow","2020-06-07","14","2227","3","156","9","6.9"
"Barrow","2020-06-08","51","2278","6","162","9.7","7.8"
"Barrow","2020-06-09","46","2324","4","166","10.3","8"
"Barrow","2020-06-10","54","2378","3","169","9.8","8.1"
"Barrow","2020-06-11","92","2470","4","173","8.9","8.2"
"Barrow","2020-06-12","47","2517","5","178","9.4","8.8"
"Barrow","2020-06-13","32","2549","2","180","9.8","9.2"
"Barrow","2020-06-14","25","2574","4","184","9","9"
"Barrow","2020-06-15","71","2645","6","190","8.6","9.1"
"Barrow","2020-06-16","84","2729","3","193","7.8","9.1"
"Barrow","2020-06-17","74","2803","9","202","8.8","9.3"
"Barrow","2020-06-18","70","2873","8","210","9.8","9.3"
"Barrow","2020-06-19","85","2958","2","212","8.6","9"
"Barrow","2020-06-20","85","3043","6","218","8.7","9.3"
"Barrow","2020-06-21","30","3073","3","221","7.9","8.4"
"Barrow","2020-06-22","87","3160","5","226","7.5","8"
"Barrow","2020-06-23","50","3210","8","234","9.2","8.5"
"Barrow","2020-06-24","189","3399","50","284","11.3","10"
"Barrow","2020-06-25","144","3543","13","297","10.9","10.4"
"Barrow","2020-06-26","107","3650","7","304","11.5","10.1"
"Barrow","2020-06-27","101","3751","7","311","11.5","10.1"
"Barrow","2020-06-28","25","3776","3","314","11.8","9.8"
"Barrow","2020-06-29","140","3916","18","332","12.8","10.2"
"Barrow","2020-06-30","121","4037","8","340","11.5","10.4"
"Barrow","2020-07-01","100","4137","14","354","9.7","10.5"
"Barrow","2020-07-02","109","4246","13","367","10.1","10.5"
"Barrow","2020-07-03","76","4322","7","374","10.5","11"
"Barrow","2020-07-04","43","4365","2","376","10.2","10.9"
"Barrow","2020-07-05","62","4427","7","383","10.1","10.9"
"Barrow","2020-07-06","190","4617","42","425","11.4","12.1"
"Barrow","2020-07-07","172","4789","25","450","12.5","12"
"Barrow","2020-07-08","144","4933","26","476","13.1","11.4"
"Barrow","2020-07-09","138","5071","21","497","13.6","11.9"
"Barrow","2020-07-10","153","5224","25","522","14.6","12.6"
"Barrow","2020-07-11","31","5255","3","525","15.3","12.7"
"Barrow","2020-07-12","20","5275","1","526","14.4","12.2"
"Barrow","2020-07-13","161","5436","31","557","14","12.7"
"Barrow","2020-07-14","119","5555","20","577","14.3","13.4"
"Barrow","2020-07-15","133","5688","20","597","13.9","13.5"
"Barrow","2020-07-16","105","5793","14","611","13.6","13.6"
"Barrow","2020-07-17","123","5916","18","629","13.4","14"
"Barrow","2020-07-18","56","5972","13","642","15.3","15.3"
"Barrow","2020-07-19","54","6026","6","648","16.2","15.3"
"Barrow","2020-07-20","113","6139","26","674","16.7","15.4"
"Barrow","2020-07-21","88","6227","13","687","16.4","15.4"
"Barrow","2020-07-22","81","6308","3","690","14.8","14.4"
"Barrow","2020-07-23","64","6372","6","696","14.3","13.9"
"Barrow","2020-07-24","124","6496","19","715","14.4","13.9"
"Barrow","2020-07-25","45","6541","10","725","14.2","14.8"
"Barrow","2020-07-26","37","6578","2","727","13.4","14.8"
"Barrow","2020-07-27","96","6674","18","745","12.8","14.8"
"Barrow","2020-07-28","116","6790","13","758","12.3","14.4"
"Barrow","2020-07-29","121","6911","25","783","14.7","14.8"
"Barrow","2020-07-30","90","7001","15","798","15.7","15"
"Barrow","2020-07-31","116","7117","24","822","16.5","15.4"
"Barrow","2020-08-01","64","7181","3","825","14","14.1"
"Barrow","2020-08-02","33","7214","5","830","15.4","14.4"
"Barrow","2020-08-03","108","7322","17","847","15","13.9"
"Barrow","2020-08-04","67","7389","8","855","15.1","13.7"
"Barrow","2020-08-05","109","7498","8","863","13.2","13.9"
"Barrow","2020-08-06","87","7585","11","874","12.6","14.2"
"Barrow","2020-08-07","106","7691","8","882","10.7","13.6"
"Barrow","2020-08-08","63","7754","10","892","12.3","13.2"
"Barrow","2020-08-09","34","7788","6","898","12.7","14"
"Barrow","2020-08-10","112","7900","19","917","12.9","13.9"
"Barrow","2020-08-11","92","7992","8","925","12.4","13.7"
"Barrow","2020-08-12","101","8093","14","939","13.3","13.2"
"Barrow","2020-08-13","82","8175","9","948","13.1","12.8"
"Barrow","2020-08-14","91","8266","6","954","12.9","11.8"
"Barrow","2020-08-15","56","8322","4","958","11.7","12"
"Barrow","2020-08-16","37","8359","4","962","10.7","11.7"
"Barrow","2020-08-17","107","8466","10","972","9.6","11.2"
"Barrow","2020-08-18","103","8569","18","990","10.9","11.6"
"Barrow","2020-08-19","83","8652","17","1007","11.8","12.6"
"Barrow","2020-08-20","74","8726","8","1015","11.8","12.4"
"Barrow","2020-08-21","91","8817","8","1023","12.1","12.5"
"Barrow","2020-08-22","42","8859","8","1031","13.8","12.8"
"Barrow","2020-08-23","35","8894","3","1034","13.5","12.1"
"Barrow","2020-08-24","97","8991","16","1050","14.5","12.1"
"Barrow","2020-08-25","75","9066","4","1054","12.8","11.8"
"Barrow","2020-08-26","71","9137","5","1059","10.9","11.4"
"Barrow","2020-08-27","81","9218","14","1073","11.8","11.8"
"Barrow","2020-08-28","84","9302","6","1079","11.6","11.8"
"Barrow","2020-08-29","51","9353","8","1087","11.1","12.5"
"Barrow","2020-08-30","32","9385","5","1092","12.1","12.8"
"Barrow","2020-08-31","67","9452","10","1102","11.9","13.2"
"Barrow","2020-09-01","93","9545","20","1122","14.2","13.5"
"Barrow","2020-09-02","73","9618","7","1129","14.5","12.7"
"Barrow","2020-09-03","117","9735","4","1133","12.6","12.2"
"Barrow","2020-09-04","133","9868","9","1142","12.5","12"
"Barrow","2020-09-05","47","9915","6","1148","12.1","11.6"
"Barrow","2020-09-06","37","9952","9","1157","13.3","12.7"
"Barrow","2020-09-07","30","9982","1","1158","11.7","11.8"
"Barrow","2020-09-08","137","10119","8","1166","9.4","11.8"
"Barrow","2020-09-09","109","10228","11","1177","9.5","12"
"Barrow","2020-09-10","131","10359","13","1190","10.4","11.5"
"Barrow","2020-09-11","90","10449","3","1193","9.9","11.2"
"Barrow","2020-09-12","37","10486","6","1199","10.4","11.3"
"Barrow","2020-09-13","33","10519","3","1202","8.3","10.8"
"Barrow","2020-09-14","107","10626","7","1209","8.7","10.2"
"Barrow","2020-09-15","106","10732","10","1219","9.2","9.3"
"Barrow","2020-09-16","122","10854","8","1227","8.7","9.1"
"Barrow","2020-09-17","93","10947","4","1231","7.9","9.2"
"Barrow","2020-09-18","94","11041","5","1236","8.2","9.1"
"Barrow","2020-09-19","59","11100","9","1245","8.1","9.3"
"Barrow","2020-09-20","43","11143","4","1249","8.1","8.2"
"Barrow","2020-09-21","102","11245","7","1256","8.1","8.4"
"Barrow","2020-09-22","91","11336","7","1263","7.9","8.6"
"Barrow","2020-09-23","108","11444","5","1268","7.6","8.2"
"Barrow","2020-09-24","93","11537","7","1275","8.1","8"
"Barrow","2020-09-25","129","11666","15","1290","9","8.6"
"Barrow","2020-09-26","41","11707","0","1290","6.8","7.4"
"Barrow","2020-09-27","42","11749","3","1293","6.5","7.3"
"Barrow","2020-09-28","120","11869","7","1300","6.4","7.2"
"Barrow","2020-09-29","114","11983","7","1307","6.1","7"
"Barrow","2020-09-30","107","12090","5","1312","6.1","6.9"
"Barrow","2020-10-01","101","12191","8","1320","6.2","7.1"
"Barrow","2020-10-02","112","12303","8","1328","5.6","7.3"
"Barrow","2020-10-03","50","12353","5","1333","7","6.9"
"Barrow","2020-10-04","51","12404","2","1335","6.5","6.5"
"Barrow","2020-10-05","132","12536","11","1346","6.9","6.6"
"Barrow","2020-10-06","117","12653","2","1348","6.2","6.2"
"Barrow","2020-10-07","153","12806","6","1354","6.1","6.1"
"Barrow","2020-10-08","125","12931","10","1364","6.1","6.2"
"Barrow","2020-10-09","127","13058","9","1373","6.1","5.8"
"Barrow","2020-10-10","70","13128","4","1377","5.5","6.3"
"Barrow","2020-10-11","49","13177","5","1382","6.4","6.5"
"Barrow","2020-10-12","127","13304","19","1401","7.4","7.1"
"Barrow","2020-10-13","148","13452","8","1409","7.9","7.1"
"Barrow","2020-10-14","136","13588","6","1415","8","7.1"
"Barrow","2020-10-15","115","13703","18","1433","9.1","7.6"
"Barrow","2020-10-16","92","13795","9","1442","9.4","7.8"
"Barrow","2020-10-17","61","13856","5","1447","9.8","7.7"
"Barrow","2020-10-18","40","13896","8","1455","11.2","8.8"
"Barrow","2020-10-19","137","14033","12","1467","10.3","8.8"
"Barrow","2020-10-20","103","14136","13","1480","11.3","9.6"
"Barrow","2020-10-21","149","14285","9","1489","11.6","9.8"
"Barrow","2020-10-22","157","14442","13","1502","10.5","9.8"
"Barrow","2020-10-23","96","14538","11","1513","10.8","10.1"
"Barrow","2020-10-24","40","14578","8","1521","12.5","11.1"
"Barrow","2020-10-25","40","14618","6","1527","11.7","11.5"
"Barrow","2020-10-26","161","14779","13","1540","11.6","11"
"Barrow","2020-10-27","156","14935","17","1557","11.4","11.4"
"Barrow","2020-10-28","129","15064","14","1571","12.1","11.8"
"Barrow","2020-10-29","129","15193","13","1584","12.3","11.4"
"Barrow","2020-10-30","159","15352","17","1601","12.2","11.5"
"Barrow","2020-10-31","62","15414","6","1607","10.8","11.6"
"Barrow","2020-11-01","43","15457","3","1610","9.6","10.7"
"Barrow","2020-11-02","148","15605","9","1619","9.3","10.5"
"Barrow","2020-11-03","160","15765","6","1625","8.3","9.8"
"Barrow","2020-11-04","118","15883","7","1632","7.6","9.8"
"Barrow","2020-11-05","120","16003","5","1637","6.8","9.5"
"Barrow","2020-11-06","104","16107","7","1644","6.2","9.2"
"Barrow","2020-11-07","55","16162","11","1655","7.7","9.2"
"Barrow","2020-11-08","55","16217","6","1661","8.2","8.9"
"Barrow","2020-11-09","158","16375","18","1679","9","9.2"
"Barrow","2020-11-10","152","16527","18","1697","10.1","9.2"
"Barrow","2020-11-11","173","16700","14","1711","10.4","9"
"Barrow","2020-11-12","137","16837","14","1725","11.3","9"
"Barrow","2020-11-13","123","16960","16","1741","12.2","9.2"
"Barrow","2020-11-14","98","17058","18","1759","12","9.8"
"Barrow","2020-11-15","59","17117","5","1764","11.6","9.9"
"Barrow","2020-11-16","219","17336","35","1799","12.3","10.6"
"Barrow","2020-11-17","185","17521","16","1815","11.8","11"
"Barrow","2020-11-18","205","17726","20","1835","12.1","11.3"
"Barrow","2020-11-19","178","17904","16","1851","11.9","11.6"
"Barrow","2020-11-20","192","18096","21","1872","11.6","11.9"
"Barrow","2020-11-21","95","18191","8","1880","10.2","11.1"
"Barrow","2020-11-22","68","18259","16","1896","12.3","12"
"Barrow","2020-11-23","200","18459","29","1925","12.1","12.2"
"Barrow","2020-11-24","181","18640","26","1951","12.9","12.4"
"Barrow","2020-11-25","206","18846","23","1974","13.1","12.6"
"Barrow","2020-11-26","18","18864","2","1976","13.4","12.7"
"Barrow","2020-11-27","166","19030","36","2012","15","13.3"
"Barrow","2020-11-28","94","19124","13","2025","15.7","13"
"Barrow","2020-11-29","78","19202","14","2039","14.9","13.6"
"Barrow","2020-11-30","274","19476","59","2098","15.9","14"
"Barrow","2020-12-01","251","19727","45","2143","16.5","14.7"
"Barrow","2020-12-02","228","19955","35","2178","17.1","15.1"
"Barrow","2020-12-03","242","20197","35","2213","17.5","15.5"
"Barrow","2020-12-04","221","20418","31","2244","16.4","15.7"
"Barrow","2020-12-05","140","20558","39","2283","18.4","17.1"
"Barrow","2020-12-06","118","20676","30","2313","19.5","17.2"
"Barrow","2020-12-07","251","20927","57","2370","19.7","17.8"
"Barrow","2020-12-08","297","21224","40","2410","19","17.8"
"Barrow","2020-12-09","270","21494","45","2455","19.2","18.1"
"Barrow","2020-12-10","266","21760","53","2508","20","18.8"
"Barrow","2020-12-11","267","22027","52","2560","20.8","18.6"
"Barrow","2020-12-12","161","22188","42","2602","20.5","19.5"
"Barrow","2020-12-13","114","22302","27","2629","20.3","19.9"
"Barrow","2020-12-14","271","22573","64","2693","20.4","20"
"Barrow","2020-12-15","289","22862","49","2742","20.9","20"
"Barrow","2020-12-16","305","23167","60","2802","21.3","20.3"
"Barrow","2020-12-17","288","23455","47","2849","20.8","20.4"
"Barrow","2020-12-18","279","23734","70","2919","21.6","21.2"
"Barrow","2020-12-19","142","23876","33","2952","21.2","20.9"
"Barrow","2020-12-20","121","23997","25","2977","20.8","20.5"
"Barrow","2020-12-21","320","24317","76","3053","20.8","20.6"
"Barrow","2020-12-22","308","24625","81","3134","22.1","21.5"
"Barrow","2020-12-23","295","24920","67","3201","22.6","22"
"Barrow","2020-12-24","155","25075","49","3250","24.8","22.8"
"Barrow","2020-12-25","25","25100","4","3254","23.5","22.5"
"Barrow","2020-12-26","137","25237","47","3301","25","23.1"
"Barrow","2020-12-27","109","25346","34","3335","26.6","23.7"
"Barrow","2020-12-28","318","25664","88","3423","27.1","24"
"Barrow","2020-12-29","334","25998","116","3539","28.3","25.2"
"Barrow","2020-12-30","318","26316","97","3636","29.4","26"
"Barrow","2020-12-31","209","26525","61","3697","29.1","26.9"
"Barrow","2021-01-01","74","26599","27","3724","32","27.7"
"Barrow","2021-01-02","114","26713","32","3756","31.1","28.1"
"Barrow","2021-01-03","105","26818","37","3793","31.7","29.1"
"Barrow","2021-01-04","277","27095","71","3864","31.4","29.3"
"Barrow","2021-01-05","377","27472","113","3977","30.7","29.5"
"Barrow","2021-01-06","417","27889","118","4095","30.4","29.9"
"Barrow","2021-01-07","383","28272","102","4197","30","29.6"
"Barrow","2021-01-08","362","28634","99","4296","28.7","30.4"
"Barrow","2021-01-09","183","28817","49","4345","28.6","29.8"
"Barrow","2021-01-10","148","28965","53","4398","28.6","30.2"
"Barrow","2021-01-11","310","29275","87","4485","29","30.2"
"Barrow","2021-01-12","284","29559","64","4549","27.9","29.3"
"Barrow","2021-01-13","287","29846","70","4619","27.4","28.9"
"Barrow","2021-01-14","271","30117","61","4680","26.8","28.4"
"Barrow","2021-01-15","293","30410","80","4760","26.8","27.8"
"Barrow","2021-01-16","186","30596","41","4801","26.1","27.3"
"Barrow","2021-01-17","139","30735","42","4843","25.3","27"
"Barrow","2021-01-18","275","31010","55","4898","24.1","26.6"
"Barrow","2021-01-19","334","31344","84","4982","24.5","26.2"
"Barrow","2021-01-20","287","31631","56","5038","23.8","25.6"
"Barrow","2021-01-21","277","31908","64","5102","23.9","25.3"
"Barrow","2021-01-22","285","32193","57","5159","22.9","24.8"
"Barrow","2021-01-23","148","32341","45","5204","24.1","25.1"
"Barrow","2021-01-24","124","32465","35","5239","23.8","24.5"
"Barrow","2021-01-25","282","32747","51","5290","23.5","23.8"
"Barrow","2021-01-26","280","33027","61","5351","23","23.8"
"Barrow","2021-01-27","277","33304","43","5394","22.4","23.1"
"Barrow","2021-01-28","256","33560","53","5447","22.1","23"
"Barrow","2021-01-29","246","33806","40","5487","21.6","22.2"
"Barrow","2021-01-30","156","33962","35","5522","20.4","22.2"
"Barrow","2021-01-31","107","34069","19","5541","18.9","21.4"
"Barrow","2021-02-01","265","34334","35","5576","18.2","20.9"
"Barrow","2021-02-02","212","34546","29","5605","17.1","20"
"Barrow","2021-02-03","181","34727","22","5627","16.6","19.5"
"Barrow","2021-02-04","207","34934","29","5656","15.6","18.9"
"Barrow","2021-02-05","114","35048","21","5677","16","18.8"
"Barrow","2021-02-06","30","35078","3","5680","14.2","17.3"
"Barrow","2021-02-07","5","35083","1","5681","14.5","16.7"
"Barrow","2021-02-08","0","35083","0","5681","12.6","15.4"
"Bartow","2020-02-01","0","0","0","0",".","."
"Bartow","2020-02-02","0","0","0","0",".","."
"Bartow","2020-02-03","0","0","0","0",".","."
"Bartow","2020-02-04","0","0","0","0",".","."
"Bartow","2020-02-05","0","0","0","0",".","."
"Bartow","2020-02-06","0","0","0","0",".","."
"Bartow","2020-02-07","0","0","0","0","0","."
"Bartow","2020-02-08","0","0","0","0","0","."
"Bartow","2020-02-09","0","0","0","0","0","."
"Bartow","2020-02-10","0","0","0","0","0","."
"Bartow","2020-02-11","0","0","0","0","0","."
"Bartow","2020-02-12","0","0","0","0","0","."
"Bartow","2020-02-13","0","0","0","0","0","."
"Bartow","2020-02-14","0","0","0","0","0","0"
"Bartow","2020-02-15","0","0","0","0","0","0"
"Bartow","2020-02-16","0","0","0","0","0","0"
"Bartow","2020-02-17","0","0","0","0","0","0"
"Bartow","2020-02-18","0","0","0","0","0","0"
"Bartow","2020-02-19","0","0","0","0","0","0"
"Bartow","2020-02-20","0","0","0","0","0","0"
"Bartow","2020-02-21","0","0","0","0","0","0"
"Bartow","2020-02-22","0","0","0","0","0","0"
"Bartow","2020-02-23","0","0","0","0","0","0"
"Bartow","2020-02-24","0","0","0","0","0","0"
"Bartow","2020-02-25","0","0","0","0","0","0"
"Bartow","2020-02-26","0","0","0","0","0","0"
"Bartow","2020-02-27","0","0","0","0","0","0"
"Bartow","2020-02-28","0","0","0","0","0","0"
"Bartow","2020-02-29","0","0","0","0","0","0"
"Bartow","2020-03-01","0","0","0","0","0","0"
"Bartow","2020-03-02","0","0","0","0","0","0"
"Bartow","2020-03-03","0","0","0","0","0","0"
"Bartow","2020-03-04","0","0","0","0","0","0"
"Bartow","2020-03-05","0","0","0","0","0","0"
"Bartow","2020-03-06","4","4","2","2","7.1","3.6"
"Bartow","2020-03-07","2","6","0","2","7.1","3.6"
"Bartow","2020-03-08","0","6","0","2","7.1","3.6"
"Bartow","2020-03-09","3","9","2","4","16.7","8.3"
"Bartow","2020-03-10","11","20","3","7","20.6","10.3"
"Bartow","2020-03-11","6","26","4","11","30.1","15"
"Bartow","2020-03-12","22","48","14","25","39.2","19.6"
"Bartow","2020-03-13","33","81","18","43","39.8","23.5"
"Bartow","2020-03-14","6","87","3","46","47","27.1"
"Bartow","2020-03-15","13","100","7","53","54.7","30.9"
"Bartow","2020-03-16","35","135","12","65","50","33.4"
"Bartow","2020-03-17","38","173","14","79","51.4","36"
"Bartow","2020-03-18","36","209","8","87","45.1","37.6"
"Bartow","2020-03-19","43","252","11","98","39.6","39.4"
"Bartow","2020-03-20","35","287","7","105","34.7","37.3"
"Bartow","2020-03-21","14","301","3","108","30.6","38.8"
"Bartow","2020-03-22","10","311","4","112","28.6","41.6"
"Bartow","2020-03-23","35","346","11","123","28.2","39.1"
"Bartow","2020-03-24","26","372","6","129","26.2","38.8"
"Bartow","2020-03-25","19","391","2","131","24.6","34.8"
"Bartow","2020-03-26","12","403","2","133","23.3","31.5"
"Bartow","2020-03-27","34","437","13","146","25.9","30.3"
"Bartow","2020-03-28","30","467","6","152","25.7","28.2"
"Bartow","2020-03-29","11","478","3","155","23.9","26.3"
"Bartow","2020-03-30","24","502","6","161","23","25.6"
"Bartow","2020-03-31","12","514","2","163","22.1","24.2"
"Bartow","2020-04-01","13","527","5","168","26","25.3"
"Bartow","2020-04-02","34","561","1","169","24.1","23.7"
"Bartow","2020-04-03","39","600","4","173","20.1","23"
"Bartow","2020-04-04","17","617","1","174","18.1","21.9"
"Bartow","2020-04-05","3","620","0","174","14.2","19"
"Bartow","2020-04-06","24","644","3","177","12.4","17.7"
"Bartow","2020-04-07","43","687","2","179","10.7","16.4"
"Bartow","2020-04-08","28","715","3","182","6.7","16.4"
"Bartow","2020-04-09","43","758","7","189","8.6","16.3"
"Bartow","2020-04-10","45","803","5","194","8.7","14.4"
"Bartow","2020-04-11","44","847","3","197","8.9","13.5"
"Bartow","2020-04-12","6","853","0","197","8.9","11.5"
"Bartow","2020-04-13","18","871","2","199","8.7","10.5"
"Bartow","2020-04-14","47","918","5","204","9.5","10.1"
"Bartow","2020-04-15","107","1025","4","208","8.5","7.6"
"Bartow","2020-04-16","109","1134","2","210","6.5","7.5"
"Bartow","2020-04-17","65","1199","4","214","5.8","7.2"
"Bartow","2020-04-18","43","1242","2","216","5.4","7.2"
"Bartow","2020-04-19","1","1243","1","217","19.7","14.3"
"Bartow","2020-04-20","163","1406","12","229","19.2","13.9"
"Bartow","2020-04-21","107","1513","4","233","18.2","13.9"
"Bartow","2020-04-22","70","1583","7","240","19.1","13.8"
"Bartow","2020-04-23","42","1625","1","241","19.2","12.8"
"Bartow","2020-04-24","79","1704","8","249","19.8","12.8"
"Bartow","2020-04-25","80","1784","4","253","19.8","12.6"
"Bartow","2020-04-26","16","1800","2","255","7.3","13.5"
"Bartow","2020-04-27","99","1899","2","257","6.5","12.9"
"Bartow","2020-04-28","89","1988","7","264","7.1","12.7"
"Bartow","2020-04-29","63","2051","3","267","6.4","12.7"
"Bartow","2020-04-30","152","2203","5","272","6.5","12.8"
"Bartow","2020-05-01","74","2277","5","277","6","12.9"
"Bartow","2020-05-02","51","2328","1","278","5.6","12.7"
"Bartow","2020-05-03","14","2342","0","278","3.8","5.6"
"Bartow","2020-05-04","141","2483","2","280","3.7","5.1"
"Bartow","2020-05-05","85","2568","1","281","2.8","4.9"
"Bartow","2020-05-06","108","2676","1","282","2.2","4.3"
"Bartow","2020-05-07","118","2794","9","291","2.8","4.7"
"Bartow","2020-05-08","139","2933","5","296","2.4","4.2"
"Bartow","2020-05-09","85","3018","4","300","2.8","4.2"
"Bartow","2020-05-10","1","3019","0","300","2.8","3.3"
"Bartow","2020-05-11","172","3191","9","309","3.3","3.5"
"Bartow","2020-05-12","137","3328","7","316","3.9","3.3"
"Bartow","2020-05-13","140","3468","3","319","4.1","3.1"
"Bartow","2020-05-14","96","3564","5","324","3.7","3.3"
"Bartow","2020-05-15","155","3719","9","333","4","3.2"
"Bartow","2020-05-16","79","3798","4","337","4.1","3.4"
"Bartow","2020-05-17","8","3806","0","337","4.1","3.4"
"Bartow","2020-05-18","136","3942","8","345","4.2","3.7"
"Bartow","2020-05-19","136","4078","5","350","4","3.9"
"Bartow","2020-05-20","143","4221","8","358","4.5","4.3"
"Bartow","2020-05-21","63","4284","3","361","4.4","4.1"
"Bartow","2020-05-22","53","4337","3","364","4.4","4.2"
"Bartow","2020-05-23","17","4354","0","364","3.7","3.9"
"Bartow","2020-05-24","11","4365","1","365","5","4.5"
"Bartow","2020-05-25","5","4370","0","365","4.1","4.1"
"Bartow","2020-05-26","127","4497","11","376","4.8","4.4"
"Bartow","2020-05-27","129","4626","10","386","5.1","4.8"
"Bartow","2020-05-28","139","4765","9","395","5.4","4.9"
"Bartow","2020-05-29","193","4958","7","402","5.1","4.7"
"Bartow","2020-05-30","44","5002","2","404","5.7","4.7"
"Bartow","2020-05-31","27","5029","2","406","5.5","5.2"
"Bartow","2020-06-01","179","5208","15","421","6.7","5.4"
"Bartow","2020-06-02","121","5329","13","434","7","5.9"
"Bartow","2020-06-03","124","5453","3","437","6.2","5.7"
"Bartow","2020-06-04","157","5610","7","444","5.9","5.7"
"Bartow","2020-06-05","168","5778","6","450","5.9","5.5"
"Bartow","2020-06-06","74","5852","1","451","5.5","5.6"
"Bartow","2020-06-07","14","5866","2","453","6.5","6"
"Bartow","2020-06-08","181","6047","9","462","6","6.3"
"Bartow","2020-06-09","147","6194","5","467","4.9","6"
"Bartow","2020-06-10","125","6319","4","471","5","5.6"
"Bartow","2020-06-11","209","6528","17","488","5.6","5.7"
"Bartow","2020-06-12","153","6681","8","496","5.8","5.9"
"Bartow","2020-06-13","79","6760","8","504","7","6.3"
"Bartow","2020-06-14","13","6773","0","504","5","5.7"
"Bartow","2020-06-15","259","7032","9","513","4.8","5.4"
"Bartow","2020-06-16","267","7299","11","524","4.9","4.9"
"Bartow","2020-06-17","129","7428","8","532","5.3","5.2"
"Bartow","2020-06-18","209","7637","24","556","5.8","5.7"
"Bartow","2020-06-19","156","7793","8","564","5.8","5.8"
"Bartow","2020-06-20","97","7890","9","573","5.7","6.4"
"Bartow","2020-06-21","16","7906","3","576","8.3","6.7"
"Bartow","2020-06-22","285","8191","19","595","8.8","6.8"
"Bartow","2020-06-23","187","8378","16","611","9.4","7.2"
"Bartow","2020-06-24","227","8605","27","638","10.3","7.8"
"Bartow","2020-06-25","314","8919","33","671","10.1","8"
"Bartow","2020-06-26","414","9333","33","704","10.5","8.2"
"Bartow","2020-06-27","186","9519","16","720","10.4","8"
"Bartow","2020-06-28","23","9542","5","725","10.8","9.6"
"Bartow","2020-06-29","616","10158","58","783","11.2","10"
"Bartow","2020-06-30","401","10559","37","820","11.3","10.4"
"Bartow","2020-07-01","507","11066","43","863","10.8","10.6"
"Bartow","2020-07-02","491","11557","47","910","10.7","10.4"
"Bartow","2020-07-03","128","11685","13","923","11","10.8"
"Bartow","2020-07-04","30","11715","6","929","12.7","11.5"
"Bartow","2020-07-05","13","11728","0","929","9.6","10.2"
"Bartow","2020-07-06","578","12306","94","1023","10.5","10.9"
"Bartow","2020-07-07","591","12897","66","1089","10.8","11.1"
"Bartow","2020-07-08","618","13515","147","1236","13","11.9"
"Bartow","2020-07-09","565","14080","54","1290","13","11.9"
"Bartow","2020-07-10","522","14602","41","1331","12.7","11.8"
"Bartow","2020-07-11","173","14775","12","1343","10.8","11.7"
"Bartow","2020-07-12","42","14817","10","1353","14.2","11.9"
"Bartow","2020-07-13","443","15260","51","1404","13.5","12"
"Bartow","2020-07-14","519","15779","65","1469","13.7","12.3"
"Bartow","2020-07-15","473","16252","50","1519","11.8","12.4"
"Bartow","2020-07-16","501","16753","36","1555","11.5","12.2"
"Bartow","2020-07-17","464","17217","49","1604","11.9","12.3"
"Bartow","2020-07-18","104","17321","12","1616","12.5","11.7"
"Bartow","2020-07-19","28","17349","2","1618","10.1","12.2"
"Bartow","2020-07-20","392","17741","37","1655","9.9","11.7"
"Bartow","2020-07-21","481","18222","71","1726","10.2","11.9"
"Bartow","2020-07-22","250","18472","35","1761","10.7","11.2"
"Bartow","2020-07-23","454","18926","56","1817","11.4","11.4"
"Bartow","2020-07-24","400","19326","46","1863","11.5","11.7"
"Bartow","2020-07-25","219","19545","36","1899","12.2","12.4"
"Bartow","2020-07-26","24","19569","4","1903","13.6","11.9"
"Bartow","2020-07-27","530","20099","59","1962","13.8","11.8"
"Bartow","2020-07-28","363","20462","45","2007","13.5","11.8"
"Bartow","2020-07-29","364","20826","48","2055","13.4","12"
"Bartow","2020-07-30","309","21135","32","2087","13.1","12.2"
"Bartow","2020-07-31","440","21575","39","2126","12.7","12.1"
"Bartow","2020-08-01","75","21650","15","2141","13.2","12.7"
"Bartow","2020-08-02","41","21691","1","2142","11.2","12.4"
"Bartow","2020-08-03","230","21921","29","2171","11.4","12.6"
"Bartow","2020-08-04","366","22287","33","2204","10.9","12.2"
"Bartow","2020-08-05","287","22574","20","2224","10","11.7"
"Bartow","2020-08-06","303","22877","21","2245","9.5","11.3"
"Bartow","2020-08-07","395","23272","32","2277","9.4","11.1"
"Bartow","2020-08-08","191","23463","19","2296","8","10.6"
"Bartow","2020-08-09","30","23493","2","2298","8.6","9.9"
"Bartow","2020-08-10","340","23833","38","2336","8.4","9.9"
"Bartow","2020-08-11","435","24268","41","2377","8.5","9.7"
"Bartow","2020-08-12","302","24570","32","2409","9","9.5"
"Bartow","2020-08-13","360","24930","29","2438","9.1","9.3"
"Bartow","2020-08-14","386","25316","30","2468","9.1","9.3"
"Bartow","2020-08-15","79","25395","11","2479","9.7","8.8"
"Bartow","2020-08-16","30","25425","5","2484","11.1","9.8"
"Bartow","2020-08-17","137","25562","20","2504","11.6","10"
"Bartow","2020-08-18","355","25917","24","2528","11.2","9.8"
"Bartow","2020-08-19","418","26335","31","2559","10.7","9.9"
"Bartow","2020-08-20","241","26576","17","2576","10.6","9.9"
"Bartow","2020-08-21","332","26908","23","2599","10.5","9.8"
"Bartow","2020-08-22","173","27081","20","2619","10.1","9.9"
"Bartow","2020-08-23","46","27127","8","2627","10.2","10.7"
"Bartow","2020-08-24","397","27524","46","2673","9.8","10.7"
"Bartow","2020-08-25","175","27699","14","2687","10","10.6"
"Bartow","2020-08-26","328","28027","25","2712","10","10.4"
"Bartow","2020-08-27","366","28393","29","2741","10.1","10.4"
"Bartow","2020-08-28","303","28696","23","2764","10.2","10.4"
"Bartow","2020-08-29","43","28739","3","2767","9.6","9.9"
"Bartow","2020-08-30","28","28767","4","2771","9.1","9.7"
"Bartow","2020-08-31","361","29128","47","2818","9.3","9.6"
"Bartow","2020-09-01","156","29284","13","2831","9.4","9.7"
"Bartow","2020-09-02","114","29398","15","2846","10.2","10.1"
"Bartow","2020-09-03","241","29639","23","2869","10.4","10.3"
"Bartow","2020-09-04","198","29837","19","2888","10.7","10.5"
"Bartow","2020-09-05","83","29920","7","2895","10.9","10.2"
"Bartow","2020-09-06","41","29961","2","2897","9.6","9.4"
"Bartow","2020-09-07","20","29981","2","2899","9.1","9.2"
"Bartow","2020-09-08","135","30116","15","2914","9.5","9.5"
"Bartow","2020-09-09","114","30230","11","2925","9","9.6"
"Bartow","2020-09-10","233","30463","28","2953","9.4","9.9"
"Bartow","2020-09-11","193","30656","11","2964","8.8","9.8"
"Bartow","2020-09-12","106","30762","7","2971","8.6","9.7"
"Bartow","2020-09-13","33","30795","4","2975","9.6","9.6"
"Bartow","2020-09-14","240","31035","21","2996","9.4","9.3"
"Bartow","2020-09-15","149","31184","11","3007","8.9","9.2"
"Bartow","2020-09-16","81","31265","7","3014","8.7","8.9"
"Bartow","2020-09-17","95","31360","7","3021","8.1","8.7"
"Bartow","2020-09-18","236","31596","25","3046","8.8","8.8"
"Bartow","2020-09-19","98","31694","6","3052","8.7","8.6"
"Bartow","2020-09-20","24","31718","3","3055","8.8","9.2"
"Bartow","2020-09-21","162","31880","21","3076","9.4","9.4"
"Bartow","2020-09-22","163","32043","11","3087","9.3","9.1"
"Bartow","2020-09-23","65","32108","8","3095","9.8","9.3"
"Bartow","2020-09-24","183","32291","18","3113","10.2","9.1"
"Bartow","2020-09-25","153","32444","5","3118","9.1","8.9"
"Bartow","2020-09-26","79","32523","4","3122","9","8.8"
"Bartow","2020-09-27","17","32540","1","3123","8","8.4"
"Bartow","2020-09-28","142","32682","25","3148","8.7","9"
"Bartow","2020-09-29","141","32823","10","3158","8.7","9"
"Bartow","2020-09-30","92","32915","8","3166","8.2","9"
"Bartow","2020-10-01","193","33108","18","3184","8.1","9.1"
"Bartow","2020-10-02","163","33271","15","3199","9","9"
"Bartow","2020-10-03","56","33327","5","3204","9.5","9.2"
"Bartow","2020-10-04","30","33357","2","3206","9.6","8.8"
"Bartow","2020-10-05","247","33604","25","3231","8.6","8.6"
"Bartow","2020-10-06","270","33874","20","3251","8.6","8.7"
"Bartow","2020-10-07","131","34005","10","3261","8.5","8.3"
"Bartow","2020-10-08","432","34437","67","3328","9.4","8.7"
"Bartow","2020-10-09","244","34681","29","3357","9.7","9.4"
"Bartow","2020-10-10","91","34772","14","3371","10.7","10.1"
"Bartow","2020-10-11","27","34799","1","3372","10.2","9.9"
"Bartow","2020-10-12","284","35083","29","3401","10.2","9.4"
"Bartow","2020-10-13","184","35267","22","3423","10.9","9.8"
"Bartow","2020-10-14","135","35402","22","3445","12.1","10.3"
"Bartow","2020-10-15","392","35794","46","3491","11.6","10.5"
"Bartow","2020-10-16","297","36091","27","3518","11.2","10.5"
"Bartow","2020-10-17","110","36201","10","3528","10.3","10.5"
"Bartow","2020-10-18","22","36223","1","3529","10.4","10.3"
"Bartow","2020-10-19","290","36513","42","3571","11","10.6"
"Bartow","2020-10-20","133","36646","21","3592","11.6","11.2"
"Bartow","2020-10-21","154","36800","25","3617","11.6","11.9"
"Bartow","2020-10-22","367","37167","41","3658","11.5","11.5"
"Bartow","2020-10-23","296","37463","32","3690","11.7","11.5"
"Bartow","2020-10-24","191","37654","21","3711","12","11.2"
"Bartow","2020-10-25","96","37750","6","3717","12.2","11.3"
"Bartow","2020-10-26","355","38105","36","3753","11.6","11.3"
"Bartow","2020-10-27","139","38244","19","3772","11.3","11.5"
"Bartow","2020-10-28","173","38417","17","3789","10.4","11"
"Bartow","2020-10-29","127","38544","8","3797","9.7","10.6"
"Bartow","2020-10-30","258","38802","24","3821","9.5","10.6"
"Bartow","2020-10-31","136","38938","20","3841","10","11"
"Bartow","2020-11-01","95","39033","11","3852","10.8","11.5"
"Bartow","2020-11-02","220","39253","31","3883","11.4","11.5"
"Bartow","2020-11-03","103","39356","10","3893","10.8","11.1"
"Bartow","2020-11-04","219","39575","26","3919","11.1","10.7"
"Bartow","2020-11-05","341","39916","38","3957","11.8","10.7"
"Bartow","2020-11-06","261","40177","29","3986","12","10.8"
"Bartow","2020-11-07","118","40295","24","4010","12.8","11.4"
"Bartow","2020-11-08","60","40355","13","4023","14.3","12.5"
"Bartow","2020-11-09","288","40643","50","4073","14.7","13"
"Bartow","2020-11-10","135","40778","22","4095","15.7","13.2"
"Bartow","2020-11-11","166","40944","22","4117","15.9","13.5"
"Bartow","2020-11-12","458","41402","67","4184","16.4","14.1"
"Bartow","2020-11-13","202","41604","29","4213","16.8","14.4"
"Bartow","2020-11-14","172","41776","28","4241","16.3","14.5"
"Bartow","2020-11-15","86","41862","11","4252","15","14.6"
"Bartow","2020-11-16","426","42288","63","4315","14.6","14.7"
"Bartow","2020-11-17","137","42425","17","4332","14.1","14.9"
"Bartow","2020-11-18","196","42621","30","4362","14.4","15.1"
"Bartow","2020-11-19","496","43117","73","4435","14.4","15.4"
"Bartow","2020-11-20","403","43520","54","4489","14.2","15.5"
"Bartow","2020-11-21","140","43660","26","4515","14.6","15.4"
"Bartow","2020-11-22","73","43733","12","4527","15.1","15"
"Bartow","2020-11-23","505","44238","66","4593","14.8","14.7"
"Bartow","2020-11-24","195","44433","31","4624","15.3","14.7"
"Bartow","2020-11-25","225","44658","40","4664","15.7","15"
"Bartow","2020-11-26","44","44702","8","4672","16.2","15.3"
"Bartow","2020-11-27","142","44844","31","4703","17.4","15.8"
"Bartow","2020-11-28","137","44981","25","4728","17.3","16"
"Bartow","2020-11-29","202","45183","31","4759","17.2","16.1"
"Bartow","2020-11-30","394","45577","82","4841","18.3","16.6"
"Bartow","2020-12-01","341","45918","60","4901","18.5","16.9"
"Bartow","2020-12-02","239","46157","41","4942","18.5","17.1"
"Bartow","2020-12-03","449","46606","76","5018","18.3","17.2"
"Bartow","2020-12-04","327","46933","64","5082","18","17.7"
"Bartow","2020-12-05","125","47058","23","5105","18","17.7"
"Bartow","2020-12-06","93","47151","27","5132","19.9","18.6"
"Bartow","2020-12-07","587","47738","81","5213","18.9","18.6"
"Bartow","2020-12-08","419","48157","55","5268","18.3","18.4"
"Bartow","2020-12-09","199","48356","44","5312","19","18.7"
"Bartow","2020-12-10","517","48873","95","5407","19.2","18.7"
"Bartow","2020-12-11","517","49390","65","5472","18.2","18.1"
"Bartow","2020-12-12","136","49526","24","5496","18.1","18"
"Bartow","2020-12-13","91","49617","22","5518","17.4","18.7"
"Bartow","2020-12-14","545","50162","94","5612","17.9","18.4"
"Bartow","2020-12-15","655","50817","138","5750","19","18.7"
"Bartow","2020-12-16","285","51102","57","5807","18.7","18.9"
"Bartow","2020-12-17","621","51723","84","5891","18","18.6"
"Bartow","2020-12-18","639","52362","109","6000","18.7","18.4"
"Bartow","2020-12-19","172","52534","48","6048","20.1","19.1"
"Bartow","2020-12-20","74","52608","16","6064","19.8","18.6"
"Bartow","2020-12-21","773","53381","161","6225","20.3","19.1"
"Bartow","2020-12-22","667","54048","149","6374","20.5","19.7"
"Bartow","2020-12-23","260","54308","49","6423","20.3","19.5"
"Bartow","2020-12-24","249","54557","99","6522","24.1","21"
"Bartow","2020-12-25","44","54601","9","6531","24.5","21.6"
"Bartow","2020-12-26","141","54742","43","6574","24.9","22.5"
"Bartow","2020-12-27","121","54863","48","6622","27.5","23.6"
"Bartow","2020-12-28","861","55724","261","6883","28.8","24.6"
"Bartow","2020-12-29","771","56495","165","7048","28.7","24.6"
"Bartow","2020-12-30","360","56855","76","7124","29","24.7"
"Bartow","2020-12-31","690","57545","161","7285","26.7","25.4"
"Bartow","2021-01-01","58","57603","21","7306","28.9","26.7"
"Bartow","2021-01-02","100","57703","34","7340","29.4","27.2"
"Bartow","2021-01-03","110","57813","50","7390","30.3","28.9"
"Bartow","2021-01-04","1172","58985","287","7677","29.4","29.1"
"Bartow","2021-01-05","1291","60276","264","7941","29.3","29"
"Bartow","2021-01-06","235","60511","54","7995","29.6","29.3"
"Bartow","2021-01-07","823","61334","147","8142","28.8","27.7"
"Bartow","2021-01-08","527","61861","93","8235","26.1","27.5"
"Bartow","2021-01-09","160","62021","38","8273","24.7","27"
"Bartow","2021-01-10","110","62131","31","8304","22.2","26.2"
"Bartow","2021-01-11","317","62448","58","8362","21.3","25.4"
"Bartow","2021-01-12","554","63002","88","8450","20.7","25"
"Bartow","2021-01-13","252","63254","53","8503","20.4","25"
"Bartow","2021-01-14","562","63816","89","8592","20.1","24.4"
"Bartow","2021-01-15","539","64355","92","8684","20","23.1"
"Bartow","2021-01-16","132","64487","35","8719","20.4","22.5"
"Bartow","2021-01-17","91","64578","12","8731","18.3","20.2"
"Bartow","2021-01-18","520","65098","104","8835","18.5","19.9"
"Bartow","2021-01-19","179","65277","34","8869","18.9","19.8"
"Bartow","2021-01-20","216","65493","41","8910","18.7","19.5"
"Bartow","2021-01-21","486","65979","61","8971","18.2","19.1"
"Bartow","2021-01-22","217","66196","39","9010","18.3","19.2"
"Bartow","2021-01-23","135","66331","34","9044","18.1","19.3"
"Bartow","2021-01-24","78","66409","17","9061","19.4","18.8"
"Bartow","2021-01-25","210","66619","48","9109","19.8","19.1"
"Bartow","2021-01-26","238","66857","30","9139","18.8","18.9"
"Bartow","2021-01-27","238","67095","39","9178","18.5","18.6"
"Bartow","2021-01-28","208","67303","38","9216","19.3","18.7"
"Bartow","2021-01-29","239","67542","49","9265","19.7","19"
"Bartow","2021-01-30","142","67684","23","9288","18.4","18.2"
"Bartow","2021-01-31","86","67770","15","9303","17.8","18.6"
"Bartow","2021-02-01","214","67984","40","9343","17.2","18.5"
"Bartow","2021-02-02","282","68266","32","9375","17","17.9"
"Bartow","2021-02-03","211","68477","34","9409","16.9","17.7"
"Bartow","2021-02-04","176","68653","34","9443","17.1","18.2"
"Bartow","2021-02-05","169","68822","29","9472","16.6","18.1"
"Bartow","2021-02-06","18","68840","3","9475","16.7","17.5"
"Bartow","2021-02-07","10","68850","1","9476","15.6","16.7"
"Bartow","2021-02-08","0","68850","0","9476","12.9","15"
"Ben Hill","2020-02-01","0","0","0","0",".","."
"Ben Hill","2020-02-02","0","0","0","0",".","."
"Ben Hill","2020-02-03","0","0","0","0",".","."
"Ben Hill","2020-02-04","0","0","0","0",".","."
"Ben Hill","2020-02-05","0","0","0","0",".","."
"Ben Hill","2020-02-06","0","0","0","0",".","."
"Ben Hill","2020-02-07","0","0","0","0","0","."
"Ben Hill","2020-02-08","0","0","0","0","0","."
"Ben Hill","2020-02-09","0","0","0","0","0","."
"Ben Hill","2020-02-10","0","0","0","0","0","."
"Ben Hill","2020-02-11","0","0","0","0","0","."
"Ben Hill","2020-02-12","0","0","0","0","0","."
"Ben Hill","2020-02-13","0","0","0","0","0","."
"Ben Hill","2020-02-14","0","0","0","0","0","0"
"Ben Hill","2020-02-15","0","0","0","0","0","0"
"Ben Hill","2020-02-16","0","0","0","0","0","0"
"Ben Hill","2020-02-17","0","0","0","0","0","0"
"Ben Hill","2020-02-18","0","0","0","0","0","0"
"Ben Hill","2020-02-19","0","0","0","0","0","0"
"Ben Hill","2020-02-20","0","0","0","0","0","0"
"Ben Hill","2020-02-21","0","0","0","0","0","0"
"Ben Hill","2020-02-22","0","0","0","0","0","0"
"Ben Hill","2020-02-23","0","0","0","0","0","0"
"Ben Hill","2020-02-24","0","0","0","0","0","0"
"Ben Hill","2020-02-25","0","0","0","0","0","0"
"Ben Hill","2020-02-26","0","0","0","0","0","0"
"Ben Hill","2020-02-27","0","0","0","0","0","0"
"Ben Hill","2020-02-28","0","0","0","0","0","0"
"Ben Hill","2020-02-29","0","0","0","0","0","0"
"Ben Hill","2020-03-01","0","0","0","0","0","0"
"Ben Hill","2020-03-02","0","0","0","0","0","0"
"Ben Hill","2020-03-03","0","0","0","0","0","0"
"Ben Hill","2020-03-04","0","0","0","0","0","0"
"Ben Hill","2020-03-05","0","0","0","0","0","0"
"Ben Hill","2020-03-06","0","0","0","0","0","0"
"Ben Hill","2020-03-07","0","0","0","0","0","0"
"Ben Hill","2020-03-08","0","0","0","0","0","0"
"Ben Hill","2020-03-09","0","0","0","0","0","0"
"Ben Hill","2020-03-10","0","0","0","0","0","0"
"Ben Hill","2020-03-11","0","0","0","0","0","0"
"Ben Hill","2020-03-12","0","0","0","0","0","0"
"Ben Hill","2020-03-13","1","1","0","0","0","0"
"Ben Hill","2020-03-14","1","2","0","0","0","0"
"Ben Hill","2020-03-15","1","3","0","0","0","0"
"Ben Hill","2020-03-16","3","6","0","0","0","0"
"Ben Hill","2020-03-17","3","9","0","0","0","0"
"Ben Hill","2020-03-18","5","14","0","0","0","0"
"Ben Hill","2020-03-19","5","19","1","1","2.9","1.4"
"Ben Hill","2020-03-20","2","21","0","1","2.9","1.4"
"Ben Hill","2020-03-21","1","22","0","1","2.9","1.4"
"Ben Hill","2020-03-22","0","22","0","1","2.9","1.4"
"Ben Hill","2020-03-23","28","50","0","1","2.9","1.4"
"Ben Hill","2020-03-24","19","69","0","1","2.9","1.4"
"Ben Hill","2020-03-25","7","76","0","1","2.9","1.4"
"Ben Hill","2020-03-26","18","94","0","1","0","1.4"
"Ben Hill","2020-03-27","5","99","2","3","5.7","4.3"
"Ben Hill","2020-03-28","4","103","0","3","5.7","4.3"
"Ben Hill","2020-03-29","6","109","0","3","5.7","4.3"
"Ben Hill","2020-03-30","15","124","1","4","6.7","4.8"
"Ben Hill","2020-03-31","21","145","1","5","7.3","5.1"
"Ben Hill","2020-04-01","7","152","0","5","7.3","5.1"
"Ben Hill","2020-04-02","12","164","3","8","10.9","5.5"
"Ben Hill","2020-04-03","4","168","0","8","5.2","5.5"
"Ben Hill","2020-04-04","4","172","0","8","5.2","5.5"
"Ben Hill","2020-04-05","4","176","0","8","5.2","5.5"
"Ben Hill","2020-04-06","5","181","0","8","4.3","5.5"
"Ben Hill","2020-04-07","21","202","0","8","3.6","5.5"
"Ben Hill","2020-04-08","5","207","1","9","6.4","6.9"
"Ben Hill","2020-04-09","9","216","1","10","4.4","7.7"
"Ben Hill","2020-04-10","3","219","0","10","4.4","4.8"
"Ben Hill","2020-04-11","1","220","0","10","4.4","4.8"
"Ben Hill","2020-04-12","1","221","0","10","4.4","4.8"
"Ben Hill","2020-04-13","6","227","2","12","9.2","6.7"
"Ben Hill","2020-04-14","3","230","1","13","14","8.8"
"Ben Hill","2020-04-15","2","232","0","13","11.1","8.8"
"Ben Hill","2020-04-16","13","245","2","15","11.7","8.1"
"Ben Hill","2020-04-17","10","255","4","19","17.4","10.9"
"Ben Hill","2020-04-18","5","260","0","19","17.4","10.9"
"Ben Hill","2020-04-19","2","262","0","19","17.4","10.9"
"Ben Hill","2020-04-20","17","279","4","23","16","12.6"
"Ben Hill","2020-04-21","5","284","0","23","11.3","12.6"
"Ben Hill","2020-04-22","9","293","1","24","12.9","12"
"Ben Hill","2020-04-23","9","302","2","26","13.8","12.8"
"Ben Hill","2020-04-24","5","307","1","27","11","14.2"
"Ben Hill","2020-04-25","1","308","0","27","11","14.2"
"Ben Hill","2020-04-26","2","310","0","27","11","14.2"
"Ben Hill","2020-04-27","45","355","2","29","8.3","12.1"
"Ben Hill","2020-04-28","22","377","2","31","9.6","10.4"
"Ben Hill","2020-04-29","17","394","1","32","8.8","10.8"
"Ben Hill","2020-04-30","5","399","0","32","5.6","9.7"
"Ben Hill","2020-05-01","21","420","2","34","4.1","7.6"
"Ben Hill","2020-05-02","4","424","1","35","7.7","9.3"
"Ben Hill","2020-05-03","4","428","2","37","14.8","12.9"
"Ben Hill","2020-05-04","3","431","0","37","14.2","11.2"
"Ben Hill","2020-05-05","12","443","0","37","12.9","11.2"
"Ben Hill","2020-05-06","33","476","0","37","12.1","10.4"
"Ben Hill","2020-05-07","39","515","0","37","12.1","8.9"
"Ben Hill","2020-05-08","39","554","1","38","11.1","7.6"
"Ben Hill","2020-05-09","4","558","0","38","7.5","7.6"
"Ben Hill","2020-05-10","0","558","0","38","0.4","7.6"
"Ben Hill","2020-05-11","19","577","2","40","1.9","8"
"Ben Hill","2020-05-12","20","597","1","41","2.6","7.7"
"Ben Hill","2020-05-13","25","622","2","43","3.7","7.9"
"Ben Hill","2020-05-14","15","637","2","45","5.6","8.9"
"Ben Hill","2020-05-15","24","661","4","49","7.6","9.4"
"Ben Hill","2020-05-16","3","664","0","49","7.6","7.6"
"Ben Hill","2020-05-17","1","665","0","49","7.6","4"
"Ben Hill","2020-05-18","38","703","1","50","6.5","4.2"
"Ben Hill","2020-05-19","25","728","1","51","6.4","4.5"
"Ben Hill","2020-05-20","30","758","1","52","5.7","4.7"
"Ben Hill","2020-05-21","37","795","4","56","5.3","5.5"
"Ben Hill","2020-05-22","34","829","4","60","4.6","6.1"
"Ben Hill","2020-05-23","2","831","1","61","11.8","9.7"
"Ben Hill","2020-05-24","4","835","0","61","11.8","9.7"
"Ben Hill","2020-05-25","0","835","0","61","11.4","9"
"Ben Hill","2020-05-26","51","886","7","68","12.8","9.6"
"Ben Hill","2020-05-27","23","909","1","69","12.9","9.3"
"Ben Hill","2020-05-28","31","940","1","70","11.9","8.6"
"Ben Hill","2020-05-29","32","972","5","75","12.4","8.5"
"Ben Hill","2020-05-30","1","973","0","75","5.3","8.5"
"Ben Hill","2020-05-31","5","978","0","75","5.3","8.5"
"Ben Hill","2020-06-01","72","1050","6","81","6.5","8.9"
"Ben Hill","2020-06-02","33","1083","4","85","6.2","9.5"
"Ben Hill","2020-06-03","43","1126","2","87","6.3","9.6"
"Ben Hill","2020-06-04","51","1177","0","87","5.8","8.8"
"Ben Hill","2020-06-05","81","1258","3","90","4.1","8.3"
"Ben Hill","2020-06-06","2","1260","0","90","4.1","4.7"
"Ben Hill","2020-06-07","2","1262","1","91","11.3","8.3"
"Ben Hill","2020-06-08","53","1315","4","95","11.1","8.8"
"Ben Hill","2020-06-09","26","1341","1","96","10","8.1"
"Ben Hill","2020-06-10","31","1372","0","96","9.3","7.8"
"Ben Hill","2020-06-11","31","1403","7","103","12.5","9.2"
"Ben Hill","2020-06-12","38","1441","2","105","12.7","8.4"
"Ben Hill","2020-06-13","2","1443","0","105","12.7","8.4"
"Ben Hill","2020-06-14","1","1444","0","105","5.6","8.4"
"Ben Hill","2020-06-15","90","1534","8","113","5.8","8.5"
"Ben Hill","2020-06-16","43","1577","5","118","6.9","8.4"
"Ben Hill","2020-06-17","62","1639","4","122","7.8","8.6"
"Ben Hill","2020-06-18","40","1679","2","124","5.3","8.9"
"Ben Hill","2020-06-19","41","1720","3","127","5.6","9.2"
"Ben Hill","2020-06-20","3","1723","0","127","5.6","9.2"
"Ben Hill","2020-06-21","3","1726","0","127","5.6","5.6"
"Ben Hill","2020-06-22","76","1802","16","143","7.3","6.6"
"Ben Hill","2020-06-23","62","1864","6","149","7.1","7"
"Ben Hill","2020-06-24","77","1941","9","158","7.8","7.8"
"Ben Hill","2020-06-25","57","1998","10","168","9.6","7.5"
"Ben Hill","2020-06-26","76","2074","4","172","9.3","7.5"
"Ben Hill","2020-06-27","3","2077","1","173","14.1","9.8"
"Ben Hill","2020-06-28","1","2078","0","173","14.1","9.8"
"Ben Hill","2020-06-29","130","2208","13","186","12.5","9.9"
"Ben Hill","2020-06-30","61","2269","14","200","14.4","10.7"
"Ben Hill","2020-07-01","89","2358","5","205","13.5","10.7"
"Ben Hill","2020-07-02","103","2461","8","213","12.1","10.9"
"Ben Hill","2020-07-03","13","2474","1","214","12.5","10.9"
"Ben Hill","2020-07-04","3","2477","1","215","12.5","13.3"
"Ben Hill","2020-07-05","1","2478","0","215","12.5","13.3"
"Ben Hill","2020-07-06","168","2646","25","240","13.2","12.8"
"Ben Hill","2020-07-07","103","2749","9","249","11.1","12.8"
"Ben Hill","2020-07-08","43","2792","1","250","10.7","12.1"
"Ben Hill","2020-07-09","116","2908","8","258","10.6","11.3"
"Ben Hill","2020-07-10","69","2977","9","267","11.3","11.9"
"Ben Hill","2020-07-11","2","2979","0","267","6.6","9.5"
"Ben Hill","2020-07-12","2","2981","0","267","6.6","9.5"
"Ben Hill","2020-07-13","89","3070","0","267","4.4","8.8"
"Ben Hill","2020-07-14","55","3125","6","273","4.7","7.9"
"Ben Hill","2020-07-15","68","3193","8","281","6.1","8.4"
"Ben Hill","2020-07-16","36","3229","2","283","5.9","8.2"
"Ben Hill","2020-07-17","67","3296","7","290","5.5","8.4"
"Ben Hill","2020-07-18","20","3316","6","296","9.8","8.2"
"Ben Hill","2020-07-19","4","3320","0","296","9.8","8.2"
"Ben Hill","2020-07-20","92","3412","11","307","11.5","8"
"Ben Hill","2020-07-21","89","3501","2","309","10.3","7.5"
"Ben Hill","2020-07-22","38","3539","4","313","10.1","8.1"
"Ben Hill","2020-07-23","58","3597","4","317","10.3","8.1"
"Ben Hill","2020-07-24","68","3665","7","324","10.3","7.9"
"Ben Hill","2020-07-25","21","3686","4","328","8.7","9.3"
"Ben Hill","2020-07-26","0","3686","0","328","8.7","9.3"
"Ben Hill","2020-07-27","87","3773","12","340","9","10.2"
"Ben Hill","2020-07-28","65","3838","8","348","10.4","10.3"
"Ben Hill","2020-07-29","78","3916","9","357","10.6","10.3"
"Ben Hill","2020-07-30","94","4010","13","370","11.5","10.9"
"Ben Hill","2020-07-31","46","4056","2","372","10.7","10.5"
"Ben Hill","2020-08-01","25","4081","5","377","10.8","9.8"
"Ben Hill","2020-08-02","4","4085","2","379","18","13.3"
"Ben Hill","2020-08-03","121","4206","13","392","17.5","13.3"
"Ben Hill","2020-08-04","94","4300","21","413","19","14.7"
"Ben Hill","2020-08-05","119","4419","24","437","20.2","15.4"
"Ben Hill","2020-08-06","81","4500","13","450","20.5","16"
"Ben Hill","2020-08-07","148","4648","18","468","21.6","16.2"
"Ben Hill","2020-08-08","45","4693","10","478","22","16.4"
"Ben Hill","2020-08-09","4","4697","0","478","14.8","16.4"
"Ben Hill","2020-08-10","99","4796","11","489","14.9","16.2"
"Ben Hill","2020-08-11","110","4906","18","507","14","16.5"
"Ben Hill","2020-08-12","166","5072","19","526","12.8","16.5"
"Ben Hill","2020-08-13","191","5263","18","544","11.8","16.2"
"Ben Hill","2020-08-14","104","5367","8","552","11.2","16.4"
"Ben Hill","2020-08-15","31","5398","3","555","9.4","15.7"
"Ben Hill","2020-08-16","2","5400","0","555","9.4","12.1"
"Ben Hill","2020-08-17","7","5407","2","557","11.9","13.4"
"Ben Hill","2020-08-18","95","5502","13","570","11.5","12.8"
"Ben Hill","2020-08-19","90","5592","10","580","11.5","12.1"
"Ben Hill","2020-08-20","152","5744","19","599","11.9","11.9"
"Ben Hill","2020-08-21","53","5797","7","606","12.7","11.9"
"Ben Hill","2020-08-22","18","5815","5","611","15.3","12.3"
"Ben Hill","2020-08-23","2","5817","0","611","15.3","12.3"
"Ben Hill","2020-08-24","83","5900","2","613","11.5","11.7"
"Ben Hill","2020-08-25","84","5984","7","620","10.8","11.1"
"Ben Hill","2020-08-26","88","6072","7","627","10.3","10.9"
"Ben Hill","2020-08-27","81","6153","8","635","9.9","10.9"
"Ben Hill","2020-08-28","50","6203","8","643","10.3","11.5"
"Ben Hill","2020-08-29","42","6245","2","645","7","11.2"
"Ben Hill","2020-08-30","19","6264","5","650","10.8","13"
"Ben Hill","2020-08-31","57","6321","2","652","11","11.2"
"Ben Hill","2020-09-01","48","6369","5","657","11.3","11"
"Ben Hill","2020-09-02","62","6431","9","666","12.2","11.3"
"Ben Hill","2020-09-03","65","6496","7","673","12.3","11.1"
"Ben Hill","2020-09-04","85","6581","13","686","12.2","11.3"
"Ben Hill","2020-09-05","16","6597","1","687","12.4","9.7"
"Ben Hill","2020-09-06","3","6600","0","687","8.7","9.7"
"Ben Hill","2020-09-07","25","6625","3","690","9.9","10.4"
"Ben Hill","2020-09-08","55","6680","1","691","8.7","10"
"Ben Hill","2020-09-09","48","6728","4","695","7.8","10"
"Ben Hill","2020-09-10","42","6770","7","702","8.6","10.5"
"Ben Hill","2020-09-11","61","6831","5","707","7.6","9.9"
"Ben Hill","2020-09-12","8","6839","3","710","12.1","12.3"
"Ben Hill","2020-09-13","5","6844","0","710","12.1","10.4"
"Ben Hill","2020-09-14","50","6894","7","717","12.4","11.1"
"Ben Hill","2020-09-15","54","6948","5","722","13.4","11"
"Ben Hill","2020-09-16","53","7001","2","724","12.8","10.3"
"Ben Hill","2020-09-17","38","7039","9","733","13.8","11.2"
"Ben Hill","2020-09-18","36","7075","2","735","13.4","10.5"
"Ben Hill","2020-09-19","20","7095","2","737","9.5","10.8"
"Ben Hill","2020-09-20","2","7097","1","738","16.6","14.3"
"Ben Hill","2020-09-21","36","7133","6","744","17","14.7"
"Ben Hill","2020-09-22","27","7160","4","748","17.8","15.6"
"Ben Hill","2020-09-23","27","7187","1","749","17.8","15.3"
"Ben Hill","2020-09-24","35","7222","10","759","18.5","16.1"
"Ben Hill","2020-09-25","47","7269","9","768","20.4","16.9"
"Ben Hill","2020-09-26","5","7274","1","769","21.8","15.7"
"Ben Hill","2020-09-27","3","7277","0","769","14.7","15.7"
"Ben Hill","2020-09-28","64","7341","9","778","14.3","15.7"
"Ben Hill","2020-09-29","39","7380","2","780","12.9","15.4"
"Ben Hill","2020-09-30","42","7422","4","784","13.8","15.8"
"Ben Hill","2020-10-01","42","7464","9","793","12.8","15.6"
"Ben Hill","2020-10-02","54","7518","5","798","11.3","15.9"
"Ben Hill","2020-10-03","15","7533","4","802","12.3","17.1"
"Ben Hill","2020-10-04","4","7537","0","802","12.3","13.5"
"Ben Hill","2020-10-05","45","7582","3","805","11.2","12.8"
"Ben Hill","2020-10-06","49","7631","2","807","11.1","12"
"Ben Hill","2020-10-07","47","7678","2","809","10.3","12.1"
"Ben Hill","2020-10-08","58","7736","8","817","9.2","11"
"Ben Hill","2020-10-09","26","7762","2","819","9","10.2"
"Ben Hill","2020-10-10","13","7775","2","821","7.4","9.9"
"Ben Hill","2020-10-11","3","7778","0","821","7.4","9.9"
"Ben Hill","2020-10-12","32","7810","1","822","6.9","9.1"
"Ben Hill","2020-10-13","31","7841","0","822","6.3","8.7"
"Ben Hill","2020-10-14","22","7863","2","824","7","8.7"
"Ben Hill","2020-10-15","34","7897","3","827","6.3","7.8"
"Ben Hill","2020-10-16","30","7927","3","830","6.6","7.8"
"Ben Hill","2020-10-17","5","7932","0","830","4.4","5.9"
"Ben Hill","2020-10-18","3","7935","0","830","4.4","5.9"
"Ben Hill","2020-10-19","39","7974","7","837","6.6","6.7"
"Ben Hill","2020-10-20","27","8001","7","844","10.3","8.3"
"Ben Hill","2020-10-21","25","8026","3","847","10.7","8.8"
"Ben Hill","2020-10-22","24","8050","1","848","10","8.2"
"Ben Hill","2020-10-23","37","8087","4","852","10.1","8.4"
"Ben Hill","2020-10-24","7","8094","1","853","12.2","8.3"
"Ben Hill","2020-10-25","0","8094","0","853","12.2","8.3"
"Ben Hill","2020-10-26","33","8127","6","859","12.2","9.4"
"Ben Hill","2020-10-27","17","8144","1","860","9.3","9.8"
"Ben Hill","2020-10-28","12","8156","4","864","12.4","11.5"
"Ben Hill","2020-10-29","23","8179","1","865","12.4","11.2"
"Ben Hill","2020-10-30","51","8230","4","869","12","11.1"
"Ben Hill","2020-10-31","5","8235","0","869","9.9","11.1"
"Ben Hill","2020-11-01","2","8237","1","870","17.1","14.6"
"Ben Hill","2020-11-02","24","8261","2","872","15.7","13.9"
"Ben Hill","2020-11-03","26","8287","3","875","16.5","12.9"
"Ben Hill","2020-11-04","35","8322","3","878","12.9","12.7"
"Ben Hill","2020-11-05","30","8352","3","881","13.8","13.1"
"Ben Hill","2020-11-06","26","8378","1","882","13.2","12.6"
"Ben Hill","2020-11-07","11","8389","3","885","17.1","13.5"
"Ben Hill","2020-11-08","4","8393","0","885","9.9","13.5"
"Ben Hill","2020-11-09","18","8411","1","886","9.5","12.6"
"Ben Hill","2020-11-10","17","8428","1","887","8.7","12.6"
"Ben Hill","2020-11-11","26","8454","2","889","8.6","10.8"
"Ben Hill","2020-11-12","35","8489","1","890","7.6","10.7"
"Ben Hill","2020-11-13","33","8522","1","891","7.5","10.3"
"Ben Hill","2020-11-14","13","8535","1","892","4.7","10.9"
"Ben Hill","2020-11-15","4","8539","1","893","8.2","9.1"
"Ben Hill","2020-11-16","41","8580","4","897","8.8","9.2"
"Ben Hill","2020-11-17","29","8609","1","898","8.5","8.6"
"Ben Hill","2020-11-18","22","8631","2","900","8.7","8.7"
"Ben Hill","2020-11-19","71","8702","2","902","8.7","8.1"
"Ben Hill","2020-11-20","42","8744","5","907","10","8.7"
"Ben Hill","2020-11-21","7","8751","0","907","8.9","6.8"
"Ben Hill","2020-11-22","4","8755","0","907","5.3","6.8"
"Ben Hill","2020-11-23","30","8785","6","913","6.8","7.8"
"Ben Hill","2020-11-24","41","8826","6","919","8.3","8.4"
"Ben Hill","2020-11-25","50","8876","7","926","9.1","8.9"
"Ben Hill","2020-11-26","4","8880","1","927","12.2","10.5"
"Ben Hill","2020-11-27","8","8888","2","929","14.1","12"
"Ben Hill","2020-11-28","11","8899","3","932","18","13.4"
"Ben Hill","2020-11-29","5","8904","0","932","18","11.6"
"Ben Hill","2020-11-30","15","8919","0","932","15.1","10.9"
"Ben Hill","2020-12-01","70","8989","12","944","15.5","11.9"
"Ben Hill","2020-12-02","51","9040","7","951","15.4","12.2"
"Ben Hill","2020-12-03","24","9064","3","954","13.7","12.9"
"Ben Hill","2020-12-04","51","9115","5","959","11.5","12.8"
"Ben Hill","2020-12-05","11","9126","5","964","14.1","16"
"Ben Hill","2020-12-06","7","9133","2","966","18.2","18.1"
"Ben Hill","2020-12-07","85","9218","15","981","20.7","17.9"
"Ben Hill","2020-12-08","32","9250","9","990","22.3","18.9"
"Ben Hill","2020-12-09","29","9279","8","998","24.2","19.8"
"Ben Hill","2020-12-10","84","9363","10","1008","24.2","18.9"
"Ben Hill","2020-12-11","66","9429","12","1020","25.4","18.4"
"Ben Hill","2020-12-12","23","9452","7","1027","23.2","18.6"
"Ben Hill","2020-12-13","3","9455","0","1027","19.1","18.6"
"Ben Hill","2020-12-14","87","9542","18","1045","19.6","20.1"
"Ben Hill","2020-12-15","25","9567","5","1050","18.4","20.3"
"Ben Hill","2020-12-16","92","9659","20","1070","17.6","20.9"
"Ben Hill","2020-12-17","39","9698","10","1080","19.5","21.8"
"Ben Hill","2020-12-18","24","9722","1","1081","17.5","21.4"
"Ben Hill","2020-12-19","17","9739","8","1089","19.9","21.6"
"Ben Hill","2020-12-20","9","9748","2","1091","23.1","21.1"
"Ben Hill","2020-12-21","17","9765","4","1095","23.5","21.5"
"Ben Hill","2020-12-22","75","9840","13","1108","23.1","20.7"
"Ben Hill","2020-12-23","84","9924","19","1127","23.2","20.4"
"Ben Hill","2020-12-24","24","9948","5","1132","22.5","21"
"Ben Hill","2020-12-25","2","9950","0","1132","21.9","19.7"
"Ben Hill","2020-12-26","8","9958","1","1133","17","18.5"
"Ben Hill","2020-12-27","3","9961","0","1133","13.8","18.5"
"Ben Hill","2020-12-28","59","10020","16","1149","14.3","18.9"
"Ben Hill","2020-12-29","25","10045","9","1158","17","20.1"
"Ben Hill","2020-12-30","59","10104","18","1176","18.1","20.7"
"Ben Hill","2020-12-31","56","10160","18","1194","19.8","21.1"
"Ben Hill","2021-01-01","4","10164","0","1194","19.8","20.8"
"Ben Hill","2021-01-02","12","10176","4","1198","22.7","19.9"
"Ben Hill","2021-01-03","22","10198","3","1201","24.7","19.3"
"Ben Hill","2021-01-04","39","10237","10","1211","24.5","19.4"
"Ben Hill","2021-01-05","51","10288","11","1222","22.4","19.7"
"Ben Hill","2021-01-06","62","10350","14","1236","21.3","19.7"
"Ben Hill","2021-01-07","45","10395","11","1247","20.2","20"
"Ben Hill","2021-01-08","41","10436","9","1256","23.3","21.5"
"Ben Hill","2021-01-09","9","10445","2","1258","21.7","22.2"
"Ben Hill","2021-01-10","6","10451","2","1260","24.5","24.6"
"Ben Hill","2021-01-11","40","10491","8","1268","23.7","24.1"
"Ben Hill","2021-01-12","53","10544","7","1275","22.5","22.5"
"Ben Hill","2021-01-13","57","10601","9","1284","21.6","21.4"
"Ben Hill","2021-01-14","45","10646","9","1293","20.9","20.6"
"Ben Hill","2021-01-15","34","10680","7","1300","20.7","22"
"Ben Hill","2021-01-16","31","10711","9","1309","21.7","21.7"
"Ben Hill","2021-01-17","8","10719","2","1311","20.5","22.5"
"Ben Hill","2021-01-18","23","10742","4","1315","20.1","21.9"
"Ben Hill","2021-01-19","28","10770","6","1321","21.3","21.9"
"Ben Hill","2021-01-20","29","10799","7","1328","22.5","22"
"Ben Hill","2021-01-21","32","10831","6","1334","22.3","21.6"
"Ben Hill","2021-01-22","36","10867","7","1341","22.2","21.5"
"Ben Hill","2021-01-23","17","10884","1","1342","18.9","20.3"
"Ben Hill","2021-01-24","6","10890","2","1344","20.1","20.3"
"Ben Hill","2021-01-25","23","10913","10","1354","23.8","22"
"Ben Hill","2021-01-26","26","10939","2","1356","21.8","21.6"
"Ben Hill","2021-01-27","26","10965","2","1358","19.5","21"
"Ben Hill","2021-01-28","33","10998","5","1363","19","20.6"
"Ben Hill","2021-01-29","10","11008","1","1364","17.6","19.9"
"Ben Hill","2021-01-30","25","11033","1","1365","17.3","18.1"
"Ben Hill","2021-01-31","12","11045","3","1368","16.1","18.1"
"Ben Hill","2021-02-01","15","11060","4","1372","13.7","18.8"
"Ben Hill","2021-02-02","20","11080","2","1374","14.1","17.9"
"Ben Hill","2021-02-03","14","11094","1","1375","14","16.7"
"Ben Hill","2021-02-04","8","11102","1","1376","13.6","16.3"
"Ben Hill","2021-02-05","15","11117","0","1376","12.2","14.9"
"Ben Hill","2021-02-06","0","11117","0","1376","11.6","14.5"
"Ben Hill","2021-02-07","0","11117","0","1376","8","12.1"
"Ben Hill","2021-02-08","0","11117","0","1376","4.2","9"
"Berrien","2020-02-01","0","0","0","0",".","."
"Berrien","2020-02-02","0","0","0","0",".","."
"Berrien","2020-02-03","0","0","0","0",".","."
"Berrien","2020-02-04","0","0","0","0",".","."
"Berrien","2020-02-05","0","0","0","0",".","."
"Berrien","2020-02-06","0","0","0","0",".","."
"Berrien","2020-02-07","0","0","0","0","0","."
"Berrien","2020-02-08","0","0","0","0","0","."
"Berrien","2020-02-09","0","0","0","0","0","."
"Berrien","2020-02-10","0","0","0","0","0","."
"Berrien","2020-02-11","0","0","0","0","0","."
"Berrien","2020-02-12","0","0","0","0","0","."
"Berrien","2020-02-13","0","0","0","0","0","."
"Berrien","2020-02-14","0","0","0","0","0","0"
"Berrien","2020-02-15","0","0","0","0","0","0"
"Berrien","2020-02-16","0","0","0","0","0","0"
"Berrien","2020-02-17","0","0","0","0","0","0"
"Berrien","2020-02-18","0","0","0","0","0","0"
"Berrien","2020-02-19","0","0","0","0","0","0"
"Berrien","2020-02-20","0","0","0","0","0","0"
"Berrien","2020-02-21","0","0","0","0","0","0"
"Berrien","2020-02-22","0","0","0","0","0","0"
"Berrien","2020-02-23","0","0","0","0","0","0"
"Berrien","2020-02-24","0","0","0","0","0","0"
"Berrien","2020-02-25","0","0","0","0","0","0"
"Berrien","2020-02-26","0","0","0","0","0","0"
"Berrien","2020-02-27","0","0","0","0","0","0"
"Berrien","2020-02-28","0","0","0","0","0","0"
"Berrien","2020-02-29","0","0","0","0","0","0"
"Berrien","2020-03-01","0","0","0","0","0","0"
"Berrien","2020-03-02","0","0","0","0","0","0"
"Berrien","2020-03-03","0","0","0","0","0","0"
"Berrien","2020-03-04","0","0","0","0","0","0"
"Berrien","2020-03-05","0","0","0","0","0","0"
"Berrien","2020-03-06","0","0","0","0","0","0"
"Berrien","2020-03-07","0","0","0","0","0","0"
"Berrien","2020-03-08","0","0","0","0","0","0"
"Berrien","2020-03-09","0","0","0","0","0","0"
"Berrien","2020-03-10","0","0","0","0","0","0"
"Berrien","2020-03-11","0","0","0","0","0","0"
"Berrien","2020-03-12","0","0","0","0","0","0"
"Berrien","2020-03-13","0","0","0","0","0","0"
"Berrien","2020-03-14","1","1","0","0","0","0"
"Berrien","2020-03-15","0","1","0","0","0","0"
"Berrien","2020-03-16","0","1","0","0","0","0"
"Berrien","2020-03-17","0","1","0","0","0","0"
"Berrien","2020-03-18","2","3","0","0","0","0"
"Berrien","2020-03-19","2","5","0","0","0","0"
"Berrien","2020-03-20","1","6","0","0","0","0"
"Berrien","2020-03-21","0","6","0","0","0","0"
"Berrien","2020-03-22","1","7","0","0","0","0"
"Berrien","2020-03-23","2","9","0","0","0","0"
"Berrien","2020-03-24","1","10","0","0","0","0"
"Berrien","2020-03-25","3","13","0","0","0","0"
"Berrien","2020-03-26","10","23","0","0","0","0"
"Berrien","2020-03-27","1","24","0","0","0","0"
"Berrien","2020-03-28","1","25","0","0","0","0"
"Berrien","2020-03-29","2","27","0","0","0","0"
"Berrien","2020-03-30","1","28","0","0","0","0"
"Berrien","2020-03-31","1","29","0","0","0","0"
"Berrien","2020-04-01","1","30","0","0","0","0"
"Berrien","2020-04-02","5","35","0","0","0","0"
"Berrien","2020-04-03","5","40","1","1","2.9","1.4"
"Berrien","2020-04-04","0","40","0","1","2.9","1.4"
"Berrien","2020-04-05","1","41","0","1","2.9","1.4"
"Berrien","2020-04-06","2","43","1","2","10","5"
"Berrien","2020-04-07","4","47","0","2","10","5"
"Berrien","2020-04-08","5","52","1","3","12.9","6.4"
"Berrien","2020-04-09","2","54","0","3","12.9","6.4"
"Berrien","2020-04-10","4","58","0","3","10","6.4"
"Berrien","2020-04-11","2","60","0","3","10","6.4"
"Berrien","2020-04-12","1","61","1","4","24.3","13.6"
"Berrien","2020-04-13","2","63","0","4","17.1","13.6"
"Berrien","2020-04-14","7","70","1","5","19.2","14.6"
"Berrien","2020-04-15","4","74","0","5","16.3","14.6"
"Berrien","2020-04-16","6","80","0","5","16.3","14.6"
"Berrien","2020-04-17","4","84","0","5","16.3","13.2"
"Berrien","2020-04-18","2","86","1","6","23.5","16.7"
"Berrien","2020-04-19","0","86","0","6","9.2","16.7"
"Berrien","2020-04-20","6","92","1","7","11.6","14.4"
"Berrien","2020-04-21","8","100","1","8","11.3","15.2"
"Berrien","2020-04-22","2","102","0","8","11.3","13.8"
"Berrien","2020-04-23","3","105","1","9","16.1","16.2"
"Berrien","2020-04-24","6","111","0","9","16.1","16.2"
"Berrien","2020-04-25","2","113","0","9","8.9","16.2"
"Berrien","2020-04-26","1","114","1","10","23.2","16.2"
"Berrien","2020-04-27","6","120","2","12","25.6","18.6"
"Berrien","2020-04-28","5","125","0","12","23.8","17.6"
"Berrien","2020-04-29","50","175","1","13","24.1","17.7"
"Berrien","2020-04-30","6","181","0","13","19.3","17.7"
"Berrien","2020-05-01","14","195","1","14","20.4","18.2"
"Berrien","2020-05-02","1","196","0","14","20.4","14.6"
"Berrien","2020-05-03","0","196","0","14","6.1","14.6"
"Berrien","2020-05-04","12","208","0","14","1.3","13.5"
"Berrien","2020-05-05","7","215","0","14","1.3","12.6"
"Berrien","2020-05-06","15","230","0","14","1","12.6"
"Berrien","2020-05-07","18","248","1","15","1.8","10.6"
"Berrien","2020-05-08","6","254","0","15","0.8","10.6"
"Berrien","2020-05-09","1","255","0","15","0.8","10.6"
"Berrien","2020-05-10","1","256","0","15","0.8","3.4"
"Berrien","2020-05-11","41","297","1","16","1.1","1.2"
"Berrien","2020-05-12","8","305","0","16","1.1","1.2"
"Berrien","2020-05-13","32","337","0","16","1.1","1.1"
"Berrien","2020-05-14","21","358","3","19","2.4","2.1"
"Berrien","2020-05-15","4","362","0","19","2.4","1.6"
"Berrien","2020-05-16","4","366","0","19","2.4","1.6"
"Berrien","2020-05-17","3","369","1","20","7.2","4"
"Berrien","2020-05-18","11","380","5","25","13.3","7.2"
"Berrien","2020-05-19","6","386","2","27","18.1","9.6"
"Berrien","2020-05-20","24","410","1","28","18.7","9.9"
"Berrien","2020-05-21","19","429","2","30","18.1","10.3"
"Berrien","2020-05-22","9","438","1","31","19.7","11"
"Berrien","2020-05-23","3","441","1","32","24.5","13.4"
"Berrien","2020-05-24","1","442","1","33","34","20.6"
"Berrien","2020-05-25","1","443","1","34","41.8","27.5"
"Berrien","2020-05-26","14","457","3","37","40.1","29.1"
"Berrien","2020-05-27","15","472","2","39","41.4","30"
"Berrien","2020-05-28","10","482","2","41","42.7","30.4"
"Berrien","2020-05-29","4","486","0","41","41.2","30.4"
"Berrien","2020-05-30","0","486","0","41","36.4","30.4"
"Berrien","2020-05-31","2","488","1","42","29.3","31.6"
"Berrien","2020-06-01","8","496","2","44","18.5","30.2"
"Berrien","2020-06-02","9","505","1","45","17.1","28.6"
"Berrien","2020-06-03","21","526","3","48","17.2","29.3"
"Berrien","2020-06-04","37","563","1","49","14.7","28.7"
"Berrien","2020-06-05","18","581","1","50","15.5","28.3"
"Berrien","2020-06-06","8","589","1","51","17.3","26.9"
"Berrien","2020-06-07","1","590","0","51","10.2","19.7"
"Berrien","2020-06-08","17","607","2","53","8.3","13.4"
"Berrien","2020-06-09","14","621","0","53","6.7","11.9"
"Berrien","2020-06-10","33","654","5","58","6.8","12"
"Berrien","2020-06-11","36","690","6","64","8.8","11.8"
"Berrien","2020-06-12","33","723","1","65","8.4","12"
"Berrien","2020-06-13","2","725","1","66","13.8","15.6"
"Berrien","2020-06-14","1","726","0","66","13.8","12"
"Berrien","2020-06-15","18","744","2","68","13.7","11"
"Berrien","2020-06-16","27","771","1","69","14.2","10.5"
"Berrien","2020-06-17","71","842","5","74","13.1","9.9"
"Berrien","2020-06-18","76","918","2","76","11.1","9.9"
"Berrien","2020-06-19","191","1109","2","78","10.8","9.6"
"Berrien","2020-06-20","5","1114","0","78","3.6","8.7"
"Berrien","2020-06-21","3","1117","1","79","8.4","11.1"
"Berrien","2020-06-22","44","1161","7","86","9.1","11.4"
"Berrien","2020-06-23","28","1189","3","89","10.1","12.2"
"Berrien","2020-06-24","74","1263","6","95","10.2","11.7"
"Berrien","2020-06-25","76","1339","3","98","10.4","10.8"
"Berrien","2020-06-26","43","1382","1","99","10.6","10.7"
"Berrien","2020-06-27","6","1388","1","100","13","8.3"
"Berrien","2020-06-28","8","1396","2","102","11.8","10.1"
"Berrien","2020-06-29","40","1436","8","110","12.4","10.7"
"Berrien","2020-06-30","47","1483","15","125","15.4","12.8"
"Berrien","2020-07-01","55","1538","4","129","15.3","12.8"
"Berrien","2020-07-02","75","1613","2","131","15.1","12.8"
"Berrien","2020-07-03","9","1622","1","132","16.4","13.5"
"Berrien","2020-07-04","1","1623","0","132","14","13.5"
"Berrien","2020-07-05","2","1625","0","132","10.4","11.1"
"Berrien","2020-07-06","33","1658","8","140","11","11.7"
"Berrien","2020-07-07","18","1676","8","148","12.8","14.1"
"Berrien","2020-07-08","45","1721","4","152","13.1","14.2"
"Berrien","2020-07-09","46","1767","2","154","13.3","14.2"
"Berrien","2020-07-10","16","1783","2","156","13.5","14.9"
"Berrien","2020-07-11","11","1794","3","159","17.4","15.7"
"Berrien","2020-07-12","7","1801","4","163","25.5","18"
"Berrien","2020-07-13","31","1832","4","167","23.9","17.5"
"Berrien","2020-07-14","17","1849","0","167","17.6","15.2"
"Berrien","2020-07-15","57","1906","4","171","17.3","15.2"
"Berrien","2020-07-16","84","1990","6","177","17.7","15.5"
"Berrien","2020-07-17","32","2022","1","178","16.4","14.9"
"Berrien","2020-07-18","8","2030","1","179","14.3","15.8"
"Berrien","2020-07-19","8","2038","1","180","7.9","16.7"
"Berrien","2020-07-20","35","2073","7","187","8.9","16.4"
"Berrien","2020-07-21","32","2105","8","195","12.5","15"
"Berrien","2020-07-22","90","2195","11","206","13.2","15.3"
"Berrien","2020-07-23","75","2270","3","209","12.8","15.2"
"Berrien","2020-07-24","29","2299","6","215","15.3","15.8"
"Berrien","2020-07-25","9","2308","1","216","15.1","14.7"
"Berrien","2020-07-26","2","2310","0","216","13.3","10.6"
"Berrien","2020-07-27","44","2354","16","232","15.6","12.3"
"Berrien","2020-07-28","21","2375","3","235","14.1","13.3"
"Berrien","2020-07-29","73","2448","5","240","13.3","13.3"
"Berrien","2020-07-30","68","2516","12","252","15.3","14"
"Berrien","2020-07-31","22","2538","2","254","13.6","14.4"
"Berrien","2020-08-01","6","2544","0","254","12","13.6"
"Berrien","2020-08-02","5","2549","4","258","23.5","18.4"
"Berrien","2020-08-03","32","2581","3","261","19.6","17.6"
"Berrien","2020-08-04","38","2619","4","265","19.1","16.6"
"Berrien","2020-08-05","75","2694","13","278","20.6","16.9"
"Berrien","2020-08-06","55","2749","5","283","19.3","17.3"
"Berrien","2020-08-07","30","2779","12","295","23.8","18.7"
"Berrien","2020-08-08","11","2790","4","299","29","20.5"
"Berrien","2020-08-09","12","2802","1","300","18.7","21.1"
"Berrien","2020-08-10","51","2853","13","313","21","20.3"
"Berrien","2020-08-11","29","2882","8","321","23.5","21.3"
"Berrien","2020-08-12","78","2960","9","330","22.6","21.6"
"Berrien","2020-08-13","54","3014","6","336","22.9","21.1"
"Berrien","2020-08-14","33","3047","6","342","19.8","21.8"
"Berrien","2020-08-15","8","3055","1","343","16.4","22.7"
"Berrien","2020-08-16","9","3064","0","343","15.2","17"
"Berrien","2020-08-17","36","3100","3","346","12.8","16.9"
"Berrien","2020-08-18","39","3139","3","349","9.9","16.7"
"Berrien","2020-08-19","69","3208","17","366","11.8","17.2"
"Berrien","2020-08-20","49","3257","6","372","11.9","17.4"
"Berrien","2020-08-21","38","3295","9","381","12.7","16.3"
"Berrien","2020-08-22","4","3299","1","382","14.5","15.5"
"Berrien","2020-08-23","5","3304","1","383","17.4","16.3"
"Berrien","2020-08-24","48","3352","6","389","18","15.4"
"Berrien","2020-08-25","53","3405","8","397","19","14.5"
"Berrien","2020-08-26","72","3477","3","400","16.1","13.9"
"Berrien","2020-08-27","63","3540","3","403","15","13.5"
"Berrien","2020-08-28","22","3562","0","403","11.6","12.2"
"Berrien","2020-08-29","7","3569","2","405","12.2","13.3"
"Berrien","2020-08-30","8","3577","3","408","14.7","16"
"Berrien","2020-08-31","42","3619","2","410","13.6","15.8"
"Berrien","2020-09-01","36","3655","9","419","15","17"
"Berrien","2020-09-02","63","3718","3","422","15.1","15.6"
"Berrien","2020-09-03","69","3787","7","429","15.8","15.4"
"Berrien","2020-09-04","29","3816","1","430","16.3","14"
"Berrien","2020-09-05","5","3821","1","431","15.1","13.6"
"Berrien","2020-09-06","5","3826","2","433","15.4","15.1"
"Berrien","2020-09-07","5","3831","1","434","17.6","15.6"
"Berrien","2020-09-08","44","3875","2","436","14.7","14.8"
"Berrien","2020-09-09","56","3931","2","438","14.5","14.8"
"Berrien","2020-09-10","60","3991","3","441","13.8","14.8"
"Berrien","2020-09-11","25","4016","3","444","15","15.7"
"Berrien","2020-09-12","3","4019","0","444","12.2","13.6"
"Berrien","2020-09-13","10","4029","3","447","10.7","13.1"
"Berrien","2020-09-14","38","4067","4","451","9.4","13.5"
"Berrien","2020-09-15","27","4094","1","452","9.3","12"
"Berrien","2020-09-16","57","4151","5","457","10","12.3"
"Berrien","2020-09-17","43","4194","8","465","11.9","12.9"
"Berrien","2020-09-18","17","4211","2","467","11.9","13.5"
"Berrien","2020-09-19","6","4217","0","467","11.9","12"
"Berrien","2020-09-20","5","4222","1","468","10.5","10.6"
"Berrien","2020-09-21","29","4251","3","471","10.5","9.9"
"Berrien","2020-09-22","13","4264","2","473","12.1","10.7"
"Berrien","2020-09-23","43","4307","1","474","11.2","10.6"
"Berrien","2020-09-24","32","4339","1","475","9","10.5"
"Berrien","2020-09-25","15","4354","2","477","9.2","10.6"
"Berrien","2020-09-26","5","4359","1","478","12.1","12"
"Berrien","2020-09-27","5","4364","2","480","14.9","12.7"
"Berrien","2020-09-28","28","4392","4","484","15.5","13"
"Berrien","2020-09-29","13","4405","0","484","13.3","12.7"
"Berrien","2020-09-30","32","4437","3","487","14.3","12.8"
"Berrien","2020-10-01","29","4466","0","487","13.9","11.4"
"Berrien","2020-10-02","19","4485","1","488","12.7","11"
"Berrien","2020-10-03","3","4488","0","488","9.8","11"
"Berrien","2020-10-04","8","4496","1","489","5.9","10.4"
"Berrien","2020-10-05","20","4516","0","489","3.9","9.7"
"Berrien","2020-10-06","16","4532","1","490","4.8","9"
"Berrien","2020-10-07","36","4568","0","490","3.4","8.9"
"Berrien","2020-10-08","36","4604","2","492","4.2","9"
"Berrien","2020-10-09","27","4631","3","495","5.1","8.9"
"Berrien","2020-10-10","6","4637","0","495","5.1","7.5"
"Berrien","2020-10-11","5","4642","1","496","6.1","6"
"Berrien","2020-10-12","25","4667","2","498","7.3","5.6"
"Berrien","2020-10-13","29","4696","2","500","7.4","6.1"
"Berrien","2020-10-14","42","4738","5","505","9.1","6.2"
"Berrien","2020-10-15","30","4768","1","506","8.7","6.5"
"Berrien","2020-10-16","24","4792","1","507","7.8","6.4"
"Berrien","2020-10-17","5","4797","1","508","10.6","7.8"
"Berrien","2020-10-18","1","4798","0","508","7.8","6.9"
"Berrien","2020-10-19","30","4828","1","509","7.1","7.2"
"Berrien","2020-10-20","23","4851","2","511","7.3","7.4"
"Berrien","2020-10-21","36","4887","3","514","6.8","8"
"Berrien","2020-10-22","27","4914","4","518","8.5","8.6"
"Berrien","2020-10-23","17","4931","2","520","9.6","8.7"
"Berrien","2020-10-24","4","4935","0","520","6.7","8.7"
"Berrien","2020-10-25","4","4939","0","520","6.7","7.2"
"Berrien","2020-10-26","27","4966","1","521","6.8","6.9"
"Berrien","2020-10-27","17","4983","0","521","5.5","6.4"
"Berrien","2020-10-28","67","5050","8","529","6","6.4"
"Berrien","2020-10-29","40","5090","2","531","4.6","6.6"
"Berrien","2020-10-30","22","5112","0","531","2.9","6.3"
"Berrien","2020-10-31","11","5123","2","533","5.5","6.1"
"Berrien","2020-11-01","5","5128","0","533","5.5","6.1"
"Berrien","2020-11-02","23","5151","0","533","5","5.9"
"Berrien","2020-11-03","18","5169","0","533","5","5.3"
"Berrien","2020-11-04","33","5202","3","536","4.6","5.3"
"Berrien","2020-11-05","20","5222","1","537","4.6","4.6"
"Berrien","2020-11-06","19","5241","2","539","6.1","4.5"
"Berrien","2020-11-07","5","5246","0","539","3.5","4.5"
"Berrien","2020-11-08","5","5251","1","540","6.4","6"
"Berrien","2020-11-09","22","5273","1","541","7","6"
"Berrien","2020-11-10","26","5299","2","543","8.1","6.6"
"Berrien","2020-11-11","11","5310","2","545","9.4","7"
"Berrien","2020-11-12","33","5343","2","547","9.6","7.1"
"Berrien","2020-11-13","12","5355","0","547","8.1","7.1"
"Berrien","2020-11-14","11","5366","2","549","10.7","7.1"
"Berrien","2020-11-15","7","5373","2","551","11.9","9.1"
"Berrien","2020-11-16","28","5401","0","551","11.2","9.1"
"Berrien","2020-11-17","28","5429","7","558","13.7","10.9"
"Berrien","2020-11-18","71","5500","10","568","13.1","11.3"
"Berrien","2020-11-19","96","5596","10","578","13.8","11.7"
"Berrien","2020-11-20","37","5633","8","586","16.8","12.5"
"Berrien","2020-11-21","12","5645","1","587","15.4","13"
"Berrien","2020-11-22","7","5652","3","590","17.5","14.7"
"Berrien","2020-11-23","37","5689","7","597","20.2","15.7"
"Berrien","2020-11-24","24","5713","3","600","18.4","16.1"
"Berrien","2020-11-25","72","5785","11","611","18.6","15.8"
"Berrien","2020-11-26","7","5792","0","611","17.1","15.4"
"Berrien","2020-11-27","13","5805","3","614","17.3","17.1"
"Berrien","2020-11-28","17","5822","4","618","19.5","17.4"
"Berrien","2020-11-29","7","5829","1","619","15.4","16.4"
"Berrien","2020-11-30","35","5864","9","628","16.3","18.3"
"Berrien","2020-12-01","33","5897","5","633","16.7","17.6"
"Berrien","2020-12-02","22","5919","2","635","15.8","17.2"
"Berrien","2020-12-03","75","5994","15","650","18.7","17.9"
"Berrien","2020-12-04","23","6017","6","656","19.1","18.2"
"Berrien","2020-12-05","12","6029","2","658","18.1","18.8"
"Berrien","2020-12-06","12","6041","1","659","17.3","16.3"
"Berrien","2020-12-07","38","6079","5","664","15.5","15.9"
"Berrien","2020-12-08","44","6123","5","669","15","15.8"
"Berrien","2020-12-09","28","6151","2","671","14.7","15.3"
"Berrien","2020-12-10","84","6235","11","682","13.7","16.2"
"Berrien","2020-12-11","33","6268","4","686","11.7","15.4"
"Berrien","2020-12-12","4","6272","1","687","12.9","15.5"
"Berrien","2020-12-13","12","6284","1","688","12.9","15.1"
"Berrien","2020-12-14","51","6335","9","697","13.5","14.5"
"Berrien","2020-12-15","33","6368","8","705","15.4","15.2"
"Berrien","2020-12-16","36","6404","9","714","17.9","16.3"
"Berrien","2020-12-17","103","6507","20","734","18.8","16.3"
"Berrien","2020-12-18","33","6540","2","736","18","14.8"
"Berrien","2020-12-19","4","6544","1","737","18","15.4"
"Berrien","2020-12-20","14","6558","3","740","19.8","16.4"
"Berrien","2020-12-21","32","6590","9","749","21.3","17.4"
"Berrien","2020-12-22","22","6612","4","753","20.5","17.9"
"Berrien","2020-12-23","32","6644","3","756","18.2","18.1"
"Berrien","2020-12-24","5","6649","2","758","21.2","20"
"Berrien","2020-12-25","9","6658","6","764","29.8","23.9"
"Berrien","2020-12-26","7","6665","2","766","30.3","24.1"
"Berrien","2020-12-27","13","6678","4","770","31.7","25.7"
"Berrien","2020-12-28","36","6714","12","782","32.4","26.9"
"Berrien","2020-12-29","33","6747","12","794","35","27.7"
"Berrien","2020-12-30","35","6782","6","800","36.1","27.2"
"Berrien","2020-12-31","89","6871","13","813","32.5","26.8"
"Berrien","2021-01-01","5","6876","0","813","23","26.4"
"Berrien","2021-01-02","2","6878","0","813","18.9","24.6"
"Berrien","2021-01-03","11","6889","3","816","18.4","25"
"Berrien","2021-01-04","34","6923","11","827","18.2","25.3"
"Berrien","2021-01-05","34","6957","9","836","16.8","25.9"
"Berrien","2021-01-06","51","7008","15","851","18.6","27.4"
"Berrien","2021-01-07","49","7057","18","869","21.7","27.1"
"Berrien","2021-01-08","42","7099","6","875","23.8","23.4"
"Berrien","2021-01-09","12","7111","1","876","25","21.9"
"Berrien","2021-01-10","17","7128","5","881","25.3","21.8"
"Berrien","2021-01-11","45","7173","9","890","23.5","20.9"
"Berrien","2021-01-12","38","7211","4","894","21.2","19"
"Berrien","2021-01-13","30","7241","4","898","18.9","18.8"
"Berrien","2021-01-14","30","7271","3","901","15.1","18.4"
"Berrien","2021-01-15","40","7311","4","905","14.5","19.2"
"Berrien","2021-01-16","10","7321","2","907","16.2","20.6"
"Berrien","2021-01-17","15","7336","2","909","13.9","19.6"
"Berrien","2021-01-18","29","7365","3","912","12.5","18"
"Berrien","2021-01-19","37","7402","1","913","11.4","16.3"
"Berrien","2021-01-20","32","7434","6","919","12.2","15.6"
"Berrien","2021-01-21","32","7466","7","926","13.9","14.5"
"Berrien","2021-01-22","25","7491","2","928","13.6","14"
"Berrien","2021-01-23","6","7497","1","929","13.1","14.6"
"Berrien","2021-01-24","9","7506","4","933","17.5","15.7"
"Berrien","2021-01-25","32","7538","4","937","17.8","15.2"
"Berrien","2021-01-26","33","7571","5","942","19.6","15.5"
"Berrien","2021-01-27","35","7606","5","947","19","15.6"
"Berrien","2021-01-28","39","7645","5","952","17.7","15.8"
"Berrien","2021-01-29","19","7664","3","955","18.8","16.2"
"Berrien","2021-01-30","5","7669","0","955","16.4","14.8"
"Berrien","2021-01-31","5","7674","1","956","12.9","15.2"
"Berrien","2021-02-01","28","7702","4","960","13.2","15.5"
"Berrien","2021-02-02","40","7742","8","968","13.9","16.8"
"Berrien","2021-02-03","19","7761","0","968","11.8","15.4"
"Berrien","2021-02-04","26","7787","4","972","12.2","15"
"Berrien","2021-02-05","8","7795","2","974","13.5","16.2"
"Berrien","2021-02-06","5","7800","0","974","13.5","15"
"Berrien","2021-02-07","6","7806","3","977","17.8","15.4"
"Berrien","2021-02-08","0","7806","0","977","15.8","14.5"
"Bibb","2020-02-01","0","0","0","0",".","."
"Bibb","2020-02-02","0","0","0","0",".","."
"Bibb","2020-02-03","1","1","1","1",".","."
"Bibb","2020-02-04","0","1","0","1",".","."
"Bibb","2020-02-05","1","2","0","1",".","."
"Bibb","2020-02-06","1","3","0","1",".","."
"Bibb","2020-02-07","0","3","0","1","14.3","."
"Bibb","2020-02-08","0","3","0","1","14.3","."
"Bibb","2020-02-09","0","3","0","1","14.3","."
"Bibb","2020-02-10","0","3","0","1","0","."
"Bibb","2020-02-11","0","3","0","1","0","."
"Bibb","2020-02-12","0","3","0","1","0","."
"Bibb","2020-02-13","0","3","0","1","0","."
"Bibb","2020-02-14","0","3","0","1","0","7.1"
"Bibb","2020-02-15","0","3","0","1","0","7.1"
"Bibb","2020-02-16","0","3","0","1","0","7.1"
"Bibb","2020-02-17","0","3","0","1","0","0"
"Bibb","2020-02-18","0","3","0","1","0","0"
"Bibb","2020-02-19","0","3","0","1","0","0"
"Bibb","2020-02-20","0","3","0","1","0","0"
"Bibb","2020-02-21","0","3","0","1","0","0"
"Bibb","2020-02-22","0","3","0","1","0","0"
"Bibb","2020-02-23","0","3","0","1","0","0"
"Bibb","2020-02-24","0","3","0","1","0","0"
"Bibb","2020-02-25","0","3","0","1","0","0"
"Bibb","2020-02-26","0","3","0","1","0","0"
"Bibb","2020-02-27","0","3","0","1","0","0"
"Bibb","2020-02-28","0","3","0","1","0","0"
"Bibb","2020-02-29","0","3","0","1","0","0"
"Bibb","2020-03-01","0","3","0","1","0","0"
"Bibb","2020-03-02","0","3","0","1","0","0"
"Bibb","2020-03-03","0","3","0","1","0","0"
"Bibb","2020-03-04","0","3","0","1","0","0"
"Bibb","2020-03-05","3","6","0","1","0","0"
"Bibb","2020-03-06","0","6","0","1","0","0"
"Bibb","2020-03-07","0","6","0","1","0","0"
"Bibb","2020-03-08","0","6","0","1","0","0"
"Bibb","2020-03-09","0","6","0","1","0","0"
"Bibb","2020-03-10","0","6","0","1","0","0"
"Bibb","2020-03-11","3","9","0","1","0","0"
"Bibb","2020-03-12","14","23","0","1","0","0"
"Bibb","2020-03-13","4","27","0","1","0","0"
"Bibb","2020-03-14","7","34","0","1","0","0"
"Bibb","2020-03-15","3","37","1","2","4.8","2.4"
"Bibb","2020-03-16","16","53","1","3","5.7","2.8"
"Bibb","2020-03-17","16","69","0","3","5.7","2.8"
"Bibb","2020-03-18","28","97","0","3","5.7","2.8"
"Bibb","2020-03-19","33","130","2","5","6.5","3.3"
"Bibb","2020-03-20","60","190","2","7","7","3.5"
"Bibb","2020-03-21","14","204","1","8","8","4"
"Bibb","2020-03-22","19","223","3","11","5.5","5.1"
"Bibb","2020-03-23","48","271","10","21","7.6","6.6"
"Bibb","2020-03-24","65","336","9","30","9.6","7.6"
"Bibb","2020-03-25","73","409","7","37","10.9","8.3"
"Bibb","2020-03-26","55","464","6","43","11.6","9.1"
"Bibb","2020-03-27","60","524","6","49","12.6","9.8"
"Bibb","2020-03-28","13","537","1","50","12.7","10.3"
"Bibb","2020-03-29","17","554","5","55","14.6","10.1"
"Bibb","2020-03-30","62","616","7","62","13.2","10.4"
"Bibb","2020-03-31","43","659","0","62","11.3","10.4"
"Bibb","2020-04-01","102","761","12","74","11.6","11.3"
"Bibb","2020-04-02","124","885","12","86","11.4","11.5"
"Bibb","2020-04-03","119","1004","14","100","11.7","12.1"
"Bibb","2020-04-04","30","1034","4","104","12.5","12.6"
"Bibb","2020-04-05","24","1058","2","106","9.5","12"
"Bibb","2020-04-06","116","1174","15","121","9.7","11.5"
"Bibb","2020-04-07","93","1267","15","136","12","11.6"
"Bibb","2020-04-08","105","1372","22","158","13.3","12.4"
"Bibb","2020-04-09","64","1436","8","166","13.7","12.6"
"Bibb","2020-04-10","86","1522","19","185","15.2","13.4"
"Bibb","2020-04-11","33","1555","6","191","15.9","14.2"
"Bibb","2020-04-12","22","1577","10","201","21.2","15.3"
"Bibb","2020-04-13","111","1688","15","216","21.3","15.5"
"Bibb","2020-04-14","123","1811","18","234","21","16.5"
"Bibb","2020-04-15","84","1895","22","256","21.8","17.5"
"Bibb","2020-04-16","102","1997","4","260","20.6","17.1"
"Bibb","2020-04-17","75","2072","8","268","18.9","17.1"
"Bibb","2020-04-18","45","2117","4","272","17.6","16.7"
"Bibb","2020-04-19","32","2149","12","284","16.5","18.8"
"Bibb","2020-04-20","117","2266","21","305","17.1","19.2"
"Bibb","2020-04-21","115","2381","10","315","16.3","18.7"
"Bibb","2020-04-22","93","2474","2","317","12.8","17.3"
"Bibb","2020-04-23","47","2521","10","327","15.3","17.9"
"Bibb","2020-04-24","136","2657","16","343","15.5","17.2"
"Bibb","2020-04-25","65","2722","8","351","15.9","16.8"
"Bibb","2020-04-26","30","2752","2","353","11.5","14"
"Bibb","2020-04-27","161","2913","47","400","13.2","15.1"
"Bibb","2020-04-28","138","3051","37","437","15.7","16"
"Bibb","2020-04-29","133","3184","7","444","16.2","14.5"
"Bibb","2020-04-30","75","3259","9","453","14.9","15.1"
"Bibb","2020-05-01","99","3358","7","460","14.2","14.8"
"Bibb","2020-05-02","50","3408","6","466","14.1","15"
"Bibb","2020-05-03","54","3462","1","467","13.5","12.5"
"Bibb","2020-05-04","158","3620","32","499","12.2","12.7"
"Bibb","2020-05-05","109","3729","6","505","9.1","12.4"
"Bibb","2020-05-06","152","3881","7","512","9","12.6"
"Bibb","2020-05-07","161","4042","6","518","7.9","11.4"
"Bibb","2020-05-08","166","4208","7","525","7.5","10.8"
"Bibb","2020-05-09","70","4278","5","530","6.8","10.5"
"Bibb","2020-05-10","45","4323","6","536","8.4","10.9"
"Bibb","2020-05-11","128","4451","4","540","6","9.1"
"Bibb","2020-05-12","140","4591","6","546","5.8","7.5"
"Bibb","2020-05-13","142","4733","11","557","6.2","7.6"
"Bibb","2020-05-14","219","4952","16","573","6.7","7.3"
"Bibb","2020-05-15","145","5097","8","581","6.9","7.2"
"Bibb","2020-05-16","81","5178","4","585","6.6","6.7"
"Bibb","2020-05-17","41","5219","2","587","5.4","6.9"
"Bibb","2020-05-18","122","5341","9","596","6","6"
"Bibb","2020-05-19","189","5530","7","603","5.9","5.9"
"Bibb","2020-05-20","225","5755","11","614","5.5","5.9"
"Bibb","2020-05-21","113","5868","8","622","5.5","6.1"
"Bibb","2020-05-22","194","6062","6","628","5.1","6"
"Bibb","2020-05-23","61","6123","3","631","5.1","5.9"
"Bibb","2020-05-24","41","6164","4","635","5.8","5.6"
"Bibb","2020-05-25","35","6199","3","638","6","6"
"Bibb","2020-05-26","145","6344","8","646","6.3","6.1"
"Bibb","2020-05-27","104","6448","10","656","6.9","6.2"
"Bibb","2020-05-28","172","6620","12","668","6.9","6.2"
"Bibb","2020-05-29","106","6726","6","674","7.3","6.2"
"Bibb","2020-05-30","86","6812","6","680","7.6","6.4"
"Bibb","2020-05-31","55","6867","5","685","7.5","6.7"
"Bibb","2020-06-01","189","7056","15","700","7.4","6.7"
"Bibb","2020-06-02","191","7247","14","714","7.7","7"
"Bibb","2020-06-03","210","7457","13","727","7.2","7.1"
"Bibb","2020-06-04","197","7654","8","735","6.7","6.8"
"Bibb","2020-06-05","193","7847","11","746","6.8","7"
"Bibb","2020-06-06","60","7907","7","753","7.4","7.5"
"Bibb","2020-06-07","37","7944","7","760","8.8","8.2"
"Bibb","2020-06-08","216","8160","13","773","8.6","8"
"Bibb","2020-06-09","194","8354","4","777","7.8","7.7"
"Bibb","2020-06-10","170","8524","11","788","7.8","7.5"
"Bibb","2020-06-11","218","8742","9","797","7.9","7.3"
"Bibb","2020-06-12","161","8903","8","805","7.7","7.3"
"Bibb","2020-06-13","71","8974","6","811","7.3","7.4"
"Bibb","2020-06-14","39","9013","6","817","6.8","7.8"
"Bibb","2020-06-15","230","9243","23","840","7.4","8"
"Bibb","2020-06-16","184","9427","14","854","8.1","8"
"Bibb","2020-06-17","240","9667","22","876","8.5","8.2"
"Bibb","2020-06-18","242","9909","19","895","9.1","8.5"
"Bibb","2020-06-19","338","10247","19","914","9.2","8.5"
"Bibb","2020-06-20","144","10391","23","937","10.2","8.8"
"Bibb","2020-06-21","144","10535","13","950","9.3","8.1"
"Bibb","2020-06-22","364","10899","53","1003","10","8.7"
"Bibb","2020-06-23","285","11184","49","1052","11.3","9.7"
"Bibb","2020-06-24","326","11510","58","1110","12.6","10.6"
"Bibb","2020-06-25","465","11975","90","1200","14.2","11.6"
"Bibb","2020-06-26","416","12391","73","1273","15.9","12.5"
"Bibb","2020-06-27","307","12698","78","1351","17.3","13.7"
"Bibb","2020-06-28","161","12859","60","1411","21.3","15.3"
"Bibb","2020-06-29","496","13355","130","1541","23","16.5"
"Bibb","2020-06-30","550","13905","112","1653","23.4","17.4"
"Bibb","2020-07-01","690","14595","123","1776","23.4","18"
"Bibb","2020-07-02","647","15242","112","1888","23.1","18.7"
"Bibb","2020-07-03","287","15529","90","1978","25.1","20.5"
"Bibb","2020-07-04","133","15662","57","2035","27.6","22.4"
"Bibb","2020-07-05","179","15841","71","2106","27.9","24.6"
"Bibb","2020-07-06","525","16366","137","2243","27.9","25.4"
"Bibb","2020-07-07","678","17044","168","2411","28.6","26"
"Bibb","2020-07-08","624","17668","155","2566","29.6","26.5"
"Bibb","2020-07-09","721","18389","171","2737","30.5","26.8"
"Bibb","2020-07-10","705","19094","144","2881","28.9","27"
"Bibb","2020-07-11","345","19439","69","2950","25.6","26.6"
"Bibb","2020-07-12","196","19635","66","3016","24.8","26.4"
"Bibb","2020-07-13","604","20239","146","3162","24.5","26.2"
"Bibb","2020-07-14","555","20794","124","3286","24.2","26.4"
"Bibb","2020-07-15","620","21414","131","3417","23.6","26.6"
"Bibb","2020-07-16","580","21994","127","3544","23.4","26.9"
"Bibb","2020-07-17","646","22640","149","3693","23.8","26.3"
"Bibb","2020-07-18","277","22917","83","3776","25.2","25.4"
"Bibb","2020-07-19","255","23172","81","3857","24.9","24.8"
"Bibb","2020-07-20","618","23790","132","3989","24.5","24.5"
"Bibb","2020-07-21","540","24330","112","4101","24.3","24.2"
"Bibb","2020-07-22","558","24888","113","4214","24.1","23.9"
"Bibb","2020-07-23","576","25464","112","4326","23.8","23.6"
"Bibb","2020-07-24","663","26127","136","4462","23.4","23.6"
"Bibb","2020-07-25","234","26361","47","4509","22","23.6"
"Bibb","2020-07-26","151","26512","62","4571","23.4","24.1"
"Bibb","2020-07-27","686","27198","132","4703","23","23.8"
"Bibb","2020-07-28","585","27783","132","4835","23.3","23.8"
"Bibb","2020-07-29","498","28281","97","4932","23.2","23.7"
"Bibb","2020-07-30","706","28987","109","5041","22.6","23.2"
"Bibb","2020-07-31","502","29489","101","5142","22.6","23"
"Bibb","2020-08-01","289","29778","78","5220","23.6","22.8"
"Bibb","2020-08-02","173","29951","40","5260","21","22.2"
"Bibb","2020-08-03","574","30525","93","5353","20.6","21.8"
"Bibb","2020-08-04","442","30967","78","5431","19.9","21.6"
"Bibb","2020-08-05","485","31452","98","5529","20","21.6"
"Bibb","2020-08-06","474","31926","98","5627","20.7","21.7"
"Bibb","2020-08-07","574","32500","94","5721","20.2","21.4"
"Bibb","2020-08-08","250","32750","45","5766","18.9","21.2"
"Bibb","2020-08-09","147","32897","35","5801","19","20"
"Bibb","2020-08-10","401","33298","84","5885","19.7","20.1"
"Bibb","2020-08-11","380","33678","59","5944","19.4","19.6"
"Bibb","2020-08-12","405","34083","67","6011","18.8","19.4"
"Bibb","2020-08-13","444","34527","76","6087","18.3","19.5"
"Bibb","2020-08-14","401","34928","70","6157","18.5","19.3"
"Bibb","2020-08-15","233","35161","76","6233","20.6","19.7"
"Bibb","2020-08-16","321","35482","54","6287","19.6","19.3"
"Bibb","2020-08-17","303","35785","41","6328","18.5","19.1"
"Bibb","2020-08-18","404","36189","65","6393","18.6","19"
"Bibb","2020-08-19","367","36556","57","6450","18.5","18.6"
"Bibb","2020-08-20","293","36849","31","6481","17.5","17.9"
"Bibb","2020-08-21","535","37384","51","6532","16.4","17.4"
"Bibb","2020-08-22","201","37585","21","6553","13.2","16.9"
"Bibb","2020-08-23","181","37766","20","6573","12.4","16"
"Bibb","2020-08-24","353","38119","44","6617","12.2","15.4"
"Bibb","2020-08-25","369","38488","39","6656","11.5","15"
"Bibb","2020-08-26","410","38898","38","6694","10.6","14.5"
"Bibb","2020-08-27","297","39195","33","6727","10.6","14.1"
"Bibb","2020-08-28","337","39532","36","6763","10.8","13.6"
"Bibb","2020-08-29","125","39657","16","6779","11.1","12.2"
"Bibb","2020-08-30","130","39787","24","6803","12.2","12.3"
"Bibb","2020-08-31","396","40183","38","6841","11.8","12"
"Bibb","2020-09-01","298","40481","35","6876","12","11.7"
"Bibb","2020-09-02","322","40803","28","6904","11.9","11.2"
"Bibb","2020-09-03","280","41083","30","6934","11.8","11.2"
"Bibb","2020-09-04","273","41356","18","6952","11.2","11"
"Bibb","2020-09-05","162","41518","14","6966","10.6","10.9"
"Bibb","2020-09-06","85","41603","11","6977","9.8","11"
"Bibb","2020-09-07","85","41688","18","6995","11.5","11.6"
"Bibb","2020-09-08","312","42000","28","7023","11.1","11.5"
"Bibb","2020-09-09","401","42401","29","7052","10.9","11.4"
"Bibb","2020-09-10","276","42677","28","7080","10.8","11.3"
"Bibb","2020-09-11","230","42907","20","7100","11.1","11.2"
"Bibb","2020-09-12","146","43053","11","7111","11","10.8"
"Bibb","2020-09-13","76","43129","19","7130","12.7","11.3"
"Bibb","2020-09-14","256","43385","29","7159","11.3","11.4"
"Bibb","2020-09-15","244","43629","30","7189","11.7","11.4"
"Bibb","2020-09-16","279","43908","18","7207","11.6","11.3"
"Bibb","2020-09-17","222","44130","14","7221","11.1","11"
"Bibb","2020-09-18","276","44406","14","7235","10.6","10.8"
"Bibb","2020-09-19","137","44543","7","7242","10.2","10.6"
"Bibb","2020-09-20","96","44639","12","7254","8.4","10.6"
"Bibb","2020-09-21","269","44908","13","7267","7.5","9.4"
"Bibb","2020-09-22","268","45176","13","7280","6.4","9.1"
"Bibb","2020-09-23","194","45370","15","7295","6.6","9.1"
"Bibb","2020-09-24","171","45541","17","7312","7.1","9.1"
"Bibb","2020-09-25","259","45800","19","7331","7.5","9"
"Bibb","2020-09-26","89","45889","3","7334","7.2","8.7"
"Bibb","2020-09-27","85","45974","7","7341","6.6","7.5"
"Bibb","2020-09-28","271","46245","22","7363","7.1","7.3"
"Bibb","2020-09-29","242","46487","10","7373","7","6.7"
"Bibb","2020-09-30","243","46730","19","7392","7","6.8"
"Bibb","2020-10-01","218","46948","11","7403","6.3","6.7"
"Bibb","2020-10-02","260","47208","29","7432","6.8","7.2"
"Bibb","2020-10-03","107","47315","9","7441","7.6","7.4"
"Bibb","2020-10-04","107","47422","16","7457","8.5","7.6"
"Bibb","2020-10-05","335","47757","38","7495","9","8"
"Bibb","2020-10-06","408","48165","29","7524","9.4","8.2"
"Bibb","2020-10-07","363","48528","26","7550","9.3","8.2"
"Bibb","2020-10-08","243","48771","28","7578","10.2","8.3"
"Bibb","2020-10-09","314","49085","18","7596","9.5","8.2"
"Bibb","2020-10-10","160","49245","15","7611","9.6","8.6"
"Bibb","2020-10-11","98","49343","13","7624","9.4","8.9"
"Bibb","2020-10-12","278","49621","26","7650","9.1","9"
"Bibb","2020-10-13","385","50006","34","7684","9.3","9.4"
"Bibb","2020-10-14","325","50331","20","7704","9.2","9.2"
"Bibb","2020-10-15","259","50590","17","7721","8.5","9.4"
"Bibb","2020-10-16","290","50880","18","7739","8.5","9"
"Bibb","2020-10-17","89","50969","9","7748","8.6","9.1"
"Bibb","2020-10-18","81","51050","13","7761","9","9.2"
"Bibb","2020-10-19","377","51427","31","7792","8.9","9"
"Bibb","2020-10-20","302","51729","22","7814","8.7","9"
"Bibb","2020-10-21","278","52007","12","7826","8.4","8.8"
"Bibb","2020-10-22","223","52230","19","7845","8.7","8.6"
"Bibb","2020-10-23","280","52510","19","7864","8.8","8.6"
"Bibb","2020-10-24","118","52628","8","7872","8.3","8.5"
"Bibb","2020-10-25","94","52722","12","7884","7.8","8.4"
"Bibb","2020-10-26","273","52995","22","7906","7.8","8.3"
"Bibb","2020-10-27","236","53231","24","7930","8.2","8.4"
"Bibb","2020-10-28","301","53532","30","7960","9","8.7"
"Bibb","2020-10-29","243","53775","18","7978","8.8","8.8"
"Bibb","2020-10-30","266","54041","21","7999","9","8.9"
"Bibb","2020-10-31","114","54155","12","8011","9.5","8.9"
"Bibb","2020-11-01","94","54249","16","8027","10.1","9"
"Bibb","2020-11-02","365","54614","20","8047","9.8","8.8"
"Bibb","2020-11-03","308","54922","24","8071","9.4","8.8"
"Bibb","2020-11-04","274","55196","18","8089","9","9"
"Bibb","2020-11-05","203","55399","9","8098","8.5","8.7"
"Bibb","2020-11-06","263","55662","23","8121","8.7","8.8"
"Bibb","2020-11-07","105","55767","17","8138","9.5","9.5"
"Bibb","2020-11-08","109","55876","11","8149","8.5","9.3"
"Bibb","2020-11-09","374","56250","40","8189","9.2","9.5"
"Bibb","2020-11-10","285","56535","25","8214","9.4","9.4"
"Bibb","2020-11-11","239","56774","23","8237","9.8","9.4"
"Bibb","2020-11-12","251","57025","24","8261","10.5","9.5"
"Bibb","2020-11-13","292","57317","25","8286","10.5","9.6"
"Bibb","2020-11-14","108","57425","17","8303","10.4","9.9"
"Bibb","2020-11-15","103","57528","15","8318","11.1","9.8"
"Bibb","2020-11-16","404","57932","33","8351","10.7","10"
"Bibb","2020-11-17","294","58226","24","8375","10.6","10"
"Bibb","2020-11-18","371","58597","24","8399","10.2","10"
"Bibb","2020-11-19","267","58864","18","8417","9.8","10.1"
"Bibb","2020-11-20","313","59177","27","8444","9.8","10.1"
"Bibb","2020-11-21","144","59321","15","8459","9","9.7"
"Bibb","2020-11-22","108","59429","11","8470","8.4","9.7"
"Bibb","2020-11-23","354","59783","36","8506","8.7","9.7"
"Bibb","2020-11-24","260","60043","32","8538","9.3","9.9"
"Bibb","2020-11-25","335","60378","43","8581","10.2","10.2"
"Bibb","2020-11-26","42","60420","6","8587","11.3","10.5"
"Bibb","2020-11-27","202","60622","34","8621","12.4","11.1"
"Bibb","2020-11-28","138","60760","22","8643","13.2","11.1"
"Bibb","2020-11-29","151","60911","37","8680","15.3","11.8"
"Bibb","2020-11-30","509","61420","73","8753","15.9","12.3"
"Bibb","2020-12-01","318","61738","33","8786","15.6","12.4"
"Bibb","2020-12-02","372","62110","65","8851","16.3","13.2"
"Bibb","2020-12-03","325","62435","53","8904","16.5","13.9"
"Bibb","2020-12-04","377","62812","73","8977","16.9","14.7"
"Bibb","2020-12-05","196","63008","48","9025","18.1","15.7"
"Bibb","2020-12-06","179","63187","27","9052","16.8","16"
"Bibb","2020-12-07","390","63577","48","9100","16.5","16.2"
"Bibb","2020-12-08","462","64039","55","9155","16.7","16.1"
"Bibb","2020-12-09","388","64427","52","9207","16.1","16.2"
"Bibb","2020-12-10","425","64852","83","9290","16.6","16.6"
"Bibb","2020-12-11","391","65243","64","9354","16.2","16.5"
"Bibb","2020-12-12","179","65422","48","9402","16.5","17.3"
"Bibb","2020-12-13","187","65609","56","9458","18.6","17.7"
"Bibb","2020-12-14","442","66051","81","9539","19.5","18"
"Bibb","2020-12-15","482","66533","74","9613","20","18.3"
"Bibb","2020-12-16","408","66941","64","9677","20.3","18.2"
"Bibb","2020-12-17","481","67422","99","9776","20.4","18.5"
"Bibb","2020-12-18","412","67834","63","9839","20.3","18.2"
"Bibb","2020-12-19","210","68044","45","9884","19.5","18"
"Bibb","2020-12-20","246","68290","55","9939","18.4","18.5"
"Bibb","2020-12-21","444","68734","109","10048","19.3","19.4"
"Bibb","2020-12-22","483","69217","99","10147","20.1","20"
"Bibb","2020-12-23","501","69718","89","10236","20.4","20.3"
"Bibb","2020-12-24","331","70049","69","10305","20.4","20.4"
"Bibb","2020-12-25","100","70149","20","10325","21.1","20.7"
"Bibb","2020-12-26","242","70391","75","10400","22.4","21"
"Bibb","2020-12-27","251","70642","52","10452","22.2","20.3"
"Bibb","2020-12-28","718","71360","170","10622","22.1","20.7"
"Bibb","2020-12-29","683","72043","195","10817","23.2","21.6"
"Bibb","2020-12-30","607","72650","135","10952","23.9","22.1"
"Bibb","2020-12-31","546","73196","119","11071","24","22.2"
"Bibb","2021-01-01","215","73411","47","11118","24.3","22.7"
"Bibb","2021-01-02","228","73639","66","11184","24","23.2"
"Bibb","2021-01-03","271","73910","81","11265","25.3","23.7"
"Bibb","2021-01-04","592","74502","152","11417","25.6","23.8"
"Bibb","2021-01-05","778","75280","142","11559","24.1","23.7"
"Bibb","2021-01-06","579","75859","132","11691","24.2","24"
"Bibb","2021-01-07","647","76506","127","11818","23.9","23.9"
"Bibb","2021-01-08","485","76991","81","11899","23.1","23.7"
"Bibb","2021-01-09","273","77264","70","11969","22.7","23.3"
"Bibb","2021-01-10","272","77536","78","12047","22.5","23.9"
"Bibb","2021-01-11","598","78134","114","12161","21.5","23.6"
"Bibb","2021-01-12","509","78643","106","12267","21.9","23"
"Bibb","2021-01-13","469","79112","81","12348","21.1","22.6"
"Bibb","2021-01-14","548","79660","87","12435","20.6","22.2"
"Bibb","2021-01-15","404","80064","76","12511","20.9","22"
"Bibb","2021-01-16","211","80275","48","12559","20.5","21.6"
"Bibb","2021-01-17","289","80564","56","12615","19.1","20.8"
"Bibb","2021-01-18","464","81028","69","12684","18.5","20"
"Bibb","2021-01-19","449","81477","78","12762","18","20"
"Bibb","2021-01-20","431","81908","58","12820","17.5","19.3"
"Bibb","2021-01-21","437","82345","69","12889","17.5","19"
"Bibb","2021-01-22","330","82675","62","12951","17.5","19.2"
"Bibb","2021-01-23","174","82849","43","12994","17.8","19.1"
"Bibb","2021-01-24","212","83061","42","13036","17.8","18.5"
"Bibb","2021-01-25","455","83516","62","13098","17.7","18.1"
"Bibb","2021-01-26","348","83864","37","13135","16.7","17.4"
"Bibb","2021-01-27","372","84236","51","13186","16.7","17.1"
"Bibb","2021-01-28","376","84612","55","13241","16.6","17"
"Bibb","2021-01-29","299","84911","59","13300","16.7","17.1"
"Bibb","2021-01-30","165","85076","26","13326","15.4","16.6"
"Bibb","2021-01-31","149","85225","34","13360","15.8","16.8"
"Bibb","2021-02-01","418","85643","46","13406","15.5","16.6"
"Bibb","2021-02-02","318","85961","41","13447","15.8","16.2"
"Bibb","2021-02-03","319","86280","39","13486","15.6","16.2"
"Bibb","2021-02-04","250","86530","33","13519","15.4","16"
"Bibb","2021-02-05","229","86759","26","13545","14.2","15.4"
"Bibb","2021-02-06","62","86821","12","13557","14.7","15.1"
"Bibb","2021-02-07","7","86828","2","13559","15.5","15.7"
"Bibb","2021-02-08","0","86828","0","13559","13.9","14.7"
"Bleckley","2020-02-01","0","0","0","0",".","."
"Bleckley","2020-02-02","0","0","0","0",".","."
"Bleckley","2020-02-03","0","0","0","0",".","."
"Bleckley","2020-02-04","0","0","0","0",".","."
"Bleckley","2020-02-05","0","0","0","0",".","."
"Bleckley","2020-02-06","0","0","0","0",".","."
"Bleckley","2020-02-07","0","0","0","0","0","."
"Bleckley","2020-02-08","0","0","0","0","0","."
"Bleckley","2020-02-09","0","0","0","0","0","."
"Bleckley","2020-02-10","0","0","0","0","0","."
"Bleckley","2020-02-11","0","0","0","0","0","."
"Bleckley","2020-02-12","0","0","0","0","0","."
"Bleckley","2020-02-13","0","0","0","0","0","."
"Bleckley","2020-02-14","0","0","0","0","0","0"
"Bleckley","2020-02-15","0","0","0","0","0","0"
"Bleckley","2020-02-16","0","0","0","0","0","0"
"Bleckley","2020-02-17","0","0","0","0","0","0"
"Bleckley","2020-02-18","0","0","0","0","0","0"
"Bleckley","2020-02-19","0","0","0","0","0","0"
"Bleckley","2020-02-20","0","0","0","0","0","0"
"Bleckley","2020-02-21","0","0","0","0","0","0"
"Bleckley","2020-02-22","0","0","0","0","0","0"
"Bleckley","2020-02-23","0","0","0","0","0","0"
"Bleckley","2020-02-24","0","0","0","0","0","0"
"Bleckley","2020-02-25","0","0","0","0","0","0"
"Bleckley","2020-02-26","0","0","0","0","0","0"
"Bleckley","2020-02-27","0","0","0","0","0","0"
"Bleckley","2020-02-28","0","0","0","0","0","0"
"Bleckley","2020-02-29","0","0","0","0","0","0"
"Bleckley","2020-03-01","0","0","0","0","0","0"
"Bleckley","2020-03-02","0","0","0","0","0","0"
"Bleckley","2020-03-03","0","0","0","0","0","0"
"Bleckley","2020-03-04","0","0","0","0","0","0"
"Bleckley","2020-03-05","0","0","0","0","0","0"
"Bleckley","2020-03-06","0","0","0","0","0","0"
"Bleckley","2020-03-07","0","0","0","0","0","0"
"Bleckley","2020-03-08","0","0","0","0","0","0"
"Bleckley","2020-03-09","0","0","0","0","0","0"
"Bleckley","2020-03-10","0","0","0","0","0","0"
"Bleckley","2020-03-11","0","0","0","0","0","0"
"Bleckley","2020-03-12","1","1","0","0","0","0"
"Bleckley","2020-03-13","0","1","0","0","0","0"
"Bleckley","2020-03-14","0","1","0","0","0","0"
"Bleckley","2020-03-15","0","1","0","0","0","0"
"Bleckley","2020-03-16","1","2","0","0","0","0"
"Bleckley","2020-03-17","1","3","0","0","0","0"
"Bleckley","2020-03-18","2","5","0","0","0","0"
"Bleckley","2020-03-19","5","10","0","0","0","0"
"Bleckley","2020-03-20","3","13","0","0","0","0"
"Bleckley","2020-03-21","0","13","0","0","0","0"
"Bleckley","2020-03-22","0","13","0","0","0","0"
"Bleckley","2020-03-23","4","17","0","0","0","0"
"Bleckley","2020-03-24","3","20","0","0","0","0"
"Bleckley","2020-03-25","2","22","0","0","0","0"
"Bleckley","2020-03-26","5","27","1","1","2.9","1.4"
"Bleckley","2020-03-27","1","28","0","1","2.9","1.4"
"Bleckley","2020-03-28","0","28","0","1","2.9","1.4"
"Bleckley","2020-03-29","0","28","0","1","2.9","1.4"
"Bleckley","2020-03-30","3","31","0","1","2.9","1.4"
"Bleckley","2020-03-31","6","37","0","1","2.9","1.4"
"Bleckley","2020-04-01","1","38","0","1","2.9","1.4"
"Bleckley","2020-04-02","2","40","0","1","0","1.4"
"Bleckley","2020-04-03","2","42","0","1","0","1.4"
"Bleckley","2020-04-04","1","43","0","1","0","1.4"
"Bleckley","2020-04-05","2","45","0","1","0","1.4"
"Bleckley","2020-04-06","1","46","0","1","0","1.4"
"Bleckley","2020-04-07","0","46","0","1","0","1.4"
"Bleckley","2020-04-08","0","46","0","1","0","1.4"
"Bleckley","2020-04-09","3","49","0","1","0","0"
"Bleckley","2020-04-10","2","51","0","1","0","0"
"Bleckley","2020-04-11","0","51","0","1","0","0"
"Bleckley","2020-04-12","1","52","0","1","0","0"
"Bleckley","2020-04-13","2","54","1","2","7.1","3.6"
"Bleckley","2020-04-14","0","54","0","2","7.1","3.6"
"Bleckley","2020-04-15","3","57","1","3","11.9","6"
"Bleckley","2020-04-16","0","57","0","3","11.9","6"
"Bleckley","2020-04-17","1","58","0","3","11.9","6"
"Bleckley","2020-04-18","1","59","0","3","11.9","6"
"Bleckley","2020-04-19","1","60","0","3","11.9","6"
"Bleckley","2020-04-20","2","62","0","3","4.8","6"
"Bleckley","2020-04-21","10","72","4","7","10.5","8.8"
"Bleckley","2020-04-22","3","75","1","8","10.5","11.2"
"Bleckley","2020-04-23","2","77","0","8","10.5","11.2"
"Bleckley","2020-04-24","11","88","2","10","13.1","12.5"
"Bleckley","2020-04-25","0","88","0","10","13.1","12.5"
"Bleckley","2020-04-26","1","89","0","10","13.1","12.5"
"Bleckley","2020-04-27","5","94","3","13","21.6","13.2"
"Bleckley","2020-04-28","5","99","1","14","18.8","14.6"
"Bleckley","2020-04-29","8","107","1","15","15.8","13.1"
"Bleckley","2020-04-30","1","108","0","15","15.8","13.1"
"Bleckley","2020-05-01","3","111","1","16","18","15.5"
"Bleckley","2020-05-02","1","112","1","17","32.3","22.7"
"Bleckley","2020-05-03","5","117","0","17","32.3","22.7"
"Bleckley","2020-05-04","1","118","0","17","23.7","22.7"
"Bleckley","2020-05-05","4","122","1","18","24.4","21.6"
"Bleckley","2020-05-06","0","122","0","18","22.6","19.2"
"Bleckley","2020-05-07","0","122","0","18","22.6","19.2"
"Bleckley","2020-05-08","20","142","0","18","17.9","17.9"
"Bleckley","2020-05-09","3","145","0","18","3.6","17.9"
"Bleckley","2020-05-10","0","145","0","18","3.6","17.9"
"Bleckley","2020-05-11","26","171","0","18","3.6","13.6"
"Bleckley","2020-05-12","1","172","0","18","0","12.2"
"Bleckley","2020-05-13","1","173","0","18","0","11.3"
"Bleckley","2020-05-14","2","175","0","18","0","11.3"
"Bleckley","2020-05-15","2","177","0","18","0","8.9"
"Bleckley","2020-05-16","2","179","1","19","7.1","5.4"
"Bleckley","2020-05-17","2","181","1","20","14.3","8.9"
"Bleckley","2020-05-18","3","184","1","21","19","11.3"
"Bleckley","2020-05-19","2","186","0","21","19","9.5"
"Bleckley","2020-05-20","23","209","1","22","19.7","9.8"
"Bleckley","2020-05-21","4","213","0","22","19.7","9.8"
"Bleckley","2020-05-22","5","218","1","23","22.5","11.3"
"Bleckley","2020-05-23","6","224","3","26","22.5","14.8"
"Bleckley","2020-05-24","1","225","1","27","29.7","22"
"Bleckley","2020-05-25","3","228","0","27","24.9","22"
"Bleckley","2020-05-26","4","232","0","27","24.9","22"
"Bleckley","2020-05-27","6","238","1","28","26.7","23.2"
"Bleckley","2020-05-28","7","245","0","28","26.7","23.2"
"Bleckley","2020-05-29","5","250","0","28","23.8","23.2"
"Bleckley","2020-05-30","3","253","1","29","21.4","22"
"Bleckley","2020-05-31","1","254","0","29","7.1","18.4"
"Bleckley","2020-06-01","11","265","1","30","8.4","16.7"
"Bleckley","2020-06-02","11","276","2","32","11","18"
"Bleckley","2020-06-03","4","280","0","32","8.7","17.7"
"Bleckley","2020-06-04","19","299","2","34","10.2","18.4"
"Bleckley","2020-06-05","13","312","1","35","11.3","17.5"
"Bleckley","2020-06-06","5","317","0","35","6.5","14"
"Bleckley","2020-06-07","2","319","1","36","13.6","10.4"
"Bleckley","2020-06-08","10","329","1","37","13.8","11.1"
"Bleckley","2020-06-09","7","336","2","39","15.3","13.1"
"Bleckley","2020-06-10","7","343","0","39","15.3","12"
"Bleckley","2020-06-11","6","349","1","40","16.1","13.1"
"Bleckley","2020-06-12","8","357","1","41","16.8","14"
"Bleckley","2020-06-13","4","361","0","41","16.8","11.7"
"Bleckley","2020-06-14","2","363","1","42","16.8","15.2"
"Bleckley","2020-06-15","5","368","2","44","21.1","17.4"
"Bleckley","2020-06-16","4","372","0","44","17","16.1"
"Bleckley","2020-06-17","10","382","3","47","21.3","18.3"
"Bleckley","2020-06-18","2","384","0","47","18.9","17.5"
"Bleckley","2020-06-19","10","394","1","48","18.6","17.7"
"Bleckley","2020-06-20","1","395","0","48","18.6","17.7"
"Bleckley","2020-06-21","4","399","3","51","22.1","19.5"
"Bleckley","2020-06-22","7","406","0","51","16.4","18.8"
"Bleckley","2020-06-23","4","410","2","53","23.6","20.3"
"Bleckley","2020-06-24","9","419","0","53","19.3","20.3"
"Bleckley","2020-06-25","4","423","1","54","22.9","20.9"
"Bleckley","2020-06-26","1","424","0","54","21.4","20"
"Bleckley","2020-06-27","4","428","2","56","28.6","23.6"
"Bleckley","2020-06-28","1","429","0","56","17.9","20"
"Bleckley","2020-06-29","5","434","3","59","26.4","21.4"
"Bleckley","2020-06-30","12","446","2","61","21.7","22.6"
"Bleckley","2020-07-01","12","458","2","63","24","21.7"
"Bleckley","2020-07-02","6","464","1","64","22.9","22.9"
"Bleckley","2020-07-03","3","467","0","64","22.9","22.1"
"Bleckley","2020-07-04","2","469","2","66","30","29.3"
"Bleckley","2020-07-05","0","469","0","66","30","23.9"
"Bleckley","2020-07-06","13","482","2","68","23.6","25"
"Bleckley","2020-07-07","3","485","0","68","21.2","21.5"
"Bleckley","2020-07-08","9","494","0","68","18.9","21.5"
"Bleckley","2020-07-09","15","509","0","68","16.5","19.7"
"Bleckley","2020-07-10","101","610","5","73","17.2","20"
"Bleckley","2020-07-11","0","610","0","73","2.9","16.5"
"Bleckley","2020-07-12","2","612","1","74","10","20"
"Bleckley","2020-07-13","6","618","0","74","7.9","15.7"
"Bleckley","2020-07-14","5","623","0","74","7.9","14.5"
"Bleckley","2020-07-15","1","624","0","74","7.9","13.4"
"Bleckley","2020-07-16","4","628","0","74","7.9","12.2"
"Bleckley","2020-07-17","6","634","1","75","9.5","13.4"
"Bleckley","2020-07-18","1","635","0","75","9.5","6.2"
"Bleckley","2020-07-19","0","635","0","75","2.4","6.2"
"Bleckley","2020-07-20","11","646","0","75","2.4","5.1"
"Bleckley","2020-07-21","7","653","2","77","6.5","7.2"
"Bleckley","2020-07-22","1","654","0","77","6.5","7.2"
"Bleckley","2020-07-23","4","658","1","78","10","8.9"
"Bleckley","2020-07-24","9","667","0","78","7.7","8.6"
"Bleckley","2020-07-25","3","670","1","79","12.4","11"
"Bleckley","2020-07-26","2","672","0","79","12.4","7.4"
"Bleckley","2020-07-27","7","679","1","80","14.5","8.4"
"Bleckley","2020-07-28","3","682","1","81","15.1","10.8"
"Bleckley","2020-07-29","6","688","2","83","19.9","13.2"
"Bleckley","2020-07-30","5","693","0","83","16.3","13.2"
"Bleckley","2020-07-31","11","704","4","87","21.5","14.6"
"Bleckley","2020-08-01","0","704","0","87","16.8","14.6"
"Bleckley","2020-08-02","0","704","0","87","16.8","14.6"
"Bleckley","2020-08-03","7","711","1","88","16.8","15.6"
"Bleckley","2020-08-04","23","734","12","100","19.5","17.3"
"Bleckley","2020-08-05","25","759","12","112","21.5","20.7"
"Bleckley","2020-08-06","14","773","3","115","24.6","20.5"
"Bleckley","2020-08-07","14","787","6","121","25.5","23.5"
"Bleckley","2020-08-08","1","788","1","122","39.8","28.3"
"Bleckley","2020-08-09","1","789","0","122","39.8","28.3"
"Bleckley","2020-08-10","4","793","3","125","48.5","32.6"
"Bleckley","2020-08-11","8","801","1","126","42.8","31.1"
"Bleckley","2020-08-12","7","808","5","131","46.2","33.9"
"Bleckley","2020-08-13","10","818","3","134","47.4","36"
"Bleckley","2020-08-14","4","822","1","135","44.8","35.2"
"Bleckley","2020-08-15","10","832","1","136","32","35.9"
"Bleckley","2020-08-16","2","834","1","137","39.1","39.5"
"Bleckley","2020-08-17","11","845","0","137","28.4","38.5"
"Bleckley","2020-08-18","12","857","2","139","29","35.9"
"Bleckley","2020-08-19","7","864","1","140","20.9","33.5"
"Bleckley","2020-08-20","28","892","10","150","21.7","34.5"
"Bleckley","2020-08-21","6","898","0","150","18.1","31.5"
"Bleckley","2020-08-22","6","904","1","151","19","25.5"
"Bleckley","2020-08-23","2","906","0","151","11.9","25.5"
"Bleckley","2020-08-24","11","917","1","152","13.2","20.8"
"Bleckley","2020-08-25","14","931","1","153","11.8","20.4"
"Bleckley","2020-08-26","7","938","3","156","15.9","18.4"
"Bleckley","2020-08-27","8","946","1","157","12.6","17.1"
"Bleckley","2020-08-28","9","955","1","158","14.2","16.1"
"Bleckley","2020-08-29","5","960","0","158","11.8","15.4"
"Bleckley","2020-08-30","1","961","0","158","11.8","11.9"
"Bleckley","2020-08-31","9","970","0","158","10.5","11.9"
"Bleckley","2020-09-01","5","975","1","159","12.4","12.1"
"Bleckley","2020-09-02","135","1110","24","183","8.8","12.3"
"Bleckley","2020-09-03","6","1116","1","184","9.4","11"
"Bleckley","2020-09-04","3","1119","0","184","7.8","11"
"Bleckley","2020-09-05","5","1124","0","184","7.8","9.8"
"Bleckley","2020-09-06","3","1127","0","184","7.8","9.8"
"Bleckley","2020-09-07","2","1129","1","185","14.9","12.7"
"Bleckley","2020-09-08","9","1138","0","185","12.1","12.2"
"Bleckley","2020-09-09","95","1233","10","195","11","9.9"
"Bleckley","2020-09-10","4","1237","0","195","8.6","9"
"Bleckley","2020-09-11","3","1240","0","195","8.6","8.2"
"Bleckley","2020-09-12","2","1242","0","195","8.6","8.2"
"Bleckley","2020-09-13","0","1242","0","195","8.6","8.2"
"Bleckley","2020-09-14","9","1251","1","196","3.1","9"
"Bleckley","2020-09-15","7","1258","0","196","3.1","7.6"
"Bleckley","2020-09-16","2","1260","1","197","8.7","9.9"
"Bleckley","2020-09-17","5","1265","1","198","11.6","10.1"
"Bleckley","2020-09-18","11","1276","0","198","11.6","10.1"
"Bleckley","2020-09-19","3","1279","0","198","11.6","10.1"
"Bleckley","2020-09-20","1","1280","1","199","25.9","17.3"
"Bleckley","2020-09-21","5","1285","1","200","27.1","15.1"
"Bleckley","2020-09-22","21","1306","2","202","28.5","15.8"
"Bleckley","2020-09-23","79","1385","4","206","22.1","15.4"
"Bleckley","2020-09-24","4","1389","0","206","19.2","15.4"
"Bleckley","2020-09-25","12","1401","0","206","19.2","15.4"
"Bleckley","2020-09-26","3","1404","0","206","19.2","15.4"
"Bleckley","2020-09-27","1","1405","1","207","19.2","22.5"
"Bleckley","2020-09-28","6","1411","0","207","16.4","21.8"
"Bleckley","2020-09-29","6","1417","0","207","15","21.8"
"Bleckley","2020-09-30","64","1481","6","213","15.6","18.9"
"Bleckley","2020-10-01","8","1489","0","213","15.6","17.4"
"Bleckley","2020-10-02","6","1495","0","213","15.6","17.4"
"Bleckley","2020-10-03","9","1504","0","213","15.6","17.4"
"Bleckley","2020-10-04","3","1507","1","214","6.1","12.7"
"Bleckley","2020-10-05","7","1514","0","214","6.1","11.2"
"Bleckley","2020-10-06","10","1524","0","214","6.1","10.6"
"Bleckley","2020-10-07","91","1615","11","225","6.5","11.1"
"Bleckley","2020-10-08","9","1624","0","225","6.5","11.1"
"Bleckley","2020-10-09","4","1628","0","225","6.5","11.1"
"Bleckley","2020-10-10","2","1630","0","225","6.5","11.1"
"Bleckley","2020-10-11","3","1633","0","225","1.7","3.9"
"Bleckley","2020-10-12","7","1640","0","225","1.7","3.9"
"Bleckley","2020-10-13","6","1646","1","226","4.1","5.1"
"Bleckley","2020-10-14","107","1753","15","241","4.4","5.4"
"Bleckley","2020-10-15","5","1758","0","241","4.4","5.4"
"Bleckley","2020-10-16","7","1765","0","241","4.4","5.4"
"Bleckley","2020-10-17","3","1768","1","242","9.1","7.8"
"Bleckley","2020-10-18","2","1770","1","243","16.3","9"
"Bleckley","2020-10-19","12","1782","2","245","18.7","10.2"
"Bleckley","2020-10-20","6","1788","1","246","18.7","11.4"
"Bleckley","2020-10-21","44","1832","7","253","18.9","11.7"
"Bleckley","2020-10-22","7","1839","1","254","21","12.7"
"Bleckley","2020-10-23","9","1848","1","255","22.6","13.5"
"Bleckley","2020-10-24","7","1855","0","255","17.8","13.5"
"Bleckley","2020-10-25","3","1858","1","256","15.4","15.9"
"Bleckley","2020-10-26","10","1868","0","256","13","15.9"
"Bleckley","2020-10-27","6","1874","0","256","10.7","14.7"
"Bleckley","2020-10-28","50","1924","2","258","9","14"
"Bleckley","2020-10-29","13","1937","3","261","10.2","15.6"
"Bleckley","2020-10-30","2","1939","0","261","8.6","15.6"
"Bleckley","2020-10-31","7","1946","0","261","8.6","13.2"
"Bleckley","2020-11-01","5","1951","2","263","9.6","12.5"
"Bleckley","2020-11-02","14","1965","0","263","9.6","11.3"
"Bleckley","2020-11-03","12","1977","1","264","10.8","10.7"
"Bleckley","2020-11-04","31","2008","1","265","10.7","9.8"
"Bleckley","2020-11-05","7","2015","2","267","11.4","10.8"
"Bleckley","2020-11-06","11","2026","0","267","11.4","10"
"Bleckley","2020-11-07","9","2035","0","267","11.4","10"
"Bleckley","2020-11-08","6","2041","1","268","8.1","8.8"
"Bleckley","2020-11-09","12","2053","1","269","9.3","9.4"
"Bleckley","2020-11-10","12","2065","0","269","8.1","9.4"
"Bleckley","2020-11-11","7","2072","2","271","11.7","11.2"
"Bleckley","2020-11-12","27","2099","3","274","9.2","10.3"
"Bleckley","2020-11-13","12","2111","1","275","10.4","10.9"
"Bleckley","2020-11-14","2","2113","0","275","10.4","10.9"
"Bleckley","2020-11-15","5","2118","0","275","8","8.1"
"Bleckley","2020-11-16","39","2157","2","277","7.6","8.4"
"Bleckley","2020-11-17","9","2166","1","278","9.2","8.6"
"Bleckley","2020-11-18","40","2206","2","280","5.8","8.8"
"Bleckley","2020-11-19","8","2214","0","280","4.2","6.7"
"Bleckley","2020-11-20","10","2224","1","281","4.5","7.4"
"Bleckley","2020-11-21","7","2231","1","282","6.5","8.5"
"Bleckley","2020-11-22","3","2234","0","282","6.5","7.3"
"Bleckley","2020-11-23","11","2245","0","282","5.8","6.7"
"Bleckley","2020-11-24","5","2250","0","282","4.2","6.7"
"Bleckley","2020-11-25","33","2283","3","285","4.8","5.3"
"Bleckley","2020-11-26","0","2283","0","285","4.8","4.5"
"Bleckley","2020-11-27","7","2290","1","286","5.4","4.9"
"Bleckley","2020-11-28","3","2293","0","286","3.3","4.9"
"Bleckley","2020-11-29","0","2293","0","286","3.3","4.9"
"Bleckley","2020-11-30","12","2305","2","288","5.7","5.7"
"Bleckley","2020-12-01","9","2314","0","288","5.7","5"
"Bleckley","2020-12-02","54","2368","7","295","6.3","5.5"
"Bleckley","2020-12-03","9","2377","0","295","6.3","5.5"
"Bleckley","2020-12-04","7","2384","1","296","6.3","5.8"
"Bleckley","2020-12-05","8","2392","1","297","8.1","5.7"
"Bleckley","2020-12-06","4","2396","0","297","8.1","5.7"
"Bleckley","2020-12-07","5","2401","0","297","5.7","5.7"
"Bleckley","2020-12-08","6","2407","1","298","8.1","6.9"
"Bleckley","2020-12-09","41","2448","4","302","7.6","6.9"
"Bleckley","2020-12-10","7","2455","1","303","9.6","8"
"Bleckley","2020-12-11","11","2466","2","305","10.2","8.2"
"Bleckley","2020-12-12","6","2472","1","306","10.8","9.4"
"Bleckley","2020-12-13","4","2476","1","307","14.4","11.2"
"Bleckley","2020-12-14","18","2494","0","307","14.4","10"
"Bleckley","2020-12-15","16","2510","2","309","13.8","10.9"
"Bleckley","2020-12-16","18","2528","4","313","15.6","11.6"
"Bleckley","2020-12-17","14","2542","3","316","16.6","13.1"
"Bleckley","2020-12-18","16","2558","1","317","14.9","12.5"
"Bleckley","2020-12-19","12","2570","5","322","18.4","14.6"
"Bleckley","2020-12-20","13","2583","3","325","18.2","16.3"
"Bleckley","2020-12-21","19","2602","2","327","19.7","17"
"Bleckley","2020-12-22","17","2619","2","329","19.6","16.7"
"Bleckley","2020-12-23","44","2663","5","334","18","16.8"
"Bleckley","2020-12-24","1","2664","0","334","14.9","15.8"
"Bleckley","2020-12-25","1","2665","1","335","28.3","21.6"
"Bleckley","2020-12-26","6","2671","1","336","24.8","21.6"
"Bleckley","2020-12-27","3","2674","0","336","21.5","19.8"
"Bleckley","2020-12-28","20","2694","4","340","22.8","21.2"
"Bleckley","2020-12-29","18","2712","3","343","23.5","21.5"
"Bleckley","2020-12-30","112","2824","5","348","22.5","20.3"
"Bleckley","2020-12-31","20","2844","3","351","24.7","19.8"
"Bleckley","2021-01-01","4","2848","1","352","14","21.2"
"Bleckley","2021-01-02","6","2854","0","352","11.6","18.2"
"Bleckley","2021-01-03","5","2859","2","354","17.3","19.4"
"Bleckley","2021-01-04","16","2875","0","354","14.4","18.6"
"Bleckley","2021-01-05","22","2897","1","355","12.7","18.1"
"Bleckley","2021-01-06","80","2977","10","365","13.9","18.2"
"Bleckley","2021-01-07","31","3008","3","368","13.1","18.9"
"Bleckley","2021-01-08","14","3022","0","368","9.5","11.8"
"Bleckley","2021-01-09","9","3031","2","370","12.7","12.1"
"Bleckley","2021-01-10","8","3039","1","371","8.8","13"
"Bleckley","2021-01-11","25","3064","3","374","10.5","12.5"
"Bleckley","2021-01-12","26","3090","2","376","10.9","11.8"
"Bleckley","2021-01-13","86","3176","8","384","10.5","12.2"
"Bleckley","2021-01-14","15","3191","3","387","12","12.5"
"Bleckley","2021-01-15","20","3211","4","391","14.8","12.2"
"Bleckley","2021-01-16","7","3218","0","391","11.6","12.2"
"Bleckley","2021-01-17","6","3224","1","392","12.2","10.5"
"Bleckley","2021-01-18","19","3243","4","396","13.5","12"
"Bleckley","2021-01-19","49","3292","13","409","16.2","13.6"
"Bleckley","2021-01-20","16","3308","1","410","15.8","13.1"
"Bleckley","2021-01-21","12","3320","1","411","14.1","13"
"Bleckley","2021-01-22","14","3334","2","413","13.3","14.1"
"Bleckley","2021-01-23","7","3341","1","414","15.3","13.5"
"Bleckley","2021-01-24","5","3346","1","415","15.8","14"
"Bleckley","2021-01-25","16","3362","2","417","14.6","14.1"
"Bleckley","2021-01-26","12","3374","2","419","13.2","14.7"
"Bleckley","2021-01-27","11","3385","1","420","13.6","14.7"
"Bleckley","2021-01-28","22","3407","2","422","13.7","13.9"
"Bleckley","2021-01-29","8","3415","1","423","13.4","13.4"
"Bleckley","2021-01-30","2","3417","0","423","11.4","13.4"
"Bleckley","2021-01-31","13","3430","3","426","11.8","13.8"
"Bleckley","2021-02-01","11","3441","1","427","11.4","13"
"Bleckley","2021-02-02","34","3475","4","431","10.7","11.9"
"Bleckley","2021-02-03","14","3489","0","431","9.4","11.5"
"Bleckley","2021-02-04","9","3498","0","431","8.1","10.9"
"Bleckley","2021-02-05","9","3507","2","433","9.5","11.4"
"Bleckley","2021-02-06","1","3508","0","433","9.5","10.4"
"Bleckley","2021-02-07","0","3508","0","433","6.2","9"
"Bleckley","2021-02-08","0","3508","0","433","4.9","8.1"
"Brantley","2020-02-01","0","0","0","0",".","."
"Brantley","2020-02-02","0","0","0","0",".","."
"Brantley","2020-02-03","0","0","0","0",".","."
"Brantley","2020-02-04","0","0","0","0",".","."
"Brantley","2020-02-05","0","0","0","0",".","."
"Brantley","2020-02-06","0","0","0","0",".","."
"Brantley","2020-02-07","0","0","0","0","0","."
"Brantley","2020-02-08","0","0","0","0","0","."
"Brantley","2020-02-09","0","0","0","0","0","."
"Brantley","2020-02-10","0","0","0","0","0","."
"Brantley","2020-02-11","0","0","0","0","0","."
"Brantley","2020-02-12","0","0","0","0","0","."
"Brantley","2020-02-13","0","0","0","0","0","."
"Brantley","2020-02-14","0","0","0","0","0","0"
"Brantley","2020-02-15","0","0","0","0","0","0"
"Brantley","2020-02-16","0","0","0","0","0","0"
"Brantley","2020-02-17","0","0","0","0","0","0"
"Brantley","2020-02-18","0","0","0","0","0","0"
"Brantley","2020-02-19","0","0","0","0","0","0"
"Brantley","2020-02-20","0","0","0","0","0","0"
"Brantley","2020-02-21","0","0","0","0","0","0"
"Brantley","2020-02-22","0","0","0","0","0","0"
"Brantley","2020-02-23","0","0","0","0","0","0"
"Brantley","2020-02-24","0","0","0","0","0","0"
"Brantley","2020-02-25","0","0","0","0","0","0"
"Brantley","2020-02-26","0","0","0","0","0","0"
"Brantley","2020-02-27","0","0","0","0","0","0"
"Brantley","2020-02-28","0","0","0","0","0","0"
"Brantley","2020-02-29","0","0","0","0","0","0"
"Brantley","2020-03-01","0","0","0","0","0","0"
"Brantley","2020-03-02","0","0","0","0","0","0"
"Brantley","2020-03-03","0","0","0","0","0","0"
"Brantley","2020-03-04","0","0","0","0","0","0"
"Brantley","2020-03-05","0","0","0","0","0","0"
"Brantley","2020-03-06","0","0","0","0","0","0"
"Brantley","2020-03-07","0","0","0","0","0","0"
"Brantley","2020-03-08","0","0","0","0","0","0"
"Brantley","2020-03-09","0","0","0","0","0","0"
"Brantley","2020-03-10","0","0","0","0","0","0"
"Brantley","2020-03-11","0","0","0","0","0","0"
"Brantley","2020-03-12","2","2","0","0","0","0"
"Brantley","2020-03-13","0","2","0","0","0","0"
"Brantley","2020-03-14","0","2","0","0","0","0"
"Brantley","2020-03-15","1","3","0","0","0","0"
"Brantley","2020-03-16","1","4","0","0","0","0"
"Brantley","2020-03-17","1","5","0","0","0","0"
"Brantley","2020-03-18","9","14","0","0","0","0"
"Brantley","2020-03-19","6","20","0","0","0","0"
"Brantley","2020-03-20","6","26","0","0","0","0"
"Brantley","2020-03-21","0","26","0","0","0","0"
"Brantley","2020-03-22","4","30","0","0","0","0"
"Brantley","2020-03-23","4","34","0","0","0","0"
"Brantley","2020-03-24","11","45","0","0","0","0"
"Brantley","2020-03-25","3","48","0","0","0","0"
"Brantley","2020-03-26","4","52","0","0","0","0"
"Brantley","2020-03-27","7","59","0","0","0","0"
"Brantley","2020-03-28","0","59","0","0","0","0"
"Brantley","2020-03-29","2","61","0","0","0","0"
"Brantley","2020-03-30","5","66","0","0","0","0"
"Brantley","2020-03-31","6","72","0","0","0","0"
"Brantley","2020-04-01","2","74","1","1","7.1","3.6"
"Brantley","2020-04-02","1","75","0","1","7.1","3.6"
"Brantley","2020-04-03","5","80","1","2","10","5"
"Brantley","2020-04-04","2","82","0","2","10","5"
"Brantley","2020-04-05","0","82","0","2","10","5"
"Brantley","2020-04-06","3","85","0","2","10","5"
"Brantley","2020-04-07","7","92","1","3","12","6"
"Brantley","2020-04-08","4","96","2","5","12","9.6"
"Brantley","2020-04-09","10","106","7","12","22","14.6"
"Brantley","2020-04-10","7","113","0","12","19.2","14.6"
"Brantley","2020-04-11","1","114","0","12","19.2","14.6"
"Brantley","2020-04-12","0","114","0","12","19.2","14.6"
"Brantley","2020-04-13","4","118","1","13","22.8","16.4"
"Brantley","2020-04-14","2","120","0","13","20.7","16.4"
"Brantley","2020-04-15","9","129","1","14","15.2","13.6"
"Brantley","2020-04-16","8","137","1","15","6.9","14.5"
"Brantley","2020-04-17","13","150","1","16","8","13.6"
"Brantley","2020-04-18","5","155","0","16","8","13.6"
"Brantley","2020-04-19","3","158","0","16","8","13.6"
"Brantley","2020-04-20","11","169","0","16","4.5","13.6"
"Brantley","2020-04-21","8","177","0","16","4.5","12.6"
"Brantley","2020-04-22","2","179","1","17","10","12.6"
"Brantley","2020-04-23","14","193","0","17","8.2","7.6"
"Brantley","2020-04-24","4","197","0","17","7.1","7.6"
"Brantley","2020-04-25","1","198","0","17","7.1","7.6"
"Brantley","2020-04-26","1","199","0","17","7.1","7.6"
"Brantley","2020-04-27","7","206","0","17","7.1","5.8"
"Brantley","2020-04-28","2","208","0","17","7.1","5.8"
"Brantley","2020-04-29","3","211","0","17","0","5"
"Brantley","2020-04-30","5","216","0","17","0","4.1"
"Brantley","2020-05-01","4","220","0","17","0","3.6"
"Brantley","2020-05-02","5","225","0","17","0","3.6"
"Brantley","2020-05-03","1","226","0","17","0","3.6"
"Brantley","2020-05-04","8","234","0","17","0","3.6"
"Brantley","2020-05-05","3","237","0","17","0","3.6"
"Brantley","2020-05-06","1","238","0","17","0","0"
"Brantley","2020-05-07","8","246","0","17","0","0"
"Brantley","2020-05-08","5","251","0","17","0","0"
"Brantley","2020-05-09","5","256","1","18","2.9","1.4"
"Brantley","2020-05-10","0","256","0","18","2.9","1.4"
"Brantley","2020-05-11","14","270","0","18","2.9","1.4"
"Brantley","2020-05-12","43","313","13","31","7.2","3.6"
"Brantley","2020-05-13","4","317","1","32","10.7","5.4"
"Brantley","2020-05-14","14","331","0","32","10.7","5.4"
"Brantley","2020-05-15","8","339","0","32","10.7","5.4"
"Brantley","2020-05-16","2","341","0","32","7.9","5.4"
"Brantley","2020-05-17","0","341","0","32","7.9","5.4"
"Brantley","2020-05-18","16","357","0","32","7.9","5.4"
"Brantley","2020-05-19","7","364","0","32","3.6","5.4"
"Brantley","2020-05-20","9","373","1","33","1.6","6.2"
"Brantley","2020-05-21","4","377","0","33","1.6","6.2"
"Brantley","2020-05-22","15","392","0","33","1.6","6.2"
"Brantley","2020-05-23","8","400","0","33","1.6","4.7"
"Brantley","2020-05-24","2","402","0","33","1.6","4.7"
"Brantley","2020-05-25","9","411","0","33","1.6","4.7"
"Brantley","2020-05-26","7","418","0","33","1.6","2.6"
"Brantley","2020-05-27","5","423","0","33","0","0.8"
"Brantley","2020-05-28","21","444","2","35","1.4","1.5"
"Brantley","2020-05-29","6","450","3","38","8.5","5"
"Brantley","2020-05-30","2","452","0","38","8.5","5"
"Brantley","2020-05-31","1","453","0","38","8.5","5"
"Brantley","2020-06-01","16","469","0","38","8.5","5"
"Brantley","2020-06-02","3","472","0","38","8.5","5"
"Brantley","2020-06-03","6","478","0","38","8.5","4.3"
"Brantley","2020-06-04","5","483","0","38","7.1","4.3"
"Brantley","2020-06-05","11","494","0","38","0","4.3"
"Brantley","2020-06-06","5","499","0","38","0","4.3"
"Brantley","2020-06-07","3","502","0","38","0","4.3"
"Brantley","2020-06-08","22","524","2","40","1.3","4.9"
"Brantley","2020-06-09","12","536","1","41","2.5","5.5"
"Brantley","2020-06-10","12","548","3","44","6.1","7.3"
"Brantley","2020-06-11","24","572","1","45","6.7","6.9"
"Brantley","2020-06-12","12","584","1","46","7.8","3.9"
"Brantley","2020-06-13","7","591","0","46","7.8","3.9"
"Brantley","2020-06-14","0","591","0","46","7.8","3.9"
"Brantley","2020-06-15","18","609","0","46","6.5","3.9"
"Brantley","2020-06-16","13","622","2","48","7.6","5"
"Brantley","2020-06-17","9","631","1","49","5.6","5.8"
"Brantley","2020-06-18","23","654","3","52","6.8","6.7"
"Brantley","2020-06-19","11","665","2","54","8.2","8"
"Brantley","2020-06-20","5","670","2","56","14","10.9"
"Brantley","2020-06-21","3","673","0","56","14","10.9"
"Brantley","2020-06-22","20","693","0","56","14","10.3"
"Brantley","2020-06-23","27","720","0","56","11.8","9.7"
"Brantley","2020-06-24","15","735","0","56","10.2","7.9"
"Brantley","2020-06-25","32","767","1","57","8.8","7.8"
"Brantley","2020-06-26","32","799","7","64","9.3","8.8"
"Brantley","2020-06-27","3","802","1","65","8.3","11.1"
"Brantley","2020-06-28","5","807","0","65","8.3","11.1"
"Brantley","2020-06-29","17","824","2","67","10","12"
"Brantley","2020-06-30","27","851","2","69","11.1","11.4"
"Brantley","2020-07-01","23","874","1","70","11.7","10.9"
"Brantley","2020-07-02","34","908","6","76","13.8","11.3"
"Brantley","2020-07-03","10","918","1","77","12.1","10.7"
"Brantley","2020-07-04","6","924","3","80","14.5","11.4"
"Brantley","2020-07-05","1","925","0","80","14.5","11.4"
"Brantley","2020-07-06","19","944","2","82","14.3","12.1"
"Brantley","2020-07-07","34","978","2","84","14.1","12.6"
"Brantley","2020-07-08","22","1000","2","86","14.7","13.2"
"Brantley","2020-07-09","37","1037","7","93","14.9","14.3"
"Brantley","2020-07-10","27","1064","2","95","14.5","13.3"
"Brantley","2020-07-11","7","1071","6","101","19.6","17.1"
"Brantley","2020-07-12","11","1082","5","106","26.1","20.3"
"Brantley","2020-07-13","27","1109","6","112","27.8","21"
"Brantley","2020-07-14","29","1138","6","118","29.9","22"
"Brantley","2020-07-15","31","1169","4","122","30.5","22.6"
"Brantley","2020-07-16","36","1205","2","124","28.6","21.7"
"Brantley","2020-07-17","26","1231","1","125","28.1","21.3"
"Brantley","2020-07-18","14","1245","3","128","18.9","19.3"
"Brantley","2020-07-19","4","1249","1","129","15.9","21"
"Brantley","2020-07-20","23","1272","3","132","14.6","21.2"
"Brantley","2020-07-21","19","1291","4","136","14.7","22.3"
"Brantley","2020-07-22","20","1311","4","140","15.7","23.1"
"Brantley","2020-07-23","24","1335","2","142","16.1","22.3"
"Brantley","2020-07-24","21","1356","9","151","21.7","24.9"
"Brantley","2020-07-25","5","1361","1","152","21.5","20.2"
"Brantley","2020-07-26","4","1365","1","153","21.5","18.7"
"Brantley","2020-07-27","34","1399","3","156","20.9","17.8"
"Brantley","2020-07-28","34","1433","8","164","21.2","18"
"Brantley","2020-07-29","23","1456","2","166","19.6","17.7"
"Brantley","2020-07-30","19","1475","2","168","19.9","18"
"Brantley","2020-07-31","10","1485","4","172","19.5","20.6"
"Brantley","2020-08-01","16","1501","1","173","17.5","19.5"
"Brantley","2020-08-02","5","1506","1","174","16.8","19.2"
"Brantley","2020-08-03","31","1537","3","177","17","18.9"
"Brantley","2020-08-04","24","1561","2","179","14.8","18"
"Brantley","2020-08-05","34","1595","3","182","14.8","17.2"
"Brantley","2020-08-06","26","1621","5","187","16","18"
"Brantley","2020-08-07","21","1642","2","189","11.7","15.6"
"Brantley","2020-08-08","15","1657","2","191","12.7","15.1"
"Brantley","2020-08-09","14","1671","3","194","12.9","14.9"
"Brantley","2020-08-10","33","1704","4","198","13.3","15.1"
"Brantley","2020-08-11","41","1745","6","204","14.2","14.5"
"Brantley","2020-08-12","28","1773","1","205","13.4","14.1"
"Brantley","2020-08-13","29","1802","3","208","12.1","14.1"
"Brantley","2020-08-14","20","1822","0","208","10.8","11.2"
"Brantley","2020-08-15","14","1836","2","210","10.9","11.8"
"Brantley","2020-08-16","13","1849","4","214","12.2","12.6"
"Brantley","2020-08-17","33","1882","2","216","11.4","12.3"
"Brantley","2020-08-18","32","1914","0","216","9.3","11.7"
"Brantley","2020-08-19","36","1950","1","217","9.2","11.3"
"Brantley","2020-08-20","22","1972","5","222","10.9","11.5"
"Brantley","2020-08-21","28","2000","0","222","10.9","10.9"
"Brantley","2020-08-22","13","2013","1","223","10","10.5"
"Brantley","2020-08-23","8","2021","0","223","5.6","8.9"
"Brantley","2020-08-24","40","2061","2","225","5.5","8.4"
"Brantley","2020-08-25","35","2096","2","227","6.3","7.8"
"Brantley","2020-08-26","37","2133","4","231","7.4","8.3"
"Brantley","2020-08-27","22","2155","3","234","6.1","8.5"
"Brantley","2020-08-28","32","2187","5","239","8.4","9.6"
"Brantley","2020-08-29","20","2207","5","244","10.8","10.4"
"Brantley","2020-08-30","12","2219","1","245","12","8.8"
"Brantley","2020-08-31","24","2243","0","245","11.3","8.4"
"Brantley","2020-09-01","32","2275","1","246","10.9","8.6"
"Brantley","2020-09-02","21","2296","0","246","9.4","8.4"
"Brantley","2020-09-03","34","2330","3","249","8.7","7.4"
"Brantley","2020-09-04","11","2341","1","250","7.8","8.1"
"Brantley","2020-09-05","10","2351","0","250","4.2","7.5"
"Brantley","2020-09-06","4","2355","2","252","10.1","11.1"
"Brantley","2020-09-07","17","2372","0","252","10.1","10.7"
"Brantley","2020-09-08","39","2411","0","252","9.7","10.3"
"Brantley","2020-09-09","27","2438","2","254","10.8","10.1"
"Brantley","2020-09-10","26","2464","0","254","9.5","9.1"
"Brantley","2020-09-11","14","2478","2","256","10.2","9"
"Brantley","2020-09-12","13","2491","2","258","12.4","8.3"
"Brantley","2020-09-13","10","2501","1","259","6.7","8.4"
"Brantley","2020-09-14","30","2531","1","260","7.2","8.7"
"Brantley","2020-09-15","37","2568","1","261","7.6","8.6"
"Brantley","2020-09-16","27","2595","0","261","6.5","8.6"
"Brantley","2020-09-17","18","2613","0","261","6.5","8"
"Brantley","2020-09-18","25","2638","3","264","6.2","8.2"
"Brantley","2020-09-19","10","2648","0","264","4","8.2"
"Brantley","2020-09-20","7","2655","0","264","2.6","4.7"
"Brantley","2020-09-21","26","2681","1","265","2.6","4.9"
"Brantley","2020-09-22","34","2715","4","269","3.9","5.8"
"Brantley","2020-09-23","23","2738","1","270","4.6","5.5"
"Brantley","2020-09-24","20","2758","2","272","6","6.3"
"Brantley","2020-09-25","13","2771","0","272","4.3","5.2"
"Brantley","2020-09-26","12","2783","0","272","4.3","4.1"
"Brantley","2020-09-27","9","2792","2","274","7.5","5"
"Brantley","2020-09-28","23","2815","0","274","6.9","4.8"
"Brantley","2020-09-29","21","2836","4","278","7.9","5.9"
"Brantley","2020-09-30","26","2862","1","279","7.9","6.2"
"Brantley","2020-10-01","13","2875","0","279","6.4","6.2"
"Brantley","2020-10-02","19","2894","2","281","7.9","6.1"
"Brantley","2020-10-03","6","2900","1","282","10.3","7.3"
"Brantley","2020-10-04","9","2909","0","282","7.2","7.3"
"Brantley","2020-10-05","36","2945","4","286","8.7","7.8"
"Brantley","2020-10-06","38","2983","5","291","7.9","7.9"
"Brantley","2020-10-07","38","3021","3","294","8.5","8.2"
"Brantley","2020-10-08","37","3058","4","298","10","8.2"
"Brantley","2020-10-09","16","3074","3","301","11.2","9.6"
"Brantley","2020-10-10","14","3088","3","304","11.9","11.1"
"Brantley","2020-10-11","6","3094","0","304","11.9","9.5"
"Brantley","2020-10-12","38","3132","5","309","12.2","10.5"
"Brantley","2020-10-13","30","3162","4","313","12.2","10"
"Brantley","2020-10-14","51","3213","7","320","13","10.8"
"Brantley","2020-10-15","31","3244","3","323","12.9","11.4"
"Brantley","2020-10-16","21","3265","4","327","12.9","12.1"
"Brantley","2020-10-17","11","3276","3","330","13.7","12.8"
"Brantley","2020-10-18","8","3284","1","331","15.5","13.7"
"Brantley","2020-10-19","42","3326","4","335","15","13.6"
"Brantley","2020-10-20","25","3351","2","337","14.2","13.2"
"Brantley","2020-10-21","41","3392","0","337","12.3","12.7"
"Brantley","2020-10-22","24","3416","2","339","12.1","12.5"
"Brantley","2020-10-23","25","3441","2","341","10.5","11.7"
"Brantley","2020-10-24","12","3453","1","342","7.8","10.8"
"Brantley","2020-10-25","9","3462","1","343","7.6","11.6"
"Brantley","2020-10-26","35","3497","3","346","7.5","11.2"
"Brantley","2020-10-27","27","3524","0","346","6.3","10.3"
"Brantley","2020-10-28","43","3567","6","352","8.3","10.3"
"Brantley","2020-10-29","26","3593","0","352","7.1","9.6"
"Brantley","2020-10-30","22","3615","3","355","7.9","9.2"
"Brantley","2020-10-31","11","3626","1","356","8.1","7.9"
"Brantley","2020-11-01","10","3636","1","357","7.9","7.8"
"Brantley","2020-11-02","38","3674","1","358","7","7.3"
"Brantley","2020-11-03","28","3702","3","361","8.6","7.5"
"Brantley","2020-11-04","31","3733","0","361","6.6","7.5"
"Brantley","2020-11-05","23","3756","2","363","7.8","7.5"
"Brantley","2020-11-06","17","3773","1","364","6.7","7.3"
"Brantley","2020-11-07","10","3783","1","365","6.8","7.4"
"Brantley","2020-11-08","7","3790","1","366","7.5","7.7"
"Brantley","2020-11-09","25","3815","1","367","7.7","7.3"
"Brantley","2020-11-10","22","3837","3","370","8.1","8.3"
"Brantley","2020-11-11","21","3858","3","373","10.1","8.3"
"Brantley","2020-11-12","32","3890","0","373","8.9","8.3"
"Brantley","2020-11-13","23","3913","1","374","8.7","7.7"
"Brantley","2020-11-14","11","3924","1","375","8.5","7.7"
"Brantley","2020-11-15","6","3930","1","376","8.9","8.2"
"Brantley","2020-11-16","28","3958","3","379","9.8","8.7"
"Brantley","2020-11-17","35","3993","5","384","9.9","9"
"Brantley","2020-11-18","44","4037","2","386","8.5","9.3"
"Brantley","2020-11-19","24","4061","6","392","12.1","10.5"
"Brantley","2020-11-20","23","4084","1","393","12.1","10.4"
"Brantley","2020-11-21","8","4092","1","394","12.6","10.6"
"Brantley","2020-11-22","14","4106","0","394","10.2","9.5"
"Brantley","2020-11-23","36","4142","3","397","9.9","9.8"
"Brantley","2020-11-24","25","4167","5","402","10.7","10.3"
"Brantley","2020-11-25","35","4202","4","406","11.7","10.1"
"Brantley","2020-11-26","10","4212","3","409","12.4","12.2"
"Brantley","2020-11-27","21","4233","2","411","13.1","12.6"
"Brantley","2020-11-28","20","4253","4","415","14.2","13.4"
"Brantley","2020-11-29","10","4263","1","416","15.6","12.9"
"Brantley","2020-11-30","31","4294","1","417","14.9","12.4"
"Brantley","2020-12-01","26","4320","4","421","14.2","12.4"
"Brantley","2020-12-02","22","4342","2","423","13.9","12.8"
"Brantley","2020-12-03","17","4359","1","424","10.4","11.4"
"Brantley","2020-12-04","29","4388","3","427","10.6","11.8"
"Brantley","2020-12-05","12","4400","2","429","10.1","12.1"
"Brantley","2020-12-06","11","4411","2","431","11.3","13.4"
"Brantley","2020-12-07","38","4449","6","437","13","14"
"Brantley","2020-12-08","27","4476","4","441","13","13.6"
"Brantley","2020-12-09","41","4517","4","445","13.1","13.5"
"Brantley","2020-12-10","14","4531","1","446","13.2","11.8"
"Brantley","2020-12-11","113","4644","3","449","12.1","11.4"
"Brantley","2020-12-12","16","4660","4","453","13.3","11.7"
"Brantley","2020-12-13","9","4669","2","455","13.9","12.6"
"Brantley","2020-12-14","37","4706","5","460","13.6","13.3"
"Brantley","2020-12-15","36","4742","1","461","11.9","12.4"
"Brantley","2020-12-16","47","4789","3","464","11.4","12.2"
"Brantley","2020-12-17","20","4809","3","467","12.5","12.9"
"Brantley","2020-12-18","23","4832","3","470","14","13.1"
"Brantley","2020-12-19","11","4843","2","472","13","13.2"
"Brantley","2020-12-20","92","4935","8","480","11.1","12.5"
"Brantley","2020-12-21","25","4960","3","483","10.9","12.2"
"Brantley","2020-12-22","45","5005","8","491","13","12.4"
"Brantley","2020-12-23","33","5038","7","498","15.1","13.3"
"Brantley","2020-12-24","29","5067","4","502","15","13.7"
"Brantley","2020-12-25","11","5078","2","504","15.7","14.8"
"Brantley","2020-12-26","17","5095","2","506","14.8","13.9"
"Brantley","2020-12-27","14","5109","3","509","16.6","13.8"
"Brantley","2020-12-28","33","5142","7","516","17.9","14.4"
"Brantley","2020-12-29","45","5187","5","521","17","15"
"Brantley","2020-12-30","47","5234","6","527","15.8","15.4"
"Brantley","2020-12-31","19","5253","4","531","16.8","15.9"
"Brantley","2021-01-01","9","5262","2","533","17.4","16.5"
"Brantley","2021-01-02","17","5279","4","537","19","16.9"
"Brantley","2021-01-03","12","5291","5","542","21.9","19.3"
"Brantley","2021-01-04","27","5318","4","546","21","19.5"
"Brantley","2021-01-05","52","5370","7","553","21.4","19.2"
"Brantley","2021-01-06","56","5426","3","556","20.3","18"
"Brantley","2021-01-07","44","5470","5","561","18.9","17.9"
"Brantley","2021-01-08","29","5499","4","565","17.7","17.5"
"Brantley","2021-01-09","16","5515","3","568","17","18"
"Brantley","2021-01-10","8","5523","1","569","12.9","17.4"
"Brantley","2021-01-11","44","5567","7","576","13","17"
"Brantley","2021-01-12","37","5604","7","583","13.8","17.6"
"Brantley","2021-01-13","37","5641","2","585","13.8","17.1"
"Brantley","2021-01-14","38","5679","4","589","13.7","16.3"
"Brantley","2021-01-15","41","5720","7","596","14.2","15.9"
"Brantley","2021-01-16","12","5732","1","597","12.7","14.8"
"Brantley","2021-01-17","13","5745","5","602","16.4","14.6"
"Brantley","2021-01-18","43","5788","8","610","16.8","14.9"
"Brantley","2021-01-19","48","5836","10","620","17","15.4"
"Brantley","2021-01-20","40","5876","9","629","19.5","16.6"
"Brantley","2021-01-21","42","5918","5","634","19.7","16.7"
"Brantley","2021-01-22","35","5953","2","636","18.1","16.1"
"Brantley","2021-01-23","19","5972","4","640","19.9","16.3"
"Brantley","2021-01-24","3","5975","1","641","19.1","17.8"
"Brantley","2021-01-25","50","6025","8","649","18.8","17.8"
"Brantley","2021-01-26","38","6063","5","654","17.7","17.4"
"Brantley","2021-01-27","25","6088","2","656","15.6","17.5"
"Brantley","2021-01-28","44","6132","1","657","14.2","16.9"
"Brantley","2021-01-29","37","6169","6","663","15.7","16.9"
"Brantley","2021-01-30","19","6188","1","664","13.5","16.7"
"Brantley","2021-01-31","13","6201","2","666","10.9","15"
"Brantley","2021-02-01","47","6248","5","671","10.1","14.4"
"Brantley","2021-02-02","31","6279","1","672","8.7","13.2"
"Brantley","2021-02-03","36","6315","8","680","10.7","13.2"
"Brantley","2021-02-04","50","6365","3","683","11.3","12.7"
"Brantley","2021-02-05","36","6401","3","686","10.2","12.9"
"Brantley","2021-02-06","6","6407","0","686","9.4","11.4"
"Brantley","2021-02-07","3","6410","0","686","7.2","9.1"
"Brantley","2021-02-08","0","6410","0","686","5.7","7.9"
"Brooks","2020-02-01","0","0","0","0",".","."
"Brooks","2020-02-02","0","0","0","0",".","."
"Brooks","2020-02-03","0","0","0","0",".","."
"Brooks","2020-02-04","0","0","0","0",".","."
"Brooks","2020-02-05","0","0","0","0",".","."
"Brooks","2020-02-06","0","0","0","0",".","."
"Brooks","2020-02-07","0","0","0","0","0","."
"Brooks","2020-02-08","0","0","0","0","0","."
"Brooks","2020-02-09","0","0","0","0","0","."
"Brooks","2020-02-10","0","0","0","0","0","."
"Brooks","2020-02-11","0","0","0","0","0","."
"Brooks","2020-02-12","0","0","0","0","0","."
"Brooks","2020-02-13","0","0","0","0","0","."
"Brooks","2020-02-14","0","0","0","0","0","0"
"Brooks","2020-02-15","0","0","0","0","0","0"
"Brooks","2020-02-16","0","0","0","0","0","0"
"Brooks","2020-02-17","0","0","0","0","0","0"
"Brooks","2020-02-18","0","0","0","0","0","0"
"Brooks","2020-02-19","0","0","0","0","0","0"
"Brooks","2020-02-20","0","0","0","0","0","0"
"Brooks","2020-02-21","0","0","0","0","0","0"
"Brooks","2020-02-22","0","0","0","0","0","0"
"Brooks","2020-02-23","0","0","0","0","0","0"
"Brooks","2020-02-24","0","0","0","0","0","0"
"Brooks","2020-02-25","0","0","0","0","0","0"
"Brooks","2020-02-26","0","0","0","0","0","0"
"Brooks","2020-02-27","0","0","0","0","0","0"
"Brooks","2020-02-28","0","0","0","0","0","0"
"Brooks","2020-02-29","0","0","0","0","0","0"
"Brooks","2020-03-01","0","0","0","0","0","0"
"Brooks","2020-03-02","0","0","0","0","0","0"
"Brooks","2020-03-03","0","0","0","0","0","0"
"Brooks","2020-03-04","0","0","0","0","0","0"
"Brooks","2020-03-05","0","0","0","0","0","0"
"Brooks","2020-03-06","0","0","0","0","0","0"
"Brooks","2020-03-07","0","0","0","0","0","0"
"Brooks","2020-03-08","0","0","0","0","0","0"
"Brooks","2020-03-09","0","0","0","0","0","0"
"Brooks","2020-03-10","0","0","0","0","0","0"
"Brooks","2020-03-11","0","0","0","0","0","0"
"Brooks","2020-03-12","0","0","0","0","0","0"
"Brooks","2020-03-13","0","0","0","0","0","0"
"Brooks","2020-03-14","0","0","0","0","0","0"
"Brooks","2020-03-15","0","0","0","0","0","0"
"Brooks","2020-03-16","1","1","0","0","0","0"
"Brooks","2020-03-17","0","1","0","0","0","0"
"Brooks","2020-03-18","0","1","0","0","0","0"
"Brooks","2020-03-19","1","2","0","0","0","0"
"Brooks","2020-03-20","0","2","0","0","0","0"
"Brooks","2020-03-21","0","2","0","0","0","0"
"Brooks","2020-03-22","1","3","0","0","0","0"
"Brooks","2020-03-23","1","4","0","0","0","0"
"Brooks","2020-03-24","2","6","1","1","7.1","3.6"
"Brooks","2020-03-25","2","8","0","1","7.1","3.6"
"Brooks","2020-03-26","5","13","1","2","10","5"
"Brooks","2020-03-27","2","15","0","2","10","5"
"Brooks","2020-03-28","1","16","1","3","24.3","12.1"
"Brooks","2020-03-29","0","16","0","3","24.3","12.1"
"Brooks","2020-03-30","16","32","11","14","34.1","17.1"
"Brooks","2020-03-31","1","33","1","15","41.3","24.2"
"Brooks","2020-04-01","2","35","2","17","55.5","31.3"
"Brooks","2020-04-02","5","40","3","20","61.3","35.6"
"Brooks","2020-04-03","0","40","0","20","61.3","35.6"
"Brooks","2020-04-04","1","41","0","20","47","35.6"
"Brooks","2020-04-05","1","42","1","21","61.3","42.8"
"Brooks","2020-04-06","5","47","1","22","54.3","44.2"
"Brooks","2020-04-07","2","49","1","23","47.1","44.2"
"Brooks","2020-04-08","3","52","0","23","32.9","44.2"
"Brooks","2020-04-09","2","54","0","23","24.3","42.8"
"Brooks","2020-04-10","0","54","0","23","24.3","42.8"
"Brooks","2020-04-11","2","56","2","25","38.6","42.8"
"Brooks","2020-04-12","2","58","1","26","31.4","46.3"
"Brooks","2020-04-13","0","58","0","26","28.6","41.4"
"Brooks","2020-04-14","6","64","1","27","23.8","35.5"
"Brooks","2020-04-15","9","73","5","32","31.7","32.3"
"Brooks","2020-04-16","3","76","1","33","36.5","30.4"
"Brooks","2020-04-17","5","81","1","34","39.4","31.8"
"Brooks","2020-04-18","0","81","0","34","25.1","31.8"
"Brooks","2020-04-19","39","120","1","35","18.3","24.9"
"Brooks","2020-04-20","2","122","1","36","25.4","27"
"Brooks","2020-04-21","2","124","0","36","23.1","23.4"
"Brooks","2020-04-22","29","153","15","51","22.5","27.1"
"Brooks","2020-04-23","5","158","0","51","17.8","27.1"
"Brooks","2020-04-24","5","163","2","53","20.6","30"
"Brooks","2020-04-25","1","164","1","54","34.9","30"
"Brooks","2020-04-26","4","168","2","56","41.7","30"
"Brooks","2020-04-27","6","174","1","57","36.9","31.2"
"Brooks","2020-04-28","3","177","0","57","36.9","30"
"Brooks","2020-04-29","8","185","3","60","34.9","28.7"
"Brooks","2020-04-30","13","198","0","60","34.9","26.3"
"Brooks","2020-05-01","11","209","2","62","31.8","26.2"
"Brooks","2020-05-02","0","209","0","62","17.5","26.2"
"Brooks","2020-05-03","2","211","1","63","17.5","29.6"
"Brooks","2020-05-04","14","225","0","63","15.1","26"
"Brooks","2020-05-05","23","248","0","63","15.1","26"
"Brooks","2020-05-06","9","257","0","63","9.7","22.3"
"Brooks","2020-05-07","4","261","0","63","9.7","22.3"
"Brooks","2020-05-08","5","266","0","63","7.1","19.5"
"Brooks","2020-05-09","2","268","0","63","7.1","12.3"
"Brooks","2020-05-10","0","268","0","63","0","8.7"
"Brooks","2020-05-11","18","286","0","63","0","7.5"
"Brooks","2020-05-12","21","307","0","63","0","7.5"
"Brooks","2020-05-13","5","312","0","63","0","4.9"
"Brooks","2020-05-14","5","317","0","63","0","4.9"
"Brooks","2020-05-15","7","324","0","63","0","3.6"
"Brooks","2020-05-16","2","326","0","63","0","3.6"
"Brooks","2020-05-17","1","327","1","64","14.3","7.1"
"Brooks","2020-05-18","27","354","1","65","14.8","7.4"
"Brooks","2020-05-19","23","377","0","65","14.8","7.4"
"Brooks","2020-05-20","13","390","4","69","19.2","9.6"
"Brooks","2020-05-21","14","404","0","69","19.2","9.6"
"Brooks","2020-05-22","12","416","0","69","19.2","9.6"
"Brooks","2020-05-23","0","416","0","69","19.2","9.6"
"Brooks","2020-05-24","1","417","0","69","4.9","9.6"
"Brooks","2020-05-25","0","417","0","69","4.4","9.6"
"Brooks","2020-05-26","31","448","0","69","4.4","9.6"
"Brooks","2020-05-27","12","460","1","70","1.2","10.2"
"Brooks","2020-05-28","6","466","0","70","1.2","10.2"
"Brooks","2020-05-29","7","473","1","71","3.2","11.2"
"Brooks","2020-05-30","0","473","0","71","3.2","11.2"
"Brooks","2020-05-31","3","476","2","73","12.8","8.8"
"Brooks","2020-06-01","47","523","4","77","14","9.2"
"Brooks","2020-06-02","25","548","3","80","15.7","10"
"Brooks","2020-06-03","20","568","2","82","15.9","8.6"
"Brooks","2020-06-04","12","580","0","82","15.9","8.6"
"Brooks","2020-06-05","17","597","3","85","16.4","9.8"
"Brooks","2020-06-06","4","601","1","86","20","11.6"
"Brooks","2020-06-07","2","603","0","86","10.5","11.6"
"Brooks","2020-06-08","67","670","2","88","9.7","11.8"
"Brooks","2020-06-09","27","697","0","88","7.9","11.8"
"Brooks","2020-06-10","16","713","3","91","9.2","12.6"
"Brooks","2020-06-11","10","723","0","91","9.2","12.6"
"Brooks","2020-06-12","21","744","0","91","6.7","11.5"
"Brooks","2020-06-13","4","748","0","91","3.1","11.5"
"Brooks","2020-06-14","3","751","0","91","3.1","6.8"
"Brooks","2020-06-15","49","800","9","100","5.3","7.5"
"Brooks","2020-06-16","71","871","5","105","6.3","7.1"
"Brooks","2020-06-17","28","899","4","109","5.7","7.4"
"Brooks","2020-06-18","25","924","3","112","7.4","8.3"
"Brooks","2020-06-19","40","964","13","125","12","9.4"
"Brooks","2020-06-20","11","975","0","125","12","7.6"
"Brooks","2020-06-21","5","980","0","125","12","7.6"
"Brooks","2020-06-22","87","1067","5","130","10.2","7.8"
"Brooks","2020-06-23","32","1099","5","135","11.5","8.9"
"Brooks","2020-06-24","20","1119","3","138","11.6","8.6"
"Brooks","2020-06-25","25","1144","5","143","12.7","10"
"Brooks","2020-06-26","42","1186","16","159","13.5","12.8"
"Brooks","2020-06-27","3","1189","0","159","13.5","12.8"
"Brooks","2020-06-28","7","1196","1","160","15.5","13.8"
"Brooks","2020-06-29","122","1318","18","178","16.8","13.5"
"Brooks","2020-06-30","112","1430","14","192","16.4","13.9"
"Brooks","2020-07-01","50","1480","9","201","16.8","14.2"
"Brooks","2020-07-02","103","1583","9","210","15.2","13.9"
"Brooks","2020-07-03","15","1598","3","213","12.6","13.1"
"Brooks","2020-07-04","0","1598","0","213","12.6","13.1"
"Brooks","2020-07-05","5","1603","0","213","10.6","13.1"
"Brooks","2020-07-06","71","1674","16","229","11.7","14.3"
"Brooks","2020-07-07","78","1752","15","244","12.6","14.5"
"Brooks","2020-07-08","48","1800","2","246","10.7","13.7"
"Brooks","2020-07-09","24","1824","10","256","15.4","15.3"
"Brooks","2020-07-10","11","1835","2","258","15.1","13.9"
"Brooks","2020-07-11","26","1861","11","269","21.2","16.9"
"Brooks","2020-07-12","9","1870","5","274","29.1","19.8"
"Brooks","2020-07-13","74","1944","10","284","27.8","19.7"
"Brooks","2020-07-14","90","2034","10","294","26.6","19.6"
"Brooks","2020-07-15","25","2059","5","299","28.9","19.8"
"Brooks","2020-07-16","37","2096","12","311","27.6","21.5"
"Brooks","2020-07-17","26","2122","11","322","31","23.1"
"Brooks","2020-07-18","6","2128","2","324","29.8","25.5"
"Brooks","2020-07-19","8","2136","6","330","32.5","30.8"
"Brooks","2020-07-20","108","2244","11","341","32.1","29.9"
"Brooks","2020-07-21","108","2352","18","359","32.8","29.7"
"Brooks","2020-07-22","25","2377","9","368","35.1","32"
"Brooks","2020-07-23","36","2413","6","374","32.9","30.2"
"Brooks","2020-07-24","30","2443","6","380","29.7","30.4"
"Brooks","2020-07-25","13","2456","7","387","32.6","31.2"
"Brooks","2020-07-26","8","2464","1","388","23.7","28.1"
"Brooks","2020-07-27","96","2560","8","396","23.4","27.7"
"Brooks","2020-07-28","71","2631","6","402","22.3","27.6"
"Brooks","2020-07-29","24","2655","9","411","22.5","28.8"
"Brooks","2020-07-30","34","2689","5","416","22.2","27.5"
"Brooks","2020-07-31","28","2717","8","424","23.4","26.6"
"Brooks","2020-08-01","11","2728","1","425","17","24.8"
"Brooks","2020-08-02","10","2738","5","430","22.4","23"
"Brooks","2020-08-03","63","2801","6","436","22.5","23"
"Brooks","2020-08-04","77","2878","14","450","23.9","23.1"
"Brooks","2020-08-05","22","2900","1","451","19.2","20.9"
"Brooks","2020-08-06","45","2945","10","461","20.3","21.2"
"Brooks","2020-08-07","15","2960","1","462","17.2","20.3"
"Brooks","2020-08-08","7","2967","2","464","20","18.5"
"Brooks","2020-08-09","11","2978","1","465","14.1","18.2"
"Brooks","2020-08-10","50","3028","3","468","13.6","18.1"
"Brooks","2020-08-11","40","3068","10","478","14.6","19.3"
"Brooks","2020-08-12","12","3080","0","478","13.9","16.6"
"Brooks","2020-08-13","22","3102","6","484","14.7","17.5"
"Brooks","2020-08-14","22","3124","6","490","17.6","17.4"
"Brooks","2020-08-15","6","3130","0","490","13.5","16.7"
"Brooks","2020-08-16","14","3144","6","496","18.3","16.2"
"Brooks","2020-08-17","35","3179","9","505","21.2","17.4"
"Brooks","2020-08-18","35","3214","3","508","18.8","16.7"
"Brooks","2020-08-19","14","3228","2","510","20.9","17.4"
"Brooks","2020-08-20","24","3252","0","510","17","15.8"
"Brooks","2020-08-21","16","3268","3","513","15.7","16.7"
"Brooks","2020-08-22","4","3272","1","514","19.3","16.4"
"Brooks","2020-08-23","4","3276","1","515","16.8","17.6"
"Brooks","2020-08-24","27","3303","10","525","18.4","19.8"
"Brooks","2020-08-25","14","3317","6","531","23.3","21"
"Brooks","2020-08-26","15","3332","3","534","24.1","22.5"
"Brooks","2020-08-27","14","3346","4","538","28.2","22.6"
"Brooks","2020-08-28","13","3359","2","540","27.7","21.7"
"Brooks","2020-08-29","3","3362","0","540","24.1","21.7"
"Brooks","2020-08-30","5","3367","0","540","20.6","18.7"
"Brooks","2020-08-31","32","3399","5","545","17.5","17.9"
"Brooks","2020-09-01","35","3434","0","545","11.4","17.3"
"Brooks","2020-09-02","16","3450","1","546","9.4","16.7"
"Brooks","2020-09-03","14","3464","0","546","5.3","16.7"
"Brooks","2020-09-04","17","3481","2","548","4.8","16.2"
"Brooks","2020-09-05","5","3486","1","549","7.7","15.9"
"Brooks","2020-09-06","6","3492","1","550","10","15.3"
"Brooks","2020-09-07","6","3498","2","552","12.6","15"
"Brooks","2020-09-08","34","3532","3","555","13.8","12.6"
"Brooks","2020-09-09","16","3548","1","556","13.8","11.6"
"Brooks","2020-09-10","18","3566","2","558","15.4","10.4"
"Brooks","2020-09-11","17","3583","3","561","16.3","10.5"
"Brooks","2020-09-12","4","3587","2","563","20.5","14.1"
"Brooks","2020-09-13","4","3591","0","563","18.2","14.1"
"Brooks","2020-09-14","35","3626","6","569","15.9","14.2"
"Brooks","2020-09-15","42","3668","7","576","17","15.4"
"Brooks","2020-09-16","24","3692","1","577","16.7","15.3"
"Brooks","2020-09-17","10","3702","2","579","17.9","16.7"
"Brooks","2020-09-18","14","3716","0","579","15.4","15.8"
"Brooks","2020-09-19","5","3721","0","579","8.3","14.4"
"Brooks","2020-09-20","4","3725","0","579","8.3","13.2"
"Brooks","2020-09-21","44","3769","4","583","7.1","11.5"
"Brooks","2020-09-22","37","3806","5","588","6.7","11.8"
"Brooks","2020-09-23","18","3824","1","589","6.9","11.8"
"Brooks","2020-09-24","14","3838","3","592","7.1","12.5"
"Brooks","2020-09-25","12","3850","2","594","9.5","12.4"
"Brooks","2020-09-26","4","3854","0","594","9.5","8.9"
"Brooks","2020-09-27","2","3856","1","595","16.6","12.4"
"Brooks","2020-09-28","28","3884","0","595","15.3","11.2"
"Brooks","2020-09-29","20","3904","0","595","13.4","10"
"Brooks","2020-09-30","16","3920","0","595","12.6","9.7"
"Brooks","2020-10-01","18","3938","3","598","11.9","9.5"
"Brooks","2020-10-02","13","3951","3","601","12.8","11.1"
"Brooks","2020-10-03","2","3953","0","601","12.8","11.1"
"Brooks","2020-10-04","4","3957","0","601","5.7","11.1"
"Brooks","2020-10-05","23","3980","0","601","5.7","10.5"
"Brooks","2020-10-06","26","4006","0","601","5.7","9.5"
"Brooks","2020-10-07","18","4024","0","601","5.7","9.1"
"Brooks","2020-10-08","22","4046","2","603","4.6","8.3"
"Brooks","2020-10-09","26","4072","0","603","1.3","7.1"
"Brooks","2020-10-10","6","4078","0","603","1.3","7.1"
"Brooks","2020-10-11","3","4081","0","603","1.3","3.5"
"Brooks","2020-10-12","15","4096","1","604","2.3","4"
"Brooks","2020-10-13","25","4121","1","605","2.8","4.3"
"Brooks","2020-10-14","21","4142","6","611","6.9","6.3"
"Brooks","2020-10-15","13","4155","2","613","7.8","6.2"
"Brooks","2020-10-16","12","4167","1","614","9","5.1"
"Brooks","2020-10-17","9","4176","3","617","13.8","7.5"
"Brooks","2020-10-18","4","4180","0","617","13.8","7.5"
"Brooks","2020-10-19","34","4214","1","618","13.2","7.7"
"Brooks","2020-10-20","21","4235","3","621","14.7","8.8"
"Brooks","2020-10-21","7","4242","0","621","10.6","8.8"
"Brooks","2020-10-22","28","4270","2","623","9.4","8.6"
"Brooks","2020-10-23","10","4280","0","623","8.2","8.6"
"Brooks","2020-10-24","5","4285","0","623","3.5","8.6"
"Brooks","2020-10-25","7","4292","0","623","3.5","8.6"
"Brooks","2020-10-26","20","4312","1","624","3.8","8.5"
"Brooks","2020-10-27","15","4327","0","624","1.7","8.2"
"Brooks","2020-10-28","18","4345","0","624","1.7","6.2"
"Brooks","2020-10-29","13","4358","1","625","1.8","5.6"
"Brooks","2020-10-30","10","4368","0","625","1.8","5"
"Brooks","2020-10-31","4","4372","0","625","1.8","2.6"
"Brooks","2020-11-01","4","4376","1","626","5.4","4.4"
"Brooks","2020-11-02","17","4393","1","627","5.5","4.6"
"Brooks","2020-11-03","12","4405","0","627","5.5","3.6"
"Brooks","2020-11-04","20","4425","0","627","5.5","3.6"
"Brooks","2020-11-05","11","4436","1","628","5.7","3.8"
"Brooks","2020-11-06","14","4450","0","628","5.7","3.8"
"Brooks","2020-11-07","5","4455","0","628","5.7","3.8"
"Brooks","2020-11-08","5","4460","1","629","5","5.2"
"Brooks","2020-11-09","17","4477","0","629","4.2","4.8"
"Brooks","2020-11-10","19","4496","1","630","4.9","5.2"
"Brooks","2020-11-11","12","4508","1","631","6.1","5.8"
"Brooks","2020-11-12","7","4515","0","631","4.8","5.3"
"Brooks","2020-11-13","10","4525","1","632","6.2","6"
"Brooks","2020-11-14","8","4533","0","632","6.2","6"
"Brooks","2020-11-15","4","4537","0","632","3.4","4.2"
"Brooks","2020-11-16","25","4562","5","637","6.2","5.2"
"Brooks","2020-11-17","25","4587","0","637","5.5","5.2"
"Brooks","2020-11-18","13","4600","1","638","5.4","5.7"
"Brooks","2020-11-19","18","4618","0","638","5.4","5.1"
"Brooks","2020-11-20","15","4633","1","639","4.9","5.6"
"Brooks","2020-11-21","7","4640","2","641","9","7.6"
"Brooks","2020-11-22","6","4646","0","641","9","6.2"
"Brooks","2020-11-23","11","4657","2","643","8.7","7.5"
"Brooks","2020-11-24","26","4683","5","648","11.5","8.5"
"Brooks","2020-11-25","19","4702","6","654","14.9","10.1"
"Brooks","2020-11-26","6","4708","2","656","19.7","12.5"
"Brooks","2020-11-27","10","4718","3","659","23","13.9"
"Brooks","2020-11-28","10","4728","4","663","24.6","16.8"
"Brooks","2020-11-29","6","4734","1","664","27","18"
"Brooks","2020-11-30","56","4790","20","684","29.5","19.1"
"Brooks","2020-12-01","55","4845","15","699","30.7","21.1"
"Brooks","2020-12-02","22","4867","6","705","30","22.5"
"Brooks","2020-12-03","18","4885","4","709","28.4","24.1"
"Brooks","2020-12-04","18","4903","5","714","28.1","25.6"
"Brooks","2020-12-05","8","4911","2","716","26","25.3"
"Brooks","2020-12-06","7","4918","0","716","23.6","25.3"
"Brooks","2020-12-07","28","4946","6","722","21.6","25.5"
"Brooks","2020-12-08","55","5001","6","728","19.2","24.9"
"Brooks","2020-12-09","27","5028","6","734","18.5","24.3"
"Brooks","2020-12-10","29","5057","7","741","18.8","23.6"
"Brooks","2020-12-11","21","5078","5","746","18.2","23.2"
"Brooks","2020-12-12","16","5094","8","754","21.8","23.9"
"Brooks","2020-12-13","9","5103","3","757","26.5","25.1"
"Brooks","2020-12-14","36","5139","8","765","26.7","24.1"
"Brooks","2020-12-15","71","5210","6","771","26.3","22.8"
"Brooks","2020-12-16","26","5236","4","775","25.3","21.9"
"Brooks","2020-12-17","21","5257","3","778","23.9","21.4"
"Brooks","2020-12-18","28","5285","5","783","23.1","20.6"
"Brooks","2020-12-19","11","5296","2","785","18.5","20.2"
"Brooks","2020-12-20","13","5309","3","788","17.1","21.8"
"Brooks","2020-12-21","29","5338","6","794","16.8","21.8"
"Brooks","2020-12-22","84","5422","17","811","18.5","22.4"
"Brooks","2020-12-23","11","5433","3","814","20.2","22.8"
"Brooks","2020-12-24","12","5445","2","816","20.6","22.2"
"Brooks","2020-12-25","5","5450","2","818","23.7","23.4"
"Brooks","2020-12-26","9","5459","0","818","21.1","19.8"
"Brooks","2020-12-27","9","5468","3","821","22.6","19.8"
"Brooks","2020-12-28","33","5501","8","829","23.1","20"
"Brooks","2020-12-29","73","5574","14","843","23","20.7"
"Brooks","2020-12-30","26","5600","3","846","20.7","20.5"
"Brooks","2020-12-31","17","5617","3","849","20.8","20.7"
"Brooks","2021-01-01","7","5624","3","852","21.3","22.5"
"Brooks","2021-01-02","3","5627","0","852","21.3","21.2"
"Brooks","2021-01-03","8","5635","1","853","18.3","20.4"
"Brooks","2021-01-04","26","5661","8","861","19.2","21.2"
"Brooks","2021-01-05","78","5739","17","878","19.6","21.3"
"Brooks","2021-01-06","24","5763","6","884","21.5","21.1"
"Brooks","2021-01-07","20","5783","6","890","23.3","22.1"
"Brooks","2021-01-08","14","5797","3","893","20.2","20.7"
"Brooks","2021-01-09","11","5808","3","896","24.1","22.7"
"Brooks","2021-01-10","8","5816","0","896","22.3","20.3"
"Brooks","2021-01-11","23","5839","5","901","21","20.1"
"Brooks","2021-01-12","66","5905","7","908","19.4","19.5"
"Brooks","2021-01-13","21","5926","5","913","19.3","20.4"
"Brooks","2021-01-14","19","5945","5","918","18.7","21"
"Brooks","2021-01-15","15","5960","1","919","16.6","18.4"
"Brooks","2021-01-16","7","5967","3","922","18.9","21.5"
"Brooks","2021-01-17","9","5976","1","923","20.4","21.4"
"Brooks","2021-01-18","19","5995","3","926","19.6","20.3"
"Brooks","2021-01-19","21","6016","3","929","20.1","19.8"
"Brooks","2021-01-20","24","6040","2","931","17.9","18.6"
"Brooks","2021-01-21","9","6049","4","935","20.5","19.6"
"Brooks","2021-01-22","21","6070","3","938","21.6","19.1"
"Brooks","2021-01-23","6","6076","0","938","15.5","17.2"
"Brooks","2021-01-24","5","6081","1","939","16.7","18.6"
"Brooks","2021-01-25","21","6102","6","945","18.6","19.1"
"Brooks","2021-01-26","18","6120","1","946","17.3","18.7"
"Brooks","2021-01-27","18","6138","1","947","16.9","17.4"
"Brooks","2021-01-28","19","6157","2","949","12.1","16.3"
"Brooks","2021-01-29","12","6169","3","952","13.6","17.6"
"Brooks","2021-01-30","5","6174","3","955","22.2","18.8"
"Brooks","2021-01-31","10","6184","0","955","19.3","18"
"Brooks","2021-02-01","26","6210","2","957","16.3","17.4"
"Brooks","2021-02-02","25","6235","6","963","19","18.1"
"Brooks","2021-02-03","15","6250","1","964","19.1","18"
"Brooks","2021-02-04","15","6265","2","966","19.5","15.8"
"Brooks","2021-02-05","7","6272","0","966","16","14.8"
"Brooks","2021-02-06","3","6275","1","967","12.1","17.2"
"Brooks","2021-02-07","3","6278","0","967","12.1","15.7"
"Brooks","2021-02-08","0","6278","0","967","11","13.7"
"Bryan","2020-02-01","0","0","0","0",".","."
"Bryan","2020-02-02","0","0","0","0",".","."
"Bryan","2020-02-03","0","0","0","0",".","."
"Bryan","2020-02-04","0","0","0","0",".","."
"Bryan","2020-02-05","0","0","0","0",".","."
"Bryan","2020-02-06","0","0","0","0",".","."
"Bryan","2020-02-07","0","0","0","0","0","."
"Bryan","2020-02-08","0","0","0","0","0","."
"Bryan","2020-02-09","0","0","0","0","0","."
"Bryan","2020-02-10","0","0","0","0","0","."
"Bryan","2020-02-11","0","0","0","0","0","."
"Bryan","2020-02-12","0","0","0","0","0","."
"Bryan","2020-02-13","0","0","0","0","0","."
"Bryan","2020-02-14","0","0","0","0","0","0"
"Bryan","2020-02-15","0","0","0","0","0","0"
"Bryan","2020-02-16","0","0","0","0","0","0"
"Bryan","2020-02-17","0","0","0","0","0","0"
"Bryan","2020-02-18","0","0","0","0","0","0"
"Bryan","2020-02-19","0","0","0","0","0","0"
"Bryan","2020-02-20","0","0","0","0","0","0"
"Bryan","2020-02-21","0","0","0","0","0","0"
"Bryan","2020-02-22","0","0","0","0","0","0"
"Bryan","2020-02-23","0","0","0","0","0","0"
"Bryan","2020-02-24","0","0","0","0","0","0"
"Bryan","2020-02-25","0","0","0","0","0","0"
"Bryan","2020-02-26","0","0","0","0","0","0"
"Bryan","2020-02-27","0","0","0","0","0","0"
"Bryan","2020-02-28","0","0","0","0","0","0"
"Bryan","2020-02-29","0","0","0","0","0","0"
"Bryan","2020-03-01","0","0","0","0","0","0"
"Bryan","2020-03-02","0","0","0","0","0","0"
"Bryan","2020-03-03","0","0","0","0","0","0"
"Bryan","2020-03-04","0","0","0","0","0","0"
"Bryan","2020-03-05","0","0","0","0","0","0"
"Bryan","2020-03-06","0","0","0","0","0","0"
"Bryan","2020-03-07","0","0","0","0","0","0"
"Bryan","2020-03-08","0","0","0","0","0","0"
"Bryan","2020-03-09","0","0","0","0","0","0"
"Bryan","2020-03-10","0","0","0","0","0","0"
"Bryan","2020-03-11","3","3","0","0","0","0"
"Bryan","2020-03-12","1","4","0","0","0","0"
"Bryan","2020-03-13","4","8","0","0","0","0"
"Bryan","2020-03-14","0","8","0","0","0","0"
"Bryan","2020-03-15","0","8","0","0","0","0"
"Bryan","2020-03-16","13","21","0","0","0","0"
"Bryan","2020-03-17","11","32","0","0","0","0"
"Bryan","2020-03-18","6","38","0","0","0","0"
"Bryan","2020-03-19","9","47","0","0","0","0"
"Bryan","2020-03-20","11","58","1","1","1.3","0.6"
"Bryan","2020-03-21","7","65","1","2","3.3","1.7"
"Bryan","2020-03-22","8","73","2","4","6.9","3.5"
"Bryan","2020-03-23","16","89","4","8","10.5","5.2"
"Bryan","2020-03-24","11","100","2","10","13.1","6.5"
"Bryan","2020-03-25","26","126","1","11","13.6","6.8"
"Bryan","2020-03-26","9","135","2","13","16.8","8.4"
"Bryan","2020-03-27","21","156","1","14","16.2","8.7"
"Bryan","2020-03-28","5","161","2","16","19.9","11.6"
"Bryan","2020-03-29","2","163","1","17","23.4","15.2"
"Bryan","2020-03-30","15","178","1","18","20.8","15.6"
"Bryan","2020-03-31","14","192","3","21","21.3","17.2"
"Bryan","2020-04-01","11","203","1","22","22","17.8"
"Bryan","2020-04-02","10","213","2","24","21.7","19.3"
"Bryan","2020-04-03","20","233","2","26","22.5","19.3"
"Bryan","2020-04-04","14","247","0","26","16.7","18.3"
"Bryan","2020-04-05","3","250","1","27","14.4","18.9"
"Bryan","2020-04-06","13","263","1","28","14.5","17.7"
"Bryan","2020-04-07","35","298","3","31","12.7","17"
"Bryan","2020-04-08","23","321","0","31","11.4","16.7"
"Bryan","2020-04-09","24","345","2","33","9.7","15.7"
"Bryan","2020-04-10","12","357","1","34","9.5","16"
"Bryan","2020-04-11","24","381","3","37","11.3","14"
"Bryan","2020-04-12","6","387","1","38","8.9","11.6"
"Bryan","2020-04-13","10","397","1","39","9.2","11.9"
"Bryan","2020-04-14","5","402","0","39","8","10.3"
"Bryan","2020-04-15","10","412","1","40","9.4","10.4"
"Bryan","2020-04-16","22","434","1","41","8.9","9.3"
"Bryan","2020-04-17","22","456","1","42","8.3","8.9"
"Bryan","2020-04-18","9","465","0","42","6.5","8.9"
"Bryan","2020-04-19","3","468","1","43","8.9","8.9"
"Bryan","2020-04-20","17","485","1","44","8.3","8.8"
"Bryan","2020-04-21","18","503","0","44","8.3","8.2"
"Bryan","2020-04-22","16","519","0","44","6.9","8.2"
"Bryan","2020-04-23","13","532","1","45","7.4","8.1"
"Bryan","2020-04-24","20","552","1","46","7.4","7.9"
"Bryan","2020-04-25","5","557","1","47","10.3","8.4"
"Bryan","2020-04-26","4","561","0","47","5.5","7.2"
"Bryan","2020-04-27","7","568","0","47","4.7","6.5"
"Bryan","2020-04-28","10","578","0","47","4.7","6.5"
"Bryan","2020-04-29","15","593","1","48","5.6","6.3"
"Bryan","2020-04-30","9","602","1","49","6.1","6.7"
"Bryan","2020-05-01","12","614","0","49","5.4","6.4"
"Bryan","2020-05-02","4","618","0","49","2.5","6.4"
"Bryan","2020-05-03","1","619","0","49","2.5","4"
"Bryan","2020-05-04","14","633","0","49","2.5","3.6"
"Bryan","2020-05-05","8","641","0","49","2.5","3.6"
"Bryan","2020-05-06","37","678","0","49","1.6","3.6"
"Bryan","2020-05-07","8","686","0","49","0","3.1"
"Bryan","2020-05-08","13","699","0","49","0","2.7"
"Bryan","2020-05-09","6","705","0","49","0","1.3"
"Bryan","2020-05-10","3","708","0","49","0","1.3"
"Bryan","2020-05-11","9","717","0","49","0","1.3"
"Bryan","2020-05-12","15","732","2","51","1.9","2.2"
"Bryan","2020-05-13","18","750","0","51","1.9","1.7"
"Bryan","2020-05-14","7","757","0","51","1.9","1"
"Bryan","2020-05-15","35","792","0","51","1.9","1"
"Bryan","2020-05-16","1","793","0","51","1.9","1"
"Bryan","2020-05-17","5","798","1","52","4.8","2.4"
"Bryan","2020-05-18","14","812","4","56","8.8","4.4"
"Bryan","2020-05-19","20","832","2","58","8.4","5.1"
"Bryan","2020-05-20","10","842","1","59","9.8","5.9"
"Bryan","2020-05-21","16","858","1","60","10.7","6.3"
"Bryan","2020-05-22","47","905","2","62","11.3","6.6"
"Bryan","2020-05-23","13","918","0","62","11.3","6.6"
"Bryan","2020-05-24","7","925","0","62","8.4","6.6"
"Bryan","2020-05-25","4","929","1","63","7.9","8.4"
"Bryan","2020-05-26","17","946","1","64","7.3","7.9"
"Bryan","2020-05-27","22","968","2","66","7.2","8.5"
"Bryan","2020-05-28","23","991","1","67","6.9","8.8"
"Bryan","2020-05-29","42","1033","1","68","6.7","9"
"Bryan","2020-05-30","11","1044","1","69","8","9.6"
"Bryan","2020-05-31","3","1047","1","70","12.7","10.6"
"Bryan","2020-06-01","43","1090","3","73","10.2","9"
"Bryan","2020-06-02","39","1129","1","74","9.7","8.5"
"Bryan","2020-06-03","25","1154","2","76","9.5","8.4"
"Bryan","2020-06-04","36","1190","0","76","8.9","7.9"
"Bryan","2020-06-05","46","1236","1","77","8.9","7.8"
"Bryan","2020-06-06","20","1256","1","78","8.3","8.1"
"Bryan","2020-06-07","13","1269","0","78","3.5","8.1"
"Bryan","2020-06-08","40","1309","0","78","2.5","6.3"
"Bryan","2020-06-09","28","1337","1","79","2.7","6.2"
"Bryan","2020-06-10","19","1356","0","79","1.5","5.5"
"Bryan","2020-06-11","33","1389","1","80","2","5.4"
"Bryan","2020-06-12","41","1430","2","82","2.4","5.6"
"Bryan","2020-06-13","9","1439","1","83","3.2","5.8"
"Bryan","2020-06-14","17","1456","1","84","4.1","3.8"
"Bryan","2020-06-15","40","1496","1","85","4.4","3.5"
"Bryan","2020-06-16","45","1541","1","86","4.2","3.5"
"Bryan","2020-06-17","34","1575","3","89","5.5","3.5"
"Bryan","2020-06-18","53","1628","9","98","7.5","4.7"
"Bryan","2020-06-19","68","1696","11","109","9.1","5.7"
"Bryan","2020-06-20","32","1728","6","115","10.2","6.7"
"Bryan","2020-06-21","19","1747","5","120","13.1","8.6"
"Bryan","2020-06-22","53","1800","7","127","14.6","9.5"
"Bryan","2020-06-23","58","1858","7","134","16","10.1"
"Bryan","2020-06-24","85","1943","13","147","17","11.2"
"Bryan","2020-06-25","73","2016","8","155","16.1","11.8"
"Bryan","2020-06-26","108","2124","11","166","15.3","12.2"
"Bryan","2020-06-27","78","2202","2","168","12.9","11.6"
"Bryan","2020-06-28","37","2239","3","171","10.3","11.7"
"Bryan","2020-06-29","108","2347","9","180","9.6","12.1"
"Bryan","2020-06-30","141","2488","13","193","9.2","12.6"
"Bryan","2020-07-01","139","2627","19","212","9","13"
"Bryan","2020-07-02","107","2734","10","222","8.8","12.4"
"Bryan","2020-07-03","58","2792","9","231","9.5","12.4"
"Bryan","2020-07-04","40","2832","7","238","11.7","12.3"
"Bryan","2020-07-05","32","2864","7","245","13.6","12"
"Bryan","2020-07-06","102","2966","18","263","15","12.3"
"Bryan","2020-07-07","130","3096","15","278","15.3","12.3"
"Bryan","2020-07-08","128","3224","19","297","15.5","12.2"
"Bryan","2020-07-09","132","3356","14","311","15.6","12.2"
"Bryan","2020-07-10","226","3582","21","332","14.8","12.1"
"Bryan","2020-07-11","70","3652","10","342","14.3","13"
"Bryan","2020-07-12","37","3689","3","345","12.3","13"
"Bryan","2020-07-13","204","3893","15","360","10.9","12.9"
"Bryan","2020-07-14","102","3995","14","374","11.2","13.2"
"Bryan","2020-07-15","159","4154","19","393","10.8","13.1"
"Bryan","2020-07-16","100","4254","4","397","9.8","12.7"
"Bryan","2020-07-17","146","4400","21","418","10.5","12.7"
"Bryan","2020-07-18","30","4430","5","423","10.9","12.6"
"Bryan","2020-07-19","17","4447","3","426","12.2","12.3"
"Bryan","2020-07-20","61","4508","12","438","14","12.4"
"Bryan","2020-07-21","89","4597","14","452","14.3","12.7"
"Bryan","2020-07-22","43","4640","10","462","15.9","13.3"
"Bryan","2020-07-23","120","4760","10","472","16.5","13.2"
"Bryan","2020-07-24","177","4937","13","485","15.5","13"
"Bryan","2020-07-25","28","4965","6","491","16.2","13.5"
"Bryan","2020-07-26","16","4981","3","494","16.4","14.3"
"Bryan","2020-07-27","89","5070","15","509","16","15"
"Bryan","2020-07-28","118","5188","13","522","15.3","14.8"
"Bryan","2020-07-29","39","5227","6","528","14.2","15"
"Bryan","2020-07-30","137","5364","9","537","13.9","15.2"
"Bryan","2020-07-31","113","5477","7","544","13.7","14.6"
"Bryan","2020-08-01","29","5506","3","547","12.2","14.2"
"Bryan","2020-08-02","19","5525","6","553","14","15.2"
"Bryan","2020-08-03","62","5587","14","567","14.8","15.4"
"Bryan","2020-08-04","118","5705","6","573","14","14.6"
"Bryan","2020-08-05","33","5738","4","577","13.5","13.8"
"Bryan","2020-08-06","108","5846","3","580","13","13.4"
"Bryan","2020-08-07","91","5937","5","585","12.9","13.3"
"Bryan","2020-08-08","23","5960","0","585","11.4","11.8"
"Bryan","2020-08-09","20","5980","1","586","7.6","10.8"
"Bryan","2020-08-10","68","6048","14","600","7.3","11.1"
"Bryan","2020-08-11","111","6159","8","608","7.6","10.8"
"Bryan","2020-08-12","30","6189","2","610","6.8","10.2"
"Bryan","2020-08-13","117","6306","6","616","7.2","10.1"
"Bryan","2020-08-14","88","6394","3","619","6.9","9.9"
"Bryan","2020-08-15","29","6423","2","621","7.8","9.6"
"Bryan","2020-08-16","16","6439","3","624","9.8","8.7"
"Bryan","2020-08-17","66","6505","10","634","9","8.2"
"Bryan","2020-08-18","92","6597","10","644","9.6","8.6"
"Bryan","2020-08-19","36","6633","2","646","9.4","8.1"
"Bryan","2020-08-20","78","6711","3","649","9.2","8.2"
"Bryan","2020-08-21","74","6785","15","664","11.6","9.2"
"Bryan","2020-08-22","19","6804","1","665","11.4","9.6"
"Bryan","2020-08-23","22","6826","2","667","10","9.9"
"Bryan","2020-08-24","41","6867","3","670","8.9","9"
"Bryan","2020-08-25","121","6988","6","676","8","8.8"
"Bryan","2020-08-26","27","7015","3","679","8.8","9.1"
"Bryan","2020-08-27","46","7061","2","681","8.9","9.1"
"Bryan","2020-08-28","101","7162","22","703","9.1","10.4"
"Bryan","2020-08-29","21","7183","5","708","11.8","11.6"
"Bryan","2020-08-30","27","7210","0","708","10.5","10.2"
"Bryan","2020-08-31","41","7251","2","710","10.1","9.5"
"Bryan","2020-09-01","106","7357","6","716","10.2","9.1"
"Bryan","2020-09-02","42","7399","5","721","10.3","9.6"
"Bryan","2020-09-03","49","7448","2","723","10.3","9.6"
"Bryan","2020-09-04","84","7532","11","734","9.1","9.1"
"Bryan","2020-09-05","29","7561","8","742","9.6","10.7"
"Bryan","2020-09-06","22","7583","1","743","10.3","10.4"
"Bryan","2020-09-07","14","7597","2","745","11.6","10.9"
"Bryan","2020-09-08","107","7704","6","751","11.6","10.9"
"Bryan","2020-09-09","54","7758","5","756","11.2","10.8"
"Bryan","2020-09-10","79","7837","5","761","11.5","10.9"
"Bryan","2020-09-11","100","7937","10","771","11.1","10.1"
"Bryan","2020-09-12","26","7963","3","774","8.8","9.2"
"Bryan","2020-09-13","23","7986","2","776","9.4","9.8"
"Bryan","2020-09-14","59","8045","5","781","8.6","10.1"
"Bryan","2020-09-15","99","8144","6","787","8.6","10.1"
"Bryan","2020-09-16","39","8183","9","796","10.6","10.9"
"Bryan","2020-09-17","79","8262","7","803","11","11.2"
"Bryan","2020-09-18","68","8330","6","809","10.8","10.9"
"Bryan","2020-09-19","28","8358","3","812","10.7","9.7"
"Bryan","2020-09-20","24","8382","1","813","10","9.7"
"Bryan","2020-09-21","47","8429","4","817","10","9.3"
"Bryan","2020-09-22","87","8516","9","826","10.6","9.6"
"Bryan","2020-09-23","29","8545","1","827","7.8","9.2"
"Bryan","2020-09-24","79","8624","3","830","7.1","9"
"Bryan","2020-09-25","69","8693","2","832","6.3","8.5"
"Bryan","2020-09-26","19","8712","1","833","5.5","8.1"
"Bryan","2020-09-27","9","8721","1","834","6.5","8.3"
"Bryan","2020-09-28","43","8764","4","838","6.6","8.3"
"Bryan","2020-09-29","80","8844","1","839","5.3","8"
"Bryan","2020-09-30","36","8880","4","843","6.4","7.1"
"Bryan","2020-10-01","66","8946","5","848","6.9","7"
"Bryan","2020-10-02","53","8999","4","852","7.6","6.9"
"Bryan","2020-10-03","30","9029","1","853","7.3","6.4"
"Bryan","2020-10-04","31","9060","3","856","7.1","6.8"
"Bryan","2020-10-05","38","9098","5","861","7.7","7.1"
"Bryan","2020-10-06","110","9208","2","863","7.7","6.5"
"Bryan","2020-10-07","67","9275","3","866","6.8","6.6"
"Bryan","2020-10-08","65","9340","7","873","7.3","7.1"
"Bryan","2020-10-09","60","9400","6","879","7.6","7.6"
"Bryan","2020-10-10","22","9422","1","880","7.8","7.5"
"Bryan","2020-10-11","21","9443","2","882","7.8","7.4"
"Bryan","2020-10-12","46","9489","7","889","8.1","7.9"
"Bryan","2020-10-13","94","9583","3","892","8.2","8"
"Bryan","2020-10-14","37","9620","1","893","8","7.4"
"Bryan","2020-10-15","62","9682","5","898","7.6","7.4"
"Bryan","2020-10-16","76","9758","5","903","7.1","7.4"
"Bryan","2020-10-17","20","9778","4","907","9.3","8.6"
"Bryan","2020-10-18","12","9790","0","907","8","7.9"
"Bryan","2020-10-19","40","9830","2","909","6.5","7.3"
"Bryan","2020-10-20","107","9937","2","911","6.3","7.3"
"Bryan","2020-10-21","33","9970","3","914","7.2","7.6"
"Bryan","2020-10-22","38","10008","12","926","10.6","9.1"
"Bryan","2020-10-23","64","10072","7","933","11.2","9.2"
"Bryan","2020-10-24","22","10094","2","935","9.7","9.5"
"Bryan","2020-10-25","19","10113","3","938","11.9","9.9"
"Bryan","2020-10-26","37","10150","4","942","12.7","9.6"
"Bryan","2020-10-27","92","10242","8","950","13.7","10"
"Bryan","2020-10-28","36","10278","4","954","14","10.6"
"Bryan","2020-10-29","33","10311","2","956","10.4","10.5"
"Bryan","2020-10-30","86","10397","7","963","10","10.6"
"Bryan","2020-10-31","20","10417","5","968","12.2","10.9"
"Bryan","2020-11-01","9","10426","0","968","10","10.9"
"Bryan","2020-11-02","42","10468","3","971","9.4","11.1"
"Bryan","2020-11-03","81","10549","4","975","8.9","11.3"
"Bryan","2020-11-04","35","10584","2","977","8.1","11.1"
"Bryan","2020-11-05","35","10619","2","979","8.1","9.2"
"Bryan","2020-11-06","63","10682","6","985","8.3","9.1"
"Bryan","2020-11-07","18","10700","2","987","6.3","9.3"
"Bryan","2020-11-08","10","10710","1","988","7.7","8.9"
"Bryan","2020-11-09","41","10751","1","989","7.1","8.3"
"Bryan","2020-11-10","41","10792","7","996","8.8","8.9"
"Bryan","2020-11-11","42","10834","5","1001","9.7","8.9"
"Bryan","2020-11-12","49","10883","3","1004","9.7","8.9"
"Bryan","2020-11-13","88","10971","2","1006","8.7","8.5"
"Bryan","2020-11-14","59","11030","7","1013","8.8","7.6"
"Bryan","2020-11-15","18","11048","2","1015","9","8.4"
"Bryan","2020-11-16","69","11117","9","1024","10.5","8.8"
"Bryan","2020-11-17","156","11273","10","1034","9","8.9"
"Bryan","2020-11-18","69","11342","9","1043","9.1","9.4"
"Bryan","2020-11-19","48","11390","4","1047","9.4","9.6"
"Bryan","2020-11-20","121","11511","5","1052","9.7","9.2"
"Bryan","2020-11-21","26","11537","4","1056","10.2","9.5"
"Bryan","2020-11-22","28","11565","0","1056","8.6","8.8"
"Bryan","2020-11-23","51","11616","6","1062","8.4","9.5"
"Bryan","2020-11-24","152","11768","6","1068","8.1","8.5"
"Bryan","2020-11-25","27","11795","3","1071","7.8","8.5"
"Bryan","2020-11-26","4","11799","0","1071","6.6","8"
"Bryan","2020-11-27","14","11813","5","1076","11.1","10.4"
"Bryan","2020-11-28","22","11835","5","1081","12.2","11.2"
"Bryan","2020-11-29","25","11860","6","1087","15.6","12.1"
"Bryan","2020-11-30","45","11905","5","1092","15.5","12"
"Bryan","2020-12-01","171","12076","15","1107","16.2","12.1"
"Bryan","2020-12-02","41","12117","4","1111","16","11.9"
"Bryan","2020-12-03","31","12148","4","1115","17.9","12.2"
"Bryan","2020-12-04","95","12243","3","1118","13.2","12.2"
"Bryan","2020-12-05","25","12268","5","1123","12.8","12.5"
"Bryan","2020-12-06","20","12288","1","1124","10.1","12.9"
"Bryan","2020-12-07","62","12350","3","1127","9.2","12.4"
"Bryan","2020-12-08","151","12501","17","1144","9.6","12.9"
"Bryan","2020-12-09","45","12546","4","1148","9.4","12.7"
"Bryan","2020-12-10","51","12597","4","1152","8.7","13.3"
"Bryan","2020-12-11","97","12694","17","1169","10.8","12"
"Bryan","2020-12-12","22","12716","6","1175","11.8","12.3"
"Bryan","2020-12-13","11","12727","2","1177","13.7","11.9"
"Bryan","2020-12-14","66","12793","10","1187","15.2","12.2"
"Bryan","2020-12-15","178","12971","13","1200","14.6","12.1"
"Bryan","2020-12-16","58","13029","12","1212","16.3","12.9"
"Bryan","2020-12-17","61","13090","16","1228","18.9","13.8"
"Bryan","2020-12-18","122","13212","8","1236","17.3","14.1"
"Bryan","2020-12-19","37","13249","5","1241","15.4","13.6"
"Bryan","2020-12-20","26","13275","4","1245","15","14.3"
"Bryan","2020-12-21","87","13362","13","1258","14.9","15.1"
"Bryan","2020-12-22","156","13518","12","1270","15","14.8"
"Bryan","2020-12-23","39","13557","10","1280","15.7","16"
"Bryan","2020-12-24","38","13595","5","1285","13.8","16.4"
"Bryan","2020-12-25","10","13605","1","1286","14.3","15.8"
"Bryan","2020-12-26","26","13631","6","1292","15.7","15.5"
"Bryan","2020-12-27","30","13661","4","1296","15.4","15.2"
"Bryan","2020-12-28","78","13739","18","1314","16.6","15.8"
"Bryan","2020-12-29","158","13897","16","1330","16.9","16"
"Bryan","2020-12-30","56","13953","14","1344","16.8","16.3"
"Bryan","2020-12-31","36","13989","11","1355","19.3","16.6"
"Bryan","2021-01-01","7","13996","2","1357","22","18.1"
"Bryan","2021-01-02","10","14006","1","1358","20.1","17.9"
"Bryan","2021-01-03","8","14014","2","1360","21.8","18.6"
"Bryan","2021-01-04","59","14073","11","1371","21.1","18.8"
"Bryan","2021-01-05","288","14361","33","1404","21.3","19.1"
"Bryan","2021-01-06","60","14421","14","1418","21.1","19"
"Bryan","2021-01-07","56","14477","11","1429","19.5","19.4"
"Bryan","2021-01-08","130","14607","19","1448","17.5","19.7"
"Bryan","2021-01-09","50","14657","3","1451","17","18.5"
"Bryan","2021-01-10","22","14679","3","1454","15.3","18.5"
"Bryan","2021-01-11","70","14749","10","1464","14.7","17.9"
"Bryan","2021-01-12","170","14919","15","1479","14.3","17.8"
"Bryan","2021-01-13","50","14969","7","1486","13","17"
"Bryan","2021-01-14","82","15051","6","1492","11.2","15.4"
"Bryan","2021-01-15","131","15182","12","1504","10.5","14"
"Bryan","2021-01-16","37","15219","7","1511","12.3","14.6"
"Bryan","2021-01-17","32","15251","4","1515","12.1","13.7"
"Bryan","2021-01-18","78","15329","8","1523","11.6","13.1"
"Bryan","2021-01-19","171","15500","12","1535","11.3","12.8"
"Bryan","2021-01-20","77","15577","7","1542","10.6","11.8"
"Bryan","2021-01-21","95","15672","13","1555","11.5","11.4"
"Bryan","2021-01-22","135","15807","21","1576","12.4","11.4"
"Bryan","2021-01-23","29","15836","2","1578","10.7","11.5"
"Bryan","2021-01-24","21","15857","5","1583","12.3","12.2"
"Bryan","2021-01-25","105","15962","11","1594","12.4","12"
"Bryan","2021-01-26","165","16127","15","1609","12.7","12"
"Bryan","2021-01-27","81","16208","5","1614","12.2","11.4"
"Bryan","2021-01-28","93","16301","17","1631","12.9","12.2"
"Bryan","2021-01-29","123","16424","12","1643","12.1","12.3"
"Bryan","2021-01-30","57","16481","3","1646","11.8","11.3"
"Bryan","2021-01-31","28","16509","7","1653","12","12.2"
"Bryan","2021-02-01","82","16591","13","1666","12.8","12.6"
"Bryan","2021-02-02","63","16654","11","1677","14","13.3"
"Bryan","2021-02-03","80","16734","8","1685","14.5","13.4"
"Bryan","2021-02-04","68","16802","11","1696","14.2","13.6"
"Bryan","2021-02-05","46","16848","3","1699","13.8","12.9"
"Bryan","2021-02-06","33","16881","4","1703","14.7","13.3"
"Bryan","2021-02-07","0","16881","0","1703","11.2","11.6"
"Bryan","2021-02-08","0","16881","0","1703","8.9","10.8"
"Bulloch","2020-02-01","0","0","0","0",".","."
"Bulloch","2020-02-02","0","0","0","0",".","."
"Bulloch","2020-02-03","0","0","0","0",".","."
"Bulloch","2020-02-04","0","0","0","0",".","."
"Bulloch","2020-02-05","0","0","0","0",".","."
"Bulloch","2020-02-06","0","0","0","0",".","."
"Bulloch","2020-02-07","0","0","0","0","0","."
"Bulloch","2020-02-08","0","0","0","0","0","."
"Bulloch","2020-02-09","0","0","0","0","0","."
"Bulloch","2020-02-10","0","0","0","0","0","."
"Bulloch","2020-02-11","0","0","0","0","0","."
"Bulloch","2020-02-12","0","0","0","0","0","."
"Bulloch","2020-02-13","0","0","0","0","0","."
"Bulloch","2020-02-14","0","0","0","0","0","0"
"Bulloch","2020-02-15","0","0","0","0","0","0"
"Bulloch","2020-02-16","0","0","0","0","0","0"
"Bulloch","2020-02-17","0","0","0","0","0","0"
"Bulloch","2020-02-18","0","0","0","0","0","0"
"Bulloch","2020-02-19","0","0","0","0","0","0"
"Bulloch","2020-02-20","0","0","0","0","0","0"
"Bulloch","2020-02-21","0","0","0","0","0","0"
"Bulloch","2020-02-22","0","0","0","0","0","0"
"Bulloch","2020-02-23","0","0","0","0","0","0"
"Bulloch","2020-02-24","0","0","0","0","0","0"
"Bulloch","2020-02-25","0","0","0","0","0","0"
"Bulloch","2020-02-26","0","0","0","0","0","0"
"Bulloch","2020-02-27","0","0","0","0","0","0"
"Bulloch","2020-02-28","0","0","0","0","0","0"
"Bulloch","2020-02-29","0","0","0","0","0","0"
"Bulloch","2020-03-01","0","0","0","0","0","0"
"Bulloch","2020-03-02","0","0","0","0","0","0"
"Bulloch","2020-03-03","0","0","0","0","0","0"
"Bulloch","2020-03-04","0","0","0","0","0","0"
"Bulloch","2020-03-05","0","0","0","0","0","0"
"Bulloch","2020-03-06","0","0","0","0","0","0"
"Bulloch","2020-03-07","0","0","0","0","0","0"
"Bulloch","2020-03-08","0","0","0","0","0","0"
"Bulloch","2020-03-09","0","0","0","0","0","0"
"Bulloch","2020-03-10","0","0","0","0","0","0"
"Bulloch","2020-03-11","1","1","0","0","0","0"
"Bulloch","2020-03-12","2","3","0","0","0","0"
"Bulloch","2020-03-13","5","8","0","0","0","0"
"Bulloch","2020-03-14","4","12","0","0","0","0"
"Bulloch","2020-03-15","2","14","0","0","0","0"
"Bulloch","2020-03-16","12","26","0","0","0","0"
"Bulloch","2020-03-17","11","37","0","0","0","0"
"Bulloch","2020-03-18","6","43","0","0","0","0"
"Bulloch","2020-03-19","10","53","0","0","0","0"
"Bulloch","2020-03-20","6","59","0","0","0","0"
"Bulloch","2020-03-21","1","60","0","0","0","0"
"Bulloch","2020-03-22","3","63","0","0","0","0"
"Bulloch","2020-03-23","11","74","0","0","0","0"
"Bulloch","2020-03-24","3","77","0","0","0","0"
"Bulloch","2020-03-25","18","95","1","1","0.8","0.4"
"Bulloch","2020-03-26","17","112","1","2","1.6","0.8"
"Bulloch","2020-03-27","12","124","1","3","2.8","1.4"
"Bulloch","2020-03-28","1","125","0","3","2.8","1.4"
"Bulloch","2020-03-29","1","126","0","3","2.8","1.4"
"Bulloch","2020-03-30","11","137","0","3","2.8","1.4"
"Bulloch","2020-03-31","14","151","1","4","3.8","1.9"
"Bulloch","2020-04-01","12","163","3","7","6.6","3.7"
"Bulloch","2020-04-02","12","175","1","8","7","4.3"
"Bulloch","2020-04-03","15","190","0","8","5.8","4.3"
"Bulloch","2020-04-04","5","195","2","10","11.5","7.2"
"Bulloch","2020-04-05","2","197","0","10","11.5","7.2"
"Bulloch","2020-04-06","21","218","1","11","12.2","7.5"
"Bulloch","2020-04-07","7","225","0","11","11.2","7.5"
"Bulloch","2020-04-08","18","243","0","11","7.6","7.1"
"Bulloch","2020-04-09","25","268","0","11","6.4","6.7"
"Bulloch","2020-04-10","18","286","2","13","8","6.9"
"Bulloch","2020-04-11","3","289","1","14","7","9.3"
"Bulloch","2020-04-12","0","289","0","14","7","9.3"
"Bulloch","2020-04-13","16","305","1","15","7.2","9.7"
"Bulloch","2020-04-14","13","318","2","17","9.4","10.3"
"Bulloch","2020-04-15","13","331","0","17","9.4","8.5"
"Bulloch","2020-04-16","16","347","1","18","10.3","8.4"
"Bulloch","2020-04-17","29","376","0","18","8.7","8.4"
"Bulloch","2020-04-18","8","384","0","18","4","5.5"
"Bulloch","2020-04-19","1","385","0","18","4","5.5"
"Bulloch","2020-04-20","15","400","0","18","3.1","5.2"
"Bulloch","2020-04-21","8","408","0","18","0.9","5.2"
"Bulloch","2020-04-22","8","416","0","18","0.9","5.2"
"Bulloch","2020-04-23","84","500","0","18","0","5.2"
"Bulloch","2020-04-24","16","516","0","18","0","4.4"
"Bulloch","2020-04-25","7","523","0","18","0","2"
"Bulloch","2020-04-26","2","525","0","18","0","2"
"Bulloch","2020-04-27","7","532","0","18","0","1.5"
"Bulloch","2020-04-28","11","543","1","19","1.3","1.1"
"Bulloch","2020-04-29","18","561","0","19","1.3","1.1"
"Bulloch","2020-04-30","11","572","0","19","1.3","0.6"
"Bulloch","2020-05-01","6","578","0","19","1.3","0.6"
"Bulloch","2020-05-02","4","582","0","19","1.3","0.6"
"Bulloch","2020-05-03","0","582","0","19","1.3","0.6"
"Bulloch","2020-05-04","15","597","0","19","1.3","0.6"
"Bulloch","2020-05-05","18","615","0","19","0","0.6"
"Bulloch","2020-05-06","12","627","2","21","2.4","1.8"
"Bulloch","2020-05-07","6","633","1","22","4.8","3"
"Bulloch","2020-05-08","9","642","0","22","4.8","3"
"Bulloch","2020-05-09","1","643","0","22","4.8","3"
"Bulloch","2020-05-10","0","643","0","22","4.8","3"
"Bulloch","2020-05-11","16","659","0","22","4.8","3"
"Bulloch","2020-05-12","17","676","0","22","4.8","2.4"
"Bulloch","2020-05-13","22","698","0","22","2.4","2.4"
"Bulloch","2020-05-14","34","732","0","22","0","2.4"
"Bulloch","2020-05-15","30","762","0","22","0","2.4"
"Bulloch","2020-05-16","1","763","0","22","0","2.4"
"Bulloch","2020-05-17","100","863","1","23","0.1","2.5"
"Bulloch","2020-05-18","69","932","1","24","0.3","2.6"
"Bulloch","2020-05-19","13","945","2","26","2.5","3.7"
"Bulloch","2020-05-20","52","997","1","27","2.8","2.6"
"Bulloch","2020-05-21","63","1060","0","27","2.8","1.4"
"Bulloch","2020-05-22","51","1111","0","27","2.8","1.4"
"Bulloch","2020-05-23","5","1116","0","27","2.8","1.4"
"Bulloch","2020-05-24","4","1120","0","27","2.7","1.4"
"Bulloch","2020-05-25","2","1122","0","27","2.5","1.4"
"Bulloch","2020-05-26","21","1143","0","27","0.3","1.4"
"Bulloch","2020-05-27","35","1178","0","27","0","1.4"
"Bulloch","2020-05-28","25","1203","2","29","1.1","2"
"Bulloch","2020-05-29","18","1221","0","29","1.1","2"
"Bulloch","2020-05-30","2","1223","0","29","1.1","2"
"Bulloch","2020-05-31","3","1226","0","29","1.1","1.9"
"Bulloch","2020-06-01","21","1247","0","29","1.1","1.8"
"Bulloch","2020-06-02","16","1263","0","29","1.1","0.7"
"Bulloch","2020-06-03","26","1289","0","29","1.1","0.6"
"Bulloch","2020-06-04","28","1317","0","29","0","0.6"
"Bulloch","2020-06-05","25","1342","0","29","0","0.6"
"Bulloch","2020-06-06","4","1346","0","29","0","0.6"
"Bulloch","2020-06-07","3","1349","0","29","0","0.6"
"Bulloch","2020-06-08","29","1378","0","29","0","0.6"
"Bulloch","2020-06-09","16","1394","0","29","0","0.6"
"Bulloch","2020-06-10","15","1409","2","31","1.9","1.5"
"Bulloch","2020-06-11","33","1442","0","31","1.9","1"
"Bulloch","2020-06-12","40","1482","0","31","1.9","1"
"Bulloch","2020-06-13","9","1491","1","32","3.5","1.7"
"Bulloch","2020-06-14","8","1499","2","34","7.1","3.5"
"Bulloch","2020-06-15","58","1557","11","45","9.8","4.9"
"Bulloch","2020-06-16","52","1609","3","48","10.6","5.3"
"Bulloch","2020-06-17","57","1666","10","58","11.2","6.6"
"Bulloch","2020-06-18","75","1741","4","62","12","6.9"
"Bulloch","2020-06-19","97","1838","11","73","13.6","7.7"
"Bulloch","2020-06-20","43","1881","14","87","16.6","10.1"
"Bulloch","2020-06-21","18","1899","1","88","13.9","10.5"
"Bulloch","2020-06-22","133","2032","21","109","13.4","11.6"
"Bulloch","2020-06-23","93","2125","15","124","14.9","12.7"
"Bulloch","2020-06-24","111","2236","15","139","14.3","12.8"
"Bulloch","2020-06-25","120","2356","23","162","16.3","14.1"
"Bulloch","2020-06-26","116","2472","6","168","15.4","14.5"
"Bulloch","2020-06-27","87","2559","16","184","13.4","15"
"Bulloch","2020-06-28","27","2586","4","188","14.7","14.3"
"Bulloch","2020-06-29","236","2822","29","217","14.2","13.8"
"Bulloch","2020-06-30","181","3003","22","239","13.6","14.3"
"Bulloch","2020-07-01","151","3154","24","263","14","14.2"
"Bulloch","2020-07-02","160","3314","15","278","12.6","14.4"
"Bulloch","2020-07-03","70","3384","7","285","13.3","14.3"
"Bulloch","2020-07-04","14","3398","2","287","12.7","13"
"Bulloch","2020-07-05","33","3431","5","292","12.7","13.7"
"Bulloch","2020-07-06","184","3615","24","316","12.8","13.5"
"Bulloch","2020-07-07","100","3715","18","334","13.7","13.7"
"Bulloch","2020-07-08","201","3916","26","360","13.3","13.6"
"Bulloch","2020-07-09","109","4025","13","373","13.6","13.1"
"Bulloch","2020-07-10","134","4159","23","396","14.6","14"
"Bulloch","2020-07-11","25","4184","5","401","15.5","14.1"
"Bulloch","2020-07-12","18","4202","1","402","14.1","13.4"
"Bulloch","2020-07-13","108","4310","24","426","15.4","14.1"
"Bulloch","2020-07-14","135","4445","25","451","15.5","14.6"
"Bulloch","2020-07-15","95","4540","13","464","15.6","14.4"
"Bulloch","2020-07-16","133","4673","14","478","15.4","14.5"
"Bulloch","2020-07-17","100","4773","10","488","14.4","14.5"
"Bulloch","2020-07-18","35","4808","8","496","14.8","15.1"
"Bulloch","2020-07-19","14","4822","0","496","14","14"
"Bulloch","2020-07-20","126","4948","31","527","14.3","14.9"
"Bulloch","2020-07-21","77","5025","10","537","13.5","14.5"
"Bulloch","2020-07-22","104","5129","18","555","14","14.8"
"Bulloch","2020-07-23","89","5218","16","571","15.1","15.2"
"Bulloch","2020-07-24","95","5313","9","580","15","14.7"
"Bulloch","2020-07-25","30","5343","4","584","13.7","14.2"
"Bulloch","2020-07-26","14","5357","4","588","17.8","15.9"
"Bulloch","2020-07-27","118","5475","20","608","16.7","15.5"
"Bulloch","2020-07-28","50","5525","10","618","17.7","15.6"
"Bulloch","2020-07-29","76","5601","10","628","17.1","15.6"
"Bulloch","2020-07-30","85","5686","15","643","17","16.1"
"Bulloch","2020-07-31","67","5753","6","649","16.9","16"
"Bulloch","2020-08-01","22","5775","5","654","18.3","16"
"Bulloch","2020-08-02","24","5799","5","659","17.2","17.5"
"Bulloch","2020-08-03","43","5842","0","659","14.8","15.7"
"Bulloch","2020-08-04","61","5903","9","668","14","15.8"
"Bulloch","2020-08-05","57","5960","9","677","14.4","15.7"
"Bulloch","2020-08-06","66","6026","10","687","14","15.5"
"Bulloch","2020-08-07","60","6086","9","696","14.9","15.9"
"Bulloch","2020-08-08","35","6121","2","698","12.5","15.4"
"Bulloch","2020-08-09","21","6142","3","701","11.5","14.4"
"Bulloch","2020-08-10","45","6187","3","704","12.5","13.6"
"Bulloch","2020-08-11","39","6226","5","709","12.2","13.1"
"Bulloch","2020-08-12","48","6274","9","718","12.6","13.5"
"Bulloch","2020-08-13","51","6325","3","721","11.3","12.7"
"Bulloch","2020-08-14","54","6379","6","727","10.7","12.8"
"Bulloch","2020-08-15","28","6407","3","730","11.5","12"
"Bulloch","2020-08-16","18","6425","5","735","13.4","12.5"
"Bulloch","2020-08-17","39","6464","5","740","14.3","13.4"
"Bulloch","2020-08-18","34","6498","2","742","13.3","12.7"
"Bulloch","2020-08-19","69","6567","6","748","11.8","12.2"
"Bulloch","2020-08-20","72","6639","7","755","12.4","11.8"
"Bulloch","2020-08-21","71","6710","11","766","13","11.9"
"Bulloch","2020-08-22","24","6734","5","771","14.5","13"
"Bulloch","2020-08-23","26","6760","4","775","12.7","13"
"Bulloch","2020-08-24","69","6829","13","788","13.6","13.9"
"Bulloch","2020-08-25","71","6900","24","812","17.5","15.4"
"Bulloch","2020-08-26","117","7017","38","850","20.9","16.4"
"Bulloch","2020-08-27","113","7130","23","873","22.5","17.4"
"Bulloch","2020-08-28","97","7227","38","911","25.8","19.4"
"Bulloch","2020-08-29","41","7268","11","922","26.7","20.6"
"Bulloch","2020-08-30","33","7301","4","926","26.2","19.5"
"Bulloch","2020-08-31","71","7372","21","947","27.8","20.7"
"Bulloch","2020-09-01","105","7477","14","961","24.8","21.2"
"Bulloch","2020-09-02","80","7557","18","979","23.4","22.2"
"Bulloch","2020-09-03","136","7693","17","996","22.3","22.4"
"Bulloch","2020-09-04","79","7772","22","1018","20.7","23.3"
"Bulloch","2020-09-05","39","7811","6","1024","19","22.9"
"Bulloch","2020-09-06","19","7830","4","1028","20.3","23.3"
"Bulloch","2020-09-07","4","7834","0","1028","16.1","21.9"
"Bulloch","2020-09-08","51","7885","12","1040","17.5","21.2"
"Bulloch","2020-09-09","101","7986","13","1053","16.2","19.8"
"Bulloch","2020-09-10","111","8097","11","1064","15.8","19"
"Bulloch","2020-09-11","56","8153","12","1076","14.9","17.8"
"Bulloch","2020-09-12","34","8187","9","1085","16.5","17.8"
"Bulloch","2020-09-13","29","8216","3","1088","14.9","17.6"
"Bulloch","2020-09-14","51","8267","6","1094","16.6","16.4"
"Bulloch","2020-09-15","168","8435","14","1108","14.4","16"
"Bulloch","2020-09-16","47","8482","7","1115","14.7","15.5"
"Bulloch","2020-09-17","116","8598","10","1125","14.6","15.2"
"Bulloch","2020-09-18","54","8652","3","1128","12.3","13.6"
"Bulloch","2020-09-19","31","8683","3","1131","9.9","13.2"
"Bulloch","2020-09-20","17","8700","2","1133","10.1","12.5"
"Bulloch","2020-09-21","50","8750","5","1138","9.8","13.2"
"Bulloch","2020-09-22","85","8835","3","1141","9.1","11.8"
"Bulloch","2020-09-23","62","8897","6","1147","8.4","11.6"
"Bulloch","2020-09-24","113","9010","6","1153","7.9","11.2"
"Bulloch","2020-09-25","47","9057","5","1158","8.7","10.5"
"Bulloch","2020-09-26","29","9086","1","1159","7.8","8.8"
"Bulloch","2020-09-27","14","9100","1","1160","7.1","8.6"
"Bulloch","2020-09-28","41","9141","1","1161","6","7.9"
"Bulloch","2020-09-29","84","9225","5","1166","6.4","7.8"
"Bulloch","2020-09-30","47","9272","4","1170","6.2","7.3"
"Bulloch","2020-10-01","87","9359","2","1172","5.8","6.9"
"Bulloch","2020-10-02","43","9402","6","1178","6.2","7.5"
"Bulloch","2020-10-03","20","9422","3","1181","7.9","7.8"
"Bulloch","2020-10-04","12","9434","1","1182","8.1","7.6"
"Bulloch","2020-10-05","47","9481","4","1186","8.9","7.5"
"Bulloch","2020-10-06","115","9596","4","1190","8.6","7.5"
"Bulloch","2020-10-07","49","9645","5","1195","8.8","7.5"
"Bulloch","2020-10-08","88","9733","4","1199","9.1","7.5"
"Bulloch","2020-10-09","37","9770","2","1201","7.9","7.1"
"Bulloch","2020-10-10","17","9787","0","1201","5.8","6.8"
"Bulloch","2020-10-11","11","9798","1","1202","5.9","7"
"Bulloch","2020-10-12","50","9848","2","1204","5.2","7.1"
"Bulloch","2020-10-13","62","9910","1","1205","5","6.8"
"Bulloch","2020-10-14","43","9953","1","1206","3.9","6.3"
"Bulloch","2020-10-15","64","10017","5","1211","4.3","6.7"
"Bulloch","2020-10-16","32","10049","3","1214","4.9","6.4"
"Bulloch","2020-10-17","29","10078","2","1216","5.9","5.8"
"Bulloch","2020-10-18","11","10089","1","1217","5.9","5.9"
"Bulloch","2020-10-19","43","10132","2","1219","6","5.6"
"Bulloch","2020-10-20","45","10177","2","1221","6.4","5.7"
"Bulloch","2020-10-21","56","10233","8","1229","8.1","6"
"Bulloch","2020-10-22","78","10311","3","1232","7.5","5.9"
"Bulloch","2020-10-23","36","10347","3","1235","7.4","6.1"
"Bulloch","2020-10-24","29","10376","0","1235","6.4","6.1"
"Bulloch","2020-10-25","11","10387","3","1238","9","7.4"
"Bulloch","2020-10-26","39","10426","4","1242","9.8","7.9"
"Bulloch","2020-10-27","45","10471","0","1242","9.1","7.8"
"Bulloch","2020-10-28","54","10525","11","1253","10","9"
"Bulloch","2020-10-29","58","10583","7","1260","11.2","9.3"
"Bulloch","2020-10-30","32","10615","5","1265","12.2","9.8"
"Bulloch","2020-10-31","25","10640","1","1266","12.8","9.6"
"Bulloch","2020-11-01","13","10653","3","1269","12.2","10.6"
"Bulloch","2020-11-02","47","10700","10","1279","13.8","11.8"
"Bulloch","2020-11-03","44","10744","1","1280","14.1","11.6"
"Bulloch","2020-11-04","54","10798","2","1282","11.7","10.9"
"Bulloch","2020-11-05","43","10841","3","1285","11","11.1"
"Bulloch","2020-11-06","55","10896","4","1289","9.8","11"
"Bulloch","2020-11-07","22","10918","2","1291","10.5","11.7"
"Bulloch","2020-11-08","13","10931","2","1293","9.4","10.8"
"Bulloch","2020-11-09","50","10981","4","1297","7.5","10.7"
"Bulloch","2020-11-10","57","11038","5","1302","8.5","11.3"
"Bulloch","2020-11-11","25","11063","1","1303","8.5","10.1"
"Bulloch","2020-11-12","50","11113","9","1312","10.1","10.5"
"Bulloch","2020-11-13","41","11154","6","1318","11.1","10.5"
"Bulloch","2020-11-14","33","11187","3","1321","11.1","10.8"
"Bulloch","2020-11-15","20","11207","2","1323","10.4","9.9"
"Bulloch","2020-11-16","60","11267","6","1329","10.6","9.1"
"Bulloch","2020-11-17","60","11327","1","1330","9.6","9"
"Bulloch","2020-11-18","54","11381","1","1331","9.3","8.9"
"Bulloch","2020-11-19","65","11446","5","1336","7.8","9"
"Bulloch","2020-11-20","63","11509","3","1339","6.4","8.8"
"Bulloch","2020-11-21","47","11556","6","1345","7","9"
"Bulloch","2020-11-22","36","11592","3","1348","6.7","8.5"
"Bulloch","2020-11-23","80","11672","9","1357","6.9","8.8"
"Bulloch","2020-11-24","67","11739","3","1360","7.3","8.5"
"Bulloch","2020-11-25","55","11794","2","1362","7.6","8.4"
"Bulloch","2020-11-26","4","11798","0","1362","6.5","7.2"
"Bulloch","2020-11-27","43","11841","4","1366","7.1","6.8"
"Bulloch","2020-11-28","35","11876","3","1369","6.5","6.7"
"Bulloch","2020-11-29","26","11902","6","1375","8.6","7.7"
"Bulloch","2020-11-30","60","11962","11","1386","9.6","8.3"
"Bulloch","2020-12-01","59","12021","6","1392","10.4","8.9"
"Bulloch","2020-12-02","74","12095","10","1402","11.9","9.7"
"Bulloch","2020-12-03","58","12153","5","1407","13.1","9.8"
"Bulloch","2020-12-04","64","12217","4","1411","12.6","9.9"
"Bulloch","2020-12-05","37","12254","6","1417","13.7","10.1"
"Bulloch","2020-12-06","30","12284","4","1421","12.3","10.5"
"Bulloch","2020-12-07","69","12353","7","1428","11.2","10.4"
"Bulloch","2020-12-08","74","12427","7","1435","11.1","10.8"
"Bulloch","2020-12-09","64","12491","6","1441","10.5","11.2"
"Bulloch","2020-12-10","149","12640","14","1455","10.6","11.8"
"Bulloch","2020-12-11","106","12746","4","1459","10.2","11.4"
"Bulloch","2020-12-12","35","12781","6","1465","10.4","12.1"
"Bulloch","2020-12-13","44","12825","6","1471","10.4","11.4"
"Bulloch","2020-12-14","83","12908","6","1477","10","10.6"
"Bulloch","2020-12-15","105","13013","15","1492","10.7","10.9"
"Bulloch","2020-12-16","100","13113","18","1510","11.9","11.2"
"Bulloch","2020-12-17","63","13176","4","1514","11.5","11"
"Bulloch","2020-12-18","75","13251","5","1519","11.9","11.1"
"Bulloch","2020-12-19","60","13311","8","1527","11.4","10.9"
"Bulloch","2020-12-20","23","13334","4","1531","11.9","11.2"
"Bulloch","2020-12-21","129","13463","23","1554","13.4","11.7"
"Bulloch","2020-12-22","69","13532","5","1559","12.4","11.5"
"Bulloch","2020-12-23","81","13613","14","1573","12.3","12.1"
"Bulloch","2020-12-24","56","13669","6","1579","12.9","12.2"
"Bulloch","2020-12-25","7","13676","0","1579","12","11.9"
"Bulloch","2020-12-26","36","13712","9","1588","13.6","12.5"
"Bulloch","2020-12-27","25","13737","8","1596","15.7","13.8"
"Bulloch","2020-12-28","80","13817","17","1613","16.2","14.8"
"Bulloch","2020-12-29","83","13900","17","1630","18.1","15.3"
"Bulloch","2020-12-30","74","13974","13","1643","18.1","15.2"
"Bulloch","2020-12-31","85","14059","21","1664","20.1","16.5"
"Bulloch","2021-01-01","0","14059","0","1664","20.1","16.1"
"Bulloch","2021-01-02","41","14100","12","1676","20.8","17.2"
"Bulloch","2021-01-03","47","14147","20","1696","22.3","19"
"Bulloch","2021-01-04","106","14253","32","1728","23.5","19.9"
"Bulloch","2021-01-05","138","14391","32","1760","23.9","21"
"Bulloch","2021-01-06","105","14496","27","1787","25.1","21.6"
"Bulloch","2021-01-07","103","14599","36","1823","26.6","23.3"
"Bulloch","2021-01-08","102","14701","28","1851","30.5","25.3"
"Bulloch","2021-01-09","47","14748","23","1874","33.3","27"
"Bulloch","2021-01-10","48","14796","13","1887","31.1","26.7"
"Bulloch","2021-01-11","94","14890","20","1907","29.8","26.7"
"Bulloch","2021-01-12","97","14987","21","1928","29.6","26.8"
"Bulloch","2021-01-13","98","15085","15","1943","28.1","26.6"
"Bulloch","2021-01-14","90","15175","14","1957","25.3","25.9"
"Bulloch","2021-01-15","90","15265","10","1967","23","26.7"
"Bulloch","2021-01-16","48","15313","10","1977","19","26.1"
"Bulloch","2021-01-17","39","15352","3","1980","16.2","23.6"
"Bulloch","2021-01-18","85","15437","17","1997","16","22.9"
"Bulloch","2021-01-19","95","15532","17","2014","15.5","22.5"
"Bulloch","2021-01-20","298","15830","47","2061","15.6","21.8"
"Bulloch","2021-01-21","284","16114","49","2110","15.8","20.6"
"Bulloch","2021-01-22","171","16285","15","2125","15.5","19.2"
"Bulloch","2021-01-23","85","16370","16","2141","15.2","17.1"
"Bulloch","2021-01-24","34","16404","8","2149","17.4","16.8"
"Bulloch","2021-01-25","324","16728","54","2203","17","16.5"
"Bulloch","2021-01-26","229","16957","33","2236","16.5","16"
"Bulloch","2021-01-27","203","17160","26","2262","16","15.8"
"Bulloch","2021-01-28","181","17341","22","2284","15.3","15.6"
"Bulloch","2021-01-29","214","17555","37","2321","16.5","16"
"Bulloch","2021-01-30","29","17584","6","2327","16.8","16"
"Bulloch","2021-01-31","27","17611","6","2333","16.6","17"
"Bulloch","2021-02-01","204","17815","44","2377","17.3","17.1"
"Bulloch","2021-02-02","207","18022","24","2401","16.9","16.7"
"Bulloch","2021-02-03","194","18216","26","2427","17","16.5"
"Bulloch","2021-02-04","164","18380","21","2448","17.1","16.2"
"Bulloch","2021-02-05","141","18521","15","2463","16.1","16.3"
"Bulloch","2021-02-06","24","18545","2","2465","14.4","15.6"
"Bulloch","2021-02-07","0","18545","0","2465","11.2","13.9"
"Bulloch","2021-02-08","0","18545","0","2465","8.1","12.7"
"Burke","2020-02-01","0","0","0","0",".","."
"Burke","2020-02-02","0","0","0","0",".","."
"Burke","2020-02-03","0","0","0","0",".","."
"Burke","2020-02-04","0","0","0","0",".","."
"Burke","2020-02-05","0","0","0","0",".","."
"Burke","2020-02-06","0","0","0","0",".","."
"Burke","2020-02-07","0","0","0","0","0","."
"Burke","2020-02-08","0","0","0","0","0","."
"Burke","2020-02-09","0","0","0","0","0","."
"Burke","2020-02-10","0","0","0","0","0","."
"Burke","2020-02-11","0","0","0","0","0","."
"Burke","2020-02-12","0","0","0","0","0","."
"Burke","2020-02-13","0","0","0","0","0","."
"Burke","2020-02-14","0","0","0","0","0","0"
"Burke","2020-02-15","0","0","0","0","0","0"
"Burke","2020-02-16","0","0","0","0","0","0"
"Burke","2020-02-17","0","0","0","0","0","0"
"Burke","2020-02-18","0","0","0","0","0","0"
"Burke","2020-02-19","0","0","0","0","0","0"
"Burke","2020-02-20","0","0","0","0","0","0"
"Burke","2020-02-21","0","0","0","0","0","0"
"Burke","2020-02-22","0","0","0","0","0","0"
"Burke","2020-02-23","0","0","0","0","0","0"
"Burke","2020-02-24","0","0","0","0","0","0"
"Burke","2020-02-25","0","0","0","0","0","0"
"Burke","2020-02-26","0","0","0","0","0","0"
"Burke","2020-02-27","0","0","0","0","0","0"
"Burke","2020-02-28","0","0","0","0","0","0"
"Burke","2020-02-29","0","0","0","0","0","0"
"Burke","2020-03-01","0","0","0","0","0","0"
"Burke","2020-03-02","0","0","0","0","0","0"
"Burke","2020-03-03","0","0","0","0","0","0"
"Burke","2020-03-04","0","0","0","0","0","0"
"Burke","2020-03-05","0","0","0","0","0","0"
"Burke","2020-03-06","0","0","0","0","0","0"
"Burke","2020-03-07","0","0","0","0","0","0"
"Burke","2020-03-08","0","0","0","0","0","0"
"Burke","2020-03-09","0","0","0","0","0","0"
"Burke","2020-03-10","0","0","0","0","0","0"
"Burke","2020-03-11","0","0","0","0","0","0"
"Burke","2020-03-12","0","0","0","0","0","0"
"Burke","2020-03-13","0","0","0","0","0","0"
"Burke","2020-03-14","0","0","0","0","0","0"
"Burke","2020-03-15","0","0","0","0","0","0"
"Burke","2020-03-16","4","4","0","0","0","0"
"Burke","2020-03-17","2","6","0","0","0","0"
"Burke","2020-03-18","0","6","0","0","0","0"
"Burke","2020-03-19","2","8","0","0","0","0"
"Burke","2020-03-20","2","10","0","0","0","0"
"Burke","2020-03-21","0","10","0","0","0","0"
"Burke","2020-03-22","0","10","0","0","0","0"
"Burke","2020-03-23","2","12","1","1","7.1","3.6"
"Burke","2020-03-24","0","12","0","1","7.1","3.6"
"Burke","2020-03-25","0","12","0","1","7.1","3.6"
"Burke","2020-03-26","0","12","0","1","7.1","3.6"
"Burke","2020-03-27","2","14","1","2","14.3","7.1"
"Burke","2020-03-28","1","15","1","3","28.6","14.3"
"Burke","2020-03-29","0","15","0","3","28.6","14.3"
"Burke","2020-03-30","3","18","0","3","21.4","14.3"
"Burke","2020-03-31","3","21","1","4","26.2","16.7"
"Burke","2020-04-01","8","29","1","5","28","17.6"
"Burke","2020-04-02","7","36","1","6","30","18.6"
"Burke","2020-04-03","10","46","2","8","25.7","20"
"Burke","2020-04-04","5","51","1","9","14.3","21.4"
"Burke","2020-04-05","5","56","0","9","14.3","21.4"
"Burke","2020-04-06","2","58","1","10","21.4","21.4"
"Burke","2020-04-07","8","66","1","11","18.5","22.3"
"Burke","2020-04-08","4","70","0","11","16.7","22.3"
"Burke","2020-04-09","10","80","0","11","14.6","22.3"
"Burke","2020-04-10","5","85","1","12","14.6","20.2"
"Burke","2020-04-11","9","94","2","14","15","14.6"
"Burke","2020-04-12","4","98","2","16","22.1","18.2"
"Burke","2020-04-13","6","104","1","17","17.3","19.4"
"Burke","2020-04-14","7","111","0","17","15.6","17"
"Burke","2020-04-15","5","116","1","18","18.4","17.5"
"Burke","2020-04-16","5","121","1","19","21.3","18"
"Burke","2020-04-17","17","138","2","21","20.1","17.4"
"Burke","2020-04-18","21","159","10","31","23.7","19.3"
"Burke","2020-04-19","7","166","2","33","20.7","21.4"
"Burke","2020-04-20","6","172","2","35","23","20.2"
"Burke","2020-04-21","13","185","2","37","25.2","20.4"
"Burke","2020-04-22","9","194","2","39","25.6","22"
"Burke","2020-04-23","23","217","6","45","26.4","23.8"
"Burke","2020-04-24","17","234","2","47","26.4","23.3"
"Burke","2020-04-25","5","239","0","47","19.6","21.7"
"Burke","2020-04-26","1","240","0","47","15.5","18.1"
"Burke","2020-04-27","13","253","0","47","10.8","16.9"
"Burke","2020-04-28","9","262","2","49","11.8","18.5"
"Burke","2020-04-29","8","270","1","50","10.4","18"
"Burke","2020-04-30","20","290","3","53","8.8","17.6"
"Burke","2020-05-01","15","305","1","54","8.1","17.2"
"Burke","2020-05-02","7","312","0","54","8.1","13.8"
"Burke","2020-05-03","13","325","0","54","8.1","11.8"
"Burke","2020-05-04","15","340","1","55","9","9.9"
"Burke","2020-05-05","11","351","3","58","9.7","10.7"
"Burke","2020-05-06","9","360","0","58","7.9","9.2"
"Burke","2020-05-07","12","372","3","61","9.4","9.1"
"Burke","2020-05-08","12","384","1","62","9.6","8.8"
"Burke","2020-05-09","9","393","0","62","9.6","8.8"
"Burke","2020-05-10","1","394","0","62","9.6","8.8"
"Burke","2020-05-11","10","404","0","62","8.7","8.8"
"Burke","2020-05-12","12","416","0","62","4.8","7.2"
"Burke","2020-05-13","12","428","2","64","7.1","7.5"
"Burke","2020-05-14","7","435","0","64","3.6","6.5"
"Burke","2020-05-15","13","448","1","65","3.5","6.5"
"Burke","2020-05-16","2","450","0","65","3.5","6.5"
"Burke","2020-05-17","10","460","3","68","7.8","8.7"
"Burke","2020-05-18","9","469","2","70","10.9","9.8"
"Burke","2020-05-19","29","498","1","71","11.4","8.1"
"Burke","2020-05-20","11","509","0","71","9.1","8.1"
"Burke","2020-05-21","20","529","0","71","9.1","6.3"
"Burke","2020-05-22","12","541","2","73","10.3","6.9"
"Burke","2020-05-23","5","546","0","73","10.3","6.9"
"Burke","2020-05-24","11","557","0","73","6","6.9"
"Burke","2020-05-25","3","560","0","73","2.9","6.9"
"Burke","2020-05-26","16","576","1","74","3.3","7.4"
"Burke","2020-05-27","8","584","0","74","3.3","6.2"
"Burke","2020-05-28","6","590","0","74","3.3","6.2"
"Burke","2020-05-29","7","597","0","74","0.9","5.6"
"Burke","2020-05-30","4","601","0","74","0.9","5.6"
"Burke","2020-05-31","5","606","0","74","0.9","3.5"
"Burke","2020-06-01","19","625","2","76","2.4","2.6"
"Burke","2020-06-02","23","648","0","76","1.5","2.4"
"Burke","2020-06-03","12","660","0","76","1.5","2.4"
"Burke","2020-06-04","13","673","0","76","1.5","2.4"
"Burke","2020-06-05","0","673","0","76","1.5","1.2"
"Burke","2020-06-06","0","673","0","76","1.5","1.2"
"Burke","2020-06-07","4","677","0","76","1.5","1.2"
"Burke","2020-06-08","4","681","0","76","0","1.2"
"Burke","2020-06-09","4","685","0","76","0","0.8"
"Burke","2020-06-10","10","695","0","76","0","0.8"
"Burke","2020-06-11","11","706","0","76","0","0.8"
"Burke","2020-06-12","25","731","1","77","0.6","1"
"Burke","2020-06-13","6","737","0","77","0.6","1"
"Burke","2020-06-14","4","741","0","77","0.6","1"
"Burke","2020-06-15","20","761","2","79","2","1"
"Burke","2020-06-16","14","775","2","81","4","2"
"Burke","2020-06-17","6","781","1","82","6.4","3.2"
"Burke","2020-06-18","16","797","0","82","6.4","3.2"
"Burke","2020-06-19","19","816","1","83","6.6","3.6"
"Burke","2020-06-20","14","830","0","83","6.6","3.6"
"Burke","2020-06-21","7","837","0","83","6.6","3.6"
"Burke","2020-06-22","50","887","2","85","5.7","3.9"
"Burke","2020-06-23","26","913","4","89","5.9","5"
"Burke","2020-06-24","29","942","3","92","5","5.7"
"Burke","2020-06-25","32","974","7","99","8.1","7.3"
"Burke","2020-06-26","28","1002","7","106","10.9","8.8"
"Burke","2020-06-27","18","1020","1","107","11.7","9.2"
"Burke","2020-06-28","5","1025","0","107","11.7","9.2"
"Burke","2020-06-29","40","1065","8","115","14","9.9"
"Burke","2020-06-30","50","1115","13","128","15.5","10.7"
"Burke","2020-07-01","33","1148","7","135","17.1","11"
"Burke","2020-07-02","49","1197","4","139","15.1","11.6"
"Burke","2020-07-03","24","1221","9","148","16.9","13.9"
"Burke","2020-07-04","8","1229","0","148","16.1","13.9"
"Burke","2020-07-05","17","1246","1","149","17","14.4"
"Burke","2020-07-06","49","1295","11","160","17.3","15.7"
"Burke","2020-07-07","55","1350","14","174","17.2","16.4"
"Burke","2020-07-08","65","1415","10","184","16.4","16.7"
"Burke","2020-07-09","63","1478","19","203","19.5","17.3"
"Burke","2020-07-10","65","1543","10","213","16.4","16.7"
"Burke","2020-07-11","27","1570","4","217","18.5","17.3"
"Burke","2020-07-12","39","1609","12","229","22.1","19.5"
"Burke","2020-07-13","77","1686","25","254","23.5","20.4"
"Burke","2020-07-14","103","1789","26","280","23.5","20.3"
"Burke","2020-07-15","49","1838","7","287","23.3","19.9"
"Burke","2020-07-16","49","1887","16","303","23.7","21.6"
"Burke","2020-07-17","41","1928","7","310","23.9","20.1"
"Burke","2020-07-18","44","1972","11","321","25.4","21.9"
"Burke","2020-07-19","38","2010","10","331","24.7","23.4"
"Burke","2020-07-20","84","2094","28","359","24.8","24.2"
"Burke","2020-07-21","75","2169","12","371","23.5","23.5"
"Burke","2020-07-22","70","2239","29","400","27.4","25.4"
"Burke","2020-07-23","90","2329","22","422","26.2","24.9"
"Burke","2020-07-24","24","2353","4","426","26.2","25"
"Burke","2020-07-25","29","2382","10","436","27.5","26.4"
"Burke","2020-07-26","25","2407","5","441","26.6","25.7"
"Burke","2020-07-27","38","2445","5","446","23.7","24.3"
"Burke","2020-07-28","45","2490","6","452","23.4","23.4"
"Burke","2020-07-29","40","2530","6","458","19.6","23.5"
"Burke","2020-07-30","34","2564","4","462","17.8","22"
"Burke","2020-07-31","28","2592","5","467","17.9","22.1"
"Burke","2020-08-01","15","2607","4","471","16.8","22.2"
"Burke","2020-08-02","28","2635","4","475","16","21.3"
"Burke","2020-08-03","34","2669","8","483","17.5","20.6"
"Burke","2020-08-04","43","2712","6","489","17.6","20.5"
"Burke","2020-08-05","30","2742","12","501","21.2","20.4"
"Burke","2020-08-06","32","2774","5","506","21.7","19.7"
"Burke","2020-08-07","26","2800","4","510","21.3","19.6"
"Burke","2020-08-08","23","2823","9","519","23.1","20"
"Burke","2020-08-09","25","2848","6","525","24.5","20.3"
"Burke","2020-08-10","32","2880","5","530","23.4","20.4"
"Burke","2020-08-11","29","2909","5","535","23.9","20.7"
"Burke","2020-08-12","34","2943","11","546","22.8","22"
"Burke","2020-08-13","30","2973","7","553","23.9","22.8"
"Burke","2020-08-14","37","3010","6","559","24","22.7"
"Burke","2020-08-15","39","3049","7","566","21","22"
"Burke","2020-08-16","19","3068","4","570","20.5","22.5"
"Burke","2020-08-17","38","3106","7","577","20.9","22.2"
"Burke","2020-08-18","38","3144","7","584","21.1","22.5"
"Burke","2020-08-19","40","3184","2","586","17.2","20"
"Burke","2020-08-20","26","3210","6","592","17.2","20.5"
"Burke","2020-08-21","21","3231","1","593","15.5","19.8"
"Burke","2020-08-22","14","3245","3","596","16","18.5"
"Burke","2020-08-23","17","3262","1","597","13.9","17.2"
"Burke","2020-08-24","20","3282","4","601","14.1","17.5"
"Burke","2020-08-25","25","3307","3","604","13.2","17.1"
"Burke","2020-08-26","57","3364","5","609","13.7","15.5"
"Burke","2020-08-27","60","3424","7","616","12.1","14.6"
"Burke","2020-08-28","61","3485","8","624","13.3","14.4"
"Burke","2020-08-29","36","3521","2","626","11","13.5"
"Burke","2020-08-30","15","3536","2","628","12.1","13"
"Burke","2020-08-31","72","3608","12","640","11.6","12.8"
"Burke","2020-09-01","101","3709","14","654","11.9","12.5"
"Burke","2020-09-02","62","3771","8","662","12.4","13.1"
"Burke","2020-09-03","60","3831","9","671","12.9","12.5"
"Burke","2020-09-04","38","3869","4","675","12.5","12.9"
"Burke","2020-09-05","24","3893","2","677","12.9","12"
"Burke","2020-09-06","11","3904","3","680","14.9","13.5"
"Burke","2020-09-07","20","3924","3","683","14.7","13.1"
"Burke","2020-09-08","93","4017","11","694","14.4","13.1"
"Burke","2020-09-09","82","4099","11","705","14.5","13.5"
"Burke","2020-09-10","81","4180","8","713","13.8","13.3"
"Burke","2020-09-11","43","4223","6","719","14.2","13.4"
"Burke","2020-09-12","25","4248","7","726","17","15"
"Burke","2020-09-13","14","4262","2","728","15.2","15.1"
"Burke","2020-09-14","74","4336","13","741","15.6","15.1"
"Burke","2020-09-15","112","4448","15","756","15.8","15.1"
"Burke","2020-09-16","107","4555","4","760","14.4","14.4"
"Burke","2020-09-17","26","4581","3","763","14.6","14.2"
"Burke","2020-09-18","48","4629","5","768","14.1","14.2"
"Burke","2020-09-19","31","4660","3","771","11.5","14.3"
"Burke","2020-09-20","12","4672","2","773","11.9","13.5"
"Burke","2020-09-21","57","4729","13","786","12.6","14.1"
"Burke","2020-09-22","103","4832","11","797","12.2","14"
"Burke","2020-09-23","67","4899","9","806","13.6","14"
"Burke","2020-09-24","60","4959","6","812","13.4","14"
"Burke","2020-09-25","35","4994","4","816","13.5","13.8"
"Burke","2020-09-26","22","5016","2","818","13.4","12.5"
"Burke","2020-09-27","8","5024","1","819","12.8","12.4"
"Burke","2020-09-28","50","5074","4","823","10.7","11.7"
"Burke","2020-09-29","78","5152","12","835","11.4","11.8"
"Burke","2020-09-30","42","5194","9","844","12.5","13.1"
"Burke","2020-10-01","48","5242","3","847","12","12.7"
"Burke","2020-10-02","50","5292","4","851","11.5","12.5"
"Burke","2020-10-03","44","5336","3","854","11.2","12.3"
"Burke","2020-10-04","12","5348","0","854","9.4","11.1"
"Burke","2020-10-05","66","5414","5","859","9.4","10"
"Burke","2020-10-06","96","5510","9","868","8.5","9.9"
"Burke","2020-10-07","77","5587","3","871","6","9.3"
"Burke","2020-10-08","98","5685","6","877","6","9"
"Burke","2020-10-09","45","5730","3","880","5.8","8.7"
"Burke","2020-10-10","35","5765","5","885","6.8","9"
"Burke","2020-10-11","21","5786","4","889","9.6","9.5"
"Burke","2020-10-12","68","5854","9","898","10.4","9.9"
"Burke","2020-10-13","75","5929","12","910","11.3","9.9"
"Burke","2020-10-14","40","5969","5","915","12.6","9.3"
"Burke","2020-10-15","37","6006","5","920","13.6","9.8"
"Burke","2020-10-16","42","6048","3","923","13.7","9.7"
"Burke","2020-10-17","36","6084","7","930","14.4","10.6"
"Burke","2020-10-18","4","6088","0","930","11.7","10.6"
"Burke","2020-10-19","67","6155","14","944","12.8","11.6"
"Burke","2020-10-20","58","6213","4","948","11.5","11.4"
"Burke","2020-10-21","69","6282","22","970","14.3","13.4"
"Burke","2020-10-22","54","6336","7","977","14.2","13.9"
"Burke","2020-10-23","37","6373","2","979","13.9","13.8"
"Burke","2020-10-24","20","6393","2","981","12.6","13.5"
"Burke","2020-10-25","11","6404","0","981","12.6","12.1"
"Burke","2020-10-26","58","6462","16","997","13.5","13.2"
"Burke","2020-10-27","68","6530","10","1007","14.6","13.1"
"Burke","2020-10-28","45","6575","5","1012","11.7","13"
"Burke","2020-10-29","48","6623","14","1026","14","14.1"
"Burke","2020-10-30","48","6671","6","1032","15","14.5"
"Burke","2020-10-31","39","6710","6","1038","15.8","14.2"
"Burke","2020-11-01","10","6720","0","1038","15.8","14.2"
"Burke","2020-11-02","65","6785","14","1052","14.9","14.2"
"Burke","2020-11-03","70","6855","8","1060","14.4","14.5"
"Burke","2020-11-04","54","6909","8","1068","15","13.3"
"Burke","2020-11-05","61","6970","15","1083","14.3","14.2"
"Burke","2020-11-06","54","7024","9","1092","14.9","15"
"Burke","2020-11-07","33","7057","8","1100","16.2","16"
"Burke","2020-11-08","4","7061","1","1101","19.8","17.8"
"Burke","2020-11-09","76","7137","29","1130","22.1","18.5"
"Burke","2020-11-10","107","7244","35","1165","25.2","19.8"
"Burke","2020-11-11","68","7312","19","1184","27","21"
"Burke","2020-11-12","92","7404","19","1203","26.5","20.4"
"Burke","2020-11-13","89","7493","16","1219","26.7","20.8"
"Burke","2020-11-14","44","7537","18","1237","29","22.6"
"Burke","2020-11-15","12","7549","1","1238","26.7","23.2"
"Burke","2020-11-16","107","7656","34","1272","25.8","23.9"
"Burke","2020-11-17","133","7789","16","1288","22.8","24"
"Burke","2020-11-18","71","7860","12","1300","21.2","24.1"
"Burke","2020-11-19","69","7929","14","1314","21.2","23.8"
"Burke","2020-11-20","42","7971","6","1320","20.6","23.7"
"Burke","2020-11-21","60","8031","9","1329","16.9","23"
"Burke","2020-11-22","8","8039","0","1329","15.8","21.2"
"Burke","2020-11-23","98","8137","22","1351","14.4","20.1"
"Burke","2020-11-24","106","8243","19","1370","15.3","19"
"Burke","2020-11-25","35","8278","8","1378","16.1","18.7"
"Burke","2020-11-26","10","8288","3","1381","17.5","19.3"
"Burke","2020-11-27","19","8307","4","1385","18.5","19.6"
"Burke","2020-11-28","29","8336","6","1391","19.3","18.1"
"Burke","2020-11-29","12","8348","0","1391","19.3","17.5"
"Burke","2020-11-30","97","8445","23","1414","19.5","16.9"
"Burke","2020-12-01","94","8539","14","1428","19","17.1"
"Burke","2020-12-02","53","8592","12","1440","19","17.6"
"Burke","2020-12-03","71","8663","24","1464","19.5","18.5"
"Burke","2020-12-04","53","8716","11","1475","19.5","19"
"Burke","2020-12-05","41","8757","11","1486","20.4","19.8"
"Burke","2020-12-06","8","8765","0","1486","20.4","19.8"
"Burke","2020-12-07","105","8870","12","1498","18.6","19"
"Burke","2020-12-08","83","8953","13","1511","18.7","18.9"
"Burke","2020-12-09","60","9013","6","1517","16.9","18"
"Burke","2020-12-10","72","9085","14","1531","14.9","17.2"
"Burke","2020-12-11","72","9157","18","1549","15.5","17.5"
"Burke","2020-12-12","74","9231","11","1560","13.8","17.1"
"Burke","2020-12-13","13","9244","3","1563","17.1","18.7"
"Burke","2020-12-14","113","9357","18","1581","17.7","18.2"
"Burke","2020-12-15","103","9460","30","1611","19.6","19.2"
"Burke","2020-12-16","73","9533","24","1635","22.9","19.9"
"Burke","2020-12-17","74","9607","15","1650","23","18.9"
"Burke","2020-12-18","65","9672","17","1667","23.2","19.3"
"Burke","2020-12-19","43","9715","11","1678","24.7","19.2"
"Burke","2020-12-20","12","9727","4","1682","26.2","21.6"
"Burke","2020-12-21","142","9869","31","1713","27","22.4"
"Burke","2020-12-22","119","9988","25","1738","25.9","22.7"
"Burke","2020-12-23","73","10061","17","1755","24.5","23.7"
"Burke","2020-12-24","15","10076","3","1758","24.5","23.7"
"Burke","2020-12-25","4","10080","3","1761","31.4","27.3"
"Burke","2020-12-26","20","10100","3","1764","29.9","27.3"
"Burke","2020-12-27","22","10122","5","1769","28.4","27.3"
"Burke","2020-12-28","86","10208","38","1807","31.6","29.3"
"Burke","2020-12-29","103","10311","31","1838","32.9","29.4"
"Burke","2020-12-30","101","10412","28","1866","33.5","29"
"Burke","2020-12-31","55","10467","19","1885","35.6","30"
"Burke","2021-01-01","4","10471","2","1887","32","31.7"
"Burke","2021-01-02","22","10493","8","1895","35.1","32.5"
"Burke","2021-01-03","12","10505","1","1896","33","30.7"
"Burke","2021-01-04","51","10556","19","1915","32","31.8"
"Burke","2021-01-05","116","10672","37","1952","32.3","32.6"
"Burke","2021-01-06","118","10790","28","1980","31.7","32.6"
"Burke","2021-01-07","82","10872","26","2006","31.3","33.5"
"Burke","2021-01-08","99","10971","34","2040","29.1","30.6"
"Burke","2021-01-09","56","11027","24","2064","30","32.6"
"Burke","2021-01-10","21","11048","4","2068","31.5","32.3"
"Burke","2021-01-11","143","11191","37","2105","29.9","31"
"Burke","2021-01-12","122","11313","25","2130","28.3","30.3"
"Burke","2021-01-13","108","11421","20","2150","27.5","29.6"
"Burke","2021-01-14","79","11500","15","2165","25.7","28.5"
"Burke","2021-01-15","95","11595","16","2181","23.2","26.2"
"Burke","2021-01-16","67","11662","19","2200","21.2","25.6"
"Burke","2021-01-17","21","11683","2","2202","19.8","25.7"
"Burke","2021-01-18","80","11763","20","2222","19.7","24.8"
"Burke","2021-01-19","113","11876","30","2252","20.5","24.4"
"Burke","2021-01-20","91","11967","14","2266","20.1","23.8"
"Burke","2021-01-21","80","12047","10","2276","19.2","22.4"
"Burke","2021-01-22","90","12137","19","2295","19.8","21.5"
"Burke","2021-01-23","39","12176","9","2304","19","20.1"
"Burke","2021-01-24","24","12200","6","2310","21.2","20.5"
"Burke","2021-01-25","102","12302","20","2330","20.5","20.1"
"Burke","2021-01-26","97","12399","19","2349","19.5","20"
"Burke","2021-01-27","67","12466","16","2365","20.7","20.4"
"Burke","2021-01-28","77","12543","15","2380","21.7","20.4"
"Burke","2021-01-29","61","12604","15","2395","22.2","21"
"Burke","2021-01-30","41","12645","9","2404","22","20.5"
"Burke","2021-01-31","27","12672","6","2410","21.6","21.4"
"Burke","2021-02-01","84","12756","20","2430","22.2","21.3"
"Burke","2021-02-02","69","12825","15","2445","22.5","21"
"Burke","2021-02-03","60","12885","6","2451","20.5","20.6"
"Burke","2021-02-04","59","12944","9","2460","19.9","20.8"
"Burke","2021-02-05","57","13001","4","2464","17.4","19.8"
"Burke","2021-02-06","26","13027","2","2466","15.4","18.7"
"Burke","2021-02-07","0","13027","0","2466","12.2","16.9"
"Burke","2021-02-08","0","13027","0","2466","8.8","15.5"
"Butts","2020-02-01","0","0","0","0",".","."
"Butts","2020-02-02","0","0","0","0",".","."
"Butts","2020-02-03","0","0","0","0",".","."
"Butts","2020-02-04","0","0","0","0",".","."
"Butts","2020-02-05","0","0","0","0",".","."
"Butts","2020-02-06","0","0","0","0",".","."
"Butts","2020-02-07","0","0","0","0","0","."
"Butts","2020-02-08","0","0","0","0","0","."
"Butts","2020-02-09","0","0","0","0","0","."
"Butts","2020-02-10","0","0","0","0","0","."
"Butts","2020-02-11","0","0","0","0","0","."
"Butts","2020-02-12","0","0","0","0","0","."
"Butts","2020-02-13","0","0","0","0","0","."
"Butts","2020-02-14","0","0","0","0","0","0"
"Butts","2020-02-15","0","0","0","0","0","0"
"Butts","2020-02-16","0","0","0","0","0","0"
"Butts","2020-02-17","0","0","0","0","0","0"
"Butts","2020-02-18","0","0","0","0","0","0"
"Butts","2020-02-19","0","0","0","0","0","0"
"Butts","2020-02-20","0","0","0","0","0","0"
"Butts","2020-02-21","0","0","0","0","0","0"
"Butts","2020-02-22","0","0","0","0","0","0"
"Butts","2020-02-23","0","0","0","0","0","0"
"Butts","2020-02-24","0","0","0","0","0","0"
"Butts","2020-02-25","0","0","0","0","0","0"
"Butts","2020-02-26","0","0","0","0","0","0"
"Butts","2020-02-27","0","0","0","0","0","0"
"Butts","2020-02-28","0","0","0","0","0","0"
"Butts","2020-02-29","0","0","0","0","0","0"
"Butts","2020-03-01","0","0","0","0","0","0"
"Butts","2020-03-02","0","0","0","0","0","0"
"Butts","2020-03-03","0","0","0","0","0","0"
"Butts","2020-03-04","0","0","0","0","0","0"
"Butts","2020-03-05","0","0","0","0","0","0"
"Butts","2020-03-06","0","0","0","0","0","0"
"Butts","2020-03-07","0","0","0","0","0","0"
"Butts","2020-03-08","0","0","0","0","0","0"
"Butts","2020-03-09","0","0","0","0","0","0"
"Butts","2020-03-10","0","0","0","0","0","0"
"Butts","2020-03-11","0","0","0","0","0","0"
"Butts","2020-03-12","0","0","0","0","0","0"
"Butts","2020-03-13","0","0","0","0","0","0"
"Butts","2020-03-14","1","1","0","0","0","0"
"Butts","2020-03-15","1","2","0","0","0","0"
"Butts","2020-03-16","3","5","0","0","0","0"
"Butts","2020-03-17","3","8","1","1","4.8","2.4"
"Butts","2020-03-18","2","10","0","1","4.8","2.4"
"Butts","2020-03-19","4","14","1","2","8.3","4.2"
"Butts","2020-03-20","5","19","3","5","16.9","8.5"
"Butts","2020-03-21","1","20","0","5","16.9","8.5"
"Butts","2020-03-22","0","20","0","5","16.9","8.5"
"Butts","2020-03-23","8","28","0","5","16.9","8.5"
"Butts","2020-03-24","7","35","3","8","18.3","11.5"
"Butts","2020-03-25","11","46","2","10","20.9","12.8"
"Butts","2020-03-26","13","59","4","14","21.7","15"
"Butts","2020-03-27","3","62","1","15","17.9","17.4"
"Butts","2020-03-28","2","64","1","16","25","21"
"Butts","2020-03-29","3","67","0","16","25","21"
"Butts","2020-03-30","10","77","0","16","25","21"
"Butts","2020-03-31","13","90","1","17","20","19.1"
"Butts","2020-04-01","8","98","1","18","19.2","20"
"Butts","2020-04-02","11","109","0","18","14.8","18.2"
"Butts","2020-04-03","6","115","3","21","17.2","17.5"
"Butts","2020-04-04","4","119","1","22","13.6","19.3"
"Butts","2020-04-05","2","121","0","22","13.6","19.3"
"Butts","2020-04-06","8","129","4","26","20.7","22.9"
"Butts","2020-04-07","7","136","0","26","19.6","19.8"
"Butts","2020-04-08","15","151","3","29","20.7","19.9"
"Butts","2020-04-09","13","164","5","34","26.2","20.5"
"Butts","2020-04-10","4","168","1","35","22.6","19.9"
"Butts","2020-04-11","4","172","2","37","26.2","19.9"
"Butts","2020-04-12","0","172","0","37","26.2","19.9"
"Butts","2020-04-13","10","182","3","40","23.4","22"
"Butts","2020-04-14","16","198","6","46","28.7","24.2"
"Butts","2020-04-15","14","212","0","46","25.9","23.3"
"Butts","2020-04-16","32","244","19","65","28.8","27.5"
"Butts","2020-04-17","19","263","10","75","32.8","27.7"
"Butts","2020-04-18","8","271","3","78","31","28.6"
"Butts","2020-04-19","4","275","1","79","34.6","30.4"
"Butts","2020-04-20","74","349","46","125","39.2","31.3"
"Butts","2020-04-21","22","371","4","129","36.4","32.6"
"Butts","2020-04-22","10","381","2","131","39.3","32.6"
"Butts","2020-04-23","8","389","0","131","30.8","29.8"
"Butts","2020-04-24","8","397","0","131","23.3","28"
"Butts","2020-04-25","9","406","1","132","19.5","25.2"
"Butts","2020-04-26","5","411","0","132","15.9","25.2"
"Butts","2020-04-27","16","427","3","135","9.7","24.4"
"Butts","2020-04-28","17","444","3","138","9.6","23"
"Butts","2020-04-29","24","468","8","146","11.5","25.4"
"Butts","2020-04-30","16","484","7","153","17.8","24.3"
"Butts","2020-05-01","21","505","6","159","21.9","22.6"
"Butts","2020-05-02","1","506","1","160","34.6","27"
"Butts","2020-05-03","4","510","1","161","38.2","27"
"Butts","2020-05-04","18","528","4","165","38.6","24.2"
"Butts","2020-05-05","24","552","7","172","40.3","25"
"Butts","2020-05-06","12","564","3","175","39.1","25.3"
"Butts","2020-05-07","16","580","3","178","35.5","26.7"
"Butts","2020-05-08","12","592","2","180","33.8","27.9"
"Butts","2020-05-09","4","596","0","180","19.5","27.1"
"Butts","2020-05-10","5","601","1","181","18.8","28.5"
"Butts","2020-05-11","22","623","1","182","16.3","27.5"
"Butts","2020-05-12","24","647","6","188","15.7","28"
"Butts","2020-05-13","14","661","5","193","17.2","28.2"
"Butts","2020-05-14","27","688","1","194","15.1","25.3"
"Butts","2020-05-15","16","704","0","194","12.7","23.3"
"Butts","2020-05-16","6","710","1","195","15.1","17.3"
"Butts","2020-05-17","12","722","3","198","15.8","17.3"
"Butts","2020-05-18","73","795","4","202","15.9","16.1"
"Butts","2020-05-19","195","990","3","205","12.6","14.1"
"Butts","2020-05-20","380","1370","5","210","7.7","12.5"
"Butts","2020-05-21","40","1410","1","211","7.5","11.3"
"Butts","2020-05-22","374","1784","8","219","7.8","10.3"
"Butts","2020-05-23","6","1790","0","219","5.4","10.3"
"Butts","2020-05-24","6","1796","0","219","1.9","8.8"
"Butts","2020-05-25","2","1798","0","219","1.1","8.5"
"Butts","2020-05-26","230","2028","5","224","1.2","6.9"
"Butts","2020-05-27","24","2052","3","227","2.8","5.2"
"Butts","2020-05-28","17","2069","2","229","4.1","5.8"
"Butts","2020-05-29","17","2086","2","231","5.5","6.6"
"Butts","2020-05-30","3","2089","0","231","5.5","5.4"
"Butts","2020-05-31","9","2098","0","231","5.5","3.7"
"Butts","2020-06-01","15","2113","1","232","6.4","3.7"
"Butts","2020-06-02","32","2145","4","236","7.9","4.5"
"Butts","2020-06-03","31","2176","3","239","7.5","5.1"
"Butts","2020-06-04","199","2375","7","246","6.3","5.2"
"Butts","2020-06-05","19","2394","1","247","5.4","5.4"
"Butts","2020-06-06","8","2402","2","249","8.9","7.2"
"Butts","2020-06-07","81","2483","2","251","9.3","7.4"
"Butts","2020-06-08","23","2506","2","253","9.6","8"
"Butts","2020-06-09","24","2530","3","256","9.6","8.7"
"Butts","2020-06-10","15","2545","2","258","10.1","8.8"
"Butts","2020-06-11","24","2569","1","259","10.2","8.3"
"Butts","2020-06-12","17","2586","0","259","9.5","7.4"
"Butts","2020-06-13","6","2592","0","259","5.9","7.4"
"Butts","2020-06-14","16","2608","1","260","6.4","7.9"
"Butts","2020-06-15","21","2629","1","261","5.9","7.7"
"Butts","2020-06-16","31","2660","4","265","5.9","7.8"
"Butts","2020-06-17","49","2709","10","275","6.9","8.5"
"Butts","2020-06-18","29","2738","5","280","8.8","9.5"
"Butts","2020-06-19","23","2761","1","281","9.4","9.4"
"Butts","2020-06-20","10","2771","1","282","10.8","8.4"
"Butts","2020-06-21","4","2775","0","282","10","8.2"
"Butts","2020-06-22","26","2801","0","282","9.3","7.6"
"Butts","2020-06-23","255","3056","15","297","8.3","7.1"
"Butts","2020-06-24","39","3095","4","301","6.8","6.9"
"Butts","2020-06-25","30","3125","3","304","5.8","7.3"
"Butts","2020-06-26","27","3152","5","309","7.8","8.6"
"Butts","2020-06-27","16","3168","2","311","8.2","9.5"
"Butts","2020-06-28","6","3174","1","312","10.5","10.2"
"Butts","2020-06-29","190","3364","11","323","11.4","10.3"
"Butts","2020-06-30","202","3566","9","332","11.2","9.7"
"Butts","2020-07-01","164","3730","7","339","10.3","8.6"
"Butts","2020-07-02","278","4008","20","359","9.9","7.8"
"Butts","2020-07-03","17","4025","5","364","11.5","9.6"
"Butts","2020-07-04","8","4033","1","365","11.5","9.8"
"Butts","2020-07-05","14","4047","2","367","11.1","10.8"
"Butts","2020-07-06","34","4081","7","374","13.2","12.3"
"Butts","2020-07-07","25","4106","2","376","13.7","12.5"
"Butts","2020-07-08","42","4148","6","382","15.2","12.7"
"Butts","2020-07-09","139","4287","9","391","15.1","12.5"
"Butts","2020-07-10","29","4316","3","394","12.4","11.9"
"Butts","2020-07-11","16","4332","3","397","13.2","12.4"
"Butts","2020-07-12","4","4336","0","397","11.2","11.2"
"Butts","2020-07-13","35","4371","4","401","9.9","11.6"
"Butts","2020-07-14","35","4406","2","403","9.6","11.7"
"Butts","2020-07-15","30","4436","12","415","13.2","14.2"
"Butts","2020-07-16","85","4521","10","425","14","14.5"
"Butts","2020-07-17","31","4552","3","428","13.9","13.1"
"Butts","2020-07-18","9","4561","1","429","12.8","13"
"Butts","2020-07-19","7","4568","2","431","16.9","14.1"
"Butts","2020-07-20","32","4600","6","437","17.9","13.9"
"Butts","2020-07-21","187","4787","15","452","18.3","13.9"
"Butts","2020-07-22","26","4813","7","459","16.4","14.8"
"Butts","2020-07-23","74","4887","7","466","16.1","15"
"Butts","2020-07-24","28","4915","2","468","15.7","14.8"
"Butts","2020-07-25","149","5064","11","479","15.2","14"
"Butts","2020-07-26","7","5071","1","480","13.1","15"
"Butts","2020-07-27","32","5103","5","485","12.7","15.3"
"Butts","2020-07-28","50","5153","3","488","12.4","15.3"
"Butts","2020-07-29","31","5184","3","491","9.9","13.2"
"Butts","2020-07-30","80","5264","5","496","9.5","12.8"
"Butts","2020-07-31","69","5333","8","504","10.1","12.9"
"Butts","2020-08-01","9","5342","2","506","12.2","13.7"
"Butts","2020-08-02","6","5348","0","506","10.2","11.7"
"Butts","2020-08-03","22","5370","3","509","9.9","11.3"
"Butts","2020-08-04","201","5571","13","522","10","11.2"
"Butts","2020-08-05","228","5799","30","552","10.5","10.2"
"Butts","2020-08-06","240","6039","9","561","10.1","9.8"
"Butts","2020-08-07","21","6060","1","562","9.1","9.6"
"Butts","2020-08-08","14","6074","1","563","7","9.6"
"Butts","2020-08-09","5","6079","2","565","12.7","11.4"
"Butts","2020-08-10","33","6112","5","570","12.9","11.4"
"Butts","2020-08-11","28","6140","5","575","14.5","12.3"
"Butts","2020-08-12","30","6170","7","582","16","13.2"
"Butts","2020-08-13","57","6227","4","586","16.5","13.3"
"Butts","2020-08-14","30","6257","2","588","16.7","12.9"
"Butts","2020-08-15","16","6273","2","590","17.5","12.2"
"Butts","2020-08-16","10","6283","2","592","14.6","13.7"
"Butts","2020-08-17","39","6322","3","595","13.6","13.2"
"Butts","2020-08-18","46","6368","3","598","12","13.3"
"Butts","2020-08-19","54","6422","2","600","9.2","12.6"
"Butts","2020-08-20","51","6473","7","607","10.1","13.3"
"Butts","2020-08-21","19","6492","3","610","11.4","14.1"
"Butts","2020-08-22","10","6502","1","611","11.1","14.3"
"Butts","2020-08-23","19","6521","0","611","8.2","11.4"
"Butts","2020-08-24","39","6560","7","618","9.7","11.6"
"Butts","2020-08-25","17","6577","2","620","10.4","11.2"
"Butts","2020-08-26","42","6619","5","625","11.6","10.4"
"Butts","2020-08-27","45","6664","4","629","10.9","10.5"
"Butts","2020-08-28","30","6694","2","631","9.6","10.5"
"Butts","2020-08-29","9","6703","1","632","9.8","10.4"
"Butts","2020-08-30","8","6711","0","632","9.8","9"
"Butts","2020-08-31","32","6743","0","632","7.2","8.4"
"Butts","2020-09-01","34","6777","3","635","6.8","8.6"
"Butts","2020-09-02","20","6797","2","637","6.5","9"
"Butts","2020-09-03","51","6848","8","645","7.5","9.2"
"Butts","2020-09-04","20","6868","0","645","6.5","8.1"
"Butts","2020-09-05","20","6888","2","647","6.4","8.1"
"Butts","2020-09-06","13","6901","2","649","8.6","9.2"
"Butts","2020-09-07","9","6910","3","652","13.3","10.3"
"Butts","2020-09-08","29","6939","1","653","12.6","9.7"
"Butts","2020-09-09","27","6966","2","655","12.2","9.3"
"Butts","2020-09-10","398","7364","46","701","11.6","9.5"
"Butts","2020-09-11","24","7388","1","702","12.2","9.4"
"Butts","2020-09-12","13","7401","0","702","10.8","8.6"
"Butts","2020-09-13","3","7404","1","703","13.3","10.9"
"Butts","2020-09-14","27","7431","2","705","9.6","11.5"
"Butts","2020-09-15","81","7512","7","712","10.4","11.5"
"Butts","2020-09-16","104","7616","6","718","10.1","11.2"
"Butts","2020-09-17","24","7640","1","719","9.1","10.3"
"Butts","2020-09-18","28","7668","2","721","9.5","10.8"
"Butts","2020-09-19","8","7676","0","721","9.5","10.1"
"Butts","2020-09-20","4","7680","0","721","4.7","9"
"Butts","2020-09-21","37","7717","4","725","5.2","7.4"
"Butts","2020-09-22","30","7747","3","728","5.4","7.9"
"Butts","2020-09-23","24","7771","3","731","6.4","8.2"
"Butts","2020-09-24","44","7815","10","741","9","9"
"Butts","2020-09-25","30","7845","5","746","10.4","9.9"
"Butts","2020-09-26","16","7861","2","748","12.2","10.8"
"Butts","2020-09-27","214","8075","14","762","13.1","8.9"
"Butts","2020-09-28","34","8109","3","765","12.8","9"
"Butts","2020-09-29","322","8431","24","789","12.5","8.9"
"Butts","2020-09-30","29","8460","3","792","12.2","9.3"
"Butts","2020-10-01","236","8696","42","834","11.4","10.2"
"Butts","2020-10-02","32","8728","2","836","10","10.2"
"Butts","2020-10-03","9","8737","1","837","9.8","11"
"Butts","2020-10-04","11","8748","3","840","12.7","12.9"
"Butts","2020-10-05","44","8792","3","843","12.4","12.6"
"Butts","2020-10-06","33","8825","1","844","11.8","12.1"
"Butts","2020-10-07","34","8859","3","847","11.6","11.9"
"Butts","2020-10-08","37","8896","2","849","9.8","10.6"
"Butts","2020-10-09","34","8930","3","852","10.2","10.1"
"Butts","2020-10-10","13","8943","1","853","9.7","9.7"
"Butts","2020-10-11","9","8952","2","855","9","10.8"
"Butts","2020-10-12","22","8974","0","855","8","10.2"
"Butts","2020-10-13","37","9011","4","859","9.1","10.5"
"Butts","2020-10-14","22","9033","1","860","8.5","10"
"Butts","2020-10-15","23","9056","1","861","8.3","9.1"
"Butts","2020-10-16","41","9097","2","863","7.8","9"
"Butts","2020-10-17","12","9109","0","863","6.7","8.2"
"Butts","2020-10-18","11","9120","1","864","4.8","6.9"
"Butts","2020-10-19","33","9153","4","868","6.5","7.3"
"Butts","2020-10-20","25","9178","1","869","5.6","7.3"
"Butts","2020-10-21","28","9206","2","871","5.9","7.2"
"Butts","2020-10-22","33","9239","6","877","7.9","8.1"
"Butts","2020-10-23","28","9267","1","878","7.7","7.8"
"Butts","2020-10-24","23","9290","1","879","8.4","7.5"
"Butts","2020-10-25","10","9300","2","881","9.9","7.4"
"Butts","2020-10-26","42","9342","4","885","9.5","8"
"Butts","2020-10-27","42","9384","2","887","9.6","7.6"
"Butts","2020-10-28","38","9422","4","891","10.1","8"
"Butts","2020-10-29","27","9449","3","894","9.1","8.5"
"Butts","2020-10-30","25","9474","1","895","9.2","8.5"
"Butts","2020-10-31","22","9496","2","897","9.9","9.1"
"Butts","2020-11-01","8","9504","1","898","8.8","9.3"
"Butts","2020-11-02","50","9554","6","904","9.1","9.3"
"Butts","2020-11-03","39","9593","4","908","9.9","9.8"
"Butts","2020-11-04","37","9630","3","911","9.6","9.9"
"Butts","2020-11-05","45","9675","5","916","9.6","9.4"
"Butts","2020-11-06","124","9799","0","916","9","9.1"
"Butts","2020-11-07","16","9815","2","918","9.5","9.7"
"Butts","2020-11-08","25","9840","3","921","9.4","9.1"
"Butts","2020-11-09","35","9875","7","928","10.6","9.9"
"Butts","2020-11-10","148","10023","11","939","10.2","10"
"Butts","2020-11-11","30","10053","3","942","10.4","10"
"Butts","2020-11-12","297","10350","8","950","9.2","9.4"
"Butts","2020-11-13","45","10395","6","956","11.1","10.1"
"Butts","2020-11-14","24","10419","1","957","9.9","9.7"
"Butts","2020-11-15","11","10430","0","957","8.2","8.8"
"Butts","2020-11-16","128","10558","8","965","6.3","8.4"
"Butts","2020-11-17","55","10613","6","971","6.8","8.5"
"Butts","2020-11-18","47","10660","9","980","8.1","9.3"
"Butts","2020-11-19","57","10717","7","987","9.4","9.3"
"Butts","2020-11-20","46","10763","2","989","8.2","9.6"
"Butts","2020-11-21","25","10788","4","993","9.8","9.9"
"Butts","2020-11-22","13","10801","2","995","12","10.1"
"Butts","2020-11-23","73","10874","8","1003","12.7","9.5"
"Butts","2020-11-24","65","10939","10","1013","13.4","10.1"
"Butts","2020-11-25","42","10981","7","1020","13","10.5"
"Butts","2020-11-26","4","10985","0","1020","11.2","10.3"
"Butts","2020-11-27","37","11022","13","1033","15.6","11.9"
"Butts","2020-11-28","18","11040","4","1037","16.5","13.2"
"Butts","2020-11-29","17","11057","3","1040","16.9","14.5"
"Butts","2020-11-30","70","11127","11","1051","17.5","15.1"
"Butts","2020-12-01","56","11183","8","1059","17.4","15.4"
"Butts","2020-12-02","128","11311","10","1069","16.1","14.6"
"Butts","2020-12-03","68","11379","15","1084","19.3","15.3"
"Butts","2020-12-04","67","11446","15","1099","17.4","16.5"
"Butts","2020-12-05","25","11471","2","1101","15.4","16"
"Butts","2020-12-06","22","11493","7","1108","17.4","17.1"
"Butts","2020-12-07","60","11553","17","1125","19.2","18.4"
"Butts","2020-12-08","57","11610","20","1145","22.2","19.8"
"Butts","2020-12-09","74","11684","23","1168","25.5","20.8"
"Butts","2020-12-10","79","11763","17","1185","25.5","22.4"
"Butts","2020-12-11","78","11841","19","1204","25.7","21.6"
"Butts","2020-12-12","38","11879","11","1215","28.7","22.1"
"Butts","2020-12-13","30","11909","11","1226","29.4","23.4"
"Butts","2020-12-14","396","12305","66","1292","27.8","23.5"
"Butts","2020-12-15","444","12749","85","1377","25.5","23.8"
"Butts","2020-12-16","379","13128","40","1417","22.6","24"
"Butts","2020-12-17","439","13567","55","1472","21.3","23.4"
"Butts","2020-12-18","388","13955","29","1501","18.9","22.3"
"Butts","2020-12-19","46","14001","13","1514","18.8","23.7"
"Butts","2020-12-20","24","14025","10","1524","19.5","24.4"
"Butts","2020-12-21","302","14327","59","1583","19.9","23.8"
"Butts","2020-12-22","55","14382","20","1603","22.3","23.9"
"Butts","2020-12-23","75","14457","9","1612","22.5","22.5"
"Butts","2020-12-24","49","14506","12","1624","24.3","22.8"
"Butts","2020-12-25","11","14517","2","1626","25.8","22.3"
"Butts","2020-12-26","37","14554","19","1645","29.1","23.9"
"Butts","2020-12-27","27","14581","9","1654","27.9","23.7"
"Butts","2020-12-28","101","14682","19","1673","27.8","23.8"
"Butts","2020-12-29","80","14762","30","1703","28","25.1"
"Butts","2020-12-30","76","14838","30","1733","31.9","27.2"
"Butts","2020-12-31","104","14942","33","1766","32.9","28.6"
"Butts","2021-01-01","17","14959","6","1772","35.4","30.6"
"Butts","2021-01-02","34","14993","9","1781","31.8","30.4"
"Butts","2021-01-03","53","15046","31","1812","35.4","31.6"
"Butts","2021-01-04","119","15165","50","1862","38.7","33.3"
"Butts","2021-01-05","398","15563","80","1942","36.2","32.1"
"Butts","2021-01-06","86","15649","28","1970","35.2","33.6"
"Butts","2021-01-07","106","15755","27","1997","34.3","33.6"
"Butts","2021-01-08","92","15847","21","2018","32.6","34"
"Butts","2021-01-09","50","15897","14","2032","32.8","32.3"
"Butts","2021-01-10","27","15924","9","2041","29.2","32.3"
"Butts","2021-01-11","95","16019","16","2057","25.6","32.2"
"Butts","2021-01-12","77","16096","20","2077","26.4","31.3"
"Butts","2021-01-13","78","16174","17","2094","24.9","30.1"
"Butts","2021-01-14","139","16313","25","2119","23.8","29.1"
"Butts","2021-01-15","65","16378","11","2130","23","27.8"
"Butts","2021-01-16","38","16416","10","2140","22.7","27.8"
"Butts","2021-01-17","27","16443","4","2144","20.1","24.6"
"Butts","2021-01-18","210","16653","30","2174","19.7","22.7"
"Butts","2021-01-19","212","16865","23","2197","17.6","22"
"Butts","2021-01-20","172","17037","16","2213","15.8","20.3"
"Butts","2021-01-21","223","17260","15","2228","14.2","19"
"Butts","2021-01-22","202","17462","18","2246","13","18"
"Butts","2021-01-23","35","17497","10","2256","13.4","18"
"Butts","2021-01-24","23","17520","3","2259","13.1","16.6"
"Butts","2021-01-25","206","17726","31","2290","13.2","16.5"
"Butts","2021-01-26","206","17932","15","2305","12.7","15.1"
"Butts","2021-01-27","125","18057","10","2315","12.5","14.1"
"Butts","2021-01-28","103","18160","21","2336","14.5","14.3"
"Butts","2021-01-29","212","18372","17","2353","14.3","13.7"
"Butts","2021-01-30","34","18406","11","2364","14.9","14.1"
"Butts","2021-01-31","14","18420","3","2367","16.1","14.6"
"Butts","2021-02-01","99","18519","14","2381","15.9","14.6"
"Butts","2021-02-02","121","18640","13","2394","16.4","14.6"
"Butts","2021-02-03","111","18751","8","2402","16.3","14.4"
"Butts","2021-02-04","298","19049","12","2414","14","14.2"
"Butts","2021-02-05","311","19360","9","2423","13.3","13.8"
"Butts","2021-02-06","7","19367","3","2426","14.8","14.8"
"Butts","2021-02-07","2","19369","0","2426","11.7","13.9"
"Butts","2021-02-08","0","19369","0","2426","9.7","12.8"
"Calhoun","2020-02-01","0","0","0","0",".","."
"Calhoun","2020-02-02","0","0","0","0",".","."
"Calhoun","2020-02-03","0","0","0","0",".","."
"Calhoun","2020-02-04","0","0","0","0",".","."
"Calhoun","2020-02-05","0","0","0","0",".","."
"Calhoun","2020-02-06","0","0","0","0",".","."
"Calhoun","2020-02-07","0","0","0","0","0","."
"Calhoun","2020-02-08","0","0","0","0","0","."
"Calhoun","2020-02-09","0","0","0","0","0","."
"Calhoun","2020-02-10","0","0","0","0","0","."
"Calhoun","2020-02-11","0","0","0","0","0","."
"Calhoun","2020-02-12","0","0","0","0","0","."
"Calhoun","2020-02-13","0","0","0","0","0","."
"Calhoun","2020-02-14","0","0","0","0","0","0"
"Calhoun","2020-02-15","0","0","0","0","0","0"
"Calhoun","2020-02-16","0","0","0","0","0","0"
"Calhoun","2020-02-17","0","0","0","0","0","0"
"Calhoun","2020-02-18","0","0","0","0","0","0"
"Calhoun","2020-02-19","0","0","0","0","0","0"
"Calhoun","2020-02-20","0","0","0","0","0","0"
"Calhoun","2020-02-21","0","0","0","0","0","0"
"Calhoun","2020-02-22","0","0","0","0","0","0"
"Calhoun","2020-02-23","0","0","0","0","0","0"
"Calhoun","2020-02-24","0","0","0","0","0","0"
"Calhoun","2020-02-25","0","0","0","0","0","0"
"Calhoun","2020-02-26","0","0","0","0","0","0"
"Calhoun","2020-02-27","0","0","0","0","0","0"
"Calhoun","2020-02-28","0","0","0","0","0","0"
"Calhoun","2020-02-29","0","0","0","0","0","0"
"Calhoun","2020-03-01","0","0","0","0","0","0"
"Calhoun","2020-03-02","0","0","0","0","0","0"
"Calhoun","2020-03-03","0","0","0","0","0","0"
"Calhoun","2020-03-04","0","0","0","0","0","0"
"Calhoun","2020-03-05","0","0","0","0","0","0"
"Calhoun","2020-03-06","0","0","0","0","0","0"
"Calhoun","2020-03-07","0","0","0","0","0","0"
"Calhoun","2020-03-08","0","0","0","0","0","0"
"Calhoun","2020-03-09","0","0","0","0","0","0"
"Calhoun","2020-03-10","0","0","0","0","0","0"
"Calhoun","2020-03-11","0","0","0","0","0","0"
"Calhoun","2020-03-12","1","1","0","0","0","0"
"Calhoun","2020-03-13","0","1","0","0","0","0"
"Calhoun","2020-03-14","0","1","0","0","0","0"
"Calhoun","2020-03-15","0","1","0","0","0","0"
"Calhoun","2020-03-16","0","1","0","0","0","0"
"Calhoun","2020-03-17","1","2","0","0","0","0"
"Calhoun","2020-03-18","4","6","3","3","10.7","5.4"
"Calhoun","2020-03-19","2","8","1","4","17.9","8.9"
"Calhoun","2020-03-20","7","15","2","6","21.9","11"
"Calhoun","2020-03-21","1","16","0","6","21.9","11"
"Calhoun","2020-03-22","0","16","0","6","21.9","11"
"Calhoun","2020-03-23","7","23","2","8","26","13"
"Calhoun","2020-03-24","8","31","0","8","26","13"
"Calhoun","2020-03-25","0","31","0","8","15.3","13"
"Calhoun","2020-03-26","2","33","0","8","8.2","13"
"Calhoun","2020-03-27","4","37","1","9","7.7","14.8"
"Calhoun","2020-03-28","3","40","1","10","12.4","17.2"
"Calhoun","2020-03-29","0","40","0","10","12.4","17.2"
"Calhoun","2020-03-30","4","44","2","12","15.5","20.7"
"Calhoun","2020-03-31","4","48","3","15","26.2","26.1"
"Calhoun","2020-04-01","5","53","1","16","29","22.2"
"Calhoun","2020-04-02","11","64","7","23","38.1","23.2"
"Calhoun","2020-04-03","8","72","5","28","43.5","25.6"
"Calhoun","2020-04-04","2","74","0","28","38.7","25.6"
"Calhoun","2020-04-05","1","75","1","29","53","32.7"
"Calhoun","2020-04-06","9","84","4","33","52.2","33.9"
"Calhoun","2020-04-07","10","94","8","41","52.9","39.6"
"Calhoun","2020-04-08","14","108","5","46","55.2","42.1"
"Calhoun","2020-04-09","4","112","2","48","53.2","45.7"
"Calhoun","2020-04-10","11","123","4","52","49.5","46.5"
"Calhoun","2020-04-11","1","124","0","52","49.5","44.1"
"Calhoun","2020-04-12","2","126","0","52","35.2","44.1"
"Calhoun","2020-04-13","7","133","1","53","30.9","41.6"
"Calhoun","2020-04-14","8","141","3","56","24.8","38.9"
"Calhoun","2020-04-15","7","148","1","57","21.8","38.5"
"Calhoun","2020-04-16","12","160","4","61","19.4","36.3"
"Calhoun","2020-04-17","11","171","1","62","15.5","32.5"
"Calhoun","2020-04-18","0","171","0","62","15.5","32.5"
"Calhoun","2020-04-19","2","173","0","62","15.5","25.4"
"Calhoun","2020-04-20","10","183","3","65","17.7","24.3"
"Calhoun","2020-04-21","1","184","1","66","26.7","25.8"
"Calhoun","2020-04-22","4","188","1","67","28.2","25"
"Calhoun","2020-04-23","17","205","14","81","35.2","27.3"
"Calhoun","2020-04-24","7","212","0","81","33.9","24.7"
"Calhoun","2020-04-25","7","219","2","83","38","26.7"
"Calhoun","2020-04-26","7","226","1","84","40","27.8"
"Calhoun","2020-04-27","12","238","7","91","44.1","30.9"
"Calhoun","2020-04-28","5","243","1","92","32.6","29.7"
"Calhoun","2020-04-29","9","252","3","95","33.8","31"
"Calhoun","2020-04-30","5","257","1","96","24.9","30.1"
"Calhoun","2020-05-01","9","266","0","96","24.9","29.4"
"Calhoun","2020-05-02","2","268","0","96","20.9","29.4"
"Calhoun","2020-05-03","2","270","0","96","18.8","29.4"
"Calhoun","2020-05-04","20","290","4","100","13.3","28.7"
"Calhoun","2020-05-05","12","302","1","101","11.7","22.2"
"Calhoun","2020-05-06","4","306","1","102","10.5","22.2"
"Calhoun","2020-05-07","2","308","0","102","7.6","16.3"
"Calhoun","2020-05-08","1","309","1","103","21.9","23.4"
"Calhoun","2020-05-09","2","311","0","103","21.9","21.4"
"Calhoun","2020-05-10","0","311","0","103","21.9","20.4"
"Calhoun","2020-05-11","7","318","0","103","19","16.2"
"Calhoun","2020-05-12","6","324","3","106","25","18.3"
"Calhoun","2020-05-13","16","340","2","108","23.2","16.8"
"Calhoun","2020-05-14","14","354","4","112","27.3","17.5"
"Calhoun","2020-05-15","7","361","1","113","15.1","18.5"
"Calhoun","2020-05-16","1","362","0","113","15.1","18.5"
"Calhoun","2020-05-17","1","363","0","113","15.1","18.5"
"Calhoun","2020-05-18","12","375","2","115","17.4","18.2"
"Calhoun","2020-05-19","23","398","0","115","10.3","17.6"
"Calhoun","2020-05-20","25","423","0","115","8.5","15.9"
"Calhoun","2020-05-21","30","453","0","115","4.4","15.9"
"Calhoun","2020-05-22","32","485","0","115","2.4","8.7"
"Calhoun","2020-05-23","2","487","0","115","2.4","8.7"
"Calhoun","2020-05-24","6","493","2","117","7.1","11.1"
"Calhoun","2020-05-25","17","510","0","117","4.8","11.1"
"Calhoun","2020-05-26","22","532","2","119","6.1","8.2"
"Calhoun","2020-05-27","11","543","1","120","7.4","7.9"
"Calhoun","2020-05-28","15","558","2","122","9.3","6.8"
"Calhoun","2020-05-29","5","563","2","124","15","8.7"
"Calhoun","2020-05-30","4","567","0","124","15","8.7"
"Calhoun","2020-05-31","3","570","1","125","15","11.1"
"Calhoun","2020-06-01","23","593","2","127","16.2","10.5"
"Calhoun","2020-06-02","11","604","1","128","16.2","11.1"
"Calhoun","2020-06-03","13","617","1","129","16","11.7"
"Calhoun","2020-06-04","119","736","7","136","15","12.1"
"Calhoun","2020-06-05","10","746","0","136","9.2","12.1"
"Calhoun","2020-06-06","2","748","1","137","16.4","15.7"
"Calhoun","2020-06-07","0","748","0","137","11.6","13.3"
"Calhoun","2020-06-08","14","762","3","140","13.4","14.8"
"Calhoun","2020-06-09","3","765","1","141","16.9","16.6"
"Calhoun","2020-06-10","5","770","1","142","18.7","17.3"
"Calhoun","2020-06-11","16","786","3","145","20.5","17.7"
"Calhoun","2020-06-12","4","790","0","145","20.5","14.9"
"Calhoun","2020-06-13","3","793","1","146","18.1","17.3"
"Calhoun","2020-06-14","0","793","0","146","18.1","14.9"
"Calhoun","2020-06-15","12","805","0","146","15.1","14.3"
"Calhoun","2020-06-16","23","828","4","150","12.8","14.8"
"Calhoun","2020-06-17","13","841","0","150","9.9","14.3"
"Calhoun","2020-06-18","53","894","5","155","8.6","14.5"
"Calhoun","2020-06-19","12","906","0","155","8.6","14.5"
"Calhoun","2020-06-20","3","909","0","155","3.8","11"
"Calhoun","2020-06-21","4","913","2","157","11","14.5"
"Calhoun","2020-06-22","18","931","1","158","11.8","13.4"
"Calhoun","2020-06-23","10","941","4","162","15","13.9"
"Calhoun","2020-06-24","3","944","0","162","15","12.5"
"Calhoun","2020-06-25","12","956","4","166","18.4","13.5"
"Calhoun","2020-06-26","14","970","4","170","22.5","15.5"
"Calhoun","2020-06-27","1","971","0","170","22.5","13.2"
"Calhoun","2020-06-28","5","976","0","170","15.4","13.2"
"Calhoun","2020-06-29","2","978","0","170","14.6","13.2"
"Calhoun","2020-06-30","9","987","3","173","13.6","14.3"
"Calhoun","2020-07-01","14","1001","2","175","15.6","15.3"
"Calhoun","2020-07-02","8","1009","2","177","14.5","16.4"
"Calhoun","2020-07-03","5","1014","0","177","10.4","16.4"
"Calhoun","2020-07-04","1","1015","0","177","10.4","16.4"
"Calhoun","2020-07-05","1","1016","1","178","24.7","20"
"Calhoun","2020-07-06","12","1028","1","179","25.9","20.2"
"Calhoun","2020-07-07","11","1039","1","180","22.4","18"
"Calhoun","2020-07-08","13","1052","1","181","21.4","18.5"
"Calhoun","2020-07-09","9","1061","2","183","21","17.8"
"Calhoun","2020-07-10","9","1070","1","184","22.6","16.5"
"Calhoun","2020-07-11","1","1071","0","184","22.6","16.5"
"Calhoun","2020-07-12","5","1076","4","188","19.8","22.2"
"Calhoun","2020-07-13","6","1082","0","188","18.6","22.2"
"Calhoun","2020-07-14","17","1099","0","188","17.3","19.8"
"Calhoun","2020-07-15","12","1111","0","188","16.2","18.8"
"Calhoun","2020-07-16","1","1112","0","188","13","17"
"Calhoun","2020-07-17","3","1115","2","190","21","21.8"
"Calhoun","2020-07-18","2","1117","0","190","21","21.8"
"Calhoun","2020-07-19","2","1119","0","190","9.5","14.7"
"Calhoun","2020-07-20","7","1126","1","191","11.6","15.1"
"Calhoun","2020-07-21","7","1133","1","192","13.6","15.4"
"Calhoun","2020-07-22","8","1141","2","194","17.2","16.7"
"Calhoun","2020-07-23","9","1150","2","196","20.4","16.7"
"Calhoun","2020-07-24","13","1163","2","198","13","17"
"Calhoun","2020-07-25","7","1170","4","202","21.2","21.1"
"Calhoun","2020-07-26","1","1171","1","203","35.5","22.5"
"Calhoun","2020-07-27","10","1181","1","204","34.9","23.2"
"Calhoun","2020-07-28","8","1189","2","206","36.4","25"
"Calhoun","2020-07-29","18","1207","3","209","35.2","26.2"
"Calhoun","2020-07-30","13","1220","1","210","33.1","26.7"
"Calhoun","2020-07-31","7","1227","1","211","33","23"
"Calhoun","2020-08-01","4","1231","1","212","28.4","24.8"
"Calhoun","2020-08-02","2","1233","0","212","14.1","24.8"
"Calhoun","2020-08-03","9","1242","0","212","12.7","23.8"
"Calhoun","2020-08-04","10","1252","1","213","10.5","23.5"
"Calhoun","2020-08-05","9","1261","2","215","11.3","23.3"
"Calhoun","2020-08-06","7","1268","2","217","14.3","23.7"
"Calhoun","2020-08-07","31","1299","2","219","13.2","23.1"
"Calhoun","2020-08-08","4","1303","1","220","13.2","20.8"
"Calhoun","2020-08-09","0","1303","0","220","13.2","13.6"
"Calhoun","2020-08-10","7","1310","1","221","15.2","13.9"
"Calhoun","2020-08-11","15","1325","3","224","16.6","13.6"
"Calhoun","2020-08-12","7","1332","0","224","13.5","12.4"
"Calhoun","2020-08-13","6","1338","0","224","9.4","11.8"
"Calhoun","2020-08-14","9","1347","1","225","10.1","11.6"
"Calhoun","2020-08-15","2","1349","1","226","13.6","13.4"
"Calhoun","2020-08-16","2","1351","0","226","13.6","13.4"
"Calhoun","2020-08-17","14","1365","1","227","12.6","13.9"
"Calhoun","2020-08-18","7","1372","2","229","13.8","15.2"
"Calhoun","2020-08-19","13","1385","2","231","16","14.8"
"Calhoun","2020-08-20","9","1394","4","235","22.4","15.9"
"Calhoun","2020-08-21","8","1402","1","236","22.6","16.3"
"Calhoun","2020-08-22","2","1404","0","236","15.4","14.5"
"Calhoun","2020-08-23","2","1406","0","236","15.4","14.5"
"Calhoun","2020-08-24","10","1416","1","237","15.8","14.2"
"Calhoun","2020-08-25","17","1433","1","238","12.6","13.2"
"Calhoun","2020-08-26","6","1439","2","240","15.2","15.6"
"Calhoun","2020-08-27","10","1449","1","241","10.2","16.3"
"Calhoun","2020-08-28","29","1478","0","241","8.5","15.5"
"Calhoun","2020-08-29","0","1478","0","241","8.5","11.9"
"Calhoun","2020-08-30","0","1478","0","241","8.5","11.9"
"Calhoun","2020-08-31","5","1483","0","241","7","11.4"
"Calhoun","2020-09-01","7","1490","0","241","6.2","9.4"
"Calhoun","2020-09-02","12","1502","0","241","1.4","8.3"
"Calhoun","2020-09-03","13","1515","0","241","0","5.1"
"Calhoun","2020-09-04","9","1524","0","241","0","4.2"
"Calhoun","2020-09-05","1","1525","0","241","0","4.2"
"Calhoun","2020-09-06","3","1528","0","241","0","4.2"
"Calhoun","2020-09-07","0","1528","0","241","0","3.5"
"Calhoun","2020-09-08","5","1533","0","241","0","3.1"
"Calhoun","2020-09-09","9","1542","0","241","0","0.7"
"Calhoun","2020-09-10","12","1554","0","241","0","0"
"Calhoun","2020-09-11","13","1567","2","243","2.2","1.1"
"Calhoun","2020-09-12","1","1568","0","243","2.2","1.1"
"Calhoun","2020-09-13","1","1569","0","243","2.2","1.1"
"Calhoun","2020-09-14","19","1588","0","243","2.2","1.1"
"Calhoun","2020-09-15","13","1601","0","243","2.2","1.1"
"Calhoun","2020-09-16","8","1609","1","244","4","2"
"Calhoun","2020-09-17","8","1617","1","245","5.8","2.9"
"Calhoun","2020-09-18","10","1627","2","247","6.4","4.3"
"Calhoun","2020-09-19","2","1629","0","247","6.4","4.3"
"Calhoun","2020-09-20","2","1631","1","248","13.6","7.9"
"Calhoun","2020-09-21","16","1647","0","248","13.6","7.9"
"Calhoun","2020-09-22","13","1660","0","248","13.6","7.9"
"Calhoun","2020-09-23","10","1670","1","249","13.2","8.6"
"Calhoun","2020-09-24","19","1689","2","251","12.9","9.4"
"Calhoun","2020-09-25","14","1703","1","252","11.1","8.8"
"Calhoun","2020-09-26","0","1703","0","252","11.1","8.8"
"Calhoun","2020-09-27","1","1704","0","252","4","8.8"
"Calhoun","2020-09-28","14","1718","1","253","5","9.3"
"Calhoun","2020-09-29","9","1727","1","254","6.6","10.1"
"Calhoun","2020-09-30","16","1743","2","256","6.9","10.1"
"Calhoun","2020-10-01","7","1750","1","257","7.5","10.2"
"Calhoun","2020-10-02","8","1758","0","257","6.4","8.8"
"Calhoun","2020-10-03","2","1760","0","257","6.4","8.8"
"Calhoun","2020-10-04","0","1760","0","257","6.4","5.2"
"Calhoun","2020-10-05","15","1775","0","257","5.4","5.2"
"Calhoun","2020-10-06","31","1806","0","257","3.8","5.2"
"Calhoun","2020-10-07","9","1815","0","257","2","4.5"
"Calhoun","2020-10-08","21","1836","1","258","0.7","4.1"
"Calhoun","2020-10-09","9","1845","2","260","3.9","5.1"
"Calhoun","2020-10-10","2","1847","0","260","3.9","5.1"
"Calhoun","2020-10-11","0","1847","0","260","3.9","5.1"
"Calhoun","2020-10-12","18","1865","2","262","5.4","5.4"
"Calhoun","2020-10-13","13","1878","0","262","5.4","4.6"
"Calhoun","2020-10-14","20","1898","1","263","6.2","4.1"
"Calhoun","2020-10-15","7","1905","0","263","5.5","3.1"
"Calhoun","2020-10-16","19","1924","0","263","2.3","3.1"
"Calhoun","2020-10-17","5","1929","1","264","5.2","4.5"
"Calhoun","2020-10-18","1","1930","0","264","5.2","4.5"
"Calhoun","2020-10-19","16","1946","0","264","3.6","4.5"
"Calhoun","2020-10-20","37","1983","0","264","3.6","4.5"
"Calhoun","2020-10-21","16","1999","2","266","4.6","5.4"
"Calhoun","2020-10-22","18","2017","0","266","4.6","5.1"
"Calhoun","2020-10-23","5","2022","0","266","4.6","3.5"
"Calhoun","2020-10-24","0","2022","0","266","1.8","3.5"
"Calhoun","2020-10-25","0","2022","0","266","1.8","3.5"
"Calhoun","2020-10-26","35","2057","2","268","2.6","3.1"
"Calhoun","2020-10-27","9","2066","0","268","2.6","3.1"
"Calhoun","2020-10-28","14","2080","2","270","2.9","3.8"
"Calhoun","2020-10-29","14","2094","1","271","3.9","4.3"
"Calhoun","2020-10-30","8","2102","0","271","3.9","4.3"
"Calhoun","2020-10-31","5","2107","0","271","3.9","2.8"
"Calhoun","2020-11-01","4","2111","0","271","3.9","2.8"
"Calhoun","2020-11-02","36","2147","1","272","3.5","3"
"Calhoun","2020-11-03","13","2160","1","273","4.6","3.6"
"Calhoun","2020-11-04","26","2186","0","273","2.5","2.7"
"Calhoun","2020-11-05","58","2244","1","274","1.7","2.8"
"Calhoun","2020-11-06","9","2253","0","274","1.7","2.8"
"Calhoun","2020-11-07","1","2254","0","274","1.7","2.8"
"Calhoun","2020-11-08","3","2257","0","274","1.7","2.8"
"Calhoun","2020-11-09","50","2307","0","274","1.3","2.4"
"Calhoun","2020-11-10","3","2310","0","274","0.2","2.4"
"Calhoun","2020-11-11","47","2357","0","274","0.2","1.4"
"Calhoun","2020-11-12","9","2366","0","274","0","0.9"
"Calhoun","2020-11-13","22","2388","2","276","1.3","1.5"
"Calhoun","2020-11-14","1","2389","1","277","15.6","8.7"
"Calhoun","2020-11-15","2","2391","1","278","22.7","12.2"
"Calhoun","2020-11-16","41","2432","0","278","22.7","12"
"Calhoun","2020-11-17","11","2443","0","278","22.7","11.5"
"Calhoun","2020-11-18","27","2470","0","278","22.7","11.5"
"Calhoun","2020-11-19","26","2496","1","279","23.3","11.6"
"Calhoun","2020-11-20","133","2629","2","281","22.2","11.7"
"Calhoun","2020-11-21","3","2632","1","282","12.7","14.1"
"Calhoun","2020-11-22","0","2632","0","282","5.5","14.1"
"Calhoun","2020-11-23","16","2648","2","284","7.3","15"
"Calhoun","2020-11-24","11","2659","1","285","8.6","15.7"
"Calhoun","2020-11-25","7","2666","0","285","8.6","15.7"
"Calhoun","2020-11-26","3","2669","0","285","8.1","15.7"
"Calhoun","2020-11-27","3","2672","0","285","7.8","15"
"Calhoun","2020-11-28","1","2673","0","285","3.1","7.9"
"Calhoun","2020-11-29","3","2676","2","287","12.6","9.1"
"Calhoun","2020-11-30","21","2697","3","290","12.9","10.1"
"Calhoun","2020-12-01","39","2736","3","293","12.7","10.6"
"Calhoun","2020-12-02","27","2763","0","293","12.7","10.6"
"Calhoun","2020-12-03","40","2803","1","294","13","10.5"
"Calhoun","2020-12-04","17","2820","2","296","14.7","11.3"
"Calhoun","2020-12-05","8","2828","3","299","20.1","11.6"
"Calhoun","2020-12-06","0","2828","0","299","10.5","11.6"
"Calhoun","2020-12-07","44","2872","0","299","8.5","10.7"
"Calhoun","2020-12-08","25","2897","1","300","8","10.3"
"Calhoun","2020-12-09","30","2927","1","301","8.4","10.6"
"Calhoun","2020-12-10","24","2951","0","301","8.1","10.6"
"Calhoun","2020-12-11","12","2963","1","302","7.6","11.1"
"Calhoun","2020-12-12","3","2966","0","302","2.2","11.1"
"Calhoun","2020-12-13","2","2968","0","302","2.2","6.4"
"Calhoun","2020-12-14","146","3114","1","303","2.3","5.4"
"Calhoun","2020-12-15","31","3145","2","305","2.7","5.3"
"Calhoun","2020-12-16","13","3158","0","305","2.2","5.3"
"Calhoun","2020-12-17","11","3169","2","307","4.8","6.4"
"Calhoun","2020-12-18","6","3175","1","308","6","6.8"
"Calhoun","2020-12-19","6","3181","0","308","6","4.1"
"Calhoun","2020-12-20","1","3182","1","309","20.3","11.3"
"Calhoun","2020-12-21","3","3185","0","309","20.2","11.3"
"Calhoun","2020-12-22","12","3197","3","312","22.8","12.8"
"Calhoun","2020-12-23","11","3208","5","317","29.3","15.8"
"Calhoun","2020-12-24","9","3217","3","320","31.5","18.2"
"Calhoun","2020-12-25","1","3218","0","320","29.1","17.6"
"Calhoun","2020-12-26","2","3220","0","320","29.1","17.6"
"Calhoun","2020-12-27","3","3223","0","320","14.8","17.6"
"Calhoun","2020-12-28","8","3231","1","321","16.6","18.4"
"Calhoun","2020-12-29","16","3247","1","322","13.9","18.4"
"Calhoun","2020-12-30","13","3260","1","323","8.5","18.9"
"Calhoun","2020-12-31","9","3269","0","323","3.8","17.6"
"Calhoun","2021-01-01","2","3271","1","324","10.9","20"
"Calhoun","2021-01-02","4","3275","0","324","10.9","20"
"Calhoun","2021-01-03","2","3277","0","324","10.9","12.9"
"Calhoun","2021-01-04","35","3312","5","329","11.2","13.9"
"Calhoun","2021-01-05","76","3388","8","337","11.8","12.9"
"Calhoun","2021-01-06","37","3425","5","342","12.6","10.6"
"Calhoun","2021-01-07","24","3449","2","344","13.8","8.8"
"Calhoun","2021-01-08","20","3469","5","349","10.2","10.6"
"Calhoun","2021-01-09","17","3486","3","352","12.8","11.8"
"Calhoun","2021-01-10","43","3529","1","353","13.1","12"
"Calhoun","2021-01-11","28","3557","9","362","15.6","13.4"
"Calhoun","2021-01-12","57","3614","4","366","15.1","13.5"
"Calhoun","2021-01-13","20","3634","3","369","15.4","14"
"Calhoun","2021-01-14","20","3654","2","371","15.6","14.7"
"Calhoun","2021-01-15","29","3683","7","378","15.5","12.9"
"Calhoun","2021-01-16","9","3692","2","380","16.1","14.4"
"Calhoun","2021-01-17","4","3696","0","380","15.8","14.4"
"Calhoun","2021-01-18","26","3722","3","383","12.8","14.2"
"Calhoun","2021-01-19","40","3762","3","386","12.9","14"
"Calhoun","2021-01-20","73","3835","0","386","10.8","13.1"
"Calhoun","2021-01-21","34","3869","2","388","10.2","12.9"
"Calhoun","2021-01-22","21","3890","3","391","8.8","12.1"
"Calhoun","2021-01-23","15","3905","5","396","10.4","13.2"
"Calhoun","2021-01-24","1","3906","0","396","10.4","13.1"
"Calhoun","2021-01-25","33","3939","0","396","8.7","10.8"
"Calhoun","2021-01-26","130","4069","3","399","8","10.4"
"Calhoun","2021-01-27","17","4086","5","404","12.2","11.5"
"Calhoun","2021-01-28","41","4127","4","408","12.7","11.5"
"Calhoun","2021-01-29","22","4149","6","414","14.6","11.7"
"Calhoun","2021-01-30","9","4158","2","416","13","11.7"
"Calhoun","2021-01-31","2","4160","0","416","13","11.7"
"Calhoun","2021-02-01","28","4188","1","417","13.5","11.1"
"Calhoun","2021-02-02","23","4211","3","420","15","11.5"
"Calhoun","2021-02-03","17","4228","1","421","11.7","11.9"
"Calhoun","2021-02-04","24","4252","1","422","10.9","11.8"
"Calhoun","2021-02-05","23","4275","3","425","8.8","11.7"
"Calhoun","2021-02-06","2","4277","1","426","12.8","12.9"
"Calhoun","2021-02-07","3","4280","2","428","22.3","17.7"
"Calhoun","2021-02-08","0","4280","0","428","21.8","17.7"
"Camden","2020-02-01","0","0","0","0",".","."
"Camden","2020-02-02","0","0","0","0",".","."
"Camden","2020-02-03","0","0","0","0",".","."
"Camden","2020-02-04","0","0","0","0",".","."
"Camden","2020-02-05","0","0","0","0",".","."
"Camden","2020-02-06","0","0","0","0",".","."
"Camden","2020-02-07","0","0","0","0","0","."
"Camden","2020-02-08","0","0","0","0","0","."
"Camden","2020-02-09","0","0","0","0","0","."
"Camden","2020-02-10","0","0","0","0","0","."
"Camden","2020-02-11","0","0","0","0","0","."
"Camden","2020-02-12","0","0","0","0","0","."
"Camden","2020-02-13","0","0","0","0","0","."
"Camden","2020-02-14","0","0","0","0","0","0"
"Camden","2020-02-15","0","0","0","0","0","0"
"Camden","2020-02-16","0","0","0","0","0","0"
"Camden","2020-02-17","0","0","0","0","0","0"
"Camden","2020-02-18","0","0","0","0","0","0"
"Camden","2020-02-19","0","0","0","0","0","0"
"Camden","2020-02-20","0","0","0","0","0","0"
"Camden","2020-02-21","0","0","0","0","0","0"
"Camden","2020-02-22","0","0","0","0","0","0"
"Camden","2020-02-23","0","0","0","0","0","0"
"Camden","2020-02-24","0","0","0","0","0","0"
"Camden","2020-02-25","0","0","0","0","0","0"
"Camden","2020-02-26","0","0","0","0","0","0"
"Camden","2020-02-27","0","0","0","0","0","0"
"Camden","2020-02-28","0","0","0","0","0","0"
"Camden","2020-02-29","0","0","0","0","0","0"
"Camden","2020-03-01","0","0","0","0","0","0"
"Camden","2020-03-02","0","0","0","0","0","0"
"Camden","2020-03-03","0","0","0","0","0","0"
"Camden","2020-03-04","0","0","0","0","0","0"
"Camden","2020-03-05","0","0","0","0","0","0"
"Camden","2020-03-06","0","0","0","0","0","0"
"Camden","2020-03-07","0","0","0","0","0","0"
"Camden","2020-03-08","0","0","0","0","0","0"
"Camden","2020-03-09","0","0","0","0","0","0"
"Camden","2020-03-10","0","0","0","0","0","0"
"Camden","2020-03-11","0","0","0","0","0","0"
"Camden","2020-03-12","0","0","0","0","0","0"
"Camden","2020-03-13","3","3","0","0","0","0"
"Camden","2020-03-14","0","3","0","0","0","0"
"Camden","2020-03-15","4","7","0","0","0","0"
"Camden","2020-03-16","4","11","0","0","0","0"
"Camden","2020-03-17","8","19","0","0","0","0"
"Camden","2020-03-18","8","27","0","0","0","0"
"Camden","2020-03-19","8","35","1","1","1.8","0.9"
"Camden","2020-03-20","8","43","1","2","3.6","1.8"
"Camden","2020-03-21","11","54","0","2","3.6","1.8"
"Camden","2020-03-22","2","56","0","2","3.6","1.8"
"Camden","2020-03-23","16","72","3","5","6.3","3.1"
"Camden","2020-03-24","21","93","1","6","6.9","3.5"
"Camden","2020-03-25","30","123","0","6","6.9","3.5"
"Camden","2020-03-26","12","135","1","7","6.3","4.1"
"Camden","2020-03-27","22","157","0","7","4.5","4.1"
"Camden","2020-03-28","8","165","0","7","4.5","4.1"
"Camden","2020-03-29","4","169","1","8","8.1","5.8"
"Camden","2020-03-30","14","183","1","9","6.5","6.4"
"Camden","2020-03-31","11","194","1","10","7.1","7"
"Camden","2020-04-01","8","202","0","10","7.1","7"
"Camden","2020-04-02","14","216","0","10","5.9","6.1"
"Camden","2020-04-03","20","236","0","10","5.9","5.2"
"Camden","2020-04-04","5","241","0","10","5.9","5.2"
"Camden","2020-04-05","1","242","0","10","2.3","5.2"
"Camden","2020-04-06","10","252","0","10","1.3","3.9"
"Camden","2020-04-07","25","277","0","10","0","3.5"
"Camden","2020-04-08","24","301","3","13","1.8","4.4"
"Camden","2020-04-09","25","326","2","15","2.9","4.4"
"Camden","2020-04-10","12","338","0","15","2.9","4.4"
"Camden","2020-04-11","12","350","0","15","2.9","4.4"
"Camden","2020-04-12","2","352","2","17","17.2","9.8"
"Camden","2020-04-13","8","360","2","19","20.8","11"
"Camden","2020-04-14","116","476","2","21","21","10.5"
"Camden","2020-04-15","32","508","0","21","19.2","10.5"
"Camden","2020-04-16","16","524","0","21","18.1","10.5"
"Camden","2020-04-17","18","542","0","21","18.1","10.5"
"Camden","2020-04-18","12","554","0","21","18.1","10.5"
"Camden","2020-04-19","11","565","0","21","3.8","10.5"
"Camden","2020-04-20","5","570","0","21","0.2","10.5"
"Camden","2020-04-21","15","585","1","22","1","11"
"Camden","2020-04-22","20","605","0","22","1","10.1"
"Camden","2020-04-23","14","619","1","23","2","10"
"Camden","2020-04-24","8","627","0","23","2","10"
"Camden","2020-04-25","3","630","0","23","2","10"
"Camden","2020-04-26","1","631","0","23","2","2.9"
"Camden","2020-04-27","5","636","0","23","2","1.1"
"Camden","2020-04-28","17","653","0","23","1","1"
"Camden","2020-04-29","10","663","1","24","2.4","1.7"
"Camden","2020-04-30","17","680","0","24","1.4","1.7"
"Camden","2020-05-01","13","693","1","25","2.5","2.3"
"Camden","2020-05-02","11","704","2","27","5.1","3.5"
"Camden","2020-05-03","1","705","0","27","5.1","3.5"
"Camden","2020-05-04","14","719","0","27","5.1","3.5"
"Camden","2020-05-05","31","750","0","27","5.1","3.1"
"Camden","2020-05-06","20","770","1","28","4.4","3.4"
"Camden","2020-05-07","14","784","1","29","5.4","3.4"
"Camden","2020-05-08","18","802","0","29","4.3","3.4"
"Camden","2020-05-09","26","828","3","32","3.4","4.3"
"Camden","2020-05-10","3","831","0","32","3.4","4.3"
"Camden","2020-05-11","224","1055","3","35","3.6","4.3"
"Camden","2020-05-12","24","1079","0","35","3.6","4.3"
"Camden","2020-05-13","22","1101","1","36","3.5","4"
"Camden","2020-05-14","36","1137","0","36","2.5","4"
"Camden","2020-05-15","42","1179","1","37","2.8","3.6"
"Camden","2020-05-16","39","1218","1","38","1.5","2.5"
"Camden","2020-05-17","6","1224","0","38","1.5","2.5"
"Camden","2020-05-18","158","1382","8","46","2.1","2.8"
"Camden","2020-05-19","30","1412","1","47","2.6","3.1"
"Camden","2020-05-20","19","1431","0","47","1.9","2.7"
"Camden","2020-05-21","20","1451","0","47","1.9","2.2"
"Camden","2020-05-22","23","1474","2","49","2.8","2.8"
"Camden","2020-05-23","10","1484","0","49","2.4","2"
"Camden","2020-05-24","7","1491","0","49","2.4","2"
"Camden","2020-05-25","22","1513","0","49","1.7","1.9"
"Camden","2020-05-26","8","1521","0","49","1.2","1.9"
"Camden","2020-05-27","14","1535","0","49","1.2","1.6"
"Camden","2020-05-28","27","1562","2","51","2.3","2.1"
"Camden","2020-05-29","32","1594","1","52","1.5","2.2"
"Camden","2020-05-30","19","1613","0","52","1.5","2"
"Camden","2020-05-31","5","1618","0","52","1.5","2"
"Camden","2020-06-01","243","1861","3","55","1.7","1.7"
"Camden","2020-06-02","29","1890","0","55","1.7","1.5"
"Camden","2020-06-03","18","1908","1","56","2.5","1.9"
"Camden","2020-06-04","29","1937","1","57","1.9","2.1"
"Camden","2020-06-05","31","1968","0","57","1.5","1.5"
"Camden","2020-06-06","33","2001","0","57","1.5","1.5"
"Camden","2020-06-07","12","2013","0","57","1.5","1.5"
"Camden","2020-06-08","38","2051","1","58","1.7","1.7"
"Camden","2020-06-09","15","2066","1","59","2.6","2.1"
"Camden","2020-06-10","31","2097","0","59","1.8","2.1"
"Camden","2020-06-11","26","2123","0","59","1.3","1.6"
"Camden","2020-06-12","24","2147","1","60","1.9","1.7"
"Camden","2020-06-13","25","2172","0","60","1.9","1.7"
"Camden","2020-06-14","8","2180","1","61","3.7","2.6"
"Camden","2020-06-15","35","2215","0","61","3.3","2.5"
"Camden","2020-06-16","127","2342","4","65","2.8","2.7"
"Camden","2020-06-17","31","2373","4","69","4.7","3.2"
"Camden","2020-06-18","24","2397","2","71","5.9","3.6"
"Camden","2020-06-19","26","2423","4","75","7.5","4.7"
"Camden","2020-06-20","20","2443","0","75","7.5","4.7"
"Camden","2020-06-21","13","2456","0","75","5.7","4.7"
"Camden","2020-06-22","43","2499","3","78","6.7","5"
"Camden","2020-06-23","90","2589","5","83","7","4.9"
"Camden","2020-06-24","107","2696","3","86","5.6","5.1"
"Camden","2020-06-25","33","2729","5","91","6.6","6.2"
"Camden","2020-06-26","37","2766","7","98","7.1","7.3"
"Camden","2020-06-27","29","2795","3","101","8.5","8"
"Camden","2020-06-28","19","2814","0","101","8.5","7.1"
"Camden","2020-06-29","71","2885","5","106","8.5","7.6"
"Camden","2020-06-30","83","2968","7","113","9","8"
"Camden","2020-07-01","164","3132","7","120","9.2","7.4"
"Camden","2020-07-02","184","3316","13","133","8","7.3"
"Camden","2020-07-03","35","3351","6","139","7.8","7.4"
"Camden","2020-07-04","13","3364","2","141","8.5","8.5"
"Camden","2020-07-05","27","3391","5","146","11.1","9.8"
"Camden","2020-07-06","212","3603","13","159","11","9.8"
"Camden","2020-07-07","260","3863","12","171","10.4","9.7"
"Camden","2020-07-08","177","4040","14","185","11","10.1"
"Camden","2020-07-09","145","4185","10","195","10.9","9.5"
"Camden","2020-07-10","127","4312","19","214","10.6","9.2"
"Camden","2020-07-11","74","4386","9","223","10.2","9.3"
"Camden","2020-07-12","39","4425","2","225","8.3","9.7"
"Camden","2020-07-13","126","4551","11","236","8.6","9.8"
"Camden","2020-07-14","268","4819","23","259","9.2","9.8"
"Camden","2020-07-15","163","4982","31","290","10.8","10.9"
"Camden","2020-07-16","361","5343","23","313","10.7","10.8"
"Camden","2020-07-17","103","5446","17","330","10.9","10.8"
"Camden","2020-07-18","83","5529","12","342","11.3","10.7"
"Camden","2020-07-19","30","5559","3","345","12","10.1"
"Camden","2020-07-20","162","5721","22","367","12.6","10.6"
"Camden","2020-07-21","296","6017","26","393","12.7","10.9"
"Camden","2020-07-22","144","6161","12","405","11.1","11"
"Camden","2020-07-23","274","6435","15","420","11","10.9"
"Camden","2020-07-24","212","6647","28","448","10.5","10.7"
"Camden","2020-07-25","30","6677","5","453","10.9","11.1"
"Camden","2020-07-26","31","6708","2","455","10.4","11.2"
"Camden","2020-07-27","224","6932","19","474","9.6","11.1"
"Camden","2020-07-28","306","7238","31","505","9.8","11.2"
"Camden","2020-07-29","229","7467","27","532","10.3","10.7"
"Camden","2020-07-30","271","7738","23","555","10.7","10.9"
"Camden","2020-07-31","150","7888","14","569","10.2","10.4"
"Camden","2020-08-01","51","7939","7","576","9.8","10.3"
"Camden","2020-08-02","34","7973","2","578","9.7","10"
"Camden","2020-08-03","105","8078","14","592","10.4","10"
"Camden","2020-08-04","154","8232","16","608","10.4","10.1"
"Camden","2020-08-05","157","8389","14","622","10","10.2"
"Camden","2020-08-06","218","8607","11","633","9.5","10.1"
"Camden","2020-08-07","189","8796","8","641","8.8","9.5"
"Camden","2020-08-08","53","8849","5","646","8.2","9"
"Camden","2020-08-09","30","8879","5","651","9.7","9.7"
"Camden","2020-08-10","80","8959","14","665","10.3","10.3"
"Camden","2020-08-11","173","9132","18","683","10.3","10.4"
"Camden","2020-08-12","139","9271","4","687","9.5","9.7"
"Camden","2020-08-13","256","9527","25","712","10.1","9.8"
"Camden","2020-08-14","121","9648","11","723","10.8","9.8"
"Camden","2020-08-15","65","9713","6","729","10.8","9.5"
"Camden","2020-08-16","50","9763","3","732","9.3","9.5"
"Camden","2020-08-17","86","9849","12","744","8.8","9.5"
"Camden","2020-08-18","230","10079","16","760","8.3","9.3"
"Camden","2020-08-19","166","10245","10","770","8.7","9.1"
"Camden","2020-08-20","302","10547","16","786","8.1","9.1"
"Camden","2020-08-21","178","10725","14","800","7.9","9.4"
"Camden","2020-08-22","54","10779","6","806","8.2","9.5"
"Camden","2020-08-23","33","10812","7","813","10.3","9.8"
"Camden","2020-08-24","178","10990","9","822","9.1","8.9"
"Camden","2020-08-25","302","11292","14","836","8.7","8.5"
"Camden","2020-08-26","177","11469","3","839","8.1","8.4"
"Camden","2020-08-27","235","11704","16","855","8.3","8.2"
"Camden","2020-08-28","108","11812","7","862","8.1","8"
"Camden","2020-08-29","34","11846","3","865","7.8","8"
"Camden","2020-08-30","25","11871","2","867","5.9","8.1"
"Camden","2020-08-31","74","11945","8","875","6.8","7.9"
"Camden","2020-09-01","158","12103","15","890","7.4","8.1"
"Camden","2020-09-02","153","12256","13","903","8.4","8.3"
"Camden","2020-09-03","206","12462","14","917","8.4","8.4"
"Camden","2020-09-04","97","12559","9","926","8.8","8.5"
"Camden","2020-09-05","38","12597","4","930","9.1","8.4"
"Camden","2020-09-06","27","12624","5","935","10.6","8.2"
"Camden","2020-09-07","42","12666","5","940","10.7","8.7"
"Camden","2020-09-08","205","12871","21","961","10.8","9.1"
"Camden","2020-09-09","182","13053","19","980","11.1","9.8"
"Camden","2020-09-10","202","13255","12","992","11","9.7"
"Camden","2020-09-11","128","13383","8","1000","10.5","9.7"
"Camden","2020-09-12","39","13422","6","1006","11.2","10.1"
"Camden","2020-09-13","33","13455","4","1010","10.3","10.4"
"Camden","2020-09-14","130","13585","15","1025","10.3","10.5"
"Camden","2020-09-15","253","13838","22","1047","10.1","10.4"
"Camden","2020-09-16","43","13881","5","1052","10.2","10.7"
"Camden","2020-09-17","107","13988","13","1065","11.1","11"
"Camden","2020-09-18","126","14114","7","1072","11","10.8"
"Camden","2020-09-19","39","14153","5","1077","10.6","10.9"
"Camden","2020-09-20","24","14177","1","1078","9.5","9.9"
"Camden","2020-09-21","152","14329","10","1088","8.8","9.5"
"Camden","2020-09-22","294","14623","15","1103","8.3","9.2"
"Camden","2020-09-23","137","14760","4","1107","7","8.6"
"Camden","2020-09-24","188","14948","4","1111","5.6","8.4"
"Camden","2020-09-25","91","15039","5","1116","5.6","8.3"
"Camden","2020-09-26","31","15070","4","1120","5.6","8.1"
"Camden","2020-09-27","23","15093","1","1121","5.6","7.6"
"Camden","2020-09-28","51","15144","1","1122","5","6.9"
"Camden","2020-09-29","85","15229","7","1129","5.4","6.9"
"Camden","2020-09-30","71","15300","11","1140","7.2","7.1"
"Camden","2020-10-01","102","15402","3","1143","7.3","6.5"
"Camden","2020-10-02","80","15482","4","1147","7.3","6.4"
"Camden","2020-10-03","25","15507","2","1149","6.6","6.1"
"Camden","2020-10-04","43","15550","2","1151","6.6","6.1"
"Camden","2020-10-05","87","15637","2","1153","6.7","5.8"
"Camden","2020-10-06","140","15777","5","1158","6","5.7"
"Camden","2020-10-07","147","15924","6","1164","4.4","5.8"
"Camden","2020-10-08","119","16043","8","1172","4.9","6.1"
"Camden","2020-10-09","70","16113","4","1176","5","6.1"
"Camden","2020-10-10","46","16159","2","1178","4.5","5.5"
"Camden","2020-10-11","30","16189","1","1179","4.3","5.5"
"Camden","2020-10-12","49","16238","2","1181","4.6","5.6"
"Camden","2020-10-13","124","16362","4","1185","4.5","5.2"
"Camden","2020-10-14","83","16445","5","1190","4.8","4.6"
"Camden","2020-10-15","80","16525","2","1192","4.2","4.5"
"Camden","2020-10-16","154","16679","3","1195","3.6","4.3"
"Camden","2020-10-17","55","16734","2","1197","3.5","4"
"Camden","2020-10-18","29","16763","4","1201","5","4.7"
"Camden","2020-10-19","153","16916","2","1203","4.6","4.6"
"Camden","2020-10-20","201","17117","3","1206","4.4","4.4"
"Camden","2020-10-21","139","17256","4","1210","3.9","4.4"
"Camden","2020-10-22","89","17345","6","1216","4.5","4.4"
"Camden","2020-10-23","79","17424","6","1222","5.3","4.5"
"Camden","2020-10-24","31","17455","6","1228","7.6","5.6"
"Camden","2020-10-25","29","17484","2","1230","6.6","5.8"
"Camden","2020-10-26","87","17571","12","1242","8.4","6.5"
"Camden","2020-10-27","152","17723","18","1260","9.9","7.1"
"Camden","2020-10-28","72","17795","6","1266","10.7","7.3"
"Camden","2020-10-29","93","17888","6","1272","10.6","7.6"
"Camden","2020-10-30","127","18015","6","1278","10.2","7.8"
"Camden","2020-10-31","44","18059","3","1281","8.4","8"
"Camden","2020-11-01","37","18096","2","1283","8.2","7.4"
"Camden","2020-11-02","160","18256","4","1287","6.6","7.5"
"Camden","2020-11-03","132","18388","14","1301","6.4","8.1"
"Camden","2020-11-04","189","18577","9","1310","5.9","8.3"
"Camden","2020-11-05","129","18706","6","1316","5.6","8.1"
"Camden","2020-11-06","106","18812","8","1324","6","8.1"
"Camden","2020-11-07","65","18877","7","1331","6.6","7.5"
"Camden","2020-11-08","51","18928","7","1338","7.8","8"
"Camden","2020-11-09","114","19042","11","1349","8.8","7.7"
"Camden","2020-11-10","183","19225","14","1363","8.4","7.4"
"Camden","2020-11-11","92","19317","8","1371","9","7.4"
"Camden","2020-11-12","113","19430","15","1386","10.2","7.9"
"Camden","2020-11-13","152","19582","14","1400","10.4","8.2"
"Camden","2020-11-14","62","19644","4","1404","9.8","8.2"
"Camden","2020-11-15","46","19690","6","1410","9.7","8.8"
"Camden","2020-11-16","143","19833","16","1426","9.9","9.4"
"Camden","2020-11-17","290","20123","29","1455","10.3","9.3"
"Camden","2020-11-18","207","20330","12","1467","9.9","9.4"
"Camden","2020-11-19","160","20490","23","1490","10","10.1"
"Camden","2020-11-20","137","20627","20","1510","10.8","10.6"
"Camden","2020-11-21","77","20704","13","1523","12.3","11"
"Camden","2020-11-22","60","20764","3","1526","11.1","10.4"
"Camden","2020-11-23","114","20878","8","1534","10.5","10.2"
"Camden","2020-11-24","187","21065","10","1544","9.9","10.1"
"Camden","2020-11-25","135","21200","7","1551","9.8","9.8"
"Camden","2020-11-26","14","21214","2","1553","9.8","9.9"
"Camden","2020-11-27","107","21321","22","1575","10.6","10.7"
"Camden","2020-11-28","84","21405","9","1584","9.7","11"
"Camden","2020-11-29","39","21444","6","1590","11.2","11.2"
"Camden","2020-11-30","328","21772","16","1606","10.9","10.7"
"Camden","2020-12-01","235","22007","15","1621","11.1","10.5"
"Camden","2020-12-02","203","22210","10","1631","11","10.4"
"Camden","2020-12-03","156","22366","14","1645","10.3","10"
"Camden","2020-12-04","130","22496","17","1662","9.2","9.9"
"Camden","2020-12-05","61","22557","2","1664","8.1","8.9"
"Camden","2020-12-06","46","22603","6","1670","7.8","9.5"
"Camden","2020-12-07","245","22848","16","1686","8","9.5"
"Camden","2020-12-08","243","23091","19","1705","8.2","9.6"
"Camden","2020-12-09","112","23203","21","1726","10.2","10.6"
"Camden","2020-12-10","124","23327","16","1742","10.8","10.5"
"Camden","2020-12-11","211","23538","13","1755","9.8","9.5"
"Camden","2020-12-12","80","23618","11","1766","11.3","9.7"
"Camden","2020-12-13","39","23657","7","1773","12","9.9"
"Camden","2020-12-14","425","24082","23","1796","11.8","9.9"
"Camden","2020-12-15","243","24325","18","1814","11.8","10"
"Camden","2020-12-16","209","24534","21","1835","10.5","10.4"
"Camden","2020-12-17","150","24684","16","1851","10.2","10.5"
"Camden","2020-12-18","152","24836","14","1865","10.6","10.2"
"Camden","2020-12-19","71","24907","10","1875","10.7","11"
"Camden","2020-12-20","59","24966","8","1883","10.1","11"
"Camden","2020-12-21","145","25111","25","1908","11.7","11.8"
"Camden","2020-12-22","300","25411","40","1948","12.6","12.2"
"Camden","2020-12-23","125","25536","16","1964","13","11.8"
"Camden","2020-12-24","86","25622","8","1972","12.8","11.5"
"Camden","2020-12-25","16","25638","2","1974","13.3","11.9"
"Camden","2020-12-26","64","25702","18","1992","15.3","13"
"Camden","2020-12-27","54","25756","17","2009","17.8","13.9"
"Camden","2020-12-28","199","25955","33","2042","17.7","14.7"
"Camden","2020-12-29","322","26277","50","2092","18","15.3"
"Camden","2020-12-30","164","26441","30","2122","18.8","15.9"
"Camden","2020-12-31","121","26562","16","2138","19.4","16.1"
"Camden","2021-01-01","57","26619","7","2145","19.4","16.3"
"Camden","2021-01-02","49","26668","6","2151","17.1","16.2"
"Camden","2021-01-03","64","26732","18","2169","16.6","17.2"
"Camden","2021-01-04","183","26915","37","2206","17.1","17.4"
"Camden","2021-01-05","450","27365","47","2253","16.4","17.2"
"Camden","2021-01-06","212","27577","20","2273","15.1","17"
"Camden","2021-01-07","169","27746","15","2288","14.5","17"
"Camden","2021-01-08","235","27981","22","2310","14.1","16.7"
"Camden","2021-01-09","63","28044","14","2324","15.5","16.3"
"Camden","2021-01-10","70","28114","11","2335","13.8","15.2"
"Camden","2021-01-11","143","28257","24","2359","13.3","15.2"
"Camden","2021-01-12","315","28572","32","2391","13.2","14.8"
"Camden","2021-01-13","160","28732","22","2413","13.8","14.5"
"Camden","2021-01-14","152","28884","17","2430","14.2","14.3"
"Camden","2021-01-15","284","29168","23","2453","14","14"
"Camden","2021-01-16","57","29225","12","2465","13.8","14.7"
"Camden","2021-01-17","60","29285","12","2477","14.4","14.1"
"Camden","2021-01-18","116","29401","18","2495","14.3","13.8"
"Camden","2021-01-19","411","29812","34","2529","14","13.6"
"Camden","2021-01-20","228","30040","21","2550","13.3","13.6"
"Camden","2021-01-21","234","30274","20","2570","13","13.6"
"Camden","2021-01-22","199","30473","17","2587","13","13.5"
"Camden","2021-01-23","51","30524","10","2597","12.8","13.3"
"Camden","2021-01-24","50","30574","5","2602","11.4","12.9"
"Camden","2021-01-25","175","30749","25","2627","11.2","12.7"
"Camden","2021-01-26","285","31034","41","2668","12.1","13"
"Camden","2021-01-27","121","31155","12","2680","12.2","12.8"
"Camden","2021-01-28","133","31288","12","2692","12.3","12.6"
"Camden","2021-01-29","185","31473","18","2710","12.4","12.7"
"Camden","2021-01-30","50","31523","8","2718","11.9","12.4"
"Camden","2021-01-31","39","31562","5","2723","12.3","11.8"
"Camden","2021-02-01","142","31704","18","2741","12.1","11.6"
"Camden","2021-02-02","150","31854","18","2759","11.7","11.9"
"Camden","2021-02-03","116","31970","10","2769","11.6","11.9"
"Camden","2021-02-04","166","32136","13","2782","11.4","11.8"
"Camden","2021-02-05","165","32301","6","2788","10.5","11.5"
"Camden","2021-02-06","8","32309","2","2790","11.8","11.9"
"Camden","2021-02-07","7","32316","0","2790","10","11.1"
"Camden","2021-02-08","0","32316","0","2790","8.2","10.1"
"Candler","2020-02-01","0","0","0","0",".","."
"Candler","2020-02-02","0","0","0","0",".","."
"Candler","2020-02-03","0","0","0","0",".","."
"Candler","2020-02-04","0","0","0","0",".","."
"Candler","2020-02-05","0","0","0","0",".","."
"Candler","2020-02-06","0","0","0","0",".","."
"Candler","2020-02-07","0","0","0","0","0","."
"Candler","2020-02-08","0","0","0","0","0","."
"Candler","2020-02-09","0","0","0","0","0","."
"Candler","2020-02-10","0","0","0","0","0","."
"Candler","2020-02-11","0","0","0","0","0","."
"Candler","2020-02-12","0","0","0","0","0","."
"Candler","2020-02-13","0","0","0","0","0","."
"Candler","2020-02-14","0","0","0","0","0","0"
"Candler","2020-02-15","0","0","0","0","0","0"
"Candler","2020-02-16","0","0","0","0","0","0"
"Candler","2020-02-17","0","0","0","0","0","0"
"Candler","2020-02-18","0","0","0","0","0","0"
"Candler","2020-02-19","0","0","0","0","0","0"
"Candler","2020-02-20","0","0","0","0","0","0"
"Candler","2020-02-21","0","0","0","0","0","0"
"Candler","2020-02-22","0","0","0","0","0","0"
"Candler","2020-02-23","0","0","0","0","0","0"
"Candler","2020-02-24","0","0","0","0","0","0"
"Candler","2020-02-25","0","0","0","0","0","0"
"Candler","2020-02-26","0","0","0","0","0","0"
"Candler","2020-02-27","0","0","0","0","0","0"
"Candler","2020-02-28","0","0","0","0","0","0"
"Candler","2020-02-29","0","0","0","0","0","0"
"Candler","2020-03-01","0","0","0","0","0","0"
"Candler","2020-03-02","0","0","0","0","0","0"
"Candler","2020-03-03","0","0","0","0","0","0"
"Candler","2020-03-04","0","0","0","0","0","0"
"Candler","2020-03-05","0","0","0","0","0","0"
"Candler","2020-03-06","0","0","0","0","0","0"
"Candler","2020-03-07","0","0","0","0","0","0"
"Candler","2020-03-08","0","0","0","0","0","0"
"Candler","2020-03-09","0","0","0","0","0","0"
"Candler","2020-03-10","0","0","0","0","0","0"
"Candler","2020-03-11","0","0","0","0","0","0"
"Candler","2020-03-12","0","0","0","0","0","0"
"Candler","2020-03-13","0","0","0","0","0","0"
"Candler","2020-03-14","0","0","0","0","0","0"
"Candler","2020-03-15","0","0","0","0","0","0"
"Candler","2020-03-16","1","1","0","0","0","0"
"Candler","2020-03-17","1","2","0","0","0","0"
"Candler","2020-03-18","0","2","0","0","0","0"
"Candler","2020-03-19","2","4","0","0","0","0"
"Candler","2020-03-20","3","7","0","0","0","0"
"Candler","2020-03-21","1","8","0","0","0","0"
"Candler","2020-03-22","0","8","0","0","0","0"
"Candler","2020-03-23","5","13","1","1","2.9","1.4"
"Candler","2020-03-24","1","14","0","1","2.9","1.4"
"Candler","2020-03-25","2","16","0","1","2.9","1.4"
"Candler","2020-03-26","2","18","0","1","2.9","1.4"
"Candler","2020-03-27","0","18","0","1","2.9","1.4"
"Candler","2020-03-28","0","18","0","1","2.9","1.4"
"Candler","2020-03-29","0","18","0","1","2.9","1.4"
"Candler","2020-03-30","3","21","1","2","4.8","3.8"
"Candler","2020-03-31","2","23","0","2","4.8","3.8"
"Candler","2020-04-01","3","26","0","2","4.8","3.8"
"Candler","2020-04-02","4","30","0","2","4.8","3.8"
"Candler","2020-04-03","0","30","0","2","4.8","3.8"
"Candler","2020-04-04","0","30","0","2","4.8","3.8"
"Candler","2020-04-05","0","30","0","2","4.8","3.8"
"Candler","2020-04-06","5","35","0","2","0","2.4"
"Candler","2020-04-07","5","40","0","2","0","2.4"
"Candler","2020-04-08","0","40","0","2","0","2.4"
"Candler","2020-04-09","1","41","0","2","0","2.4"
"Candler","2020-04-10","1","42","0","2","0","2.4"
"Candler","2020-04-11","0","42","0","2","0","2.4"
"Candler","2020-04-12","0","42","0","2","0","2.4"
"Candler","2020-04-13","1","43","0","2","0","0"
"Candler","2020-04-14","2","45","0","2","0","0"
"Candler","2020-04-15","1","46","0","2","0","0"
"Candler","2020-04-16","2","48","0","2","0","0"
"Candler","2020-04-17","9","57","0","2","0","0"
"Candler","2020-04-18","1","58","0","2","0","0"
"Candler","2020-04-19","0","58","0","2","0","0"
"Candler","2020-04-20","3","61","0","2","0","0"
"Candler","2020-04-21","2","63","0","2","0","0"
"Candler","2020-04-22","0","63","0","2","0","0"
"Candler","2020-04-23","4","67","1","3","3.6","1.8"
"Candler","2020-04-24","1","68","0","3","3.6","1.8"
"Candler","2020-04-25","1","69","0","3","3.6","1.8"
"Candler","2020-04-26","1","70","0","3","3.6","1.8"
"Candler","2020-04-27","3","73","0","3","3.6","1.8"
"Candler","2020-04-28","1","74","0","3","3.6","1.8"
"Candler","2020-04-29","0","74","0","3","3.6","1.8"
"Candler","2020-04-30","1","75","0","3","0","1.8"
"Candler","2020-05-01","0","75","0","3","0","1.8"
"Candler","2020-05-02","1","76","0","3","0","1.8"
"Candler","2020-05-03","1","77","1","4","14.3","8.9"
"Candler","2020-05-04","4","81","0","4","14.3","8.9"
"Candler","2020-05-05","1","82","0","4","14.3","8.9"
"Candler","2020-05-06","3","85","0","4","14.3","8.9"
"Candler","2020-05-07","8","93","0","4","14.3","7.1"
"Candler","2020-05-08","2","95","1","5","21.4","10.7"
"Candler","2020-05-09","0","95","0","5","21.4","10.7"
"Candler","2020-05-10","1","96","1","6","21.4","17.9"
"Candler","2020-05-11","4","100","0","6","21.4","17.9"
"Candler","2020-05-12","1","101","0","6","21.4","17.9"
"Candler","2020-05-13","1","102","0","6","21.4","17.9"
"Candler","2020-05-14","4","106","0","6","21.4","17.9"
"Candler","2020-05-15","4","110","0","6","14.3","17.9"
"Candler","2020-05-16","0","110","0","6","14.3","17.9"
"Candler","2020-05-17","0","110","0","6","0","10.7"
"Candler","2020-05-18","5","115","0","6","0","10.7"
"Candler","2020-05-19","3","118","0","6","0","10.7"
"Candler","2020-05-20","2","120","0","6","0","10.7"
"Candler","2020-05-21","118","238","0","6","0","10.7"
"Candler","2020-05-22","8","246","0","6","0","7.1"
"Candler","2020-05-23","0","246","0","6","0","7.1"
"Candler","2020-05-24","19","265","0","6","0","0"
"Candler","2020-05-25","1","266","0","6","0","0"
"Candler","2020-05-26","8","274","0","6","0","0"
"Candler","2020-05-27","2","276","0","6","0","0"
"Candler","2020-05-28","2","278","0","6","0","0"
"Candler","2020-05-29","8","286","0","6","0","0"
"Candler","2020-05-30","0","286","0","6","0","0"
"Candler","2020-05-31","0","286","0","6","0","0"
"Candler","2020-06-01","6","292","1","7","2.4","1.2"
"Candler","2020-06-02","1","293","0","7","2.4","1.2"
"Candler","2020-06-03","1","294","0","7","2.4","1.2"
"Candler","2020-06-04","5","299","0","7","2.4","1.2"
"Candler","2020-06-05","8","307","0","7","2.4","1.2"
"Candler","2020-06-06","1","308","0","7","2.4","1.2"
"Candler","2020-06-07","0","308","0","7","2.4","1.2"
"Candler","2020-06-08","4","312","0","7","0","1.2"
"Candler","2020-06-09","4","316","0","7","0","1.2"
"Candler","2020-06-10","15","331","0","7","0","1.2"
"Candler","2020-06-11","4","335","0","7","0","1.2"
"Candler","2020-06-12","5","340","0","7","0","1.2"
"Candler","2020-06-13","2","342","0","7","0","1.2"
"Candler","2020-06-14","0","342","0","7","0","1.2"
"Candler","2020-06-15","4","346","1","8","3.6","1.8"
"Candler","2020-06-16","2","348","0","8","3.6","1.8"
"Candler","2020-06-17","5","353","1","9","6.4","3.2"
"Candler","2020-06-18","27","380","3","12","8","4"
"Candler","2020-06-19","10","390","1","13","9.4","4.7"
"Candler","2020-06-20","4","394","0","13","9.4","4.7"
"Candler","2020-06-21","0","394","0","13","9.4","4.7"
"Candler","2020-06-22","24","418","3","16","7.7","5.6"
"Candler","2020-06-23","18","436","4","20","10.8","7.2"
"Candler","2020-06-24","66","502","6","26","9.3","7.9"
"Candler","2020-06-25","13","515","4","30","12.1","10"
"Candler","2020-06-26","10","525","1","31","12.1","10.8"
"Candler","2020-06-27","3","528","0","31","12.1","10.8"
"Candler","2020-06-28","1","529","0","31","12.1","10.8"
"Candler","2020-06-29","38","567","5","36","12.2","9.9"
"Candler","2020-06-30","27","594","6","42","12.2","11.5"
"Candler","2020-07-01","18","612","2","44","12.5","10.9"
"Candler","2020-07-02","37","649","2","46","8.8","10.5"
"Candler","2020-07-03","15","664","4","50","11.2","11.7"
"Candler","2020-07-04","1","665","1","51","25.5","18.8"
"Candler","2020-07-05","4","669","3","54","36.2","24.2"
"Candler","2020-07-06","38","707","5","59","36.2","24.2"
"Candler","2020-07-07","27","734","6","65","36.2","24.2"
"Candler","2020-07-08","28","762","8","73","38.7","25.6"
"Candler","2020-07-09","18","780","7","80","43.5","26.2"
"Candler","2020-07-10","20","800","2","82","41.1","26.2"
"Candler","2020-07-11","1","801","0","82","26.8","26.2"
"Candler","2020-07-12","3","804","2","84","25.6","30.9"
"Candler","2020-07-13","35","839","9","93","27.4","31.8"
"Candler","2020-07-14","30","869","6","99","27.1","31.7"
"Candler","2020-07-15","29","898","13","112","29.4","34.1"
"Candler","2020-07-16","27","925","7","119","27.6","35.5"
"Candler","2020-07-17","30","955","9","128","30.4","35.8"
"Candler","2020-07-18","5","960","0","128","30.4","28.6"
"Candler","2020-07-19","3","963","1","129","25.7","25.7"
"Candler","2020-07-20","53","1016","16","145","26.3","26.9"
"Candler","2020-07-21","36","1052","7","152","26.2","26.7"
"Candler","2020-07-22","46","1098","7","159","22","25.7"
"Candler","2020-07-23","37","1135","6","165","20.6","24.1"
"Candler","2020-07-24","18","1153","5","170","20.3","25.4"
"Candler","2020-07-25","1","1154","0","170","20.3","25.4"
"Candler","2020-07-26","6","1160","3","173","22.7","24.2"
"Candler","2020-07-27","25","1185","8","181","23","24.6"
"Candler","2020-07-28","18","1203","5","186","24.1","25.2"
"Candler","2020-07-29","33","1236","6","192","24.6","23.3"
"Candler","2020-07-30","10","1246","3","195","26.5","23.6"
"Candler","2020-07-31","18","1264","2","197","24.2","22.2"
"Candler","2020-08-01","13","1277","1","198","25.3","22.8"
"Candler","2020-08-02","2","1279","0","198","18.1","20.4"
"Candler","2020-08-03","15","1294","2","200","15.4","19.2"
"Candler","2020-08-04","6","1300","0","200","11.5","17.8"
"Candler","2020-08-05","23","1323","6","206","12.6","18.6"
"Candler","2020-08-06","11","1334","4","210","13.5","20"
"Candler","2020-08-07","13","1347","0","210","11.9","18"
"Candler","2020-08-08","6","1353","0","210","10.8","18"
"Candler","2020-08-09","3","1356","1","211","15.6","16.8"
"Candler","2020-08-10","9","1365","3","214","18.4","16.9"
"Candler","2020-08-11","8","1373","3","217","23.8","17.6"
"Candler","2020-08-12","14","1387","4","221","24.2","18.4"
"Candler","2020-08-13","5","1392","2","223","24.7","19.1"
"Candler","2020-08-14","8","1400","0","223","24.7","18.3"
"Candler","2020-08-15","5","1405","4","227","36.1","23.5"
"Candler","2020-08-16","15","1420","6","233","37.1","26.3"
"Candler","2020-08-17","16","1436","2","235","34.1","26.3"
"Candler","2020-08-18","17","1453","3","238","31.2","27.5"
"Candler","2020-08-19","13","1466","1","239","28.3","26.2"
"Candler","2020-08-20","45","1511","1","240","22.9","23.8"
"Candler","2020-08-21","23","1534","3","243","24.7","24.7"
"Candler","2020-08-22","2","1536","1","244","20.4","28.3"
"Candler","2020-08-23","2","1538","0","244","14.7","25.9"
"Candler","2020-08-24","27","1565","11","255","18.8","26.4"
"Candler","2020-08-25","19","1584","9","264","23","27.1"
"Candler","2020-08-26","22","1606","5","269","25.2","26.7"
"Candler","2020-08-27","20","1626","2","271","26.3","24.6"
"Candler","2020-08-28","27","1653","8","279","28.6","26.7"
"Candler","2020-08-29","6","1659","0","279","21.5","21"
"Candler","2020-08-30","7","1666","4","283","29.7","22.2"
"Candler","2020-08-31","14","1680","2","285","25.9","22.3"
"Candler","2020-09-01","19","1699","4","289","22.1","22.6"
"Candler","2020-09-02","22","1721","8","297","24.1","24.6"
"Candler","2020-09-03","26","1747","3","300","24.3","25.3"
"Candler","2020-09-04","27","1774","1","301","20.6","24.6"
"Candler","2020-09-05","5","1779","2","303","26.3","23.9"
"Candler","2020-09-06","2","1781","1","304","25.3","27.5"
"Candler","2020-09-07","2","1783","2","306","37.5","31.7"
"Candler","2020-09-08","16","1799","5","311","39","30.5"
"Candler","2020-09-09","13","1812","2","313","36","30"
"Candler","2020-09-10","43","1855","1","314","34.7","29.5"
"Candler","2020-09-11","11","1866","2","316","36.7","28.7"
"Candler","2020-09-12","1","1867","0","316","31","28.7"
"Candler","2020-09-13","1","1868","1","317","38.2","31.7"
"Candler","2020-09-14","12","1880","2","319","26.3","31.9"
"Candler","2020-09-15","12","1892","4","323","26.6","32.8"
"Candler","2020-09-16","6","1898","4","327","33.9","34.9"
"Candler","2020-09-17","34","1932","9","336","37.3","36"
"Candler","2020-09-18","4","1936","1","337","38.3","37.5"
"Candler","2020-09-19","1","1937","0","337","38.3","34.7"
"Candler","2020-09-20","2","1939","0","337","24","31.1"
"Candler","2020-09-21","16","1955","5","342","26.1","26.2"
"Candler","2020-09-22","13","1968","0","342","21.3","23.9"
"Candler","2020-09-23","4","1972","2","344","19","26.4"
"Candler","2020-09-24","32","2004","4","348","17","27.1"
"Candler","2020-09-25","18","2022","4","352","16.6","27.4"
"Candler","2020-09-26","4","2026","1","353","20.1","29.2"
"Candler","2020-09-27","0","2026","0","353","20.1","22.1"
"Candler","2020-09-28","3","2029","0","353","15.7","20.9"
"Candler","2020-09-29","19","2048","4","357","18.7","20"
"Candler","2020-09-30","20","2068","3","360","13.7","16.3"
"Candler","2020-10-01","32","2100","3","363","13.2","15.1"
"Candler","2020-10-02","5","2105","1","364","12.9","14.7"
"Candler","2020-10-03","1","2106","0","364","9.3","14.7"
"Candler","2020-10-04","8","2114","1","365","11.1","15.6"
"Candler","2020-10-05","13","2127","5","370","16.6","16.2"
"Candler","2020-10-06","7","2134","1","371","15.7","17.2"
"Candler","2020-10-07","5","2139","1","372","16.4","15"
"Candler","2020-10-08","46","2185","10","382","18.1","15.7"
"Candler","2020-10-09","6","2191","2","384","20","16.5"
"Candler","2020-10-10","2","2193","0","384","20","14.7"
"Candler","2020-10-11","2","2195","0","384","18.3","14.7"
"Candler","2020-10-12","4","2199","0","384","12.8","14.7"
"Candler","2020-10-13","4","2203","1","385","14.3","15"
"Candler","2020-10-14","2","2205","2","387","25.7","21"
"Candler","2020-10-15","33","2238","5","392","24.8","21.5"
"Candler","2020-10-16","5","2243","2","394","25.7","22.9"
"Candler","2020-10-17","3","2246","0","394","25.7","22.9"
"Candler","2020-10-18","3","2249","2","396","35.3","26.8"
"Candler","2020-10-19","3","2252","0","396","35.3","24"
"Candler","2020-10-20","4","2256","1","397","35.3","24.8"
"Candler","2020-10-21","4","2260","1","398","24.5","25.1"
"Candler","2020-10-22","24","2284","3","401","24.2","24.5"
"Candler","2020-10-23","4","2288","2","403","25.6","25.7"
"Candler","2020-10-24","3","2291","1","404","30.4","28"
"Candler","2020-10-25","1","2292","0","404","20.8","28"
"Candler","2020-10-26","2","2294","0","404","20.8","28"
"Candler","2020-10-27","3","2297","1","405","22","28.6"
"Candler","2020-10-28","4","2301","0","405","18.5","21.5"
"Candler","2020-10-29","28","2329","1","406","17.2","20.7"
"Candler","2020-10-30","2","2331","0","406","10","17.8"
"Candler","2020-10-31","2","2333","0","406","5.3","17.8"
"Candler","2020-11-01","0","2333","0","406","5.3","13.1"
"Candler","2020-11-02","6","2339","1","407","7.7","14.2"
"Candler","2020-11-03","3","2342","0","407","2.9","12.5"
"Candler","2020-11-04","6","2348","0","407","2.9","10.7"
"Candler","2020-11-05","21","2369","3","410","4.4","10.8"
"Candler","2020-11-06","4","2373","0","410","4.4","7.2"
"Candler","2020-11-07","2","2375","0","410","4.4","4.8"
"Candler","2020-11-08","1","2376","0","410","4.4","4.8"
"Candler","2020-11-09","5","2381","0","410","2","4.8"
"Candler","2020-11-10","3","2384","0","410","2","2.5"
"Candler","2020-11-11","3","2387","0","410","2","2.5"
"Candler","2020-11-12","20","2407","1","411","0.7","2.6"
"Candler","2020-11-13","4","2411","0","411","0.7","2.6"
"Candler","2020-11-14","0","2411","0","411","0.7","2.6"
"Candler","2020-11-15","1","2412","1","412","15","9.7"
"Candler","2020-11-16","2","2414","0","412","15","8.5"
"Candler","2020-11-17","7","2421","0","412","15","8.5"
"Candler","2020-11-18","7","2428","0","412","15","8.5"
"Candler","2020-11-19","6","2434","0","412","14.3","7.5"
"Candler","2020-11-20","6","2440","0","412","14.3","7.5"
"Candler","2020-11-21","2","2442","0","412","14.3","7.5"
"Candler","2020-11-22","2","2444","0","412","0","7.5"
"Candler","2020-11-23","5","2449","0","412","0","7.5"
"Candler","2020-11-24","6","2455","0","412","0","7.5"
"Candler","2020-11-25","2","2457","0","412","0","7.5"
"Candler","2020-11-26","0","2457","0","412","0","7.1"
"Candler","2020-11-27","1","2458","0","412","0","7.1"
"Candler","2020-11-28","2","2460","0","412","0","7.1"
"Candler","2020-11-29","0","2460","0","412","0","0"
"Candler","2020-11-30","2","2462","0","412","0","0"
"Candler","2020-12-01","6","2468","0","412","0","0"
"Candler","2020-12-02","2","2470","0","412","0","0"
"Candler","2020-12-03","10","2480","3","415","4.3","2.1"
"Candler","2020-12-04","3","2483","2","417","13.8","6.9"
"Candler","2020-12-05","1","2484","0","417","13.8","6.9"
"Candler","2020-12-06","3","2487","0","417","13.8","6.9"
"Candler","2020-12-07","7","2494","1","418","15.9","7.9"
"Candler","2020-12-08","3","2497","0","418","15.9","7.9"
"Candler","2020-12-09","8","2505","0","418","15.9","7.9"
"Candler","2020-12-10","5","2510","0","418","11.6","7.9"
"Candler","2020-12-11","5","2515","1","419","4.9","9.4"
"Candler","2020-12-12","1","2516","0","419","4.9","9.4"
"Candler","2020-12-13","2","2518","0","419","4.9","9.4"
"Candler","2020-12-14","3","2521","1","420","7.6","11.7"
"Candler","2020-12-15","6","2527","0","420","7.6","11.7"
"Candler","2020-12-16","4","2531","3","423","18.3","17.1"
"Candler","2020-12-17","37","2568","3","426","19.5","15.5"
"Candler","2020-12-18","7","2575","0","426","16.6","10.8"
"Candler","2020-12-19","6","2581","1","427","19","12"
"Candler","2020-12-20","7","2588","1","428","21.1","13"
"Candler","2020-12-21","13","2601","0","428","16.3","12"
"Candler","2020-12-22","9","2610","1","429","17.9","12.8"
"Candler","2020-12-23","5","2615","0","429","7.2","12.8"
"Candler","2020-12-24","5","2620","0","429","6","12.8"
"Candler","2020-12-25","0","2620","0","429","6","11.3"
"Candler","2020-12-26","2","2622","1","430","10.8","14.9"
"Candler","2020-12-27","0","2622","0","430","8.7","14.9"
"Candler","2020-12-28","9","2631","5","435","16.7","16.5"
"Candler","2020-12-29","9","2640","1","436","16.7","17.3"
"Candler","2020-12-30","9","2649","3","439","21.4","14.3"
"Candler","2020-12-31","5","2654","2","441","27.1","16.6"
"Candler","2021-01-01","1","2655","0","441","27.1","16.6"
"Candler","2021-01-02","0","2655","0","441","20","15.4"
"Candler","2021-01-03","4","2659","2","443","27.1","17.9"
"Candler","2021-01-04","11","2670","9","452","30.9","23.8"
"Candler","2021-01-05","9","2679","1","453","30.9","23.8"
"Candler","2021-01-06","5","2684","1","454","29","25.2"
"Candler","2021-01-07","49","2733","6","460","25","26.1"
"Candler","2021-01-08","8","2741","3","463","30.4","28.8"
"Candler","2021-01-09","6","2747","4","467","39.9","30"
"Candler","2021-01-10","7","2754","4","471","40.9","34"
"Candler","2021-01-11","5","2759","1","472","32.1","31.5"
"Candler","2021-01-12","12","2771","5","477","36.5","33.7"
"Candler","2021-01-13","8","2779","2","479","37.2","33.1"
"Candler","2021-01-14","36","2815","6","485","37.8","31.4"
"Candler","2021-01-15","6","2821","1","486","34.8","32.6"
"Candler","2021-01-16","4","2825","4","490","39.6","39.7"
"Candler","2021-01-17","3","2828","0","490","31.4","36.2"
"Candler","2021-01-18","7","2835","2","492","32.7","32.4"
"Candler","2021-01-19","14","2849","5","497","31.8","34.1"
"Candler","2021-01-20","11","2860","1","498","29.5","33.4"
"Candler","2021-01-21","120","2980","17","515","29.2","33.5"
"Candler","2021-01-22","7","2987","1","516","28.8","31.8"
"Candler","2021-01-23","3","2990","1","517","19.3","29.5"
"Candler","2021-01-24","0","2990","0","517","19.3","25.4"
"Candler","2021-01-25","10","3000","1","518","16.7","24.7"
"Candler","2021-01-26","9","3009","0","518","11.6","21.7"
"Candler","2021-01-27","7","3016","0","518","10.3","19.9"
"Candler","2021-01-28","28","3044","1","519","8.7","19"
"Candler","2021-01-29","7","3051","1","520","8.7","18.8"
"Candler","2021-01-30","2","3053","0","520","4","11.6"
"Candler","2021-01-31","1","3054","0","520","4","11.6"
"Candler","2021-02-01","10","3064","0","520","2.6","9.6"
"Candler","2021-02-02","5","3069","1","521","5.4","8.5"
"Candler","2021-02-03","8","3077","0","521","5.4","7.8"
"Candler","2021-02-04","23","3100","1","522","5.5","7.1"
"Candler","2021-02-05","10","3110","2","524","6.3","7.5"
"Candler","2021-02-06","0","3110","0","524","6.3","5.2"
"Candler","2021-02-07","0","3110","0","524","6.3","5.2"
"Candler","2021-02-08","0","3110","0","524","6.3","4.4"
"Carroll","2020-02-01","0","0","0","0",".","."
"Carroll","2020-02-02","0","0","0","0",".","."
"Carroll","2020-02-03","0","0","0","0",".","."
"Carroll","2020-02-04","0","0","0","0",".","."
"Carroll","2020-02-05","0","0","0","0",".","."
"Carroll","2020-02-06","0","0","0","0",".","."
"Carroll","2020-02-07","0","0","0","0","0","."
"Carroll","2020-02-08","0","0","0","0","0","."
"Carroll","2020-02-09","0","0","0","0","0","."
"Carroll","2020-02-10","0","0","0","0","0","."
"Carroll","2020-02-11","0","0","0","0","0","."
"Carroll","2020-02-12","0","0","0","0","0","."
"Carroll","2020-02-13","0","0","0","0","0","."
"Carroll","2020-02-14","0","0","0","0","0","0"
"Carroll","2020-02-15","0","0","0","0","0","0"
"Carroll","2020-02-16","0","0","0","0","0","0"
"Carroll","2020-02-17","0","0","0","0","0","0"
"Carroll","2020-02-18","0","0","0","0","0","0"
"Carroll","2020-02-19","0","0","0","0","0","0"
"Carroll","2020-02-20","0","0","0","0","0","0"
"Carroll","2020-02-21","0","0","0","0","0","0"
"Carroll","2020-02-22","0","0","0","0","0","0"
"Carroll","2020-02-23","0","0","0","0","0","0"
"Carroll","2020-02-24","0","0","0","0","0","0"
"Carroll","2020-02-25","0","0","0","0","0","0"
"Carroll","2020-02-26","0","0","0","0","0","0"
"Carroll","2020-02-27","0","0","0","0","0","0"
"Carroll","2020-02-28","0","0","0","0","0","0"
"Carroll","2020-02-29","0","0","0","0","0","0"
"Carroll","2020-03-01","0","0","0","0","0","0"
"Carroll","2020-03-02","0","0","0","0","0","0"
"Carroll","2020-03-03","0","0","0","0","0","0"
"Carroll","2020-03-04","0","0","0","0","0","0"
"Carroll","2020-03-05","0","0","0","0","0","0"
"Carroll","2020-03-06","2","2","0","0","0","0"
"Carroll","2020-03-07","0","2","0","0","0","0"
"Carroll","2020-03-08","0","2","0","0","0","0"
"Carroll","2020-03-09","1","3","0","0","0","0"
"Carroll","2020-03-10","2","5","0","0","0","0"
"Carroll","2020-03-11","5","10","0","0","0","0"
"Carroll","2020-03-12","10","20","0","0","0","0"
"Carroll","2020-03-13","15","35","4","4","3.8","1.9"
"Carroll","2020-03-14","9","44","4","8","10.2","5.1"
"Carroll","2020-03-15","13","57","3","11","13.5","6.7"
"Carroll","2020-03-16","31","88","4","15","15.3","7.6"
"Carroll","2020-03-17","60","148","5","20","16.5","8.2"
"Carroll","2020-03-18","47","195","6","26","18.3","9.2"
"Carroll","2020-03-19","26","221","2","28","19.4","9.7"
"Carroll","2020-03-20","9","230","1","29","17.2","10.5"
"Carroll","2020-03-21","2","232","0","29","10.8","10.5"
"Carroll","2020-03-22","7","239","3","32","13.7","13.6"
"Carroll","2020-03-23","5","244","1","33","14.7","15"
"Carroll","2020-03-24","15","259","3","36","16.3","16.4"
"Carroll","2020-03-25","19","278","8","44","20.5","19.4"
"Carroll","2020-03-26","7","285","4","48","27.6","23.5"
"Carroll","2020-03-27","22","307","4","52","28.6","22.9"
"Carroll","2020-03-28","1","308","0","52","28.6","19.7"
"Carroll","2020-03-29","3","311","0","52","22.5","18.1"
"Carroll","2020-03-30","12","323","4","56","24.4","19.5"
"Carroll","2020-03-31","3","326","0","56","21.5","18.9"
"Carroll","2020-04-01","11","337","4","60","20.7","20.6"
"Carroll","2020-04-02","92","429","11","71","14.3","20.9"
"Carroll","2020-04-03","85","514","10","81","13.3","21"
"Carroll","2020-04-04","80","594","11","92","15.3","22"
"Carroll","2020-04-05","0","594","0","92","15.3","18.9"
"Carroll","2020-04-06","60","654","12","104","13.4","18.9"
"Carroll","2020-04-07","112","766","14","118","15.2","18.4"
"Carroll","2020-04-08","83","849","5","123","10.9","15.8"
"Carroll","2020-04-09","76","925","18","141","12.5","13.4"
"Carroll","2020-04-10","106","1031","10","151","12.2","12.8"
"Carroll","2020-04-11","53","1084","6","157","11.9","13.6"
"Carroll","2020-04-12","7","1091","1","158","13.9","14.6"
"Carroll","2020-04-13","59","1150","17","175","15.2","14.3"
"Carroll","2020-04-14","88","1238","10","185","15","15.1"
"Carroll","2020-04-15","71","1309","12","197","16.5","13.7"
"Carroll","2020-04-16","158","1467","28","225","15.7","14.1"
"Carroll","2020-04-17","68","1535","15","240","17.5","14.8"
"Carroll","2020-04-18","79","1614","18","258","19.1","15.5"
"Carroll","2020-04-19","6","1620","1","259","19.5","16.7"
"Carroll","2020-04-20","56","1676","9","268","17.7","16.4"
"Carroll","2020-04-21","110","1786","10","278","17.3","16.2"
"Carroll","2020-04-22","99","1885","14","292","16.9","16.7"
"Carroll","2020-04-23","93","1978","7","299","15.5","15.6"
"Carroll","2020-04-24","94","2072","7","306","13.4","15.4"
"Carroll","2020-04-25","88","2160","7","313","11.3","15.2"
"Carroll","2020-04-26","18","2178","3","316","11.3","15.4"
"Carroll","2020-04-27","104","2282","18","334","11.4","14.6"
"Carroll","2020-04-28","107","2389","10","344","11.5","14.4"
"Carroll","2020-04-29","149","2538","14","358","10.8","13.9"
"Carroll","2020-04-30","141","2679","7","365","10.4","13"
"Carroll","2020-05-01","185","2864","15","380","10.5","12"
"Carroll","2020-05-02","119","2983","5","385","10","10.6"
"Carroll","2020-05-03","28","3011","0","385","7.6","9.4"
"Carroll","2020-05-04","199","3210","13","398","6.1","8.8"
"Carroll","2020-05-05","142","3352","3","401","5","8.3"
"Carroll","2020-05-06","143","3495","4","405","4.1","7.5"
"Carroll","2020-05-07","94","3589","8","413","4.6","7.5"
"Carroll","2020-05-08","135","3724","4","417","3.9","7.2"
"Carroll","2020-05-09","132","3856","3","420","3.6","6.8"
"Carroll","2020-05-10","12","3868","2","422","6","6.8"
"Carroll","2020-05-11","139","4007","8","430","5.9","6"
"Carroll","2020-05-12","220","4227","11","441","6.3","5.7"
"Carroll","2020-05-13","124","4351","2","443","6.1","5.1"
"Carroll","2020-05-14","104","4455","5","448","5.6","5.1"
"Carroll","2020-05-15","158","4613","8","456","5.9","4.9"
"Carroll","2020-05-16","102","4715","8","464","6.7","5.1"
"Carroll","2020-05-17","38","4753","5","469","6.2","6.1"
"Carroll","2020-05-18","161","4914","21","490","7.2","6.5"
"Carroll","2020-05-19","194","5108","24","514","8.3","7.3"
"Carroll","2020-05-20","201","5309","33","547","10.4","8.2"
"Carroll","2020-05-21","151","5460","13","560","10.9","8.3"
"Carroll","2020-05-22","162","5622","11","571","11.2","8.5"
"Carroll","2020-05-23","32","5654","7","578","13.2","9.9"
"Carroll","2020-05-24","19","5673","1","579","12.1","9.1"
"Carroll","2020-05-25","55","5728","3","582","11","9.1"
"Carroll","2020-05-26","115","5843","6","588","9.9","9.1"
"Carroll","2020-05-27","249","6092","13","601","8.3","9.4"
"Carroll","2020-05-28","149","6241","11","612","8.2","9.6"
"Carroll","2020-05-29","150","6391","11","623","8.2","9.7"
"Carroll","2020-05-30","111","6502","7","630","6","9.6"
"Carroll","2020-05-31","19","6521","3","633","7.5","9.8"
"Carroll","2020-06-01","151","6672","17","650","8.4","9.7"
"Carroll","2020-06-02","177","6849","14","664","8.7","9.3"
"Carroll","2020-06-03","146","6995","9","673","8.9","8.6"
"Carroll","2020-06-04","148","7143","7","680","8.5","8.3"
"Carroll","2020-06-05","157","7300","9","689","8.3","8.3"
"Carroll","2020-06-06","131","7431","5","694","7.9","7"
"Carroll","2020-06-07","28","7459","3","697","7.2","7.4"
"Carroll","2020-06-08","175","7634","11","708","6.5","7.4"
"Carroll","2020-06-09","272","7906","11","719","5.9","7.3"
"Carroll","2020-06-10","276","8182","14","733","5.8","7.3"
"Carroll","2020-06-11","122","8304","9","742","6.1","7.3"
"Carroll","2020-06-12","117","8421","3","745","5.7","7"
"Carroll","2020-06-13","9","8430","2","747","8.3","8.1"
"Carroll","2020-06-14","6","8436","0","747","6.8","7"
"Carroll","2020-06-15","161","8597","7","754","6.5","6.5"
"Carroll","2020-06-16","182","8779","20","774","7.5","6.7"
"Carroll","2020-06-17","162","8941","11","785","7.8","6.8"
"Carroll","2020-06-18","148","9089","17","802","8.3","7.2"
"Carroll","2020-06-19","196","9285","13","815","8.9","7.3"
"Carroll","2020-06-20","135","9420","7","822","6.5","7.4"
"Carroll","2020-06-21","20","9440","2","824","7.9","7.4"
"Carroll","2020-06-22","158","9598","24","848","9.5","8"
"Carroll","2020-06-23","253","9851","34","882","9.8","8.7"
"Carroll","2020-06-24","199","10050","27","909","10.8","9.3"
"Carroll","2020-06-25","252","10302","36","945","11.2","9.8"
"Carroll","2020-06-26","280","10582","32","977","11.9","10.4"
"Carroll","2020-06-27","181","10763","24","1001","13","9.8"
"Carroll","2020-06-28","37","10800","4","1005","13.1","10.5"
"Carroll","2020-06-29","223","11023","35","1040","13.2","11.3"
"Carroll","2020-06-30","308","11331","51","1091","13.7","11.7"
"Carroll","2020-07-01","428","11759","61","1152","13.8","12.3"
"Carroll","2020-07-02","288","12047","53","1205","14.3","12.8"
"Carroll","2020-07-03","334","12381","79","1284","16.1","14"
"Carroll","2020-07-04","66","12447","20","1304","18.5","15.8"
"Carroll","2020-07-05","53","12500","17","1321","21.6","17.4"
"Carroll","2020-07-06","421","12921","110","1431","23.1","18.1"
"Carroll","2020-07-07","366","13287","87","1518","24.1","18.9"
"Carroll","2020-07-08","347","13634","87","1605","25.6","19.7"
"Carroll","2020-07-09","542","14176","121","1726","26.2","20.3"
"Carroll","2020-07-10","530","14706","120","1846","26","21.1"
"Carroll","2020-07-11","356","15062","86","1932","25.2","21.8"
"Carroll","2020-07-12","59","15121","11","1943","23.2","22.4"
"Carroll","2020-07-13","416","15537","106","2049","23.2","23.1"
"Carroll","2020-07-14","542","16079","131","2180","23.2","23.6"
"Carroll","2020-07-15","690","16769","113","2293","22","23.8"
"Carroll","2020-07-16","409","17178","94","2387","22.1","24.1"
"Carroll","2020-07-17","550","17728","120","2507","21.9","24"
"Carroll","2020-07-18","214","17942","52","2559","22","23.6"
"Carroll","2020-07-19","59","18001","16","2575","23.2","23.2"
"Carroll","2020-07-20","380","18381","122","2697","24.1","23.6"
"Carroll","2020-07-21","419","18800","141","2838","25.5","24.3"
"Carroll","2020-07-22","456","19256","68","2906","25.3","23.6"
"Carroll","2020-07-23","412","19668","110","3016","25.8","23.9"
"Carroll","2020-07-24","379","20047","99","3115","26.4","24.2"
"Carroll","2020-07-25","196","20243","52","3167","26.7","24.4"
"Carroll","2020-07-26","20","20263","1","3168","23.6","23.4"
"Carroll","2020-07-27","225","20488","52","3220","22.3","23.2"
"Carroll","2020-07-28","349","20837","93","3313","21.3","23.4"
"Carroll","2020-07-29","436","21273","94","3407","22.2","23.8"
"Carroll","2020-07-30","271","21544","63","3470","21.7","23.8"
"Carroll","2020-07-31","230","21774","50","3520","21.1","23.8"
"Carroll","2020-08-01","211","21985","31","3551","19.4","23.1"
"Carroll","2020-08-02","12","21997","3","3554","22.3","22.9"
"Carroll","2020-08-03","182","22179","38","3592","22","22.1"
"Carroll","2020-08-04","326","22505","68","3660","21.1","21.2"
"Carroll","2020-08-05","358","22863","49","3709","20","21.1"
"Carroll","2020-08-06","239","23102","42","3751","19.2","20.5"
"Carroll","2020-08-07","209","23311","33","3784","18.4","19.7"
"Carroll","2020-08-08","121","23432","13","3797","17.8","18.6"
"Carroll","2020-08-09","25","23457","2","3799","15.4","18.8"
"Carroll","2020-08-10","146","23603","30","3829","15.3","18.6"
"Carroll","2020-08-11","289","23892","60","3889","15.3","18.2"
"Carroll","2020-08-12","447","24339","69","3958","15.6","17.8"
"Carroll","2020-08-13","375","24714","43","4001","14.7","16.9"
"Carroll","2020-08-14","226","24940","29","4030","14.3","16.3"
"Carroll","2020-08-15","163","25103","24","4054","14.8","16.3"
"Carroll","2020-08-16","27","25130","3","4057","15.3","15.3"
"Carroll","2020-08-17","143","25273","30","4087","15.3","15.3"
"Carroll","2020-08-18","247","25520","42","4129","14.8","15"
"Carroll","2020-08-19","465","25985","49","4178","14.1","14.8"
"Carroll","2020-08-20","265","26250","37","4215","14.4","14.6"
"Carroll","2020-08-21","185","26435","28","4243","14.8","14.5"
"Carroll","2020-08-22","104","26539","11","4254","14.2","14.5"
"Carroll","2020-08-23","12","26551","0","4254","12.6","13.9"
"Carroll","2020-08-24","122","26673","25","4279","12.5","13.9"
"Carroll","2020-08-25","208","26881","41","4320","12.9","13.9"
"Carroll","2020-08-26","279","27160","36","4356","13.3","13.7"
"Carroll","2020-08-27","219","27379","23","4379","12.8","13.6"
"Carroll","2020-08-28","165","27544","21","4400","12.4","13.6"
"Carroll","2020-08-29","111","27655","13","4413","12.6","13.4"
"Carroll","2020-08-30","8","27663","1","4414","14.4","13.5"
"Carroll","2020-08-31","133","27796","12","4426","12.7","12.6"
"Carroll","2020-09-01","206","28002","24","4450","11.6","12.2"
"Carroll","2020-09-02","365","28367","33","4483","11","12.1"
"Carroll","2020-09-03","209","28576","22","4505","11","11.9"
"Carroll","2020-09-04","201","28777","19","4524","10.6","11.5"
"Carroll","2020-09-05","142","28919","9","4533","9.8","11.2"
"Carroll","2020-09-06","15","28934","4","4537","11.8","13.1"
"Carroll","2020-09-07","39","28973","4","4541","12","12.4"
"Carroll","2020-09-08","114","29087","19","4560","12.7","12.1"
"Carroll","2020-09-09","335","29422","35","4595","12.9","12"
"Carroll","2020-09-10","198","29620","16","4611","12.6","11.8"
"Carroll","2020-09-11","205","29825","21","4632","12.7","11.6"
"Carroll","2020-09-12","47","29872","3","4635","12.7","11.2"
"Carroll","2020-09-13","16","29888","1","4636","9.8","10.8"
"Carroll","2020-09-14","129","30017","11","4647","9.5","10.8"
"Carroll","2020-09-15","225","30242","16","4663","8.1","10.4"
"Carroll","2020-09-16","172","30414","9","4672","7.4","10.2"
"Carroll","2020-09-17","100","30514","8","4680","7.4","10"
"Carroll","2020-09-18","101","30615","15","4695","8.1","10.4"
"Carroll","2020-09-19","169","30784","8","4703","7.8","10.2"
"Carroll","2020-09-20","15","30799","0","4703","6.9","8.3"
"Carroll","2020-09-21","115","30914","16","4719","7.7","8.6"
"Carroll","2020-09-22","186","31100","33","4752","9.2","8.7"
"Carroll","2020-09-23","323","31423","32","4784","9.9","8.6"
"Carroll","2020-09-24","225","31648","26","4810","10.4","8.9"
"Carroll","2020-09-25","142","31790","19","4829","10.2","9.1"
"Carroll","2020-09-26","88","31878","8","4837","10.8","9.3"
"Carroll","2020-09-27","15","31893","3","4840","13.7","10.3"
"Carroll","2020-09-28","80","31973","10","4850","13.5","10.6"
"Carroll","2020-09-29","141","32114","17","4867","12.6","10.9"
"Carroll","2020-09-30","332","32446","27","4894","12.4","11.1"
"Carroll","2020-10-01","132","32578","18","4912","12.7","11.5"
"Carroll","2020-10-02","145","32723","18","4930","12.5","11.4"
"Carroll","2020-10-03","93","32816","8","4938","12.5","11.6"
"Carroll","2020-10-04","10","32826","1","4939","11","12.4"
"Carroll","2020-10-05","108","32934","11","4950","10.7","12.1"
"Carroll","2020-10-06","207","33141","20","4970","10.4","11.5"
"Carroll","2020-10-07","314","33455","20","4990","10.1","11.3"
"Carroll","2020-10-08","210","33665","21","5011","9.6","11.1"
"Carroll","2020-10-09","166","33831","18","5029","9.4","11"
"Carroll","2020-10-10","82","33913","15","5044","10.8","11.6"
"Carroll","2020-10-11","52","33965","0","5044","9.3","10.2"
"Carroll","2020-10-12","127","34092","24","5068","10.6","10.6"
"Carroll","2020-10-13","217","34309","27","5095","11","10.7"
"Carroll","2020-10-14","360","34669","24","5119","11","10.6"
"Carroll","2020-10-15","231","34900","28","5147","11.3","10.5"
"Carroll","2020-10-16","226","35126","16","5163","10.8","10.1"
"Carroll","2020-10-17","170","35296","16","5179","9.5","10.1"
"Carroll","2020-10-18","50","35346","2","5181","10.1","9.7"
"Carroll","2020-10-19","276","35622","30","5211","8.9","9.8"
"Carroll","2020-10-20","227","35849","40","5251","9.7","10.3"
"Carroll","2020-10-21","306","36155","45","5296","10.8","10.9"
"Carroll","2020-10-22","197","36352","28","5324","11.1","11.2"
"Carroll","2020-10-23","199","36551","20","5344","11.6","11.2"
"Carroll","2020-10-24","142","36693","19","5363","12.1","10.8"
"Carroll","2020-10-25","49","36742","7","5370","13.6","11.8"
"Carroll","2020-10-26","141","36883","8","5378","12.8","10.9"
"Carroll","2020-10-27","247","37130","26","5404","11.8","10.8"
"Carroll","2020-10-28","273","37403","36","5440","11.6","11.2"
"Carroll","2020-10-29","213","37616","24","5464","11.2","11.2"
"Carroll","2020-10-30","135","37751","16","5480","11.5","11.5"
"Carroll","2020-10-31","160","37911","21","5501","11.4","11.8"
"Carroll","2020-11-01","29","37940","3","5504","10.9","12.2"
"Carroll","2020-11-02","150","38090","35","5539","13.4","13.1"
"Carroll","2020-11-03","108","38198","19","5558","14.4","13.1"
"Carroll","2020-11-04","342","38540","45","5603","14.4","13"
"Carroll","2020-11-05","251","38791","37","5640","14.9","13"
"Carroll","2020-11-06","187","38978","20","5660","14.7","13.1"
"Carroll","2020-11-07","135","39113","22","5682","15.2","13.3"
"Carroll","2020-11-08","41","39154","3","5685","14.7","12.8"
"Carroll","2020-11-09","147","39301","19","5704","13.2","13.3"
"Carroll","2020-11-10","298","39599","39","5743","12.6","13.5"
"Carroll","2020-11-11","229","39828","27","5770","12.4","13.4"
"Carroll","2020-11-12","218","40046","24","5794","11.9","13.4"
"Carroll","2020-11-13","285","40331","39","5833","12.3","13.5"
"Carroll","2020-11-14","144","40475","19","5852","11.9","13.5"
"Carroll","2020-11-15","63","40538","8","5860","12.6","13.7"
"Carroll","2020-11-16","175","40713","25","5885","12.8","13"
"Carroll","2020-11-17","176","40889","32","5917","13.5","13.1"
"Carroll","2020-11-18","459","41348","72","5989","14.1","13.3"
"Carroll","2020-11-19","310","41658","38","6027","14.3","13.1"
"Carroll","2020-11-20","278","41936","51","6078","15","13.6"
"Carroll","2020-11-21","144","42080","19","6097","15","13.4"
"Carroll","2020-11-22","54","42134","12","6109","16.3","14.5"
"Carroll","2020-11-23","153","42287","28","6137","16.9","14.9"
"Carroll","2020-11-24","108","42395","21","6158","17.1","15.3"
"Carroll","2020-11-25","363","42758","59","6217","17.1","15.6"
"Carroll","2020-11-26","13","42771","0","6217","15.4","14.8"
"Carroll","2020-11-27","125","42896","21","6238","15.2","15.1"
"Carroll","2020-11-28","114","43010","14","6252","15","15"
"Carroll","2020-11-29","37","43047","7","6259","14.6","15.4"
"Carroll","2020-11-30","184","43231","21","6280","13.6","15.2"
"Carroll","2020-12-01","272","43503","64","6344","14.2","15.6"
"Carroll","2020-12-02","457","43960","98","6442","14.9","16"
"Carroll","2020-12-03","285","44245","68","6510","18.3","16.9"
"Carroll","2020-12-04","247","44492","43","6553","18.4","16.8"
"Carroll","2020-12-05","129","44621","24","6577","19.3","17.2"
"Carroll","2020-12-06","57","44678","7","6584","18.4","16.5"
"Carroll","2020-12-07","206","44884","31","6615","18.9","16.2"
"Carroll","2020-12-08","252","45136","42","6657","17.9","16"
"Carroll","2020-12-09","346","45482","52","6709","17","15.9"
"Carroll","2020-12-10","219","45701","34","6743","15.8","17.1"
"Carroll","2020-12-11","255","45956","44","6787","15.8","17.1"
"Carroll","2020-12-12","280","46236","40","6827","15.2","17.2"
"Carroll","2020-12-13","45","46281","4","6831","14.7","16.5"
"Carroll","2020-12-14","183","46464","33","6864","15.1","17"
"Carroll","2020-12-15","372","46836","82","6946","15.9","16.9"
"Carroll","2020-12-16","452","47288","59","7005","15.6","16.3"
"Carroll","2020-12-17","251","47539","33","7038","15.2","15.5"
"Carroll","2020-12-18","267","47806","31","7069","14.4","15.1"
"Carroll","2020-12-19","187","47993","42","7111","15.6","15.4"
"Carroll","2020-12-20","68","48061","9","7120","16.2","15.4"
"Carroll","2020-12-21","133","48194","33","7153","17.2","16.1"
"Carroll","2020-12-22","347","48541","87","7240","17.6","16.7"
"Carroll","2020-12-23","502","49043","77","7317","18","16.8"
"Carroll","2020-12-24","213","49256","35","7352","18.4","16.8"
"Carroll","2020-12-25","14","49270","1","7353","17.8","16.1"
"Carroll","2020-12-26","104","49374","18","7371","17","16.3"
"Carroll","2020-12-27","128","49502","13","7384","16.6","16.4"
"Carroll","2020-12-28","261","49763","57","7441","16.2","16.7"
"Carroll","2020-12-29","435","50198","111","7552","16.2","16.9"
"Carroll","2020-12-30","452","50650","99","7651","17.2","17.6"
"Carroll","2020-12-31","333","50983","71","7722","17.9","18.2"
"Carroll","2021-01-01","26","51009","8","7730","21.3","19.5"
"Carroll","2021-01-02","82","51091","21","7751","22.4","19.7"
"Carroll","2021-01-03","86","51177","7","7758","22.2","19.4"
"Carroll","2021-01-04","188","51365","53","7811","23.1","19.6"
"Carroll","2021-01-05","379","51744","94","7905","23","19.6"
"Carroll","2021-01-06","490","52234","97","8002","22.7","19.9"
"Carroll","2021-01-07","388","52622","53","8055","21.6","19.7"
"Carroll","2021-01-08","341","52963","53","8108","19.4","20.3"
"Carroll","2021-01-09","190","53153","31","8139","18.1","20.3"
"Carroll","2021-01-10","60","53213","12","8151","19.8","21"
"Carroll","2021-01-11","330","53543","43","8194","17.6","20.3"
"Carroll","2021-01-12","312","53855","53","8247","16.5","19.7"
"Carroll","2021-01-13","400","54255","69","8316","16.1","19.4"
"Carroll","2021-01-14","342","54597","51","8367","16.3","18.9"
"Carroll","2021-01-15","366","54963","59","8426","16.4","17.9"
"Carroll","2021-01-16","212","55175","43","8469","16.9","17.5"
"Carroll","2021-01-17","57","55232","14","8483","17.6","18.7"
"Carroll","2021-01-18","214","55446","32","8515","17.9","17.7"
"Carroll","2021-01-19","313","55759","51","8566","17.8","17.1"
"Carroll","2021-01-20","351","56110","58","8624","17.7","16.9"
"Carroll","2021-01-21","341","56451","65","8689","18.3","17.3"
"Carroll","2021-01-22","289","56740","36","8725","17.7","17.1"
"Carroll","2021-01-23","203","56943","40","8765","17.7","17.3"
"Carroll","2021-01-24","56","56999","10","8775","16.7","17.1"
"Carroll","2021-01-25","215","57214","30","8805","16.6","17.2"
"Carroll","2021-01-26","304","57518","35","8840","15.9","16.8"
"Carroll","2021-01-27","377","57895","42","8882","15.1","16.4"
"Carroll","2021-01-28","289","58184","36","8918","14.2","16.2"
"Carroll","2021-01-29","256","58440","32","8950","14.2","15.9"
"Carroll","2021-01-30","136","58576","32","8982","14.7","16.2"
"Carroll","2021-01-31","65","58641","13","8995","15","15.9"
"Carroll","2021-02-01","133","58774","20","9015","15.2","15.9"
"Carroll","2021-02-02","275","59049","50","9065","16.1","16"
"Carroll","2021-02-03","245","59294","42","9107","17","16"
"Carroll","2021-02-04","183","59477","29","9136","17.5","15.8"
"Carroll","2021-02-05","158","59635","22","9158","17.7","15.9"
"Carroll","2021-02-06","36","59671","2","9160","15.1","14.9"
"Carroll","2021-02-07","6","59677","1","9161","14.6","14.8"
"Carroll","2021-02-08","0","59677","0","9161","12.5","13.8"
"Catoosa","2020-02-01","0","0","0","0",".","."
"Catoosa","2020-02-02","0","0","0","0",".","."
"Catoosa","2020-02-03","0","0","0","0",".","."
"Catoosa","2020-02-04","0","0","0","0",".","."
"Catoosa","2020-02-05","0","0","0","0",".","."
"Catoosa","2020-02-06","0","0","0","0",".","."
"Catoosa","2020-02-07","0","0","0","0","0","."
"Catoosa","2020-02-08","0","0","0","0","0","."
"Catoosa","2020-02-09","0","0","0","0","0","."
"Catoosa","2020-02-10","0","0","0","0","0","."
"Catoosa","2020-02-11","0","0","0","0","0","."
"Catoosa","2020-02-12","0","0","0","0","0","."
"Catoosa","2020-02-13","0","0","0","0","0","."
"Catoosa","2020-02-14","0","0","0","0","0","0"
"Catoosa","2020-02-15","0","0","0","0","0","0"
"Catoosa","2020-02-16","0","0","0","0","0","0"
"Catoosa","2020-02-17","0","0","0","0","0","0"
"Catoosa","2020-02-18","0","0","0","0","0","0"
"Catoosa","2020-02-19","0","0","0","0","0","0"
"Catoosa","2020-02-20","0","0","0","0","0","0"
"Catoosa","2020-02-21","0","0","0","0","0","0"
"Catoosa","2020-02-22","0","0","0","0","0","0"
"Catoosa","2020-02-23","0","0","0","0","0","0"
"Catoosa","2020-02-24","0","0","0","0","0","0"
"Catoosa","2020-02-25","0","0","0","0","0","0"
"Catoosa","2020-02-26","0","0","0","0","0","0"
"Catoosa","2020-02-27","0","0","0","0","0","0"
"Catoosa","2020-02-28","0","0","0","0","0","0"
"Catoosa","2020-02-29","0","0","0","0","0","0"
"Catoosa","2020-03-01","0","0","0","0","0","0"
"Catoosa","2020-03-02","0","0","0","0","0","0"
"Catoosa","2020-03-03","0","0","0","0","0","0"
"Catoosa","2020-03-04","0","0","0","0","0","0"
"Catoosa","2020-03-05","0","0","0","0","0","0"
"Catoosa","2020-03-06","1","1","0","0","0","0"
"Catoosa","2020-03-07","0","1","0","0","0","0"
"Catoosa","2020-03-08","0","1","0","0","0","0"
"Catoosa","2020-03-09","0","1","0","0","0","0"
"Catoosa","2020-03-10","1","2","0","0","0","0"
"Catoosa","2020-03-11","0","2","0","0","0","0"
"Catoosa","2020-03-12","5","7","0","0","0","0"
"Catoosa","2020-03-13","5","12","0","0","0","0"
"Catoosa","2020-03-14","2","14","0","0","0","0"
"Catoosa","2020-03-15","1","15","1","1","14.3","7.1"
"Catoosa","2020-03-16","14","29","0","1","14.3","7.1"
"Catoosa","2020-03-17","17","46","0","1","14.3","7.1"
"Catoosa","2020-03-18","15","61","0","1","14.3","7.1"
"Catoosa","2020-03-19","22","83","0","1","14.3","7.1"
"Catoosa","2020-03-20","10","93","0","1","14.3","7.1"
"Catoosa","2020-03-21","5","98","0","1","14.3","7.1"
"Catoosa","2020-03-22","2","100","0","1","0","7.1"
"Catoosa","2020-03-23","13","113","0","1","0","7.1"
"Catoosa","2020-03-24","11","124","0","1","0","7.1"
"Catoosa","2020-03-25","14","138","1","2","1","7.7"
"Catoosa","2020-03-26","8","146","0","2","1","7.7"
"Catoosa","2020-03-27","11","157","0","2","1","7.7"
"Catoosa","2020-03-28","0","157","0","2","1","7.7"
"Catoosa","2020-03-29","1","158","0","2","1","0.5"
"Catoosa","2020-03-30","6","164","1","3","3.4","1.7"
"Catoosa","2020-03-31","3","167","0","3","3.4","1.7"
"Catoosa","2020-04-01","5","172","0","3","2.4","1.7"
"Catoosa","2020-04-02","6","178","0","3","2.4","1.7"
"Catoosa","2020-04-03","10","188","0","3","2.4","1.7"
"Catoosa","2020-04-04","0","188","0","3","2.4","1.7"
"Catoosa","2020-04-05","0","188","0","3","2.4","1.7"
"Catoosa","2020-04-06","3","191","0","3","0","1.7"
"Catoosa","2020-04-07","7","198","0","3","0","1.7"
"Catoosa","2020-04-08","12","210","0","3","0","1.2"
"Catoosa","2020-04-09","15","225","0","3","0","1.2"
"Catoosa","2020-04-10","20","245","0","3","0","1.2"
"Catoosa","2020-04-11","2","247","1","4","7.1","4.8"
"Catoosa","2020-04-12","1","248","0","4","7.1","4.8"
"Catoosa","2020-04-13","1","249","0","4","7.1","3.6"
"Catoosa","2020-04-14","10","259","0","4","7.1","3.6"
"Catoosa","2020-04-15","15","274","0","4","7.1","3.6"
"Catoosa","2020-04-16","9","283","1","5","8.7","4.4"
"Catoosa","2020-04-17","17","300","0","5","8.7","4.4"
"Catoosa","2020-04-18","6","306","0","5","1.6","4.4"
"Catoosa","2020-04-19","4","310","0","5","1.6","4.4"
"Catoosa","2020-04-20","10","320","0","5","1.6","4.4"
"Catoosa","2020-04-21","28","348","0","5","1.6","4.4"
"Catoosa","2020-04-22","4","352","0","5","1.6","4.4"
"Catoosa","2020-04-23","7","359","0","5","0","4.4"
"Catoosa","2020-04-24","13","372","0","5","0","4.4"
"Catoosa","2020-04-25","6","378","0","5","0","0.8"
"Catoosa","2020-04-26","3","381","0","5","0","0.8"
"Catoosa","2020-04-27","13","394","0","5","0","0.8"
"Catoosa","2020-04-28","7","401","0","5","0","0.8"
"Catoosa","2020-04-29","11","412","0","5","0","0.8"
"Catoosa","2020-04-30","28","440","0","5","0","0"
"Catoosa","2020-05-01","14","454","0","5","0","0"
"Catoosa","2020-05-02","1","455","0","5","0","0"
"Catoosa","2020-05-03","4","459","0","5","0","0"
"Catoosa","2020-05-04","6","465","0","5","0","0"
"Catoosa","2020-05-05","9","474","0","5","0","0"
"Catoosa","2020-05-06","9","483","0","5","0","0"
"Catoosa","2020-05-07","14","497","2","7","2","1"
"Catoosa","2020-05-08","6","503","0","7","2","1"
"Catoosa","2020-05-09","4","507","0","7","2","1"
"Catoosa","2020-05-10","0","507","0","7","2","1"
"Catoosa","2020-05-11","6","513","0","7","2","1"
"Catoosa","2020-05-12","11","524","1","8","3.3","1.7"
"Catoosa","2020-05-13","11","535","0","8","3.3","1.7"
"Catoosa","2020-05-14","9","544","0","8","1.3","1.7"
"Catoosa","2020-05-15","8","552","0","8","1.3","1.7"
"Catoosa","2020-05-16","4","556","2","10","8.4","5.2"
"Catoosa","2020-05-17","1","557","0","10","8.4","5.2"
"Catoosa","2020-05-18","13","570","1","11","9.5","5.8"
"Catoosa","2020-05-19","29","599","1","12","8.7","6"
"Catoosa","2020-05-20","35","634","1","13","9.1","6.2"
"Catoosa","2020-05-21","18","652","0","13","9.1","5.2"
"Catoosa","2020-05-22","28","680","2","15","10.2","5.7"
"Catoosa","2020-05-23","1","681","0","15","3","5.7"
"Catoosa","2020-05-24","0","681","0","15","3","5.7"
"Catoosa","2020-05-25","0","681","0","15","1.9","5.7"
"Catoosa","2020-05-26","22","703","0","15","1.4","5.1"
"Catoosa","2020-05-27","33","736","3","18","2.3","5.7"
"Catoosa","2020-05-28","17","753","3","21","4.8","7"
"Catoosa","2020-05-29","26","779","1","22","4.4","7.3"
"Catoosa","2020-05-30","9","788","1","23","6","4.5"
"Catoosa","2020-05-31","4","792","0","23","6","4.5"
"Catoosa","2020-06-01","30","822","1","24","6.4","4.2"
"Catoosa","2020-06-02","22","844","1","25","7.1","4.3"
"Catoosa","2020-06-03","13","857","0","25","5.8","4.1"
"Catoosa","2020-06-04","14","871","0","25","3.3","4.1"
"Catoosa","2020-06-05","15","886","1","26","3.7","4"
"Catoosa","2020-06-06","8","894","1","27","3.9","4.9"
"Catoosa","2020-06-07","1","895","0","27","3.9","4.9"
"Catoosa","2020-06-08","32","927","1","28","3.8","5.1"
"Catoosa","2020-06-09","20","947","2","30","4.6","5.8"
"Catoosa","2020-06-10","21","968","0","30","4.6","5.2"
"Catoosa","2020-06-11","24","992","2","32","5.8","4.5"
"Catoosa","2020-06-12","24","1016","1","33","5.4","4.6"
"Catoosa","2020-06-13","7","1023","0","33","3.7","3.8"
"Catoosa","2020-06-14","0","1023","0","33","3.7","3.8"
"Catoosa","2020-06-15","20","1043","2","35","4.6","4.2"
"Catoosa","2020-06-16","18","1061","0","35","3.2","3.9"
"Catoosa","2020-06-17","26","1087","2","37","4.3","4.5"
"Catoosa","2020-06-18","29","1116","2","39","4.1","5"
"Catoosa","2020-06-19","20","1136","1","40","4.2","4.8"
"Catoosa","2020-06-20","17","1153","1","41","5.1","4.4"
"Catoosa","2020-06-21","12","1165","4","45","9.8","6.7"
"Catoosa","2020-06-22","14","1179","0","45","8.4","6.5"
"Catoosa","2020-06-23","28","1207","8","53","12.5","7.8"
"Catoosa","2020-06-24","19","1226","2","55","12.9","8.6"
"Catoosa","2020-06-25","25","1251","0","55","11.9","8"
"Catoosa","2020-06-26","12","1263","0","55","11.2","7.7"
"Catoosa","2020-06-27","12","1275","0","55","10.3","7.7"
"Catoosa","2020-06-28","12","1287","0","55","5.6","7.7"
"Catoosa","2020-06-29","26","1313","1","56","6.1","7.3"
"Catoosa","2020-06-30","35","1348","3","59","3.3","7.9"
"Catoosa","2020-07-01","27","1375","1","60","2.3","7.6"
"Catoosa","2020-07-02","35","1410","4","64","3.9","7.9"
"Catoosa","2020-07-03","25","1435","1","65","4.5","7.8"
"Catoosa","2020-07-04","4","1439","0","65","4.5","7.4"
"Catoosa","2020-07-05","3","1442","0","65","4.5","5"
"Catoosa","2020-07-06","36","1478","1","66","4.4","5.2"
"Catoosa","2020-07-07","36","1514","5","71","5.1","4.2"
"Catoosa","2020-07-08","22","1536","1","72","5.2","3.8"
"Catoosa","2020-07-09","24","1560","0","72","3.6","3.8"
"Catoosa","2020-07-10","27","1587","3","75","4.6","4.6"
"Catoosa","2020-07-11","11","1598","2","77","7.2","5.9"
"Catoosa","2020-07-12","5","1603","1","78","10.1","7.3"
"Catoosa","2020-07-13","31","1634","8","86","13.4","8.9"
"Catoosa","2020-07-14","59","1693","2","88","11.9","8.5"
"Catoosa","2020-07-15","33","1726","5","93","13.4","9.3"
"Catoosa","2020-07-16","16","1742","4","97","16.9","10.3"
"Catoosa","2020-07-17","21","1763","1","98","16","10.3"
"Catoosa","2020-07-18","9","1772","0","98","13.4","10.3"
"Catoosa","2020-07-19","7","1779","0","98","10.6","10.3"
"Catoosa","2020-07-20","20","1799","0","98","6.9","10.1"
"Catoosa","2020-07-21","19","1818","0","98","6.4","9.1"
"Catoosa","2020-07-22","29","1847","2","100","5.2","9.3"
"Catoosa","2020-07-23","23","1870","1","101","2.3","9.6"
"Catoosa","2020-07-24","36","1906","4","105","3.2","9.6"
"Catoosa","2020-07-25","18","1924","1","106","4","8.7"
"Catoosa","2020-07-26","1","1925","0","106","4","7.3"
"Catoosa","2020-07-27","38","1963","4","110","5.5","6.2"
"Catoosa","2020-07-28","42","2005","2","112","6.2","6.3"
"Catoosa","2020-07-29","25","2030","4","116","7.5","6.4"
"Catoosa","2020-07-30","23","2053","1","117","7.5","4.9"
"Catoosa","2020-07-31","26","2079","4","121","8.1","5.6"
"Catoosa","2020-08-01","14","2093","2","123","9.3","6.7"
"Catoosa","2020-08-02","4","2097","1","124","12.9","8.4"
"Catoosa","2020-08-03","29","2126","4","128","13.4","9.4"
"Catoosa","2020-08-04","30","2156","1","129","13.2","9.7"
"Catoosa","2020-08-05","20","2176","0","129","10.9","9.2"
"Catoosa","2020-08-06","20","2196","3","132","12.4","9.9"
"Catoosa","2020-08-07","36","2232","3","135","11.4","9.7"
"Catoosa","2020-08-08","21","2253","1","136","10","9.7"
"Catoosa","2020-08-09","9","2262","0","136","6.5","9.7"
"Catoosa","2020-08-10","31","2293","1","137","5","9.2"
"Catoosa","2020-08-11","37","2330","1","138","4.9","9"
"Catoosa","2020-08-12","29","2359","1","139","5.4","8.1"
"Catoosa","2020-08-13","19","2378","0","139","3.2","7.8"
"Catoosa","2020-08-14","20","2398","0","139","2","6.7"
"Catoosa","2020-08-15","13","2411","2","141","3.5","6.8"
"Catoosa","2020-08-16","11","2422","2","143","6.1","6.3"
"Catoosa","2020-08-17","26","2448","0","143","5.7","5.3"
"Catoosa","2020-08-18","37","2485","1","144","5.7","5.3"
"Catoosa","2020-08-19","38","2523","4","148","6.7","6"
"Catoosa","2020-08-20","21","2544","1","149","7.4","5.3"
"Catoosa","2020-08-21","43","2587","5","154","9","5.5"
"Catoosa","2020-08-22","23","2610","1","155","7.4","5.5"
"Catoosa","2020-08-23","8","2618","4","159","12","9.1"
"Catoosa","2020-08-24","33","2651","1","160","12.4","9.1"
"Catoosa","2020-08-25","63","2714","6","166","13.4","9.5"
"Catoosa","2020-08-26","40","2754","5","171","13.7","10.2"
"Catoosa","2020-08-27","25","2779","2","173","14.1","10.8"
"Catoosa","2020-08-28","22","2801","1","174","13.1","11.1"
"Catoosa","2020-08-29","18","2819","4","178","15.7","11.6"
"Catoosa","2020-08-30","9","2828","1","179","10.1","11.1"
"Catoosa","2020-08-31","37","2865","6","185","12","12.2"
"Catoosa","2020-09-01","168","3033","6","191","11.2","12.3"
"Catoosa","2020-09-02","39","3072","5","196","11.2","12.4"
"Catoosa","2020-09-03","37","3109","7","203","12.8","13.5"
"Catoosa","2020-09-04","32","3141","4","207","13.9","13.5"
"Catoosa","2020-09-05","20","3161","4","211","13.6","14.6"
"Catoosa","2020-09-06","10","3171","2","213","14.9","12.5"
"Catoosa","2020-09-07","50","3221","6","219","14.3","13.1"
"Catoosa","2020-09-08","210","3431","18","237","15","13.1"
"Catoosa","2020-09-09","52","3483","3","240","14","12.6"
"Catoosa","2020-09-10","34","3517","5","245","13.4","13.1"
"Catoosa","2020-09-11","27","3544","4","249","13.7","13.8"
"Catoosa","2020-09-12","5","3549","0","249","10.8","12.2"
"Catoosa","2020-09-13","8","3557","1","250","9.8","12.3"
"Catoosa","2020-09-14","180","3737","8","258","8.7","11.5"
"Catoosa","2020-09-15","196","3933","17","275","8.7","11.8"
"Catoosa","2020-09-16","24","3957","2","277","9.1","11.5"
"Catoosa","2020-09-17","25","3982","4","281","9.3","11.3"
"Catoosa","2020-09-18","46","4028","0","281","7.1","10.4"
"Catoosa","2020-09-19","37","4065","5","286","9.1","10"
"Catoosa","2020-09-20","13","4078","1","287","8.4","9.1"
"Catoosa","2020-09-21","136","4214","17","304","9.5","9.1"
"Catoosa","2020-09-22","155","4369","11","315","9.3","9"
"Catoosa","2020-09-23","26","4395","3","318","9.8","9.4"
"Catoosa","2020-09-24","28","4423","1","319","8","8.6"
"Catoosa","2020-09-25","24","4447","1","320","8.6","7.9"
"Catoosa","2020-09-26","16","4463","1","321","7.5","8.3"
"Catoosa","2020-09-27","9","4472","1","322","8","8.2"
"Catoosa","2020-09-28","137","4609","15","337","7.8","8.7"
"Catoosa","2020-09-29","132","4741","11","348","8","8.6"
"Catoosa","2020-09-30","17","4758","0","348","6.3","8.1"
"Catoosa","2020-10-01","20","4778","0","348","5.8","6.9"
"Catoosa","2020-10-02","25","4803","0","348","5.2","6.9"
"Catoosa","2020-10-03","25","4828","1","349","4.9","6.2"
"Catoosa","2020-10-04","19","4847","0","349","3.3","5.7"
"Catoosa","2020-10-05","199","5046","10","359","2.5","5.1"
"Catoosa","2020-10-06","124","5170","9","368","2.3","5.2"
"Catoosa","2020-10-07","38","5208","3","371","3.5","4.9"
"Catoosa","2020-10-08","24","5232","1","372","4","4.9"
"Catoosa","2020-10-09","18","5250","1","373","4.8","5"
"Catoosa","2020-10-10","6","5256","0","373","4.3","4.6"
"Catoosa","2020-10-11","15","5271","3","376","7.1","5.2"
"Catoosa","2020-10-12","30","5301","1","377","6.9","4.7"
"Catoosa","2020-10-13","170","5471","14","391","7","4.7"
"Catoosa","2020-10-14","30","5501","2","393","6.9","5.2"
"Catoosa","2020-10-15","29","5530","0","393","6.3","5.2"
"Catoosa","2020-10-16","32","5562","6","399","8.1","6.5"
"Catoosa","2020-10-17","11","5573","0","399","8.1","6.2"
"Catoosa","2020-10-18","6","5579","0","399","5.3","6.2"
"Catoosa","2020-10-19","196","5775","25","424","6.6","6.8"
"Catoosa","2020-10-20","122","5897","10","434","6.6","6.8"
"Catoosa","2020-10-21","22","5919","0","434","5.7","6.3"
"Catoosa","2020-10-22","19","5938","1","435","6.4","6.3"
"Catoosa","2020-10-23","17","5955","3","438","6.3","7.2"
"Catoosa","2020-10-24","79","6034","8","446","7.7","7.9"
"Catoosa","2020-10-25","4","6038","1","447","11.3","8.3"
"Catoosa","2020-10-26","230","6268","25","472","11","8.8"
"Catoosa","2020-10-27","142","6410","12","484","11.1","8.8"
"Catoosa","2020-10-28","27","6437","3","487","12.6","9.2"
"Catoosa","2020-10-29","34","6471","5","492","14","10.2"
"Catoosa","2020-10-30","33","6504","2","494","12.3","9.3"
"Catoosa","2020-10-31","30","6534","4","498","12.8","10.3"
"Catoosa","2020-11-01","11","6545","1","499","10.5","10.9"
"Catoosa","2020-11-02","261","6806","23","522","10.2","10.6"
"Catoosa","2020-11-03","132","6938","12","534","10.3","10.7"
"Catoosa","2020-11-04","30","6968","3","537","10.2","11.4"
"Catoosa","2020-11-05","46","7014","6","543","9.9","12"
"Catoosa","2020-11-06","41","7055","9","552","12.2","12.3"
"Catoosa","2020-11-07","38","7093","9","561","13.7","13.2"
"Catoosa","2020-11-08","17","7110","5","566","16.6","13.5"
"Catoosa","2020-11-09","292","7402","54","620","18","14.1"
"Catoosa","2020-11-10","287","7689","24","644","17.8","14.1"
"Catoosa","2020-11-11","75","7764","8","652","17.9","14.1"
"Catoosa","2020-11-12","79","7843","3","655","16.6","13.3"
"Catoosa","2020-11-13","91","7934","7","662","14.6","13.4"
"Catoosa","2020-11-14","34","7968","7","669","14.1","13.9"
"Catoosa","2020-11-15","34","8002","5","674","12","14.3"
"Catoosa","2020-11-16","303","8305","37","711","11.1","14.5"
"Catoosa","2020-11-17","336","8641","36","747","11.5","14.7"
"Catoosa","2020-11-18","93","8734","7","754","11","14.5"
"Catoosa","2020-11-19","99","8833","13","767","12.4","14.5"
"Catoosa","2020-11-20","88","8921","13","780","13.4","14"
"Catoosa","2020-11-21","63","8984","12","792","13.2","13.7"
"Catoosa","2020-11-22","34","9018","2","794","11.9","12"
"Catoosa","2020-11-23","385","9403","53","847","12.1","11.6"
"Catoosa","2020-11-24","238","9641","22","869","11.9","11.7"
"Catoosa","2020-11-25","69","9710","13","882","13.5","12.3"
"Catoosa","2020-11-26","2","9712","0","882","11.7","12"
"Catoosa","2020-11-27","65","9777","15","897","12.8","13.1"
"Catoosa","2020-11-28","41","9818","7","904","12.6","12.9"
"Catoosa","2020-11-29","35","9853","8","912","15","13.4"
"Catoosa","2020-11-30","473","10326","59","971","14.8","13.5"
"Catoosa","2020-12-01","253","10579","23","994","14.8","13.3"
"Catoosa","2020-12-02","195","10774","27","1021","14.1","13.8"
"Catoosa","2020-12-03","75","10849","15","1036","16.9","14.3"
"Catoosa","2020-12-04","78","10927","11","1047","15.6","14.2"
"Catoosa","2020-12-05","42","10969","9","1056","16.3","14.4"
"Catoosa","2020-12-06","30","10999","7","1063","16.3","15.7"
"Catoosa","2020-12-07","429","11428","67","1130","16.8","15.8"
"Catoosa","2020-12-08","246","11674","30","1160","17.2","16"
"Catoosa","2020-12-09","232","11906","28","1188","17","15.5"
"Catoosa","2020-12-10","63","11969","12","1200","16.8","16.9"
"Catoosa","2020-12-11","71","12040","17","1217","18.2","16.9"
"Catoosa","2020-12-12","37","12077","5","1222","17.1","16.7"
"Catoosa","2020-12-13","35","12112","10","1232","17.9","17.1"
"Catoosa","2020-12-14","418","12530","67","1299","17.9","17.3"
"Catoosa","2020-12-15","346","12876","66","1365","18.9","18.1"
"Catoosa","2020-12-16","325","13201","52","1417","19.5","18.2"
"Catoosa","2020-12-17","83","13284","12","1429","18.8","17.8"
"Catoosa","2020-12-18","73","13357","16","1445","18.5","18.4"
"Catoosa","2020-12-19","38","13395","8","1453","19.6","18.3"
"Catoosa","2020-12-20","27","13422","6","1459","18.7","18.3"
"Catoosa","2020-12-21","524","13946","94","1553","19","18.4"
"Catoosa","2020-12-22","401","14347","51","1604","18","18.5"
"Catoosa","2020-12-23","305","14652","65","1669","18.8","19.1"
"Catoosa","2020-12-24","39","14691","6","1675","18.9","18.9"
"Catoosa","2020-12-25","0","14691","0","1675","15.8","17.2"
"Catoosa","2020-12-26","43","14734","15","1690","17.8","18.7"
"Catoosa","2020-12-27","43","14777","16","1706","19.9","19.3"
"Catoosa","2020-12-28","587","15364","135","1841","20.6","19.8"
"Catoosa","2020-12-29","423","15787","72","1913","21.3","19.7"
"Catoosa","2020-12-30","479","16266","96","2009","21.1","19.9"
"Catoosa","2020-12-31","62","16328","17","2026","22.8","20.9"
"Catoosa","2021-01-01","7","16335","2","2028","26.9","21.3"
"Catoosa","2021-01-02","10","16345","1","2029","23.3","20.6"
"Catoosa","2021-01-03","19","16364","5","2034","21.8","20.8"
"Catoosa","2021-01-04","478","16842","117","2151","22","21.3"
"Catoosa","2021-01-05","763","17605","142","2293","22.2","21.7"
"Catoosa","2021-01-06","290","17895","58","2351","22.2","21.6"
"Catoosa","2021-01-07","77","17972","18","2369","21.6","22.2"
"Catoosa","2021-01-08","88","18060","14","2383","19.8","23.3"
"Catoosa","2021-01-09","43","18103","11","2394","22","22.7"
"Catoosa","2021-01-10","26","18129","12","2406","24.9","23.3"
"Catoosa","2021-01-11","89","18218","9","2415","22.8","22.4"
"Catoosa","2021-01-12","320","18538","38","2453","21.9","22"
"Catoosa","2021-01-13","57","18595","13","2466","22.3","22.2"
"Catoosa","2021-01-14","68","18663","12","2478","21.4","21.5"
"Catoosa","2021-01-15","62","18725","9","2487","21.2","20.5"
"Catoosa","2021-01-16","45","18770","7","2494","19.8","20.9"
"Catoosa","2021-01-17","17","18787","4","2498","16.6","20.7"
"Catoosa","2021-01-18","72","18859","10","2508","17.1","20"
"Catoosa","2021-01-19","72","18931","10","2518","17.4","19.6"
"Catoosa","2021-01-20","73","19004","11","2529","16.3","19.3"
"Catoosa","2021-01-21","58","19062","8","2537","15.7","18.6"
"Catoosa","2021-01-22","74","19136","6","2543","14.8","18"
"Catoosa","2021-01-23","41","19177","8","2551","15.4","17.6"
"Catoosa","2021-01-24","22","19199","8","2559","17.2","16.9"
"Catoosa","2021-01-25","74","19273","9","2568","17","17.1"
"Catoosa","2021-01-26","67","19340","11","2579","17.3","17.4"
"Catoosa","2021-01-27","66","19406","9","2588","17.1","16.7"
"Catoosa","2021-01-28","54","19460","3","2591","16","15.9"
"Catoosa","2021-01-29","39","19499","11","2602","18.8","16.8"
"Catoosa","2021-01-30","34","19533","6","2608","18.6","17"
"Catoosa","2021-01-31","40","19573","3","2611","14.4","15.8"
"Catoosa","2021-02-01","64","19637","8","2619","14.5","15.7"
"Catoosa","2021-02-02","60","19697","11","2630","14.8","16.1"
"Catoosa","2021-02-03","50","19747","4","2634","14","15.6"
"Catoosa","2021-02-04","59","19806","8","2642","15.1","15.5"
"Catoosa","2021-02-05","26","19832","2","2644","12.2","15.5"
"Catoosa","2021-02-06","0","19832","0","2644","9.7","14.1"
"Catoosa","2021-02-07","0","19832","0","2644","8.6","11.5"
"Catoosa","2021-02-08","0","19832","0","2644","6.8","10.6"
"Charlton","2020-02-01","0","0","0","0",".","."
"Charlton","2020-02-02","0","0","0","0",".","."
"Charlton","2020-02-03","0","0","0","0",".","."
"Charlton","2020-02-04","0","0","0","0",".","."
"Charlton","2020-02-05","0","0","0","0",".","."
"Charlton","2020-02-06","0","0","0","0",".","."
"Charlton","2020-02-07","0","0","0","0","0","."
"Charlton","2020-02-08","0","0","0","0","0","."
"Charlton","2020-02-09","0","0","0","0","0","."
"Charlton","2020-02-10","0","0","0","0","0","."
"Charlton","2020-02-11","0","0","0","0","0","."
"Charlton","2020-02-12","0","0","0","0","0","."
"Charlton","2020-02-13","0","0","0","0","0","."
"Charlton","2020-02-14","0","0","0","0","0","0"
"Charlton","2020-02-15","0","0","0","0","0","0"
"Charlton","2020-02-16","0","0","0","0","0","0"
"Charlton","2020-02-17","0","0","0","0","0","0"
"Charlton","2020-02-18","0","0","0","0","0","0"
"Charlton","2020-02-19","0","0","0","0","0","0"
"Charlton","2020-02-20","0","0","0","0","0","0"
"Charlton","2020-02-21","0","0","0","0","0","0"
"Charlton","2020-02-22","0","0","0","0","0","0"
"Charlton","2020-02-23","0","0","0","0","0","0"
"Charlton","2020-02-24","0","0","0","0","0","0"
"Charlton","2020-02-25","0","0","0","0","0","0"
"Charlton","2020-02-26","0","0","0","0","0","0"
"Charlton","2020-02-27","0","0","0","0","0","0"
"Charlton","2020-02-28","0","0","0","0","0","0"
"Charlton","2020-02-29","0","0","0","0","0","0"
"Charlton","2020-03-01","0","0","0","0","0","0"
"Charlton","2020-03-02","0","0","0","0","0","0"
"Charlton","2020-03-03","0","0","0","0","0","0"
"Charlton","2020-03-04","0","0","0","0","0","0"
"Charlton","2020-03-05","0","0","0","0","0","0"
"Charlton","2020-03-06","0","0","0","0","0","0"
"Charlton","2020-03-07","0","0","0","0","0","0"
"Charlton","2020-03-08","0","0","0","0","0","0"
"Charlton","2020-03-09","0","0","0","0","0","0"
"Charlton","2020-03-10","0","0","0","0","0","0"
"Charlton","2020-03-11","0","0","0","0","0","0"
"Charlton","2020-03-12","0","0","0","0","0","0"
"Charlton","2020-03-13","2","2","1","1","7.1","3.6"
"Charlton","2020-03-14","0","2","0","1","7.1","3.6"
"Charlton","2020-03-15","0","2","0","1","7.1","3.6"
"Charlton","2020-03-16","0","2","0","1","7.1","3.6"
"Charlton","2020-03-17","1","3","1","2","21.4","10.7"
"Charlton","2020-03-18","3","6","0","2","21.4","10.7"
"Charlton","2020-03-19","1","7","0","2","21.4","10.7"
"Charlton","2020-03-20","3","10","0","2","14.3","10.7"
"Charlton","2020-03-21","0","10","0","2","14.3","10.7"
"Charlton","2020-03-22","0","10","0","2","14.3","10.7"
"Charlton","2020-03-23","2","12","0","2","14.3","10.7"
"Charlton","2020-03-24","2","14","0","2","0","10.7"
"Charlton","2020-03-25","3","17","1","3","4.8","13.1"
"Charlton","2020-03-26","0","17","0","3","4.8","13.1"
"Charlton","2020-03-27","0","17","0","3","4.8","9.5"
"Charlton","2020-03-28","1","18","0","3","4.8","9.5"
"Charlton","2020-03-29","1","19","0","3","4.8","9.5"
"Charlton","2020-03-30","2","21","0","3","4.8","9.5"
"Charlton","2020-03-31","3","24","0","3","4.8","2.4"
"Charlton","2020-04-01","1","25","0","3","0","2.4"
"Charlton","2020-04-02","0","25","0","3","0","2.4"
"Charlton","2020-04-03","0","25","0","3","0","2.4"
"Charlton","2020-04-04","1","26","0","3","0","2.4"
"Charlton","2020-04-05","1","27","0","3","0","2.4"
"Charlton","2020-04-06","3","30","0","3","0","2.4"
"Charlton","2020-04-07","2","32","0","3","0","2.4"
"Charlton","2020-04-08","9","41","2","5","3.2","1.6"
"Charlton","2020-04-09","6","47","0","5","3.2","1.6"
"Charlton","2020-04-10","2","49","0","5","3.2","1.6"
"Charlton","2020-04-11","2","51","0","5","3.2","1.6"
"Charlton","2020-04-12","0","51","0","5","3.2","1.6"
"Charlton","2020-04-13","2","53","1","6","10.3","5.2"
"Charlton","2020-04-14","9","62","0","6","10.3","5.2"
"Charlton","2020-04-15","8","70","1","7","8.9","6.1"
"Charlton","2020-04-16","4","74","0","7","8.9","6.1"
"Charlton","2020-04-17","10","84","1","8","10.4","6.8"
"Charlton","2020-04-18","4","88","0","8","10.4","6.8"
"Charlton","2020-04-19","0","88","0","8","10.4","6.8"
"Charlton","2020-04-20","1","89","0","8","3.2","6.8"
"Charlton","2020-04-21","2","91","0","8","3.2","6.8"
"Charlton","2020-04-22","13","104","0","8","1.4","5.2"
"Charlton","2020-04-23","4","108","0","8","1.4","5.2"
"Charlton","2020-04-24","3","111","0","8","0","5.2"
"Charlton","2020-04-25","3","114","0","8","0","5.2"
"Charlton","2020-04-26","1","115","0","8","0","5.2"
"Charlton","2020-04-27","5","120","0","8","0","1.6"
"Charlton","2020-04-28","7","127","0","8","0","1.6"
"Charlton","2020-04-29","6","133","2","10","4.8","3.1"
"Charlton","2020-04-30","1","134","0","10","4.8","3.1"
"Charlton","2020-05-01","7","141","1","11","6.8","3.4"
"Charlton","2020-05-02","3","144","1","12","11.6","5.8"
"Charlton","2020-05-03","0","144","0","12","11.6","5.8"
"Charlton","2020-05-04","10","154","1","13","13","6.5"
"Charlton","2020-05-05","16","170","0","13","13","6.5"
"Charlton","2020-05-06","15","185","1","14","9.2","7"
"Charlton","2020-05-07","5","190","1","15","12","8.4"
"Charlton","2020-05-08","2","192","0","15","10","8.4"
"Charlton","2020-05-09","1","193","0","15","5.2","8.4"
"Charlton","2020-05-10","3","196","0","15","5.2","8.4"
"Charlton","2020-05-11","6","202","1","16","6.2","9.6"
"Charlton","2020-05-12","15","217","5","21","11","12"
"Charlton","2020-05-13","3","220","1","22","14.8","12"
"Charlton","2020-05-14","3","223","1","23","16.7","14.4"
"Charlton","2020-05-15","6","229","1","24","19","14.5"
"Charlton","2020-05-16","7","236","1","25","21.1","13.2"
"Charlton","2020-05-17","2","238","1","26","28.2","16.7"
"Charlton","2020-05-18","9","247","0","26","25.9","16"
"Charlton","2020-05-19","13","260","0","26","21.1","16"
"Charlton","2020-05-20","73","333","3","29","16.9","15.8"
"Charlton","2020-05-21","13","346","0","29","12.2","14.4"
"Charlton","2020-05-22","10","356","1","30","11.2","15.1"
"Charlton","2020-05-23","3","359","0","30","9.2","15.1"
"Charlton","2020-05-24","2","361","0","30","2","15.1"
"Charlton","2020-05-25","5","366","0","30","2","13.9"
"Charlton","2020-05-26","3","369","1","31","6.8","13.9"
"Charlton","2020-05-27","10","379","0","31","6.2","11.6"
"Charlton","2020-05-28","10","389","0","31","6.2","9.2"
"Charlton","2020-05-29","10","399","1","32","6.2","8.7"
"Charlton","2020-05-30","3","402","0","32","6.2","7.7"
"Charlton","2020-05-31","0","402","0","32","6.2","4.1"
"Charlton","2020-06-01","6","408","0","32","6.2","4.1"
"Charlton","2020-06-02","5","413","1","33","4.3","5.5"
"Charlton","2020-06-03","5","418","0","33","4.3","5.2"
"Charlton","2020-06-04","1","419","0","33","4.3","5.2"
"Charlton","2020-06-05","5","424","0","33","2.9","4.5"
"Charlton","2020-06-06","5","429","1","34","5.7","6"
"Charlton","2020-06-07","2","431","0","34","5.7","6"
"Charlton","2020-06-08","4","435","0","34","5.7","6"
"Charlton","2020-06-09","3","438","0","34","2.9","3.6"
"Charlton","2020-06-10","4","442","0","34","2.9","3.6"
"Charlton","2020-06-11","5","447","0","34","2.9","3.6"
"Charlton","2020-06-12","5","452","0","34","2.9","2.9"
"Charlton","2020-06-13","4","456","0","34","0","2.9"
"Charlton","2020-06-14","2","458","1","35","7.1","6.4"
"Charlton","2020-06-15","12","470","0","35","7.1","6.4"
"Charlton","2020-06-16","11","481","1","36","8.4","5.6"
"Charlton","2020-06-17","6","487","0","36","8.4","5.6"
"Charlton","2020-06-18","4","491","0","36","8.4","5.6"
"Charlton","2020-06-19","8","499","1","37","10.2","6.5"
"Charlton","2020-06-20","2","501","0","37","10.2","5.1"
"Charlton","2020-06-21","4","505","3","40","13.8","10.5"
"Charlton","2020-06-22","3","508","0","40","13.8","10.5"
"Charlton","2020-06-23","13","521","1","41","13.6","11"
"Charlton","2020-06-24","26","547","2","43","14.7","11.6"
"Charlton","2020-06-25","34","581","2","45","15.5","12"
"Charlton","2020-06-26","23","604","1","46","14.4","12.3"
"Charlton","2020-06-27","14","618","1","47","15.4","12.8"
"Charlton","2020-06-28","3","621","0","47","4.7","9.2"
"Charlton","2020-06-29","16","637","1","48","5.6","9.7"
"Charlton","2020-06-30","35","672","6","54","6.9","10.3"
"Charlton","2020-07-01","23","695","1","55","6.4","10.6"
"Charlton","2020-07-02","48","743","10","65","8.6","12.1"
"Charlton","2020-07-03","9","752","2","67","11.1","12.8"
"Charlton","2020-07-04","8","760","4","71","17.3","16.3"
"Charlton","2020-07-05","7","767","5","76","27.5","16.1"
"Charlton","2020-07-06","24","791","7","83","30.7","18.2"
"Charlton","2020-07-07","54","845","5","88","29.6","18.3"
"Charlton","2020-07-08","81","926","14","102","31.5","19"
"Charlton","2020-07-09","43","969","12","114","32.5","20.5"
"Charlton","2020-07-10","51","1020","14","128","33.2","22.2"
"Charlton","2020-07-11","27","1047","7","135","29.8","23.5"
"Charlton","2020-07-12","9","1056","1","136","21.2","24.3"
"Charlton","2020-07-13","47","1103","11","147","20.3","25.5"
"Charlton","2020-07-14","57","1160","19","166","23.8","26.7"
"Charlton","2020-07-15","45","1205","18","184","27","29.2"
"Charlton","2020-07-16","34","1239","5","189","25.1","28.8"
"Charlton","2020-07-17","45","1284","10","199","24.4","28.8"
"Charlton","2020-07-18","24","1308","8","207","25.4","27.6"
"Charlton","2020-07-19","7","1315","1","208","25.9","23.5"
"Charlton","2020-07-20","30","1345","12","220","28.3","24.3"
"Charlton","2020-07-21","63","1408","11","231","26","24.9"
"Charlton","2020-07-22","56","1464","10","241","22.8","24.9"
"Charlton","2020-07-23","49","1513","17","258","25.7","25.4"
"Charlton","2020-07-24","36","1549","11","269","26.9","25.6"
"Charlton","2020-07-25","18","1567","2","271","23.7","24.6"
"Charlton","2020-07-26","5","1572","1","272","24.5","25.2"
"Charlton","2020-07-27","65","1637","21","293","23.4","25.8"
"Charlton","2020-07-28","46","1683","14","307","25.3","25.6"
"Charlton","2020-07-29","34","1717","3","310","24","23.4"
"Charlton","2020-07-30","123","1840","11","321","20.3","23"
"Charlton","2020-07-31","22","1862","4","325","18.5","22.7"
"Charlton","2020-08-01","10","1872","2","327","19.8","21.8"
"Charlton","2020-08-02","13","1885","5","332","22.5","23.5"
"Charlton","2020-08-03","48","1933","6","338","19.6","21.5"
"Charlton","2020-08-04","57","1990","6","344","16.8","21"
"Charlton","2020-08-05","65","2055","12","356","18.2","21.1"
"Charlton","2020-08-06","209","2264","13","369","17.8","19"
"Charlton","2020-08-07","49","2313","8","377","17.5","18"
"Charlton","2020-08-08","7","2320","2","379","18.7","19.3"
"Charlton","2020-08-09","9","2329","1","380","14.8","18.6"
"Charlton","2020-08-10","59","2388","6","386","14.5","17.1"
"Charlton","2020-08-11","25","2413","7","393","17","16.9"
"Charlton","2020-08-12","98","2511","32","425","19","18.6"
"Charlton","2020-08-13","196","2707","8","433","18.7","18.2"
"Charlton","2020-08-14","105","2812","7","440","17.3","17.4"
"Charlton","2020-08-15","7","2819","0","440","13.2","16"
"Charlton","2020-08-16","46","2865","5","445","13.2","14"
"Charlton","2020-08-17","29","2894","2","447","12.7","13.6"
"Charlton","2020-08-18","81","2975","15","462","11.4","14.2"
"Charlton","2020-08-19","201","3176","9","471","7.4","13.2"
"Charlton","2020-08-20","150","3326","14","485","8.1","13.4"
"Charlton","2020-08-21","70","3396","2","487","7.6","12.4"
"Charlton","2020-08-22","6","3402","0","487","7.6","10.4"
"Charlton","2020-08-23","8","3410","3","490","11.4","12.3"
"Charlton","2020-08-24","33","3443","2","492","11.2","12"
"Charlton","2020-08-25","125","3568","7","499","9.4","10.4"
"Charlton","2020-08-26","215","3783","10","509","9.4","8.4"
"Charlton","2020-08-27","191","3974","15","524","9.2","8.7"
"Charlton","2020-08-28","26","4000","0","524","8.8","8.2"
"Charlton","2020-08-29","16","4016","2","526","10.6","9.1"
"Charlton","2020-08-30","14","4030","4","530","9.3","10.3"
"Charlton","2020-08-31","34","4064","2","532","9.3","10.3"
"Charlton","2020-09-01","66","4130","3","535","9.1","9.3"
"Charlton","2020-09-02","47","4177","2","537","9.1","9.3"
"Charlton","2020-09-03","69","4246","4","541","8.8","9"
"Charlton","2020-09-04","23","4269","0","541","8.8","8.8"
"Charlton","2020-09-05","26","4295","1","542","7.6","9.1"
"Charlton","2020-09-06","5","4300","0","542","3.5","6.4"
"Charlton","2020-09-07","16","4316","1","543","3.5","6.4"
"Charlton","2020-09-08","36","4352","2","545","3.7","6.4"
"Charlton","2020-09-09","46","4398","2","547","3.7","6.4"
"Charlton","2020-09-10","67","4465","8","555","4.6","6.7"
"Charlton","2020-09-11","53","4518","2","557","5.1","6.9"
"Charlton","2020-09-12","6","4524","1","558","6.9","7.2"
"Charlton","2020-09-13","8","4532","1","559","8.7","6.1"
"Charlton","2020-09-14","28","4560","0","559","7.8","5.7"
"Charlton","2020-09-15","40","4600","2","561","7.7","5.7"
"Charlton","2020-09-16","28","4628","2","563","8.1","5.9"
"Charlton","2020-09-17","46","4674","2","565","7.1","5.8"
"Charlton","2020-09-18","16","4690","2","567","8.3","6.7"
"Charlton","2020-09-19","5","4695","0","567","5.9","6.4"
"Charlton","2020-09-20","8","4703","2","569","7.7","8.2"
"Charlton","2020-09-21","27","4730","3","572","9.3","8.6"
"Charlton","2020-09-22","54","4784","5","577","9.9","8.8"
"Charlton","2020-09-23","27","4811","3","580","10.5","9.3"
"Charlton","2020-09-24","49","4860","7","587","11.9","9.5"
"Charlton","2020-09-25","27","4887","1","588","10.6","9.5"
"Charlton","2020-09-26","19","4906","0","588","10.6","8.3"
"Charlton","2020-09-27","1","4907","0","588","7.1","7.4"
"Charlton","2020-09-28","28","4935","2","590","6.5","7.9"
"Charlton","2020-09-29","21","4956","2","592","6.5","8.2"
"Charlton","2020-09-30","30","4986","1","593","5.4","8"
"Charlton","2020-10-01","7","4993","0","593","3.4","7.6"
"Charlton","2020-10-02","12","5005","0","593","2.9","6.7"
"Charlton","2020-10-03","0","5005","0","593","2.9","6.7"
"Charlton","2020-10-04","4","5009","0","593","2.9","5"
"Charlton","2020-10-05","29","5038","1","594","2.3","4.4"
"Charlton","2020-10-06","19","5057","0","594","1","3.8"
"Charlton","2020-10-07","24","5081","1","595","1.1","3.3"
"Charlton","2020-10-08","24","5105","0","595","1.1","2.2"
"Charlton","2020-10-09","72","5177","1","596","1.3","2.1"
"Charlton","2020-10-10","4","5181","0","596","1.3","2.1"
"Charlton","2020-10-11","15","5196","2","598","3.2","3"
"Charlton","2020-10-12","11","5207","1","599","4","3.2"
"Charlton","2020-10-13","16","5223","1","600","4.9","2.9"
"Charlton","2020-10-14","41","5264","0","600","4.3","2.7"
"Charlton","2020-10-15","14","5278","1","601","5.3","3.2"
"Charlton","2020-10-16","17","5295","0","601","5.1","3.2"
"Charlton","2020-10-17","5","5300","0","601","5.1","3.2"
"Charlton","2020-10-18","4","5304","0","601","3.2","3.2"
"Charlton","2020-10-19","22","5326","0","601","1.9","3"
"Charlton","2020-10-20","34","5360","0","601","1","3"
"Charlton","2020-10-21","18","5378","0","601","1","2.7"
"Charlton","2020-10-22","10","5388","2","603","2.9","4.1"
"Charlton","2020-10-23","25","5413","0","603","2.9","4"
"Charlton","2020-10-24","3","5416","0","603","2.9","4"
"Charlton","2020-10-25","4","5420","0","603","2.9","3"
"Charlton","2020-10-26","52","5472","0","603","2.9","2.4"
"Charlton","2020-10-27","20","5492","2","605","4.3","2.7"
"Charlton","2020-10-28","30","5522","1","606","4.8","2.9"
"Charlton","2020-10-29","25","5547","2","608","3","3"
"Charlton","2020-10-30","20","5567","1","609","3.8","3.3"
"Charlton","2020-10-31","6","5573","0","609","3.8","3.3"
"Charlton","2020-11-01","1","5574","0","609","3.8","3.3"
"Charlton","2020-11-02","18","5592","1","610","4.6","3.7"
"Charlton","2020-11-03","17","5609","1","611","4","4.1"
"Charlton","2020-11-04","24","5633","3","614","5.3","5"
"Charlton","2020-11-05","17","5650","3","617","6.7","4.9"
"Charlton","2020-11-06","24","5674","1","618","6.5","5.1"
"Charlton","2020-11-07","8","5682","3","621","11.9","7.8"
"Charlton","2020-11-08","4","5686","1","622","15.5","9.6"
"Charlton","2020-11-09","28","5714","1","623","15.2","9.9"
"Charlton","2020-11-10","18","5732","3","626","16.7","10.3"
"Charlton","2020-11-11","29","5761","0","626","14.9","10.1"
"Charlton","2020-11-12","30","5791","3","629","13.8","10.2"
"Charlton","2020-11-13","17","5808","2","631","14.9","10.7"
"Charlton","2020-11-14","12","5820","0","631","9.6","10.7"
"Charlton","2020-11-15","2","5822","1","632","13.1","14.3"
"Charlton","2020-11-16","32","5854","1","633","13.1","14.1"
"Charlton","2020-11-17","10","5864","2","635","13.6","15.1"
"Charlton","2020-11-18","42","5906","2","637","14.2","14.6"
"Charlton","2020-11-19","21","5927","4","641","15.5","14.7"
"Charlton","2020-11-20","16","5943","2","643","15.6","15.3"
"Charlton","2020-11-21","51","5994","4","647","16.8","13.2"
"Charlton","2020-11-22","4","5998","0","647","9.6","11.4"
"Charlton","2020-11-23","355","6353","3","650","9.3","11.2"
"Charlton","2020-11-24","20","6373","1","651","7.1","10.3"
"Charlton","2020-11-25","39","6412","3","654","7.6","10.9"
"Charlton","2020-11-26","48","6460","1","655","5.1","10.3"
"Charlton","2020-11-27","8","6468","1","656","5.1","10.4"
"Charlton","2020-11-28","14","6482","4","660","8.1","12.4"
"Charlton","2020-11-29","4","6486","1","661","11.7","10.6"
"Charlton","2020-11-30","112","6598","2","663","11.8","10.5"
"Charlton","2020-12-01","68","6666","1","664","11.3","9.2"
"Charlton","2020-12-02","38","6704","2","666","11","9.3"
"Charlton","2020-12-03","72","6776","11","677","12.8","9"
"Charlton","2020-12-04","52","6828","5","682","12.4","8.8"
"Charlton","2020-12-05","31","6859","2","684","9.3","8.7"
"Charlton","2020-12-06","7","6866","0","684","5.7","8.7"
"Charlton","2020-12-07","130","6996","4","688","5.9","8.8"
"Charlton","2020-12-08","20","7016","2","690","7.1","9.2"
"Charlton","2020-12-09","76","7092","7","697","7.7","9.3"
"Charlton","2020-12-10","37","7129","3","700","6.6","9.7"
"Charlton","2020-12-11","132","7261","6","706","5.9","9.2"
"Charlton","2020-12-12","38","7299","3","709","6.1","7.7"
"Charlton","2020-12-13","4","7303","1","710","9.7","7.7"
"Charlton","2020-12-14","49","7352","4","714","10.4","8.1"
"Charlton","2020-12-15","80","7432","6","720","10.1","8.6"
"Charlton","2020-12-16","44","7476","5","725","10.4","9"
"Charlton","2020-12-17","32","7508","6","731","11.9","9.3"
"Charlton","2020-12-18","29","7537","4","735","13.2","9.6"
"Charlton","2020-12-19","15","7552","6","741","17.8","12"
"Charlton","2020-12-20","11","7563","2","743","16.8","13.3"
"Charlton","2020-12-21","64","7627","8","751","17.4","13.9"
"Charlton","2020-12-22","43","7670","3","754","17.4","13.7"
"Charlton","2020-12-23","71","7741","19","773","19.6","15"
"Charlton","2020-12-24","28","7769","8","781","21","16.4"
"Charlton","2020-12-25","3","7772","1","782","23.8","18.5"
"Charlton","2020-12-26","8","7780","3","785","23.4","20.6"
"Charlton","2020-12-27","9","7789","2","787","24","20.4"
"Charlton","2020-12-28","110","7899","5","792","22.8","20.1"
"Charlton","2020-12-29","59","7958","9","801","24","20.7"
"Charlton","2020-12-30","205","8163","16","817","21.3","20.4"
"Charlton","2020-12-31","17","8180","5","822","21.4","21.2"
"Charlton","2021-01-01","8","8188","0","822","16.7","20.2"
"Charlton","2021-01-02","5","8193","1","823","14.2","18.8"
"Charlton","2021-01-03","7","8200","0","823","11","17.5"
"Charlton","2021-01-04","73","8273","11","834","12.5","17.7"
"Charlton","2021-01-05","31","8304","13","847","16.3","20.2"
"Charlton","2021-01-06","127","8431","2","849","15.4","18.4"
"Charlton","2021-01-07","35","8466","5","854","13.3","17.4"
"Charlton","2021-01-08","29","8495","5","859","15.7","16.2"
"Charlton","2021-01-09","13","8508","3","862","16.2","15.2"
"Charlton","2021-01-10","3","8511","2","864","25.7","18.3"
"Charlton","2021-01-11","27","8538","3","867","25.1","18.8"
"Charlton","2021-01-12","34","8572","7","874","22.1","19.2"
"Charlton","2021-01-13","64","8636","3","877","22.5","19"
"Charlton","2021-01-14","132","8768","4","881","20.9","17.1"
"Charlton","2021-01-15","30","8798","4","885","20.4","18"
"Charlton","2021-01-16","13","8811","4","889","21.5","18.8"
"Charlton","2021-01-17","5","8816","2","891","17.6","21.7"
"Charlton","2021-01-18","16","8832","1","892","17","21"
"Charlton","2021-01-19","28","8860","3","895","15.5","18.8"
"Charlton","2021-01-20","83","8943","6","901","15.9","19.2"
"Charlton","2021-01-21","98","9041","2","903","15.8","18.3"
"Charlton","2021-01-22","82","9123","2","905","14.2","17.3"
"Charlton","2021-01-23","52","9175","1","906","10.1","15.8"
"Charlton","2021-01-24","3","9178","1","907","9.1","13.4"
"Charlton","2021-01-25","25","9203","6","913","11.7","14.3"
"Charlton","2021-01-26","23","9226","2","915","11.4","13.5"
"Charlton","2021-01-27","26","9252","2","917","11.4","13.7"
"Charlton","2021-01-28","17","9269","2","919","12.8","14.3"
"Charlton","2021-01-29","32","9301","1","920","12.9","13.6"
"Charlton","2021-01-30","8","9309","3","923","18","14.1"
"Charlton","2021-01-31","6","9315","3","926","20.4","14.8"
"Charlton","2021-02-01","19","9334","1","927","17.7","14.7"
"Charlton","2021-02-02","25","9359","0","927","16.5","13.9"
"Charlton","2021-02-03","12","9371","3","930","19","15.2"
"Charlton","2021-02-04","21","9392","3","933","19.3","16.1"
"Charlton","2021-02-05","17","9409","3","936","21.4","17.2"
"Charlton","2021-02-06","1","9410","0","936","16","17"
"Charlton","2021-02-07","0","9410","0","936","8.9","14.6"
"Charlton","2021-02-08","0","9410","0","936","8.1","12.9"
"Chatham","2020-02-01","0","0","0","0",".","."
"Chatham","2020-02-02","0","0","0","0",".","."
"Chatham","2020-02-03","0","0","0","0",".","."
"Chatham","2020-02-04","1","1","0","0",".","."
"Chatham","2020-02-05","0","1","0","0",".","."
"Chatham","2020-02-06","0","1","0","0",".","."
"Chatham","2020-02-07","0","1","0","0","0","."
"Chatham","2020-02-08","0","1","0","0","0","."
"Chatham","2020-02-09","0","1","0","0","0","."
"Chatham","2020-02-10","2","3","0","0","0","."
"Chatham","2020-02-11","0","3","0","0","0","."
"Chatham","2020-02-12","0","3","0","0","0","."
"Chatham","2020-02-13","0","3","0","0","0","."
"Chatham","2020-02-14","0","3","0","0","0","0"
"Chatham","2020-02-15","0","3","0","0","0","0"
"Chatham","2020-02-16","0","3","0","0","0","0"
"Chatham","2020-02-17","0","3","0","0","0","0"
"Chatham","2020-02-18","0","3","0","0","0","0"
"Chatham","2020-02-19","0","3","0","0","0","0"
"Chatham","2020-02-20","0","3","0","0","0","0"
"Chatham","2020-02-21","0","3","0","0","0","0"
"Chatham","2020-02-22","0","3","0","0","0","0"
"Chatham","2020-02-23","0","3","0","0","0","0"
"Chatham","2020-02-24","0","3","0","0","0","0"
"Chatham","2020-02-25","0","3","0","0","0","0"
"Chatham","2020-02-26","0","3","0","0","0","0"
"Chatham","2020-02-27","1","4","1","1","14.3","7.1"
"Chatham","2020-02-28","0","4","0","1","14.3","7.1"
"Chatham","2020-02-29","0","4","0","1","14.3","7.1"
"Chatham","2020-03-01","0","4","0","1","14.3","7.1"
"Chatham","2020-03-02","0","4","0","1","14.3","7.1"
"Chatham","2020-03-03","0","4","0","1","14.3","7.1"
"Chatham","2020-03-04","0","4","0","1","14.3","7.1"
"Chatham","2020-03-05","0","4","0","1","0","7.1"
"Chatham","2020-03-06","2","6","0","1","0","7.1"
"Chatham","2020-03-07","0","6","0","1","0","7.1"
"Chatham","2020-03-08","0","6","0","1","0","7.1"
"Chatham","2020-03-09","2","8","0","1","0","7.1"
"Chatham","2020-03-10","1","9","0","1","0","7.1"
"Chatham","2020-03-11","1","10","0","1","0","7.1"
"Chatham","2020-03-12","22","32","0","1","0","0"
"Chatham","2020-03-13","34","66","1","2","0.4","0.2"
"Chatham","2020-03-14","38","104","0","2","0.4","0.2"
"Chatham","2020-03-15","58","162","0","2","0.4","0.2"
"Chatham","2020-03-16","76","238","3","5","1","0.5"
"Chatham","2020-03-17","74","312","1","6","1.2","0.6"
"Chatham","2020-03-18","76","388","7","13","2.5","1.2"
"Chatham","2020-03-19","28","416","5","18","5","2.5"
"Chatham","2020-03-20","74","490","5","23","5.6","3"
"Chatham","2020-03-21","47","537","1","24","5.9","3.2"
"Chatham","2020-03-22","40","577","3","27","7","3.7"
"Chatham","2020-03-23","87","664","10","37","8","4.5"
"Chatham","2020-03-24","107","771","7","44","8.8","5"
"Chatham","2020-03-25","107","878","6","50","8.3","5.4"
"Chatham","2020-03-26","104","982","9","59","7","6"
"Chatham","2020-03-27","99","1081","16","75","8.3","6.9"
"Chatham","2020-03-28","19","1100","1","76","8.7","7.3"
"Chatham","2020-03-29","22","1122","5","81","10.9","8.9"
"Chatham","2020-03-30","103","1225","10","91","10.7","9.4"
"Chatham","2020-03-31","79","1304","7","98","11","9.9"
"Chatham","2020-04-01","87","1391","11","109","12","10.1"
"Chatham","2020-04-02","73","1464","6","115","11.9","9.4"
"Chatham","2020-04-03","106","1570","8","123","10.7","9.5"
"Chatham","2020-04-04","33","1603","2","125","10.8","9.8"
"Chatham","2020-04-05","39","1642","6","131","9.8","10.3"
"Chatham","2020-04-06","149","1791","7","138","9.1","9.9"
"Chatham","2020-04-07","113","1904","5","143","8.4","9.7"
"Chatham","2020-04-08","119","2023","7","150","7.5","9.7"
"Chatham","2020-04-09","115","2138","10","160","7.5","9.7"
"Chatham","2020-04-10","95","2233","2","162","6.8","8.7"
"Chatham","2020-04-11","13","2246","1","163","7","8.9"
"Chatham","2020-04-12","10","2256","1","164","6.2","8"
"Chatham","2020-04-13","65","2321","6","170","6.9","8"
"Chatham","2020-04-14","122","2443","13","183","7.8","8.1"
"Chatham","2020-04-15","97","2540","7","190","7.9","7.7"
"Chatham","2020-04-16","126","2666","4","194","7.2","7.3"
"Chatham","2020-04-17","113","2779","8","202","7.9","7.3"
"Chatham","2020-04-18","62","2841","2","204","7.2","7.1"
"Chatham","2020-04-19","20","2861","0","204","5.8","6"
"Chatham","2020-04-20","150","3011","13","217","5.7","6.3"
"Chatham","2020-04-21","151","3162","0","217","4.2","6"
"Chatham","2020-04-22","174","3336","4","221","3.5","5.7"
"Chatham","2020-04-23","104","3440","4","225","3.6","5.4"
"Chatham","2020-04-24","96","3536","2","227","2.9","5.4"
"Chatham","2020-04-25","24","3560","0","227","2.4","4.8"
"Chatham","2020-04-26","30","3590","1","228","2.9","4.3"
"Chatham","2020-04-27","184","3774","4","232","2","3.8"
"Chatham","2020-04-28","128","3902","7","239","2.7","3.5"
"Chatham","2020-04-29","91","3993","3","242","2.9","3.2"
"Chatham","2020-04-30","125","4118","13","255","3.8","3.7"
"Chatham","2020-05-01","96","4214","6","261","4.4","3.6"
"Chatham","2020-05-02","42","4256","5","266","6.1","4.3"
"Chatham","2020-05-03","38","4294","0","266","5.6","4.3"
"Chatham","2020-05-04","119","4413","4","270","5.8","3.9"
"Chatham","2020-05-05","89","4502","5","275","5.8","4.3"
"Chatham","2020-05-06","179","4681","3","278","5.6","4.2"
"Chatham","2020-05-07","87","4768","1","279","4.3","4.1"
"Chatham","2020-05-08","84","4852","3","282","3.9","4.2"
"Chatham","2020-05-09","65","4917","6","288","3.5","4.8"
"Chatham","2020-05-10","28","4945","0","288","3.5","4.6"
"Chatham","2020-05-11","167","5112","9","297","3.8","4.8"
"Chatham","2020-05-12","107","5219","2","299","3.3","4.6"
"Chatham","2020-05-13","246","5465","7","306","3.4","4.5"
"Chatham","2020-05-14","351","5816","6","312","3.5","3.9"
"Chatham","2020-05-15","188","6004","6","318","3.5","3.7"
"Chatham","2020-05-16","194","6198","9","327","2.8","3.2"
"Chatham","2020-05-17","34","6232","3","330","4.1","3.8"
"Chatham","2020-05-18","410","6642","17","347","3.9","3.8"
"Chatham","2020-05-19","189","6831","5","352","4","3.6"
"Chatham","2020-05-20","341","7172","13","365","4.1","3.8"
"Chatham","2020-05-21","193","7365","8","373","4.5","4"
"Chatham","2020-05-22","248","7613","5","378","4.3","3.9"
"Chatham","2020-05-23","121","7734","1","379","3.8","3.3"
"Chatham","2020-05-24","62","7796","1","380","2.7","3.4"
"Chatham","2020-05-25","65","7861","3","383","2.8","3.3"
"Chatham","2020-05-26","367","8228","5","388","2.6","3.3"
"Chatham","2020-05-27","424","8652","10","398","2.4","3.3"
"Chatham","2020-05-28","485","9137","6","404","2","3.2"
"Chatham","2020-05-29","639","9776","9","413","1.9","3.1"
"Chatham","2020-05-30","283","10059","3","416","2","2.9"
"Chatham","2020-05-31","66","10125","9","425","3.7","3.2"
"Chatham","2020-06-01","399","10524","6","431","3.2","3"
"Chatham","2020-06-02","300","10824","8","439","3.4","3"
"Chatham","2020-06-03","274","11098","4","443","3.3","2.9"
"Chatham","2020-06-04","462","11560","15","458","3.6","2.8"
"Chatham","2020-06-05","199","11759","5","463","3.7","2.8"
"Chatham","2020-06-06","94","11853","10","473","5.1","3.5"
"Chatham","2020-06-07","40","11893","2","475","3.9","3.8"
"Chatham","2020-06-08","294","12187","23","498","4.8","4"
"Chatham","2020-06-09","228","12415","15","513","5.3","4.4"
"Chatham","2020-06-10","420","12835","25","538","6","4.6"
"Chatham","2020-06-11","297","13132","16","554","6.3","4.9"
"Chatham","2020-06-12","230","13362","12","566","6.7","5.2"
"Chatham","2020-06-13","196","13558","9","575","5.8","5.4"
"Chatham","2020-06-14","72","13630","7","582","6.5","5.2"
"Chatham","2020-06-15","365","13995","30","612","6.5","5.6"
"Chatham","2020-06-16","329","14324","46","658","7.6","6.5"
"Chatham","2020-06-17","286","14610","34","692","8.4","7.2"
"Chatham","2020-06-18","623","15233","59","751","9","7.6"
"Chatham","2020-06-19","902","16135","72","823","9.4","8"
"Chatham","2020-06-20","527","16662","40","863","9.8","7.8"
"Chatham","2020-06-21","71","16733","23","886","13.1","9.8"
"Chatham","2020-06-22","1251","17984","151","1037","13.6","10.1"
"Chatham","2020-06-23","877","18861","81","1118","12.9","10.3"
"Chatham","2020-06-24","1225","20086","142","1260","12.9","10.7"
"Chatham","2020-06-25","1168","21254","121","1381","13","11"
"Chatham","2020-06-26","1439","22693","135","1516","13.2","11.3"
"Chatham","2020-06-27","907","23600","89","1605","13.5","11.7"
"Chatham","2020-06-28","161","23761","26","1631","11.2","12.2"
"Chatham","2020-06-29","1359","25120","145","1776","11","12.3"
"Chatham","2020-06-30","1584","26704","188","1964","11.4","12.2"
"Chatham","2020-07-01","1412","28116","141","2105","11.2","12"
"Chatham","2020-07-02","1280","29396","153","2258","11.4","12.2"
"Chatham","2020-07-03","429","29825","97","2355","13.3","13.3"
"Chatham","2020-07-04","141","29966","35","2390","15.4","14.5"
"Chatham","2020-07-05","161","30127","39","2429","16.6","13.9"
"Chatham","2020-07-06","1521","31648","236","2665","17.3","14.2"
"Chatham","2020-07-07","1287","32935","165","2830","17.4","14.4"
"Chatham","2020-07-08","1495","34430","184","3014","17.8","14.5"
"Chatham","2020-07-09","1300","35730","167","3181","17.9","14.6"
"Chatham","2020-07-10","1231","36961","144","3325","16.3","14.8"
"Chatham","2020-07-11","523","37484","87","3412","15.1","15.3"
"Chatham","2020-07-12","170","37654","51","3463","16","16.3"
"Chatham","2020-07-13","1425","39079","223","3686","16","16.6"
"Chatham","2020-07-14","1365","40444","187","3873","16.1","16.8"
"Chatham","2020-07-15","1210","41654","185","4058","16.5","17.1"
"Chatham","2020-07-16","1525","43179","178","4236","16.4","17.1"
"Chatham","2020-07-17","1247","44426","158","4394","16.5","16.4"
"Chatham","2020-07-18","723","45149","107","4501","16.3","15.7"
"Chatham","2020-07-19","202","45351","43","4544","15","15.5"
"Chatham","2020-07-20","1378","46729","199","4743","14.8","15.4"
"Chatham","2020-07-21","1084","47813","108","4851","14.3","15.2"
"Chatham","2020-07-22","1170","48983","136","4987","13.8","15.2"
"Chatham","2020-07-23","902","49885","132","5119","14.2","15.3"
"Chatham","2020-07-24","999","50884","102","5221","13.9","15.2"
"Chatham","2020-07-25","469","51353","58","5279","13.5","14.9"
"Chatham","2020-07-26","188","51541","45","5324","13.9","14.4"
"Chatham","2020-07-27","1736","53277","173","5497","13.2","14"
"Chatham","2020-07-28","1270","54547","121","5618","13.2","13.7"
"Chatham","2020-07-29","1003","55550","121","5739","13.2","13.5"
"Chatham","2020-07-30","949","56499","128","5867","13.1","13.6"
"Chatham","2020-07-31","1218","57717","143","6010","13.3","13.6"
"Chatham","2020-08-01","892","58609","102","6112","13.2","13.3"
"Chatham","2020-08-02","198","58807","36","6148","12.3","13.1"
"Chatham","2020-08-03","657","59464","97","6245","13","13.1"
"Chatham","2020-08-04","1371","60835","160","6405","13.3","13.3"
"Chatham","2020-08-05","969","61804","83","6488","12.8","13"
"Chatham","2020-08-06","1163","62967","100","6588","12.1","12.6"
"Chatham","2020-08-07","976","63943","89","6677","11.8","12.5"
"Chatham","2020-08-08","443","64386","55","6732","11.9","12.5"
"Chatham","2020-08-09","299","64685","42","6774","11.3","11.8"
"Chatham","2020-08-10","1142","65827","91","6865","10.3","11.7"
"Chatham","2020-08-11","662","66489","82","6947","10.4","11.9"
"Chatham","2020-08-12","960","67449","77","7024","10.4","11.6"
"Chatham","2020-08-13","878","68327","59","7083","10.1","11.1"
"Chatham","2020-08-14","912","69239","95","7178","10.3","11"
"Chatham","2020-08-15","379","69618","33","7211","9.8","10.8"
"Chatham","2020-08-16","517","70135","34","7245","8.7","10"
"Chatham","2020-08-17","481","70616","58","7303","9.3","9.8"
"Chatham","2020-08-18","893","71509","72","7375","8.7","9.5"
"Chatham","2020-08-19","894","72403","77","7452","8.7","9.6"
"Chatham","2020-08-20","796","73199","79","7531","9.2","9.6"
"Chatham","2020-08-21","747","73946","74","7605","9.1","9.7"
"Chatham","2020-08-22","270","74216","34","7639","9.7","9.7"
"Chatham","2020-08-23","173","74389","23","7662","10.6","9.7"
"Chatham","2020-08-24","987","75376","96","7758","10.3","9.8"
"Chatham","2020-08-25","696","76072","80","7838","10.8","9.7"
"Chatham","2020-08-26","856","76928","75","7913","10.8","9.8"
"Chatham","2020-08-27","832","77760","76","7989","10.7","9.9"
"Chatham","2020-08-28","707","78467","71","8060","10.7","9.9"
"Chatham","2020-08-29","226","78693","38","8098","11.3","10.5"
"Chatham","2020-08-30","299","78992","27","8125","10.7","10.7"
"Chatham","2020-08-31","997","79989","92","8217","10.6","10.5"
"Chatham","2020-09-01","881","80870","77","8294","10.3","10.5"
"Chatham","2020-09-02","879","81749","80","8374","10.3","10.6"
"Chatham","2020-09-03","824","82573","75","8449","10.3","10.5"
"Chatham","2020-09-04","752","83325","79","8528","10.4","10.5"
"Chatham","2020-09-05","485","83810","42","8570","9.2","10.3"
"Chatham","2020-09-06","244","84054","14","8584","8.7","9.7"
"Chatham","2020-09-07","465","84519","53","8637","9","9.8"
"Chatham","2020-09-08","893","85412","77","8714","9","9.6"
"Chatham","2020-09-09","902","86314","75","8789","8.9","9.6"
"Chatham","2020-09-10","788","87102","54","8843","8.6","9.4"
"Chatham","2020-09-11","768","87870","75","8918","8.5","9.4"
"Chatham","2020-09-12","215","88085","26","8944","9","9.1"
"Chatham","2020-09-13","355","88440","34","8978","9.5","9.1"
"Chatham","2020-09-14","1030","89470","75","9053","8.9","9"
"Chatham","2020-09-15","750","90220","60","9113","8.8","8.9"
"Chatham","2020-09-16","690","90910","56","9169","8.8","8.9"
"Chatham","2020-09-17","971","91881","82","9251","9","8.8"
"Chatham","2020-09-18","713","92594","48","9299","8.6","8.5"
"Chatham","2020-09-19","466","93060","34","9333","7.9","8.4"
"Chatham","2020-09-20","264","93324","13","9346","7.3","8.4"
"Chatham","2020-09-21","788","94112","51","9397","7.1","8"
"Chatham","2020-09-22","692","94804","54","9451","7.1","8"
"Chatham","2020-09-23","662","95466","42","9493","6.9","7.8"
"Chatham","2020-09-24","838","96304","41","9534","6.4","7.7"
"Chatham","2020-09-25","671","96975","44","9578","6.3","7.5"
"Chatham","2020-09-26","174","97149","12","9590","6.3","7.1"
"Chatham","2020-09-27","95","97244","18","9608","8.3","7.8"
"Chatham","2020-09-28","798","98042","42","9650","8.1","7.6"
"Chatham","2020-09-29","620","98662","50","9700","8.1","7.6"
"Chatham","2020-09-30","712","99374","39","9739","8","7.4"
"Chatham","2020-10-01","629","100003","33","9772","8.1","7.2"
"Chatham","2020-10-02","583","100586","35","9807","8","7.2"
"Chatham","2020-10-03","357","100943","15","9822","7.6","6.9"
"Chatham","2020-10-04","274","101217","12","9834","5.5","6.9"
"Chatham","2020-10-05","840","102057","64","9898","5.9","7"
"Chatham","2020-10-06","733","102790","40","9938","5.5","6.8"
"Chatham","2020-10-07","591","103381","25","9963","5.3","6.7"
"Chatham","2020-10-08","775","104156","53","10016","5.5","6.8"
"Chatham","2020-10-09","628","104784","29","10045","5.3","6.7"
"Chatham","2020-10-10","207","104991","18","10063","6","6.8"
"Chatham","2020-10-11","236","105227","21","10084","6.6","6.1"
"Chatham","2020-10-12","617","105844","46","10130","6.6","6.2"
"Chatham","2020-10-13","818","106662","37","10167","6.5","6"
"Chatham","2020-10-14","491","107153","23","10190","6.5","5.9"
"Chatham","2020-10-15","619","107772","37","10227","6.4","6"
"Chatham","2020-10-16","617","108389","40","10267","6.7","6"
"Chatham","2020-10-17","304","108693","26","10293","6.7","6.3"
"Chatham","2020-10-18","173","108866","12","10305","6.4","6.5"
"Chatham","2020-10-19","906","109772","48","10353","6.1","6.3"
"Chatham","2020-10-20","634","110406","56","10409","6.7","6.6"
"Chatham","2020-10-21","533","110939","29","10438","6.8","6.7"
"Chatham","2020-10-22","706","111645","54","10492","7","6.7"
"Chatham","2020-10-23","512","112157","32","10524","7","6.8"
"Chatham","2020-10-24","261","112418","5","10529","6","6.3"
"Chatham","2020-10-25","129","112547","8","10537","5.9","6.2"
"Chatham","2020-10-26","756","113303","50","10587","6.1","6.1"
"Chatham","2020-10-27","571","113874","41","10628","5.9","6.3"
"Chatham","2020-10-28","541","114415","33","10661","6","6.4"
"Chatham","2020-10-29","609","115024","42","10703","5.9","6.5"
"Chatham","2020-10-30","555","115579","37","10740","5.9","6.5"
"Chatham","2020-10-31","167","115746","8","10748","6.3","6.2"
"Chatham","2020-11-01","116","115862","8","10756","6.4","6.2"
"Chatham","2020-11-02","906","116768","50","10806","6.3","6.2"
"Chatham","2020-11-03","398","117166","37","10843","6.6","6.2"
"Chatham","2020-11-04","422","117588","27","10870","6.6","6.3"
"Chatham","2020-11-05","692","118280","36","10906","6.4","6.1"
"Chatham","2020-11-06","496","118776","34","10940","6.4","6.2"
"Chatham","2020-11-07","247","119023","23","10963","7.1","6.7"
"Chatham","2020-11-08","153","119176","15","10978","7.5","7"
"Chatham","2020-11-09","816","119992","69","11047","7.9","7.1"
"Chatham","2020-11-10","760","120752","51","11098","7.5","7.1"
"Chatham","2020-11-11","460","121212","45","11143","8","7.3"
"Chatham","2020-11-12","558","121770","56","11199","8.7","7.6"
"Chatham","2020-11-13","821","122591","43","11242","8.5","7.4"
"Chatham","2020-11-14","372","122963","33","11275","8.4","7.7"
"Chatham","2020-11-15","175","123138","31","11306","9.5","8.5"
"Chatham","2020-11-16","996","124134","77","11383","9.4","8.7"
"Chatham","2020-11-17","863","124997","61","11444","9.5","8.5"
"Chatham","2020-11-18","660","125657","35","11479","8.9","8.4"
"Chatham","2020-11-19","815","126472","57","11536","8.4","8.6"
"Chatham","2020-11-20","731","127203","44","11580","8.5","8.5"
"Chatham","2020-11-21","457","127660","21","11601","7.9","8.2"
"Chatham","2020-11-22","231","127891","14","11615","6.3","7.9"
"Chatham","2020-11-23","1083","128974","76","11691","6.2","7.8"
"Chatham","2020-11-24","961","129935","80","11771","6.3","7.9"
"Chatham","2020-11-25","940","130875","73","11844","6.7","7.8"
"Chatham","2020-11-26","80","130955","3","11847","6.2","7.3"
"Chatham","2020-11-27","255","131210","35","11882","7.3","7.9"
"Chatham","2020-11-28","169","131379","30","11912","9.2","8.6"
"Chatham","2020-11-29","199","131578","17","11929","9.6","7.9"
"Chatham","2020-11-30","1029","132607","96","12025","9.9","8"
"Chatham","2020-12-01","850","133457","91","12116","10.2","8.3"
"Chatham","2020-12-02","697","134154","60","12176","10.3","8.5"
"Chatham","2020-12-03","761","134915","70","12246","11.1","8.7"
"Chatham","2020-12-04","671","135586","53","12299","10.3","8.8"
"Chatham","2020-12-05","426","136012","47","12346","9.3","9.3"
"Chatham","2020-12-06","195","136207","22","12368","9.7","9.6"
"Chatham","2020-12-07","1025","137232","96","12464","9.7","9.8"
"Chatham","2020-12-08","738","137970","80","12544","9.7","10"
"Chatham","2020-12-09","944","138914","89","12633","9.9","10.1"
"Chatham","2020-12-10","729","139643","77","12710","10.1","10.6"
"Chatham","2020-12-11","756","140399","89","12799","10.6","10.5"
"Chatham","2020-12-12","223","140622","25","12824","10.6","10"
"Chatham","2020-12-13","172","140794","34","12858","11.8","10.8"
"Chatham","2020-12-14","916","141710","127","12985","12.5","11.1"
"Chatham","2020-12-15","866","142576","99","13084","12.6","11.2"
"Chatham","2020-12-16","983","143559","107","13191","12.8","11.3"
"Chatham","2020-12-17","838","144397","90","13281","12.8","11.4"
"Chatham","2020-12-18","845","145242","96","13377","12.8","11.7"
"Chatham","2020-12-19","454","145696","37","13414","12.3","11.5"
"Chatham","2020-12-20","245","145941","38","13452","11.7","11.8"
"Chatham","2020-12-21","1224","147165","106","13558","11","11.7"
"Chatham","2020-12-22","1035","148200","118","13676","11","11.8"
"Chatham","2020-12-23","1019","149219","110","13786","10.9","11.9"
"Chatham","2020-12-24","359","149578","41","13827","11","11.9"
"Chatham","2020-12-25","104","149682","11","13838","10.9","11.8"
"Chatham","2020-12-26","185","149867","27","13865","11.9","12.1"
"Chatham","2020-12-27","201","150068","48","13913","13","12.4"
"Chatham","2020-12-28","1287","151355","158","14071","13.6","12.3"
"Chatham","2020-12-29","1130","152485","151","14222","13.8","12.4"
"Chatham","2020-12-30","1065","153550","154","14376","14.4","12.7"
"Chatham","2020-12-31","833","154383","120","14496","14.8","12.9"
"Chatham","2021-01-01","32","154415","7","14503","16.4","13.7"
"Chatham","2021-01-02","352","154767","36","14539","15.8","13.8"
"Chatham","2021-01-03","126","154893","33","14572","16.1","14.6"
"Chatham","2021-01-04","1203","156096","184","14756","16.5","15.1"
"Chatham","2021-01-05","1398","157494","201","14957","16.7","15.3"
"Chatham","2021-01-06","1121","158615","178","15135","16.9","15.6"
"Chatham","2021-01-07","901","159516","123","15258","16.8","15.8"
"Chatham","2021-01-08","1024","160540","145","15403","15.7","16"
"Chatham","2021-01-09","319","160859","54","15457","16.6","16.2"
"Chatham","2021-01-10","258","161117","42","15499","15.2","15.7"
"Chatham","2021-01-11","1083","162200","109","15608","14.5","15.5"
"Chatham","2021-01-12","938","163138","117","15725","14.2","15.4"
"Chatham","2021-01-13","1000","164138","123","15848","13.7","15.3"
"Chatham","2021-01-14","1082","165220","122","15970","13.4","15.1"
"Chatham","2021-01-15","791","166011","107","16077","13.3","14.5"
"Chatham","2021-01-16","478","166489","59","16136","12.6","14.6"
"Chatham","2021-01-17","272","166761","69","16205","13.9","14.6"
"Chatham","2021-01-18","877","167638","115","16320","14.3","14.4"
"Chatham","2021-01-19","1089","168727","146","16466","14.5","14.3"
"Chatham","2021-01-20","866","169593","135","16601","14.9","14.3"
"Chatham","2021-01-21","1034","170627","156","16757","15.5","14.4"
"Chatham","2021-01-22","925","171552","113","16870","15.3","14.3"
"Chatham","2021-01-23","254","171806","37","16907","15.6","14.1"
"Chatham","2021-01-24","256","172062","48","16955","14.7","14.3"
"Chatham","2021-01-25","1153","173215","182","17137","15.1","14.7"
"Chatham","2021-01-26","1019","174234","120","17257","14.8","14.7"
"Chatham","2021-01-27","841","175075","137","17394","14.9","14.9"
"Chatham","2021-01-28","902","175977","123","17517","14.7","15.1"
"Chatham","2021-01-29","945","176922","123","17640","14.8","15.1"
"Chatham","2021-01-30","278","177200","46","17686","15.1","15.4"
"Chatham","2021-01-31","236","177436","39","17725","14.8","14.7"
"Chatham","2021-02-01","1090","178526","158","17883","14.6","14.8"
"Chatham","2021-02-02","824","179350","84","17967","14.4","14.6"
"Chatham","2021-02-03","839","180189","105","18072","13.8","14.4"
"Chatham","2021-02-04","782","180971","98","18170","13.7","14.2"
"Chatham","2021-02-05","623","181594","76","18246","13.6","14.2"
"Chatham","2021-02-06","108","181702","13","18259","12.9","14"
"Chatham","2021-02-07","0","181702","0","18259","10.6","12.7"
"Chatham","2021-02-08","0","181702","0","18259","8.5","11.6"
"Chattahoochee","2020-02-01","0","0","0","0",".","."
"Chattahoochee","2020-02-02","0","0","0","0",".","."
"Chattahoochee","2020-02-03","0","0","0","0",".","."
"Chattahoochee","2020-02-04","0","0","0","0",".","."
"Chattahoochee","2020-02-05","0","0","0","0",".","."
"Chattahoochee","2020-02-06","0","0","0","0",".","."
"Chattahoochee","2020-02-07","0","0","0","0","0","."
"Chattahoochee","2020-02-08","0","0","0","0","0","."
"Chattahoochee","2020-02-09","0","0","0","0","0","."
"Chattahoochee","2020-02-10","0","0","0","0","0","."
"Chattahoochee","2020-02-11","0","0","0","0","0","."
"Chattahoochee","2020-02-12","0","0","0","0","0","."
"Chattahoochee","2020-02-13","0","0","0","0","0","."
"Chattahoochee","2020-02-14","0","0","0","0","0","0"
"Chattahoochee","2020-02-15","0","0","0","0","0","0"
"Chattahoochee","2020-02-16","0","0","0","0","0","0"
"Chattahoochee","2020-02-17","0","0","0","0","0","0"
"Chattahoochee","2020-02-18","0","0","0","0","0","0"
"Chattahoochee","2020-02-19","0","0","0","0","0","0"
"Chattahoochee","2020-02-20","0","0","0","0","0","0"
"Chattahoochee","2020-02-21","0","0","0","0","0","0"
"Chattahoochee","2020-02-22","0","0","0","0","0","0"
"Chattahoochee","2020-02-23","0","0","0","0","0","0"
"Chattahoochee","2020-02-24","0","0","0","0","0","0"
"Chattahoochee","2020-02-25","0","0","0","0","0","0"
"Chattahoochee","2020-02-26","0","0","0","0","0","0"
"Chattahoochee","2020-02-27","0","0","0","0","0","0"
"Chattahoochee","2020-02-28","0","0","0","0","0","0"
"Chattahoochee","2020-02-29","0","0","0","0","0","0"
"Chattahoochee","2020-03-01","0","0","0","0","0","0"
"Chattahoochee","2020-03-02","0","0","0","0","0","0"
"Chattahoochee","2020-03-03","0","0","0","0","0","0"
"Chattahoochee","2020-03-04","0","0","0","0","0","0"
"Chattahoochee","2020-03-05","0","0","0","0","0","0"
"Chattahoochee","2020-03-06","0","0","0","0","0","0"
"Chattahoochee","2020-03-07","0","0","0","0","0","0"
"Chattahoochee","2020-03-08","0","0","0","0","0","0"
"Chattahoochee","2020-03-09","0","0","0","0","0","0"
"Chattahoochee","2020-03-10","0","0","0","0","0","0"
"Chattahoochee","2020-03-11","1","1","0","0","0","0"
"Chattahoochee","2020-03-12","0","1","0","0","0","0"
"Chattahoochee","2020-03-13","2","3","0","0","0","0"
"Chattahoochee","2020-03-14","0","3","0","0","0","0"
"Chattahoochee","2020-03-15","0","3","0","0","0","0"
"Chattahoochee","2020-03-16","2","5","0","0","0","0"
"Chattahoochee","2020-03-17","0","5","0","0","0","0"
"Chattahoochee","2020-03-18","2","7","1","1","7.1","3.6"
"Chattahoochee","2020-03-19","1","8","0","1","7.1","3.6"
"Chattahoochee","2020-03-20","1","9","0","1","7.1","3.6"
"Chattahoochee","2020-03-21","3","12","0","1","7.1","3.6"
"Chattahoochee","2020-03-22","1","13","0","1","7.1","3.6"
"Chattahoochee","2020-03-23","1","14","0","1","7.1","3.6"
"Chattahoochee","2020-03-24","2","16","0","1","7.1","3.6"
"Chattahoochee","2020-03-25","0","16","0","1","0","3.6"
"Chattahoochee","2020-03-26","3","19","0","1","0","3.6"
"Chattahoochee","2020-03-27","1","20","0","1","0","3.6"
"Chattahoochee","2020-03-28","2","22","1","2","7.1","7.1"
"Chattahoochee","2020-03-29","1","23","0","2","7.1","7.1"
"Chattahoochee","2020-03-30","3","26","0","2","7.1","7.1"
"Chattahoochee","2020-03-31","3","29","2","4","16.7","11.9"
"Chattahoochee","2020-04-01","4","33","0","4","16.7","8.3"
"Chattahoochee","2020-04-02","0","33","0","4","16.7","8.3"
"Chattahoochee","2020-04-03","13","46","0","4","16.7","8.3"
"Chattahoochee","2020-04-04","2","48","1","5","16.7","11.9"
"Chattahoochee","2020-04-05","0","48","0","5","16.7","11.9"
"Chattahoochee","2020-04-06","2","50","0","5","16.7","11.9"
"Chattahoochee","2020-04-07","5","55","0","5","7.1","11.9"
"Chattahoochee","2020-04-08","0","55","0","5","7.1","11.9"
"Chattahoochee","2020-04-09","2","57","1","6","14.3","15.5"
"Chattahoochee","2020-04-10","2","59","0","6","14.3","15.5"
"Chattahoochee","2020-04-11","0","59","0","6","7.1","11.9"
"Chattahoochee","2020-04-12","0","59","0","6","7.1","11.9"
"Chattahoochee","2020-04-13","3","62","0","6","7.1","11.9"
"Chattahoochee","2020-04-14","2","64","0","6","7.1","7.1"
"Chattahoochee","2020-04-15","0","64","0","6","7.1","7.1"
"Chattahoochee","2020-04-16","2","66","1","7","7.1","10.7"
"Chattahoochee","2020-04-17","2","68","1","8","14.3","14.3"
"Chattahoochee","2020-04-18","0","68","0","8","14.3","10.7"
"Chattahoochee","2020-04-19","0","68","0","8","14.3","10.7"
"Chattahoochee","2020-04-20","0","68","0","8","14.3","10.7"
"Chattahoochee","2020-04-21","3","71","2","10","23.8","15.5"
"Chattahoochee","2020-04-22","0","71","0","10","23.8","15.5"
"Chattahoochee","2020-04-23","0","71","0","10","16.7","11.9"
"Chattahoochee","2020-04-24","1","72","0","10","9.5","11.9"
"Chattahoochee","2020-04-25","3","75","0","10","9.5","11.9"
"Chattahoochee","2020-04-26","1","76","0","10","9.5","11.9"
"Chattahoochee","2020-04-27","0","76","0","10","9.5","11.9"
"Chattahoochee","2020-04-28","5","81","1","11","2.9","13.3"
"Chattahoochee","2020-04-29","1","82","0","11","2.9","13.3"
"Chattahoochee","2020-04-30","2","84","0","11","2.9","9.8"
"Chattahoochee","2020-05-01","4","88","1","12","6.4","8"
"Chattahoochee","2020-05-02","1","89","0","12","6.4","8"
"Chattahoochee","2020-05-03","3","92","0","12","6.4","8"
"Chattahoochee","2020-05-04","0","92","0","12","6.4","8"
"Chattahoochee","2020-05-05","5","97","0","12","3.6","3.2"
"Chattahoochee","2020-05-06","3","100","0","12","3.6","3.2"
"Chattahoochee","2020-05-07","2","102","0","12","3.6","3.2"
"Chattahoochee","2020-05-08","1","103","0","12","0","3.2"
"Chattahoochee","2020-05-09","0","103","0","12","0","3.2"
"Chattahoochee","2020-05-10","2","105","0","12","0","3.2"
"Chattahoochee","2020-05-11","4","109","0","12","0","3.2"
"Chattahoochee","2020-05-12","5","114","1","13","2.9","3.2"
"Chattahoochee","2020-05-13","6","120","3","16","10","6.8"
"Chattahoochee","2020-05-14","2","122","1","17","17.1","10.4"
"Chattahoochee","2020-05-15","4","126","0","17","17.1","8.6"
"Chattahoochee","2020-05-16","1","127","0","17","17.1","8.6"
"Chattahoochee","2020-05-17","2","129","0","17","17.1","8.6"
"Chattahoochee","2020-05-18","4","133","1","18","20.7","10.4"
"Chattahoochee","2020-05-19","8","141","0","18","17.9","10.4"
"Chattahoochee","2020-05-20","4","145","0","18","10.7","10.4"
"Chattahoochee","2020-05-21","10","155","0","18","3.6","10.4"
"Chattahoochee","2020-05-22","0","155","0","18","3.6","10.4"
"Chattahoochee","2020-05-23","1","156","0","18","3.6","10.4"
"Chattahoochee","2020-05-24","1","157","1","19","17.9","17.5"
"Chattahoochee","2020-05-25","1","158","1","20","28.6","24.6"
"Chattahoochee","2020-05-26","7","165","3","23","34.7","26.3"
"Chattahoochee","2020-05-27","3","168","0","23","34.7","22.7"
"Chattahoochee","2020-05-28","2","170","0","23","34.7","19.1"
"Chattahoochee","2020-05-29","6","176","1","24","37.1","20.3"
"Chattahoochee","2020-05-30","1","177","0","24","37.1","20.3"
"Chattahoochee","2020-05-31","1","178","0","24","22.8","20.3"
"Chattahoochee","2020-06-01","6","184","0","24","8.5","18.5"
"Chattahoochee","2020-06-02","2","186","0","24","2.4","18.5"
"Chattahoochee","2020-06-03","7","193","0","24","2.4","18.5"
"Chattahoochee","2020-06-04","8","201","0","24","2.4","18.5"
"Chattahoochee","2020-06-05","9","210","2","26","3.2","20.1"
"Chattahoochee","2020-06-06","4","214","0","26","3.2","20.1"
"Chattahoochee","2020-06-07","1","215","0","26","3.2","13"
"Chattahoochee","2020-06-08","4","219","0","26","3.2","5.8"
"Chattahoochee","2020-06-09","4","223","0","26","3.2","2.8"
"Chattahoochee","2020-06-10","3","226","0","26","3.2","2.8"
"Chattahoochee","2020-06-11","5","231","0","26","3.2","2.8"
"Chattahoochee","2020-06-12","3","234","0","26","0","1.6"
"Chattahoochee","2020-06-13","4","238","0","26","0","1.6"
"Chattahoochee","2020-06-14","2","240","0","26","0","1.6"
"Chattahoochee","2020-06-15","14","254","2","28","2","2.6"
"Chattahoochee","2020-06-16","11","265","0","28","2","2.6"
"Chattahoochee","2020-06-17","8","273","1","29","3.8","3.5"
"Chattahoochee","2020-06-18","18","291","1","30","4.6","3.9"
"Chattahoochee","2020-06-19","2","293","1","31","11.8","5.9"
"Chattahoochee","2020-06-20","1","294","0","31","11.8","5.9"
"Chattahoochee","2020-06-21","0","294","0","31","11.8","5.9"
"Chattahoochee","2020-06-22","8","302","2","33","13.3","7.7"
"Chattahoochee","2020-06-23","5","307","2","35","19","10.5"
"Chattahoochee","2020-06-24","14","321","0","35","17.2","10.5"
"Chattahoochee","2020-06-25","15","336","2","37","18.3","11.5"
"Chattahoochee","2020-06-26","22","358","1","38","11.8","11.8"
"Chattahoochee","2020-06-27","15","373","1","39","12.8","12.3"
"Chattahoochee","2020-06-28","15","388","4","43","16.6","14.2"
"Chattahoochee","2020-06-29","15","403","5","48","17.8","15.5"
"Chattahoochee","2020-06-30","17","420","3","51","14.6","16.8"
"Chattahoochee","2020-07-01","8","428","0","51","14.6","15.9"
"Chattahoochee","2020-07-02","16","444","5","56","17.2","17.7"
"Chattahoochee","2020-07-03","19","463","7","63","21.8","16.8"
"Chattahoochee","2020-07-04","7","470","2","65","24.9","18.8"
"Chattahoochee","2020-07-05","8","478","3","68","26.4","21.5"
"Chattahoochee","2020-07-06","330","808","6","74","21.9","19.9"
"Chattahoochee","2020-07-07","546","1354","8","82","19.6","17.1"
"Chattahoochee","2020-07-08","88","1442","7","89","20.8","17.7"
"Chattahoochee","2020-07-09","350","1792","16","105","17","17.1"
"Chattahoochee","2020-07-10","559","2351","11","116","12","16.9"
"Chattahoochee","2020-07-11","24","2375","1","117","8.5","16.7"
"Chattahoochee","2020-07-12","1","2376","0","117","3.1","14.8"
"Chattahoochee","2020-07-13","321","2697","7","124","3.2","12.6"
"Chattahoochee","2020-07-14","436","3133","7","131","3.2","11.4"
"Chattahoochee","2020-07-15","234","3367","11","142","2.7","11.8"
"Chattahoochee","2020-07-16","502","3869","6","148","2.3","9.6"
"Chattahoochee","2020-07-17","69","3938","9","157","3.8","7.9"
"Chattahoochee","2020-07-18","7","3945","1","158","5.3","6.9"
"Chattahoochee","2020-07-19","2","3947","0","158","5.3","4.2"
"Chattahoochee","2020-07-20","17","3964","3","161","7.5","5.3"
"Chattahoochee","2020-07-21","17","3981","2","163","8.9","6.1"
"Chattahoochee","2020-07-22","4","3985","0","163","8.3","5.5"
"Chattahoochee","2020-07-23","16","4001","1","164","9","5.6"
"Chattahoochee","2020-07-24","7","4008","0","164","7.1","5.5"
"Chattahoochee","2020-07-25","4","4012","1","165","8.7","7"
"Chattahoochee","2020-07-26","4","4016","0","165","8.7","7"
"Chattahoochee","2020-07-27","42","4058","7","172","8.5","8"
"Chattahoochee","2020-07-28","27","4085","2","174","7.9","8.4"
"Chattahoochee","2020-07-29","19","4104","1","175","8.7","8.5"
"Chattahoochee","2020-07-30","32","4136","16","191","14.9","12"
"Chattahoochee","2020-07-31","29","4165","10","201","19.8","13.5"
"Chattahoochee","2020-08-01","12","4177","5","206","22.2","15.4"
"Chattahoochee","2020-08-02","0","4177","0","206","22.2","15.4"
"Chattahoochee","2020-08-03","26","4203","7","213","23.7","16.1"
"Chattahoochee","2020-08-04","35","4238","7","220","25.5","16.7"
"Chattahoochee","2020-08-05","25","4263","8","228","29.3","19"
"Chattahoochee","2020-08-06","32","4295","5","233","24.4","19.6"
"Chattahoochee","2020-08-07","7","4302","1","234","21.5","20.7"
"Chattahoochee","2020-08-08","2","4304","1","235","22.7","22.5"
"Chattahoochee","2020-08-09","4","4308","0","235","22.7","22.5"
"Chattahoochee","2020-08-10","45","4353","4","239","20.1","21.9"
"Chattahoochee","2020-08-11","39","4392","1","240","17.6","21.5"
"Chattahoochee","2020-08-12","26","4418","5","245","15.8","22.5"
"Chattahoochee","2020-08-13","16","4434","2","247","15.4","19.9"
"Chattahoochee","2020-08-14","30","4464","1","248","13.8","17.6"
"Chattahoochee","2020-08-15","2","4466","0","248","6.6","14.7"
"Chattahoochee","2020-08-16","3","4469","0","248","6.6","14.7"
"Chattahoochee","2020-08-17","36","4505","0","248","5.4","12.7"
"Chattahoochee","2020-08-18","16","4521","1","249","5.9","11.8"
"Chattahoochee","2020-08-19","13","4534","2","251","5.4","10.6"
"Chattahoochee","2020-08-20","11","4545","1","252","4.9","10.1"
"Chattahoochee","2020-08-21","14","4559","0","252","4.4","9.1"
"Chattahoochee","2020-08-22","4","4563","1","253","8","7.3"
"Chattahoochee","2020-08-23","0","4563","0","253","8","7.3"
"Chattahoochee","2020-08-24","14","4577","1","254","9","7.2"
"Chattahoochee","2020-08-25","19","4596","2","256","9.6","7.7"
"Chattahoochee","2020-08-26","18","4614","2","258","9","7.2"
"Chattahoochee","2020-08-27","12","4626","0","258","7.7","6.3"
"Chattahoochee","2020-08-28","6","4632","0","258","7.7","6"
"Chattahoochee","2020-08-29","1","4633","0","258","4.1","6"
"Chattahoochee","2020-08-30","3","4636","0","258","4.1","6"
"Chattahoochee","2020-08-31","14","4650","2","260","5.1","7.1"
"Chattahoochee","2020-09-01","17","4667","2","262","5.3","7.5"
"Chattahoochee","2020-09-02","17","4684","3","265","6.2","7.6"
"Chattahoochee","2020-09-03","17","4701","4","269","9.6","8.6"
"Chattahoochee","2020-09-04","9","4710","0","269","9.6","8.6"
"Chattahoochee","2020-09-05","0","4710","0","269","9.6","6.9"
"Chattahoochee","2020-09-06","2","4712","0","269","9.6","6.9"
"Chattahoochee","2020-09-07","2","4714","0","269","7.6","6.3"
"Chattahoochee","2020-09-08","27","4741","1","270","6.4","5.9"
"Chattahoochee","2020-09-09","11","4752","0","270","3.9","5.1"
"Chattahoochee","2020-09-10","12","4764","0","270","0.5","5.1"
"Chattahoochee","2020-09-11","8","4772","0","270","0.5","5.1"
"Chattahoochee","2020-09-12","0","4772","0","270","0.5","5.1"
"Chattahoochee","2020-09-13","1","4773","0","270","0.5","5.1"
"Chattahoochee","2020-09-14","4","4777","0","270","0.5","4"
"Chattahoochee","2020-09-15","12","4789","1","271","1.2","3.8"
"Chattahoochee","2020-09-16","4","4793","0","271","1.2","2.5"
"Chattahoochee","2020-09-17","6","4799","0","271","1.2","0.9"
"Chattahoochee","2020-09-18","7","4806","0","271","1.2","0.9"
"Chattahoochee","2020-09-19","0","4806","0","271","1.2","0.9"
"Chattahoochee","2020-09-20","1","4807","0","271","1.2","0.9"
"Chattahoochee","2020-09-21","2","4809","0","271","1.2","0.9"
"Chattahoochee","2020-09-22","5","4814","3","274","8.6","4.9"
"Chattahoochee","2020-09-23","5","4819","1","275","11.4","6.3"
"Chattahoochee","2020-09-24","11","4830","0","275","11.4","6.3"
"Chattahoochee","2020-09-25","5","4835","0","275","11.4","6.3"
"Chattahoochee","2020-09-26","1","4836","0","275","11.4","6.3"
"Chattahoochee","2020-09-27","1","4837","0","275","11.4","6.3"
"Chattahoochee","2020-09-28","4","4841","0","275","11.4","6.3"
"Chattahoochee","2020-09-29","16","4857","2","277","4.6","6.6"
"Chattahoochee","2020-09-30","2","4859","0","277","1.8","6.6"
"Chattahoochee","2020-10-01","7","4866","0","277","1.8","6.6"
"Chattahoochee","2020-10-02","5","4871","0","277","1.8","6.6"
"Chattahoochee","2020-10-03","3","4874","0","277","1.8","6.6"
"Chattahoochee","2020-10-04","1","4875","0","277","1.8","6.6"
"Chattahoochee","2020-10-05","5","4880","0","277","1.8","6.6"
"Chattahoochee","2020-10-06","13","4893","0","277","0","2.3"
"Chattahoochee","2020-10-07","4","4897","0","277","0","0.9"
"Chattahoochee","2020-10-08","8","4905","0","277","0","0.9"
"Chattahoochee","2020-10-09","6","4911","0","277","0","0.9"
"Chattahoochee","2020-10-10","2","4913","1","278","7.1","4.5"
"Chattahoochee","2020-10-11","2","4915","1","279","14.3","8"
"Chattahoochee","2020-10-12","3","4918","0","279","14.3","8"
"Chattahoochee","2020-10-13","5","4923","0","279","14.3","7.1"
"Chattahoochee","2020-10-14","6","4929","0","279","14.3","7.1"
"Chattahoochee","2020-10-15","8","4937","0","279","14.3","7.1"
"Chattahoochee","2020-10-16","4","4941","0","279","14.3","7.1"
"Chattahoochee","2020-10-17","2","4943","0","279","7.1","7.1"
"Chattahoochee","2020-10-18","2","4945","0","279","0","7.1"
"Chattahoochee","2020-10-19","3","4948","0","279","0","7.1"
"Chattahoochee","2020-10-20","11","4959","0","279","0","7.1"
"Chattahoochee","2020-10-21","3","4962","0","279","0","7.1"
"Chattahoochee","2020-10-22","6","4968","0","279","0","7.1"
"Chattahoochee","2020-10-23","4","4972","0","279","0","7.1"
"Chattahoochee","2020-10-24","2","4974","0","279","0","3.6"
"Chattahoochee","2020-10-25","1","4975","0","279","0","0"
"Chattahoochee","2020-10-26","14","4989","0","279","0","0"
"Chattahoochee","2020-10-27","6","4995","1","280","2.4","1.2"
"Chattahoochee","2020-10-28","1","4996","0","280","2.4","1.2"
"Chattahoochee","2020-10-29","13","5009","0","280","2.4","1.2"
"Chattahoochee","2020-10-30","7","5016","0","280","2.4","1.2"
"Chattahoochee","2020-10-31","4","5020","0","280","2.4","1.2"
"Chattahoochee","2020-11-01","0","5020","0","280","2.4","1.2"
"Chattahoochee","2020-11-02","6","5026","2","282","7.1","3.6"
"Chattahoochee","2020-11-03","3","5029","0","282","4.8","3.6"
"Chattahoochee","2020-11-04","7","5036","0","282","4.8","3.6"
"Chattahoochee","2020-11-05","16","5052","0","282","4.8","3.6"
"Chattahoochee","2020-11-06","2","5054","0","282","4.8","3.6"
"Chattahoochee","2020-11-07","4","5058","0","282","4.8","3.6"
"Chattahoochee","2020-11-08","3","5061","0","282","4.8","3.6"
"Chattahoochee","2020-11-09","2","5063","0","282","0","3.6"
"Chattahoochee","2020-11-10","5","5068","0","282","0","2.4"
"Chattahoochee","2020-11-11","6","5074","1","283","2.4","3.6"
"Chattahoochee","2020-11-12","5","5079","0","283","2.4","3.6"
"Chattahoochee","2020-11-13","9","5088","0","283","2.4","3.6"
"Chattahoochee","2020-11-14","2","5090","0","283","2.4","3.6"
"Chattahoochee","2020-11-15","1","5091","0","283","2.4","3.6"
"Chattahoochee","2020-11-16","4","5095","0","283","2.4","1.2"
"Chattahoochee","2020-11-17","13","5108","0","283","2.4","1.2"
"Chattahoochee","2020-11-18","6","5114","0","283","0","1.2"
"Chattahoochee","2020-11-19","15","5129","1","284","1","1.7"
"Chattahoochee","2020-11-20","6","5135","0","284","1","1.7"
"Chattahoochee","2020-11-21","8","5143","0","284","1","1.7"
"Chattahoochee","2020-11-22","3","5146","0","284","1","1.7"
"Chattahoochee","2020-11-23","2","5148","0","284","1","1.7"
"Chattahoochee","2020-11-24","6","5154","0","284","1","1.7"
"Chattahoochee","2020-11-25","3","5157","0","284","1","0.5"
"Chattahoochee","2020-11-26","1","5158","0","284","0","0.5"
"Chattahoochee","2020-11-27","2","5160","0","284","0","0.5"
"Chattahoochee","2020-11-28","2","5162","0","284","0","0.5"
"Chattahoochee","2020-11-29","3","5165","0","284","0","0.5"
"Chattahoochee","2020-11-30","8","5173","2","286","3.6","2.3"
"Chattahoochee","2020-12-01","4","5177","0","286","3.6","2.3"
"Chattahoochee","2020-12-02","9","5186","1","287","5.2","3.1"
"Chattahoochee","2020-12-03","6","5192","0","287","5.2","2.6"
"Chattahoochee","2020-12-04","8","5200","0","287","5.2","2.6"
"Chattahoochee","2020-12-05","8","5208","0","287","5.2","2.6"
"Chattahoochee","2020-12-06","1","5209","0","287","5.2","2.6"
"Chattahoochee","2020-12-07","8","5217","0","287","1.6","2.6"
"Chattahoochee","2020-12-08","5","5222","0","287","1.6","2.6"
"Chattahoochee","2020-12-09","8","5230","0","287","0","2.6"
"Chattahoochee","2020-12-10","10","5240","2","289","2.9","4"
"Chattahoochee","2020-12-11","9","5249","3","292","7.6","6.4"
"Chattahoochee","2020-12-12","2","5251","0","292","7.6","6.4"
"Chattahoochee","2020-12-13","5","5256","1","293","10.5","7.8"
"Chattahoochee","2020-12-14","15","5271","1","294","11.4","6.5"
"Chattahoochee","2020-12-15","22","5293","2","296","12.7","7.2"
"Chattahoochee","2020-12-16","7","5300","0","296","12.7","6.4"
"Chattahoochee","2020-12-17","9","5309","0","296","9.9","6.4"
"Chattahoochee","2020-12-18","14","5323","0","296","5.1","6.4"
"Chattahoochee","2020-12-19","7","5330","0","296","5.1","6.4"
"Chattahoochee","2020-12-20","6","5336","2","298","7","8.7"
"Chattahoochee","2020-12-21","18","5354","1","299","6.9","9.1"
"Chattahoochee","2020-12-22","4","5358","0","299","5.6","9.1"
"Chattahoochee","2020-12-23","6","5364","0","299","5.6","9.1"
"Chattahoochee","2020-12-24","14","5378","2","301","7.6","8.7"
"Chattahoochee","2020-12-25","2","5380","0","301","7.6","6.4"
"Chattahoochee","2020-12-26","3","5383","0","301","7.6","6.4"
"Chattahoochee","2020-12-27","3","5386","0","301","2.8","4.9"
"Chattahoochee","2020-12-28","5","5391","1","302","4.9","5.9"
"Chattahoochee","2020-12-29","3","5394","2","304","14.4","10"
"Chattahoochee","2020-12-30","13","5407","3","307","17.7","11.6"
"Chattahoochee","2020-12-31","4","5411","1","308","19.2","13.4"
"Chattahoochee","2021-01-01","3","5414","2","310","28.8","18.2"
"Chattahoochee","2021-01-02","3","5417","0","310","28.8","18.2"
"Chattahoochee","2021-01-03","2","5419","1","311","35.9","19.4"
"Chattahoochee","2021-01-04","9","5428","1","312","34.6","19.8"
"Chattahoochee","2021-01-05","31","5459","9","321","29.3","21.8"
"Chattahoochee","2021-01-06","6","5465","1","322","28.4","23"
"Chattahoochee","2021-01-07","5","5470","1","323","27.6","23.4"
"Chattahoochee","2021-01-08","13","5483","3","326","21.4","25.1"
"Chattahoochee","2021-01-09","4","5487","0","326","21.4","25.1"
"Chattahoochee","2021-01-10","1","5488","1","327","28.6","32.2"
"Chattahoochee","2021-01-11","4","5492","2","329","34.1","34.4"
"Chattahoochee","2021-01-12","21","5513","1","330","30.6","30"
"Chattahoochee","2021-01-13","7","5520","1","331","30.3","29.3"
"Chattahoochee","2021-01-14","6","5526","0","331","27.4","27.5"
"Chattahoochee","2021-01-15","6","5532","0","331","24.1","22.8"
"Chattahoochee","2021-01-16","11","5543","1","332","25.4","23.4"
"Chattahoochee","2021-01-17","3","5546","1","333","15.9","22.2"
"Chattahoochee","2021-01-18","6","5552","1","334","11.2","22.6"
"Chattahoochee","2021-01-19","26","5578","2","336","11.6","21.1"
"Chattahoochee","2021-01-20","5","5583","0","336","9.5","19.9"
"Chattahoochee","2021-01-21","9","5592","1","337","11.1","19.3"
"Chattahoochee","2021-01-22","9","5601","1","338","12.7","18.4"
"Chattahoochee","2021-01-23","3","5604","0","338","11.4","18.4"
"Chattahoochee","2021-01-24","1","5605","0","338","6.7","11.3"
"Chattahoochee","2021-01-25","6","5611","0","338","4.3","7.7"
"Chattahoochee","2021-01-26","12","5623","0","338","3.2","7.4"
"Chattahoochee","2021-01-27","5","5628","3","341","11.7","10.6"
"Chattahoochee","2021-01-28","11","5639","2","343","12.8","11.9"
"Chattahoochee","2021-01-29","12","5651","2","345","13.5","13.1"
"Chattahoochee","2021-01-30","3","5654","1","346","18.3","14.9"
"Chattahoochee","2021-01-31","4","5658","0","346","18.3","12.5"
"Chattahoochee","2021-02-01","3","5661","1","347","23.1","13.7"
"Chattahoochee","2021-02-02","6","5667","0","347","23.1","13.1"
"Chattahoochee","2021-02-03","7","5674","1","348","16.5","14.1"
"Chattahoochee","2021-02-04","6","5680","1","349","16.3","14.5"
"Chattahoochee","2021-02-05","3","5683","0","349","13.9","13.7"
"Chattahoochee","2021-02-06","2","5685","0","349","9.2","13.7"
"Chattahoochee","2021-02-07","0","5685","0","349","9.2","13.7"
"Chattahoochee","2021-02-08","0","5685","0","349","4.4","13.7"
"Chattooga","2020-02-01","0","0","0","0",".","."
"Chattooga","2020-02-02","0","0","0","0",".","."
"Chattooga","2020-02-03","0","0","0","0",".","."
"Chattooga","2020-02-04","0","0","0","0",".","."
"Chattooga","2020-02-05","0","0","0","0",".","."
"Chattooga","2020-02-06","0","0","0","0",".","."
"Chattooga","2020-02-07","0","0","0","0","0","."
"Chattooga","2020-02-08","0","0","0","0","0","."
"Chattooga","2020-02-09","0","0","0","0","0","."
"Chattooga","2020-02-10","0","0","0","0","0","."
"Chattooga","2020-02-11","0","0","0","0","0","."
"Chattooga","2020-02-12","0","0","0","0","0","."
"Chattooga","2020-02-13","0","0","0","0","0","."
"Chattooga","2020-02-14","0","0","0","0","0","0"
"Chattooga","2020-02-15","0","0","0","0","0","0"
"Chattooga","2020-02-16","0","0","0","0","0","0"
"Chattooga","2020-02-17","0","0","0","0","0","0"
"Chattooga","2020-02-18","0","0","0","0","0","0"
"Chattooga","2020-02-19","0","0","0","0","0","0"
"Chattooga","2020-02-20","0","0","0","0","0","0"
"Chattooga","2020-02-21","0","0","0","0","0","0"
"Chattooga","2020-02-22","0","0","0","0","0","0"
"Chattooga","2020-02-23","0","0","0","0","0","0"
"Chattooga","2020-02-24","0","0","0","0","0","0"
"Chattooga","2020-02-25","0","0","0","0","0","0"
"Chattooga","2020-02-26","0","0","0","0","0","0"
"Chattooga","2020-02-27","0","0","0","0","0","0"
"Chattooga","2020-02-28","0","0","0","0","0","0"
"Chattooga","2020-02-29","0","0","0","0","0","0"
"Chattooga","2020-03-01","0","0","0","0","0","0"
"Chattooga","2020-03-02","0","0","0","0","0","0"
"Chattooga","2020-03-03","0","0","0","0","0","0"
"Chattooga","2020-03-04","0","0","0","0","0","0"
"Chattooga","2020-03-05","0","0","0","0","0","0"
"Chattooga","2020-03-06","0","0","0","0","0","0"
"Chattooga","2020-03-07","0","0","0","0","0","0"
"Chattooga","2020-03-08","0","0","0","0","0","0"
"Chattooga","2020-03-09","0","0","0","0","0","0"
"Chattooga","2020-03-10","0","0","0","0","0","0"
"Chattooga","2020-03-11","0","0","0","0","0","0"
"Chattooga","2020-03-12","3","3","0","0","0","0"
"Chattooga","2020-03-13","3","6","0","0","0","0"
"Chattooga","2020-03-14","1","7","0","0","0","0"
"Chattooga","2020-03-15","2","9","0","0","0","0"
"Chattooga","2020-03-16","8","17","0","0","0","0"
"Chattooga","2020-03-17","7","24","0","0","0","0"
"Chattooga","2020-03-18","8","32","2","2","3.6","1.8"
"Chattooga","2020-03-19","7","39","0","2","3.6","1.8"
"Chattooga","2020-03-20","5","44","0","2","3.6","1.8"
"Chattooga","2020-03-21","4","48","0","2","3.6","1.8"
"Chattooga","2020-03-22","4","52","0","2","3.6","1.8"
"Chattooga","2020-03-23","3","55","0","2","3.6","1.8"
"Chattooga","2020-03-24","8","63","0","2","3.6","1.8"
"Chattooga","2020-03-25","3","66","0","2","0","1.8"
"Chattooga","2020-03-26","5","71","0","2","0","1.8"
"Chattooga","2020-03-27","4","75","0","2","0","1.8"
"Chattooga","2020-03-28","11","86","0","2","0","1.8"
"Chattooga","2020-03-29","6","92","0","2","0","1.8"
"Chattooga","2020-03-30","6","98","0","2","0","1.8"
"Chattooga","2020-03-31","9","107","1","3","1.6","2.6"
"Chattooga","2020-04-01","2","109","0","3","1.6","0.8"
"Chattooga","2020-04-02","9","118","0","3","1.6","0.8"
"Chattooga","2020-04-03","6","124","0","3","1.6","0.8"
"Chattooga","2020-04-04","4","128","1","4","5.2","2.6"
"Chattooga","2020-04-05","2","130","0","4","5.2","2.6"
"Chattooga","2020-04-06","3","133","0","4","5.2","2.6"
"Chattooga","2020-04-07","9","142","0","4","3.6","2.6"
"Chattooga","2020-04-08","8","150","1","5","5.4","3.5"
"Chattooga","2020-04-09","6","156","0","5","5.4","3.5"
"Chattooga","2020-04-10","13","169","0","5","5.4","3.5"
"Chattooga","2020-04-11","6","175","1","6","4.2","4.7"
"Chattooga","2020-04-12","0","175","0","6","4.2","4.7"
"Chattooga","2020-04-13","3","178","0","6","4.2","4.7"
"Chattooga","2020-04-14","15","193","1","7","5.1","4.3"
"Chattooga","2020-04-15","12","205","1","8","4.5","4.9"
"Chattooga","2020-04-16","3","208","0","8","4.5","4.9"
"Chattooga","2020-04-17","10","218","0","8","4.5","4.9"
"Chattooga","2020-04-18","8","226","0","8","2.1","3.2"
"Chattooga","2020-04-19","0","226","0","8","2.1","3.2"
"Chattooga","2020-04-20","3","229","0","8","2.1","3.2"
"Chattooga","2020-04-21","11","240","0","8","1.2","3.2"
"Chattooga","2020-04-22","10","250","1","9","1.4","3"
"Chattooga","2020-04-23","9","259","0","9","1.4","3"
"Chattooga","2020-04-24","13","272","0","9","1.4","3"
"Chattooga","2020-04-25","5","277","1","10","4.3","3.2"
"Chattooga","2020-04-26","1","278","0","10","4.3","3.2"
"Chattooga","2020-04-27","5","283","0","10","4.3","3.2"
"Chattooga","2020-04-28","24","307","0","10","4.3","2.7"
"Chattooga","2020-04-29","12","319","0","10","2.9","2.1"
"Chattooga","2020-04-30","8","327","0","10","2.9","2.1"
"Chattooga","2020-05-01","17","344","0","10","2.9","2.1"
"Chattooga","2020-05-02","6","350","0","10","0","2.1"
"Chattooga","2020-05-03","3","353","0","10","0","2.1"
"Chattooga","2020-05-04","5","358","1","11","2.9","3.6"
"Chattooga","2020-05-05","17","375","0","11","2.9","3.6"
"Chattooga","2020-05-06","9","384","0","11","2.9","2.9"
"Chattooga","2020-05-07","10","394","0","11","2.9","2.9"
"Chattooga","2020-05-08","10","404","0","11","2.9","2.9"
"Chattooga","2020-05-09","8","412","0","11","2.9","1.4"
"Chattooga","2020-05-10","0","412","0","11","2.9","1.4"
"Chattooga","2020-05-11","12","424","2","13","2.4","2.6"
"Chattooga","2020-05-12","18","442","0","13","2.4","2.6"
"Chattooga","2020-05-13","15","457","1","14","3.3","3.1"
"Chattooga","2020-05-14","14","471","0","14","3.3","3.1"
"Chattooga","2020-05-15","5","476","0","14","3.3","3.1"
"Chattooga","2020-05-16","14","490","0","14","3.3","3.1"
"Chattooga","2020-05-17","0","490","0","14","3.3","3.1"
"Chattooga","2020-05-18","8","498","0","14","1","1.7"
"Chattooga","2020-05-19","14","512","0","14","1","1.7"
"Chattooga","2020-05-20","5","517","0","14","0","1.7"
"Chattooga","2020-05-21","27","544","1","15","0.5","1.9"
"Chattooga","2020-05-22","13","557","0","15","0.5","1.9"
"Chattooga","2020-05-23","4","561","0","15","0.5","1.9"
"Chattooga","2020-05-24","0","561","0","15","0.5","1.9"
"Chattooga","2020-05-25","3","564","0","15","0.5","0.7"
"Chattooga","2020-05-26","9","573","1","16","2.1","1.5"
"Chattooga","2020-05-27","10","583","0","16","2.1","1.1"
"Chattooga","2020-05-28","22","605","0","16","1.6","1.1"
"Chattooga","2020-05-29","14","619","0","16","1.6","1.1"
"Chattooga","2020-05-30","7","626","0","16","1.6","1.1"
"Chattooga","2020-05-31","4","630","0","16","1.6","1.1"
"Chattooga","2020-06-01","12","642","0","16","1.6","1.1"
"Chattooga","2020-06-02","15","657","0","16","0","1.1"
"Chattooga","2020-06-03","5","662","0","16","0","1.1"
"Chattooga","2020-06-04","16","678","2","18","1.8","1.7"
"Chattooga","2020-06-05","18","696","0","18","1.8","1.7"
"Chattooga","2020-06-06","11","707","1","19","3.1","2.3"
"Chattooga","2020-06-07","0","707","0","19","3.1","2.3"
"Chattooga","2020-06-08","11","718","0","19","3.1","2.3"
"Chattooga","2020-06-09","24","742","3","22","4.9","2.4"
"Chattooga","2020-06-10","5","747","1","23","7.7","3.9"
"Chattooga","2020-06-11","14","761","0","23","5.9","3.9"
"Chattooga","2020-06-12","10","771","0","23","5.9","3.9"
"Chattooga","2020-06-13","2","773","0","23","4.6","3.9"
"Chattooga","2020-06-14","2","775","0","23","4.6","3.9"
"Chattooga","2020-06-15","8","783","0","23","4.6","3.9"
"Chattooga","2020-06-16","21","804","0","23","2.9","3.9"
"Chattooga","2020-06-17","12","816","1","24","1.2","4.5"
"Chattooga","2020-06-18","16","832","0","24","1.2","3.6"
"Chattooga","2020-06-19","16","848","0","24","1.2","3.6"
"Chattooga","2020-06-20","31","879","0","24","1.2","2.9"
"Chattooga","2020-06-21","0","879","0","24","1.2","2.9"
"Chattooga","2020-06-22","7","886","0","24","1.2","2.9"
"Chattooga","2020-06-23","26","912","3","27","2.8","2.8"
"Chattooga","2020-06-24","26","938","3","30","3.3","2.2"
"Chattooga","2020-06-25","20","958","2","32","4.7","3"
"Chattooga","2020-06-26","9","967","0","32","4.7","3"
"Chattooga","2020-06-27","18","985","0","32","4.7","3"
"Chattooga","2020-06-28","3","988","0","32","4.7","3"
"Chattooga","2020-06-29","18","1006","0","32","4.7","3"
"Chattooga","2020-06-30","22","1028","0","32","3.1","3"
"Chattooga","2020-07-01","24","1052","0","32","1.4","2.4"
"Chattooga","2020-07-02","11","1063","0","32","0","2.4"
"Chattooga","2020-07-03","15","1078","1","33","1","2.8"
"Chattooga","2020-07-04","0","1078","0","33","1","2.8"
"Chattooga","2020-07-05","1","1079","0","33","1","2.8"
"Chattooga","2020-07-06","24","1103","2","35","2.1","3.4"
"Chattooga","2020-07-07","20","1123","1","36","2.9","3"
"Chattooga","2020-07-08","42","1165","3","39","3.9","2.7"
"Chattooga","2020-07-09","14","1179","3","42","6.9","3.5"
"Chattooga","2020-07-10","22","1201","3","45","7.9","4.4"
"Chattooga","2020-07-11","11","1212","0","45","7.9","4.4"
"Chattooga","2020-07-12","3","1215","0","45","7.9","4.4"
"Chattooga","2020-07-13","24","1239","4","49","9.1","5.6"
"Chattooga","2020-07-14","20","1259","2","51","9.8","6.3"
"Chattooga","2020-07-15","11","1270","2","53","11.4","7.6"
"Chattooga","2020-07-16","21","1291","2","55","9.7","8.3"
"Chattooga","2020-07-17","19","1310","2","57","9.3","8.6"
"Chattooga","2020-07-18","24","1334","5","62","12.2","10.1"
"Chattooga","2020-07-19","0","1334","0","62","12.2","10.1"
"Chattooga","2020-07-20","29","1363","2","64","10.9","10"
"Chattooga","2020-07-21","46","1409","15","79","14.1","12"
"Chattooga","2020-07-22","41","1450","11","90","15.3","13.4"
"Chattooga","2020-07-23","119","1569","14","104","15.6","12.7"
"Chattooga","2020-07-24","62","1631","9","113","16.2","12.7"
"Chattooga","2020-07-25","37","1668","6","119","15.5","13.9"
"Chattooga","2020-07-26","6","1674","3","122","22.7","17.5"
"Chattooga","2020-07-27","34","1708","4","126","23.4","17.1"
"Chattooga","2020-07-28","46","1754","14","140","23.1","18.6"
"Chattooga","2020-07-29","35","1789","7","147","22.1","18.7"
"Chattooga","2020-07-30","36","1825","12","159","25.2","20.4"
"Chattooga","2020-07-31","75","1900","15","174","26","21.1"
"Chattooga","2020-08-01","24","1924","5","179","26.6","21.1"
"Chattooga","2020-08-02","5","1929","0","179","19.5","21.1"
"Chattooga","2020-08-03","17","1946","3","182","20.3","21.9"
"Chattooga","2020-08-04","89","2035","17","199","18.7","20.9"
"Chattooga","2020-08-05","62","2097","21","220","20.7","21.4"
"Chattooga","2020-08-06","47","2144","9","229","18.7","21.9"
"Chattooga","2020-08-07","50","2194","5","234","17.2","21.6"
"Chattooga","2020-08-08","10","2204","1","235","15.7","21.2"
"Chattooga","2020-08-09","7","2211","0","235","15.7","17.6"
"Chattooga","2020-08-10","29","2240","3","238","14.6","17.5"
"Chattooga","2020-08-11","88","2328","19","257","15","16.8"
"Chattooga","2020-08-12","53","2381","9","266","12.6","16.6"
"Chattooga","2020-08-13","32","2413","6","272","12.5","15.6"
"Chattooga","2020-08-14","53","2466","3","275","11.9","14.6"
"Chattooga","2020-08-15","39","2505","7","282","13","14.4"
"Chattooga","2020-08-16","12","2517","1","283","14.2","15"
"Chattooga","2020-08-17","24","2541","5","288","15.7","15.2"
"Chattooga","2020-08-18","53","2594","5","293","14","14.5"
"Chattooga","2020-08-19","35","2629","10","303","15.6","14.1"
"Chattooga","2020-08-20","26","2655","3","306","14.6","13.6"
"Chattooga","2020-08-21","54","2709","5","311","15.1","13.5"
"Chattooga","2020-08-22","83","2792","19","330","15.8","14.4"
"Chattooga","2020-08-23","36","2828","23","353","23.8","19"
"Chattooga","2020-08-24","28","2856","4","357","22.8","19.3"
"Chattooga","2020-08-25","66","2922","8","365","23.2","18.6"
"Chattooga","2020-08-26","112","3034","25","390","22.3","19"
"Chattooga","2020-08-27","68","3102","2","392","21.1","17.9"
"Chattooga","2020-08-28","29","3131","4","396","21.7","18.4"
"Chattooga","2020-08-29","15","3146","0","396","18.5","17.2"
"Chattooga","2020-08-30","42","3188","24","420","17.5","20.6"
"Chattooga","2020-08-31","16","3204","1","421","16.4","19.6"
"Chattooga","2020-09-01","139","3343","11","432","15.8","19.5"
"Chattooga","2020-09-02","41","3384","2","434","13.3","17.8"
"Chattooga","2020-09-03","74","3458","8","442","14.4","17.7"
"Chattooga","2020-09-04","36","3494","1","443","12.8","17.3"
"Chattooga","2020-09-05","31","3525","0","443","12.8","15.7"
"Chattooga","2020-09-06","36","3561","5","448","6.6","12.1"
"Chattooga","2020-09-07","3","3564","1","449","10.5","13.4"
"Chattooga","2020-09-08","61","3625","1","450","9.6","12.7"
"Chattooga","2020-09-09","78","3703","5","455","9.8","11.6"
"Chattooga","2020-09-10","27","3730","0","455","8.3","11.3"
"Chattooga","2020-09-11","50","3780","5","460","9.3","11.1"
"Chattooga","2020-09-12","25","3805","1","461","9.9","11.4"
"Chattooga","2020-09-13","3","3808","0","461","7.9","7.3"
"Chattooga","2020-09-14","10","3818","1","462","4.6","7.5"
"Chattooga","2020-09-15","116","3934","4","466","4.8","7.2"
"Chattooga","2020-09-16","12","3946","3","469","7.5","8.7"
"Chattooga","2020-09-17","11","3957","1","470","8.8","8.5"
"Chattooga","2020-09-18","59","4016","7","477","9.1","9.2"
"Chattooga","2020-09-19","13","4029","0","477","8.5","9.2"
"Chattooga","2020-09-20","3","4032","1","478","13.2","10.6"
"Chattooga","2020-09-21","10","4042","1","479","13.2","8.9"
"Chattooga","2020-09-22","72","4114","10","489","14.7","9.8"
"Chattooga","2020-09-23","26","4140","4","493","13.4","10.4"
"Chattooga","2020-09-24","16","4156","2","495","13.9","11.3"
"Chattooga","2020-09-25","19","4175","3","498","14.4","11.7"
"Chattooga","2020-09-26","33","4208","7","505","17.4","13"
"Chattooga","2020-09-27","4","4212","0","505","12.7","13"
"Chattooga","2020-09-28","8","4220","1","506","13","13.1"
"Chattooga","2020-09-29","67","4287","4","510","11.9","13.3"
"Chattooga","2020-09-30","16","4303","3","513","12.4","12.9"
"Chattooga","2020-10-01","18","4321","1","514","11.4","12.6"
"Chattooga","2020-10-02","38","4359","5","519","11","12.7"
"Chattooga","2020-10-03","4","4363","0","519","8","12.7"
"Chattooga","2020-10-04","4","4367","0","519","8","10.3"
"Chattooga","2020-10-05","13","4380","2","521","8.4","10.7"
"Chattooga","2020-10-06","114","4494","9","530","8.7","10.3"
"Chattooga","2020-10-07","52","4546","3","533","6.8","9.6"
"Chattooga","2020-10-08","28","4574","2","535","7","9.2"
"Chattooga","2020-10-09","32","4606","5","540","7.4","9.2"
"Chattooga","2020-10-10","33","4639","0","540","7.4","7.7"
"Chattooga","2020-10-11","0","4639","0","540","7.4","7.7"
"Chattooga","2020-10-12","18","4657","3","543","7.6","8"
"Chattooga","2020-10-13","92","4749","14","557","8.6","8.7"
"Chattooga","2020-10-14","31","4780","1","558","8.3","7.5"
"Chattooga","2020-10-15","32","4812","2","560","8.1","7.6"
"Chattooga","2020-10-16","29","4841","2","562","6.9","7.1"
"Chattooga","2020-10-17","45","4886","6","568","8.8","8.1"
"Chattooga","2020-10-18","9","4895","3","571","13.6","10.5"
"Chattooga","2020-10-19","16","4911","1","572","12.1","9.8"
"Chattooga","2020-10-20","103","5014","11","583","11.4","10"
"Chattooga","2020-10-21","53","5067","3","586","11.8","10"
"Chattooga","2020-10-22","53","5120","11","597","13.8","11"
"Chattooga","2020-10-23","38","5158","6","603","15.1","11"
"Chattooga","2020-10-24","30","5188","7","610","16.5","12.7"
"Chattooga","2020-10-25","8","5196","1","611","13.6","13.6"
"Chattooga","2020-10-26","18","5214","4","615","15.8","14"
"Chattooga","2020-10-27","118","5332","20","635","16.7","14.1"
"Chattooga","2020-10-28","39","5371","5","640","17.8","14.8"
"Chattooga","2020-10-29","27","5398","1","641","15.3","14.6"
"Chattooga","2020-10-30","29","5427","6","647","16","15.6"
"Chattooga","2020-10-31","41","5468","13","660","17.2","16.9"
"Chattooga","2020-11-01","7","5475","2","662","19.5","16.5"
"Chattooga","2020-11-02","26","5501","1","663","16.9","16.4"
"Chattooga","2020-11-03","96","5597","10","673","16","16.4"
"Chattooga","2020-11-04","27","5624","1","674","14.7","16.2"
"Chattooga","2020-11-05","39","5663","3","677","15.2","15.3"
"Chattooga","2020-11-06","41","5704","6","683","14.4","15.2"
"Chattooga","2020-11-07","29","5733","5","688","12.3","14.8"
"Chattooga","2020-11-08","4","5737","1","689","11.8","15.7"
"Chattooga","2020-11-09","28","5765","3","692","12.8","14.8"
"Chattooga","2020-11-10","121","5886","7","699","12.1","14"
"Chattooga","2020-11-11","42","5928","5","704","13.3","14"
"Chattooga","2020-11-12","50","5978","3","707","13","14.1"
"Chattooga","2020-11-13","34","6012","4","711","12.6","13.5"
"Chattooga","2020-11-14","24","6036","1","712","10.8","11.5"
"Chattooga","2020-11-15","9","6045","0","712","7.2","9.5"
"Chattooga","2020-11-16","20","6065","6","718","9.9","11.4"
"Chattooga","2020-11-17","76","6141","5","723","10.1","11.1"
"Chattooga","2020-11-18","29","6170","2","725","9.3","11.3"
"Chattooga","2020-11-19","30","6200","1","726","9","11"
"Chattooga","2020-11-20","41","6241","4","730","8.7","10.7"
"Chattooga","2020-11-21","39","6280","6","736","10.3","10.5"
"Chattooga","2020-11-22","9","6289","2","738","13.5","10.3"
"Chattooga","2020-11-23","28","6317","1","739","9.7","9.8"
"Chattooga","2020-11-24","88","6405","13","752","10.8","10.5"
"Chattooga","2020-11-25","64","6469","13","765","12.8","11.1"
"Chattooga","2020-11-26","13","6482","3","768","15.6","12.3"
"Chattooga","2020-11-27","27","6509","3","771","15.8","12.2"
"Chattooga","2020-11-28","45","6554","12","783","17.4","13.8"
"Chattooga","2020-11-29","12","6566","7","790","22.5","18"
"Chattooga","2020-11-30","31","6597","4","794","23.9","16.8"
"Chattooga","2020-12-01","78","6675","13","807","24.2","17.5"
"Chattooga","2020-12-02","41","6716","8","815","24","18.4"
"Chattooga","2020-12-03","64","6780","9","824","22.8","19.2"
"Chattooga","2020-12-04","61","6841","9","833","23.3","19.5"
"Chattooga","2020-12-05","25","6866","9","842","24.6","21"
"Chattooga","2020-12-06","15","6881","6","848","22","22.3"
"Chattooga","2020-12-07","59","6940","13","861","23.3","23.6"
"Chattooga","2020-12-08","70","7010","16","877","24.2","24.2"
"Chattooga","2020-12-09","51","7061","11","888","24.5","24.3"
"Chattooga","2020-12-10","54","7115","13","901","25.9","24.3"
"Chattooga","2020-12-11","63","7178","13","914","26.7","25"
"Chattooga","2020-12-12","62","7240","7","921","23.2","23.9"
"Chattooga","2020-12-13","22","7262","7","928","22","22"
"Chattooga","2020-12-14","49","7311","9","937","21.5","22.4"
"Chattooga","2020-12-15","114","7425","27","964","21.6","22.9"
"Chattooga","2020-12-16","84","7509","13","977","20.8","22.6"
"Chattooga","2020-12-17","55","7564","11","988","20.2","23"
"Chattooga","2020-12-18","49","7613","11","999","20.4","23.6"
"Chattooga","2020-12-19","49","7662","11","1010","22","22.6"
"Chattooga","2020-12-20","16","7678","4","1014","21.1","21.6"
"Chattooga","2020-12-21","28","7706","5","1019","21","21.3"
"Chattooga","2020-12-22","96","7802","26","1045","21.5","21.6"
"Chattooga","2020-12-23","57","7859","14","1059","22.8","21.8"
"Chattooga","2020-12-24","30","7889","8","1067","23.7","22"
"Chattooga","2020-12-25","8","7897","2","1069","24.1","22.3"
"Chattooga","2020-12-26","42","7939","14","1083","25.6","23.8"
"Chattooga","2020-12-27","29","7968","10","1093","27","24"
"Chattooga","2020-12-28","49","8017","7","1100","26.5","23.7"
"Chattooga","2020-12-29","178","8195","64","1164","27.8","24.6"
"Chattooga","2020-12-30","53","8248","15","1179","28.3","25.5"
"Chattooga","2020-12-31","70","8318","12","1191","26.9","25.3"
"Chattooga","2021-01-01","12","8330","2","1193","25.7","24.9"
"Chattooga","2021-01-02","9","8339","2","1195","24.2","24.9"
"Chattooga","2021-01-03","14","8353","3","1198","22.3","24.6"
"Chattooga","2021-01-04","47","8400","13","1211","24.2","25.3"
"Chattooga","2021-01-05","154","8554","54","1265","24.1","25.9"
"Chattooga","2021-01-06","85","8639","21","1286","23.6","25.9"
"Chattooga","2021-01-07","72","8711","13","1299","23.7","25.3"
"Chattooga","2021-01-08","109","8820","29","1328","25.1","25.4"
"Chattooga","2021-01-09","69","8889","14","1342","24.8","24.5"
"Chattooga","2021-01-10","18","8907","7","1349","27.3","24.8"
"Chattooga","2021-01-11","48","8955","8","1357","25.8","25"
"Chattooga","2021-01-12","109","9064","23","1380","23.8","23.9"
"Chattooga","2021-01-13","50","9114","10","1390","23.1","23.3"
"Chattooga","2021-01-14","127","9241","12","1402","21.9","22.8"
"Chattooga","2021-01-15","61","9302","12","1414","20.9","23"
"Chattooga","2021-01-16","48","9350","8","1422","20.3","22.6"
"Chattooga","2021-01-17","24","9374","2","1424","16","21.7"
"Chattooga","2021-01-18","43","9417","8","1432","16.3","21"
"Chattooga","2021-01-19","57","9474","16","1448","17.3","20.5"
"Chattooga","2021-01-20","66","9540","11","1459","16.8","19.9"
"Chattooga","2021-01-21","55","9595","6","1465","17","19.4"
"Chattooga","2021-01-22","27","9622","4","1469","16.3","18.6"
"Chattooga","2021-01-23","41","9663","5","1474","15.7","18"
"Chattooga","2021-01-24","15","9678","3","1477","17.3","16.7"
"Chattooga","2021-01-25","46","9724","5","1482","16.2","16.2"
"Chattooga","2021-01-26","56","9780","9","1491","14.5","15.9"
"Chattooga","2021-01-27","46","9826","7","1498","14.3","15.5"
"Chattooga","2021-01-28","38","9864","3","1501","13.9","15.4"
"Chattooga","2021-01-29","31","9895","3","1504","13.1","14.7"
"Chattooga","2021-01-30","27","9922","2","1506","12.4","14.1"
"Chattooga","2021-01-31","9","9931","1","1507","11.2","14.3"
"Chattooga","2021-02-01","36","9967","5","1512","11.6","13.9"
"Chattooga","2021-02-02","60","10027","9","1521","11.5","13"
"Chattooga","2021-02-03","31","10058","4","1525","11.1","12.7"
"Chattooga","2021-02-04","52","10110","4","1529","11.1","12.5"
"Chattooga","2021-02-05","38","10148","2","1531","10.5","11.8"
"Chattooga","2021-02-06","2","10150","0","1531","9.4","10.9"
"Chattooga","2021-02-07","2","10152","0","1531","7.8","9.5"
"Chattooga","2021-02-08","0","10152","0","1531","5.8","8.7"
"Cherokee","2020-02-01","0","0","0","0",".","."
"Cherokee","2020-02-02","0","0","0","0",".","."
"Cherokee","2020-02-03","0","0","0","0",".","."
"Cherokee","2020-02-04","0","0","0","0",".","."
"Cherokee","2020-02-05","0","0","0","0",".","."
"Cherokee","2020-02-06","0","0","0","0",".","."
"Cherokee","2020-02-07","0","0","0","0","0","."
"Cherokee","2020-02-08","0","0","0","0","0","."
"Cherokee","2020-02-09","0","0","0","0","0","."
"Cherokee","2020-02-10","0","0","0","0","0","."
"Cherokee","2020-02-11","0","0","0","0","0","."
"Cherokee","2020-02-12","0","0","0","0","0","."
"Cherokee","2020-02-13","0","0","0","0","0","."
"Cherokee","2020-02-14","0","0","0","0","0","0"
"Cherokee","2020-02-15","1","1","0","0","0","0"
"Cherokee","2020-02-16","0","1","0","0","0","0"
"Cherokee","2020-02-17","0","1","0","0","0","0"
"Cherokee","2020-02-18","1","2","1","1","14.3","7.1"
"Cherokee","2020-02-19","0","2","0","1","14.3","7.1"
"Cherokee","2020-02-20","0","2","0","1","14.3","7.1"
"Cherokee","2020-02-21","0","2","0","1","14.3","7.1"
"Cherokee","2020-02-22","0","2","0","1","14.3","7.1"
"Cherokee","2020-02-23","0","2","0","1","14.3","7.1"
"Cherokee","2020-02-24","0","2","0","1","14.3","7.1"
"Cherokee","2020-02-25","0","2","0","1","0","7.1"
"Cherokee","2020-02-26","0","2","0","1","0","7.1"
"Cherokee","2020-02-27","1","3","0","1","0","7.1"
"Cherokee","2020-02-28","0","3","0","1","0","7.1"
"Cherokee","2020-02-29","0","3","0","1","0","7.1"
"Cherokee","2020-03-01","0","3","0","1","0","7.1"
"Cherokee","2020-03-02","0","3","0","1","0","7.1"
"Cherokee","2020-03-03","0","3","0","1","0","0"
"Cherokee","2020-03-04","0","3","0","1","0","0"
"Cherokee","2020-03-05","2","5","0","1","0","0"
"Cherokee","2020-03-06","6","11","0","1","0","0"
"Cherokee","2020-03-07","1","12","0","1","0","0"
"Cherokee","2020-03-08","5","17","2","3","5.7","2.9"
"Cherokee","2020-03-09","6","23","0","3","5.7","2.9"
"Cherokee","2020-03-10","20","43","0","3","5.7","2.9"
"Cherokee","2020-03-11","13","56","1","4","6.8","3.4"
"Cherokee","2020-03-12","34","90","1","5","7.2","3.6"
"Cherokee","2020-03-13","17","107","3","8","9.8","4.9"
"Cherokee","2020-03-14","1","108","0","8","9.8","4.9"
"Cherokee","2020-03-15","0","108","0","8","4","4.9"
"Cherokee","2020-03-16","27","135","2","10","5.1","5.4"
"Cherokee","2020-03-17","42","177","2","12","5.8","5.7"
"Cherokee","2020-03-18","12","189","1","13","5.9","6.3"
"Cherokee","2020-03-19","15","204","5","18","10.2","8.7"
"Cherokee","2020-03-20","45","249","4","22","9","9.4"
"Cherokee","2020-03-21","4","253","0","22","9","9.4"
"Cherokee","2020-03-22","7","260","0","22","9","6.5"
"Cherokee","2020-03-23","53","313","9","31","10.3","7.7"
"Cherokee","2020-03-24","27","340","5","36","12.3","9"
"Cherokee","2020-03-25","59","399","5","41","12.3","9.1"
"Cherokee","2020-03-26","51","450","11","52","10.6","10.4"
"Cherokee","2020-03-27","63","513","8","60","11.2","10.1"
"Cherokee","2020-03-28","10","523","0","60","11.2","10.1"
"Cherokee","2020-03-29","19","542","2","62","12.7","10.8"
"Cherokee","2020-03-30","69","611","9","71","12.1","11.2"
"Cherokee","2020-03-31","60","671","5","76","10.7","11.5"
"Cherokee","2020-04-01","43","714","4","80","10.8","11.5"
"Cherokee","2020-04-02","29","743","4","84","9.7","10.2"
"Cherokee","2020-04-03","53","796","5","89","9.2","10.2"
"Cherokee","2020-04-04","15","811","2","91","11.1","11.1"
"Cherokee","2020-04-05","10","821","2","93","12.5","12.6"
"Cherokee","2020-04-06","70","891","10","103","12.6","12.4"
"Cherokee","2020-04-07","64","955","7","110","13","11.8"
"Cherokee","2020-04-08","53","1008","7","117","13.6","12.2"
"Cherokee","2020-04-09","44","1052","6","123","13.5","11.6"
"Cherokee","2020-04-10","50","1102","7","130","14.2","11.7"
"Cherokee","2020-04-11","29","1131","2","132","13.3","12.2"
"Cherokee","2020-04-12","9","1140","1","133","12","12.2"
"Cherokee","2020-04-13","81","1221","14","147","12.4","12.5"
"Cherokee","2020-04-14","109","1330","14","161","12.7","12.9"
"Cherokee","2020-04-15","111","1441","8","169","11.9","12.7"
"Cherokee","2020-04-16","170","1611","22","191","11.8","12.7"
"Cherokee","2020-04-17","331","1942","20","211","10.6","12.4"
"Cherokee","2020-04-18","169","2111","4","215","10","11.6"
"Cherokee","2020-04-19","137","2248","3","218","8.7","10.4"
"Cherokee","2020-04-20","198","2446","34","252","8.7","10.6"
"Cherokee","2020-04-21","209","2655","28","280","8.8","10.7"
"Cherokee","2020-04-22","148","2803","12","292","8.9","10.4"
"Cherokee","2020-04-23","102","2905","10","302","8.4","10.1"
"Cherokee","2020-04-24","272","3177","18","320","8.5","9.6"
"Cherokee","2020-04-25","112","3289","7","327","9.1","9.5"
"Cherokee","2020-04-26","71","3360","4","331","9.6","9.1"
"Cherokee","2020-04-27","187","3547","26","357","9.1","8.9"
"Cherokee","2020-04-28","215","3762","12","369","8","8.4"
"Cherokee","2020-04-29","179","3941","19","388","8.3","8.6"
"Cherokee","2020-04-30","255","4196","24","412","8.3","8.4"
"Cherokee","2020-05-01","145","4341","11","423","8.4","8.5"
"Cherokee","2020-05-02","126","4467","19","442","9.7","9.4"
"Cherokee","2020-05-03","62","4529","11","453","11.4","10.5"
"Cherokee","2020-05-04","197","4726","12","465","10.3","9.7"
"Cherokee","2020-05-05","159","4885","11","476","10.5","9.2"
"Cherokee","2020-05-06","135","5020","6","482","9.6","9"
"Cherokee","2020-05-07","122","5142","15","497","10","9.2"
"Cherokee","2020-05-08","190","5332","9","506","9.6","9"
"Cherokee","2020-05-09","65","5397","1","507","7.7","8.7"
"Cherokee","2020-05-10","38","5435","6","513","7.4","9.4"
"Cherokee","2020-05-11","349","5784","25","538","7.6","8.9"
"Cherokee","2020-05-12","314","6098","16","554","7.3","8.9"
"Cherokee","2020-05-13","255","6353","4","558","6.9","8.2"
"Cherokee","2020-05-14","331","6684","13","571","5.7","7.9"
"Cherokee","2020-05-15","367","7051","30","601","6.2","7.9"
"Cherokee","2020-05-16","88","7139","6","607","6.9","7.3"
"Cherokee","2020-05-17","78","7217","2","609","5","6.2"
"Cherokee","2020-05-18","379","7596","29","638","5.1","6.3"
"Cherokee","2020-05-19","369","7965","18","656","5.1","6.2"
"Cherokee","2020-05-20","307","8272","21","677","5.8","6.4"
"Cherokee","2020-05-21","292","8564","13","690","5.9","5.8"
"Cherokee","2020-05-22","230","8794","1","691","4.8","5.5"
"Cherokee","2020-05-23","115","8909","5","696","4.5","5.7"
"Cherokee","2020-05-24","75","8984","5","701","5","5"
"Cherokee","2020-05-25","114","9098","5","706","4.6","4.8"
"Cherokee","2020-05-26","322","9420","9","715","4.3","4.7"
"Cherokee","2020-05-27","288","9708","14","729","4","4.9"
"Cherokee","2020-05-28","193","9901","8","737","3.9","4.9"
"Cherokee","2020-05-29","199","10100","4","741","4.2","4.5"
"Cherokee","2020-05-30","84","10184","2","743","3.9","4.2"
"Cherokee","2020-05-31","70","10254","1","744","3.1","4.1"
"Cherokee","2020-06-01","277","10531","10","754","3","3.8"
"Cherokee","2020-06-02","302","10833","17","771","3.4","3.9"
"Cherokee","2020-06-03","280","11113","8","779","3.2","3.6"
"Cherokee","2020-06-04","280","11393","4","783","2.8","3.4"
"Cherokee","2020-06-05","229","11622","8","791","3","3.6"
"Cherokee","2020-06-06","128","11750","5","796","3.2","3.5"
"Cherokee","2020-06-07","84","11834","7","803","4.2","3.7"
"Cherokee","2020-06-08","276","12110","9","812","4.1","3.6"
"Cherokee","2020-06-09","236","12346","9","821","3.9","3.7"
"Cherokee","2020-06-10","252","12598","6","827","3.8","3.5"
"Cherokee","2020-06-11","281","12879","6","833","3.9","3.3"
"Cherokee","2020-06-12","245","13124","7","840","3.8","3.4"
"Cherokee","2020-06-13","114","13238","8","848","4.3","3.7"
"Cherokee","2020-06-14","104","13342","1","849","3.2","3.7"
"Cherokee","2020-06-15","333","13675","16","865","3.4","3.8"
"Cherokee","2020-06-16","339","14014","14","879","3.5","3.7"
"Cherokee","2020-06-17","279","14293","11","890","3.7","3.7"
"Cherokee","2020-06-18","347","14640","26","916","4.5","4.2"
"Cherokee","2020-06-19","367","15007","25","941","5","4.4"
"Cherokee","2020-06-20","109","15116","17","958","6.2","5.3"
"Cherokee","2020-06-21","75","15191","10","968","8","5.6"
"Cherokee","2020-06-22","482","15673","30","998","8.2","5.8"
"Cherokee","2020-06-23","447","16120","38","1036","8.8","6.2"
"Cherokee","2020-06-24","466","16586","39","1075","9.5","6.6"
"Cherokee","2020-06-25","509","17095","31","1106","9.3","6.9"
"Cherokee","2020-06-26","531","17626","47","1153","9.6","7.3"
"Cherokee","2020-06-27","186","17812","19","1172","8.8","7.5"
"Cherokee","2020-06-28","90","17902","6","1178","7.8","7.9"
"Cherokee","2020-06-29","650","18552","49","1227","8","8.1"
"Cherokee","2020-06-30","588","19140","57","1284","8.2","8.5"
"Cherokee","2020-07-01","625","19765","50","1334","8.2","8.8"
"Cherokee","2020-07-02","811","20576","62","1396","8.4","8.8"
"Cherokee","2020-07-03","199","20775","19","1415","8.5","9"
"Cherokee","2020-07-04","255","21030","29","1444","8.6","8.7"
"Cherokee","2020-07-05","117","21147","9","1453","8.8","8.3"
"Cherokee","2020-07-06","824","21971","49","1502","8.6","8.3"
"Cherokee","2020-07-07","743","22714","78","1580","8.7","8.4"
"Cherokee","2020-07-08","780","23494","80","1660","9","8.6"
"Cherokee","2020-07-09","821","24315","84","1744","9.4","8.9"
"Cherokee","2020-07-10","754","25069","72","1816","9.4","8.9"
"Cherokee","2020-07-11","198","25267","28","1844","9.8","9.2"
"Cherokee","2020-07-12","134","25401","12","1856","9.9","9.4"
"Cherokee","2020-07-13","724","26125","75","1931","10.6","9.6"
"Cherokee","2020-07-14","690","26815","72","2003","10.6","9.6"
"Cherokee","2020-07-15","669","27484","57","2060","10.3","9.7"
"Cherokee","2020-07-16","693","28177","62","2122","10.1","9.7"
"Cherokee","2020-07-17","753","28930","69","2191","10.1","9.7"
"Cherokee","2020-07-18","232","29162","27","2218","9.7","9.7"
"Cherokee","2020-07-19","139","29301","21","2239","10.6","10.3"
"Cherokee","2020-07-20","790","30091","71","2310","10.4","10.5"
"Cherokee","2020-07-21","631","30722","52","2362","10.1","10.3"
"Cherokee","2020-07-22","668","31390","57","2419","10.1","10.2"
"Cherokee","2020-07-23","782","32172","42","2461","9.6","9.9"
"Cherokee","2020-07-24","730","32902","43","2504","9.1","9.6"
"Cherokee","2020-07-25","222","33124","24","2528","9","9.4"
"Cherokee","2020-07-26","142","33266","13","2541","8.1","9.4"
"Cherokee","2020-07-27","827","34093","61","2602","7.9","9.2"
"Cherokee","2020-07-28","706","34799","42","2644","7.6","8.8"
"Cherokee","2020-07-29","759","35558","66","2710","7.6","8.8"
"Cherokee","2020-07-30","864","36422","59","2769","7.8","8.7"
"Cherokee","2020-07-31","927","37349","76","2845","8.1","8.6"
"Cherokee","2020-08-01","242","37591","13","2858","7.4","8.2"
"Cherokee","2020-08-02","201","37792","26","2884","7.9","8"
"Cherokee","2020-08-03","800","38592","75","2959","8.2","8.1"
"Cherokee","2020-08-04","835","39427","65","3024","8.5","8"
"Cherokee","2020-08-05","739","40166","92","3116","9","8.3"
"Cherokee","2020-08-06","840","41006","62","3178","9.1","8.4"
"Cherokee","2020-08-07","781","41787","76","3254","9.3","8.7"
"Cherokee","2020-08-08","212","41999","20","3274","9.9","8.6"
"Cherokee","2020-08-09","215","42214","22","3296","9.5","8.7"
"Cherokee","2020-08-10","857","43071","88","3384","9.6","8.9"
"Cherokee","2020-08-11","992","44063","99","3483","9.9","9.2"
"Cherokee","2020-08-12","886","44949","52","3535","9","9"
"Cherokee","2020-08-13","962","45911","52","3587","8.7","8.9"
"Cherokee","2020-08-14","974","46885","59","3646","8.2","8.7"
"Cherokee","2020-08-15","327","47212","39","3685","8.5","9.2"
"Cherokee","2020-08-16","182","47394","16","3701","8.3","8.9"
"Cherokee","2020-08-17","493","47887","37","3738","7.9","8.8"
"Cherokee","2020-08-18","921","48808","50","3788","7.3","8.6"
"Cherokee","2020-08-19","831","49639","49","3837","7.3","8.1"
"Cherokee","2020-08-20","823","50462","46","3883","7.3","8"
"Cherokee","2020-08-21","881","51343","68","3951","7.6","7.9"
"Cherokee","2020-08-22","372","51715","23","3974","6.7","7.6"
"Cherokee","2020-08-23","151","51866","21","3995","7.5","7.9"
"Cherokee","2020-08-24","929","52795","80","4075","7.6","7.8"
"Cherokee","2020-08-25","791","53586","60","4135","7.9","7.6"
"Cherokee","2020-08-26","670","54256","48","4183","8.1","7.7"
"Cherokee","2020-08-27","731","54987","44","4227","8.2","7.7"
"Cherokee","2020-08-28","845","55832","39","4266","7.7","7.6"
"Cherokee","2020-08-29","306","56138","22","4288","7.9","7.3"
"Cherokee","2020-08-30","173","56311","18","4306","7.4","7.4"
"Cherokee","2020-08-31","725","57036","64","4370","7.4","7.5"
"Cherokee","2020-09-01","656","57692","51","4421","7.4","7.7"
"Cherokee","2020-09-02","672","58364","35","4456","7.1","7.6"
"Cherokee","2020-09-03","779","59143","51","4507","7.2","7.7"
"Cherokee","2020-09-04","631","59774","63","4570","8","7.9"
"Cherokee","2020-09-05","158","59932","8","4578","7.7","7.8"
"Cherokee","2020-09-06","124","60056","15","4593","7.9","7.6"
"Cherokee","2020-09-07","248","60304","19","4612","7.8","7.6"
"Cherokee","2020-09-08","811","61115","60","4672","7.7","7.6"
"Cherokee","2020-09-09","628","61743","52","4724","8.1","7.6"
"Cherokee","2020-09-10","839","62582","48","4772","8","7.6"
"Cherokee","2020-09-11","673","63255","47","4819","7.6","7.8"
"Cherokee","2020-09-12","285","63540","23","4842","8","7.9"
"Cherokee","2020-09-13","142","63682","10","4852","7.3","7.6"
"Cherokee","2020-09-14","685","64367","50","4902","7.3","7.5"
"Cherokee","2020-09-15","664","65031","27","4929","6.8","7.2"
"Cherokee","2020-09-16","673","65704","33","4962","6.3","7.2"
"Cherokee","2020-09-17","566","66270","15","4977","5.9","6.9"
"Cherokee","2020-09-18","645","66915","34","5011","5.6","6.6"
"Cherokee","2020-09-19","266","67181","15","5026","5.3","6.6"
"Cherokee","2020-09-20","103","67284","16","5042","6.5","6.9"
"Cherokee","2020-09-21","484","67768","40","5082","6.6","6.9"
"Cherokee","2020-09-22","508","68276","22","5104","6.7","6.7"
"Cherokee","2020-09-23","497","68773","30","5134","6.8","6.6"
"Cherokee","2020-09-24","642","69415","29","5163","7.1","6.5"
"Cherokee","2020-09-25","464","69879","33","5196","7.3","6.5"
"Cherokee","2020-09-26","197","70076","12","5208","7.4","6.3"
"Cherokee","2020-09-27","136","70212","10","5218","6.2","6.4"
"Cherokee","2020-09-28","540","70752","41","5259","6.1","6.4"
"Cherokee","2020-09-29","622","71374","28","5287","6.2","6.4"
"Cherokee","2020-09-30","537","71911","32","5319","6.2","6.5"
"Cherokee","2020-10-01","673","72584","26","5345","6.1","6.6"
"Cherokee","2020-10-02","571","73155","26","5371","5.7","6.5"
"Cherokee","2020-10-03","274","73429","18","5389","5.8","6.6"
"Cherokee","2020-10-04","121","73550","15","5404","6.5","6.4"
"Cherokee","2020-10-05","637","74187","32","5436","6.1","6.1"
"Cherokee","2020-10-06","904","75091","37","5473","6.1","6.1"
"Cherokee","2020-10-07","702","75793","39","5512","6","6.1"
"Cherokee","2020-10-08","628","76421","44","5556","6.5","6.3"
"Cherokee","2020-10-09","591","77012","47","5603","6.9","6.3"
"Cherokee","2020-10-10","175","77187","22","5625","7.8","6.8"
"Cherokee","2020-10-11","161","77348","15","5640","7.4","6.9"
"Cherokee","2020-10-12","453","77801","16","5656","7.1","6.6"
"Cherokee","2020-10-13","819","78620","42","5698","7.3","6.7"
"Cherokee","2020-10-14","593","79213","30","5728","7.2","6.6"
"Cherokee","2020-10-15","592","79805","36","5764","7.1","6.8"
"Cherokee","2020-10-16","525","80330","27","5791","6.7","6.8"
"Cherokee","2020-10-17","253","80583","13","5804","5.6","6.7"
"Cherokee","2020-10-18","144","80727","11","5815","5.4","6.4"
"Cherokee","2020-10-19","628","81355","50","5865","6","6.6"
"Cherokee","2020-10-20","835","82190","39","5904","6","6.6"
"Cherokee","2020-10-21","704","82894","57","5961","6.4","6.8"
"Cherokee","2020-10-22","774","83668","51","6012","6.5","6.8"
"Cherokee","2020-10-23","695","84363","39","6051","6.5","6.6"
"Cherokee","2020-10-24","178","84541","19","6070","7.3","6.5"
"Cherokee","2020-10-25","227","84768","31","6101","8.2","6.8"
"Cherokee","2020-10-26","786","85554","61","6162","8.2","7.1"
"Cherokee","2020-10-27","746","86300","53","6215","8.5","7.2"
"Cherokee","2020-10-28","697","86997","44","6259","8.2","7.3"
"Cherokee","2020-10-29","512","87509","23","6282","7.9","7.2"
"Cherokee","2020-10-30","745","88254","61","6343","8.3","7.4"
"Cherokee","2020-10-31","301","88555","27","6370","8.1","7.7"
"Cherokee","2020-11-01","159","88714","24","6394","8.3","8.2"
"Cherokee","2020-11-02","749","89463","64","6458","8.4","8.3"
"Cherokee","2020-11-03","745","90208","56","6514","8.4","8.5"
"Cherokee","2020-11-04","727","90935","71","6585","8.9","8.6"
"Cherokee","2020-11-05","786","91721","53","6638","9.3","8.6"
"Cherokee","2020-11-06","695","92416","60","6698","9.3","8.8"
"Cherokee","2020-11-07","346","92762","50","6748","10.1","9.1"
"Cherokee","2020-11-08","193","92955","37","6785","10.7","9.5"
"Cherokee","2020-11-09","857","93812","88","6873","10.9","9.7"
"Cherokee","2020-11-10","1042","94854","76","6949","10.9","9.7"
"Cherokee","2020-11-11","498","95352","41","6990","10.7","9.8"
"Cherokee","2020-11-12","1258","96610","120","7110","11.1","10.2"
"Cherokee","2020-11-13","1079","97689","69","7179","10.8","10"
"Cherokee","2020-11-14","695","98384","60","7239","9.9","10"
"Cherokee","2020-11-15","200","98584","30","7269","9.3","10"
"Cherokee","2020-11-16","1088","99672","120","7389","9.4","10.2"
"Cherokee","2020-11-17","937","100609","67","7456","9.4","10.2"
"Cherokee","2020-11-18","1161","101770","81","7537","9.2","10"
"Cherokee","2020-11-19","1310","103080","96","7633","8.9","10"
"Cherokee","2020-11-20","1168","104248","90","7723","9.1","9.9"
"Cherokee","2020-11-21","656","104904","56","7779","9.1","9.5"
"Cherokee","2020-11-22","265","105169","37","7816","9","9.1"
"Cherokee","2020-11-23","1077","106246","83","7899","8.5","9"
"Cherokee","2020-11-24","1028","107274","87","7986","8.7","9"
"Cherokee","2020-11-25","866","108140","91","8077","9.2","9.2"
"Cherokee","2020-11-26","94","108234","12","8089","9.9","9.4"
"Cherokee","2020-11-27","515","108749","44","8133","10.1","9.6"
"Cherokee","2020-11-28","435","109184","59","8192","10.8","9.9"
"Cherokee","2020-11-29","224","109408","32","8224","10.8","9.9"
"Cherokee","2020-11-30","1097","110505","146","8370","11.6","10.1"
"Cherokee","2020-12-01","1159","111664","130","8500","12","10.3"
"Cherokee","2020-12-02","1012","112676","100","8600","11.9","10.6"
"Cherokee","2020-12-03","1075","113751","98","8698","11.4","10.7"
"Cherokee","2020-12-04","991","114742","97","8795","11.6","10.8"
"Cherokee","2020-12-05","555","115297","74","8869","11.6","11.2"
"Cherokee","2020-12-06","220","115517","39","8908","12.1","11.4"
"Cherokee","2020-12-07","1036","116553","141","9049","12.1","11.9"
"Cherokee","2020-12-08","1201","117754","106","9155","11.8","11.9"
"Cherokee","2020-12-09","987","118741","121","9276","12.1","12"
"Cherokee","2020-12-10","998","119739","110","9386","12.4","11.9"
"Cherokee","2020-12-11","1102","120841","111","9497","12.4","12"
"Cherokee","2020-12-12","516","121357","85","9582","12.9","12.2"
"Cherokee","2020-12-13","255","121612","40","9622","12.6","12.3"
"Cherokee","2020-12-14","1067","122679","136","9758","12.4","12.3"
"Cherokee","2020-12-15","1411","124090","211","9969","13.3","12.5"
"Cherokee","2020-12-16","1253","125343","144","10113","13.2","12.7"
"Cherokee","2020-12-17","1161","126504","144","10257","13.4","12.9"
"Cherokee","2020-12-18","1046","127550","136","10393","13.8","13.1"
"Cherokee","2020-12-19","575","128125","78","10471","13.4","13.1"
"Cherokee","2020-12-20","253","128378","63","10534","14.7","13.6"
"Cherokee","2020-12-21","1203","129581","180","10714","15","13.7"
"Cherokee","2020-12-22","1230","130811","205","10919","15.3","14.3"
"Cherokee","2020-12-23","1272","132083","193","11112","15.8","14.5"
"Cherokee","2020-12-24","494","132577","108","11220","17.2","15.3"
"Cherokee","2020-12-25","133","132710","40","11260","19.6","16.7"
"Cherokee","2020-12-26","396","133106","93","11353","21","17.2"
"Cherokee","2020-12-27","294","133400","91","11444","21.9","18.3"
"Cherokee","2020-12-28","1321","134721","249","11693","22.4","18.7"
"Cherokee","2020-12-29","1122","135843","231","11924","23","19.1"
"Cherokee","2020-12-30","1179","137022","253","12177","23.9","19.9"
"Cherokee","2020-12-31","1118","138140","220","12397","23.6","20.4"
"Cherokee","2021-01-01","200","138340","57","12454","23.4","21.5"
"Cherokee","2021-01-02","564","138904","126","12580","23.2","22.1"
"Cherokee","2021-01-03","279","139183","108","12688","24.3","23.1"
"Cherokee","2021-01-04","1179","140362","257","12945","24.7","23.6"
"Cherokee","2021-01-05","1836","142198","314","13259","24.2","23.6"
"Cherokee","2021-01-06","1329","143527","273","13532","24.1","24"
"Cherokee","2021-01-07","1421","144948","269","13801","24","23.8"
"Cherokee","2021-01-08","1153","146101","212","14013","22.5","23"
"Cherokee","2021-01-09","693","146794","133","14146","22.1","22.6"
"Cherokee","2021-01-10","331","147125","94","14240","20.6","22.5"
"Cherokee","2021-01-11","1058","148183","184","14424","20","22.4"
"Cherokee","2021-01-12","1222","149405","150","14574","19.3","21.8"
"Cherokee","2021-01-13","983","150388","193","14767","19.2","21.6"
"Cherokee","2021-01-14","1127","151515","153","14920","18.4","21.2"
"Cherokee","2021-01-15","1051","152566","178","15098","18.2","20.4"
"Cherokee","2021-01-16","372","152938","92","15190","19","20.5"
"Cherokee","2021-01-17","304","153242","71","15261","18.3","19.4"
"Cherokee","2021-01-18","794","154036","126","15387","18.1","19"
"Cherokee","2021-01-19","1163","155199","126","15513","17.8","18.6"
"Cherokee","2021-01-20","896","156095","152","15665","17.5","18.3"
"Cherokee","2021-01-21","859","156954","135","15800","17.8","18.1"
"Cherokee","2021-01-22","888","157842","116","15916","17.2","17.7"
"Cherokee","2021-01-23","398","158240","90","16006","16.9","18"
"Cherokee","2021-01-24","351","158591","56","16062","15.9","17.1"
"Cherokee","2021-01-25","1094","159685","149","16211","15.5","16.8"
"Cherokee","2021-01-26","1035","160720","136","16347","15.9","16.9"
"Cherokee","2021-01-27","985","161705","107","16454","15","16.2"
"Cherokee","2021-01-28","846","162551","103","16557","14.5","16.1"
"Cherokee","2021-01-29","826","163377","127","16684","14.8","16"
"Cherokee","2021-01-30","306","163683","45","16729","13.7","15.3"
"Cherokee","2021-01-31","305","163988","41","16770","13.3","14.6"
"Cherokee","2021-02-01","980","164968","139","16909","13.4","14.5"
"Cherokee","2021-02-02","830","165798","79","16988","12.9","14.4"
"Cherokee","2021-02-03","904","166702","71","17059","12.5","13.7"
"Cherokee","2021-02-04","671","167373","78","17137","12.4","13.4"
"Cherokee","2021-02-05","614","167987","75","17212","11.9","13.4"
"Cherokee","2021-02-06","125","168112","14","17226","11.4","12.6"
"Cherokee","2021-02-07","27","168139","4","17230","11.6","12.5"
"Cherokee","2021-02-08","0","168139","0","17230","9.6","11.5"
"Clarke","2020-02-01","0","0","0","0",".","."
"Clarke","2020-02-02","0","0","0","0",".","."
"Clarke","2020-02-03","0","0","0","0",".","."
"Clarke","2020-02-04","0","0","0","0",".","."
"Clarke","2020-02-05","0","0","0","0",".","."
"Clarke","2020-02-06","0","0","0","0",".","."
"Clarke","2020-02-07","0","0","0","0","0","."
"Clarke","2020-02-08","0","0","0","0","0","."
"Clarke","2020-02-09","0","0","0","0","0","."
"Clarke","2020-02-10","0","0","0","0","0","."
"Clarke","2020-02-11","0","0","0","0","0","."
"Clarke","2020-02-12","0","0","0","0","0","."
"Clarke","2020-02-13","0","0","0","0","0","."
"Clarke","2020-02-14","0","0","0","0","0","0"
"Clarke","2020-02-15","0","0","0","0","0","0"
"Clarke","2020-02-16","0","0","0","0","0","0"
"Clarke","2020-02-17","0","0","0","0","0","0"
"Clarke","2020-02-18","0","0","0","0","0","0"
"Clarke","2020-02-19","0","0","0","0","0","0"
"Clarke","2020-02-20","0","0","0","0","0","0"
"Clarke","2020-02-21","0","0","0","0","0","0"
"Clarke","2020-02-22","0","0","0","0","0","0"
"Clarke","2020-02-23","0","0","0","0","0","0"
"Clarke","2020-02-24","0","0","0","0","0","0"
"Clarke","2020-02-25","0","0","0","0","0","0"
"Clarke","2020-02-26","0","0","0","0","0","0"
"Clarke","2020-02-27","0","0","0","0","0","0"
"Clarke","2020-02-28","0","0","0","0","0","0"
"Clarke","2020-02-29","0","0","0","0","0","0"
"Clarke","2020-03-01","0","0","0","0","0","0"
"Clarke","2020-03-02","0","0","0","0","0","0"
"Clarke","2020-03-03","0","0","0","0","0","0"
"Clarke","2020-03-04","0","0","0","0","0","0"
"Clarke","2020-03-05","0","0","0","0","0","0"
"Clarke","2020-03-06","0","0","0","0","0","0"
"Clarke","2020-03-07","1","1","0","0","0","0"
"Clarke","2020-03-08","3","4","0","0","0","0"
"Clarke","2020-03-09","3","7","0","0","0","0"
"Clarke","2020-03-10","2","9","0","0","0","0"
"Clarke","2020-03-11","8","17","2","2","3.6","1.8"
"Clarke","2020-03-12","15","32","1","3","4.5","2.3"
"Clarke","2020-03-13","10","42","4","7","10.2","5.1"
"Clarke","2020-03-14","6","48","1","8","12.6","6.3"
"Clarke","2020-03-15","13","61","3","11","15.9","8"
"Clarke","2020-03-16","35","96","2","13","16.7","8.4"
"Clarke","2020-03-17","40","136","5","18","18.5","9.3"
"Clarke","2020-03-18","41","177","3","21","16","9.8"
"Clarke","2020-03-19","54","231","7","28","16.9","10.7"
"Clarke","2020-03-20","66","297","5","33","12.3","11.2"
"Clarke","2020-03-21","16","313","1","34","10.8","11.7"
"Clarke","2020-03-22","10","323","3","37","11.8","13.8"
"Clarke","2020-03-23","42","365","4","41","12.3","14.5"
"Clarke","2020-03-24","80","445","17","58","13.6","16"
"Clarke","2020-03-25","66","511","14","72","15.5","15.8"
"Clarke","2020-03-26","62","573","9","81","15.8","16.3"
"Clarke","2020-03-27","67","640","11","92","17","14.6"
"Clarke","2020-03-28","3","643","0","92","16.1","13.5"
"Clarke","2020-03-29","5","648","0","92","11.8","11.8"
"Clarke","2020-03-30","53","701","3","95","11.3","11.8"
"Clarke","2020-03-31","29","730","4","99","10.2","11.9"
"Clarke","2020-04-01","66","796","9","108","9.1","12.3"
"Clarke","2020-04-02","45","841","3","111","8","11.9"
"Clarke","2020-04-03","36","877","2","113","6.5","11.7"
"Clarke","2020-04-04","9","886","1","114","8.1","12.1"
"Clarke","2020-04-05","6","892","0","114","8.1","10"
"Clarke","2020-04-06","35","927","0","114","7.3","9.3"
"Clarke","2020-04-07","37","964","2","116","6.1","8.1"
"Clarke","2020-04-08","48","1012","2","118","4.7","6.9"
"Clarke","2020-04-09","60","1072","2","120","4.2","6.1"
"Clarke","2020-04-10","36","1108","6","126","5.8","6.1"
"Clarke","2020-04-11","9","1117","2","128","7.4","7.7"
"Clarke","2020-04-12","1","1118","0","128","7.4","7.7"
"Clarke","2020-04-13","57","1175","2","130","7.9","7.6"
"Clarke","2020-04-14","38","1213","5","135","9","7.5"
"Clarke","2020-04-15","54","1267","3","138","9.2","7"
"Clarke","2020-04-16","110","1377","4","142","9.2","6.7"
"Clarke","2020-04-17","102","1479","10","152","8.3","7"
"Clarke","2020-04-18","25","1504","1","153","5.7","6.5"
"Clarke","2020-04-19","12","1516","1","154","6.9","7.1"
"Clarke","2020-04-20","84","1600","12","166","8.4","8.1"
"Clarke","2020-04-21","115","1715","8","174","7.5","8.3"
"Clarke","2020-04-22","175","1890","16","190","8","8.6"
"Clarke","2020-04-23","32","1922","1","191","7.9","8.6"
"Clarke","2020-04-24","101","2023","4","195","7.1","7.7"
"Clarke","2020-04-25","92","2115","4","199","7.2","6.4"
"Clarke","2020-04-26","10","2125","3","202","10.3","8.6"
"Clarke","2020-04-27","112","2237","16","218","10.3","9.3"
"Clarke","2020-04-28","187","2424","8","226","9.9","8.7"
"Clarke","2020-04-29","122","2546","4","230","9","8.5"
"Clarke","2020-04-30","111","2657","3","233","9","8.5"
"Clarke","2020-05-01","55","2712","1","234","8.7","7.9"
"Clarke","2020-05-02","61","2773","5","239","9.2","8.2"
"Clarke","2020-05-03","25","2798","3","242","6.7","8.5"
"Clarke","2020-05-04","102","2900","2","244","4.9","7.6"
"Clarke","2020-05-05","98","2998","1","245","4.4","7.2"
"Clarke","2020-05-06","89","3087","1","246","4.1","6.6"
"Clarke","2020-05-07","170","3257","3","249","4","6.5"
"Clarke","2020-05-08","115","3372","2","251","4","6.3"
"Clarke","2020-05-09","129","3501","3","254","3.1","6.2"
"Clarke","2020-05-10","40","3541","2","256","2.1","4.4"
"Clarke","2020-05-11","266","3807","2","258","2","3.4"
"Clarke","2020-05-12","271","4078","5","263","2.1","3.3"
"Clarke","2020-05-13","229","4307","4","267","2.2","3.1"
"Clarke","2020-05-14","213","4520","11","278","2.7","3.3"
"Clarke","2020-05-15","434","4954","10","288","2.7","3.4"
"Clarke","2020-05-16","60","5014","2","290","2.9","3"
"Clarke","2020-05-17","50","5064","0","290","2.2","2.1"
"Clarke","2020-05-18","160","5224","3","293","2.3","2.1"
"Clarke","2020-05-19","338","5562","10","303","2.5","2.3"
"Clarke","2020-05-20","211","5773","8","311","2.8","2.5"
"Clarke","2020-05-21","255","6028","25","336","3.4","3"
"Clarke","2020-05-22","132","6160","10","346","4.2","3.5"
"Clarke","2020-05-23","122","6282","25","371","6.6","4.8"
"Clarke","2020-05-24","42","6324","2","373","7.3","4.7"
"Clarke","2020-05-25","66","6390","11","384","9.4","5.9"
"Clarke","2020-05-26","312","6702","28","412","10.3","6.4"
"Clarke","2020-05-27","249","6951","7","419","10.2","6.5"
"Clarke","2020-05-28","342","7293","7","426","9","6.2"
"Clarke","2020-05-29","244","7537","12","438","8.7","6.4"
"Clarke","2020-05-30","96","7633","5","443","6.5","6.6"
"Clarke","2020-05-31","40","7673","2","445","6.5","6.9"
"Clarke","2020-06-01","256","7929","17","462","5.1","7.3"
"Clarke","2020-06-02","336","8265","14","476","4.4","7.3"
"Clarke","2020-06-03","311","8576","12","488","4.5","7.4"
"Clarke","2020-06-04","328","8904","8","496","4.6","6.8"
"Clarke","2020-06-05","318","9222","6","502","4.2","6.4"
"Clarke","2020-06-06","202","9424","2","504","3.6","5"
"Clarke","2020-06-07","50","9474","2","506","3.4","5"
"Clarke","2020-06-08","327","9801","8","514","2.8","4"
"Clarke","2020-06-09","340","10141","11","525","2.7","3.5"
"Clarke","2020-06-10","325","10466","7","532","2.5","3.5"
"Clarke","2020-06-11","322","10788","14","546","2.7","3.7"
"Clarke","2020-06-12","261","11049","5","551","2.7","3.4"
"Clarke","2020-06-13","107","11156","1","552","2.7","3.1"
"Clarke","2020-06-14","69","11225","3","555","2.8","3.1"
"Clarke","2020-06-15","321","11546","18","573","3.2","3"
"Clarke","2020-06-16","330","11876","8","581","3.1","2.9"
"Clarke","2020-06-17","349","12225","19","600","3.6","3"
"Clarke","2020-06-18","343","12568","17","617","3.7","3.2"
"Clarke","2020-06-19","340","12908","28","645","4.6","3.6"
"Clarke","2020-06-20","107","13015","9","654","5.6","4.2"
"Clarke","2020-06-21","55","13070","5","659","6.3","4.5"
"Clarke","2020-06-22","400","13470","41","700","7","5.1"
"Clarke","2020-06-23","384","13854","34","734","7.9","5.5"
"Clarke","2020-06-24","468","14322","51","785","8.7","6.1"
"Clarke","2020-06-25","551","14873","54","839","9.4","6.5"
"Clarke","2020-06-26","518","15391","54","893","9.7","7.1"
"Clarke","2020-06-27","161","15552","27","920","10.9","8.3"
"Clarke","2020-06-28","107","15659","10","930","10.9","8.6"
"Clarke","2020-06-29","617","16276","49","979","10.6","8.8"
"Clarke","2020-06-30","551","16827","65","1044","11","9.4"
"Clarke","2020-07-01","614","17441","63","1107","10.9","9.8"
"Clarke","2020-07-02","559","18000","57","1164","11","10.2"
"Clarke","2020-07-03","255","18255","29","1193","11.1","10.4"
"Clarke","2020-07-04","34","18289","6","1199","11.2","11"
"Clarke","2020-07-05","106","18395","10","1209","11.2","11.1"
"Clarke","2020-07-06","612","19007","90","1299","12.2","11.4"
"Clarke","2020-07-07","649","19656","80","1379","12.3","11.6"
"Clarke","2020-07-08","661","20317","59","1438","12.1","11.5"
"Clarke","2020-07-09","702","21019","76","1514","12.2","11.6"
"Clarke","2020-07-10","741","21760","77","1591","12","11.6"
"Clarke","2020-07-11","152","21912","32","1623","12.5","11.9"
"Clarke","2020-07-12","75","21987","9","1632","12.9","12.1"
"Clarke","2020-07-13","706","22693","66","1698","12.1","12.2"
"Clarke","2020-07-14","729","23422","77","1775","11.9","12.1"
"Clarke","2020-07-15","763","24185","74","1849","12","12"
"Clarke","2020-07-16","665","24850","63","1912","11.8","12"
"Clarke","2020-07-17","617","25467","59","1971","11.7","11.9"
"Clarke","2020-07-18","191","25658","16","1987","9.9","11.2"
"Clarke","2020-07-19","100","25758","17","2004","10.6","11.7"
"Clarke","2020-07-20","724","26482","61","2065","10.4","11.3"
"Clarke","2020-07-21","586","27068","57","2122","10.3","11.1"
"Clarke","2020-07-22","625","27693","57","2179","10.2","11.1"
"Clarke","2020-07-23","658","28351","58","2237","10.1","11"
"Clarke","2020-07-24","693","29044","54","2291","9.9","10.8"
"Clarke","2020-07-25","265","29309","31","2322","10.4","10.1"
"Clarke","2020-07-26","110","29419","14","2336","9.8","10.2"
"Clarke","2020-07-27","604","30023","58","2394","9.9","10.2"
"Clarke","2020-07-28","566","30589","60","2454","10.1","10.2"
"Clarke","2020-07-29","535","31124","57","2511","10.3","10.3"
"Clarke","2020-07-30","534","31658","31","2542","9.8","10"
"Clarke","2020-07-31","496","32154","42","2584","9.9","9.9"
"Clarke","2020-08-01","160","32314","16","2600","9.7","10"
"Clarke","2020-08-02","96","32410","17","2617","10.4","10.1"
"Clarke","2020-08-03","451","32861","50","2667","10.6","10.3"
"Clarke","2020-08-04","495","33356","57","2724","10.7","10.4"
"Clarke","2020-08-05","412","33768","41","2765","10.6","10.5"
"Clarke","2020-08-06","425","34193","32","2797","10.9","10.4"
"Clarke","2020-08-07","450","34643","31","2828","10.7","10.3"
"Clarke","2020-08-08","174","34817","22","2850","11","10.4"
"Clarke","2020-08-09","76","34893","10","2860","10.4","10.4"
"Clarke","2020-08-10","587","35480","46","2906","9.9","10.3"
"Clarke","2020-08-11","627","36107","32","2938","9","9.9"
"Clarke","2020-08-12","538","36645","47","2985","8.8","9.7"
"Clarke","2020-08-13","531","37176","51","3036","9.1","10"
"Clarke","2020-08-14","546","37722","32","3068","9","9.8"
"Clarke","2020-08-15","120","37842","13","3081","8.7","9.9"
"Clarke","2020-08-16","57","37899","7","3088","8.6","9.5"
"Clarke","2020-08-17","641","38540","38","3126","8.3","9.1"
"Clarke","2020-08-18","778","39318","55","3181","8.6","8.8"
"Clarke","2020-08-19","784","40102","53","3234","8.3","8.6"
"Clarke","2020-08-20","640","40742","52","3286","8.1","8.6"
"Clarke","2020-08-21","872","41614","59","3345","8.3","8.6"
"Clarke","2020-08-22","169","41783","25","3370","8.8","8.8"
"Clarke","2020-08-23","59","41842","8","3378","9","8.8"
"Clarke","2020-08-24","865","42707","86","3464","9.6","9"
"Clarke","2020-08-25","763","43470","49","3513","9.5","9"
"Clarke","2020-08-26","809","44279","74","3587","9.8","9.1"
"Clarke","2020-08-27","764","45043","109","3696","10.7","9.4"
"Clarke","2020-08-28","927","45970","154","3850","12.1","10.2"
"Clarke","2020-08-29","308","46278","26","3876","11.2","10"
"Clarke","2020-08-30","103","46381","25","3901","12.7","10.9"
"Clarke","2020-08-31","880","47261","150","4051","13.7","11.7"
"Clarke","2020-09-01","920","48181","182","4233","15.7","12.6"
"Clarke","2020-09-02","993","49174","182","4415","17","13.4"
"Clarke","2020-09-03","907","50081","136","4551","17.1","13.9"
"Clarke","2020-09-04","867","50948","101","4652","16.4","14.2"
"Clarke","2020-09-05","293","51241","26","4678","16.4","13.8"
"Clarke","2020-09-06","95","51336","18","4696","15.7","14.2"
"Clarke","2020-09-07","166","51502","25","4721","15.4","14.6"
"Clarke","2020-09-08","1003","52505","106","4827","14.1","14.9"
"Clarke","2020-09-09","833","53338","95","4922","13.1","15"
"Clarke","2020-09-10","840","54178","97","5019","12.6","14.8"
"Clarke","2020-09-11","892","55070","71","5090","12.1","14.2"
"Clarke","2020-09-12","235","55305","27","5117","12.4","14.4"
"Clarke","2020-09-13","79","55384","10","5127","11.5","13.6"
"Clarke","2020-09-14","764","56148","58","5185","10.5","12.9"
"Clarke","2020-09-15","801","56949","63","5248","10.1","12.1"
"Clarke","2020-09-16","706","57655","35","5283","9.2","11.1"
"Clarke","2020-09-17","645","58300","30","5313","8.2","10.4"
"Clarke","2020-09-18","624","58924","34","5347","7.8","9.9"
"Clarke","2020-09-19","325","59249","10","5357","6.6","9.5"
"Clarke","2020-09-20","78","59327","5","5362","5.7","8.6"
"Clarke","2020-09-21","578","59905","35","5397","5.5","8"
"Clarke","2020-09-22","526","60431","20","5417","4.9","7.5"
"Clarke","2020-09-23","628","61059","24","5441","4.8","7"
"Clarke","2020-09-24","494","61553","22","5463","4.7","6.4"
"Clarke","2020-09-25","489","62042","23","5486","4.6","6.2"
"Clarke","2020-09-26","136","62178","8","5494","5","5.8"
"Clarke","2020-09-27","60","62238","3","5497","4.8","5.3"
"Clarke","2020-09-28","494","62732","15","5512","4.4","4.9"
"Clarke","2020-09-29","495","63227","18","5530","4.4","4.6"
"Clarke","2020-09-30","535","63762","23","5553","4.4","4.6"
"Clarke","2020-10-01","425","64187","11","5564","4.2","4.4"
"Clarke","2020-10-02","461","64648","13","5577","3.9","4.3"
"Clarke","2020-10-03","131","64779","11","5588","4.3","4.6"
"Clarke","2020-10-04","73","64852","7","5595","4.9","4.9"
"Clarke","2020-10-05","640","65492","31","5626","5.2","4.8"
"Clarke","2020-10-06","639","66131","24","5650","5.2","4.8"
"Clarke","2020-10-07","754","66885","35","5685","5.2","4.8"
"Clarke","2020-10-08","552","67437","21","5706","5.4","4.8"
"Clarke","2020-10-09","560","67997","21","5727","5.5","4.7"
"Clarke","2020-10-10","131","68128","9","5736","5.3","4.8"
"Clarke","2020-10-11","77","68205","11","5747","6","5.5"
"Clarke","2020-10-12","530","68735","27","5774","6","5.6"
"Clarke","2020-10-13","612","69347","28","5802","6.1","5.7"
"Clarke","2020-10-14","628","69975","25","5827","6.1","5.6"
"Clarke","2020-10-15","536","70511","17","5844","6","5.7"
"Clarke","2020-10-16","532","71043","16","5860","5.9","5.7"
"Clarke","2020-10-17","157","71200","6","5866","5.4","5.4"
"Clarke","2020-10-18","55","71255","7","5873","5.2","5.6"
"Clarke","2020-10-19","625","71880","25","5898","5","5.5"
"Clarke","2020-10-20","575","72455","18","5916","4.8","5.5"
"Clarke","2020-10-21","582","73037","25","5941","4.9","5.5"
"Clarke","2020-10-22","528","73565","20","5961","5","5.5"
"Clarke","2020-10-23","434","73999","24","5985","5.3","5.6"
"Clarke","2020-10-24","175","74174","11","5996","5.7","5.5"
"Clarke","2020-10-25","63","74237","7","6003","5.4","5.3"
"Clarke","2020-10-26","615","74852","24","6027","5.4","5.2"
"Clarke","2020-10-27","618","75470","26","6053","5.6","5.2"
"Clarke","2020-10-28","625","76095","35","6088","5.8","5.3"
"Clarke","2020-10-29","584","76679","20","6108","5.7","5.3"
"Clarke","2020-10-30","500","77179","22","6130","5.6","5.4"
"Clarke","2020-10-31","134","77313","15","6145","6.3","6"
"Clarke","2020-11-01","64","77377","3","6148","5.3","5.4"
"Clarke","2020-11-02","628","78005","31","6179","5.5","5.5"
"Clarke","2020-11-03","952","78957","39","6218","5.5","5.5"
"Clarke","2020-11-04","558","79515","28","6246","5.4","5.6"
"Clarke","2020-11-05","635","80150","30","6276","5.6","5.7"
"Clarke","2020-11-06","588","80738","24","6300","5.5","5.5"
"Clarke","2020-11-07","145","80883","7","6307","4.6","5.4"
"Clarke","2020-11-08","102","80985","9","6316","5.2","5.3"
"Clarke","2020-11-09","709","81694","38","6354","5.3","5.4"
"Clarke","2020-11-10","715","82409","41","6395","5.5","5.5"
"Clarke","2020-11-11","631","83040","30","6425","5.5","5.4"
"Clarke","2020-11-12","639","83679","31","6456","5.5","5.5"
"Clarke","2020-11-13","528","84207","31","6487","5.7","5.6"
"Clarke","2020-11-14","165","84372","18","6505","6.6","5.6"
"Clarke","2020-11-15","122","84494","11","6516","6.6","5.9"
"Clarke","2020-11-16","839","85333","35","6551","6.5","5.9"
"Clarke","2020-11-17","917","86250","27","6578","6.1","5.8"
"Clarke","2020-11-18","1053","87303","26","6604","5.7","5.6"
"Clarke","2020-11-19","1302","88605","29","6633","5.4","5.4"
"Clarke","2020-11-20","1513","90118","37","6670","4.9","5.3"
"Clarke","2020-11-21","254","90372","20","6690","4.4","5.5"
"Clarke","2020-11-22","190","90562","20","6710","4.7","5.7"
"Clarke","2020-11-23","1381","91943","32","6742","4.4","5.4"
"Clarke","2020-11-24","1076","93019","31","6773","4.4","5.2"
"Clarke","2020-11-25","368","93387","27","6800","5.1","5.4"
"Clarke","2020-11-26","49","93436","9","6809","7.4","6.4"
"Clarke","2020-11-27","306","93742","37","6846","8.8","6.8"
"Clarke","2020-11-28","235","93977","27","6873","9.3","6.9"
"Clarke","2020-11-29","158","94135","24","6897","10","7.3"
"Clarke","2020-11-30","718","94853","99","6996","11.6","8"
"Clarke","2020-12-01","874","95727","61","7057","12.2","8.3"
"Clarke","2020-12-02","884","96611","60","7117","12.1","8.6"
"Clarke","2020-12-03","813","97424","65","7182","10.6","9"
"Clarke","2020-12-04","850","98274","56","7238","9.8","9.3"
"Clarke","2020-12-05","262","98536","21","7259","9.3","9.3"
"Clarke","2020-12-06","197","98733","32","7291","9.5","9.7"
"Clarke","2020-12-07","854","99587","92","7383","9.1","10.3"
"Clarke","2020-12-08","838","100425","59","7442","9.1","10.6"
"Clarke","2020-12-09","734","101159","69","7511","9.4","10.8"
"Clarke","2020-12-10","803","101962","63","7574","9.4","10"
"Clarke","2020-12-11","881","102843","62","7636","9.5","9.7"
"Clarke","2020-12-12","205","103048","37","7673","10.9","10.1"
"Clarke","2020-12-13","144","103192","29","7702","11.5","10.5"
"Clarke","2020-12-14","862","104054","54","7756","10.8","9.9"
"Clarke","2020-12-15","859","104913","60","7816","10.8","9.9"
"Clarke","2020-12-16","947","105860","82","7898","10.7","10.1"
"Clarke","2020-12-17","932","106792","83","7981","10.9","10.1"
"Clarke","2020-12-18","1015","107807","79","8060","11","10.2"
"Clarke","2020-12-19","252","108059","35","8095","10.4","10.6"
"Clarke","2020-12-20","203","108262","30","8125","9.6","10.5"
"Clarke","2020-12-21","1007","109269","92","8217","10","10.4"
"Clarke","2020-12-22","868","110137","85","8302","10.4","10.6"
"Clarke","2020-12-23","815","110952","78","8380","10.6","10.6"
"Clarke","2020-12-24","299","111251","54","8434","11.9","11.4"
"Clarke","2020-12-25","51","111302","14","8448","14.7","12.8"
"Clarke","2020-12-26","361","111663","65","8513","15.3","12.8"
"Clarke","2020-12-27","215","111878","36","8549","15.5","12.6"
"Clarke","2020-12-28","642","112520","130","8679","17.1","13.6"
"Clarke","2020-12-29","623","113143","125","8804","18.6","14.5"
"Clarke","2020-12-30","639","113782","122","8926","20","15.3"
"Clarke","2020-12-31","531","114313","91","9017","19.8","15.8"
"Clarke","2021-01-01","130","114443","40","9057","20.3","17.5"
"Clarke","2021-01-02","163","114606","45","9102","21.7","18.5"
"Clarke","2021-01-03","192","114798","41","9143","22.3","18.9"
"Clarke","2021-01-04","1213","116011","130","9273","21","19"
"Clarke","2021-01-05","1122","117133","180","9453","20.4","19.5"
"Clarke","2021-01-06","1341","118474","178","9631","19.6","19.8"
"Clarke","2021-01-07","939","119413","147","9778","19.3","19.6"
"Clarke","2021-01-08","741","120154","109","9887","17.1","18.7"
"Clarke","2021-01-09","238","120392","81","9968","18","19.8"
"Clarke","2021-01-10","217","120609","55","10023","18.5","20.4"
"Clarke","2021-01-11","1076","121685","131","10154","18.7","19.9"
"Clarke","2021-01-12","971","122656","119","10273","18.2","19.3"
"Clarke","2021-01-13","974","123630","94","10367","17.7","18.6"
"Clarke","2021-01-14","715","124345","86","10453","17.2","18.3"
"Clarke","2021-01-15","663","125008","68","10521","16.5","16.8"
"Clarke","2021-01-16","205","125213","47","10568","14.9","16.5"
"Clarke","2021-01-17","188","125401","39","10607","14.3","16.4"
"Clarke","2021-01-18","419","125820","87","10694","15.5","17.1"
"Clarke","2021-01-19","1147","126967","109","10803","15.1","16.7"
"Clarke","2021-01-20","977","127944","101","10904","15.2","16.5"
"Clarke","2021-01-21","647","128591","85","10989","15.4","16.3"
"Clarke","2021-01-22","677","129268","61","11050","15.2","15.9"
"Clarke","2021-01-23","180","129448","44","11094","15.4","15.2"
"Clarke","2021-01-24","199","129647","59","11153","16.7","15.5"
"Clarke","2021-01-25","732","130379","71","11224","15.1","15.3"
"Clarke","2021-01-26","995","131374","97","11321","15.1","15.1"
"Clarke","2021-01-27","843","132217","68","11389","14.8","15"
"Clarke","2021-01-28","725","132942","74","11463","14.4","14.9"
"Clarke","2021-01-29","569","133511","54","11517","14.5","14.8"
"Clarke","2021-01-30","149","133660","20","11537","12.9","14.2"
"Clarke","2021-01-31","164","133824","32","11569","11.4","14.1"
"Clarke","2021-02-01","879","134703","55","11624","11","13"
"Clarke","2021-02-02","755","135458","49","11673","10.5","12.8"
"Clarke","2021-02-03","768","136226","59","11732","10.4","12.6"
"Clarke","2021-02-04","558","136784","46","11778","10.2","12.3"
"Clarke","2021-02-05","180","136964","31","11809","11.3","12.9"
"Clarke","2021-02-06","46","137010","12","11821","13.1","13"
"Clarke","2021-02-07","20","137030","0","11821","10.3","10.9"
"Clarke","2021-02-08","0","137030","0","11821","9.4","10.2"
"Clay","2020-02-01","0","0","0","0",".","."
"Clay","2020-02-02","0","0","0","0",".","."
"Clay","2020-02-03","0","0","0","0",".","."
"Clay","2020-02-04","0","0","0","0",".","."
"Clay","2020-02-05","0","0","0","0",".","."
"Clay","2020-02-06","0","0","0","0",".","."
"Clay","2020-02-07","0","0","0","0","0","."
"Clay","2020-02-08","0","0","0","0","0","."
"Clay","2020-02-09","0","0","0","0","0","."
"Clay","2020-02-10","0","0","0","0","0","."
"Clay","2020-02-11","0","0","0","0","0","."
"Clay","2020-02-12","0","0","0","0","0","."
"Clay","2020-02-13","0","0","0","0","0","."
"Clay","2020-02-14","0","0","0","0","0","0"
"Clay","2020-02-15","0","0","0","0","0","0"
"Clay","2020-02-16","0","0","0","0","0","0"
"Clay","2020-02-17","0","0","0","0","0","0"
"Clay","2020-02-18","0","0","0","0","0","0"
"Clay","2020-02-19","0","0","0","0","0","0"
"Clay","2020-02-20","0","0","0","0","0","0"
"Clay","2020-02-21","0","0","0","0","0","0"
"Clay","2020-02-22","0","0","0","0","0","0"
"Clay","2020-02-23","0","0","0","0","0","0"
"Clay","2020-02-24","0","0","0","0","0","0"
"Clay","2020-02-25","0","0","0","0","0","0"
"Clay","2020-02-26","0","0","0","0","0","0"
"Clay","2020-02-27","0","0","0","0","0","0"
"Clay","2020-02-28","0","0","0","0","0","0"
"Clay","2020-02-29","0","0","0","0","0","0"
"Clay","2020-03-01","0","0","0","0","0","0"
"Clay","2020-03-02","0","0","0","0","0","0"
"Clay","2020-03-03","0","0","0","0","0","0"
"Clay","2020-03-04","0","0","0","0","0","0"
"Clay","2020-03-05","0","0","0","0","0","0"
"Clay","2020-03-06","0","0","0","0","0","0"
"Clay","2020-03-07","0","0","0","0","0","0"
"Clay","2020-03-08","0","0","0","0","0","0"
"Clay","2020-03-09","0","0","0","0","0","0"
"Clay","2020-03-10","0","0","0","0","0","0"
"Clay","2020-03-11","0","0","0","0","0","0"
"Clay","2020-03-12","0","0","0","0","0","0"
"Clay","2020-03-13","2","2","0","0","0","0"
"Clay","2020-03-14","0","2","0","0","0","0"
"Clay","2020-03-15","0","2","0","0","0","0"
"Clay","2020-03-16","1","3","0","0","0","0"
"Clay","2020-03-17","0","3","0","0","0","0"
"Clay","2020-03-18","1","4","0","0","0","0"
"Clay","2020-03-19","1","5","0","0","0","0"
"Clay","2020-03-20","0","5","0","0","0","0"
"Clay","2020-03-21","0","5","0","0","0","0"
"Clay","2020-03-22","0","5","0","0","0","0"
"Clay","2020-03-23","2","7","2","2","14.3","7.1"
"Clay","2020-03-24","0","7","0","2","14.3","7.1"
"Clay","2020-03-25","2","9","0","2","14.3","7.1"
"Clay","2020-03-26","2","11","1","3","21.4","10.7"
"Clay","2020-03-27","3","14","1","4","26.2","13.1"
"Clay","2020-03-28","2","16","0","4","26.2","13.1"
"Clay","2020-03-29","0","16","0","4","26.2","13.1"
"Clay","2020-03-30","1","17","1","5","26.2","20.2"
"Clay","2020-03-31","2","19","2","7","40.5","27.4"
"Clay","2020-04-01","0","19","0","7","40.5","27.4"
"Clay","2020-04-02","0","19","0","7","33.3","27.4"
"Clay","2020-04-03","1","20","0","7","28.6","27.4"
"Clay","2020-04-04","0","20","0","7","28.6","27.4"
"Clay","2020-04-05","2","22","2","9","42.9","34.5"
"Clay","2020-04-06","0","22","0","9","28.6","27.4"
"Clay","2020-04-07","1","23","1","10","28.6","34.5"
"Clay","2020-04-08","1","24","0","10","28.6","34.5"
"Clay","2020-04-09","1","25","0","10","28.6","31"
"Clay","2020-04-10","1","26","0","10","28.6","28.6"
"Clay","2020-04-11","2","28","1","11","35.7","32.1"
"Clay","2020-04-12","0","28","0","11","21.4","32.1"
"Clay","2020-04-13","2","30","1","12","28.6","28.6"
"Clay","2020-04-14","2","32","1","13","21.4","25"
"Clay","2020-04-15","3","35","0","13","21.4","25"
"Clay","2020-04-16","1","36","0","13","21.4","25"
"Clay","2020-04-17","4","40","1","14","25","26.8"
"Clay","2020-04-18","0","40","0","14","17.9","26.8"
"Clay","2020-04-19","0","40","0","14","17.9","19.6"
"Clay","2020-04-20","3","43","0","14","10.7","19.6"
"Clay","2020-04-21","1","44","1","15","17.9","19.6"
"Clay","2020-04-22","1","45","0","15","17.9","19.6"
"Clay","2020-04-23","1","46","0","15","17.9","19.6"
"Clay","2020-04-24","1","47","0","15","14.3","19.6"
"Clay","2020-04-25","1","48","0","15","14.3","16.1"
"Clay","2020-04-26","0","48","0","15","14.3","16.1"
"Clay","2020-04-27","2","50","0","15","14.3","12.5"
"Clay","2020-04-28","0","50","0","15","0","8.9"
"Clay","2020-04-29","7","57","3","18","6.1","12"
"Clay","2020-04-30","3","60","1","19","10.9","14.4"
"Clay","2020-05-01","2","62","0","19","10.9","12.6"
"Clay","2020-05-02","0","62","0","19","10.9","12.6"
"Clay","2020-05-03","0","62","0","19","10.9","12.6"
"Clay","2020-05-04","6","68","1","20","13.3","13.8"
"Clay","2020-05-05","0","68","0","20","13.3","6.6"
"Clay","2020-05-06","6","74","0","20","7.1","6.6"
"Clay","2020-05-07","1","75","0","20","2.4","6.6"
"Clay","2020-05-08","2","77","1","21","9.5","10.2"
"Clay","2020-05-09","1","78","0","21","9.5","10.2"
"Clay","2020-05-10","0","78","0","21","9.5","10.2"
"Clay","2020-05-11","1","79","1","22","21.4","17.3"
"Clay","2020-05-12","2","81","0","22","21.4","17.3"
"Clay","2020-05-13","9","90","1","23","23","15.1"
"Clay","2020-05-14","3","93","1","24","27.8","15.1"
"Clay","2020-05-15","5","98","0","24","20.6","15.1"
"Clay","2020-05-16","1","99","0","24","20.6","15.1"
"Clay","2020-05-17","0","99","0","24","20.6","15.1"
"Clay","2020-05-18","5","104","2","26","12.1","16.7"
"Clay","2020-05-19","1","105","0","26","12.1","16.7"
"Clay","2020-05-20","15","120","3","29","13.3","18.2"
"Clay","2020-05-21","0","120","0","29","8.6","18.2"
"Clay","2020-05-22","3","123","2","31","18.1","19.4"
"Clay","2020-05-23","1","124","0","31","18.1","19.4"
"Clay","2020-05-24","1","125","1","32","32.4","26.5"
"Clay","2020-05-25","0","125","0","32","26.7","19.4"
"Clay","2020-05-26","5","130","2","34","32.4","22.2"
"Clay","2020-05-27","16","146","2","36","31.3","22.3"
"Clay","2020-05-28","3","149","0","36","31.3","19.9"
"Clay","2020-05-29","1","150","0","36","21.8","19.9"
"Clay","2020-05-30","1","151","0","36","21.8","19.9"
"Clay","2020-05-31","0","151","0","36","7.5","19.9"
"Clay","2020-06-01","1","152","0","36","7.5","17.1"
"Clay","2020-06-02","3","155","1","37","6.5","19.5"
"Clay","2020-06-03","7","162","3","40","10.9","21.1"
"Clay","2020-06-04","3","165","1","41","15.6","23.5"
"Clay","2020-06-05","4","169","0","41","15.6","18.7"
"Clay","2020-06-06","0","169","0","41","15.6","18.7"
"Clay","2020-06-07","4","173","0","41","15.6","11.6"
"Clay","2020-06-08","30","203","1","42","16.1","11.8"
"Clay","2020-06-09","0","203","0","42","11.4","9"
"Clay","2020-06-10","1","204","0","42","5.2","8.1"
"Clay","2020-06-11","4","208","2","44","7.6","11.6"
"Clay","2020-06-12","2","210","0","44","7.6","11.6"
"Clay","2020-06-13","0","210","0","44","7.6","11.6"
"Clay","2020-06-14","0","210","0","44","7.6","11.6"
"Clay","2020-06-15","1","211","0","44","7.1","11.6"
"Clay","2020-06-16","4","215","0","44","7.1","9.3"
"Clay","2020-06-17","1","216","0","44","7.1","6.2"
"Clay","2020-06-18","1","217","0","44","0","3.8"
"Clay","2020-06-19","2","219","0","44","0","3.8"
"Clay","2020-06-20","0","219","0","44","0","3.8"
"Clay","2020-06-21","0","219","0","44","0","3.8"
"Clay","2020-06-22","0","219","0","44","0","3.6"
"Clay","2020-06-23","0","219","0","44","0","3.6"
"Clay","2020-06-24","0","219","0","44","0","3.6"
"Clay","2020-06-25","0","219","0","44","0","0"
"Clay","2020-06-26","1","220","0","44","0","0"
"Clay","2020-06-27","0","220","0","44","0","0"
"Clay","2020-06-28","0","220","0","44","0","0"
"Clay","2020-06-29","0","220","0","44","0","0"
"Clay","2020-06-30","3","223","0","44","0","0"
"Clay","2020-07-01","1","224","0","44","0","0"
"Clay","2020-07-02","2","226","0","44","0","0"
"Clay","2020-07-03","0","226","0","44","0","0"
"Clay","2020-07-04","0","226","0","44","0","0"
"Clay","2020-07-05","1","227","1","45","14.3","7.1"
"Clay","2020-07-06","0","227","0","45","14.3","7.1"
"Clay","2020-07-07","3","230","1","46","19","9.5"
"Clay","2020-07-08","5","235","1","47","21.9","11"
"Clay","2020-07-09","1","236","0","47","21.9","11"
"Clay","2020-07-10","6","242","0","47","21.9","11"
"Clay","2020-07-11","1","243","0","47","21.9","11"
"Clay","2020-07-12","1","244","1","48","21.9","18.1"
"Clay","2020-07-13","0","244","0","48","21.9","18.1"
"Clay","2020-07-14","3","247","1","49","21.9","20.5"
"Clay","2020-07-15","1","248","0","49","19","20.5"
"Clay","2020-07-16","0","248","0","49","19","20.5"
"Clay","2020-07-17","1","249","1","50","33.3","27.6"
"Clay","2020-07-18","1","250","0","50","33.3","27.6"
"Clay","2020-07-19","2","252","1","51","26.2","24"
"Clay","2020-07-20","4","256","0","51","26.2","24"
"Clay","2020-07-21","1","257","0","51","21.4","21.7"
"Clay","2020-07-22","0","257","0","51","21.4","20.2"
"Clay","2020-07-23","2","259","0","51","21.4","20.2"
"Clay","2020-07-24","1","260","0","51","7.1","20.2"
"Clay","2020-07-25","0","260","0","51","7.1","20.2"
"Clay","2020-07-26","0","260","0","51","0","13.1"
"Clay","2020-07-27","3","263","0","51","0","13.1"
"Clay","2020-07-28","2","265","0","51","0","10.7"
"Clay","2020-07-29","0","265","0","51","0","10.7"
"Clay","2020-07-30","4","269","1","52","3.6","12.5"
"Clay","2020-07-31","4","273","3","55","14.3","10.7"
"Clay","2020-08-01","0","273","0","55","14.3","10.7"
"Clay","2020-08-02","0","273","0","55","14.3","7.1"
"Clay","2020-08-03","1","274","0","55","14.3","7.1"
"Clay","2020-08-04","2","276","0","55","14.3","7.1"
"Clay","2020-08-05","1","277","0","55","14.3","7.1"
"Clay","2020-08-06","2","279","0","55","10.7","7.1"
"Clay","2020-08-07","3","282","2","57","9.5","11.9"
"Clay","2020-08-08","1","283","0","57","9.5","11.9"
"Clay","2020-08-09","0","283","0","57","9.5","11.9"
"Clay","2020-08-10","1","284","0","57","9.5","11.9"
"Clay","2020-08-11","5","289","1","58","12.4","13.3"
"Clay","2020-08-12","2","291","0","58","12.4","13.3"
"Clay","2020-08-13","1","292","0","58","12.4","11.5"
"Clay","2020-08-14","3","295","1","59","7.6","8.6"
"Clay","2020-08-15","1","296","0","59","7.6","8.6"
"Clay","2020-08-16","0","296","0","59","7.6","8.6"
"Clay","2020-08-17","5","301","0","59","7.6","8.6"
"Clay","2020-08-18","1","302","0","59","4.8","8.6"
"Clay","2020-08-19","2","304","0","59","4.8","8.6"
"Clay","2020-08-20","1","305","1","60","19","15.7"
"Clay","2020-08-21","2","307","1","61","21.4","14.5"
"Clay","2020-08-22","1","308","1","62","35.7","21.7"
"Clay","2020-08-23","1","309","1","63","50","28.8"
"Clay","2020-08-24","2","311","0","63","50","28.8"
"Clay","2020-08-25","0","311","0","63","50","27.4"
"Clay","2020-08-26","0","311","0","63","50","27.4"
"Clay","2020-08-27","1","312","1","64","50","34.5"
"Clay","2020-08-28","2","314","0","64","42.9","32.1"
"Clay","2020-08-29","0","314","0","64","28.6","32.1"
"Clay","2020-08-30","0","314","0","64","14.3","32.1"
"Clay","2020-08-31","0","314","0","64","14.3","32.1"
"Clay","2020-09-01","3","317","0","64","14.3","32.1"
"Clay","2020-09-02","0","317","0","64","14.3","32.1"
"Clay","2020-09-03","2","319","0","64","0","25"
"Clay","2020-09-04","1","320","0","64","0","21.4"
"Clay","2020-09-05","0","320","0","64","0","14.3"
"Clay","2020-09-06","0","320","0","64","0","7.1"
"Clay","2020-09-07","0","320","0","64","0","7.1"
"Clay","2020-09-08","6","326","2","66","4.8","9.5"
"Clay","2020-09-09","2","328","0","66","4.8","9.5"
"Clay","2020-09-10","3","331","0","66","4.8","2.4"
"Clay","2020-09-11","4","335","0","66","4.8","2.4"
"Clay","2020-09-12","0","335","0","66","4.8","2.4"
"Clay","2020-09-13","0","335","0","66","4.8","2.4"
"Clay","2020-09-14","4","339","0","66","4.8","2.4"
"Clay","2020-09-15","2","341","0","66","0","2.4"
"Clay","2020-09-16","3","344","0","66","0","2.4"
"Clay","2020-09-17","2","346","0","66","0","2.4"
"Clay","2020-09-18","0","346","0","66","0","2.4"
"Clay","2020-09-19","1","347","0","66","0","2.4"
"Clay","2020-09-20","0","347","0","66","0","2.4"
"Clay","2020-09-21","3","350","0","66","0","2.4"
"Clay","2020-09-22","1","351","0","66","0","0"
"Clay","2020-09-23","0","351","0","66","0","0"
"Clay","2020-09-24","4","355","0","66","0","0"
"Clay","2020-09-25","2","357","1","67","7.1","3.6"
"Clay","2020-09-26","0","357","0","67","7.1","3.6"
"Clay","2020-09-27","0","357","0","67","7.1","3.6"
"Clay","2020-09-28","4","361","0","67","7.1","3.6"
"Clay","2020-09-29","1","362","0","67","7.1","3.6"
"Clay","2020-09-30","3","365","0","67","7.1","3.6"
"Clay","2020-10-01","3","368","1","68","11.9","6"
"Clay","2020-10-02","0","368","0","68","4.8","6"
"Clay","2020-10-03","1","369","0","68","4.8","6"
"Clay","2020-10-04","0","369","0","68","4.8","6"
"Clay","2020-10-05","3","372","0","68","4.8","6"
"Clay","2020-10-06","1","373","0","68","4.8","6"
"Clay","2020-10-07","0","373","0","68","4.8","6"
"Clay","2020-10-08","2","375","0","68","0","6"
"Clay","2020-10-09","1","376","0","68","0","2.4"
"Clay","2020-10-10","0","376","0","68","0","2.4"
"Clay","2020-10-11","0","376","0","68","0","2.4"
"Clay","2020-10-12","0","376","0","68","0","2.4"
"Clay","2020-10-13","3","379","0","68","0","2.4"
"Clay","2020-10-14","3","382","0","68","0","2.4"
"Clay","2020-10-15","1","383","0","68","0","0"
"Clay","2020-10-16","0","383","0","68","0","0"
"Clay","2020-10-17","1","384","0","68","0","0"
"Clay","2020-10-18","0","384","0","68","0","0"
"Clay","2020-10-19","5","389","0","68","0","0"
"Clay","2020-10-20","1","390","0","68","0","0"
"Clay","2020-10-21","1","391","0","68","0","0"
"Clay","2020-10-22","1","392","0","68","0","0"
"Clay","2020-10-23","0","392","0","68","0","0"
"Clay","2020-10-24","1","393","0","68","0","0"
"Clay","2020-10-25","0","393","0","68","0","0"
"Clay","2020-10-26","5","398","0","68","0","0"
"Clay","2020-10-27","4","402","0","68","0","0"
"Clay","2020-10-28","4","406","0","68","0","0"
"Clay","2020-10-29","1","407","0","68","0","0"
"Clay","2020-10-30","0","407","0","68","0","0"
"Clay","2020-10-31","0","407","0","68","0","0"
"Clay","2020-11-01","1","408","0","68","0","0"
"Clay","2020-11-02","3","411","0","68","0","0"
"Clay","2020-11-03","2","413","0","68","0","0"
"Clay","2020-11-04","2","415","0","68","0","0"
"Clay","2020-11-05","2","417","0","68","0","0"
"Clay","2020-11-06","0","417","0","68","0","0"
"Clay","2020-11-07","0","417","0","68","0","0"
"Clay","2020-11-08","0","417","0","68","0","0"
"Clay","2020-11-09","1","418","0","68","0","0"
"Clay","2020-11-10","4","422","0","68","0","0"
"Clay","2020-11-11","5","427","0","68","0","0"
"Clay","2020-11-12","2","429","0","68","0","0"
"Clay","2020-11-13","0","429","0","68","0","0"
"Clay","2020-11-14","0","429","0","68","0","0"
"Clay","2020-11-15","0","429","0","68","0","0"
"Clay","2020-11-16","7","436","0","68","0","0"
"Clay","2020-11-17","2","438","0","68","0","0"
"Clay","2020-11-18","0","438","0","68","0","0"
"Clay","2020-11-19","0","438","0","68","0","0"
"Clay","2020-11-20","2","440","0","68","0","0"
"Clay","2020-11-21","1","441","1","69","14.3","7.1"
"Clay","2020-11-22","1","442","0","69","14.3","7.1"
"Clay","2020-11-23","2","444","0","69","14.3","7.1"
"Clay","2020-11-24","4","448","0","69","14.3","7.1"
"Clay","2020-11-25","3","451","0","69","14.3","7.1"
"Clay","2020-11-26","0","451","0","69","14.3","7.1"
"Clay","2020-11-27","1","452","1","70","28.6","14.3"
"Clay","2020-11-28","0","452","0","70","14.3","14.3"
"Clay","2020-11-29","1","453","0","70","14.3","14.3"
"Clay","2020-11-30","5","458","0","70","14.3","14.3"
"Clay","2020-12-01","0","458","0","70","14.3","14.3"
"Clay","2020-12-02","1","459","0","70","14.3","14.3"
"Clay","2020-12-03","5","464","0","70","14.3","14.3"
"Clay","2020-12-04","3","467","1","71","4.8","16.7"
"Clay","2020-12-05","3","470","2","73","14.3","14.3"
"Clay","2020-12-06","0","470","0","73","14.3","14.3"
"Clay","2020-12-07","2","472","0","73","14.3","14.3"
"Clay","2020-12-08","6","478","3","76","21.4","17.9"
"Clay","2020-12-09","8","486","1","77","23.2","18.8"
"Clay","2020-12-10","3","489","0","77","23.2","18.8"
"Clay","2020-12-11","2","491","1","78","25.6","15.2"
"Clay","2020-12-12","0","491","0","78","16.1","15.2"
"Clay","2020-12-13","0","491","0","78","16.1","15.2"
"Clay","2020-12-14","7","498","1","79","18.1","16.2"
"Clay","2020-12-15","3","501","0","79","11","16.2"
"Clay","2020-12-16","1","502","0","79","9.2","16.2"
"Clay","2020-12-17","1","503","0","79","9.2","16.2"
"Clay","2020-12-18","1","504","0","79","2","13.8"
"Clay","2020-12-19","1","505","1","80","16.3","16.2"
"Clay","2020-12-20","1","506","1","81","30.6","23.3"
"Clay","2020-12-21","0","506","0","81","28.6","23.3"
"Clay","2020-12-22","8","514","4","85","35.7","23.3"
"Clay","2020-12-23","2","516","0","85","35.7","22.4"
"Clay","2020-12-24","0","516","0","85","35.7","22.4"
"Clay","2020-12-25","0","516","0","85","35.7","18.9"
"Clay","2020-12-26","1","517","0","85","21.4","18.9"
"Clay","2020-12-27","1","518","1","86","21.4","26"
"Clay","2020-12-28","3","521","2","88","31","29.8"
"Clay","2020-12-29","6","527","2","90","28.6","32.1"
"Clay","2020-12-30","5","532","0","90","28.6","32.1"
"Clay","2020-12-31","6","538","1","91","31","33.3"
"Clay","2021-01-01","0","538","0","91","31","33.3"
"Clay","2021-01-02","0","538","0","91","31","26.2"
"Clay","2021-01-03","1","539","0","91","16.7","19"
"Clay","2021-01-04","9","548","2","93","10.3","20.6"
"Clay","2021-01-05","7","555","3","96","11.7","20.1"
"Clay","2021-01-06","9","564","2","98","14.9","21.7"
"Clay","2021-01-07","6","570","1","99","14.9","22.9"
"Clay","2021-01-08","3","573","0","99","14.9","22.9"
"Clay","2021-01-09","1","574","0","99","14.9","22.9"
"Clay","2021-01-10","3","577","1","100","19.6","18.1"
"Clay","2021-01-11","4","581","0","100","16.4","13.4"
"Clay","2021-01-12","5","586","1","101","13.2","12.4"
"Clay","2021-01-13","2","588","1","102","17.1","16"
"Clay","2021-01-14","9","597","3","105","19.5","17.2"
"Clay","2021-01-15","9","606","1","106","21.1","18"
"Clay","2021-01-16","2","608","0","106","21.1","18"
"Clay","2021-01-17","0","608","0","106","16.3","18"
"Clay","2021-01-18","3","611","0","106","16.3","16.4"
"Clay","2021-01-19","6","617","2","108","18.3","15.7"
"Clay","2021-01-20","7","624","0","108","11.1","14.1"
"Clay","2021-01-21","11","635","1","109","7.6","13.6"
"Clay","2021-01-22","5","640","2","111","11.8","16.4"
"Clay","2021-01-23","3","643","0","111","11.8","16.4"
"Clay","2021-01-24","1","644","0","111","11.8","14.1"
"Clay","2021-01-25","8","652","0","111","11.8","14.1"
"Clay","2021-01-26","4","656","1","112","10.6","14.4"
"Clay","2021-01-27","1","657","0","112","10.6","10.8"
"Clay","2021-01-28","2","659","0","112","9.3","8.5"
"Clay","2021-01-29","4","663","0","112","3.6","7.7"
"Clay","2021-01-30","0","663","0","112","3.6","7.7"
"Clay","2021-01-31","0","663","0","112","3.6","7.7"
"Clay","2021-02-01","2","665","0","112","3.6","7.7"
"Clay","2021-02-02","10","675","3","115","4.3","7.4"
"Clay","2021-02-03","6","681","0","115","4.3","7.4"
"Clay","2021-02-04","4","685","1","116","7.9","8.6"
"Clay","2021-02-05","3","688","0","116","7.9","5.7"
"Clay","2021-02-06","0","688","0","116","7.9","5.7"
"Clay","2021-02-07","1","689","0","116","7.9","5.7"
"Clay","2021-02-08","0","689","0","116","7.9","5.7"
"Clayton","2020-02-01","0","0","0","0",".","."
"Clayton","2020-02-02","0","0","0","0",".","."
"Clayton","2020-02-03","0","0","0","0",".","."
"Clayton","2020-02-04","0","0","0","0",".","."
"Clayton","2020-02-05","0","0","0","0",".","."
"Clayton","2020-02-06","0","0","0","0",".","."
"Clayton","2020-02-07","0","0","0","0","0","."
"Clayton","2020-02-08","0","0","0","0","0","."
"Clayton","2020-02-09","0","0","0","0","0","."
"Clayton","2020-02-10","0","0","0","0","0","."
"Clayton","2020-02-11","0","0","0","0","0","."
"Clayton","2020-02-12","0","0","0","0","0","."
"Clayton","2020-02-13","0","0","0","0","0","."
"Clayton","2020-02-14","0","0","0","0","0","0"
"Clayton","2020-02-15","0","0","0","0","0","0"
"Clayton","2020-02-16","0","0","0","0","0","0"
"Clayton","2020-02-17","0","0","0","0","0","0"
"Clayton","2020-02-18","0","0","0","0","0","0"
"Clayton","2020-02-19","0","0","0","0","0","0"
"Clayton","2020-02-20","0","0","0","0","0","0"
"Clayton","2020-02-21","0","0","0","0","0","0"
"Clayton","2020-02-22","0","0","0","0","0","0"
"Clayton","2020-02-23","0","0","0","0","0","0"
"Clayton","2020-02-24","0","0","0","0","0","0"
"Clayton","2020-02-25","0","0","0","0","0","0"
"Clayton","2020-02-26","0","0","0","0","0","0"
"Clayton","2020-02-27","0","0","0","0","0","0"
"Clayton","2020-02-28","0","0","0","0","0","0"
"Clayton","2020-02-29","0","0","0","0","0","0"
"Clayton","2020-03-01","0","0","0","0","0","0"
"Clayton","2020-03-02","0","0","0","0","0","0"
"Clayton","2020-03-03","0","0","0","0","0","0"
"Clayton","2020-03-04","0","0","0","0","0","0"
"Clayton","2020-03-05","0","0","0","0","0","0"
"Clayton","2020-03-06","0","0","0","0","0","0"
"Clayton","2020-03-07","0","0","0","0","0","0"
"Clayton","2020-03-08","0","0","0","0","0","0"
"Clayton","2020-03-09","0","0","0","0","0","0"
"Clayton","2020-03-10","3","3","2","2","9.5","4.8"
"Clayton","2020-03-11","1","4","0","2","9.5","4.8"
"Clayton","2020-03-12","2","6","0","2","9.5","4.8"
"Clayton","2020-03-13","19","25","4","6","12.5","6.3"
"Clayton","2020-03-14","7","32","2","8","16.6","8.3"
"Clayton","2020-03-15","9","41","3","11","21.4","10.7"
"Clayton","2020-03-16","36","77","3","14","22.6","11.3"
"Clayton","2020-03-17","32","109","4","18","14.8","12.2"
"Clayton","2020-03-18","35","144","9","27","18.5","14"
"Clayton","2020-03-19","32","176","13","40","24.3","16.9"
"Clayton","2020-03-20","59","235","20","60","26.1","19.3"
"Clayton","2020-03-21","18","253","7","67","27.6","22.1"
"Clayton","2020-03-22","28","281","14","81","30","25.7"
"Clayton","2020-03-23","53","334","21","102","34.5","28.5"
"Clayton","2020-03-24","82","416","29","131","37.7","26.3"
"Clayton","2020-03-25","82","498","29","160","39.1","28.8"
"Clayton","2020-03-26","96","594","30","190","37.8","31"
"Clayton","2020-03-27","101","695","41","231","38.7","32.4"
"Clayton","2020-03-28","31","726","13","244","39.2","33.4"
"Clayton","2020-03-29","29","755","8","252","36","33"
"Clayton","2020-03-30","113","868","24","276","33.3","33.9"
"Clayton","2020-03-31","93","961","27","303","32.4","35.1"
"Clayton","2020-04-01","99","1060","36","339","32.6","35.8"
"Clayton","2020-04-02","91","1151","25","364","32","34.9"
"Clayton","2020-04-03","100","1251","17","381","28.7","33.7"
"Clayton","2020-04-04","21","1272","7","388","27.4","33.3"
"Clayton","2020-04-05","9","1281","3","391","28.3","32.1"
"Clayton","2020-04-06","111","1392","30","421","29.1","31.2"
"Clayton","2020-04-07","178","1570","22","443","26.7","29.6"
"Clayton","2020-04-08","122","1692","19","462","23.7","28.2"
"Clayton","2020-04-09","122","1814","22","484","22.4","27.2"
"Clayton","2020-04-10","251","2065","54","538","23","25.8"
"Clayton","2020-04-11","56","2121","5","543","19.5","23.5"
"Clayton","2020-04-12","23","2144","4","547","17.3","22.8"
"Clayton","2020-04-13","118","2262","7","554","14.2","21.7"
"Clayton","2020-04-14","153","2415","21","575","14.4","20.6"
"Clayton","2020-04-15","122","2537","16","591","14.1","18.9"
"Clayton","2020-04-16","119","2656","24","615","14.4","18.4"
"Clayton","2020-04-17","175","2831","16","631","12.6","17.8"
"Clayton","2020-04-18","84","2915","9","640","12.9","16.2"
"Clayton","2020-04-19","54","2969","5","645","11.7","14.5"
"Clayton","2020-04-20","220","3189","58","703","14.6","14.4"
"Clayton","2020-04-21","184","3373","12","715","13.6","14"
"Clayton","2020-04-22","188","3561","11","726","12.6","13.3"
"Clayton","2020-04-23","169","3730","18","744","11.2","12.8"
"Clayton","2020-04-24","224","3954","17","761","11","11.8"
"Clayton","2020-04-25","117","4071","13","774","11","12"
"Clayton","2020-04-26","61","4132","10","784","12.1","11.9"
"Clayton","2020-04-27","342","4474","112","896","13","13.8"
"Clayton","2020-04-28","263","4737","19","915","13.1","13.3"
"Clayton","2020-04-29","244","4981","12","927","12.9","12.8"
"Clayton","2020-04-30","244","5225","23","950","12.8","12"
"Clayton","2020-05-01","339","5564","53","1003","13.9","12.5"
"Clayton","2020-05-02","147","5711","11","1014","13.4","12.2"
"Clayton","2020-05-03","80","5791","5","1019","12","12"
"Clayton","2020-05-04","413","6204","20","1039","8","10.5"
"Clayton","2020-05-05","293","6497","34","1073","8.6","10.8"
"Clayton","2020-05-06","372","6869","12","1085","8.4","10.7"
"Clayton","2020-05-07","207","7076","22","1107","8.5","10.6"
"Clayton","2020-05-08","191","7267","18","1125","7.6","10.8"
"Clayton","2020-05-09","150","7417","15","1140","8","10.7"
"Clayton","2020-05-10","57","7474","5","1145","8.4","10.2"
"Clayton","2020-05-11","296","7770","17","1162","8.5","8.2"
"Clayton","2020-05-12","340","8110","10","1172","7.2","7.9"
"Clayton","2020-05-13","395","8505","33","1205","8","8.2"
"Clayton","2020-05-14","353","8858","9","1214","6.8","7.7"
"Clayton","2020-05-15","336","9194","21","1235","6.4","7"
"Clayton","2020-05-16","191","9385","27","1262","7","7.5"
"Clayton","2020-05-17","95","9480","7","1269","6.8","7.6"
"Clayton","2020-05-18","466","9946","17","1286","6.5","7.5"
"Clayton","2020-05-19","348","10294","44","1330","7.9","7.5"
"Clayton","2020-05-20","373","10667","21","1351","7.5","7.7"
"Clayton","2020-05-21","257","10924","15","1366","7.9","7.4"
"Clayton","2020-05-22","208","11132","12","1378","7.9","7.1"
"Clayton","2020-05-23","84","11216","6","1384","6.9","6.9"
"Clayton","2020-05-24","80","11296","5","1389","6.7","6.7"
"Clayton","2020-05-25","35","11331","1","1390","6.6","6.5"
"Clayton","2020-05-26","305","11636","26","1416","6","6.9"
"Clayton","2020-05-27","367","12003","22","1438","6.1","6.8"
"Clayton","2020-05-28","260","12263","20","1458","6.3","7.1"
"Clayton","2020-05-29","259","12522","21","1479","6.7","7.3"
"Clayton","2020-05-30","149","12671","14","1493","7","6.9"
"Clayton","2020-05-31","69","12740","6","1499","7.3","7"
"Clayton","2020-06-01","267","13007","13","1512","7.6","7.1"
"Clayton","2020-06-02","275","13282","34","1546","8.2","7.1"
"Clayton","2020-06-03","240","13522","13","1559","8.1","7.1"
"Clayton","2020-06-04","230","13752","11","1570","7.7","7"
"Clayton","2020-06-05","252","14004","27","1597","8","7.3"
"Clayton","2020-06-06","258","14262","10","1607","7.2","7.1"
"Clayton","2020-06-07","81","14343","7","1614","7.2","7.3"
"Clayton","2020-06-08","325","14668","27","1641","7.7","7.7"
"Clayton","2020-06-09","353","15021","19","1660","6.7","7.4"
"Clayton","2020-06-10","322","15343","22","1682","6.9","7.5"
"Clayton","2020-06-11","400","15743","31","1713","7.4","7.5"
"Clayton","2020-06-12","277","16020","28","1741","7.3","7.7"
"Clayton","2020-06-13","69","16089","7","1748","8.2","7.7"
"Clayton","2020-06-14","81","16170","12","1760","9","8.1"
"Clayton","2020-06-15","407","16577","66","1826","10.2","9"
"Clayton","2020-06-16","428","17005","34","1860","10.5","8.6"
"Clayton","2020-06-17","383","17388","56","1916","11.7","9.3"
"Clayton","2020-06-18","388","17776","61","1977","12.8","10.1"
"Clayton","2020-06-19","374","18150","60","2037","13.6","10.5"
"Clayton","2020-06-20","151","18301","37","2074","15.7","11.9"
"Clayton","2020-06-21","63","18364","8","2082","15.4","12.2"
"Clayton","2020-06-22","602","18966","102","2184","15.5","12.8"
"Clayton","2020-06-23","572","19538","106","2290","17","13.8"
"Clayton","2020-06-24","522","20060","93","2383","17.5","14.6"
"Clayton","2020-06-25","546","20606","105","2488","18","15.4"
"Clayton","2020-06-26","683","21289","109","2597","18","15.8"
"Clayton","2020-06-27","234","21523","62","2659","18.2","17"
"Clayton","2020-06-28","154","21677","44","2703","20.5","17.9"
"Clayton","2020-06-29","862","22539","168","2871","20.9","18.2"
"Clayton","2020-06-30","931","23470","139","3010","20.4","18.7"
"Clayton","2020-07-01","844","24314","155","3165","20.4","18.9"
"Clayton","2020-07-02","832","25146","129","3294","19.9","18.9"
"Clayton","2020-07-03","285","25431","67","3361","21","19.5"
"Clayton","2020-07-04","76","25507","17","3378","20.4","19.3"
"Clayton","2020-07-05","200","25707","37","3415","19","19.7"
"Clayton","2020-07-06","843","26550","213","3628","19.8","20.3"
"Clayton","2020-07-07","953","27503","219","3847","20.9","20.6"
"Clayton","2020-07-08","861","28364","158","4005","20.9","20.7"
"Clayton","2020-07-09","998","29362","199","4204","21.6","20.7"
"Clayton","2020-07-10","936","30298","178","4382","20.9","20.9"
"Clayton","2020-07-11","445","30743","95","4477","20.8","20.6"
"Clayton","2020-07-12","178","30921","27","4504","20.3","19.6"
"Clayton","2020-07-13","911","31832","206","4710","19.9","19.8"
"Clayton","2020-07-14","938","32770","217","4927","19.9","20.4"
"Clayton","2020-07-15","1037","33807","199","5126","20.1","20.5"
"Clayton","2020-07-16","917","34724","160","5286","19.7","20.6"
"Clayton","2020-07-17","856","35580","157","5443","19.6","20.3"
"Clayton","2020-07-18","433","36013","82","5525","19.3","20"
"Clayton","2020-07-19","205","36218","44","5569","20.2","20.2"
"Clayton","2020-07-20","919","37137","210","5779","20.2","20.1"
"Clayton","2020-07-21","677","37814","129","5908","19.6","19.8"
"Clayton","2020-07-22","964","38778","136","6044","18.9","19.5"
"Clayton","2020-07-23","903","39681","167","6211","19","19.4"
"Clayton","2020-07-24","991","40672","214","6425","19.5","19.6"
"Clayton","2020-07-25","457","41129","88","6513","19.5","19.4"
"Clayton","2020-07-26","139","41268","18","6531","18.3","19.2"
"Clayton","2020-07-27","940","42208","198","6729","18.1","19.1"
"Clayton","2020-07-28","696","42904","116","6845","17.7","18.7"
"Clayton","2020-07-29","885","43789","190","7035","18.8","18.8"
"Clayton","2020-07-30","750","44539","135","7170","18.7","18.9"
"Clayton","2020-07-31","954","45493","160","7330","18","18.8"
"Clayton","2020-08-01","219","45712","27","7357","17","18.3"
"Clayton","2020-08-02","125","45837","20","7377","17.5","17.9"
"Clayton","2020-08-03","855","46692","64","7441","15.5","16.8"
"Clayton","2020-08-04","864","47556","178","7619","16.1","16.9"
"Clayton","2020-08-05","865","48421","192","7811","16.2","17.5"
"Clayton","2020-08-06","807","49228","127","7938","15.9","17.3"
"Clayton","2020-08-07","887","50115","151","8089","15.9","17"
"Clayton","2020-08-08","1168","51283","50","8139","14.8","15.9"
"Clayton","2020-08-09","170","51453","21","8160","14.2","15.9"
"Clayton","2020-08-10","760","52213","122","8282","15.5","15.5"
"Clayton","2020-08-11","776","52989","80","8362","14","15"
"Clayton","2020-08-12","596","53585","61","8423","12.3","14.2"
"Clayton","2020-08-13","655","54240","71","8494","11.6","13.7"
"Clayton","2020-08-14","921","55161","98","8592","10.7","13.3"
"Clayton","2020-08-15","457","55618","42","8634","11.4","13.1"
"Clayton","2020-08-16","229","55847","25","8659","11.2","12.7"
"Clayton","2020-08-17","532","56379","61","8720","10.5","13"
"Clayton","2020-08-18","727","57106","70","8790","10.4","12.2"
"Clayton","2020-08-19","659","57765","70","8860","10.5","11.4"
"Clayton","2020-08-20","530","58295","49","8909","10.2","10.9"
"Clayton","2020-08-21","663","58958","75","8984","10.3","10.5"
"Clayton","2020-08-22","217","59175","9","8993","9.6","10.5"
"Clayton","2020-08-23","155","59330","14","9007","9.4","10.3"
"Clayton","2020-08-24","582","59912","65","9072","9.3","9.9"
"Clayton","2020-08-25","523","60435","42","9114","9.1","9.7"
"Clayton","2020-08-26","552","60987","46","9160","8.8","9.6"
"Clayton","2020-08-27","554","61541","46","9206","8.6","9.4"
"Clayton","2020-08-28","538","62079","42","9248","8.1","9.2"
"Clayton","2020-08-29","281","62360","22","9270","8.6","9.1"
"Clayton","2020-08-30","117","62477","11","9281","8.7","9"
"Clayton","2020-08-31","454","62931","45","9326","8.5","8.9"
"Clayton","2020-09-01","466","63397","21","9347","8","8.5"
"Clayton","2020-09-02","436","63833","35","9382","8","8.4"
"Clayton","2020-09-03","422","64255","24","9406","7.6","8.1"
"Clayton","2020-09-04","505","64760","41","9447","7.6","7.9"
"Clayton","2020-09-05","254","65014","11","9458","7.1","7.9"
"Clayton","2020-09-06","132","65146","5","9463","6.3","7.5"
"Clayton","2020-09-07","163","65309","14","9477","6.1","7.3"
"Clayton","2020-09-08","581","65890","42","9519","6.5","7.3"
"Clayton","2020-09-09","503","66393","45","9564","6.7","7.3"
"Clayton","2020-09-10","458","66851","26","9590","6.7","7.1"
"Clayton","2020-09-11","515","67366","36","9626","6.5","7.1"
"Clayton","2020-09-12","211","67577","12","9638","6.7","6.9"
"Clayton","2020-09-13","114","67691","13","9651","7.8","7.1"
"Clayton","2020-09-14","550","68241","44","9695","7.7","6.9"
"Clayton","2020-09-15","488","68729","27","9722","7.5","7"
"Clayton","2020-09-16","563","69292","22","9744","6.7","6.7"
"Clayton","2020-09-17","379","69671","14","9758","6.5","6.6"
"Clayton","2020-09-18","582","70253","29","9787","6.2","6.3"
"Clayton","2020-09-19","194","70447","17","9804","6.6","6.7"
"Clayton","2020-09-20","107","70554","7","9811","5.9","6.9"
"Clayton","2020-09-21","559","71113","30","9841","5.5","6.6"
"Clayton","2020-09-22","520","71633","30","9871","5.6","6.5"
"Clayton","2020-09-23","526","72159","33","9904","5.9","6.3"
"Clayton","2020-09-24","499","72658","20","9924","6","6.2"
"Clayton","2020-09-25","519","73177","30","9954","6.1","6.1"
"Clayton","2020-09-26","179","73356","23","9977","6.7","6.6"
"Clayton","2020-09-27","137","73493","8","9985","6.6","6.2"
"Clayton","2020-09-28","622","74115","60","10045","7.2","6.4"
"Clayton","2020-09-29","485","74600","24","10069","7","6.3"
"Clayton","2020-09-30","563","75163","29","10098","6.9","6.4"
"Clayton","2020-10-01","502","75665","26","10124","7.1","6.5"
"Clayton","2020-10-02","562","76227","36","10160","7.1","6.6"
"Clayton","2020-10-03","215","76442","17","10177","6.4","6.5"
"Clayton","2020-10-04","160","76602","16","10193","7","6.8"
"Clayton","2020-10-05","622","77224","41","10234","6.6","6.9"
"Clayton","2020-10-06","884","78108","41","10275","6.6","6.8"
"Clayton","2020-10-07","629","78737","34","10309","6.6","6.7"
"Clayton","2020-10-08","696","79433","39","10348","6.7","6.9"
"Clayton","2020-10-09","630","80063","58","10406","7.1","7.1"
"Clayton","2020-10-10","244","80307","18","10424","7","6.7"
"Clayton","2020-10-11","151","80458","13","10437","6.8","6.9"
"Clayton","2020-10-12","517","80975","37","10474","6.9","6.7"
"Clayton","2020-10-13","671","81646","47","10521","7.2","6.9"
"Clayton","2020-10-14","613","82259","34","10555","7.2","6.9"
"Clayton","2020-10-15","600","82859","36","10591","7.3","7"
"Clayton","2020-10-16","512","83371","35","10626","6.9","7"
"Clayton","2020-10-17","168","83539","12","10638","6.9","6.9"
"Clayton","2020-10-18","161","83700","17","10655","7.2","7"
"Clayton","2020-10-19","586","84286","57","10712","7.5","7.2"
"Clayton","2020-10-20","601","84887","46","10758","7.6","7.4"
"Clayton","2020-10-21","672","85559","47","10805","7.8","7.5"
"Clayton","2020-10-22","598","86157","43","10848","8","7.6"
"Clayton","2020-10-23","682","86839","71","10919","8.5","7.7"
"Clayton","2020-10-24","240","87079","25","10944","9","7.9"
"Clayton","2020-10-25","203","87282","16","10960","8.6","7.9"
"Clayton","2020-10-26","749","88031","99","11059","9.1","8.3"
"Clayton","2020-10-27","608","88639","66","11125","9.6","8.6"
"Clayton","2020-10-28","722","89361","78","11203","10.1","9"
"Clayton","2020-10-29","437","89798","27","11230","10","9"
"Clayton","2020-10-30","824","90622","101","11331","10.2","9.4"
"Clayton","2020-10-31","254","90876","25","11356","10.1","9.6"
"Clayton","2020-11-01","196","91072","32","11388","11.4","10"
"Clayton","2020-11-02","724","91796","77","11465","11","10"
"Clayton","2020-11-03","564","92360","59","11524","10.9","10.2"
"Clayton","2020-11-04","600","92960","84","11608","11.4","10.7"
"Clayton","2020-11-05","789","93749","51","11659","11.4","10.7"
"Clayton","2020-11-06","634","94383","77","11736","11.4","10.8"
"Clayton","2020-11-07","287","94670","32","11768","11.6","10.9"
"Clayton","2020-11-08","177","94847","22","11790","11","11.2"
"Clayton","2020-11-09","667","95514","86","11876","11.4","11.2"
"Clayton","2020-11-10","694","96208","62","11938","11.1","11"
"Clayton","2020-11-11","486","96694","42","11980","10.4","10.9"
"Clayton","2020-11-12","912","97606","82","12062","10.7","11.1"
"Clayton","2020-11-13","828","98434","77","12139","10.3","10.9"
"Clayton","2020-11-14","371","98805","38","12177","10.2","10.9"
"Clayton","2020-11-15","254","99059","22","12199","9.7","10.4"
"Clayton","2020-11-16","889","99948","110","12309","9.6","10.5"
"Clayton","2020-11-17","870","100818","81","12390","9.6","10.4"
"Clayton","2020-11-18","899","101717","60","12450","9.4","9.9"
"Clayton","2020-11-19","907","102624","103","12553","9.7","10.2"
"Clayton","2020-11-20","1002","103626","99","12652","9.8","10.1"
"Clayton","2020-11-21","347","103973","28","12680","9.5","9.8"
"Clayton","2020-11-22","245","104218","25","12705","9.7","9.7"
"Clayton","2020-11-23","1049","105267","113","12818","9.5","9.5"
"Clayton","2020-11-24","1074","106341","105","12923","9.5","9.6"
"Clayton","2020-11-25","791","107132","91","13014","10.2","9.8"
"Clayton","2020-11-26","302","107434","16","13030","9.4","9.5"
"Clayton","2020-11-27","319","107753","42","13072","9.8","9.8"
"Clayton","2020-11-28","370","108123","62","13134","11.1","10.3"
"Clayton","2020-11-29","543","108666","48","13182","10.9","10.3"
"Clayton","2020-11-30","1111","109777","181","13363","11.7","10.6"
"Clayton","2020-12-01","1001","110778","209","13572","13.2","11.4"
"Clayton","2020-12-02","1004","111782","207","13779","14.5","12.4"
"Clayton","2020-12-03","1185","112967","214","13993","16.4","12.9"
"Clayton","2020-12-04","1120","114087","175","14168","16.7","13.3"
"Clayton","2020-12-05","579","114666","95","14263","16.7","13.9"
"Clayton","2020-12-06","457","115123","49","14312","16.9","13.9"
"Clayton","2020-12-07","1049","116172","193","14505","17.2","14.5"
"Clayton","2020-12-08","1484","117656","252","14757","16.7","15"
"Clayton","2020-12-09","1226","118882","233","14990","16.5","15.5"
"Clayton","2020-12-10","1253","120135","222","15212","16.4","16.4"
"Clayton","2020-12-11","1211","121346","224","15436","16.8","16.8"
"Clayton","2020-12-12","420","121766","71","15507","16.9","16.8"
"Clayton","2020-12-13","265","122031","35","15542","17.2","17.1"
"Clayton","2020-12-14","1400","123431","246","15788","17.1","17.2"
"Clayton","2020-12-15","1435","124866","260","16048","17.3","17"
"Clayton","2020-12-16","935","125801","121","16169","16.4","16.4"
"Clayton","2020-12-17","1511","127312","224","16393","16","16.2"
"Clayton","2020-12-18","1277","128589","202","16595","15.6","16.2"
"Clayton","2020-12-19","414","129003","78","16673","15.9","16.4"
"Clayton","2020-12-20","443","129446","44","16717","15.4","16.3"
"Clayton","2020-12-21","1416","130862","265","16982","15.6","16.4"
"Clayton","2020-12-22","1202","132064","220","17202","15.6","16.5"
"Clayton","2020-12-23","1129","133193","172","17374","16","16.2"
"Clayton","2020-12-24","729","133922","95","17469","15.7","15.9"
"Clayton","2020-12-25","165","134087","31","17500","16.1","15.9"
"Clayton","2020-12-26","442","134529","92","17592","16.4","16.2"
"Clayton","2020-12-27","323","134852","59","17651","17.6","16.5"
"Clayton","2020-12-28","1516","136368","355","18006","18.3","16.9"
"Clayton","2020-12-29","1488","137856","261","18267","18.2","16.9"
"Clayton","2020-12-30","1355","139211","278","18545","18.9","17.4"
"Clayton","2020-12-31","921","140132","153","18698","19.4","17.6"
"Clayton","2021-01-01","187","140319","46","18744","20.3","18.2"
"Clayton","2021-01-02","564","140883","125","18869","20.4","18.4"
"Clayton","2021-01-03","240","141123","43","18912","20.4","19"
"Clayton","2021-01-04","1087","142210","234","19146","20.1","19.2"
"Clayton","2021-01-05","1667","143877","350","19496","20.6","19.4"
"Clayton","2021-01-06","1461","145338","321","19817","20.8","19.9"
"Clayton","2021-01-07","1629","146967","357","20174","21.6","20.5"
"Clayton","2021-01-08","998","147965","171","20345","20.5","20.4"
"Clayton","2021-01-09","627","148592","111","20456","19.9","20.2"
"Clayton","2021-01-10","339","148931","58","20514","19.8","20.1"
"Clayton","2021-01-11","1190","150121","209","20723","19.2","19.7"
"Clayton","2021-01-12","1681","151802","324","21047","19","19.8"
"Clayton","2021-01-13","1484","153286","310","21357","18.8","19.8"
"Clayton","2021-01-14","1412","154698","259","21616","18.3","19.9"
"Clayton","2021-01-15","1033","155731","176","21792","18.3","19.4"
"Clayton","2021-01-16","521","156252","108","21900","18.7","19.3"
"Clayton","2021-01-17","325","156577","51","21951","18.5","19.1"
"Clayton","2021-01-18","563","157140","79","22030","18","18.6"
"Clayton","2021-01-19","1544","158684","257","22287","17.6","18.3"
"Clayton","2021-01-20","1371","160055","234","22521","17.1","17.9"
"Clayton","2021-01-21","1212","161267","190","22711","16.7","17.5"
"Clayton","2021-01-22","1196","162463","171","22882","16.3","17.3"
"Clayton","2021-01-23","400","162863","62","22944","15.6","17.1"
"Clayton","2021-01-24","398","163261","64","23008","15.6","17.1"
"Clayton","2021-01-25","1378","164639","220","23228","15.9","16.9"
"Clayton","2021-01-26","1353","165992","202","23430","15.6","16.6"
"Clayton","2021-01-27","1117","167109","174","23604","15.4","16.3"
"Clayton","2021-01-28","1197","168306","170","23774","15.2","16"
"Clayton","2021-01-29","963","169269","111","23885","14.8","15.6"
"Clayton","2021-01-30","494","169763","62","23947","14.4","15"
"Clayton","2021-01-31","366","170129","43","23990","13.8","14.7"
"Clayton","2021-02-01","1037","171166","129","24119","13.3","14.6"
"Clayton","2021-02-02","1210","172376","167","24286","13.1","14.4"
"Clayton","2021-02-03","1035","173411","122","24408","12.6","14"
"Clayton","2021-02-04","945","174356","83","24491","11.8","13.5"
"Clayton","2021-02-05","677","175033","74","24565","11.7","13.3"
"Clayton","2021-02-06","300","175333","24","24589","11.1","12.7"
"Clayton","2021-02-07","5","175338","0","24589","9.4","11.6"
"Clayton","2021-02-08","0","175338","0","24589","7.6","10.4"
"Clinch","2020-02-01","0","0","0","0",".","."
"Clinch","2020-02-02","0","0","0","0",".","."
"Clinch","2020-02-03","0","0","0","0",".","."
"Clinch","2020-02-04","0","0","0","0",".","."
"Clinch","2020-02-05","0","0","0","0",".","."
"Clinch","2020-02-06","0","0","0","0",".","."
"Clinch","2020-02-07","0","0","0","0","0","."
"Clinch","2020-02-08","0","0","0","0","0","."
"Clinch","2020-02-09","0","0","0","0","0","."
"Clinch","2020-02-10","0","0","0","0","0","."
"Clinch","2020-02-11","0","0","0","0","0","."
"Clinch","2020-02-12","0","0","0","0","0","."
"Clinch","2020-02-13","0","0","0","0","0","."
"Clinch","2020-02-14","0","0","0","0","0","0"
"Clinch","2020-02-15","0","0","0","0","0","0"
"Clinch","2020-02-16","0","0","0","0","0","0"
"Clinch","2020-02-17","0","0","0","0","0","0"
"Clinch","2020-02-18","0","0","0","0","0","0"
"Clinch","2020-02-19","0","0","0","0","0","0"
"Clinch","2020-02-20","0","0","0","0","0","0"
"Clinch","2020-02-21","0","0","0","0","0","0"
"Clinch","2020-02-22","0","0","0","0","0","0"
"Clinch","2020-02-23","0","0","0","0","0","0"
"Clinch","2020-02-24","0","0","0","0","0","0"
"Clinch","2020-02-25","0","0","0","0","0","0"
"Clinch","2020-02-26","0","0","0","0","0","0"
"Clinch","2020-02-27","0","0","0","0","0","0"
"Clinch","2020-02-28","0","0","0","0","0","0"
"Clinch","2020-02-29","0","0","0","0","0","0"
"Clinch","2020-03-01","0","0","0","0","0","0"
"Clinch","2020-03-02","0","0","0","0","0","0"
"Clinch","2020-03-03","0","0","0","0","0","0"
"Clinch","2020-03-04","0","0","0","0","0","0"
"Clinch","2020-03-05","0","0","0","0","0","0"
"Clinch","2020-03-06","0","0","0","0","0","0"
"Clinch","2020-03-07","0","0","0","0","0","0"
"Clinch","2020-03-08","0","0","0","0","0","0"
"Clinch","2020-03-09","0","0","0","0","0","0"
"Clinch","2020-03-10","0","0","0","0","0","0"
"Clinch","2020-03-11","0","0","0","0","0","0"
"Clinch","2020-03-12","6","6","0","0","0","0"
"Clinch","2020-03-13","2","8","0","0","0","0"
"Clinch","2020-03-14","0","8","0","0","0","0"
"Clinch","2020-03-15","0","8","0","0","0","0"
"Clinch","2020-03-16","2","10","1","1","7.1","3.6"
"Clinch","2020-03-17","1","11","0","1","7.1","3.6"
"Clinch","2020-03-18","3","14","0","1","7.1","3.6"
"Clinch","2020-03-19","0","14","0","1","7.1","3.6"
"Clinch","2020-03-20","2","16","0","1","7.1","3.6"
"Clinch","2020-03-21","3","19","0","1","7.1","3.6"
"Clinch","2020-03-22","1","20","0","1","7.1","3.6"
"Clinch","2020-03-23","4","24","0","1","0","3.6"
"Clinch","2020-03-24","2","26","0","1","0","3.6"
"Clinch","2020-03-25","0","26","0","1","0","3.6"
"Clinch","2020-03-26","1","27","0","1","0","3.6"
"Clinch","2020-03-27","2","29","0","1","0","3.6"
"Clinch","2020-03-28","0","29","0","1","0","3.6"
"Clinch","2020-03-29","1","30","0","1","0","3.6"
"Clinch","2020-03-30","2","32","0","1","0","0"
"Clinch","2020-03-31","4","36","2","3","7.1","3.6"
"Clinch","2020-04-01","4","40","0","3","7.1","3.6"
"Clinch","2020-04-02","2","42","0","3","7.1","3.6"
"Clinch","2020-04-03","5","47","0","3","7.1","3.6"
"Clinch","2020-04-04","2","49","0","3","7.1","3.6"
"Clinch","2020-04-05","0","49","0","3","7.1","3.6"
"Clinch","2020-04-06","0","49","0","3","7.1","3.6"
"Clinch","2020-04-07","4","53","0","3","0","3.6"
"Clinch","2020-04-08","10","63","3","6","4.3","5.7"
"Clinch","2020-04-09","3","66","1","7","9","8.1"
"Clinch","2020-04-10","14","80","1","8","10.1","8.6"
"Clinch","2020-04-11","6","86","1","9","12.4","9.8"
"Clinch","2020-04-12","0","86","0","9","12.4","9.8"
"Clinch","2020-04-13","0","86","0","9","12.4","9.8"
"Clinch","2020-04-14","6","92","1","10","14.8","7.4"
"Clinch","2020-04-15","7","99","2","12","14.6","9.5"
"Clinch","2020-04-16","6","105","1","13","12.2","10.6"
"Clinch","2020-04-17","2","107","0","13","11.2","10.6"
"Clinch","2020-04-18","5","112","0","13","8.8","10.6"
"Clinch","2020-04-19","0","112","0","13","8.8","10.6"
"Clinch","2020-04-20","8","120","0","13","8.8","10.6"
"Clinch","2020-04-21","16","136","3","16","9.1","12"
"Clinch","2020-04-22","8","144","2","18","8.6","11.6"
"Clinch","2020-04-23","9","153","0","18","6.3","9.2"
"Clinch","2020-04-24","7","160","0","18","6.3","8.7"
"Clinch","2020-04-25","0","160","0","18","6.3","7.5"
"Clinch","2020-04-26","0","160","0","18","6.3","7.5"
"Clinch","2020-04-27","19","179","1","19","7","7.9"
"Clinch","2020-04-28","5","184","1","20","7.2","8.2"
"Clinch","2020-04-29","20","204","1","21","4.3","6.5"
"Clinch","2020-04-30","35","239","4","25","6","6.1"
"Clinch","2020-05-01","10","249","0","25","6","6.1"
"Clinch","2020-05-02","1","250","1","26","20.2","13.2"
"Clinch","2020-05-03","0","250","0","26","20.2","13.2"
"Clinch","2020-05-04","6","256","0","26","19.5","13.2"
"Clinch","2020-05-05","14","270","3","29","19.7","13.4"
"Clinch","2020-05-06","17","287","1","30","19.8","12.1"
"Clinch","2020-05-07","28","315","12","42","24.3","15.1"
"Clinch","2020-05-08","2","317","1","43","31.5","18.7"
"Clinch","2020-05-09","5","322","0","43","17.2","18.7"
"Clinch","2020-05-10","26","348","13","56","24.3","22.3"
"Clinch","2020-05-11","57","405","25","81","30.6","25"
"Clinch","2020-05-12","9","414","2","83","30.7","25.2"
"Clinch","2020-05-13","45","459","1","84","30.2","25"
"Clinch","2020-05-14","89","548","12","96","26","25.1"
"Clinch","2020-05-15","16","564","2","98","20.6","26"
"Clinch","2020-05-16","2","566","0","98","20.6","18.9"
"Clinch","2020-05-17","0","566","0","98","13.5","18.9"
"Clinch","2020-05-18","11","577","0","98","7.2","18.9"
"Clinch","2020-05-19","3","580","0","98","4","17.4"
"Clinch","2020-05-20","23","603","6","104","7.4","18.8"
"Clinch","2020-05-21","27","630","3","107","7.1","16.5"
"Clinch","2020-05-22","29","659","2","109","6.3","13.5"
"Clinch","2020-05-23","6","665","1","110","8.7","14.6"
"Clinch","2020-05-24","4","669","0","110","8.7","11.1"
"Clinch","2020-05-25","4","673","0","110","8.7","7.9"
"Clinch","2020-05-26","10","683","0","110","8.7","6.4"
"Clinch","2020-05-27","23","706","0","110","5","6.2"
"Clinch","2020-05-28","17","723","3","113","5.9","6.5"
"Clinch","2020-05-29","11","734","3","116","8.8","7.5"
"Clinch","2020-05-30","3","737","1","117","11.2","9.9"
"Clinch","2020-05-31","3","740","0","117","11.2","9.9"
"Clinch","2020-06-01","5","745","2","119","16.9","12.8"
"Clinch","2020-06-02","3","748","0","119","16.9","12.8"
"Clinch","2020-06-03","80","828","4","123","17.6","11.3"
"Clinch","2020-06-04","11","839","0","123","15.1","10.5"
"Clinch","2020-06-05","7","846","0","123","11.2","10"
"Clinch","2020-06-06","0","846","0","123","6.4","8.8"
"Clinch","2020-06-07","3","849","0","123","6.4","8.8"
"Clinch","2020-06-08","13","862","2","125","2.9","9.9"
"Clinch","2020-06-09","126","988","11","136","4.2","10.5"
"Clinch","2020-06-10","13","1001","0","136","3.4","10.5"
"Clinch","2020-06-11","22","1023","6","142","7.3","11.2"
"Clinch","2020-06-12","32","1055","0","142","7.3","9.3"
"Clinch","2020-06-13","5","1060","0","142","7.3","6.9"
"Clinch","2020-06-14","4","1064","1","143","10.9","8.7"
"Clinch","2020-06-15","30","1094","1","144","9.2","6.1"
"Clinch","2020-06-16","26","1120","3","147","9.6","6.9"
"Clinch","2020-06-17","16","1136","2","149","11.4","7.4"
"Clinch","2020-06-18","16","1152","5","154","11.9","9.6"
"Clinch","2020-06-19","15","1167","3","157","14.8","11.1"
"Clinch","2020-06-20","0","1167","0","157","14.8","11.1"
"Clinch","2020-06-21","5","1172","1","158","14.1","12.5"
"Clinch","2020-06-22","35","1207","12","170","18.5","13.9"
"Clinch","2020-06-23","41","1248","5","175","18.6","14.1"
"Clinch","2020-06-24","100","1348","4","179","17.4","14.4"
"Clinch","2020-06-25","23","1371","1","180","13.5","12.7"
"Clinch","2020-06-26","60","1431","5","185","11.9","13.3"
"Clinch","2020-06-27","4","1435","1","186","15.5","15.1"
"Clinch","2020-06-28","9","1444","1","187","14.2","14.1"
"Clinch","2020-06-29","63","1507","13","200","12.2","15.4"
"Clinch","2020-06-30","33","1540","2","202","11.4","15"
"Clinch","2020-07-01","29","1569","6","208","13.7","15.6"
"Clinch","2020-07-02","21","1590","2","210","14.5","14"
"Clinch","2020-07-03","13","1603","0","210","13.3","12.6"
"Clinch","2020-07-04","1","1604","0","210","9.7","12.6"
"Clinch","2020-07-05","3","1607","0","210","8.1","11.2"
"Clinch","2020-07-06","30","1637","8","218","9","10.6"
"Clinch","2020-07-07","35","1672","9","227","11.8","11.6"
"Clinch","2020-07-08","23","1695","9","236","14.4","14.1"
"Clinch","2020-07-09","19","1714","4","240","16.1","15.3"
"Clinch","2020-07-10","42","1756","12","252","20.2","16.7"
"Clinch","2020-07-11","9","1765","0","252","20.2","14.9"
"Clinch","2020-07-12","3","1768","1","253","24.9","16.5"
"Clinch","2020-07-13","56","1824","15","268","24.9","17"
"Clinch","2020-07-14","47","1871","7","275","23.4","17.6"
"Clinch","2020-07-15","29","1900","3","278","19.3","16.9"
"Clinch","2020-07-16","10","1910","1","279","17.7","16.9"
"Clinch","2020-07-17","41","1951","5","284","15.4","17.8"
"Clinch","2020-07-18","6","1957","3","287","22.5","21.3"
"Clinch","2020-07-19","9","1966","0","287","17.7","21.3"
"Clinch","2020-07-20","60","2026","5","292","15.1","20"
"Clinch","2020-07-21","4","2030","1","293","16.6","20"
"Clinch","2020-07-22","16","2046","6","299","20.4","19.9"
"Clinch","2020-07-23","28","2074","3","302","20.5","19.1"
"Clinch","2020-07-24","12","2086","3","305","22.4","18.9"
"Clinch","2020-07-25","6","2092","0","305","15.2","18.9"
"Clinch","2020-07-26","2","2094","0","305","15.2","16.5"
"Clinch","2020-07-27","30","2124","4","309","15.9","15.5"
"Clinch","2020-07-28","19","2143","2","311","13.9","15.2"
"Clinch","2020-07-29","10","2153","0","311","8.5","14.5"
"Clinch","2020-07-30","14","2167","3","314","10","15.3"
"Clinch","2020-07-31","17","2184","4","318","9.8","16.1"
"Clinch","2020-08-01","2","2186","1","319","17","16.1"
"Clinch","2020-08-02","3","2189","0","319","17","16.1"
"Clinch","2020-08-03","29","2218","5","324","17.5","16.7"
"Clinch","2020-08-04","23","2241","4","328","18.5","16.2"
"Clinch","2020-08-05","21","2262","6","334","22.6","15.6"
"Clinch","2020-08-06","15","2277","2","336","21.4","15.7"
"Clinch","2020-08-07","41","2318","9","345","21.2","15.5"
"Clinch","2020-08-08","4","2322","0","345","14.1","15.5"
"Clinch","2020-08-09","8","2330","0","345","14.1","15.5"
"Clinch","2020-08-10","42","2372","6","351","13.6","15.6"
"Clinch","2020-08-11","14","2386","4","355","15.2","16.9"
"Clinch","2020-08-12","22","2408","2","357","12.5","17.5"
"Clinch","2020-08-13","19","2427","4","361","13.6","17.5"
"Clinch","2020-08-14","19","2446","2","363","11.9","16.6"
"Clinch","2020-08-15","3","2449","2","365","21.5","17.8"
"Clinch","2020-08-16","2","2451","0","365","21.5","17.8"
"Clinch","2020-08-17","30","2481","3","368","20.8","17.2"
"Clinch","2020-08-18","20","2501","6","374","21","18.1"
"Clinch","2020-08-19","26","2527","6","380","23","17.8"
"Clinch","2020-08-20","15","2542","2","382","21.9","17.8"
"Clinch","2020-08-21","14","2556","2","384","22.5","17.2"
"Clinch","2020-08-22","4","2560","0","384","13","17.2"
"Clinch","2020-08-23","5","2565","1","385","15.8","18.6"
"Clinch","2020-08-24","26","2591","3","388","16","18.4"
"Clinch","2020-08-25","23","2614","7","395","16.1","18.6"
"Clinch","2020-08-26","21","2635","1","396","13.5","18.3"
"Clinch","2020-08-27","23","2658","3","399","13.4","17.7"
"Clinch","2020-08-28","14","2672","4","403","15.5","19"
"Clinch","2020-08-29","8","2680","5","408","24.4","18.7"
"Clinch","2020-08-30","7","2687","1","409","23.6","19.7"
"Clinch","2020-08-31","32","2719","7","416","25.1","20.6"
"Clinch","2020-09-01","16","2735","6","422","26.1","21.1"
"Clinch","2020-09-02","22","2757","0","422","25.4","19.4"
"Clinch","2020-09-03","12","2769","1","423","24.7","19.1"
"Clinch","2020-09-04","23","2792","1","424","21.3","18.4"
"Clinch","2020-09-05","4","2796","0","424","12.3","18.4"
"Clinch","2020-09-06","12","2808","3","427","13.9","18.7"
"Clinch","2020-09-07","8","2816","1","428","12.5","18.8"
"Clinch","2020-09-08","22","2838","7","435","11.7","18.9"
"Clinch","2020-09-09","20","2858","1","436","12.4","18.9"
"Clinch","2020-09-10","18","2876","2","438","12.8","18.8"
"Clinch","2020-09-11","40","2916","7","445","14.7","18"
"Clinch","2020-09-12","13","2929","2","447","16.9","14.6"
"Clinch","2020-09-13","8","2937","2","449","16.9","15.4"
"Clinch","2020-09-14","36","2973","7","456","17.9","15.2"
"Clinch","2020-09-15","16","2989","3","459","16","13.9"
"Clinch","2020-09-16","17","3006","6","465","20.4","16.4"
"Clinch","2020-09-17","16","3022","3","468","21.4","17.1"
"Clinch","2020-09-18","16","3038","2","470","20.7","17.7"
"Clinch","2020-09-19","5","3043","2","472","24.2","20.6"
"Clinch","2020-09-20","4","3047","2","474","27.8","22.4"
"Clinch","2020-09-21","17","3064","1","475","25.9","21.9"
"Clinch","2020-09-22","24","3088","1","476","23.8","19.9"
"Clinch","2020-09-23","21","3109","6","482","22.8","21.6"
"Clinch","2020-09-24","12","3121","0","482","20.2","20.8"
"Clinch","2020-09-25","23","3144","1","483","19","19.9"
"Clinch","2020-09-26","8","3152","0","483","13.3","18.8"
"Clinch","2020-09-27","4","3156","1","484","9.7","18.8"
"Clinch","2020-09-28","23","3179","4","488","11.4","18.6"
"Clinch","2020-09-29","13","3192","0","488","10.8","17.3"
"Clinch","2020-09-30","14","3206","1","489","7.7","15.3"
"Clinch","2020-10-01","13","3219","2","491","9.9","15"
"Clinch","2020-10-02","6","3225","2","493","14","16.5"
"Clinch","2020-10-03","7","3232","1","494","16.1","14.7"
"Clinch","2020-10-04","1","3233","1","495","26.8","18.3"
"Clinch","2020-10-05","15","3248","3","498","27.2","19.3"
"Clinch","2020-10-06","16","3264","0","498","27.2","19"
"Clinch","2020-10-07","16","3280","3","501","28.8","18.3"
"Clinch","2020-10-08","10","3290","0","501","26.6","18.3"
"Clinch","2020-10-09","18","3308","4","505","25","19.5"
"Clinch","2020-10-10","3","3311","0","505","23","19.5"
"Clinch","2020-10-11","4","3315","0","505","8.7","17.8"
"Clinch","2020-10-12","19","3334","1","506","6.6","16.9"
"Clinch","2020-10-13","21","3355","2","508","8","17.6"
"Clinch","2020-10-14","14","3369","1","509","6.3","17.6"
"Clinch","2020-10-15","10","3379","1","510","7.7","17.2"
"Clinch","2020-10-16","5","3384","0","510","4.6","14.8"
"Clinch","2020-10-17","66","3450","0","510","4.6","13.8"
"Clinch","2020-10-18","5","3455","1","511","7.4","8.1"
"Clinch","2020-10-19","13","3468","3","514","10","8.3"
"Clinch","2020-10-20","13","3481","4","518","13","10.5"
"Clinch","2020-10-21","13","3494","7","525","19.7","13"
"Clinch","2020-10-22","12","3506","0","525","18.2","13"
"Clinch","2020-10-23","18","3524","1","526","19","11.8"
"Clinch","2020-10-24","4","3528","1","527","22.6","13.6"
"Clinch","2020-10-25","6","3534","0","527","19.7","13.6"
"Clinch","2020-10-26","21","3555","3","530","18.5","14.2"
"Clinch","2020-10-27","11","3566","2","532","16.7","14.8"
"Clinch","2020-10-28","18","3584","7","539","14.6","17.1"
"Clinch","2020-10-29","14","3598","1","540","15.6","16.9"
"Clinch","2020-10-30","9","3607","2","542","18","18.5"
"Clinch","2020-10-31","1","3608","0","542","14.4","18.5"
"Clinch","2020-11-01","2","3610","1","543","21.5","20.6"
"Clinch","2020-11-02","13","3623","4","547","23.9","21.2"
"Clinch","2020-11-03","13","3636","1","548","22.4","19.5"
"Clinch","2020-11-04","5","3641","0","548","16.8","15.7"
"Clinch","2020-11-05","9","3650","4","552","22.2","18.9"
"Clinch","2020-11-06","12","3662","2","554","21.4","19.7"
"Clinch","2020-11-07","7","3669","2","556","25.4","19.9"
"Clinch","2020-11-08","4","3673","2","558","25.4","23.5"
"Clinch","2020-11-09","22","3695","3","561","23","23.4"
"Clinch","2020-11-10","8","3703","2","563","25.5","23.9"
"Clinch","2020-11-11","10","3713","0","563","25.5","21.2"
"Clinch","2020-11-12","10","3723","0","563","19.1","20.6"
"Clinch","2020-11-13","11","3734","0","563","16.7","19.1"
"Clinch","2020-11-14","3","3737","0","563","12.7","19.1"
"Clinch","2020-11-15","5","3742","0","563","5.5","15.5"
"Clinch","2020-11-16","14","3756","1","564","4.6","13.8"
"Clinch","2020-11-17","10","3766","0","564","1","13.2"
"Clinch","2020-11-18","9","3775","3","567","5.8","15.6"
"Clinch","2020-11-19","13","3788","1","568","6.9","13"
"Clinch","2020-11-20","11","3799","1","569","8.2","12.5"
"Clinch","2020-11-21","5","3804","0","569","8.2","10.4"
"Clinch","2020-11-22","5","3809","1","570","11","8.3"
"Clinch","2020-11-23","4","3813","0","570","10","7.3"
"Clinch","2020-11-24","16","3829","0","570","10","5.5"
"Clinch","2020-11-25","6","3835","0","570","5.3","5.5"
"Clinch","2020-11-26","1","3836","0","570","4.2","5.5"
"Clinch","2020-11-27","7","3843","0","570","2.9","5.5"
"Clinch","2020-11-28","5","3848","2","572","8.6","8.4"
"Clinch","2020-11-29","3","3851","0","572","5.7","8.4"
"Clinch","2020-11-30","15","3866","3","575","8.6","9.3"
"Clinch","2020-12-01","13","3879","1","576","9.7","9.8"
"Clinch","2020-12-02","3","3882","0","576","9.7","7.5"
"Clinch","2020-12-03","9","3891","0","576","9.7","6.9"
"Clinch","2020-12-04","9","3900","1","577","11.3","7.1"
"Clinch","2020-12-05","4","3904","1","578","9.1","8.8"
"Clinch","2020-12-06","4","3908","0","578","9.1","7.4"
"Clinch","2020-12-07","13","3921","4","582","10.7","9.6"
"Clinch","2020-12-08","8","3929","2","584","13.1","11.4"
"Clinch","2020-12-09","6","3935","0","584","13.1","11.4"
"Clinch","2020-12-10","12","3947","1","585","14.3","12"
"Clinch","2020-12-11","7","3954","0","585","12.7","12"
"Clinch","2020-12-12","7","3961","0","585","9.2","9.1"
"Clinch","2020-12-13","6","3967","3","588","16.3","12.7"
"Clinch","2020-12-14","14","3981","5","593","17","13.8"
"Clinch","2020-12-15","8","3989","1","594","15.2","14.2"
"Clinch","2020-12-16","9","3998","3","597","20","16.6"
"Clinch","2020-12-17","4","4002","0","597","18.8","16.6"
"Clinch","2020-12-18","18","4020","1","598","19.6","16.2"
"Clinch","2020-12-19","5","4025","3","601","28.2","18.7"
"Clinch","2020-12-20","6","4031","1","602","23.4","19.8"
"Clinch","2020-12-21","12","4043","3","605","21.9","19.4"
"Clinch","2020-12-22","19","4062","7","612","25.3","20.3"
"Clinch","2020-12-23","12","4074","3","615","24.2","22.1"
"Clinch","2020-12-24","7","4081","3","618","30.3","24.5"
"Clinch","2020-12-25","2","4083","2","620","43.8","31.7"
"Clinch","2020-12-26","4","4087","2","622","42.3","35.2"
"Clinch","2020-12-27","4","4091","1","623","43.5","33.5"
"Clinch","2020-12-28","27","4118","13","636","46.8","34.4"
"Clinch","2020-12-29","36","4154","11","647","45.9","35.6"
"Clinch","2020-12-30","37","4191","6","653","44.7","34.4"
"Clinch","2020-12-31","18","4209","5","658","42.5","36.4"
"Clinch","2021-01-01","2","4211","1","659","35.4","39.6"
"Clinch","2021-01-02","1","4212","0","659","28.2","35.3"
"Clinch","2021-01-03","3","4215","1","660","29.4","36.5"
"Clinch","2021-01-04","42","4257","8","668","25.3","36.1"
"Clinch","2021-01-05","31","4288","8","676","24.6","35.3"
"Clinch","2021-01-06","14","4302","4","680","26.4","35.5"
"Clinch","2021-01-07","26","4328","7","687","26.2","34.4"
"Clinch","2021-01-08","15","4343","4","691","22.9","29.1"
"Clinch","2021-01-09","4","4347","1","692","26.5","27.4"
"Clinch","2021-01-10","4","4351","1","693","25.3","27.4"
"Clinch","2021-01-11","39","4390","9","702","25.9","25.6"
"Clinch","2021-01-12","25","4415","2","704","23.3","24"
"Clinch","2021-01-13","36","4451","1","705","19.6","23"
"Clinch","2021-01-14","24","4475","3","708","17.6","21.9"
"Clinch","2021-01-15","17","4492","4","712","17.1","20"
"Clinch","2021-01-16","1","4493","1","713","27.8","27.2"
"Clinch","2021-01-17","2","4495","2","715","38.6","31.9"
"Clinch","2021-01-18","30","4525","8","723","39.1","32.5"
"Clinch","2021-01-19","22","4547","3","726","39.9","31.6"
"Clinch","2021-01-20","18","4565","7","733","45","32.3"
"Clinch","2021-01-21","24","4589","6","739","46.8","32.2"
"Clinch","2021-01-22","19","4608","4","743","46.5","31.8"
"Clinch","2021-01-23","4","4612","0","743","32.2","30"
"Clinch","2021-01-24","6","4618","2","745","22.7","30.6"
"Clinch","2021-01-25","100","4718","12","757","20.6","29.8"
"Clinch","2021-01-26","23","4741","3","760","20.5","30.2"
"Clinch","2021-01-27","32","4773","6","766","17.6","31.3"
"Clinch","2021-01-28","25","4798","3","769","15.7","31.3"
"Clinch","2021-01-29","19","4817","4","773","15.7","31.1"
"Clinch","2021-01-30","4","4821","0","773","15.7","24"
"Clinch","2021-01-31","2","4823","0","773","11","16.8"
"Clinch","2021-02-01","18","4841","5","778","13.2","16.9"
"Clinch","2021-02-02","12","4853","4","782","16.1","18.3"
"Clinch","2021-02-03","21","4874","2","784","14.8","16.2"
"Clinch","2021-02-04","8","4882","0","784","13.1","14.4"
"Clinch","2021-02-05","6","4888","0","784","10.1","12.9"
"Clinch","2021-02-06","4","4892","1","785","13.7","14.7"
"Clinch","2021-02-07","3","4895","3","788","27.9","19.5"
"Clinch","2021-02-08","0","4895","0","788","24","18.6"
"Cobb","2020-02-01","0","0","0","0",".","."
"Cobb","2020-02-02","0","0","0","0",".","."
"Cobb","2020-02-03","0","0","0","0",".","."
"Cobb","2020-02-04","0","0","0","0",".","."
"Cobb","2020-02-05","0","0","0","0",".","."
"Cobb","2020-02-06","0","0","0","0",".","."
"Cobb","2020-02-07","0","0","0","0","0","."
"Cobb","2020-02-08","0","0","0","0","0","."
"Cobb","2020-02-09","0","0","0","0","0","."
"Cobb","2020-02-10","0","0","0","0","0","."
"Cobb","2020-02-11","0","0","0","0","0","."
"Cobb","2020-02-12","0","0","0","0","0","."
"Cobb","2020-02-13","1","1","0","0","0","."
"Cobb","2020-02-14","0","1","0","0","0","0"
"Cobb","2020-02-15","0","1","0","0","0","0"
"Cobb","2020-02-16","0","1","0","0","0","0"
"Cobb","2020-02-17","0","1","0","0","0","0"
"Cobb","2020-02-18","0","1","0","0","0","0"
"Cobb","2020-02-19","0","1","0","0","0","0"
"Cobb","2020-02-20","0","1","0","0","0","0"
"Cobb","2020-02-21","0","1","0","0","0","0"
"Cobb","2020-02-22","0","1","0","0","0","0"
"Cobb","2020-02-23","0","1","0","0","0","0"
"Cobb","2020-02-24","0","1","0","0","0","0"
"Cobb","2020-02-25","0","1","0","0","0","0"
"Cobb","2020-02-26","0","1","0","0","0","0"
"Cobb","2020-02-27","0","1","0","0","0","0"
"Cobb","2020-02-28","0","1","0","0","0","0"
"Cobb","2020-02-29","0","1","0","0","0","0"
"Cobb","2020-03-01","0","1","0","0","0","0"
"Cobb","2020-03-02","0","1","0","0","0","0"
"Cobb","2020-03-03","0","1","0","0","0","0"
"Cobb","2020-03-04","2","3","0","0","0","0"
"Cobb","2020-03-05","0","3","0","0","0","0"
"Cobb","2020-03-06","2","5","0","0","0","0"
"Cobb","2020-03-07","2","7","0","0","0","0"
"Cobb","2020-03-08","0","7","0","0","0","0"
"Cobb","2020-03-09","14","21","0","0","0","0"
"Cobb","2020-03-10","65","86","0","0","0","0"
"Cobb","2020-03-11","78","164","2","2","0.4","0.2"
"Cobb","2020-03-12","74","238","10","12","2.3","1.1"
"Cobb","2020-03-13","53","291","18","30","7.1","3.6"
"Cobb","2020-03-14","46","337","17","47","12.4","6.2"
"Cobb","2020-03-15","40","377","9","56","15.6","7.8"
"Cobb","2020-03-16","95","472","19","75","18.5","9.2"
"Cobb","2020-03-17","119","591","32","107","22.3","11.2"
"Cobb","2020-03-18","92","683","26","133","26","13.2"
"Cobb","2020-03-19","118","801","17","150","26.1","14.2"
"Cobb","2020-03-20","121","922","30","180","24.8","16"
"Cobb","2020-03-21","35","957","10","190","23.6","18"
"Cobb","2020-03-22","42","999","14","204","25.2","20.4"
"Cobb","2020-03-23","195","1194","59","263","26.6","22.6"
"Cobb","2020-03-24","171","1365","54","317","27.3","24.8"
"Cobb","2020-03-25","278","1643","77","394","27.2","26.6"
"Cobb","2020-03-26","230","1873","59","453","28.8","27.5"
"Cobb","2020-03-27","286","2159","66","519","28.6","26.7"
"Cobb","2020-03-28","132","2291","45","564","29.4","26.5"
"Cobb","2020-03-29","119","2410","46","610","30.1","27.7"
"Cobb","2020-03-30","285","2695","78","688","29.7","28.2"
"Cobb","2020-03-31","299","2994","68","756","28.5","27.9"
"Cobb","2020-04-01","230","3224","44","800","27.2","27.2"
"Cobb","2020-04-02","220","3444","39","839","26.1","27.5"
"Cobb","2020-04-03","228","3672","31","870","24.8","26.7"
"Cobb","2020-04-04","102","3774","20","890","22.7","26"
"Cobb","2020-04-05","80","3854","10","900","19","24.5"
"Cobb","2020-04-06","287","4141","50","950","17.5","23.6"
"Cobb","2020-04-07","338","4479","52","1002","16.5","22.5"
"Cobb","2020-04-08","318","4797","30","1032","15.1","21.2"
"Cobb","2020-04-09","259","5056","37","1069","14.6","20.4"
"Cobb","2020-04-10","303","5359","42","1111","14.6","19.7"
"Cobb","2020-04-11","153","5512","12","1123","13","17.8"
"Cobb","2020-04-12","75","5587","19","1142","14.8","16.9"
"Cobb","2020-04-13","289","5876","55","1197","15","16.3"
"Cobb","2020-04-14","278","6154","36","1233","14.7","15.6"
"Cobb","2020-04-15","305","6459","31","1264","14.8","14.9"
"Cobb","2020-04-16","335","6794","39","1303","14.4","14.5"
"Cobb","2020-04-17","474","7268","55","1358","14.1","14.4"
"Cobb","2020-04-18","243","7511","18","1376","14","13.5"
"Cobb","2020-04-19","140","7651","14","1390","11.8","13.3"
"Cobb","2020-04-20","499","8150","52","1442","10.6","12.8"
"Cobb","2020-04-21","434","8584","45","1487","10.2","12.5"
"Cobb","2020-04-22","380","8964","34","1521","10.1","12.4"
"Cobb","2020-04-23","416","9380","40","1561","9.8","12.1"
"Cobb","2020-04-24","469","9849","41","1602","9.4","11.7"
"Cobb","2020-04-25","272","10121","26","1628","9.7","11.8"
"Cobb","2020-04-26","114","10235","15","1643","10.1","11"
"Cobb","2020-04-27","625","10860","88","1731","10.6","10.6"
"Cobb","2020-04-28","734","11594","55","1786","10.2","10.2"
"Cobb","2020-04-29","970","12564","44","1830","9.6","9.8"
"Cobb","2020-04-30","759","13323","39","1869","9","9.4"
"Cobb","2020-05-01","475","13798","36","1905","8.8","9.1"
"Cobb","2020-05-02","369","14167","20","1925","8.2","8.9"
"Cobb","2020-05-03","247","14414","25","1950","7.8","8.9"
"Cobb","2020-05-04","560","14974","31","1981","6.5","8.6"
"Cobb","2020-05-05","501","15475","33","2014","6.4","8.3"
"Cobb","2020-05-06","818","16293","28","2042","6.3","7.9"
"Cobb","2020-05-07","582","16875","26","2068","6.2","7.6"
"Cobb","2020-05-08","943","17818","75","2143","6.2","7.5"
"Cobb","2020-05-09","572","18390","36","2179","6.3","7.3"
"Cobb","2020-05-10","126","18516","18","2197","6.9","7.4"
"Cobb","2020-05-11","919","19435","58","2255","7","6.8"
"Cobb","2020-05-12","1002","20437","48","2303","6.8","6.6"
"Cobb","2020-05-13","1234","21671","46","2349","6.8","6.5"
"Cobb","2020-05-14","896","22567","44","2393","6.9","6.5"
"Cobb","2020-05-15","922","23489","50","2443","6.5","6.4"
"Cobb","2020-05-16","539","24028","48","2491","6.9","6.6"
"Cobb","2020-05-17","301","24329","31","2522","6.3","6.6"
"Cobb","2020-05-18","944","25273","61","2583","6.4","6.7"
"Cobb","2020-05-19","1041","26314","54","2637","6.4","6.6"
"Cobb","2020-05-20","914","27228","56","2693","6.8","6.8"
"Cobb","2020-05-21","922","28150","44","2737","6.7","6.8"
"Cobb","2020-05-22","737","28887","44","2781","6.8","6.7"
"Cobb","2020-05-23","354","29241","33","2814","6.9","6.9"
"Cobb","2020-05-24","207","29448","14","2828","6.4","6.4"
"Cobb","2020-05-25","207","29655","9","2837","6.1","6.2"
"Cobb","2020-05-26","906","30561","48","2885","6.1","6.3"
"Cobb","2020-05-27","1002","31563","41","2926","5.8","6.3"
"Cobb","2020-05-28","707","32270","37","2963","5.9","6.3"
"Cobb","2020-05-29","802","33072","55","3018","6","6.4"
"Cobb","2020-05-30","428","33500","15","3033","5.2","6"
"Cobb","2020-05-31","185","33685","7","3040","4.7","5.6"
"Cobb","2020-06-01","589","34274","41","3081","5.1","5.6"
"Cobb","2020-06-02","774","35048","33","3114","5","5.5"
"Cobb","2020-06-03","899","35947","50","3164","5.2","5.5"
"Cobb","2020-06-04","832","36779","61","3225","5.5","5.7"
"Cobb","2020-06-05","758","37537","61","3286","5.6","5.8"
"Cobb","2020-06-06","555","38092","25","3311","5.8","5.5"
"Cobb","2020-06-07","227","38319","23","3334","6.7","5.7"
"Cobb","2020-06-08","835","39154","55","3389","6.6","5.9"
"Cobb","2020-06-09","873","40027","53","3442","6.9","5.9"
"Cobb","2020-06-10","786","40813","48","3490","7","6.1"
"Cobb","2020-06-11","1042","41855","62","3552","6.8","6.1"
"Cobb","2020-06-12","850","42705","46","3598","6.4","6"
"Cobb","2020-06-13","578","43283","46","3644","6.9","6.3"
"Cobb","2020-06-14","301","43584","35","3679","7.1","6.9"
"Cobb","2020-06-15","698","44282","56","3735","7.3","7"
"Cobb","2020-06-16","1037","45319","95","3830","7.7","7.3"
"Cobb","2020-06-17","1166","46485","90","3920","8","7.5"
"Cobb","2020-06-18","1057","47542","106","4026","8.6","7.7"
"Cobb","2020-06-19","944","48486","102","4128","9.3","7.9"
"Cobb","2020-06-20","739","49225","114","4242","10.4","8.6"
"Cobb","2020-06-21","309","49534","40","4282","10.6","8.8"
"Cobb","2020-06-22","1332","50866","166","4448","11.2","9.3"
"Cobb","2020-06-23","1144","52010","171","4619","12","9.9"
"Cobb","2020-06-24","1157","53167","148","4767","12.8","10.4"
"Cobb","2020-06-25","1254","54421","160","4927","13.2","10.9"
"Cobb","2020-06-26","1497","55918","183","5110","13.4","11.3"
"Cobb","2020-06-27","1004","56922","148","5258","13.3","11.8"
"Cobb","2020-06-28","354","57276","52","5310","13.5","12.1"
"Cobb","2020-06-29","1674","58950","200","5510","13.4","12.3"
"Cobb","2020-06-30","1527","60477","186","5696","13","12.5"
"Cobb","2020-07-01","1641","62118","192","5888","12.9","12.8"
"Cobb","2020-07-02","1664","63782","223","6111","13","13.1"
"Cobb","2020-07-03","882","64664","128","6239","13.3","13.3"
"Cobb","2020-07-04","254","64918","32","6271","13","13.1"
"Cobb","2020-07-05","360","65278","69","6340","13.6","13.6"
"Cobb","2020-07-06","1638","66916","200","6540","13.7","13.6"
"Cobb","2020-07-07","1690","68606","232","6772","13.9","13.5"
"Cobb","2020-07-08","1709","70315","204","6976","13.9","13.4"
"Cobb","2020-07-09","2172","72487","223","7199","13.5","13.2"
"Cobb","2020-07-10","2168","74655","184","7383","12.6","13"
"Cobb","2020-07-11","1023","75678","122","7505","12.5","12.8"
"Cobb","2020-07-12","383","76061","52","7557","11.7","12.7"
"Cobb","2020-07-13","1517","77578","177","7734","11.7","12.7"
"Cobb","2020-07-14","2110","79688","220","7954","11.2","12.5"
"Cobb","2020-07-15","1518","81206","175","8129","11.1","12.5"
"Cobb","2020-07-16","1842","83048","185","8314","11.1","12.3"
"Cobb","2020-07-17","1415","84463","153","8467","11.4","12"
"Cobb","2020-07-18","748","85211","65","8532","11","11.7"
"Cobb","2020-07-19","386","85597","41","8573","10.5","11.1"
"Cobb","2020-07-20","1452","87049","169","8742","10.5","11.1"
"Cobb","2020-07-21","1247","88296","99","8841","10.2","10.7"
"Cobb","2020-07-22","1367","89663","88","8929","9.5","10.3"
"Cobb","2020-07-23","1433","91096","133","9062","9.3","10.2"
"Cobb","2020-07-24","1423","92519","100","9162","8.8","10.1"
"Cobb","2020-07-25","871","93390","74","9236","8.8","9.9"
"Cobb","2020-07-26","294","93684","16","9252","8","9.3"
"Cobb","2020-07-27","1567","95251","138","9390","7.6","9.1"
"Cobb","2020-07-28","1230","96481","102","9492","7.7","8.9"
"Cobb","2020-07-29","1745","98226","140","9632","7.9","8.7"
"Cobb","2020-07-30","1586","99812","133","9765","7.8","8.6"
"Cobb","2020-07-31","1268","101080","78","9843","7.7","8.2"
"Cobb","2020-08-01","947","102027","85","9928","7.7","8.3"
"Cobb","2020-08-02","281","102308","30","9958","8.5","8.3"
"Cobb","2020-08-03","1532","103840","119","10077","8.3","8"
"Cobb","2020-08-04","1435","105275","91","10168","8","7.9"
"Cobb","2020-08-05","1316","106591","89","10257","7.9","7.9"
"Cobb","2020-08-06","1513","108104","107","10364","7.7","7.7"
"Cobb","2020-08-07","1580","109684","103","10467","7.7","7.7"
"Cobb","2020-08-08","1068","110752","77","10544","7.5","7.6"
"Cobb","2020-08-09","368","111120","27","10571","7","7.7"
"Cobb","2020-08-10","1592","112712","93","10664","6.7","7.5"
"Cobb","2020-08-11","1488","114200","82","10746","6.6","7.3"
"Cobb","2020-08-12","1474","115674","87","10833","6.5","7.2"
"Cobb","2020-08-13","1723","117397","89","10922","6.2","6.9"
"Cobb","2020-08-14","1683","119080","70","10992","5.9","6.8"
"Cobb","2020-08-15","523","119603","36","11028","5.8","6.7"
"Cobb","2020-08-16","748","120351","56","11084","5.8","6.4"
"Cobb","2020-08-17","1052","121403","57","11141","5.8","6.3"
"Cobb","2020-08-18","1459","122862","103","11244","6","6.3"
"Cobb","2020-08-19","1376","124238","61","11305","5.8","6.1"
"Cobb","2020-08-20","1499","125737","87","11392","5.9","6.1"
"Cobb","2020-08-21","1456","127193","76","11468","6","6"
"Cobb","2020-08-22","1034","128227","45","11513","5.7","5.8"
"Cobb","2020-08-23","352","128579","30","11543","5.8","5.8"
"Cobb","2020-08-24","1487","130066","91","11634","5.9","5.9"
"Cobb","2020-08-25","1608","131674","116","11750","6","6"
"Cobb","2020-08-26","1305","132979","98","11848","6.4","6.1"
"Cobb","2020-08-27","1480","134459","108","11956","6.6","6.2"
"Cobb","2020-08-28","1543","136002","101","12057","6.8","6.4"
"Cobb","2020-08-29","705","136707","44","12101","7.1","6.4"
"Cobb","2020-08-30","367","137074","32","12133","7.1","6.5"
"Cobb","2020-08-31","1519","138593","83","12216","7","6.5"
"Cobb","2020-09-01","1557","140150","101","12317","6.9","6.4"
"Cobb","2020-09-02","1252","141402","79","12396","6.7","6.6"
"Cobb","2020-09-03","1534","142936","121","12517","6.8","6.7"
"Cobb","2020-09-04","1424","144360","86","12603","6.7","6.8"
"Cobb","2020-09-05","782","145142","53","12656","6.8","6.9"
"Cobb","2020-09-06","330","145472","17","12673","6.3","6.7"
"Cobb","2020-09-07","462","145934","24","12697","6.3","6.6"
"Cobb","2020-09-08","1939","147873","120","12817","6.2","6.6"
"Cobb","2020-09-09","1661","149534","87","12904","6.1","6.4"
"Cobb","2020-09-10","1444","150978","81","12985","5.7","6.3"
"Cobb","2020-09-11","1498","152476","73","13058","5.6","6.2"
"Cobb","2020-09-12","821","153297","35","13093","5.2","6"
"Cobb","2020-09-13","498","153795","20","13113","5.1","5.7"
"Cobb","2020-09-14","1686","155481","61","13174","4.8","5.5"
"Cobb","2020-09-15","1371","156852","70","13244","4.7","5.4"
"Cobb","2020-09-16","1597","158449","63","13307","4.5","5.3"
"Cobb","2020-09-17","1083","159532","42","13349","4.2","5"
"Cobb","2020-09-18","1420","160952","54","13403","4.1","4.8"
"Cobb","2020-09-19","939","161891","43","13446","4.1","4.7"
"Cobb","2020-09-20","317","162208","26","13472","4.7","4.9"
"Cobb","2020-09-21","1692","163900","47","13519","4.6","4.7"
"Cobb","2020-09-22","1357","165257","53","13572","4.4","4.6"
"Cobb","2020-09-23","1795","167052","47","13619","4.3","4.4"
"Cobb","2020-09-24","1535","168587","63","13682","4.3","4.3"
"Cobb","2020-09-25","1840","170427","55","13737","4.2","4.1"
"Cobb","2020-09-26","676","171103","35","13772","4.3","4.2"
"Cobb","2020-09-27","400","171503","25","13797","4","4.4"
"Cobb","2020-09-28","1484","172987","39","13836","4","4.3"
"Cobb","2020-09-29","1250","174237","44","13880","3.9","4.2"
"Cobb","2020-09-30","1557","175794","29","13909","3.8","4"
"Cobb","2020-10-01","1423","177217","49","13958","3.7","4"
"Cobb","2020-10-02","1356","178573","44","14002","3.7","4"
"Cobb","2020-10-03","779","179352","40","14042","3.7","4"
"Cobb","2020-10-04","411","179763","16","14058","3.4","3.7"
"Cobb","2020-10-05","1706","181469","61","14119","3.5","3.7"
"Cobb","2020-10-06","1599","183068","63","14182","3.6","3.7"
"Cobb","2020-10-07","1864","184932","61","14243","3.8","3.8"
"Cobb","2020-10-08","1217","186149","32","14275","3.7","3.7"
"Cobb","2020-10-09","1730","187879","56","14331","3.7","3.7"
"Cobb","2020-10-10","1017","188896","52","14383","3.7","3.7"
"Cobb","2020-10-11","451","189347","23","14406","3.8","3.6"
"Cobb","2020-10-12","1386","190733","75","14481","4.1","3.8"
"Cobb","2020-10-13","1498","192231","63","14544","4.1","3.9"
"Cobb","2020-10-14","1522","193753","68","14612","4.3","4"
"Cobb","2020-10-15","1233","194986","32","14644","4.3","4"
"Cobb","2020-10-16","1691","196677","63","14707","4.4","4"
"Cobb","2020-10-17","647","197324","38","14745","4.5","4.1"
"Cobb","2020-10-18","487","197811","22","14767","4.4","4.1"
"Cobb","2020-10-19","1624","199435","71","14838","4.3","4.2"
"Cobb","2020-10-20","1528","200963","60","14898","4.2","4.2"
"Cobb","2020-10-21","2268","203231","86","14984","4.1","4.2"
"Cobb","2020-10-22","1314","204545","89","15073","4.7","4.5"
"Cobb","2020-10-23","2124","206669","106","15179","4.9","4.6"
"Cobb","2020-10-24","874","207543","45","15224","4.8","4.6"
"Cobb","2020-10-25","623","208166","55","15279","5.4","4.9"
"Cobb","2020-10-26","1977","210143","93","15372","5.5","4.9"
"Cobb","2020-10-27","1891","212034","102","15474","5.7","4.9"
"Cobb","2020-10-28","2287","214321","107","15581","5.8","5"
"Cobb","2020-10-29","1190","215511","70","15651","5.7","5.2"
"Cobb","2020-10-30","2091","217602","111","15762","5.7","5.3"
"Cobb","2020-10-31","888","218490","54","15816","5.8","5.3"
"Cobb","2020-11-01","627","219117","58","15874","5.9","5.7"
"Cobb","2020-11-02","2010","221127","112","15986","6","5.7"
"Cobb","2020-11-03","1792","222919","100","16086","6.1","5.9"
"Cobb","2020-11-04","1859","224778","102","16188","6.2","6"
"Cobb","2020-11-05","1584","226362","90","16278","6.1","5.9"
"Cobb","2020-11-06","2047","228409","109","16387","6.1","5.9"
"Cobb","2020-11-07","1022","229431","99","16486","6.7","6.2"
"Cobb","2020-11-08","572","230003","64","16550","6.9","6.4"
"Cobb","2020-11-09","2296","232299","147","16697","7.1","6.5"
"Cobb","2020-11-10","2116","234415","152","16849","7.3","6.7"
"Cobb","2020-11-11","2633","237048","148","16997","7.3","6.7"
"Cobb","2020-11-12","1986","239034","133","17130","7.4","6.8"
"Cobb","2020-11-13","2368","241402","155","17285","7.6","6.9"
"Cobb","2020-11-14","1635","243037","116","17401","7.2","7"
"Cobb","2020-11-15","583","243620","69","17470","7.3","7.1"
"Cobb","2020-11-16","2848","246468","194","17664","7.4","7.2"
"Cobb","2020-11-17","2653","249121","171","17835","7.3","7.3"
"Cobb","2020-11-18","3391","252512","186","18021","7.3","7.3"
"Cobb","2020-11-19","2581","255093","158","18179","7.2","7.3"
"Cobb","2020-11-20","3180","258273","175","18354","7","7.3"
"Cobb","2020-11-21","2195","260468","113","18467","6.8","7"
"Cobb","2020-11-22","792","261260","69","18536","6.3","6.8"
"Cobb","2020-11-23","2885","264145","157","18693","6.1","6.8"
"Cobb","2020-11-24","2430","266575","160","18853","6.1","6.7"
"Cobb","2020-11-25","2705","269280","218","19071","6.5","6.9"
"Cobb","2020-11-26","294","269574","17","19088","6.5","6.8"
"Cobb","2020-11-27","1504","271078","147","19235","7.1","7.1"
"Cobb","2020-11-28","1133","272211","141","19376","8.1","7.4"
"Cobb","2020-11-29","723","272934","65","19441","8.2","7.2"
"Cobb","2020-11-30","2843","275777","286","19727","8.8","7.5"
"Cobb","2020-12-01","2921","278698","309","20036","9.4","7.8"
"Cobb","2020-12-02","3754","282452","322","20358","9.5","8"
"Cobb","2020-12-03","2551","285003","255","20613","10.1","8.3"
"Cobb","2020-12-04","2675","287678","226","20839","9.9","8.5"
"Cobb","2020-12-05","1893","289571","232","21071","9.8","9"
"Cobb","2020-12-06","664","290235","74","21145","10.2","9.2"
"Cobb","2020-12-07","3114","293349","326","21471","10.2","9.5"
"Cobb","2020-12-08","3232","296581","325","21796","10.1","9.8"
"Cobb","2020-12-09","3877","300458","334","22130","10.1","9.8"
"Cobb","2020-12-10","2949","303407","363","22493","10.5","10.3"
"Cobb","2020-12-11","3496","306903","361","22854","10.7","10.3"
"Cobb","2020-12-12","2126","309029","254","23108","10.7","10.3"
"Cobb","2020-12-13","673","309702","106","23214","11.4","10.8"
"Cobb","2020-12-14","3390","313092","435","23649","11.7","11"
"Cobb","2020-12-15","3585","316677","446","24095","12","11.1"
"Cobb","2020-12-16","3965","320642","396","24491","12.2","11.2"
"Cobb","2020-12-17","3842","324484","400","24891","12","11.2"
"Cobb","2020-12-18","3718","328202","417","25308","12.1","11.4"
"Cobb","2020-12-19","2547","330749","279","25587","11.9","11.3"
"Cobb","2020-12-20","800","331549","113","25700","11.7","11.5"
"Cobb","2020-12-21","4578","336127","558","26258","11.6","11.7"
"Cobb","2020-12-22","4277","340404","572","26830","11.8","11.9"
"Cobb","2020-12-23","3858","344262","428","27258","11.9","12.1"
"Cobb","2020-12-24","1237","345499","199","27457","12.7","12.3"
"Cobb","2020-12-25","343","345842","47","27504","13.1","12.6"
"Cobb","2020-12-26","1818","347660","358","27862","14.3","13.1"
"Cobb","2020-12-27","864","348524","147","28009","14.7","13.2"
"Cobb","2020-12-28","3953","352477","734","28743","15.6","13.6"
"Cobb","2020-12-29","3700","356177","651","29394","16.3","14"
"Cobb","2020-12-30","4393","360570","762","30156","17.1","14.5"
"Cobb","2020-12-31","2560","363130","411","30567","17.1","14.9"
"Cobb","2021-01-01","469","363599","85","30652","17.8","15.4"
"Cobb","2021-01-02","2493","366092","449","31101","17.5","15.9"
"Cobb","2021-01-03","913","367005","146","31247","17.4","16.1"
"Cobb","2021-01-04","4081","371086","640","31887","17","16.3"
"Cobb","2021-01-05","5289","376375","849","32736","16.8","16.5"
"Cobb","2021-01-06","5374","381749","805","33541","16.4","16.8"
"Cobb","2021-01-07","3802","385551","742","34283","16.9","17"
"Cobb","2021-01-08","3185","388736","525","34808","16.7","17.2"
"Cobb","2021-01-09","2574","391310","411","35219","16.4","17"
"Cobb","2021-01-10","872","392182","182","35401","17.1","17.2"
"Cobb","2021-01-11","3699","395881","502","35903","16.8","16.9"
"Cobb","2021-01-12","3331","399212","465","36368","16.5","16.6"
"Cobb","2021-01-13","4088","403300","555","36923","16.3","16.3"
"Cobb","2021-01-14","3298","406598","438","37361","15.4","16.1"
"Cobb","2021-01-15","2859","409457","405","37766","15.1","15.9"
"Cobb","2021-01-16","2428","411885","421","38187","15.3","15.8"
"Cobb","2021-01-17","977","412862","181","38368","14.9","16"
"Cobb","2021-01-18","2489","415351","355","38723","15","15.9"
"Cobb","2021-01-19","3444","418795","463","39186","14.9","15.7"
"Cobb","2021-01-20","3710","422505","438","39624","14.7","15.5"
"Cobb","2021-01-21","2668","425173","371","39995","14.8","15.1"
"Cobb","2021-01-22","2835","428008","355","40350","14.5","14.8"
"Cobb","2021-01-23","2359","430367","366","40716","14.3","14.8"
"Cobb","2021-01-24","883","431250","131","40847","13.8","14.3"
"Cobb","2021-01-25","3179","434429","402","41249","13.5","14.3"
"Cobb","2021-01-26","3563","437992","405","41654","13.2","14.1"
"Cobb","2021-01-27","3055","441047","323","41977","13.1","13.9"
"Cobb","2021-01-28","2651","443698","300","42277","12.7","13.7"
"Cobb","2021-01-29","2867","446565","277","42554","12.3","13.4"
"Cobb","2021-01-30","1888","448453","223","42777","11.7","13"
"Cobb","2021-01-31","771","449224","113","42890","11.7","12.7"
"Cobb","2021-02-01","2609","451833","270","43160","11.4","12.5"
"Cobb","2021-02-02","2938","454771","273","43433","11.1","12.2"
"Cobb","2021-02-03","3166","457937","246","43679","10.7","11.9"
"Cobb","2021-02-04","1986","459923","227","43906","10.7","11.7"
"Cobb","2021-02-05","1966","461889","153","44059","10.4","11.4"
"Cobb","2021-02-06","479","462368","55","44114","10.4","11.1"
"Cobb","2021-02-07","64","462432","6","44120","9.6","10.7"
"Cobb","2021-02-08","0","462432","0","44120","8.2","9.8"
"Coffee","2020-02-01","0","0","0","0",".","."
"Coffee","2020-02-02","0","0","0","0",".","."
"Coffee","2020-02-03","0","0","0","0",".","."
"Coffee","2020-02-04","0","0","0","0",".","."
"Coffee","2020-02-05","0","0","0","0",".","."
"Coffee","2020-02-06","0","0","0","0",".","."
"Coffee","2020-02-07","0","0","0","0","0","."
"Coffee","2020-02-08","0","0","0","0","0","."
"Coffee","2020-02-09","0","0","0","0","0","."
"Coffee","2020-02-10","0","0","0","0","0","."
"Coffee","2020-02-11","0","0","0","0","0","."
"Coffee","2020-02-12","0","0","0","0","0","."
"Coffee","2020-02-13","0","0","0","0","0","."
"Coffee","2020-02-14","0","0","0","0","0","0"
"Coffee","2020-02-15","0","0","0","0","0","0"
"Coffee","2020-02-16","0","0","0","0","0","0"
"Coffee","2020-02-17","0","0","0","0","0","0"
"Coffee","2020-02-18","0","0","0","0","0","0"
"Coffee","2020-02-19","0","0","0","0","0","0"
"Coffee","2020-02-20","0","0","0","0","0","0"
"Coffee","2020-02-21","0","0","0","0","0","0"
"Coffee","2020-02-22","0","0","0","0","0","0"
"Coffee","2020-02-23","0","0","0","0","0","0"
"Coffee","2020-02-24","0","0","0","0","0","0"
"Coffee","2020-02-25","0","0","0","0","0","0"
"Coffee","2020-02-26","0","0","0","0","0","0"
"Coffee","2020-02-27","0","0","0","0","0","0"
"Coffee","2020-02-28","0","0","0","0","0","0"
"Coffee","2020-02-29","0","0","0","0","0","0"
"Coffee","2020-03-01","0","0","0","0","0","0"
"Coffee","2020-03-02","0","0","0","0","0","0"
"Coffee","2020-03-03","0","0","0","0","0","0"
"Coffee","2020-03-04","0","0","0","0","0","0"
"Coffee","2020-03-05","0","0","0","0","0","0"
"Coffee","2020-03-06","0","0","0","0","0","0"
"Coffee","2020-03-07","0","0","0","0","0","0"
"Coffee","2020-03-08","0","0","0","0","0","0"
"Coffee","2020-03-09","0","0","0","0","0","0"
"Coffee","2020-03-10","0","0","0","0","0","0"
"Coffee","2020-03-11","0","0","0","0","0","0"
"Coffee","2020-03-12","2","2","0","0","0","0"
"Coffee","2020-03-13","3","5","0","0","0","0"
"Coffee","2020-03-14","0","5","0","0","0","0"
"Coffee","2020-03-15","1","6","0","0","0","0"
"Coffee","2020-03-16","2","8","0","0","0","0"
"Coffee","2020-03-17","6","14","0","0","0","0"
"Coffee","2020-03-18","6","20","1","1","2.4","1.2"
"Coffee","2020-03-19","8","28","1","2","4.2","2.1"
"Coffee","2020-03-20","12","40","0","2","4.2","2.1"
"Coffee","2020-03-21","1","41","0","2","4.2","2.1"
"Coffee","2020-03-22","2","43","0","2","4.2","2.1"
"Coffee","2020-03-23","19","62","1","3","4.9","2.5"
"Coffee","2020-03-24","20","82","3","6","7.1","3.5"
"Coffee","2020-03-25","17","99","1","7","5.5","4"
"Coffee","2020-03-26","26","125","6","13","7","5.6"
"Coffee","2020-03-27","17","142","3","16","9.6","6.9"
"Coffee","2020-03-28","8","150","4","20","16.7","10.4"
"Coffee","2020-03-29","10","160","2","22","19.6","11.9"
"Coffee","2020-03-30","27","187","4","26","20.9","12.9"
"Coffee","2020-03-31","24","211","3","29","20.6","13.8"
"Coffee","2020-04-01","28","239","7","36","23.3","14.4"
"Coffee","2020-04-02","21","260","5","41","23.4","15.2"
"Coffee","2020-04-03","20","280","5","46","24.4","17"
"Coffee","2020-04-04","0","280","0","46","17.3","17"
"Coffee","2020-04-05","1","281","0","46","14.4","17"
"Coffee","2020-04-06","18","299","5","51","16.3","18.6"
"Coffee","2020-04-07","24","323","1","52","15.1","17.8"
"Coffee","2020-04-08","30","353","5","57","13.9","18.6"
"Coffee","2020-04-09","25","378","1","58","11.1","17.2"
"Coffee","2020-04-10","13","391","2","60","9.7","17.1"
"Coffee","2020-04-11","7","398","2","62","13.8","15.5"
"Coffee","2020-04-12","11","409","0","62","13.8","14.1"
"Coffee","2020-04-13","23","432","9","71","15.4","15.9"
"Coffee","2020-04-14","28","460","2","73","15.8","15.5"
"Coffee","2020-04-15","29","489","1","74","14","13.9"
"Coffee","2020-04-16","51","540","9","83","15.9","13.5"
"Coffee","2020-04-17","46","586","2","85","14.3","12"
"Coffee","2020-04-18","18","604","3","88","12.6","13.2"
"Coffee","2020-04-19","8","612","3","91","18","15.9"
"Coffee","2020-04-20","81","693","9","100","14","14.7"
"Coffee","2020-04-21","57","750","11","111","15.7","15.8"
"Coffee","2020-04-22","50","800","4","115","16.4","15.2"
"Coffee","2020-04-23","43","843","6","121","15.8","15.9"
"Coffee","2020-04-24","36","879","5","126","17.2","15.8"
"Coffee","2020-04-25","15","894","3","129","17.7","15.2"
"Coffee","2020-04-26","8","902","2","131","15.9","16.9"
"Coffee","2020-04-27","41","943","8","139","17.1","15.5"
"Coffee","2020-04-28","56","999","9","148","16.6","16.2"
"Coffee","2020-04-29","44","1043","6","154","17.4","16.9"
"Coffee","2020-04-30","76","1119","5","159","16.4","16.1"
"Coffee","2020-05-01","25","1144","2","161","15.5","16.4"
"Coffee","2020-05-02","30","1174","6","167","15.5","16.6"
"Coffee","2020-05-03","17","1191","0","167","12","13.9"
"Coffee","2020-05-04","85","1276","5","172","10","13.6"
"Coffee","2020-05-05","51","1327","6","178","9.4","13"
"Coffee","2020-05-06","103","1430","5","183","8.2","12.8"
"Coffee","2020-05-07","48","1478","4","187","8.4","12.4"
"Coffee","2020-05-08","51","1529","5","192","8.7","12.1"
"Coffee","2020-05-09","29","1558","0","192","5.8","10.7"
"Coffee","2020-05-10","7","1565","2","194","9.9","10.9"
"Coffee","2020-05-11","52","1617","5","199","10.4","10.2"
"Coffee","2020-05-12","141","1758","9","208","9.7","9.5"
"Coffee","2020-05-13","168","1926","7","215","9.6","8.9"
"Coffee","2020-05-14","148","2074","16","231","9.9","9.2"
"Coffee","2020-05-15","4","2078","0","231","8.5","8.6"
"Coffee","2020-05-16","60","2138","8","239","10.4","8.1"
"Coffee","2020-05-17","17","2155","1","240","7.2","8.5"
"Coffee","2020-05-18","85","2240","23","263","9.7","10"
"Coffee","2020-05-19","94","2334","4","267","9.4","9.5"
"Coffee","2020-05-20","8","2342","1","268","10.5","10.1"
"Coffee","2020-05-21","99","2441","6","274","9.9","9.9"
"Coffee","2020-05-22","52","2493","4","278","11","9.7"
"Coffee","2020-05-23","11","2504","0","278","9.1","9.7"
"Coffee","2020-05-24","8","2512","0","278","8.2","7.7"
"Coffee","2020-05-25","11","2523","1","279","5.7","7.7"
"Coffee","2020-05-26","42","2565","2","281","5.7","7.5"
"Coffee","2020-05-27","59","2624","5","286","5.2","7.9"
"Coffee","2020-05-28","171","2795","9","295","5","7.5"
"Coffee","2020-05-29","65","2860","3","298","4.6","7.8"
"Coffee","2020-05-30","8","2868","0","298","4.6","6.8"
"Coffee","2020-05-31","48","2916","6","304","6.4","7.3"
"Coffee","2020-06-01","124","3040","13","317","6.6","6.1"
"Coffee","2020-06-02","65","3105","5","322","7","6.4"
"Coffee","2020-06-03","126","3231","16","338","7.6","6.4"
"Coffee","2020-06-04","123","3354","20","358","9.2","7.1"
"Coffee","2020-06-05","110","3464","7","365","9.4","7"
"Coffee","2020-06-06","87","3551","11","376","11.2","7.9"
"Coffee","2020-06-07","5","3556","3","379","18","12.2"
"Coffee","2020-06-08","106","3662","10","389","17.9","12.2"
"Coffee","2020-06-09","95","3757","11","400","18.4","12.7"
"Coffee","2020-06-10","78","3835","10","410","18.4","13"
"Coffee","2020-06-11","131","3966","23","433","18.6","13.9"
"Coffee","2020-06-12","236","4202","15","448","18.6","14"
"Coffee","2020-06-13","18","4220","3","451","19.2","15.2"
"Coffee","2020-06-14","61","4281","7","458","12.3","15.1"
"Coffee","2020-06-15","175","4456","25","483","13","15.4"
"Coffee","2020-06-16","195","4651","13","496","12.3","15.3"
"Coffee","2020-06-17","176","4827","35","531","13.3","15.9"
"Coffee","2020-06-18","198","5025","21","552","12.3","15.5"
"Coffee","2020-06-19","149","5174","21","573","13.4","16"
"Coffee","2020-06-20","82","5256","15","588","13.6","16.4"
"Coffee","2020-06-21","13","5269","2","590","14.2","13.2"
"Coffee","2020-06-22","200","5469","48","638","15.6","14.3"
"Coffee","2020-06-23","230","5699","14","652","15.5","13.9"
"Coffee","2020-06-24","321","6020","46","698","14.7","14"
"Coffee","2020-06-25","115","6135","25","723","16.3","14.3"
"Coffee","2020-06-26","205","6340","21","744","15.7","14.6"
"Coffee","2020-06-27","104","6444","17","761","15.4","14.5"
"Coffee","2020-06-28","16","6460","6","767","18.6","16.4"
"Coffee","2020-06-29","185","6645","27","794","17.3","16.4"
"Coffee","2020-06-30","252","6897","30","824","18.1","16.8"
"Coffee","2020-07-01","39","6936","11","835","20.1","17.4"
"Coffee","2020-07-02","153","7089","20","855","18.8","17.6"
"Coffee","2020-07-03","141","7230","19","874","19.3","17.5"
"Coffee","2020-07-04","22","7252","6","880","20.9","18.2"
"Coffee","2020-07-05","12","7264","8","888","25","21.8"
"Coffee","2020-07-06","237","7501","54","942","26.2","21.7"
"Coffee","2020-07-07","147","7648","20","962","26.4","22.3"
"Coffee","2020-07-08","164","7812","19","981","24.1","22.1"
"Coffee","2020-07-09","223","8035","26","1007","23.9","21.4"
"Coffee","2020-07-10","48","8083","13","1020","25.8","22.6"
"Coffee","2020-07-11","106","8189","12","1032","23.5","22.2"
"Coffee","2020-07-12","23","8212","6","1038","17.7","21.4"
"Coffee","2020-07-13","148","8360","39","1077","18.2","22.2"
"Coffee","2020-07-14","165","8525","26","1103","18.5","22.5"
"Coffee","2020-07-15","33","8558","10","1113","21.2","22.6"
"Coffee","2020-07-16","196","8754","25","1138","21.4","22.6"
"Coffee","2020-07-17","37","8791","7","1145","20.2","23"
"Coffee","2020-07-18","72","8863","17","1162","22","22.7"
"Coffee","2020-07-19","21","8884","10","1172","25","21.4"
"Coffee","2020-07-20","217","9101","31","1203","23.3","20.8"
"Coffee","2020-07-21","258","9359","26","1229","22.5","20.5"
"Coffee","2020-07-22","105","9464","9","1238","19.4","20.3"
"Coffee","2020-07-23","230","9694","20","1258","18.8","20.1"
"Coffee","2020-07-24","25","9719","4","1262","18.4","19.3"
"Coffee","2020-07-25","133","9852","22","1284","17.4","19.7"
"Coffee","2020-07-26","19","9871","6","1290","15.1","20.1"
"Coffee","2020-07-27","162","10033","34","1324","16.1","19.7"
"Coffee","2020-07-28","187","10220","19","1343","16.1","19.3"
"Coffee","2020-07-29","110","10330","21","1364","17.6","18.5"
"Coffee","2020-07-30","144","10474","11","1375","17.4","18.1"
"Coffee","2020-07-31","23","10497","4","1379","17.6","18"
"Coffee","2020-08-01","140","10637","25","1404","17.8","17.6"
"Coffee","2020-08-02","10","10647","2","1406","16.2","15.6"
"Coffee","2020-08-03","178","10825","36","1442","16.1","16.1"
"Coffee","2020-08-04","151","10976","25","1467","17","16.5"
"Coffee","2020-08-05","126","11102","8","1475","15.1","16.4"
"Coffee","2020-08-06","136","11238","13","1488","15.4","16.4"
"Coffee","2020-08-07","35","11273","10","1498","17","17.3"
"Coffee","2020-08-08","208","11481","43","1541","17.4","17.6"
"Coffee","2020-08-09","14","11495","4","1545","18.6","17.4"
"Coffee","2020-08-10","144","11639","20","1565","17.7","16.9"
"Coffee","2020-08-11","175","11814","28","1593","17.7","17.3"
"Coffee","2020-08-12","130","11944","18","1611","18.7","16.9"
"Coffee","2020-08-13","135","12079","13","1624","18.7","17.1"
"Coffee","2020-08-14","28","12107","4","1628","16.7","16.9"
"Coffee","2020-08-15","9","12116","0","1628","13.7","15.6"
"Coffee","2020-08-16","127","12243","23","1651","12.3","15.4"
"Coffee","2020-08-17","45","12288","11","1662","13.8","15.7"
"Coffee","2020-08-18","158","12446","34","1696","14.5","16.1"
"Coffee","2020-08-19","99","12545","14","1710","14.6","16.7"
"Coffee","2020-08-20","138","12683","16","1726","14.9","16.8"
"Coffee","2020-08-21","28","12711","3","1729","14.4","15.5"
"Coffee","2020-08-22","107","12818","9","1738","15.6","14.7"
"Coffee","2020-08-23","10","12828","3","1741","17.3","14.8"
"Coffee","2020-08-24","156","12984","25","1766","16.1","14.9"
"Coffee","2020-08-25","131","13115","10","1776","14.1","14.3"
"Coffee","2020-08-26","144","13259","14","1790","13.4","14"
"Coffee","2020-08-27","102","13361","6","1796","12.6","13.7"
"Coffee","2020-08-28","24","13385","1","1797","11.7","13"
"Coffee","2020-08-29","113","13498","14","1811","12.3","13.9"
"Coffee","2020-08-30","9","13507","2","1813","11.1","14.2"
"Coffee","2020-08-31","168","13675","23","1836","10.8","13.4"
"Coffee","2020-09-01","149","13824","10","1846","10.7","12.4"
"Coffee","2020-09-02","144","13968","10","1856","10.3","11.9"
"Coffee","2020-09-03","128","14096","17","1873","11.3","12"
"Coffee","2020-09-04","20","14116","1","1874","11.5","11.6"
"Coffee","2020-09-05","127","14243","10","1884","10.8","11.5"
"Coffee","2020-09-06","5","14248","2","1886","13.4","12.3"
"Coffee","2020-09-07","61","14309","6","1892","12.8","11.8"
"Coffee","2020-09-08","137","14446","18","1910","13.7","12.2"
"Coffee","2020-09-09","107","14553","19","1929","15.3","12.8"
"Coffee","2020-09-10","82","14635","7","1936","14.6","13"
"Coffee","2020-09-11","29","14664","0","1936","13.9","12.7"
"Coffee","2020-09-12","96","14760","4","1940","13.3","12.1"
"Coffee","2020-09-13","7","14767","3","1943","13.8","13.6"
"Coffee","2020-09-14","144","14911","14","1957","13.7","13.3"
"Coffee","2020-09-15","154","15065","9","1966","12.7","13.2"
"Coffee","2020-09-16","94","15159","10","1976","11.7","13.5"
"Coffee","2020-09-17","29","15188","1","1977","11","12.8"
"Coffee","2020-09-18","27","15215","7","1984","14.7","14.3"
"Coffee","2020-09-19","105","15320","18","2002","16.5","14.9"
"Coffee","2020-09-20","9","15329","1","2003","12","12.9"
"Coffee","2020-09-21","83","15412","10","2013","12.3","13"
"Coffee","2020-09-22","85","15497","11","2024","13.3","13"
"Coffee","2020-09-23","84","15581","6","2030","12.8","12.3"
"Coffee","2020-09-24","85","15666","8","2038","13.7","12.3"
"Coffee","2020-09-25","13","15679","1","2039","11.1","12.9"
"Coffee","2020-09-26","64","15743","2","2041","9.1","12.8"
"Coffee","2020-09-27","4","15747","1","2042","11.1","11.5"
"Coffee","2020-09-28","93","15840","14","2056","11.5","11.9"
"Coffee","2020-09-29","71","15911","2","2058","10","11.7"
"Coffee","2020-09-30","78","15989","4","2062","9.7","11.3"
"Coffee","2020-10-01","91","16080","5","2067","9.2","11.4"
"Coffee","2020-10-02","20","16100","1","2068","8.8","9.9"
"Coffee","2020-10-03","41","16141","3","2071","9.4","9.2"
"Coffee","2020-10-04","19","16160","2","2073","7.3","9.2"
"Coffee","2020-10-05","141","16301","12","2085","6.4","8.9"
"Coffee","2020-10-06","110","16411","3","2088","6.4","8.2"
"Coffee","2020-10-07","96","16507","8","2096","6.8","8.3"
"Coffee","2020-10-08","83","16590","1","2097","6.2","7.7"
"Coffee","2020-10-09","55","16645","0","2097","5.5","7.2"
"Coffee","2020-10-10","61","16706","10","2107","6.8","8.1"
"Coffee","2020-10-11","1","16707","0","2107","5.3","6.3"
"Coffee","2020-10-12","48","16755","2","2109","4.7","5.5"
"Coffee","2020-10-13","95","16850","6","2115","5.2","5.8"
"Coffee","2020-10-14","87","16937","7","2122","5.2","6"
"Coffee","2020-10-15","60","16997","1","2123","5.2","5.7"
"Coffee","2020-10-16","8","17005","1","2124","7","6.3"
"Coffee","2020-10-17","69","17074","3","2127","5.3","6.1"
"Coffee","2020-10-18","5","17079","0","2127","5.3","5.3"
"Coffee","2020-10-19","88","17167","8","2135","6","5.3"
"Coffee","2020-10-20","119","17286","10","2145","6.3","5.7"
"Coffee","2020-10-21","85","17371","5","2150","6","5.6"
"Coffee","2020-10-22","73","17444","7","2157","7.1","6.2"
"Coffee","2020-10-23","22","17466","1","2158","6","6.5"
"Coffee","2020-10-24","78","17544","10","2168","7.2","6.2"
"Coffee","2020-10-25","9","17553","1","2169","8.8","7"
"Coffee","2020-10-26","106","17659","10","2179","8.8","7.4"
"Coffee","2020-10-27","85","17744","12","2191","9.6","8"
"Coffee","2020-10-28","70","17814","5","2196","9.8","7.9"
"Coffee","2020-10-29","69","17883","5","2201","9.5","8.3"
"Coffee","2020-10-30","21","17904","2","2203","10.2","8.1"
"Coffee","2020-10-31","76","17980","7","2210","9.7","8.4"
"Coffee","2020-11-01","9","17989","3","2213","12.9","10.8"
"Coffee","2020-11-02","82","18071","10","2223","13.3","11"
"Coffee","2020-11-03","32","18103","6","2229","13.9","11.8"
"Coffee","2020-11-04","101","18204","18","2247","15.4","12.6"
"Coffee","2020-11-05","95","18299","8","2255","15.6","12.5"
"Coffee","2020-11-06","30","18329","7","2262","17.6","13.9"
"Coffee","2020-11-07","56","18385","8","2270","18.3","14"
"Coffee","2020-11-08","8","18393","4","2274","20.7","16.8"
"Coffee","2020-11-09","68","18461","9","2283","20.8","17"
"Coffee","2020-11-10","33","18494","1","2284","18.6","16.3"
"Coffee","2020-11-11","88","18582","13","2297","18.2","16.8"
"Coffee","2020-11-12","104","18686","11","2308","18.5","17"
"Coffee","2020-11-13","22","18708","6","2314","19","18.3"
"Coffee","2020-11-14","98","18806","19","2333","19.8","19"
"Coffee","2020-11-15","5","18811","3","2336","21.2","20.9"
"Coffee","2020-11-16","60","18871","11","2347","21.9","21.4"
"Coffee","2020-11-17","54","18925","4","2351","22.5","20.6"
"Coffee","2020-11-18","144","19069","13","2364","21.7","19.9"
"Coffee","2020-11-19","98","19167","9","2373","21.5","20"
"Coffee","2020-11-20","25","19192","1","2374","18.2","18.6"
"Coffee","2020-11-21","139","19331","22","2396","17.7","18.7"
"Coffee","2020-11-22","16","19347","4","2400","12.7","16.9"
"Coffee","2020-11-23","114","19461","22","2422","12.8","17.4"
"Coffee","2020-11-24","28","19489","6","2428","14.8","18.7"
"Coffee","2020-11-25","117","19606","19","2447","15.9","18.8"
"Coffee","2020-11-26","7","19613","2","2449","18.6","20.1"
"Coffee","2020-11-27","27","19640","6","2455","21.2","19.7"
"Coffee","2020-11-28","97","19737","23","2478","22.4","20"
"Coffee","2020-11-29","17","19754","8","2486","25.5","19.1"
"Coffee","2020-11-30","182","19936","48","2534","26.5","19.7"
"Coffee","2020-12-01","55","19991","10","2544","26.1","20.4"
"Coffee","2020-12-02","208","20199","38","2582","26.3","21.1"
"Coffee","2020-12-03","175","20374","37","2619","25.3","22"
"Coffee","2020-12-04","32","20406","9","2628","26.1","23.7"
"Coffee","2020-12-05","98","20504","27","2655","26.7","24.5"
"Coffee","2020-12-06","16","20520","4","2659","23.5","24.5"
"Coffee","2020-12-07","208","20728","25","2684","21.5","24"
"Coffee","2020-12-08","67","20795","10","2694","21","23.5"
"Coffee","2020-12-09","203","20998","38","2732","21.1","23.7"
"Coffee","2020-12-10","237","21235","34","2766","20.1","22.7"
"Coffee","2020-12-11","40","21275","11","2777","20","23.1"
"Coffee","2020-12-12","202","21477","30","2807","18.2","22.4"
"Coffee","2020-12-13","23","21500","5","2812","17.7","20.6"
"Coffee","2020-12-14","246","21746","46","2858","18.7","20.1"
"Coffee","2020-12-15","52","21798","14","2872","20.4","20.7"
"Coffee","2020-12-16","257","22055","47","2919","20.3","20.7"
"Coffee","2020-12-17","211","22266","27","2946","20.1","20.1"
"Coffee","2020-12-18","34","22300","7","2953","19.1","19.6"
"Coffee","2020-12-19","187","22487","31","2984","19.4","18.8"
"Coffee","2020-12-20","26","22513","10","2994","21.8","19.7"
"Coffee","2020-12-21","156","22669","34","3028","22.2","20.4"
"Coffee","2020-12-22","48","22717","14","3042","22.5","21.5"
"Coffee","2020-12-23","218","22935","58","3100","23.7","22"
"Coffee","2020-12-24","36","22971","12","3112","26.6","23.4"
"Coffee","2020-12-25","4","22975","2","3114","30.8","25"
"Coffee","2020-12-26","107","23082","27","3141","32.1","25.7"
"Coffee","2020-12-27","13","23095","9","3150","36.5","29.1"
"Coffee","2020-12-28","168","23263","34","3184","36.3","29.2"
"Coffee","2020-12-29","79","23342","19","3203","35.5","29"
"Coffee","2020-12-30","264","23606","58","3261","34.9","29.3"
"Coffee","2020-12-31","74","23680","23","3284","34.5","30.6"
"Coffee","2021-01-01","4","23684","0","3284","27.4","29.1"
"Coffee","2021-01-02","151","23835","41","3325","27.7","29.9"
"Coffee","2021-01-03","5","23840","1","3326","20.6","28.6"
"Coffee","2021-01-04","267","24107","62","3388","21.1","28.7"
"Coffee","2021-01-05","118","24225","34","3422","21.7","28.6"
"Coffee","2021-01-06","271","24496","41","3463","20.8","27.8"
"Coffee","2021-01-07","200","24696","29","3492","18.4","26.5"
"Coffee","2021-01-08","53","24749","11","3503","21.4","24.4"
"Coffee","2021-01-09","210","24959","26","3529","19.3","23.5"
"Coffee","2021-01-10","26","24985","4","3533","18.6","19.6"
"Coffee","2021-01-11","63","25048","14","3547","18.5","19.8"
"Coffee","2021-01-12","97","25145","21","3568","17.4","19.6"
"Coffee","2021-01-13","65","25210","5","3573","16.4","18.6"
"Coffee","2021-01-14","146","25356","17","3590","16","17.2"
"Coffee","2021-01-15","49","25405","7","3597","15","18.2"
"Coffee","2021-01-16","29","25434","8","3605","17.2","18.2"
"Coffee","2021-01-17","23","25457","2","3607","16.3","17.4"
"Coffee","2021-01-18","73","25530","8","3615","14.6","16.5"
"Coffee","2021-01-19","76","25606","9","3624","13.2","15.3"
"Coffee","2021-01-20","110","25716","13","3637","13.8","15.1"
"Coffee","2021-01-21","134","25850","10","3647","13.2","14.6"
"Coffee","2021-01-22","74","25924","11","3658","13.3","14.2"
"Coffee","2021-01-23","25","25949","11","3669","15.7","16.4"
"Coffee","2021-01-24","28","25977","7","3676","18","17.1"
"Coffee","2021-01-25","106","26083","21","3697","19.3","17"
"Coffee","2021-01-26","118","26201","19","3716","19.9","16.6"
"Coffee","2021-01-27","71","26272","17","3733","21.6","17.7"
"Coffee","2021-01-28","120","26392","20","3753","22.9","18.1"
"Coffee","2021-01-29","63","26455","8","3761","22.6","18"
"Coffee","2021-01-30","31","26486","5","3766","18.6","17.1"
"Coffee","2021-01-31","12","26498","3","3769","18.6","18.3"
"Coffee","2021-02-01","89","26587","13","3782","17.9","18.6"
"Coffee","2021-02-02","78","26665","10","3792","17.4","18.6"
"Coffee","2021-02-03","79","26744","13","3805","16.3","19"
"Coffee","2021-02-04","102","26846","11","3816","15.5","19.2"
"Coffee","2021-02-05","57","26903","11","3827","16.4","19.5"
"Coffee","2021-02-06","1","26904","0","3827","14.1","16.4"
"Coffee","2021-02-07","0","26904","0","3827","10.6","14.6"
"Coffee","2021-02-08","0","26904","0","3827","8.5","13.2"
"Colquitt","2020-02-01","0","0","0","0",".","."
"Colquitt","2020-02-02","0","0","0","0",".","."
"Colquitt","2020-02-03","0","0","0","0",".","."
"Colquitt","2020-02-04","0","0","0","0",".","."
"Colquitt","2020-02-05","0","0","0","0",".","."
"Colquitt","2020-02-06","0","0","0","0",".","."
"Colquitt","2020-02-07","0","0","0","0","0","."
"Colquitt","2020-02-08","0","0","0","0","0","."
"Colquitt","2020-02-09","0","0","0","0","0","."
"Colquitt","2020-02-10","0","0","0","0","0","."
"Colquitt","2020-02-11","0","0","0","0","0","."
"Colquitt","2020-02-12","0","0","0","0","0","."
"Colquitt","2020-02-13","0","0","0","0","0","."
"Colquitt","2020-02-14","0","0","0","0","0","0"
"Colquitt","2020-02-15","0","0","0","0","0","0"
"Colquitt","2020-02-16","0","0","0","0","0","0"
"Colquitt","2020-02-17","0","0","0","0","0","0"
"Colquitt","2020-02-18","0","0","0","0","0","0"
"Colquitt","2020-02-19","0","0","0","0","0","0"
"Colquitt","2020-02-20","0","0","0","0","0","0"
"Colquitt","2020-02-21","0","0","0","0","0","0"
"Colquitt","2020-02-22","0","0","0","0","0","0"
"Colquitt","2020-02-23","0","0","0","0","0","0"
"Colquitt","2020-02-24","0","0","0","0","0","0"
"Colquitt","2020-02-25","0","0","0","0","0","0"
"Colquitt","2020-02-26","0","0","0","0","0","0"
"Colquitt","2020-02-27","0","0","0","0","0","0"
"Colquitt","2020-02-28","0","0","0","0","0","0"
"Colquitt","2020-02-29","0","0","0","0","0","0"
"Colquitt","2020-03-01","0","0","0","0","0","0"
"Colquitt","2020-03-02","0","0","0","0","0","0"
"Colquitt","2020-03-03","0","0","0","0","0","0"
"Colquitt","2020-03-04","0","0","0","0","0","0"
"Colquitt","2020-03-05","0","0","0","0","0","0"
"Colquitt","2020-03-06","0","0","0","0","0","0"
"Colquitt","2020-03-07","0","0","0","0","0","0"
"Colquitt","2020-03-08","0","0","0","0","0","0"
"Colquitt","2020-03-09","0","0","0","0","0","0"
"Colquitt","2020-03-10","0","0","0","0","0","0"
"Colquitt","2020-03-11","0","0","0","0","0","0"
"Colquitt","2020-03-12","0","0","0","0","0","0"
"Colquitt","2020-03-13","1","1","0","0","0","0"
"Colquitt","2020-03-14","0","1","0","0","0","0"
"Colquitt","2020-03-15","2","3","0","0","0","0"
"Colquitt","2020-03-16","3","6","0","0","0","0"
"Colquitt","2020-03-17","8","14","2","2","3.6","1.8"
"Colquitt","2020-03-18","6","20","0","2","3.6","1.8"
"Colquitt","2020-03-19","4","24","1","3","7.1","3.6"
"Colquitt","2020-03-20","7","31","1","4","9.2","4.6"
"Colquitt","2020-03-21","4","35","0","4","9.2","4.6"
"Colquitt","2020-03-22","6","41","4","8","18.7","9.4"
"Colquitt","2020-03-23","11","52","4","12","23.9","12"
"Colquitt","2020-03-24","31","83","7","19","23.6","13.6"
"Colquitt","2020-03-25","22","105","3","22","25.5","14.5"
"Colquitt","2020-03-26","16","121","6","28","27.3","17.2"
"Colquitt","2020-03-27","7","128","3","31","31.4","20.3"
"Colquitt","2020-03-28","4","132","1","32","34.9","22.1"
"Colquitt","2020-03-29","0","132","0","32","25.4","22.1"
"Colquitt","2020-03-30","2","134","1","33","27.4","25.6"
"Colquitt","2020-03-31","2","136","2","35","38.4","31"
"Colquitt","2020-04-01","4","140","2","37","43.6","34.6"
"Colquitt","2020-04-02","5","145","1","38","41.1","34.2"
"Colquitt","2020-04-03","2","147","1","39","42.1","36.8"
"Colquitt","2020-04-04","0","147","0","39","38.6","36.8"
"Colquitt","2020-04-05","1","148","0","39","38.6","32"
"Colquitt","2020-04-06","3","151","1","40","36.2","31.8"
"Colquitt","2020-04-07","6","157","0","40","21.9","30.2"
"Colquitt","2020-04-08","2","159","0","40","14.8","29.2"
"Colquitt","2020-04-09","1","160","0","40","11.9","26.5"
"Colquitt","2020-04-10","5","165","1","41","7.6","24.9"
"Colquitt","2020-04-11","5","170","0","41","7.6","23.1"
"Colquitt","2020-04-12","11","181","4","45","12.8","25.7"
"Colquitt","2020-04-13","24","205","7","52","12.2","24.2"
"Colquitt","2020-04-14","44","249","14","66","16.8","19.3"
"Colquitt","2020-04-15","30","279","4","70","18.7","16.7"
"Colquitt","2020-04-16","39","318","6","76","20.9","16.4"
"Colquitt","2020-04-17","36","354","4","80","19.6","13.6"
"Colquitt","2020-04-18","19","373","3","83","21.9","14.7"
"Colquitt","2020-04-19","7","380","1","84","18.7","15.8"
"Colquitt","2020-04-20","16","396","4","88","18.1","15.2"
"Colquitt","2020-04-21","50","446","5","93","15","15.9"
"Colquitt","2020-04-22","38","484","6","99","15.3","17"
"Colquitt","2020-04-23","28","512","4","103","15.2","18"
"Colquitt","2020-04-24","20","532","5","108","17.2","18.4"
"Colquitt","2020-04-25","22","554","0","108","14.9","18.4"
"Colquitt","2020-04-26","8","562","1","109","14.7","16.7"
"Colquitt","2020-04-27","28","590","3","112","12.6","15.4"
"Colquitt","2020-04-28","44","634","3","115","12.2","13.6"
"Colquitt","2020-04-29","110","744","9","124","11.1","13.2"
"Colquitt","2020-04-30","59","803","4","128","10","12.6"
"Colquitt","2020-05-01","63","866","6","134","7.8","12.5"
"Colquitt","2020-05-02","36","902","2","136","8.6","11.7"
"Colquitt","2020-05-03","18","920","1","137","7.6","11.1"
"Colquitt","2020-05-04","52","972","6","143","7.7","10.2"
"Colquitt","2020-05-05","43","1015","2","145","7.4","9.8"
"Colquitt","2020-05-06","30","1045","6","151","9.1","10.1"
"Colquitt","2020-05-07","30","1075","4","155","10","10"
"Colquitt","2020-05-08","66","1141","14","169","11.7","9.7"
"Colquitt","2020-05-09","26","1167","5","174","13.6","11.1"
"Colquitt","2020-05-10","38","1205","10","184","16.6","12.1"
"Colquitt","2020-05-11","75","1280","8","192","16.5","12.1"
"Colquitt","2020-05-12","54","1334","18","210","20.6","14"
"Colquitt","2020-05-13","20","1354","3","213","19.9","14.5"
"Colquitt","2020-05-14","80","1434","1","214","18.1","14.1"
"Colquitt","2020-05-15","110","1544","29","243","18.9","15.3"
"Colquitt","2020-05-16","38","1582","8","251","19.1","16.4"
"Colquitt","2020-05-17","52","1634","28","279","23.1","19.8"
"Colquitt","2020-05-18","118","1752","31","310","25.3","20.9"
"Colquitt","2020-05-19","93","1845","32","342","25.5","23"
"Colquitt","2020-05-20","84","1929","4","346","24","21.9"
"Colquitt","2020-05-21","228","2157","74","420","28.5","23.3"
"Colquitt","2020-05-22","140","2297","9","429","25.6","22.2"
"Colquitt","2020-05-23","69","2366","14","443","25.5","22.3"
"Colquitt","2020-05-24","33","2399","6","449","20.4","21.7"
"Colquitt","2020-05-25","17","2416","3","452","19.2","22.2"
"Colquitt","2020-05-26","96","2512","15","467","16.5","21"
"Colquitt","2020-05-27","127","2639","10","477","16.9","20.5"
"Colquitt","2020-05-28","38","2677","4","481","13.8","21.1"
"Colquitt","2020-05-29","72","2749","8","489","14.5","20"
"Colquitt","2020-05-30","41","2790","7","496","14","19.8"
"Colquitt","2020-05-31","33","2823","7","503","14.4","17.4"
"Colquitt","2020-06-01","74","2897","14","517","14.6","16.9"
"Colquitt","2020-06-02","99","2996","22","539","15.6","16"
"Colquitt","2020-06-03","96","3092","5","544","15.2","16.1"
"Colquitt","2020-06-04","106","3198","12","556","15.3","14.5"
"Colquitt","2020-06-05","214","3412","17","573","14.8","14.7"
"Colquitt","2020-06-06","9","3421","3","576","17.2","15.6"
"Colquitt","2020-06-07","29","3450","6","582","17.1","15.8"
"Colquitt","2020-06-08","173","3623","16","598","15.7","15.2"
"Colquitt","2020-06-09","137","3760","34","632","16.1","15.8"
"Colquitt","2020-06-10","127","3887","15","647","17","16.1"
"Colquitt","2020-06-11","163","4050","23","670","17.4","16.4"
"Colquitt","2020-06-12","131","4181","16","686","18","16.4"
"Colquitt","2020-06-13","7","4188","4","690","21.4","19.3"
"Colquitt","2020-06-14","144","4332","27","717","21.2","19.1"
"Colquitt","2020-06-15","160","4492","22","739","21.8","18.8"
"Colquitt","2020-06-16","144","4636","26","765","20.8","18.5"
"Colquitt","2020-06-17","73","4709","10","775","21.1","19.1"
"Colquitt","2020-06-18","164","4873","29","804","21.6","19.5"
"Colquitt","2020-06-19","152","5025","22","826","21.9","20"
"Colquitt","2020-06-20","73","5098","11","837","15.9","18.7"
"Colquitt","2020-06-21","27","5125","8","845","17.5","19.3"
"Colquitt","2020-06-22","234","5359","37","882","17.8","19.8"
"Colquitt","2020-06-23","214","5573","45","927","18.2","19.5"
"Colquitt","2020-06-24","65","5638","16","943","19.8","20.4"
"Colquitt","2020-06-25","252","5890","59","1002","20.6","21.1"
"Colquitt","2020-06-26","233","6123","26","1028","20.1","21"
"Colquitt","2020-06-27","161","6284","18","1046","19.5","17.7"
"Colquitt","2020-06-28","19","6303","5","1051","19.1","18.3"
"Colquitt","2020-06-29","286","6589","60","1111","19.8","18.8"
"Colquitt","2020-06-30","259","6848","44","1155","19.2","18.7"
"Colquitt","2020-07-01","72","6920","9","1164","17.5","18.6"
"Colquitt","2020-07-02","299","7219","45","1209","16.3","18.4"
"Colquitt","2020-07-03","206","7425","35","1244","17.1","18.6"
"Colquitt","2020-07-04","11","7436","1","1245","16.8","18.2"
"Colquitt","2020-07-05","10","7446","2","1247","15.9","17.5"
"Colquitt","2020-07-06","227","7673","26","1273","14.6","17.2"
"Colquitt","2020-07-07","192","7865","32","1305","14.5","16.9"
"Colquitt","2020-07-08","64","7929","12","1317","15.4","16.5"
"Colquitt","2020-07-09","237","8166","22","1339","14.6","15.5"
"Colquitt","2020-07-10","143","8309","14","1353","13.6","15.4"
"Colquitt","2020-07-11","78","8387","5","1358","13.2","15"
"Colquitt","2020-07-12","13","8400","2","1360","12.5","14.2"
"Colquitt","2020-07-13","205","8605","22","1382","12.4","13.5"
"Colquitt","2020-07-14","169","8774","23","1405","12","13.3"
"Colquitt","2020-07-15","69","8843","11","1416","11.6","13.5"
"Colquitt","2020-07-16","201","9044","17","1433","11.5","13"
"Colquitt","2020-07-17","182","9226","23","1456","11.9","12.7"
"Colquitt","2020-07-18","69","9295","7","1463","12.4","12.8"
"Colquitt","2020-07-19","24","9319","9","1472","15.6","14.1"
"Colquitt","2020-07-20","207","9526","12","1484","14.9","13.7"
"Colquitt","2020-07-21","189","9715","13","1497","13.9","13"
"Colquitt","2020-07-22","107","9822","18","1515","14","12.8"
"Colquitt","2020-07-23","171","9993","12","1527","13.8","12.7"
"Colquitt","2020-07-24","156","10149","16","1543","13.5","12.7"
"Colquitt","2020-07-25","58","10207","10","1553","14.5","13.5"
"Colquitt","2020-07-26","18","10225","4","1557","12.3","13.9"
"Colquitt","2020-07-27","158","10383","10","1567","12.4","13.6"
"Colquitt","2020-07-28","124","10507","5","1572","12","12.9"
"Colquitt","2020-07-29","17","10524","1","1573","10.4","12.2"
"Colquitt","2020-07-30","143","10667","18","1591","11.2","12.5"
"Colquitt","2020-07-31","104","10771","15","1606","11.8","12.7"
"Colquitt","2020-08-01","61","10832","4","1610","10.3","12.4"
"Colquitt","2020-08-02","6","10838","2","1612","11.9","12.1"
"Colquitt","2020-08-03","121","10959","11","1623","12.3","12.3"
"Colquitt","2020-08-04","43","11002","2","1625","12.4","12.2"
"Colquitt","2020-08-05","158","11160","14","1639","12.8","11.6"
"Colquitt","2020-08-06","50","11210","5","1644","12.4","11.8"
"Colquitt","2020-08-07","182","11392","13","1657","11.4","11.6"
"Colquitt","2020-08-08","93","11485","1","1658","10.6","10.4"
"Colquitt","2020-08-09","64","11549","3","1661","6.5","9.2"
"Colquitt","2020-08-10","161","11710","14","1675","6.4","9.4"
"Colquitt","2020-08-11","112","11822","12","1687","7.3","9.8"
"Colquitt","2020-08-12","185","12007","9","1696","6.7","9.8"
"Colquitt","2020-08-13","74","12081","6","1702","6.5","9.4"
"Colquitt","2020-08-14","158","12239","9","1711","6.3","8.8"
"Colquitt","2020-08-15","95","12334","8","1719","7.3","9"
"Colquitt","2020-08-16","70","12404","3","1722","7.3","6.9"
"Colquitt","2020-08-17","75","12479","4","1726","6.8","6.6"
"Colquitt","2020-08-18","88","12567","5","1731","6.1","6.7"
"Colquitt","2020-08-19","210","12777","20","1751","6.7","6.7"
"Colquitt","2020-08-20","105","12882","9","1760","6.8","6.6"
"Colquitt","2020-08-21","274","13156","15","1775","6.8","6.5"
"Colquitt","2020-08-22","77","13233","4","1779","6.3","6.8"
"Colquitt","2020-08-23","79","13312","3","1782","6.2","6.7"
"Colquitt","2020-08-24","192","13504","16","1798","6.7","6.7"
"Colquitt","2020-08-25","46","13550","13","1811","9.9","8"
"Colquitt","2020-08-26","262","13812","12","1823","9.2","7.9"
"Colquitt","2020-08-27","78","13890","3","1826","8.5","7.6"
"Colquitt","2020-08-28","333","14223","15","1841","8.4","7.6"
"Colquitt","2020-08-29","91","14314","5","1846","8.4","7.3"
"Colquitt","2020-08-30","151","14465","2","1848","8","7.1"
"Colquitt","2020-08-31","243","14708","12","1860","7.6","7.1"
"Colquitt","2020-09-01","63","14771","3","1863","4.2","7"
"Colquitt","2020-09-02","280","15051","5","1868","3.8","6.5"
"Colquitt","2020-09-03","61","15112","3","1871","4","6.2"
"Colquitt","2020-09-04","339","15451","7","1878","3.6","6"
"Colquitt","2020-09-05","9","15460","1","1879","4.4","6.4"
"Colquitt","2020-09-06","6","15466","1","1880","6.6","7.3"
"Colquitt","2020-09-07","7","15473","1","1881","7.9","7.8"
"Colquitt","2020-09-08","201","15674","22","1903","8.8","6.5"
"Colquitt","2020-09-09","135","15809","6","1909","9.2","6.5"
"Colquitt","2020-09-10","145","15954","11","1920","9.6","6.8"
"Colquitt","2020-09-11","85","16039","6","1926","10.3","7"
"Colquitt","2020-09-12","146","16185","4","1930","9.1","6.8"
"Colquitt","2020-09-13","12","16197","3","1933","10.3","8.5"
"Colquitt","2020-09-14","117","16314","13","1946","9.8","8.9"
"Colquitt","2020-09-15","31","16345","5","1951","10.6","9.7"
"Colquitt","2020-09-16","228","16573","8","1959","10.4","9.8"
"Colquitt","2020-09-17","48","16621","3","1962","10.3","9.9"
"Colquitt","2020-09-18","110","16731","8","1970","10.3","10.3"
"Colquitt","2020-09-19","56","16787","0","1970","9.9","9.5"
"Colquitt","2020-09-20","8","16795","1","1971","8.1","9.2"
"Colquitt","2020-09-21","75","16870","4","1975","7.3","8.6"
"Colquitt","2020-09-22","27","16897","1","1976","5.5","8"
"Colquitt","2020-09-23","92","16989","5","1981","5.8","8.1"
"Colquitt","2020-09-24","13","17002","0","1981","4.9","7.6"
"Colquitt","2020-09-25","128","17130","6","1987","4.5","7.4"
"Colquitt","2020-09-26","7","17137","1","1988","6.6","8.2"
"Colquitt","2020-09-27","7","17144","2","1990","8.9","8.5"
"Colquitt","2020-09-28","72","17216","5","1995","9.1","8.2"
"Colquitt","2020-09-29","50","17266","5","2000","10","7.7"
"Colquitt","2020-09-30","101","17367","8","2008","10.3","8.1"
"Colquitt","2020-10-01","30","17397","2","2010","11.3","8.1"
"Colquitt","2020-10-02","92","17489","7","2017","11.7","8.1"
"Colquitt","2020-10-03","26","17515","1","2018","10.2","8.4"
"Colquitt","2020-10-04","67","17582","4","2022","7","7.9"
"Colquitt","2020-10-05","111","17693","15","2037","7.9","8.5"
"Colquitt","2020-10-06","38","17731","6","2043","8.8","9.4"
"Colquitt","2020-10-07","145","17876","12","2055","8.8","9.6"
"Colquitt","2020-10-08","110","17986","5","2060","8.5","9.9"
"Colquitt","2020-10-09","172","18158","14","2074","8.6","10.1"
"Colquitt","2020-10-10","46","18204","0","2074","8","9.1"
"Colquitt","2020-10-11","14","18218","0","2074","7.2","7.1"
"Colquitt","2020-10-12","59","18277","8","2082","7.2","7.6"
"Colquitt","2020-10-13","181","18458","13","2095","6","7.4"
"Colquitt","2020-10-14","55","18513","3","2098","5.6","7.2"
"Colquitt","2020-10-15","203","18716","11","2109","5.7","7.1"
"Colquitt","2020-10-16","44","18760","1","2110","4.8","6.7"
"Colquitt","2020-10-17","103","18863","6","2116","5.7","6.9"
"Colquitt","2020-10-18","6","18869","0","2116","5.7","6.4"
"Colquitt","2020-10-19","96","18965","8","2124","4.9","6.1"
"Colquitt","2020-10-20","110","19075","1","2125","4","5"
"Colquitt","2020-10-21","53","19128","1","2126","3.5","4.5"
"Colquitt","2020-10-22","82","19210","8","2134","4.1","4.9"
"Colquitt","2020-10-23","83","19293","7","2141","5","4.9"
"Colquitt","2020-10-24","6","19299","0","2141","4.2","4.9"
"Colquitt","2020-10-25","4","19303","1","2142","7.8","6.7"
"Colquitt","2020-10-26","73","19376","6","2148","7.7","6.3"
"Colquitt","2020-10-27","14","19390","1","2149","8.6","6.3"
"Colquitt","2020-10-28","80","19470","6","2155","9.4","6.5"
"Colquitt","2020-10-29","25","19495","2","2157","9.2","6.7"
"Colquitt","2020-10-30","58","19553","3","2160","8.7","6.9"
"Colquitt","2020-10-31","5","19558","0","2160","8.7","6.5"
"Colquitt","2020-11-01","1","19559","0","2160","5.1","6.5"
"Colquitt","2020-11-02","54","19613","2","2162","4.5","6.1"
"Colquitt","2020-11-03","24","19637","4","2166","5.9","7.2"
"Colquitt","2020-11-04","88","19725","5","2171","5.6","7.5"
"Colquitt","2020-11-05","14","19739","0","2171","4.5","6.8"
"Colquitt","2020-11-06","70","19809","3","2174","4.3","6.5"
"Colquitt","2020-11-07","8","19817","1","2175","6.1","7.4"
"Colquitt","2020-11-08","8","19825","2","2177","9.7","7.4"
"Colquitt","2020-11-09","63","19888","6","2183","10.5","7.5"
"Colquitt","2020-11-10","27","19915","1","2184","8.7","7.3"
"Colquitt","2020-11-11","31","19946","2","2186","8.8","7.2"
"Colquitt","2020-11-12","65","20011","6","2192","10.1","7.3"
"Colquitt","2020-11-13","34","20045","2","2194","10.3","7.3"
"Colquitt","2020-11-14","11","20056","1","2195","9.8","8"
"Colquitt","2020-11-15","9","20065","0","2195","6.3","8"
"Colquitt","2020-11-16","70","20135","6","2201","6.1","8.3"
"Colquitt","2020-11-17","33","20168","5","2206","7.8","8.2"
"Colquitt","2020-11-18","101","20269","3","2209","7.3","8"
"Colquitt","2020-11-19","24","20293","1","2210","6.5","8.3"
"Colquitt","2020-11-20","88","20381","1","2211","5.9","8.1"
"Colquitt","2020-11-21","4","20385","1","2212","8.1","9"
"Colquitt","2020-11-22","3","20388","0","2212","8.1","7.2"
"Colquitt","2020-11-23","60","20448","5","2217","8.1","7.1"
"Colquitt","2020-11-24","24","20472","1","2218","6.5","7.2"
"Colquitt","2020-11-25","42","20514","4","2222","7.5","7.4"
"Colquitt","2020-11-26","9","20523","1","2223","8.5","7.5"
"Colquitt","2020-11-27","15","20538","4","2227","12.1","9"
"Colquitt","2020-11-28","12","20550","2","2229","10.9","9.5"
"Colquitt","2020-11-29","6","20556","1","2230","13.3","10.7"
"Colquitt","2020-11-30","120","20676","20","2250","14.5","11.3"
"Colquitt","2020-12-01","65","20741","12","2262","16.5","11.5"
"Colquitt","2020-12-02","33","20774","4","2266","16.9","12.2"
"Colquitt","2020-12-03","38","20812","5","2271","17.2","12.8"
"Colquitt","2020-12-04","100","20912","20","2291","16.2","14.2"
"Colquitt","2020-12-05","9","20921","1","2292","15.5","13.2"
"Colquitt","2020-12-06","13","20934","4","2296","17.5","15.4"
"Colquitt","2020-12-07","44","20978","13","2309","19.3","16.9"
"Colquitt","2020-12-08","164","21142","14","2323","17.9","17.2"
"Colquitt","2020-12-09","96","21238","12","2335","17.9","17.4"
"Colquitt","2020-12-10","47","21285","3","2338","17","17.1"
"Colquitt","2020-12-11","162","21447","11","2349","15.1","15.7"
"Colquitt","2020-12-12","19","21466","5","2354","17.3","16.4"
"Colquitt","2020-12-13","9","21475","0","2354","12.9","15.2"
"Colquitt","2020-12-14","50","21525","6","2360","10.4","14.8"
"Colquitt","2020-12-15","124","21649","13","2373","10.6","14.3"
"Colquitt","2020-12-16","55","21704","11","2384","11.7","14.8"
"Colquitt","2020-12-17","127","21831","9","2393","11.8","14.4"
"Colquitt","2020-12-18","143","21974","12","2405","12","13.6"
"Colquitt","2020-12-19","20","21994","4","2409","11.1","14.2"
"Colquitt","2020-12-20","3","21997","0","2409","11.1","12"
"Colquitt","2020-12-21","161","22158","31","2440","12.2","11.3"
"Colquitt","2020-12-22","41","22199","9","2449","13.8","12.2"
"Colquitt","2020-12-23","141","22340","24","2473","13.4","12.5"
"Colquitt","2020-12-24","8","22348","1","2474","14.2","13"
"Colquitt","2020-12-25","5","22353","2","2476","18.7","15.4"
"Colquitt","2020-12-26","19","22372","9","2485","22.6","16.9"
"Colquitt","2020-12-27","11","22383","5","2490","29.1","20.1"
"Colquitt","2020-12-28","180","22563","24","2514","28.2","20.2"
"Colquitt","2020-12-29","133","22696","17","2531","26.9","20.4"
"Colquitt","2020-12-30","26","22722","8","2539","28.9","21.1"
"Colquitt","2020-12-31","154","22876","23","2562","29.2","21.7"
"Colquitt","2021-01-01","4","22880","2","2564","30.7","24.7"
"Colquitt","2021-01-02","23","22903","7","2571","28.2","25.4"
"Colquitt","2021-01-03","30","22933","9","2580","26","27.6"
"Colquitt","2021-01-04","190","23123","38","2618","27","27.6"
"Colquitt","2021-01-05","39","23162","7","2625","27.7","27.3"
"Colquitt","2021-01-06","40","23202","8","2633","26.2","27.5"
"Colquitt","2021-01-07","245","23447","40","2673","26.4","27.8"
"Colquitt","2021-01-08","45","23492","3","2676","20.2","25.4"
"Colquitt","2021-01-09","108","23600","16","2692","18","23.1"
"Colquitt","2021-01-10","34","23634","9","2701","17.5","21.7"
"Colquitt","2021-01-11","222","23856","36","2737","16.9","22"
"Colquitt","2021-01-12","61","23917","18","2755","18.6","23.1"
"Colquitt","2021-01-13","66","23983","20","2775","20","23.1"
"Colquitt","2021-01-14","235","24218","37","2812","20","23.2"
"Colquitt","2021-01-15","138","24356","19","2831","21","20.6"
"Colquitt","2021-01-16","41","24397","7","2838","21.3","19.6"
"Colquitt","2021-01-17","43","24440","14","2852","22.2","19.8"
"Colquitt","2021-01-18","167","24607","38","2890","23.1","20"
"Colquitt","2021-01-19","58","24665","10","2900","21.3","20"
"Colquitt","2021-01-20","83","24748","9","2909","18.6","19.3"
"Colquitt","2021-01-21","217","24965","34","2943","18.6","19.3"
"Colquitt","2021-01-22","39","25004","7","2950","19.2","20.1"
"Colquitt","2021-01-23","11","25015","2","2952","19.3","20.3"
"Colquitt","2021-01-24","9","25024","3","2955","19.4","20.8"
"Colquitt","2021-01-25","125","25149","20","2975","18.5","20.8"
"Colquitt","2021-01-26","44","25193","8","2983","18.6","20"
"Colquitt","2021-01-27","14","25207","3","2986","20.1","19.3"
"Colquitt","2021-01-28","155","25362","17","3003","19.4","19"
"Colquitt","2021-01-29","93","25455","17","3020","19.5","19.3"
"Colquitt","2021-01-30","21","25476","4","3024","19.6","19.5"
"Colquitt","2021-01-31","43","25519","11","3035","18.5","19"
"Colquitt","2021-02-01","42","25561","3","3038","17.2","17.8"
"Colquitt","2021-02-02","223","25784","19","3057","15.9","17.2"
"Colquitt","2021-02-03","31","25815","8","3065","16.5","18.3"
"Colquitt","2021-02-04","135","25950","10","3075","16","17.7"
"Colquitt","2021-02-05","27","25977","5","3080","16","17.7"
"Colquitt","2021-02-06","16","25993","3","3083","16","17.8"
"Colquitt","2021-02-07","1","25994","0","3083","12.3","15.4"
"Colquitt","2021-02-08","0","25994","0","3083","11.3","14.3"
"Columbia","2020-02-01","0","0","0","0",".","."
"Columbia","2020-02-02","0","0","0","0",".","."
"Columbia","2020-02-03","0","0","0","0",".","."
"Columbia","2020-02-04","0","0","0","0",".","."
"Columbia","2020-02-05","0","0","0","0",".","."
"Columbia","2020-02-06","0","0","0","0",".","."
"Columbia","2020-02-07","0","0","0","0","0","."
"Columbia","2020-02-08","0","0","0","0","0","."
"Columbia","2020-02-09","0","0","0","0","0","."
"Columbia","2020-02-10","0","0","0","0","0","."
"Columbia","2020-02-11","0","0","0","0","0","."
"Columbia","2020-02-12","0","0","0","0","0","."
"Columbia","2020-02-13","0","0","0","0","0","."
"Columbia","2020-02-14","0","0","0","0","0","0"
"Columbia","2020-02-15","0","0","0","0","0","0"
"Columbia","2020-02-16","0","0","0","0","0","0"
"Columbia","2020-02-17","0","0","0","0","0","0"
"Columbia","2020-02-18","0","0","0","0","0","0"
"Columbia","2020-02-19","0","0","0","0","0","0"
"Columbia","2020-02-20","0","0","0","0","0","0"
"Columbia","2020-02-21","0","0","0","0","0","0"
"Columbia","2020-02-22","0","0","0","0","0","0"
"Columbia","2020-02-23","0","0","0","0","0","0"
"Columbia","2020-02-24","0","0","0","0","0","0"
"Columbia","2020-02-25","0","0","0","0","0","0"
"Columbia","2020-02-26","0","0","0","0","0","0"
"Columbia","2020-02-27","0","0","0","0","0","0"
"Columbia","2020-02-28","0","0","0","0","0","0"
"Columbia","2020-02-29","0","0","0","0","0","0"
"Columbia","2020-03-01","0","0","0","0","0","0"
"Columbia","2020-03-02","0","0","0","0","0","0"
"Columbia","2020-03-03","3","3","0","0","0","0"
"Columbia","2020-03-04","0","3","0","0","0","0"
"Columbia","2020-03-05","0","3","0","0","0","0"
"Columbia","2020-03-06","0","3","0","0","0","0"
"Columbia","2020-03-07","0","3","0","0","0","0"
"Columbia","2020-03-08","0","3","0","0","0","0"
"Columbia","2020-03-09","0","3","0","0","0","0"
"Columbia","2020-03-10","0","3","0","0","0","0"
"Columbia","2020-03-11","0","3","0","0","0","0"
"Columbia","2020-03-12","1","4","0","0","0","0"
"Columbia","2020-03-13","2","6","1","1","7.1","3.6"
"Columbia","2020-03-14","0","6","0","1","7.1","3.6"
"Columbia","2020-03-15","0","6","0","1","7.1","3.6"
"Columbia","2020-03-16","1","7","0","1","7.1","3.6"
"Columbia","2020-03-17","9","16","1","2","8.7","4.4"
"Columbia","2020-03-18","9","25","2","4","11.9","6"
"Columbia","2020-03-19","5","30","0","4","11.9","6"
"Columbia","2020-03-20","9","39","1","5","6.3","6.7"
"Columbia","2020-03-21","6","45","0","5","6.3","6.7"
"Columbia","2020-03-22","7","52","2","7","10.4","8.8"
"Columbia","2020-03-23","16","68","1","8","11.3","9.2"
"Columbia","2020-03-24","14","82","1","9","10.8","9.7"
"Columbia","2020-03-25","7","89","0","9","7.6","9.7"
"Columbia","2020-03-26","21","110","0","9","7.6","9.7"
"Columbia","2020-03-27","28","138","2","11","7","6.7"
"Columbia","2020-03-28","6","144","0","11","7","6.7"
"Columbia","2020-03-29","6","150","2","13","7.7","9.1"
"Columbia","2020-03-30","22","172","1","14","7.5","9.4"
"Columbia","2020-03-31","12","184","1","15","7.6","9.2"
"Columbia","2020-04-01","19","203","1","16","8.4","8"
"Columbia","2020-04-02","27","230","2","18","9.4","8.5"
"Columbia","2020-04-03","52","282","4","22","9.5","8.3"
"Columbia","2020-04-04","24","306","5","27","12.5","9.8"
"Columbia","2020-04-05","17","323","2","29","9.4","8.6"
"Columbia","2020-04-06","25","348","3","32","10.5","9"
"Columbia","2020-04-07","47","395","2","34","9.9","8.8"
"Columbia","2020-04-08","48","443","2","36","9.7","9.1"
"Columbia","2020-04-09","35","478","1","37","9.1","9.3"
"Columbia","2020-04-10","34","512","1","38","8.4","9"
"Columbia","2020-04-11","20","532","2","40","6.9","9.7"
"Columbia","2020-04-12","6","538","0","40","5.2","7.3"
"Columbia","2020-04-13","41","579","5","45","5.2","7.8"
"Columbia","2020-04-14","28","607","2","47","5.6","7.8"
"Columbia","2020-04-15","40","647","5","52","6.8","8.3"
"Columbia","2020-04-16","38","685","8","60","9.4","9.2"
"Columbia","2020-04-17","67","752","8","68","10.7","9.5"
"Columbia","2020-04-18","30","782","13","81","15.5","11.2"
"Columbia","2020-04-19","21","803","6","87","19.5","12.4"
"Columbia","2020-04-20","44","847","5","92","19.4","12.3"
"Columbia","2020-04-21","83","930","10","102","20.1","12.9"
"Columbia","2020-04-22","71","1001","7","109","19.7","13.3"
"Columbia","2020-04-23","37","1038","5","114","18.7","14"
"Columbia","2020-04-24","107","1145","15","129","19","14.8"
"Columbia","2020-04-25","57","1202","1","130","13","14.2"
"Columbia","2020-04-26","42","1244","2","132","9.6","14.6"
"Columbia","2020-04-27","86","1330","6","138","9","14.2"
"Columbia","2020-04-28","37","1367","4","142","8.8","14.5"
"Columbia","2020-04-29","75","1442","1","143","7.6","13.7"
"Columbia","2020-04-30","90","1532","5","148","6.5","12.6"
"Columbia","2020-05-01","67","1599","5","153","5.5","12.2"
"Columbia","2020-05-02","68","1667","9","162","7.2","10.1"
"Columbia","2020-05-03","52","1719","4","166","7.6","8.6"
"Columbia","2020-05-04","65","1784","1","167","6.8","7.9"
"Columbia","2020-05-05","87","1871","2","169","5.6","7.2"
"Columbia","2020-05-06","64","1935","5","174","6.5","7.1"
"Columbia","2020-05-07","63","1998","6","180","7.1","6.8"
"Columbia","2020-05-08","72","2070","3","183","6.6","6.1"
"Columbia","2020-05-09","58","2128","0","183","4.7","5.9"
"Columbia","2020-05-10","8","2136","1","184","5.4","6.5"
"Columbia","2020-05-11","116","2252","3","187","5.6","6.2"
"Columbia","2020-05-12","122","2374","3","190","5.6","5.6"
"Columbia","2020-05-13","78","2452","9","199","6.1","6.3"
"Columbia","2020-05-14","83","2535","3","202","5.3","6.2"
"Columbia","2020-05-15","85","2620","10","212","6.4","6.5"
"Columbia","2020-05-16","75","2695","4","216","7.1","5.9"
"Columbia","2020-05-17","59","2754","0","216","5.3","5.4"
"Columbia","2020-05-18","128","2882","3","219","5.3","5.4"
"Columbia","2020-05-19","130","3012","4","223","5.4","5.5"
"Columbia","2020-05-20","85","3097","2","225","4.1","5.1"
"Columbia","2020-05-21","104","3201","1","226","3.7","4.5"
"Columbia","2020-05-22","95","3296","4","230","2.6","4.5"
"Columbia","2020-05-23","36","3332","3","233","3","5.1"
"Columbia","2020-05-24","39","3371","3","236","4.1","4.7"
"Columbia","2020-05-25","35","3406","3","239","5","5.2"
"Columbia","2020-05-26","35","3441","4","243","6.2","5.8"
"Columbia","2020-05-27","17","3458","1","244","6.7","5.4"
"Columbia","2020-05-28","109","3567","11","255","8","5.9"
"Columbia","2020-05-29","47","3614","2","257","8","5.3"
"Columbia","2020-05-30","14","3628","0","257","6.8","4.9"
"Columbia","2020-05-31","54","3682","0","257","5.7","4.9"
"Columbia","2020-06-01","93","3775","2","259","4.8","4.9"
"Columbia","2020-06-02","114","3889","5","264","3.8","5"
"Columbia","2020-06-03","75","3964","3","267","3.6","5.1"
"Columbia","2020-06-04","47","4011","6","273","3.9","6"
"Columbia","2020-06-05","30","4041","1","274","3.8","5.9"
"Columbia","2020-06-06","16","4057","0","274","3.8","5.3"
"Columbia","2020-06-07","12","4069","0","274","3.8","4.8"
"Columbia","2020-06-08","26","4095","0","274","3.5","4.2"
"Columbia","2020-06-09","76","4171","4","278","3.6","3.7"
"Columbia","2020-06-10","131","4302","8","286","3.9","3.7"
"Columbia","2020-06-11","108","4410","8","294","3.2","3.5"
"Columbia","2020-06-12","133","4543","3","297","3","3.4"
"Columbia","2020-06-13","85","4628","3","300","3.5","3.7"
"Columbia","2020-06-14","65","4693","4","304","4.4","4.1"
"Columbia","2020-06-15","165","4858","10","314","5.3","4.4"
"Columbia","2020-06-16","119","4977","7","321","5.3","4.5"
"Columbia","2020-06-17","60","5037","3","324","5.2","4.6"
"Columbia","2020-06-18","103","5140","10","334","5.5","4.3"
"Columbia","2020-06-19","116","5256","7","341","6.1","4.5"
"Columbia","2020-06-20","103","5359","5","346","6.2","4.9"
"Columbia","2020-06-21","26","5385","5","351","8.1","6.2"
"Columbia","2020-06-22","188","5573","16","367","8.5","6.9"
"Columbia","2020-06-23","163","5736","20","387","9.4","7.4"
"Columbia","2020-06-24","208","5944","38","425","11.3","8.2"
"Columbia","2020-06-25","209","6153","19","444","11.2","8.3"
"Columbia","2020-06-26","199","6352","16","460","11.5","8.8"
"Columbia","2020-06-27","141","6493","25","485","13.3","9.8"
"Columbia","2020-06-28","111","6604","15","500","12.5","10.3"
"Columbia","2020-06-29","273","6877","40","540","13.4","10.9"
"Columbia","2020-06-30","364","7241","38","578","13.1","11.2"
"Columbia","2020-07-01","376","7617","39","617","12","11.6"
"Columbia","2020-07-02","416","8033","40","657","12.1","11.6"
"Columbia","2020-07-03","297","8330","32","689","12.4","12"
"Columbia","2020-07-04","47","8377","9","698","12.6","13"
"Columbia","2020-07-05","222","8599","23","721","12.2","12.3"
"Columbia","2020-07-06","318","8917","46","767","12.2","12.8"
"Columbia","2020-07-07","273","9190","42","809","12.9","13"
"Columbia","2020-07-08","325","9515","37","846","13","12.5"
"Columbia","2020-07-09","332","9847","34","880","13.1","12.6"
"Columbia","2020-07-10","359","10206","51","931","13.6","13"
"Columbia","2020-07-11","281","10487","25","956","12.1","12.4"
"Columbia","2020-07-12","159","10646","28","984","13.2","12.7"
"Columbia","2020-07-13","362","11008","41","1025","12.7","12.4"
"Columbia","2020-07-14","374","11382","45","1070","12.2","12.6"
"Columbia","2020-07-15","330","11712","49","1119","12.7","12.9"
"Columbia","2020-07-16","352","12064","54","1173","13.5","13.3"
"Columbia","2020-07-17","264","12328","42","1215","13.7","13.7"
"Columbia","2020-07-18","233","12561","22","1237","13.8","13"
"Columbia","2020-07-19","159","12720","22","1259","13.2","13.2"
"Columbia","2020-07-20","295","13015","48","1307","14","13.3"
"Columbia","2020-07-21","367","13382","35","1342","13.6","12.9"
"Columbia","2020-07-22","288","13670","66","1408","14.8","13.7"
"Columbia","2020-07-23","342","14012","53","1461","14.8","14.1"
"Columbia","2020-07-24","277","14289","43","1504","14.7","14.2"
"Columbia","2020-07-25","238","14527","46","1550","16.1","15"
"Columbia","2020-07-26","160","14687","33","1583","17.1","15.2"
"Columbia","2020-07-27","343","15030","46","1629","16.7","15.3"
"Columbia","2020-07-28","422","15452","70","1699","17.7","15.6"
"Columbia","2020-07-29","359","15811","44","1743","16.2","15.5"
"Columbia","2020-07-30","320","16131","75","1818","17.3","16"
"Columbia","2020-07-31","269","16400","52","1870","17.9","16.3"
"Columbia","2020-08-01","195","16595","32","1902","17.4","16.8"
"Columbia","2020-08-02","122","16717","15","1917","16.2","16.7"
"Columbia","2020-08-03","207","16924","38","1955","17","16.8"
"Columbia","2020-08-04","380","17304","52","2007","16.5","17.1"
"Columbia","2020-08-05","283","17587","49","2056","17.3","16.7"
"Columbia","2020-08-06","317","17904","47","2103","16","16.7"
"Columbia","2020-08-07","281","18185","31","2134","14.8","16.3"
"Columbia","2020-08-08","141","18326","15","2149","14","15.7"
"Columbia","2020-08-09","179","18505","13","2162","13.3","14.8"
"Columbia","2020-08-10","319","18824","52","2214","13","15"
"Columbia","2020-08-11","429","19253","55","2269","12.9","14.7"
"Columbia","2020-08-12","289","19542","53","2322","13","15.1"
"Columbia","2020-08-13","382","19924","50","2372","12.8","14.4"
"Columbia","2020-08-14","301","20225","36","2408","12.9","13.9"
"Columbia","2020-08-15","202","20427","29","2437","13.4","13.7"
"Columbia","2020-08-16","185","20612","25","2462","14.3","13.8"
"Columbia","2020-08-17","313","20925","43","2505","14","13.5"
"Columbia","2020-08-18","377","21302","44","2549","13.8","13.3"
"Columbia","2020-08-19","268","21570","28","2577","12.7","12.9"
"Columbia","2020-08-20","282","21852","18","2595","11.7","12.3"
"Columbia","2020-08-21","299","22151","35","2630","11.7","12.3"
"Columbia","2020-08-22","142","22293","6","2636","10.2","11.8"
"Columbia","2020-08-23","168","22461","15","2651","9.6","12"
"Columbia","2020-08-24","310","22771","46","2697","9.7","11.9"
"Columbia","2020-08-25","316","23087","31","2728","9.5","11.6"
"Columbia","2020-08-26","259","23346","29","2757","9.6","11.1"
"Columbia","2020-08-27","268","23614","36","2793","10.6","11.2"
"Columbia","2020-08-28","220","23834","31","2824","10.9","11.3"
"Columbia","2020-08-29","159","23993","23","2847","12.4","11.3"
"Columbia","2020-08-30","121","24114","15","2862","12.9","11.2"
"Columbia","2020-08-31","245","24359","22","2884","12.1","10.9"
"Columbia","2020-09-01","298","24657","23","2907","11.8","10.6"
"Columbia","2020-09-02","210","24867","23","2930","11.7","10.7"
"Columbia","2020-09-03","250","25117","45","2975","12.4","11.5"
"Columbia","2020-09-04","166","25283","22","2997","12.3","11.6"
"Columbia","2020-09-05","158","25441","13","3010","11.4","11.9"
"Columbia","2020-09-06","82","25523","12","3022","11.7","12.3"
"Columbia","2020-09-07","61","25584","4","3026","11.3","11.7"
"Columbia","2020-09-08","305","25889","36","3062","11.9","11.8"
"Columbia","2020-09-09","219","26108","28","3090","12.2","11.9"
"Columbia","2020-09-10","344","26452","35","3125","11.1","11.7"
"Columbia","2020-09-11","247","26699","31","3156","11","11.6"
"Columbia","2020-09-12","141","26840","20","3176","11.8","11.6"
"Columbia","2020-09-13","61","26901","7","3183","11.4","11.5"
"Columbia","2020-09-14","257","27158","32","3215","12.2","11.8"
"Columbia","2020-09-15","264","27422","18","3233","11.5","11.7"
"Columbia","2020-09-16","184","27606","12","3245","10.6","11.4"
"Columbia","2020-09-17","163","27769","15","3260","10.5","10.8"
"Columbia","2020-09-18","216","27985","17","3277","9.8","10.4"
"Columbia","2020-09-19","127","28112","9","3286","8.8","10.3"
"Columbia","2020-09-20","68","28180","3","3289","7.8","9.6"
"Columbia","2020-09-21","253","28433","16","3305","6.9","9.5"
"Columbia","2020-09-22","257","28690","23","3328","7.2","9.3"
"Columbia","2020-09-23","158","28848","12","3340","7.3","9"
"Columbia","2020-09-24","313","29161","23","3363","7.1","8.8"
"Columbia","2020-09-25","214","29375","20","3383","7.3","8.5"
"Columbia","2020-09-26","91","29466","8","3391","7.5","8.2"
"Columbia","2020-09-27","43","29509","2","3393","7.6","7.7"
"Columbia","2020-09-28","285","29794","11","3404","7.2","7.1"
"Columbia","2020-09-29","227","30021","15","3419","6.9","7"
"Columbia","2020-09-30","177","30198","25","3444","7.8","7.6"
"Columbia","2020-10-01","231","30429","13","3457","7.6","7.3"
"Columbia","2020-10-02","261","30690","22","3479","7.4","7.4"
"Columbia","2020-10-03","136","30826","4","3483","6.6","7.1"
"Columbia","2020-10-04","71","30897","2","3485","6.3","7"
"Columbia","2020-10-05","331","31228","27","3512","7","7.1"
"Columbia","2020-10-06","320","31548","20","3532","6.9","6.9"
"Columbia","2020-10-07","431","31979","29","3561","5.9","6.8"
"Columbia","2020-10-08","363","32342","18","3579","5.8","6.7"
"Columbia","2020-10-09","300","32642","28","3607","5.9","6.7"
"Columbia","2020-10-10","220","32862","5","3612","5.8","6.2"
"Columbia","2020-10-11","63","32925","4","3616","6.3","6.3"
"Columbia","2020-10-12","358","33283","33","3649","6.4","6.7"
"Columbia","2020-10-13","348","33631","26","3675","6.6","6.8"
"Columbia","2020-10-14","290","33921","27","3702","7","6.4"
"Columbia","2020-10-15","309","34230","34","3736","7.9","6.8"
"Columbia","2020-10-16","239","34469","23","3759","7.9","6.9"
"Columbia","2020-10-17","218","34687","17","3776","8.7","7.2"
"Columbia","2020-10-18","75","34762","7","3783","9.1","7.7"
"Columbia","2020-10-19","329","35091","33","3816","9.2","7.8"
"Columbia","2020-10-20","340","35431","24","3840","9.2","7.9"
"Columbia","2020-10-21","292","35723","27","3867","9.2","8.1"
"Columbia","2020-10-22","258","35981","31","3898","9.3","8.6"
"Columbia","2020-10-23","252","36233","31","3929","9.7","8.8"
"Columbia","2020-10-24","139","36372","13","3942","9.9","9.3"
"Columbia","2020-10-25","80","36452","8","3950","10","9.6"
"Columbia","2020-10-26","322","36774","25","3975","9.7","9.5"
"Columbia","2020-10-27","319","37093","29","4004","10","9.6"
"Columbia","2020-10-28","250","37343","35","4039","10.6","9.9"
"Columbia","2020-10-29","274","37617","25","4064","10.2","9.8"
"Columbia","2020-10-30","289","37906","28","4092","9.9","9.8"
"Columbia","2020-10-31","144","38050","10","4102","9.5","9.7"
"Columbia","2020-11-01","102","38152","4","4106","8.6","9.3"
"Columbia","2020-11-02","372","38524","28","4134","8.6","9.1"
"Columbia","2020-11-03","303","38827","26","4160","8.5","9.3"
"Columbia","2020-11-04","350","39177","33","4193","7.9","9.3"
"Columbia","2020-11-05","415","39592","33","4226","7.7","9"
"Columbia","2020-11-06","346","39938","34","4260","7.7","8.8"
"Columbia","2020-11-07","190","40128","17","4277","8","8.8"
"Columbia","2020-11-08","88","40216","6","4283","8.4","8.5"
"Columbia","2020-11-09","368","40584","58","4341","9.6","9.1"
"Columbia","2020-11-10","359","40943","51","4392","10.4","9.5"
"Columbia","2020-11-11","335","41278","32","4424","10.4","9.2"
"Columbia","2020-11-12","322","41600","49","4473","11.5","9.6"
"Columbia","2020-11-13","352","41952","26","4499","11.1","9.4"
"Columbia","2020-11-14","147","42099","24","4523","12.2","10.1"
"Columbia","2020-11-15","118","42217","8","4531","12.2","10.3"
"Columbia","2020-11-16","403","42620","39","4570","11.3","10.5"
"Columbia","2020-11-17","460","43080","49","4619","10.8","10.6"
"Columbia","2020-11-18","368","43448","27","4646","10.5","10.5"
"Columbia","2020-11-19","351","43799","34","4680","9.7","10.6"
"Columbia","2020-11-20","534","44333","34","4714","9.5","10.3"
"Columbia","2020-11-21","238","44571","9","4723","7.8","10"
"Columbia","2020-11-22","170","44741","10","4733","7.6","9.9"
"Columbia","2020-11-23","441","45182","46","4779","7.7","9.5"
"Columbia","2020-11-24","543","45725","63","4842","7.9","9.3"
"Columbia","2020-11-25","303","46028","17","4859","7.6","9.1"
"Columbia","2020-11-26","59","46087","2","4861","6.7","8.2"
"Columbia","2020-11-27","190","46277","24","4885","7.6","8.6"
"Columbia","2020-11-28","166","46443","22","4907","9","8.4"
"Columbia","2020-11-29","118","46561","9","4916","9.2","8.4"
"Columbia","2020-11-30","460","47021","71","4987","9.9","8.8"
"Columbia","2020-12-01","465","47486","61","5048","10.2","9"
"Columbia","2020-12-02","578","48064","71","5119","11.1","9.4"
"Columbia","2020-12-03","398","48462","55","5174","12.6","9.7"
"Columbia","2020-12-04","370","48832","62","5236","13.2","10.4"
"Columbia","2020-12-05","248","49080","37","5273","13.4","11.2"
"Columbia","2020-12-06","94","49174","14","5287","14.5","11.8"
"Columbia","2020-12-07","473","49647","72","5359","14.4","12.2"
"Columbia","2020-12-08","441","50088","100","5459","15.8","13"
"Columbia","2020-12-09","522","50610","62","5521","15.7","13.4"
"Columbia","2020-12-10","403","51013","66","5587","16.1","14.3"
"Columbia","2020-12-11","366","51379","47","5634","15.5","14.4"
"Columbia","2020-12-12","297","51676","40","5674","15.3","14.4"
"Columbia","2020-12-13","122","51798","24","5698","16","15.2"
"Columbia","2020-12-14","437","52235","75","5773","16.3","15.4"
"Columbia","2020-12-15","569","52804","74","5847","14.9","15.4"
"Columbia","2020-12-16","540","53344","78","5925","15.3","15.5"
"Columbia","2020-12-17","445","53789","90","6015","15.8","16"
"Columbia","2020-12-18","439","54228","54","6069","15.8","15.6"
"Columbia","2020-12-19","310","54538","43","6112","15.8","15.6"
"Columbia","2020-12-20","151","54689","30","6142","15.8","15.9"
"Columbia","2020-12-21","561","55250","98","6240","15.9","16.1"
"Columbia","2020-12-22","527","55777","78","6318","16.1","15.5"
"Columbia","2020-12-23","524","56301","75","6393","16.1","15.7"
"Columbia","2020-12-24","171","56472","26","6419","15.4","15.6"
"Columbia","2020-12-25","31","56503","9","6428","17.8","16.8"
"Columbia","2020-12-26","265","56768","58","6486","18.9","17.4"
"Columbia","2020-12-27","138","56906","36","6522","19.8","17.8"
"Columbia","2020-12-28","481","57387","100","6622","20.3","18.1"
"Columbia","2020-12-29","426","57813","139","6761","22.8","19.5"
"Columbia","2020-12-30","472","58285","104","6865","24","20"
"Columbia","2020-12-31","207","58492","44","6909","24.8","20.1"
"Columbia","2021-01-01","44","58536","10","6919","23.9","20.9"
"Columbia","2021-01-02","158","58694","45","6964","24.9","21.9"
"Columbia","2021-01-03","67","58761","18","6982","25","22.4"
"Columbia","2021-01-04","247","59008","82","7064","26.7","23.5"
"Columbia","2021-01-05","538","59546","106","7170","24.9","23.9"
"Columbia","2021-01-06","448","59994","100","7270","24.9","24.4"
"Columbia","2021-01-07","458","60452","107","7377","25.2","25"
"Columbia","2021-01-08","637","61089","117","7494","24.6","24.3"
"Columbia","2021-01-09","330","61419","73","7567","23.7","24.3"
"Columbia","2021-01-10","173","61592","43","7610","23.4","24.2"
"Columbia","2021-01-11","637","62229","129","7739","21.6","24.2"
"Columbia","2021-01-12","654","62883","125","7864","21.5","23.2"
"Columbia","2021-01-13","601","63484","106","7970","20.8","22.9"
"Columbia","2021-01-14","485","63969","110","8080","20.7","23"
"Columbia","2021-01-15","494","64463","79","8159","20.4","22.5"
"Columbia","2021-01-16","290","64753","79","8238","21.1","22.4"
"Columbia","2021-01-17","144","64897","21","8259","19.6","21.5"
"Columbia","2021-01-18","453","65350","111","8370","20.3","20.9"
"Columbia","2021-01-19","540","65890","91","8461","19.9","20.7"
"Columbia","2021-01-20","446","66336","75","8536","19.8","20.3"
"Columbia","2021-01-21","356","66692","66","8602","19.2","20"
"Columbia","2021-01-22","443","67135","75","8677","19.4","19.9"
"Columbia","2021-01-23","200","67335","36","8713","18","19.6"
"Columbia","2021-01-24","107","67442","19","8732","18.5","19.1"
"Columbia","2021-01-25","410","67852","81","8813","17.8","19"
"Columbia","2021-01-26","493","68345","70","8883","17.4","18.7"
"Columbia","2021-01-27","407","68752","70","8953","17.5","18.6"
"Columbia","2021-01-28","346","69098","67","9020","17.6","18.4"
"Columbia","2021-01-29","332","69430","49","9069","17.3","18.3"
"Columbia","2021-01-30","173","69603","18","9087","16.2","17.1"
"Columbia","2021-01-31","107","69710","11","9098","15.1","16.8"
"Columbia","2021-02-01","330","70040","73","9171","15.5","16.6"
"Columbia","2021-02-02","409","70449","42","9213","14.9","16.2"
"Columbia","2021-02-03","387","70836","54","9267","14.5","16"
"Columbia","2021-02-04","280","71116","34","9301","13.4","15.5"
"Columbia","2021-02-05","327","71443","34","9335","12.8","15"
"Columbia","2021-02-06","87","71530","16","9351","13.9","15.1"
"Columbia","2021-02-07","1","71531","0","9351","12.5","13.8"
"Columbia","2021-02-08","0","71531","0","9351","9.3","12.4"
"Cook","2020-02-01","0","0","0","0",".","."
"Cook","2020-02-02","0","0","0","0",".","."
"Cook","2020-02-03","0","0","0","0",".","."
"Cook","2020-02-04","0","0","0","0",".","."
"Cook","2020-02-05","0","0","0","0",".","."
"Cook","2020-02-06","0","0","0","0",".","."
"Cook","2020-02-07","0","0","0","0","0","."
"Cook","2020-02-08","0","0","0","0","0","."
"Cook","2020-02-09","0","0","0","0","0","."
"Cook","2020-02-10","0","0","0","0","0","."
"Cook","2020-02-11","0","0","0","0","0","."
"Cook","2020-02-12","0","0","0","0","0","."
"Cook","2020-02-13","0","0","0","0","0","."
"Cook","2020-02-14","0","0","0","0","0","0"
"Cook","2020-02-15","0","0","0","0","0","0"
"Cook","2020-02-16","0","0","0","0","0","0"
"Cook","2020-02-17","0","0","0","0","0","0"
"Cook","2020-02-18","0","0","0","0","0","0"
"Cook","2020-02-19","0","0","0","0","0","0"
"Cook","2020-02-20","0","0","0","0","0","0"
"Cook","2020-02-21","0","0","0","0","0","0"
"Cook","2020-02-22","0","0","0","0","0","0"
"Cook","2020-02-23","0","0","0","0","0","0"
"Cook","2020-02-24","0","0","0","0","0","0"
"Cook","2020-02-25","0","0","0","0","0","0"
"Cook","2020-02-26","0","0","0","0","0","0"
"Cook","2020-02-27","0","0","0","0","0","0"
"Cook","2020-02-28","0","0","0","0","0","0"
"Cook","2020-02-29","0","0","0","0","0","0"
"Cook","2020-03-01","0","0","0","0","0","0"
"Cook","2020-03-02","0","0","0","0","0","0"
"Cook","2020-03-03","0","0","0","0","0","0"
"Cook","2020-03-04","0","0","0","0","0","0"
"Cook","2020-03-05","0","0","0","0","0","0"
"Cook","2020-03-06","0","0","0","0","0","0"
"Cook","2020-03-07","0","0","0","0","0","0"
"Cook","2020-03-08","0","0","0","0","0","0"
"Cook","2020-03-09","0","0","0","0","0","0"
"Cook","2020-03-10","0","0","0","0","0","0"
"Cook","2020-03-11","0","0","0","0","0","0"
"Cook","2020-03-12","0","0","0","0","0","0"
"Cook","2020-03-13","0","0","0","0","0","0"
"Cook","2020-03-14","0","0","0","0","0","0"
"Cook","2020-03-15","0","0","0","0","0","0"
"Cook","2020-03-16","0","0","0","0","0","0"
"Cook","2020-03-17","1","1","0","0","0","0"
"Cook","2020-03-18","0","1","0","0","0","0"
"Cook","2020-03-19","3","4","0","0","0","0"
"Cook","2020-03-20","1","5","0","0","0","0"
"Cook","2020-03-21","0","5","0","0","0","0"
"Cook","2020-03-22","1","6","0","0","0","0"
"Cook","2020-03-23","0","6","0","0","0","0"
"Cook","2020-03-24","2","8","0","0","0","0"
"Cook","2020-03-25","0","8","0","0","0","0"
"Cook","2020-03-26","5","13","0","0","0","0"
"Cook","2020-03-27","5","18","0","0","0","0"
"Cook","2020-03-28","0","18","0","0","0","0"
"Cook","2020-03-29","0","18","0","0","0","0"
"Cook","2020-03-30","5","23","0","0","0","0"
"Cook","2020-03-31","4","27","0","0","0","0"
"Cook","2020-04-01","6","33","0","0","0","0"
"Cook","2020-04-02","3","36","0","0","0","0"
"Cook","2020-04-03","5","41","0","0","0","0"
"Cook","2020-04-04","2","43","1","1","7.1","3.6"
"Cook","2020-04-05","1","44","0","1","7.1","3.6"
"Cook","2020-04-06","2","46","0","1","7.1","3.6"
"Cook","2020-04-07","5","51","1","2","10","5"
"Cook","2020-04-08","2","53","0","2","10","5"
"Cook","2020-04-09","3","56","0","2","10","5"
"Cook","2020-04-10","5","61","0","2","10","5"
"Cook","2020-04-11","1","62","0","2","2.9","5"
"Cook","2020-04-12","2","64","1","3","10","8.6"
"Cook","2020-04-13","0","64","0","3","10","8.6"
"Cook","2020-04-14","4","68","0","3","7.1","8.6"
"Cook","2020-04-15","1","69","0","3","7.1","8.6"
"Cook","2020-04-16","4","73","1","4","10.7","10.4"
"Cook","2020-04-17","1","74","0","4","10.7","10.4"
"Cook","2020-04-18","3","77","1","5","15.5","9.2"
"Cook","2020-04-19","4","81","1","6","11.9","11"
"Cook","2020-04-20","10","91","0","6","11.9","11"
"Cook","2020-04-21","8","99","0","6","11.9","9.5"
"Cook","2020-04-22","9","108","1","7","13.5","10.3"
"Cook","2020-04-23","6","114","1","8","12.3","11.5"
"Cook","2020-04-24","7","121","1","9","14.3","12.5"
"Cook","2020-04-25","6","127","2","11","14.3","14.9"
"Cook","2020-04-26","0","127","0","11","10.8","11.3"
"Cook","2020-04-27","19","146","2","13","12.3","12.1"
"Cook","2020-04-28","21","167","2","15","13.6","12.8"
"Cook","2020-04-29","12","179","4","19","16.8","15.2"
"Cook","2020-04-30","8","187","0","19","14.4","13.4"
"Cook","2020-05-01","13","200","1","20","13.5","13.9"
"Cook","2020-05-02","1","201","0","20","8.7","11.5"
"Cook","2020-05-03","1","202","1","21","23","16.9"
"Cook","2020-05-04","3","205","0","21","21.5","16.9"
"Cook","2020-05-05","14","219","1","22","21.2","17.4"
"Cook","2020-05-06","9","228","0","22","16.4","16.6"
"Cook","2020-05-07","12","240","0","22","16.4","15.4"
"Cook","2020-05-08","21","261","0","22","15.3","14.4"
"Cook","2020-05-09","7","268","1","23","17.3","13"
"Cook","2020-05-10","2","270","0","23","3.1","13"
"Cook","2020-05-11","24","294","1","24","3.7","12.6"
"Cook","2020-05-12","16","310","1","25","3.5","12.3"
"Cook","2020-05-13","17","327","1","26","4.4","10.4"
"Cook","2020-05-14","18","345","2","28","6","11.2"
"Cook","2020-05-15","18","363","2","30","7.5","11.4"
"Cook","2020-05-16","5","368","0","30","5.5","11.4"
"Cook","2020-05-17","3","371","1","31","10.3","6.7"
"Cook","2020-05-18","25","396","2","33","10.8","7.2"
"Cook","2020-05-19","7","403","1","34","12","7.7"
"Cook","2020-05-20","22","425","3","37","13.1","8.7"
"Cook","2020-05-21","23","448","0","37","11.5","8.7"
"Cook","2020-05-22","14","462","2","39","11.9","9.7"
"Cook","2020-05-23","2","464","1","40","19.1","12.3"
"Cook","2020-05-24","0","464","0","40","14.3","12.3"
"Cook","2020-05-25","1","465","0","40","13.2","12"
"Cook","2020-05-26","25","490","2","42","12.3","12.1"
"Cook","2020-05-27","13","503","0","42","10.3","11.7"
"Cook","2020-05-28","20","523","1","43","11","11.3"
"Cook","2020-05-29","22","545","2","45","10.3","11.1"
"Cook","2020-05-30","11","556","1","46","4.5","11.8"
"Cook","2020-05-31","51","607","7","53","6.4","10.4"
"Cook","2020-06-01","42","649","4","57","7.8","10.5"
"Cook","2020-06-02","18","667","5","62","10.6","11.4"
"Cook","2020-06-03","26","693","3","65","12.2","11.3"
"Cook","2020-06-04","36","729","4","69","13.1","12.1"
"Cook","2020-06-05","46","775","3","72","12.8","11.5"
"Cook","2020-06-06","5","780","2","74","17.2","10.8"
"Cook","2020-06-07","4","784","0","74","15.2","10.8"
"Cook","2020-06-08","61","845","7","81","15.5","11.6"
"Cook","2020-06-09","26","871","1","82","12.1","11.3"
"Cook","2020-06-10","34","905","3","85","11.7","12"
"Cook","2020-06-11","38","943","5","90","12","12.5"
"Cook","2020-06-12","35","978","2","92","11.9","12.3"
"Cook","2020-06-13","13","991","1","93","7.2","12.2"
"Cook","2020-06-14","1","992","1","94","21.5","18.4"
"Cook","2020-06-15","59","1051","12","106","22.8","19.1"
"Cook","2020-06-16","52","1103","4","110","23.3","17.7"
"Cook","2020-06-17","51","1154","5","115","23.5","17.6"
"Cook","2020-06-18","62","1216","12","127","24.4","18.2"
"Cook","2020-06-19","71","1287","3","130","24.2","18"
"Cook","2020-06-20","12","1299","4","134","27.8","17.5"
"Cook","2020-06-21","5","1304","1","135","16.4","19"
"Cook","2020-06-22","78","1382","10","145","15.3","19.1"
"Cook","2020-06-23","83","1465","5","150","15.1","19.2"
"Cook","2020-06-24","93","1558","8","158","14.9","19.2"
"Cook","2020-06-25","114","1672","11","169","13.5","18.9"
"Cook","2020-06-26","83","1755","9","178","14.5","19.3"
"Cook","2020-06-27","4","1759","0","178","9.7","18.8"
"Cook","2020-06-28","6","1765","1","179","9.2","12.8"
"Cook","2020-06-29","104","1869","12","191","9","12.2"
"Cook","2020-06-30","83","1952","10","201","9.9","12.5"
"Cook","2020-07-01","60","2012","5","206","9.9","12.4"
"Cook","2020-07-02","73","2085","14","220","11.2","12.4"
"Cook","2020-07-03","31","2116","7","227","12.9","13.7"
"Cook","2020-07-04","11","2127","4","231","18.1","13.9"
"Cook","2020-07-05","6","2133","1","232","18.1","13.7"
"Cook","2020-07-06","88","2221","23","255","20.2","14.6"
"Cook","2020-07-07","74","2295","8","263","20","15"
"Cook","2020-07-08","27","2322","5","268","21.5","15.7"
"Cook","2020-07-09","82","2404","14","282","21.2","16.2"
"Cook","2020-07-10","198","2602","34","316","20.4","16.6"
"Cook","2020-07-11","9","2611","1","317","16.8","17.4"
"Cook","2020-07-12","5","2616","0","317","14.4","16.3"
"Cook","2020-07-13","74","2690","6","323","11.8","16"
"Cook","2020-07-14","87","2777","12","335","12.3","16.1"
"Cook","2020-07-15","33","2810","5","340","11.8","16.6"
"Cook","2020-07-16","172","2982","28","368","11.7","16.4"
"Cook","2020-07-17","145","3127","23","391","11.5","15.9"
"Cook","2020-07-18","12","3139","0","391","9.9","13.3"
"Cook","2020-07-19","9","3148","2","393","13.1","13.7"
"Cook","2020-07-20","107","3255","19","412","14.4","13.1"
"Cook","2020-07-21","92","3347","11","423","14.2","13.2"
"Cook","2020-07-22","41","3388","6","429","14.1","12.9"
"Cook","2020-07-23","76","3464","8","437","13.3","12.5"
"Cook","2020-07-24","79","3543","11","448","13","12.2"
"Cook","2020-07-25","10","3553","5","453","20.1","15"
"Cook","2020-07-26","4","3557","2","455","24.1","18.6"
"Cook","2020-07-27","67","3624","16","471","25","19.7"
"Cook","2020-07-28","94","3718","8","479","24.5","19.3"
"Cook","2020-07-29","123","3841","51","530","28.3","21.2"
"Cook","2020-07-30","80","3921","8","538","28.3","20.8"
"Cook","2020-07-31","75","3996","8","546","27.8","20.4"
"Cook","2020-08-01","14","4010","2","548","22.7","21.4"
"Cook","2020-08-02","4","4014","0","548","15.5","19.8"
"Cook","2020-08-03","52","4066","9","557","14.6","19.8"
"Cook","2020-08-04","55","4121","4","561","14.4","19.5"
"Cook","2020-08-05","28","4149","6","567","11.6","19.9"
"Cook","2020-08-06","83","4232","11","578","12","20.1"
"Cook","2020-08-07","74","4306","10","588","12.4","20.1"
"Cook","2020-08-08","5","4311","2","590","16.1","19.4"
"Cook","2020-08-09","2","4313","0","590","16.1","15.8"
"Cook","2020-08-10","40","4353","5","595","15.4","15"
"Cook","2020-08-11","63","4416","4","599","15.3","14.9"
"Cook","2020-08-12","25","4441","4","603","14.5","13"
"Cook","2020-08-13","41","4482","2","605","13.3","12.7"
"Cook","2020-08-14","58","4540","5","610","12.6","12.5"
"Cook","2020-08-15","4","4544","1","611","10.5","13.3"
"Cook","2020-08-16","10","4554","1","612","11.9","14"
"Cook","2020-08-17","29","4583","5","617","12.6","14"
"Cook","2020-08-18","39","4622","7","624","14.2","14.8"
"Cook","2020-08-19","22","4644","1","625","12.6","13.6"
"Cook","2020-08-20","35","4679","1","626","12.3","12.8"
"Cook","2020-08-21","37","4716","2","628","11.9","12.2"
"Cook","2020-08-22","5","4721","0","628","8.3","9.4"
"Cook","2020-08-23","7","4728","4","632","15","13.5"
"Cook","2020-08-24","42","4770","1","633","12.9","12.7"
"Cook","2020-08-25","58","4828","3","636","11.1","12.7"
"Cook","2020-08-26","26","4854","6","642","13.7","13.2"
"Cook","2020-08-27","47","4901","0","642","13.3","12.8"
"Cook","2020-08-28","53","4954","0","642","12.5","12.2"
"Cook","2020-08-29","7","4961","0","642","12.5","10.4"
"Cook","2020-08-30","10","4971","0","642","4.4","9.7"
"Cook","2020-08-31","31","5002","3","645","5.4","9.2"
"Cook","2020-09-01","27","5029","1","646","5.2","8.1"
"Cook","2020-09-02","22","5051","5","651","5.2","9.4"
"Cook","2020-09-03","27","5078","4","655","7.3","10.3"
"Cook","2020-09-04","10","5088","1","656","8.7","10.6"
"Cook","2020-09-05","7","5095","0","656","8.7","10.6"
"Cook","2020-09-06","3","5098","0","656","8.7","6.5"
"Cook","2020-09-07","10","5108","0","656","7.3","6.4"
"Cook","2020-09-08","161","5269","1","657","6.9","6"
"Cook","2020-09-09","77","5346","2","659","4","4.6"
"Cook","2020-09-10","26","5372","4","663","4.1","5.7"
"Cook","2020-09-11","9","5381","0","663","2.7","5.7"
"Cook","2020-09-12","6","5387","0","663","2.7","5.7"
"Cook","2020-09-13","7","5394","2","665","6.7","7.7"
"Cook","2020-09-14","82","5476","2","667","7.1","7.2"
"Cook","2020-09-15","20","5496","1","668","7.7","7.3"
"Cook","2020-09-16","69","5565","2","670","7.8","5.9"
"Cook","2020-09-17","38","5603","2","672","6.3","5.2"
"Cook","2020-09-18","20","5623","7","679","11.3","7"
"Cook","2020-09-19","10","5633","0","679","11.3","7"
"Cook","2020-09-20","8","5641","1","680","9","7.9"
"Cook","2020-09-21","98","5739","2","682","9","8"
"Cook","2020-09-22","27","5766","1","683","8.8","8.2"
"Cook","2020-09-23","56","5822","0","683","8.4","8.1"
"Cook","2020-09-24","19","5841","0","683","7.6","7"
"Cook","2020-09-25","9","5850","0","683","2.6","7"
"Cook","2020-09-26","5","5855","0","683","2.6","7"
"Cook","2020-09-27","2","5857","0","683","0.8","4.9"
"Cook","2020-09-28","90","5947","3","686","1","5"
"Cook","2020-09-29","27","5974","1","687","1","4.9"
"Cook","2020-09-30","79","6053","2","689","1.4","4.9"
"Cook","2020-10-01","25","6078","1","690","1.9","4.8"
"Cook","2020-10-02","19","6097","0","690","1.9","2.3"
"Cook","2020-10-03","4","6101","1","691","5.5","4.1"
"Cook","2020-10-04","5","6106","2","693","11.2","6"
"Cook","2020-10-05","34","6140","0","693","10.7","5.9"
"Cook","2020-10-06","46","6186","1","694","10.5","5.8"
"Cook","2020-10-07","44","6230","2","696","10.8","6.1"
"Cook","2020-10-08","41","6271","3","699","11.3","6.6"
"Cook","2020-10-09","23","6294","0","699","11.3","6.6"
"Cook","2020-10-10","11","6305","0","699","7.7","6.6"
"Cook","2020-10-11","6","6311","1","700","4.4","7.8"
"Cook","2020-10-12","22","6333","1","701","5","7.9"
"Cook","2020-10-13","32","6365","4","705","6.5","8.5"
"Cook","2020-10-14","12","6377","0","705","5.9","8.3"
"Cook","2020-10-15","19","6396","1","706","5.6","8.4"
"Cook","2020-10-16","24","6420","2","708","6.8","9"
"Cook","2020-10-17","6","6426","1","709","9.1","8.4"
"Cook","2020-10-18","5","6431","0","709","6.8","5.6"
"Cook","2020-10-19","39","6470","1","710","6.5","5.8"
"Cook","2020-10-20","50","6520","6","716","6.4","6.5"
"Cook","2020-10-21","39","6559","1","717","6.8","6.3"
"Cook","2020-10-22","24","6583","0","717","6","5.8"
"Cook","2020-10-23","13","6596","1","718","5.9","6.3"
"Cook","2020-10-24","7","6603","1","719","5.6","7.4"
"Cook","2020-10-25","2","6605","0","719","5.6","6.2"
"Cook","2020-10-26","32","6637","1","720","5.7","6.1"
"Cook","2020-10-27","53","6690","8","728","6.1","6.3"
"Cook","2020-10-28","104","6794","6","734","6.6","6.7"
"Cook","2020-10-29","37","6831","9","743","10","8"
"Cook","2020-10-30","24","6855","4","747","11.3","8.6"
"Cook","2020-10-31","11","6866","1","748","10.6","8.1"
"Cook","2020-11-01","10","6876","8","756","22","13.8"
"Cook","2020-11-02","36","6912","6","762","23.9","14.8"
"Cook","2020-11-03","134","7046","4","766","22.2","14.2"
"Cook","2020-11-04","37","7083","3","769","22.5","14.6"
"Cook","2020-11-05","68","7151","13","782","21.8","15.9"
"Cook","2020-11-06","19","7170","1","783","20.2","15.7"
"Cook","2020-11-07","1","7171","0","783","18.9","14.7"
"Cook","2020-11-08","5","7176","0","783","7.4","14.7"
"Cook","2020-11-09","61","7237","5","788","6.2","15.1"
"Cook","2020-11-10","59","7296","5","793","7","14.6"
"Cook","2020-11-11","39","7335","6","799","8.1","15.3"
"Cook","2020-11-12","96","7431","7","806","6.4","14.1"
"Cook","2020-11-13","32","7463","2","808","6.5","13.3"
"Cook","2020-11-14","14","7477","2","810","8.6","13.7"
"Cook","2020-11-15","15","7492","2","812","10.5","9"
"Cook","2020-11-16","71","7563","6","818","10.5","8.4"
"Cook","2020-11-17","63","7626","6","824","10.6","8.8"
"Cook","2020-11-18","27","7653","3","827","10","9"
"Cook","2020-11-19","19","7672","4","831","12","9.2"
"Cook","2020-11-20","27","7699","6","837","14.3","10.4"
"Cook","2020-11-21","15","7714","3","840","15.1","11.8"
"Cook","2020-11-22","11","7725","0","840","13.2","11.8"
"Cook","2020-11-23","105","7830","22","862","15","12.7"
"Cook","2020-11-24","44","7874","5","867","15.2","12.9"
"Cook","2020-11-25","27","7901","9","876","18.4","14.2"
"Cook","2020-11-26","8","7909","0","876","15.4","13.7"
"Cook","2020-11-27","16","7925","3","879","14.9","14.6"
"Cook","2020-11-28","10","7935","4","883","17.8","16.4"
"Cook","2020-11-29","9","7944","3","886","22.5","17.9"
"Cook","2020-11-30","59","8003","9","895","21.7","18.3"
"Cook","2020-12-01","78","8081","12","907","22.3","18.8"
"Cook","2020-12-02","34","8115","7","914","20.5","19.4"
"Cook","2020-12-03","24","8139","8","922","25.2","20.3"
"Cook","2020-12-04","23","8162","6","928","26.3","20.6"
"Cook","2020-12-05","9","8171","3","931","25.3","21.6"
"Cook","2020-12-06","13","8184","5","936","26.1","24.3"
"Cook","2020-12-07","75","8259","17","953","27.1","24.4"
"Cook","2020-12-08","56","8315","4","957","25.9","24.1"
"Cook","2020-12-09","41","8356","9","966","26.1","23.3"
"Cook","2020-12-10","26","8382","3","969","23","24.1"
"Cook","2020-12-11","24","8406","3","972","21.1","23.7"
"Cook","2020-12-12","11","8417","0","972","16.3","20.8"
"Cook","2020-12-13","12","8429","4","976","15.6","20.8"
"Cook","2020-12-14","36","8465","9","985","15.9","21.5"
"Cook","2020-12-15","92","8557","28","1013","19.3","22.6"
"Cook","2020-12-16","40","8597","4","1017","17.5","21.8"
"Cook","2020-12-17","84","8681","11","1028","17.8","20.4"
"Cook","2020-12-18","22","8703","6","1034","19.9","20.5"
"Cook","2020-12-19","10","8713","1","1035","21.3","18.8"
"Cook","2020-12-20","17","8730","7","1042","22.4","19"
"Cook","2020-12-21","24","8754","7","1049","23","19.5"
"Cook","2020-12-22","91","8845","22","1071","22.1","20.7"
"Cook","2020-12-23","15","8860","2","1073","22.6","20.1"
"Cook","2020-12-24","15","8875","3","1076","23.6","20.7"
"Cook","2020-12-25","2","8877","0","1076","19.7","19.8"
"Cook","2020-12-26","12","8889","4","1080","23","22.2"
"Cook","2020-12-27","9","8898","3","1083","21.9","22.2"
"Cook","2020-12-28","57","8955","11","1094","20.5","21.8"
"Cook","2020-12-29","37","8992","5","1099","19","20.5"
"Cook","2020-12-30","34","9026","8","1107","20.4","21.5"
"Cook","2020-12-31","23","9049","2","1109","18.8","21.2"
"Cook","2021-01-01","7","9056","0","1109","18.8","19.3"
"Cook","2021-01-02","10","9066","1","1110","15.5","19.3"
"Cook","2021-01-03","14","9080","0","1110","10.7","16.3"
"Cook","2021-01-04","42","9122","4","1114","9.3","14.9"
"Cook","2021-01-05","45","9167","8","1122","9.9","14.5"
"Cook","2021-01-06","35","9202","2","1124","7.4","13.9"
"Cook","2021-01-07","28","9230","1","1125","6.7","12.7"
"Cook","2021-01-08","38","9268","6","1131","8.9","13.9"
"Cook","2021-01-09","10","9278","3","1134","11.8","13.6"
"Cook","2021-01-10","17","9295","1","1135","12.6","11.7"
"Cook","2021-01-11","17","9312","3","1138","13.8","11.5"
"Cook","2021-01-12","35","9347","7","1145","14.1","12"
"Cook","2021-01-13","17","9364","2","1147","15","11.2"
"Cook","2021-01-14","27","9391","1","1148","15","10.8"
"Cook","2021-01-15","13","9404","2","1150","14.9","11.9"
"Cook","2021-01-16","10","9414","0","1150","10.6","11.2"
"Cook","2021-01-17","8","9422","1","1151","11.6","12.1"
"Cook","2021-01-18","27","9449","2","1153","10.1","11.9"
"Cook","2021-01-19","25","9474","5","1158","10.1","12.1"
"Cook","2021-01-20","26","9500","6","1164","11.7","13.3"
"Cook","2021-01-21","7","9507","1","1165","13.2","14.1"
"Cook","2021-01-22","16","9523","4","1169","14.6","14.8"
"Cook","2021-01-23","5","9528","2","1171","20.3","15.5"
"Cook","2021-01-24","6","9534","1","1172","20.9","16.2"
"Cook","2021-01-25","17","9551","4","1176","23.2","16.7"
"Cook","2021-01-26","18","9569","2","1178","22","16"
"Cook","2021-01-27","15","9584","1","1179","19.6","15.7"
"Cook","2021-01-28","22","9606","5","1184","20.8","17"
"Cook","2021-01-29","18","9624","2","1186","18.8","16.7"
"Cook","2021-01-30","7","9631","1","1187","15.2","17.7"
"Cook","2021-01-31","2","9633","1","1188","19.9","20.4"
"Cook","2021-02-01","27","9660","3","1191","18.1","20.7"
"Cook","2021-02-02","17","9677","0","1191","16.6","19.3"
"Cook","2021-02-03","15","9692","3","1194","18.5","19"
"Cook","2021-02-04","9","9701","1","1195","16.8","18.8"
"Cook","2021-02-05","3","9704","0","1195","15.2","17"
"Cook","2021-02-06","0","9704","0","1195","13.2","14.2"
"Cook","2021-02-07","2","9706","1","1196","13.2","16.5"
"Cook","2021-02-08","0","9706","0","1196","11.6","14.9"
"Coweta","2020-02-01","0","0","0","0",".","."
"Coweta","2020-02-02","0","0","0","0",".","."
"Coweta","2020-02-03","0","0","0","0",".","."
"Coweta","2020-02-04","0","0","0","0",".","."
"Coweta","2020-02-05","0","0","0","0",".","."
"Coweta","2020-02-06","0","0","0","0",".","."
"Coweta","2020-02-07","0","0","0","0","0","."
"Coweta","2020-02-08","0","0","0","0","0","."
"Coweta","2020-02-09","0","0","0","0","0","."
"Coweta","2020-02-10","0","0","0","0","0","."
"Coweta","2020-02-11","0","0","0","0","0","."
"Coweta","2020-02-12","0","0","0","0","0","."
"Coweta","2020-02-13","0","0","0","0","0","."
"Coweta","2020-02-14","0","0","0","0","0","0"
"Coweta","2020-02-15","0","0","0","0","0","0"
"Coweta","2020-02-16","0","0","0","0","0","0"
"Coweta","2020-02-17","0","0","0","0","0","0"
"Coweta","2020-02-18","0","0","0","0","0","0"
"Coweta","2020-02-19","0","0","0","0","0","0"
"Coweta","2020-02-20","0","0","0","0","0","0"
"Coweta","2020-02-21","0","0","0","0","0","0"
"Coweta","2020-02-22","0","0","0","0","0","0"
"Coweta","2020-02-23","0","0","0","0","0","0"
"Coweta","2020-02-24","0","0","0","0","0","0"
"Coweta","2020-02-25","0","0","0","0","0","0"
"Coweta","2020-02-26","0","0","0","0","0","0"
"Coweta","2020-02-27","0","0","0","0","0","0"
"Coweta","2020-02-28","0","0","0","0","0","0"
"Coweta","2020-02-29","0","0","0","0","0","0"
"Coweta","2020-03-01","0","0","0","0","0","0"
"Coweta","2020-03-02","1","1","1","1","14.3","7.1"
"Coweta","2020-03-03","0","1","0","1","14.3","7.1"
"Coweta","2020-03-04","0","1","0","1","14.3","7.1"
"Coweta","2020-03-05","0","1","0","1","14.3","7.1"
"Coweta","2020-03-06","0","1","0","1","14.3","7.1"
"Coweta","2020-03-07","0","1","0","1","14.3","7.1"
"Coweta","2020-03-08","0","1","0","1","14.3","7.1"
"Coweta","2020-03-09","0","1","0","1","0","7.1"
"Coweta","2020-03-10","2","3","0","1","0","7.1"
"Coweta","2020-03-11","5","8","1","2","2.9","8.6"
"Coweta","2020-03-12","4","12","1","3","6.4","10.4"
"Coweta","2020-03-13","11","23","2","5","9","11.7"
"Coweta","2020-03-14","2","25","0","5","9","11.7"
"Coweta","2020-03-15","1","26","0","5","9","11.7"
"Coweta","2020-03-16","12","38","1","6","10.2","5.1"
"Coweta","2020-03-17","24","62","2","8","11.4","5.7"
"Coweta","2020-03-18","21","83","3","11","10.6","6.7"
"Coweta","2020-03-19","16","99","1","12","7.9","7.2"
"Coweta","2020-03-20","29","128","3","15","6.8","7.9"
"Coweta","2020-03-21","11","139","4","19","12","10.5"
"Coweta","2020-03-22","15","154","5","24","16.7","12.9"
"Coweta","2020-03-23","33","187","5","29","17.7","14"
"Coweta","2020-03-24","67","254","7","36","18","14.7"
"Coweta","2020-03-25","51","305","5","41","17.4","14"
"Coweta","2020-03-26","56","361","8","49","18.5","13.2"
"Coweta","2020-03-27","36","397","11","60","21.4","14.1"
"Coweta","2020-03-28","8","405","3","63","21.6","16.8"
"Coweta","2020-03-29","16","421","2","65","18.6","17.7"
"Coweta","2020-03-30","50","471","5","70","17.9","17.8"
"Coweta","2020-03-31","31","502","4","74","18.2","18.1"
"Coweta","2020-04-01","43","545","5","79","18.5","17.9"
"Coweta","2020-04-02","29","574","3","82","17.9","18.2"
"Coweta","2020-04-03","46","620","10","92","16.7","19"
"Coweta","2020-04-04","11","631","4","96","16.5","19"
"Coweta","2020-04-05","7","638","2","98","18.8","18.7"
"Coweta","2020-04-06","40","678","9","107","20.6","19.2"
"Coweta","2020-04-07","39","717","4","111","20.2","19.2"
"Coweta","2020-04-08","45","762","0","111","18.5","18.5"
"Coweta","2020-04-09","49","811","13","124","20.9","19.4"
"Coweta","2020-04-10","48","859","6","130","19.5","18.1"
"Coweta","2020-04-11","9","868","1","131","15.9","16.2"
"Coweta","2020-04-12","10","878","1","132","13.3","16"
"Coweta","2020-04-13","33","911","4","136","11.8","16.2"
"Coweta","2020-04-14","34","945","5","141","12.4","16.3"
"Coweta","2020-04-15","53","998","6","147","14","16.3"
"Coweta","2020-04-16","68","1066","12","159","12.8","16.8"
"Coweta","2020-04-17","108","1174","12","171","12.6","16.1"
"Coweta","2020-04-18","58","1232","10","181","13.4","14.7"
"Coweta","2020-04-19","22","1254","2","183","13.3","13.3"
"Coweta","2020-04-20","117","1371","8","191","12.6","12.2"
"Coweta","2020-04-21","106","1477","6","197","11.3","11.8"
"Coweta","2020-04-22","85","1562","5","202","10.5","12.3"
"Coweta","2020-04-23","43","1605","4","206","9.3","11"
"Coweta","2020-04-24","121","1726","14","220","9.4","11"
"Coweta","2020-04-25","67","1793","3","223","7.5","10.5"
"Coweta","2020-04-26","22","1815","1","224","6.9","10.1"
"Coweta","2020-04-27","111","1926","9","233","7.1","9.8"
"Coweta","2020-04-28","122","2048","1","234","6.4","8.8"
"Coweta","2020-04-29","99","2147","4","238","6.1","8.3"
"Coweta","2020-04-30","141","2288","7","245","5.5","7.4"
"Coweta","2020-05-01","63","2351","4","249","4.8","7.1"
"Coweta","2020-05-02","73","2424","2","251","4.5","6"
"Coweta","2020-05-03","30","2454","3","254","5.3","6.1"
"Coweta","2020-05-04","136","2590","5","259","4.7","5.9"
"Coweta","2020-05-05","109","2699","2","261","4.8","5.6"
"Coweta","2020-05-06","111","2810","3","264","4.6","5.4"
"Coweta","2020-05-07","96","2906","8","272","5.1","5.3"
"Coweta","2020-05-08","139","3045","7","279","4.9","4.8"
"Coweta","2020-05-09","72","3117","0","279","4.5","4.5"
"Coweta","2020-05-10","29","3146","5","284","5.5","5.4"
"Coweta","2020-05-11","196","3342","7","291","5.5","5.1"
"Coweta","2020-05-12","170","3512","4","295","5.6","5.2"
"Coweta","2020-05-13","175","3687","5","300","5.6","5.1"
"Coweta","2020-05-14","160","3847","13","313","5.6","5.3"
"Coweta","2020-05-15","181","4028","11","324","5.7","5.3"
"Coweta","2020-05-16","113","4141","11","335","7.1","5.8"
"Coweta","2020-05-17","39","4180","2","337","5.4","5.5"
"Coweta","2020-05-18","133","4313","7","344","5.6","5.6"
"Coweta","2020-05-19","298","4611","17","361","6.1","5.9"
"Coweta","2020-05-20","201","4812","4","365","6","5.8"
"Coweta","2020-05-21","135","4947","5","370","5.4","5.5"
"Coweta","2020-05-22","123","5070","12","382","5.9","5.8"
"Coweta","2020-05-23","73","5143","14","396","7.2","7.2"
"Coweta","2020-05-24","32","5175","1","397","7","6.2"
"Coweta","2020-05-25","47","5222","3","400","7.1","6.4"
"Coweta","2020-05-26","199","5421","6","406","6.7","6.4"
"Coweta","2020-05-27","194","5615","5","411","6.8","6.4"
"Coweta","2020-05-28","178","5793","11","422","7.2","6.3"
"Coweta","2020-05-29","172","5965","9","431","6.5","6.2"
"Coweta","2020-05-30","24","5989","2","433","5","6.1"
"Coweta","2020-05-31","36","6025","4","437","6.1","6.5"
"Coweta","2020-06-01","178","6203","4","441","5.5","6.3"
"Coweta","2020-06-02","170","6373","10","451","5.9","6.3"
"Coweta","2020-06-03","153","6526","4","455","5.9","6.4"
"Coweta","2020-06-04","153","6679","5","460","5.5","6.4"
"Coweta","2020-06-05","105","6784","4","464","5.3","5.9"
"Coweta","2020-06-06","36","6820","3","467","5.3","5.2"
"Coweta","2020-06-07","28","6848","5","472","6.3","6.2"
"Coweta","2020-06-08","105","6953","1","473","6.1","5.8"
"Coweta","2020-06-09","109","7062","4","477","5.8","5.9"
"Coweta","2020-06-10","92","7154","6","483","6.3","6.1"
"Coweta","2020-06-11","164","7318","8","491","6.6","6.1"
"Coweta","2020-06-12","255","7573","6","497","6.4","5.8"
"Coweta","2020-06-13","38","7611","5","502","7.1","6.2"
"Coweta","2020-06-14","31","7642","4","506","6.3","6.3"
"Coweta","2020-06-15","198","7840","11","517","7","6.6"
"Coweta","2020-06-16","210","8050","9","526","7.1","6.4"
"Coweta","2020-06-17","192","8242","11","537","7","6.7"
"Coweta","2020-06-18","159","8401","18","555","7.9","7.2"
"Coweta","2020-06-19","156","8557","13","568","8.8","7.6"
"Coweta","2020-06-20","34","8591","2","570","7.7","7.4"
"Coweta","2020-06-21","33","8624","5","575","8","7.2"
"Coweta","2020-06-22","274","8898","25","600","8.5","7.8"
"Coweta","2020-06-23","311","9209","25","625","9.1","8.1"
"Coweta","2020-06-24","206","9415","17","642","9.4","8.2"
"Coweta","2020-06-25","133","9548","11","653","9","8.5"
"Coweta","2020-06-26","258","9806","13","666","8.5","8.6"
"Coweta","2020-06-27","35","9841","6","672","10.1","8.9"
"Coweta","2020-06-28","32","9873","3","675","9.3","8.7"
"Coweta","2020-06-29","331","10204","20","695","8.9","8.7"
"Coweta","2020-06-30","318","10522","15","710","8.4","8.7"
"Coweta","2020-07-01","252","10774","11","721","7.9","8.6"
"Coweta","2020-07-02","275","11049","18","739","7.6","8.3"
"Coweta","2020-07-03","90","11139","8","747","8.2","8.3"
"Coweta","2020-07-04","27","11166","7","754","9.4","9.8"
"Coweta","2020-07-05","42","11208","8","762","10.8","10.1"
"Coweta","2020-07-06","294","11502","29","791","11.3","10.1"
"Coweta","2020-07-07","311","11813","29","820","12","10.2"
"Coweta","2020-07-08","177","11990","10","830","12.2","10"
"Coweta","2020-07-09","191","12181","25","855","13.1","10.4"
"Coweta","2020-07-10","184","12365","10","865","12.6","10.4"
"Coweta","2020-07-11","58","12423","13","878","12.1","10.8"
"Coweta","2020-07-12","45","12468","11","889","12.9","11.8"
"Coweta","2020-07-13","162","12630","7","896","12.1","11.7"
"Coweta","2020-07-14","159","12789","24","920","12.9","12.5"
"Coweta","2020-07-15","159","12948","18","938","13.7","13"
"Coweta","2020-07-16","132","13080","24","962","14.5","13.8"
"Coweta","2020-07-17","131","13211","19","981","15.8","14.2"
"Coweta","2020-07-18","44","13255","6","987","14.5","13.3"
"Coweta","2020-07-19","31","13286","3","990","12.4","12.6"
"Coweta","2020-07-20","150","13436","18","1008","13.5","12.8"
"Coweta","2020-07-21","112","13548","15","1023","13.2","13.1"
"Coweta","2020-07-22","120","13668","14","1037","13.3","13.5"
"Coweta","2020-07-23","176","13844","12","1049","11.7","13.1"
"Coweta","2020-07-24","145","13989","12","1061","10.8","13.3"
"Coweta","2020-07-25","58","14047","9","1070","11","12.8"
"Coweta","2020-07-26","32","14079","4","1074","11.5","11.9"
"Coweta","2020-07-27","216","14295","12","1086","10.5","12"
"Coweta","2020-07-28","170","14465","11","1097","9.5","11.4"
"Coweta","2020-07-29","152","14617","15","1112","9.3","11.3"
"Coweta","2020-07-30","125","14742","14","1126","9.9","10.8"
"Coweta","2020-07-31","132","14874","7","1133","9.5","10.1"
"Coweta","2020-08-01","58","14932","7","1140","9","10"
"Coweta","2020-08-02","46","14978","7","1147","9.4","10.4"
"Coweta","2020-08-03","176","15154","19","1166","10.1","10.3"
"Coweta","2020-08-04","208","15362","8","1174","9.8","9.7"
"Coweta","2020-08-05","119","15481","6","1180","9.1","9.2"
"Coweta","2020-08-06","199","15680","11","1191","8.3","9.1"
"Coweta","2020-08-07","175","15855","12","1203","8.5","9"
"Coweta","2020-08-08","91","15946","7","1210","7.9","8.4"
"Coweta","2020-08-09","55","16001","6","1216","7.2","8.3"
"Coweta","2020-08-10","208","16209","9","1225","6.3","8.2"
"Coweta","2020-08-11","268","16477","47","1272","8.3","9"
"Coweta","2020-08-12","291","16768","37","1309","9.4","9.2"
"Coweta","2020-08-13","232","17000","30","1339","10.4","9.3"
"Coweta","2020-08-14","322","17322","40","1379","11.2","9.8"
"Coweta","2020-08-15","102","17424","9","1388","11.4","9.6"
"Coweta","2020-08-16","69","17493","4","1392","10.7","8.9"
"Coweta","2020-08-17","324","17817","24","1416","11.1","8.7"
"Coweta","2020-08-18","228","18045","27","1443","10.3","9.3"
"Coweta","2020-08-19","258","18303","35","1478","10.4","9.9"
"Coweta","2020-08-20","224","18527","18","1496","9.7","10.1"
"Coweta","2020-08-21","248","18775","35","1531","9.9","10.6"
"Coweta","2020-08-22","68","18843","7","1538","10.2","10.8"
"Coweta","2020-08-23","73","18916","13","1551","11.9","11.3"
"Coweta","2020-08-24","281","19197","58","1609","13.8","12.4"
"Coweta","2020-08-25","199","19396","24","1633","13.8","12"
"Coweta","2020-08-26","194","19590","23","1656","13.5","12"
"Coweta","2020-08-27","164","19754","21","1677","14.2","12"
"Coweta","2020-08-28","258","20012","31","1708","13.9","11.9"
"Coweta","2020-08-29","58","20070","3","1711","13.2","11.7"
"Coweta","2020-08-30","66","20136","7","1718","12.2","12"
"Coweta","2020-08-31","228","20364","31","1749","11.2","12.5"
"Coweta","2020-09-01","198","20562","13","1762","10.4","12.1"
"Coweta","2020-09-02","198","20760","24","1786","10.4","12"
"Coweta","2020-09-03","188","20948","26","1812","10.6","12.4"
"Coweta","2020-09-04","205","21153","24","1836","10.5","12.2"
"Coweta","2020-09-05","54","21207","4","1840","10.8","12"
"Coweta","2020-09-06","30","21237","1","1841","9.8","11"
"Coweta","2020-09-07","115","21352","16","1857","9.8","10.5"
"Coweta","2020-09-08","194","21546","18","1875","10.2","10.3"
"Coweta","2020-09-09","192","21738","15","1890","9.6","10"
"Coweta","2020-09-10","234","21972","19","1909","8.8","9.7"
"Coweta","2020-09-11","197","22169","17","1926","8.4","9.4"
"Coweta","2020-09-12","42","22211","6","1932","9.3","10.1"
"Coweta","2020-09-13","47","22258","1","1933","9.2","9.5"
"Coweta","2020-09-14","261","22519","31","1964","8.9","9.4"
"Coweta","2020-09-15","219","22738","10","1974","8.2","9.2"
"Coweta","2020-09-16","132","22870","0","1974","7.1","8.3"
"Coweta","2020-09-17","132","23002","3","1977","6.3","7.5"
"Coweta","2020-09-18","243","23245","15","1992","5.9","7.1"
"Coweta","2020-09-19","50","23295","2","1994","4.4","6.9"
"Coweta","2020-09-20","34","23329","4","1998","5.8","7.5"
"Coweta","2020-09-21","219","23548","10","2008","4.8","6.8"
"Coweta","2020-09-22","204","23752","10","2018","4.8","6.5"
"Coweta","2020-09-23","213","23965","4","2022","5.1","6.1"
"Coweta","2020-09-24","156","24121","16","2038","6.2","6.2"
"Coweta","2020-09-25","197","24318","3","2041","5.6","5.7"
"Coweta","2020-09-26","87","24405","7","2048","6.1","5.3"
"Coweta","2020-09-27","40","24445","1","2049","4.8","5.3"
"Coweta","2020-09-28","221","24666","13","2062","5","4.9"
"Coweta","2020-09-29","211","24877","7","2069","4.8","4.8"
"Coweta","2020-09-30","184","25061","11","2080","5.4","5.2"
"Coweta","2020-10-01","191","25252","9","2089","4.6","5.4"
"Coweta","2020-10-02","180","25432","5","2094","4.7","5.2"
"Coweta","2020-10-03","80","25512","5","2099","4.5","5.3"
"Coweta","2020-10-04","57","25569","1","2100","4.4","4.6"
"Coweta","2020-10-05","326","25895","12","2112","4.1","4.5"
"Coweta","2020-10-06","274","26169","14","2126","4.3","4.5"
"Coweta","2020-10-07","204","26373","11","2137","4.2","4.8"
"Coweta","2020-10-08","236","26609","25","2162","5.1","4.8"
"Coweta","2020-10-09","220","26829","13","2175","5.5","5.1"
"Coweta","2020-10-10","48","26877","2","2177","5.2","4.9"
"Coweta","2020-10-11","48","26925","6","2183","6.8","5.6"
"Coweta","2020-10-12","204","27129","5","2188","6.6","5.3"
"Coweta","2020-10-13","305","27434","23","2211","6.9","5.6"
"Coweta","2020-10-14","282","27716","15","2226","6.9","5.6"
"Coweta","2020-10-15","192","27908","12","2238","6.3","5.7"
"Coweta","2020-10-16","247","28155","6","2244","5.8","5.7"
"Coweta","2020-10-17","58","28213","3","2247","6","5.6"
"Coweta","2020-10-18","68","28281","2","2249","4.6","5.7"
"Coweta","2020-10-19","296","28577","17","2266","5.1","5.8"
"Coweta","2020-10-20","230","28807","13","2279","4.8","5.9"
"Coweta","2020-10-21","249","29056","20","2299","5.2","6.1"
"Coweta","2020-10-22","233","29289","18","2317","5.4","5.8"
"Coweta","2020-10-23","261","29550","13","2330","5.7","5.8"
"Coweta","2020-10-24","78","29628","9","2339","6.7","6.3"
"Coweta","2020-10-25","63","29691","2","2341","6.7","5.6"
"Coweta","2020-10-26","315","30006","26","2367","7.1","6.1"
"Coweta","2020-10-27","321","30327","24","2391","7.3","6"
"Coweta","2020-10-28","247","30574","15","2406","7","6.1"
"Coweta","2020-10-29","169","30743","10","2416","6.8","6.1"
"Coweta","2020-10-30","288","31031","14","2430","6.8","6.3"
"Coweta","2020-10-31","72","31103","4","2434","5.9","6.3"
"Coweta","2020-11-01","82","31185","2","2436","5.8","6.2"
"Coweta","2020-11-02","315","31500","20","2456","5.5","6.3"
"Coweta","2020-11-03","179","31679","10","2466","5.3","6.3"
"Coweta","2020-11-04","290","31969","24","2490","5.6","6.3"
"Coweta","2020-11-05","258","32227","15","2505","5.6","6.2"
"Coweta","2020-11-06","236","32463","21","2526","6.1","6.4"
"Coweta","2020-11-07","89","32552","3","2529","5.8","5.9"
"Coweta","2020-11-08","76","32628","6","2535","6.6","6.2"
"Coweta","2020-11-09","273","32901","16","2551","6.5","6"
"Coweta","2020-11-10","315","33216","11","2562","6.2","5.7"
"Coweta","2020-11-11","263","33479","10","2572","5.6","5.6"
"Coweta","2020-11-12","224","33703","15","2587","5.7","5.6"
"Coweta","2020-11-13","333","34036","26","2613","5.6","5.8"
"Coweta","2020-11-14","116","34152","14","2627","6.8","6.3"
"Coweta","2020-11-15","95","34247","10","2637","7.2","6.9"
"Coweta","2020-11-16","407","34654","49","2686","8.1","7.3"
"Coweta","2020-11-17","427","35081","44","2730","9","7.6"
"Coweta","2020-11-18","423","35504","34","2764","9.6","7.6"
"Coweta","2020-11-19","405","35909","21","2785","9.4","7.6"
"Coweta","2020-11-20","394","36303","29","2814","9.4","7.5"
"Coweta","2020-11-21","128","36431","13","2827","9.1","7.9"
"Coweta","2020-11-22","113","36544","12","2839","9.1","8.1"
"Coweta","2020-11-23","575","37119","74","2913","9.2","8.6"
"Coweta","2020-11-24","444","37563","50","2963","9.4","9.2"
"Coweta","2020-11-25","398","37961","41","3004","9.7","9.7"
"Coweta","2020-11-26","39","38000","3","3007","10","9.7"
"Coweta","2020-11-27","151","38151","25","3032","11.4","10.4"
"Coweta","2020-11-28","121","38272","13","3045","11.4","10.3"
"Coweta","2020-11-29","99","38371","16","3061","12.2","10.7"
"Coweta","2020-11-30","457","38828","62","3123","12.3","10.8"
"Coweta","2020-12-01","398","39226","27","3150","11.7","10.5"
"Coweta","2020-12-02","411","39637","36","3186","11.5","10.6"
"Coweta","2020-12-03","420","40057","54","3240","12.2","11.1"
"Coweta","2020-12-04","401","40458","47","3287","11.5","11.4"
"Coweta","2020-12-05","133","40591","18","3305","11.9","11.7"
"Coweta","2020-12-06","127","40718","19","3324","11.7","12"
"Coweta","2020-12-07","465","41183","67","3391","11.9","12.1"
"Coweta","2020-12-08","519","41702","61","3452","12.6","12.1"
"Coweta","2020-12-09","527","42229","67","3519","13.1","12.3"
"Coweta","2020-12-10","508","42737","58","3577","12.9","12.6"
"Coweta","2020-12-11","453","43190","62","3639","13.2","12.4"
"Coweta","2020-12-12","217","43407","40","3679","13.9","12.9"
"Coweta","2020-12-13","141","43548","17","3696","13.5","12.6"
"Coweta","2020-12-14","603","44151","75","3771","13.2","12.5"
"Coweta","2020-12-15","553","44704","65","3836","13.2","12.9"
"Coweta","2020-12-16","529","45233","79","3915","13.5","13.3"
"Coweta","2020-12-17","528","45761","90","4005","14.3","13.6"
"Coweta","2020-12-18","554","46315","87","4092","14.6","13.9"
"Coweta","2020-12-19","221","46536","42","4134","14.7","14.3"
"Coweta","2020-12-20","175","46711","29","4163","15.4","14.4"
"Coweta","2020-12-21","583","47294","85","4248","15.7","14.4"
"Coweta","2020-12-22","574","47868","100","4348","16.5","14.8"
"Coweta","2020-12-23","492","48360","64","4412","16.2","14.9"
"Coweta","2020-12-24","244","48604","45","4457","16.4","15.4"
"Coweta","2020-12-25","64","48668","11","4468","16.6","15.6"
"Coweta","2020-12-26","225","48893","57","4525","17.5","16.1"
"Coweta","2020-12-27","190","49083","44","4569","18.4","16.9"
"Coweta","2020-12-28","566","49649","137","4706","19.8","17.7"
"Coweta","2020-12-29","571","50220","149","4855","21.1","18.8"
"Coweta","2020-12-30","361","50581","65","4920","21.8","19"
"Coweta","2020-12-31","505","51086","104","5024","22.1","19.2"
"Coweta","2021-01-01","88","51174","15","5039","22.1","19.3"
"Coweta","2021-01-02","220","51394","40","5079","21","19.3"
"Coweta","2021-01-03","130","51524","33","5112","21.4","19.9"
"Coweta","2021-01-04","369","51893","86","5198","21.2","20.5"
"Coweta","2021-01-05","777","52670","124","5322","19.8","20.4"
"Coweta","2021-01-06","632","53302","121","5443","19.9","20.9"
"Coweta","2021-01-07","605","53907","111","5554","19.6","20.9"
"Coweta","2021-01-08","612","54519","119","5673","20","21"
"Coweta","2021-01-09","193","54712","34","5707","19.9","20.5"
"Coweta","2021-01-10","163","54875","29","5736","18.8","20.1"
"Coweta","2021-01-11","532","55407","89","5825","17.9","19.5"
"Coweta","2021-01-12","614","56021","81","5906","17.5","18.6"
"Coweta","2021-01-13","543","56564","99","6005","17.3","18.6"
"Coweta","2021-01-14","528","57092","65","6070","16.5","18"
"Coweta","2021-01-15","495","57587","69","6139","15.7","17.8"
"Coweta","2021-01-16","248","57835","54","6193","16.3","18.1"
"Coweta","2021-01-17","172","58007","26","6219","15.9","17.4"
"Coweta","2021-01-18","415","58422","65","6284","15.7","16.8"
"Coweta","2021-01-19","664","59086","84","6368","15.7","16.6"
"Coweta","2021-01-20","486","59572","66","6434","15","16.2"
"Coweta","2021-01-21","641","60213","94","6528","15.3","15.9"
"Coweta","2021-01-22","531","60744","56","6584","14.9","15.3"
"Coweta","2021-01-23","241","60985","41","6625","14.2","15.2"
"Coweta","2021-01-24","168","61153","29","6654","14.5","15.2"
"Coweta","2021-01-25","536","61689","49","6703","13.6","14.6"
"Coweta","2021-01-26","508","62197","61","6764","13.5","14.6"
"Coweta","2021-01-27","488","62685","43","6807","12.8","13.9"
"Coweta","2021-01-28","590","63275","78","6885","12.6","14"
"Coweta","2021-01-29","484","63759","46","6931","12.4","13.6"
"Coweta","2021-01-30","189","63948","30","6961","12.3","13.2"
"Coweta","2021-01-31","154","64102","23","6984","11.9","13.2"
"Coweta","2021-02-01","524","64626","45","7029","11.8","12.7"
"Coweta","2021-02-02","596","65222","69","7098","11.8","12.6"
"Coweta","2021-02-03","474","65696","42","7140","11.8","12.3"
"Coweta","2021-02-04","420","66116","35","7175","11.1","11.8"
"Coweta","2021-02-05","316","66432","26","7201","10.9","11.7"
"Coweta","2021-02-06","35","66467","3","7204","9.9","11.1"
"Coweta","2021-02-07","6","66473","0","7204","7.7","9.8"
"Coweta","2021-02-08","0","66473","0","7204","6.5","9.2"
"Crawford","2020-02-01","0","0","0","0",".","."
"Crawford","2020-02-02","0","0","0","0",".","."
"Crawford","2020-02-03","0","0","0","0",".","."
"Crawford","2020-02-04","0","0","0","0",".","."
"Crawford","2020-02-05","0","0","0","0",".","."
"Crawford","2020-02-06","0","0","0","0",".","."
"Crawford","2020-02-07","0","0","0","0","0","."
"Crawford","2020-02-08","0","0","0","0","0","."
"Crawford","2020-02-09","0","0","0","0","0","."
"Crawford","2020-02-10","0","0","0","0","0","."
"Crawford","2020-02-11","0","0","0","0","0","."
"Crawford","2020-02-12","0","0","0","0","0","."
"Crawford","2020-02-13","0","0","0","0","0","."
"Crawford","2020-02-14","1","1","0","0","0","0"
"Crawford","2020-02-15","0","1","0","0","0","0"
"Crawford","2020-02-16","0","1","0","0","0","0"
"Crawford","2020-02-17","0","1","0","0","0","0"
"Crawford","2020-02-18","0","1","0","0","0","0"
"Crawford","2020-02-19","0","1","0","0","0","0"
"Crawford","2020-02-20","0","1","0","0","0","0"
"Crawford","2020-02-21","0","1","0","0","0","0"
"Crawford","2020-02-22","0","1","0","0","0","0"
"Crawford","2020-02-23","0","1","0","0","0","0"
"Crawford","2020-02-24","0","1","0","0","0","0"
"Crawford","2020-02-25","0","1","0","0","0","0"
"Crawford","2020-02-26","0","1","0","0","0","0"
"Crawford","2020-02-27","0","1","0","0","0","0"
"Crawford","2020-02-28","0","1","0","0","0","0"
"Crawford","2020-02-29","0","1","0","0","0","0"
"Crawford","2020-03-01","0","1","0","0","0","0"
"Crawford","2020-03-02","0","1","0","0","0","0"
"Crawford","2020-03-03","0","1","0","0","0","0"
"Crawford","2020-03-04","0","1","0","0","0","0"
"Crawford","2020-03-05","0","1","0","0","0","0"
"Crawford","2020-03-06","0","1","0","0","0","0"
"Crawford","2020-03-07","0","1","0","0","0","0"
"Crawford","2020-03-08","0","1","0","0","0","0"
"Crawford","2020-03-09","0","1","0","0","0","0"
"Crawford","2020-03-10","0","1","0","0","0","0"
"Crawford","2020-03-11","0","1","0","0","0","0"
"Crawford","2020-03-12","1","2","0","0","0","0"
"Crawford","2020-03-13","0","2","0","0","0","0"
"Crawford","2020-03-14","0","2","0","0","0","0"
"Crawford","2020-03-15","0","2","0","0","0","0"
"Crawford","2020-03-16","0","2","0","0","0","0"
"Crawford","2020-03-17","1","3","0","0","0","0"
"Crawford","2020-03-18","2","5","0","0","0","0"
"Crawford","2020-03-19","2","7","0","0","0","0"
"Crawford","2020-03-20","2","9","0","0","0","0"
"Crawford","2020-03-21","0","9","0","0","0","0"
"Crawford","2020-03-22","0","9","0","0","0","0"
"Crawford","2020-03-23","3","12","0","0","0","0"
"Crawford","2020-03-24","10","22","0","0","0","0"
"Crawford","2020-03-25","0","22","0","0","0","0"
"Crawford","2020-03-26","2","24","0","0","0","0"
"Crawford","2020-03-27","3","27","0","0","0","0"
"Crawford","2020-03-28","2","29","0","0","0","0"
"Crawford","2020-03-29","5","34","0","0","0","0"
"Crawford","2020-03-30","1","35","0","0","0","0"
"Crawford","2020-03-31","0","35","0","0","0","0"
"Crawford","2020-04-01","7","42","0","0","0","0"
"Crawford","2020-04-02","4","46","1","1","3.6","1.8"
"Crawford","2020-04-03","3","49","0","1","3.6","1.8"
"Crawford","2020-04-04","0","49","0","1","3.6","1.8"
"Crawford","2020-04-05","3","52","2","3","13.1","6.5"
"Crawford","2020-04-06","4","56","1","4","16.7","8.3"
"Crawford","2020-04-07","7","63","4","8","24.8","12.4"
"Crawford","2020-04-08","7","70","0","8","24.8","12.4"
"Crawford","2020-04-09","5","75","4","12","32.7","18.1"
"Crawford","2020-04-10","7","82","0","12","32.7","18.1"
"Crawford","2020-04-11","0","82","0","12","32.7","18.1"
"Crawford","2020-04-12","4","86","0","12","23.2","18.1"
"Crawford","2020-04-13","5","91","0","12","19.6","18.1"
"Crawford","2020-04-14","7","98","4","16","19.6","22.2"
"Crawford","2020-04-15","6","104","0","16","19.6","22.2"
"Crawford","2020-04-16","2","106","0","16","8.2","20.4"
"Crawford","2020-04-17","3","109","0","16","8.2","20.4"
"Crawford","2020-04-18","4","113","0","16","8.2","20.4"
"Crawford","2020-04-19","0","113","0","16","8.2","15.7"
"Crawford","2020-04-20","0","113","0","16","8.2","13.9"
"Crawford","2020-04-21","6","119","0","16","0","9.8"
"Crawford","2020-04-22","5","124","0","16","0","9.8"
"Crawford","2020-04-23","3","127","0","16","0","4.1"
"Crawford","2020-04-24","4","131","1","17","3.6","5.9"
"Crawford","2020-04-25","0","131","0","17","3.6","5.9"
"Crawford","2020-04-26","0","131","0","17","3.6","5.9"
"Crawford","2020-04-27","6","137","3","20","10.7","9.4"
"Crawford","2020-04-28","7","144","0","20","10.7","5.4"
"Crawford","2020-04-29","6","150","3","23","17.9","8.9"
"Crawford","2020-04-30","4","154","2","25","25","12.5"
"Crawford","2020-05-01","4","158","0","25","21.4","12.5"
"Crawford","2020-05-02","3","161","0","25","21.4","12.5"
"Crawford","2020-05-03","4","165","0","25","21.4","12.5"
"Crawford","2020-05-04","6","171","0","25","14.3","12.5"
"Crawford","2020-05-05","1","172","0","25","14.3","12.5"
"Crawford","2020-05-06","0","172","0","25","7.1","12.5"
"Crawford","2020-05-07","18","190","0","25","0","12.5"
"Crawford","2020-05-08","4","194","0","25","0","10.7"
"Crawford","2020-05-09","1","195","0","25","0","10.7"
"Crawford","2020-05-10","1","196","0","25","0","10.7"
"Crawford","2020-05-11","27","223","8","33","4.2","9.3"
"Crawford","2020-05-12","10","233","7","40","14.2","14.3"
"Crawford","2020-05-13","12","245","1","41","15.4","11.3"
"Crawford","2020-05-14","18","263","1","42","16.2","8.1"
"Crawford","2020-05-15","8","271","0","42","16.2","8.1"
"Crawford","2020-05-16","0","271","0","42","16.2","8.1"
"Crawford","2020-05-17","1","272","0","42","16.2","8.1"
"Crawford","2020-05-18","2","274","1","43","19.1","11.7"
"Crawford","2020-05-19","13","287","2","45","11.3","12.8"
"Crawford","2020-05-20","9","296","0","45","10.1","12.8"
"Crawford","2020-05-21","21","317","1","46","10","13.1"
"Crawford","2020-05-22","3","320","1","47","14.8","15.5"
"Crawford","2020-05-23","1","321","0","47","14.8","15.5"
"Crawford","2020-05-24","4","325","0","47","14.8","15.5"
"Crawford","2020-05-25","6","331","0","47","7.6","13.4"
"Crawford","2020-05-26","13","344","0","47","5.4","8.4"
"Crawford","2020-05-27","5","349","0","47","5.4","7.8"
"Crawford","2020-05-28","23","372","2","49","6","8"
"Crawford","2020-05-29","3","375","0","49","1.2","8"
"Crawford","2020-05-30","2","377","1","50","8.4","11.6"
"Crawford","2020-05-31","5","382","0","50","8.4","11.6"
"Crawford","2020-06-01","7","389","0","50","8.4","8"
"Crawford","2020-06-02","4","393","1","51","12","8.7"
"Crawford","2020-06-03","7","400","0","51","12","8.7"
"Crawford","2020-06-04","15","415","0","51","10.7","8.4"
"Crawford","2020-06-05","11","426","0","51","10.7","6"
"Crawford","2020-06-06","1","427","0","51","3.6","6"
"Crawford","2020-06-07","4","431","1","52","7.1","7.8"
"Crawford","2020-06-08","6","437","0","52","7.1","7.8"
"Crawford","2020-06-09","3","440","0","52","3.6","7.8"
"Crawford","2020-06-10","6","446","0","52","3.6","7.8"
"Crawford","2020-06-11","16","462","1","53","4.5","7.6"
"Crawford","2020-06-12","7","469","0","53","4.5","7.6"
"Crawford","2020-06-13","2","471","1","54","11.6","7.6"
"Crawford","2020-06-14","6","477","2","56","12.8","10"
"Crawford","2020-06-15","10","487","0","56","12.8","10"
"Crawford","2020-06-16","5","492","0","56","12.8","8.2"
"Crawford","2020-06-17","8","500","1","57","14.6","9.1"
"Crawford","2020-06-18","20","520","1","58","14.4","9.4"
"Crawford","2020-06-19","22","542","0","58","14.4","9.4"
"Crawford","2020-06-20","1","543","0","58","7.3","9.4"
"Crawford","2020-06-21","40","583","0","58","2.5","7.6"
"Crawford","2020-06-22","22","605","0","58","2.5","7.6"
"Crawford","2020-06-23","9","614","1","59","4.1","8.4"
"Crawford","2020-06-24","12","626","0","59","2.3","8.4"
"Crawford","2020-06-25","25","651","3","62","3.3","8.9"
"Crawford","2020-06-26","12","663","0","62","3.3","8.9"
"Crawford","2020-06-27","4","667","2","64","10.4","8.9"
"Crawford","2020-06-28","6","673","3","67","17.6","10"
"Crawford","2020-06-29","16","689","4","71","21.2","11.8"
"Crawford","2020-06-30","7","696","2","73","23.7","13.9"
"Crawford","2020-07-01","14","710","4","77","27.7","15"
"Crawford","2020-07-02","44","754","12","89","29.9","16.6"
"Crawford","2020-07-03","10","764","1","90","31.3","17.3"
"Crawford","2020-07-04","2","766","0","90","24.2","17.3"
"Crawford","2020-07-05","1","767","0","90","17.1","17.3"
"Crawford","2020-07-06","22","789","3","93","15.4","18.3"
"Crawford","2020-07-07","16","805","4","97","14.9","19.3"
"Crawford","2020-07-08","9","814","3","100","15.6","21.7"
"Crawford","2020-07-09","35","849","8","108","15","22.4"
"Crawford","2020-07-10","12","861","0","108","13.5","22.4"
"Crawford","2020-07-11","5","866","1","109","16.4","20.3"
"Crawford","2020-07-12","7","873","3","112","22.5","19.8"
"Crawford","2020-07-13","24","897","2","114","21.8","18.6"
"Crawford","2020-07-14","15","912","3","117","21.1","18"
"Crawford","2020-07-15","16","928","3","120","19","17.3"
"Crawford","2020-07-16","39","967","7","127","18.3","16.6"
"Crawford","2020-07-17","24","991","6","133","21.8","17.7"
"Crawford","2020-07-18","8","999","0","133","19","17.7"
"Crawford","2020-07-19","0","999","0","133","12.9","17.7"
"Crawford","2020-07-20","13","1012","2","135","13.9","17.8"
"Crawford","2020-07-21","19","1031","2","137","12.5","16.8"
"Crawford","2020-07-22","10","1041","2","139","12.7","15.8"
"Crawford","2020-07-23","43","1084","5","144","11.8","15"
"Crawford","2020-07-24","18","1102","2","146","9.8","15.8"
"Crawford","2020-07-25","9","1111","1","147","11.4","15.2"
"Crawford","2020-07-26","6","1117","1","148","13.8","13.3"
"Crawford","2020-07-27","26","1143","1","149","12.1","13"
"Crawford","2020-07-28","13","1156","2","151","12.8","12.7"
"Crawford","2020-07-29","16","1172","4","155","13.5","13.1"
"Crawford","2020-07-30","54","1226","7","162","13.7","12.8"
"Crawford","2020-07-31","12","1238","1","163","13.3","11.6"
"Crawford","2020-08-01","6","1244","3","166","18.9","15.1"
"Crawford","2020-08-02","3","1247","0","166","16.5","15.1"
"Crawford","2020-08-03","13","1260","2","168","18.2","15.1"
"Crawford","2020-08-04","11","1271","1","169","17.3","15"
"Crawford","2020-08-05","15","1286","2","171","15.6","14.6"
"Crawford","2020-08-06","49","1335","2","173","14.3","14"
"Crawford","2020-08-07","21","1356","4","177","15.8","14.6"
"Crawford","2020-08-08","5","1361","0","177","8.7","13.8"
"Crawford","2020-08-09","8","1369","2","179","12.3","14.4"
"Crawford","2020-08-10","15","1384","1","180","11","14.6"
"Crawford","2020-08-11","15","1399","4","184","13.5","15.4"
"Crawford","2020-08-12","11","1410","2","186","14.2","14.9"
"Crawford","2020-08-13","63","1473","3","189","14.3","14.3"
"Crawford","2020-08-14","19","1492","3","192","13.9","14.9"
"Crawford","2020-08-15","12","1504","4","196","18.6","13.7"
"Crawford","2020-08-16","5","1509","1","197","17.9","15.1"
"Crawford","2020-08-17","15","1524","3","200","19.8","15.4"
"Crawford","2020-08-18","15","1539","2","202","17.9","15.7"
"Crawford","2020-08-19","10","1549","2","204","18.2","16.2"
"Crawford","2020-08-20","40","1589","7","211","20","17.2"
"Crawford","2020-08-21","16","1605","0","211","17.7","15.8"
"Crawford","2020-08-22","12","1617","2","213","15.4","17"
"Crawford","2020-08-23","16","1633","3","216","15.2","16.5"
"Crawford","2020-08-24","18","1651","3","219","14.7","17.3"
"Crawford","2020-08-25","14","1665","4","223","16.9","17.4"
"Crawford","2020-08-26","19","1684","1","224","14.8","16.5"
"Crawford","2020-08-27","30","1714","8","232","16.1","18"
"Crawford","2020-08-28","19","1733","1","233","16.8","17.3"
"Crawford","2020-08-29","11","1744","2","235","17.1","16.2"
"Crawford","2020-08-30","5","1749","0","235","14.4","14.8"
"Crawford","2020-08-31","13","1762","1","236","13.1","13.9"
"Crawford","2020-09-01","17","1779","3","239","11.5","14.2"
"Crawford","2020-09-02","7","1786","2","241","14.9","14.8"
"Crawford","2020-09-03","38","1824","3","244","12.2","14.1"
"Crawford","2020-09-04","14","1838","2","246","13.5","15.2"
"Crawford","2020-09-05","10","1848","0","246","10.9","14"
"Crawford","2020-09-06","27","1875","0","246","10.9","12.6"
"Crawford","2020-09-07","7","1882","1","247","11.8","12.5"
"Crawford","2020-09-08","20","1902","0","247","9.3","10.4"
"Crawford","2020-09-09","12","1914","4","251","10","12.4"
"Crawford","2020-09-10","24","1938","2","253","10","11.1"
"Crawford","2020-09-11","16","1954","1","254","8.9","11.2"
"Crawford","2020-09-12","4","1958","0","254","8.9","9.9"
"Crawford","2020-09-13","2","1960","0","254","8.9","9.9"
"Crawford","2020-09-14","13","1973","1","255","7.9","9.9"
"Crawford","2020-09-15","13","1986","1","256","9","9.2"
"Crawford","2020-09-16","15","2001","1","257","5.2","7.6"
"Crawford","2020-09-17","21","2022","0","257","4","7"
"Crawford","2020-09-18","12","2034","1","258","4.3","6.6"
"Crawford","2020-09-19","14","2048","3","261","7.4","8.1"
"Crawford","2020-09-20","4","2052","0","261","7.4","8.1"
"Crawford","2020-09-21","9","2061","0","261","6.3","7.1"
"Crawford","2020-09-22","15","2076","0","261","5.2","7.1"
"Crawford","2020-09-23","10","2086","0","261","4.3","4.7"
"Crawford","2020-09-24","19","2105","1","262","5","4.5"
"Crawford","2020-09-25","11","2116","0","262","3.8","4.1"
"Crawford","2020-09-26","5","2121","2","264","6.5","6.9"
"Crawford","2020-09-27","5","2126","0","264","6.5","6.9"
"Crawford","2020-09-28","14","2140","0","264","6.5","6.4"
"Crawford","2020-09-29","11","2151","0","264","6.5","5.8"
"Crawford","2020-09-30","14","2165","0","264","6.5","5.4"
"Crawford","2020-10-01","15","2180","0","264","5.7","5.4"
"Crawford","2020-10-02","15","2195","1","265","6.7","5.2"
"Crawford","2020-10-03","10","2205","1","266","2.4","4.4"
"Crawford","2020-10-04","9","2214","3","269","7.1","6.8"
"Crawford","2020-10-05","20","2234","0","269","7.1","6.8"
"Crawford","2020-10-06","20","2254","1","270","7.9","7.2"
"Crawford","2020-10-07","6","2260","0","270","7.9","7.2"
"Crawford","2020-10-08","15","2275","3","273","10.7","8.2"
"Crawford","2020-10-09","15","2290","1","274","10.7","8.7"
"Crawford","2020-10-10","6","2296","0","274","9.3","5.8"
"Crawford","2020-10-11","5","2301","0","274","4.5","5.8"
"Crawford","2020-10-12","29","2330","2","276","5.5","6.3"
"Crawford","2020-10-13","20","2350","1","277","5.5","6.7"
"Crawford","2020-10-14","11","2361","1","278","6.8","7.3"
"Crawford","2020-10-15","20","2381","2","280","5.4","8"
"Crawford","2020-10-16","10","2391","0","280","4.4","7.6"
"Crawford","2020-10-17","3","2394","0","280","4.4","6.9"
"Crawford","2020-10-18","5","2399","1","281","7.3","5.9"
"Crawford","2020-10-19","31","2430","2","283","7.2","6.4"
"Crawford","2020-10-20","11","2441","0","283","6.5","6"
"Crawford","2020-10-21","13","2454","2","285","7.4","7.1"
"Crawford","2020-10-22","22","2476","3","288","7.9","6.7"
"Crawford","2020-10-23","18","2494","2","290","9.5","7"
"Crawford","2020-10-24","7","2501","1","291","11.6","8"
"Crawford","2020-10-25","5","2506","0","291","8.7","8"
"Crawford","2020-10-26","14","2520","0","291","7.8","7.5"
"Crawford","2020-10-27","13","2533","0","291","7.8","7.1"
"Crawford","2020-10-28","9","2542","0","291","5.6","6.5"
"Crawford","2020-10-29","14","2556","1","292","4.6","6.3"
"Crawford","2020-10-30","13","2569","2","294","5.3","7.4"
"Crawford","2020-10-31","3","2572","1","295","8","9.8"
"Crawford","2020-11-01","8","2580","0","295","8","8.3"
"Crawford","2020-11-02","13","2593","0","295","8","7.9"
"Crawford","2020-11-03","12","2605","1","296","9.2","8.5"
"Crawford","2020-11-04","13","2618","0","296","9.2","7.4"
"Crawford","2020-11-05","22","2640","1","297","8.8","6.7"
"Crawford","2020-11-06","24","2664","0","297","6.6","5.9"
"Crawford","2020-11-07","6","2670","0","297","1.8","4.9"
"Crawford","2020-11-08","1","2671","0","297","1.8","4.9"
"Crawford","2020-11-09","27","2698","1","298","2.4","5.2"
"Crawford","2020-11-10","14","2712","1","299","2.2","5.7"
"Crawford","2020-11-11","11","2723","1","300","3.5","6.3"
"Crawford","2020-11-12","31","2754","3","303","4.2","6.5"
"Crawford","2020-11-13","7","2761","0","303","4.2","5.4"
"Crawford","2020-11-14","11","2772","0","303","4.2","3"
"Crawford","2020-11-15","4","2776","1","304","7.8","4.8"
"Crawford","2020-11-16","22","2798","4","308","9.9","6.1"
"Crawford","2020-11-17","19","2817","0","308","8.9","5.5"
"Crawford","2020-11-18","12","2829","2","310","9.9","6.7"
"Crawford","2020-11-19","8","2837","0","310","8.5","6.4"
"Crawford","2020-11-20","15","2852","1","311","9.5","6.9"
"Crawford","2020-11-21","3","2855","0","311","9.5","6.9"
"Crawford","2020-11-22","6","2861","0","311","5.9","6.9"
"Crawford","2020-11-23","17","2878","3","314","5.9","7.9"
"Crawford","2020-11-24","11","2889","2","316","8.5","8.7"
"Crawford","2020-11-25","9","2898","2","318","9.2","9.6"
"Crawford","2020-11-26","3","2901","1","319","14","11.3"
"Crawford","2020-11-27","7","2908","0","319","13.1","11.3"
"Crawford","2020-11-28","6","2914","1","320","15.4","12.5"
"Crawford","2020-11-29","4","2918","1","321","19","12.5"
"Crawford","2020-11-30","26","2944","5","326","19.2","12.5"
"Crawford","2020-12-01","13","2957","1","327","17.7","13.1"
"Crawford","2020-12-02","14","2971","2","329","16.6","12.9"
"Crawford","2020-12-03","24","2995","5","334","14.8","14.4"
"Crawford","2020-12-04","19","3014","5","339","18.6","15.8"
"Crawford","2020-12-05","11","3025","2","341","18.8","17.1"
"Crawford","2020-12-06","8","3033","1","342","17","18"
"Crawford","2020-12-07","23","3056","5","347","17.4","18.3"
"Crawford","2020-12-08","18","3074","2","349","17.9","17.8"
"Crawford","2020-12-09","16","3090","2","351","17.6","17.1"
"Crawford","2020-12-10","42","3132","8","359","17.3","16.1"
"Crawford","2020-12-11","19","3151","0","359","13.6","16.1"
"Crawford","2020-12-12","8","3159","2","361","14.6","16.7"
"Crawford","2020-12-13","4","3163","2","363","19.9","18.5"
"Crawford","2020-12-14","27","3190","5","368","19.5","18.4"
"Crawford","2020-12-15","15","3205","5","373","22.6","20.2"
"Crawford","2020-12-16","20","3225","4","377","23.7","20.6"
"Crawford","2020-12-17","44","3269","8","385","23.6","20.5"
"Crawford","2020-12-18","22","3291","6","391","27.5","20.5"
"Crawford","2020-12-19","18","3309","8","399","30.3","22.4"
"Crawford","2020-12-20","14","3323","3","402","26.2","23"
"Crawford","2020-12-21","26","3349","8","410","27.9","23.7"
"Crawford","2020-12-22","15","3364","3","413","26","24.3"
"Crawford","2020-12-23","21","3385","7","420","27.9","25.8"
"Crawford","2020-12-24","11","3396","6","426","33.1","28.3"
"Crawford","2020-12-25","9","3405","2","428","32.4","29.9"
"Crawford","2020-12-26","15","3420","4","432","29.9","30.1"
"Crawford","2020-12-27","11","3431","5","437","33.3","29.7"
"Crawford","2020-12-28","39","3470","8","445","31.8","29.9"
"Crawford","2020-12-29","31","3501","5","450","31.3","28.6"
"Crawford","2020-12-30","26","3527","5","455","29.3","28.6"
"Crawford","2020-12-31","38","3565","7","462","24.1","28.6"
"Crawford","2021-01-01","5","3570","2","464","26.6","29.5"
"Crawford","2021-01-02","9","3579","3","467","27.6","28.7"
"Crawford","2021-01-03","12","3591","3","470","24.7","29"
"Crawford","2021-01-04","29","3620","5","475","24.2","28"
"Crawford","2021-01-05","35","3655","10","485","26","28.6"
"Crawford","2021-01-06","27","3682","6","491","26.4","27.8"
"Crawford","2021-01-07","44","3726","4","495","25.1","24.6"
"Crawford","2021-01-08","30","3756","2","497","20.3","23.5"
"Crawford","2021-01-09","22","3778","4","501","18.1","22.9"
"Crawford","2021-01-10","14","3792","3","504","17.6","21.1"
"Crawford","2021-01-11","33","3825","3","507","16.5","20.3"
"Crawford","2021-01-12","26","3851","8","515","16.8","21.4"
"Crawford","2021-01-13","19","3870","1","516","14.4","20.4"
"Crawford","2021-01-14","13","3883","1","517","14.2","19.6"
"Crawford","2021-01-15","10","3893","1","518","14.6","17.5"
"Crawford","2021-01-16","7","3900","2","520","16.1","17.1"
"Crawford","2021-01-17","10","3910","1","521","14.5","16.1"
"Crawford","2021-01-18","25","3935","4","525","15.5","16"
"Crawford","2021-01-19","16","3951","4","529","14.6","15.7"
"Crawford","2021-01-20","22","3973","7","536","18.4","16.4"
"Crawford","2021-01-21","35","4008","1","537","17.7","16"
"Crawford","2021-01-22","17","4025","1","538","17.2","15.9"
"Crawford","2021-01-23","12","4037","3","541","16.7","16.4"
"Crawford","2021-01-24","10","4047","2","543","18.1","16.3"
"Crawford","2021-01-25","28","4075","4","547","17.8","16.7"
"Crawford","2021-01-26","18","4093","0","547","14.3","14.5"
"Crawford","2021-01-27","18","4111","3","550","12.1","15.3"
"Crawford","2021-01-28","33","4144","5","555","13.9","15.8"
"Crawford","2021-01-29","16","4160","5","560","17.5","17.3"
"Crawford","2021-01-30","9","4169","4","564","20.3","18.5"
"Crawford","2021-01-31","4","4173","0","564","17.4","17.7"
"Crawford","2021-02-01","12","4185","2","566","17.7","17.8"
"Crawford","2021-02-02","11","4196","1","567","19","16.7"
"Crawford","2021-02-03","11","4207","1","568","18","15"
"Crawford","2021-02-04","34","4241","3","571","17.1","15.5"
"Crawford","2021-02-05","14","4255","0","571","12.6","15"
"Crawford","2021-02-06","9","4264","1","572","7.8","14"
"Crawford","2021-02-07","0","4264","0","572","7.8","12.6"
"Crawford","2021-02-08","0","4264","0","572","5.4","11.6"
"Crisp","2020-02-01","0","0","0","0",".","."
"Crisp","2020-02-02","0","0","0","0",".","."
"Crisp","2020-02-03","0","0","0","0",".","."
"Crisp","2020-02-04","0","0","0","0",".","."
"Crisp","2020-02-05","0","0","0","0",".","."
"Crisp","2020-02-06","0","0","0","0",".","."
"Crisp","2020-02-07","0","0","0","0","0","."
"Crisp","2020-02-08","0","0","0","0","0","."
"Crisp","2020-02-09","0","0","0","0","0","."
"Crisp","2020-02-10","0","0","0","0","0","."
"Crisp","2020-02-11","0","0","0","0","0","."
"Crisp","2020-02-12","0","0","0","0","0","."
"Crisp","2020-02-13","0","0","0","0","0","."
"Crisp","2020-02-14","0","0","0","0","0","0"
"Crisp","2020-02-15","0","0","0","0","0","0"
"Crisp","2020-02-16","0","0","0","0","0","0"
"Crisp","2020-02-17","0","0","0","0","0","0"
"Crisp","2020-02-18","0","0","0","0","0","0"
"Crisp","2020-02-19","0","0","0","0","0","0"
"Crisp","2020-02-20","0","0","0","0","0","0"
"Crisp","2020-02-21","0","0","0","0","0","0"
"Crisp","2020-02-22","0","0","0","0","0","0"
"Crisp","2020-02-23","0","0","0","0","0","0"
"Crisp","2020-02-24","0","0","0","0","0","0"
"Crisp","2020-02-25","0","0","0","0","0","0"
"Crisp","2020-02-26","0","0","0","0","0","0"
"Crisp","2020-02-27","0","0","0","0","0","0"
"Crisp","2020-02-28","0","0","0","0","0","0"
"Crisp","2020-02-29","0","0","0","0","0","0"
"Crisp","2020-03-01","0","0","0","0","0","0"
"Crisp","2020-03-02","0","0","0","0","0","0"
"Crisp","2020-03-03","0","0","0","0","0","0"
"Crisp","2020-03-04","0","0","0","0","0","0"
"Crisp","2020-03-05","0","0","0","0","0","0"
"Crisp","2020-03-06","0","0","0","0","0","0"
"Crisp","2020-03-07","0","0","0","0","0","0"
"Crisp","2020-03-08","0","0","0","0","0","0"
"Crisp","2020-03-09","0","0","0","0","0","0"
"Crisp","2020-03-10","0","0","0","0","0","0"
"Crisp","2020-03-11","1","1","0","0","0","0"
"Crisp","2020-03-12","0","1","0","0","0","0"
"Crisp","2020-03-13","1","2","0","0","0","0"
"Crisp","2020-03-14","0","2","0","0","0","0"
"Crisp","2020-03-15","0","2","0","0","0","0"
"Crisp","2020-03-16","4","6","1","1","3.6","1.8"
"Crisp","2020-03-17","4","10","2","3","10.7","5.4"
"Crisp","2020-03-18","4","14","0","3","10.7","5.4"
"Crisp","2020-03-19","3","17","1","4","15.5","7.7"
"Crisp","2020-03-20","8","25","1","5","17.3","8.6"
"Crisp","2020-03-21","1","26","0","5","17.3","8.6"
"Crisp","2020-03-22","3","29","0","5","17.3","8.6"
"Crisp","2020-03-23","12","41","4","9","18.5","11"
"Crisp","2020-03-24","9","50","2","11","14.5","12.6"
"Crisp","2020-03-25","13","63","3","14","17.8","14.2"
"Crisp","2020-03-26","5","68","2","16","18.7","17.1"
"Crisp","2020-03-27","8","76","2","18","20.5","18.9"
"Crisp","2020-03-28","10","86","6","24","29.1","23.2"
"Crisp","2020-03-29","5","91","4","28","40.5","28.9"
"Crisp","2020-03-30","11","102","4","32","41","29.7"
"Crisp","2020-03-31","10","112","4","36","43.5","29"
"Crisp","2020-04-01","16","128","5","41","44.7","31.2"
"Crisp","2020-04-02","18","146","5","46","42.9","30.8"
"Crisp","2020-04-03","11","157","2","48","41.9","31.2"
"Crisp","2020-04-04","1","158","0","48","33.4","31.2"
"Crisp","2020-04-05","2","160","0","48","21.9","31.2"
"Crisp","2020-04-06","16","176","4","52","20.3","30.6"
"Crisp","2020-04-07","26","202","9","61","19.5","31.5"
"Crisp","2020-04-08","9","211","2","63","18.3","31.5"
"Crisp","2020-04-09","15","226","7","70","21","31.9"
"Crisp","2020-04-10","17","243","5","75","22.6","32.2"
"Crisp","2020-04-11","4","247","1","76","26.1","29.7"
"Crisp","2020-04-12","7","254","2","78","30.2","26.1"
"Crisp","2020-04-13","27","281","14","92","34","27.2"
"Crisp","2020-04-14","25","306","5","97","32","25.8"
"Crisp","2020-04-15","18","324","6","103","33.5","25.9"
"Crisp","2020-04-16","25","349","7","110","30.9","25.9"
"Crisp","2020-04-17","30","379","5","115","29.1","25.8"
"Crisp","2020-04-18","10","389","4","119","31.2","28.7"
"Crisp","2020-04-19","4","393","1","120","30.7","30.5"
"Crisp","2020-04-20","27","420","7","127","27","30.5"
"Crisp","2020-04-21","36","456","12","139","28.9","30.4"
"Crisp","2020-04-22","39","495","9","148","27.4","30.5"
"Crisp","2020-04-23","9","504","4","152","29.8","30.3"
"Crisp","2020-04-24","29","533","5","157","29.9","29.5"
"Crisp","2020-04-25","7","540","1","158","26.2","28.7"
"Crisp","2020-04-26","7","547","1","159","24.7","27.7"
"Crisp","2020-04-27","40","587","8","167","23.8","25.4"
"Crisp","2020-04-28","37","624","8","175","22.1","25.5"
"Crisp","2020-04-29","20","644","3","178","21","24.2"
"Crisp","2020-04-30","27","671","1","179","15.2","22.5"
"Crisp","2020-05-01","22","693","4","183","15.3","22.6"
"Crisp","2020-05-02","13","706","3","186","16.6","21.4"
"Crisp","2020-05-03","4","710","1","187","18.1","21.4"
"Crisp","2020-05-04","18","728","1","188","16","19.9"
"Crisp","2020-05-05","28","756","3","191","14.5","18.3"
"Crisp","2020-05-06","33","789","4","195","14.1","17.5"
"Crisp","2020-05-07","30","819","3","198","14.9","15.1"
"Crisp","2020-05-08","25","844","2","200","13.5","14.4"
"Crisp","2020-05-09","16","860","0","200","10.2","13.4"
"Crisp","2020-05-10","7","867","5","205","16.8","17.5"
"Crisp","2020-05-11","76","943","8","213","17.5","16.8"
"Crisp","2020-05-12","41","984","0","213","16","15.2"
"Crisp","2020-05-13","29","1013","1","214","14.8","14.4"
"Crisp","2020-05-14","44","1057","4","218","14.6","14.8"
"Crisp","2020-05-15","31","1088","3","221","14.9","14.2"
"Crisp","2020-05-16","7","1095","1","222","16.9","13.6"
"Crisp","2020-05-17","52","1147","8","230","8.9","12.9"
"Crisp","2020-05-18","22","1169","2","232","8.7","13.1"
"Crisp","2020-05-19","63","1232","6","238","10.1","13"
"Crisp","2020-05-20","61","1293","5","243","10.8","12.8"
"Crisp","2020-05-21","33","1326","4","247","11.2","12.9"
"Crisp","2020-05-22","56","1382","1","248","10.1","12.5"
"Crisp","2020-05-23","4","1386","0","248","8","12.5"
"Crisp","2020-05-24","7","1393","2","250","9.9","9.4"
"Crisp","2020-05-25","6","1399","0","250","8.6","8.7"
"Crisp","2020-05-26","38","1437","9","259","10.6","10.3"
"Crisp","2020-05-27","34","1471","2","261","10.3","10.5"
"Crisp","2020-05-28","55","1526","2","263","9.1","10.1"
"Crisp","2020-05-29","33","1559","0","263","8.8","9.4"
"Crisp","2020-05-30","5","1564","1","264","11.7","9.8"
"Crisp","2020-05-31","14","1578","0","264","7.6","8.7"
"Crisp","2020-06-01","52","1630","5","269","9","8.8"
"Crisp","2020-06-02","51","1681","1","270","5.9","8.2"
"Crisp","2020-06-03","66","1747","1","271","5.2","7.8"
"Crisp","2020-06-04","33","1780","6","277","7.3","8.2"
"Crisp","2020-06-05","18","1798","0","277","7.3","8.1"
"Crisp","2020-06-06","4","1802","1","278","8","9.9"
"Crisp","2020-06-07","3","1805","2","280","17.6","12.6"
"Crisp","2020-06-08","56","1861","3","283","17","13"
"Crisp","2020-06-09","30","1891","0","283","16.7","11.3"
"Crisp","2020-06-10","53","1944","6","289","18.1","11.7"
"Crisp","2020-06-11","82","2026","2","291","15.8","11.6"
"Crisp","2020-06-12","48","2074","9","300","18.5","12.9"
"Crisp","2020-06-13","8","2082","1","301","16.7","12.4"
"Crisp","2020-06-14","5","2087","0","301","7.2","12.4"
"Crisp","2020-06-15","43","2130","2","303","7.1","12"
"Crisp","2020-06-16","37","2167","0","303","7.1","11.9"
"Crisp","2020-06-17","47","2214","1","304","5.8","11.9"
"Crisp","2020-06-18","28","2242","0","304","5.4","10.6"
"Crisp","2020-06-19","62","2304","4","308","3.7","11.1"
"Crisp","2020-06-20","8","2312","2","310","5.5","11.1"
"Crisp","2020-06-21","0","2312","0","310","5.5","6.3"
"Crisp","2020-06-22","40","2352","2","312","5.5","6.3"
"Crisp","2020-06-23","40","2392","2","314","6.2","6.7"
"Crisp","2020-06-24","26","2418","2","316","7","6.4"
"Crisp","2020-06-25","36","2454","4","320","8.6","7"
"Crisp","2020-06-26","34","2488","2","322","8.5","6.1"
"Crisp","2020-06-27","15","2503","3","325","7.8","6.6"
"Crisp","2020-06-28","9","2512","3","328","12.6","9"
"Crisp","2020-06-29","74","2586","4","332","12.6","9.1"
"Crisp","2020-06-30","71","2657","8","340","13.5","9.9"
"Crisp","2020-07-01","55","2712","4","344","13.5","10.2"
"Crisp","2020-07-02","58","2770","4","348","12.9","10.7"
"Crisp","2020-07-03","11","2781","0","348","12","10.3"
"Crisp","2020-07-04","5","2786","3","351","17.7","12.8"
"Crisp","2020-07-05","11","2797","4","355","18.2","15.4"
"Crisp","2020-07-06","80","2877","10","365","19.2","15.9"
"Crisp","2020-07-07","42","2919","2","367","18.3","15.9"
"Crisp","2020-07-08","44","2963","3","370","18.2","15.8"
"Crisp","2020-07-09","92","3055","4","374","17.8","15.3"
"Crisp","2020-07-10","59","3114","10","384","20.2","16.1"
"Crisp","2020-07-11","14","3128","2","386","13.7","15.7"
"Crisp","2020-07-12","5","3133","2","388","14.2","16.2"
"Crisp","2020-07-13","87","3220","6","394","13.4","16.3"
"Crisp","2020-07-14","61","3281","2","396","13.2","15.7"
"Crisp","2020-07-15","30","3311","2","398","13.2","15.7"
"Crisp","2020-07-16","47","3358","2","400","13.2","15.5"
"Crisp","2020-07-17","51","3409","3","403","11.6","15.9"
"Crisp","2020-07-18","11","3420","0","403","9.6","11.6"
"Crisp","2020-07-19","10","3430","1","404","5.3","9.8"
"Crisp","2020-07-20","49","3479","4","408","5.5","9.5"
"Crisp","2020-07-21","18","3497","2","410","6.6","9.9"
"Crisp","2020-07-22","62","3559","2","412","6.1","9.6"
"Crisp","2020-07-23","24","3583","2","414","6.7","9.9"
"Crisp","2020-07-24","56","3639","3","417","6.6","9.1"
"Crisp","2020-07-25","16","3655","2","419","8.4","9"
"Crisp","2020-07-26","5","3660","0","419","7","6.1"
"Crisp","2020-07-27","58","3718","3","422","6.5","6"
"Crisp","2020-07-28","29","3747","1","423","5.4","6"
"Crisp","2020-07-29","58","3805","0","423","5","5.5"
"Crisp","2020-07-30","9","3814","0","423","3.8","5.2"
"Crisp","2020-07-31","49","3863","2","425","3.6","5.1"
"Crisp","2020-08-01","8","3871","0","425","1.8","5.1"
"Crisp","2020-08-02","6","3877","0","425","1.8","4.4"
"Crisp","2020-08-03","38","3915","6","431","3.3","4.9"
"Crisp","2020-08-04","23","3938","6","437","6.6","6"
"Crisp","2020-08-05","40","3978","2","439","7.3","6.1"
"Crisp","2020-08-06","25","4003","0","439","7.3","5.5"
"Crisp","2020-08-07","30","4033","1","440","7.2","5.4"
"Crisp","2020-08-08","7","4040","1","441","9.2","5.5"
"Crisp","2020-08-09","13","4053","2","443","11.4","6.6"
"Crisp","2020-08-10","51","4104","7","450","11.1","7.2"
"Crisp","2020-08-11","19","4123","4","454","10.4","8.5"
"Crisp","2020-08-12","30","4153","4","458","11.6","9.4"
"Crisp","2020-08-13","15","4168","1","459","12.5","9.9"
"Crisp","2020-08-14","36","4204","1","460","12.5","9.8"
"Crisp","2020-08-15","11","4215","2","462","13","11.1"
"Crisp","2020-08-16","1","4216","0","462","10.8","11.1"
"Crisp","2020-08-17","10","4226","1","463","10.3","10.7"
"Crisp","2020-08-18","7","4233","2","465","11.4","10.9"
"Crisp","2020-08-19","69","4302","16","481","12.8","12.2"
"Crisp","2020-08-20","20","4322","0","481","11.8","12.2"
"Crisp","2020-08-21","44","4366","3","484","12.4","12.4"
"Crisp","2020-08-22","11","4377","4","488","15","14"
"Crisp","2020-08-23","2","4379","0","488","15","12.9"
"Crisp","2020-08-24","41","4420","5","493","15.3","12.8"
"Crisp","2020-08-25","21","4441","3","496","13.3","12.3"
"Crisp","2020-08-26","27","4468","0","496","10","11.4"
"Crisp","2020-08-27","21","4489","2","498","11.3","11.6"
"Crisp","2020-08-28","40","4529","8","506","13.2","12.8"
"Crisp","2020-08-29","15","4544","1","507","9","12"
"Crisp","2020-08-30","7","4551","0","507","9","12"
"Crisp","2020-08-31","65","4616","7","514","8.7","12"
"Crisp","2020-09-01","25","4641","2","516","7.9","10.6"
"Crisp","2020-09-02","56","4697","6","522","9.4","9.7"
"Crisp","2020-09-03","26","4723","0","522","8","9.7"
"Crisp","2020-09-04","63","4786","6","528","6.5","9.9"
"Crisp","2020-09-05","7","4793","0","528","5.6","7.3"
"Crisp","2020-09-06","8","4801","0","528","5.6","7.3"
"Crisp","2020-09-07","5","4806","0","528","4","6.4"
"Crisp","2020-09-08","22","4828","4","532","5.5","6.7"
"Crisp","2020-09-09","40","4868","3","535","5","7.2"
"Crisp","2020-09-10","38","4906","4","539","6.5","7.3"
"Crisp","2020-09-11","47","4953","8","547","7.6","7.1"
"Crisp","2020-09-12","8","4961","1","548","9.4","7.5"
"Crisp","2020-09-13","8","4969","2","550","13","9.3"
"Crisp","2020-09-14","41","5010","4","554","14.4","9.2"
"Crisp","2020-09-15","21","5031","1","555","12.4","9"
"Crisp","2020-09-16","46","5077","3","558","12.3","8.7"
"Crisp","2020-09-17","16","5093","0","558","10.8","8.7"
"Crisp","2020-09-18","37","5130","3","561","9.5","8.6"
"Crisp","2020-09-19","6","5136","1","562","10.1","9.8"
"Crisp","2020-09-20","4","5140","1","563","10.1","11.5"
"Crisp","2020-09-21","41","5181","3","566","9.8","12.1"
"Crisp","2020-09-22","14","5195","0","566","9.1","10.8"
"Crisp","2020-09-23","40","5235","8","574","11","11.7"
"Crisp","2020-09-24","20","5255","2","576","12.4","11.6"
"Crisp","2020-09-25","65","5320","9","585","13.3","11.4"
"Crisp","2020-09-26","17","5337","0","585","10.9","10.5"
"Crisp","2020-09-27","0","5337","0","585","7.3","8.7"
"Crisp","2020-09-28","49","5386","5","590","7.7","8.7"
"Crisp","2020-09-29","23","5409","1","591","8.3","8.7"
"Crisp","2020-09-30","62","5471","8","599","7.3","9.2"
"Crisp","2020-10-01","32","5503","1","600","6.3","9.4"
"Crisp","2020-10-02","47","5550","5","605","5.9","9.6"
"Crisp","2020-10-03","2","5552","0","605","5.9","8.4"
"Crisp","2020-10-04","2","5554","0","605","5.9","6.6"
"Crisp","2020-10-05","73","5627","5","610","5.4","6.6"
"Crisp","2020-10-06","56","5683","3","613","5.6","6.9"
"Crisp","2020-10-07","44","5727","2","615","4.4","5.8"
"Crisp","2020-10-08","26","5753","4","619","6.1","6.2"
"Crisp","2020-10-09","66","5819","4","623","5.5","5.7"
"Crisp","2020-10-10","4","5823","0","623","5.5","5.7"
"Crisp","2020-10-11","4","5827","0","623","5.5","5.7"
"Crisp","2020-10-12","13","5840","1","624","5.6","5.5"
"Crisp","2020-10-13","54","5894","4","628","5.9","5.7"
"Crisp","2020-10-14","50","5944","4","632","6.4","5.4"
"Crisp","2020-10-15","62","6006","6","638","5.5","5.8"
"Crisp","2020-10-16","43","6049","4","642","6","5.7"
"Crisp","2020-10-17","3","6052","0","642","6","5.7"
"Crisp","2020-10-18","0","6052","0","642","6","5.7"
"Crisp","2020-10-19","22","6074","1","643","5.6","5.6"
"Crisp","2020-10-20","33","6107","1","644","4.9","5.4"
"Crisp","2020-10-21","40","6147","1","645","4.2","5.3"
"Crisp","2020-10-22","28","6175","1","646","3.3","4.4"
"Crisp","2020-10-23","28","6203","1","647","2.5","4.2"
"Crisp","2020-10-24","7","6210","0","647","2.5","4.2"
"Crisp","2020-10-25","5","6215","0","647","2.5","4.2"
"Crisp","2020-10-26","47","6262","5","652","3.3","4.4"
"Crisp","2020-10-27","34","6296","3","655","4.2","4.5"
"Crisp","2020-10-28","36","6332","2","657","4.6","4.4"
"Crisp","2020-10-29","24","6356","8","665","8.8","6.1"
"Crisp","2020-10-30","33","6389","4","669","10.1","6.3"
"Crisp","2020-10-31","11","6400","2","671","12.7","7.6"
"Crisp","2020-11-01","4","6404","0","671","12.7","7.6"
"Crisp","2020-11-02","24","6428","2","673","12.3","7.8"
"Crisp","2020-11-03","29","6457","1","674","11.6","7.9"
"Crisp","2020-11-04","42","6499","1","675","11.1","7.9"
"Crisp","2020-11-05","44","6543","3","678","7.3","8.1"
"Crisp","2020-11-06","28","6571","1","679","6.1","8.1"
"Crisp","2020-11-07","5","6576","0","679","3.5","8.1"
"Crisp","2020-11-08","5","6581","0","679","3.5","8.1"
"Crisp","2020-11-09","55","6636","6","685","3.9","8.1"
"Crisp","2020-11-10","46","6682","0","685","3.4","7.5"
"Crisp","2020-11-11","15","6697","1","686","4","7.6"
"Crisp","2020-11-12","57","6754","3","689","3.8","5.5"
"Crisp","2020-11-13","43","6797","2","691","3.9","5"
"Crisp","2020-11-14","2","6799","0","691","3.9","3.7"
"Crisp","2020-11-15","4","6803","0","691","3.9","3.7"
"Crisp","2020-11-16","44","6847","0","691","2.4","3.1"
"Crisp","2020-11-17","39","6886","0","691","2.4","2.9"
"Crisp","2020-11-18","11","6897","0","691","1.4","2.7"
"Crisp","2020-11-19","44","6941","2","693","1.3","2.5"
"Crisp","2020-11-20","35","6976","1","694","1.1","2.5"
"Crisp","2020-11-21","9","6985","0","694","1.1","2.5"
"Crisp","2020-11-22","9","6994","1","695","2.6","3.3"
"Crisp","2020-11-23","60","7054","8","703","4.5","3.5"
"Crisp","2020-11-24","38","7092","4","707","6.1","4.2"
"Crisp","2020-11-25","48","7140","4","711","7.2","4.3"
"Crisp","2020-11-26","4","7144","0","711","6.6","4"
"Crisp","2020-11-27","10","7154","0","711","6.2","3.6"
"Crisp","2020-11-28","6","7160","0","711","6.2","3.6"
"Crisp","2020-11-29","12","7172","2","713","7","4.8"
"Crisp","2020-11-30","53","7225","4","717","6.2","5.4"
"Crisp","2020-12-01","32","7257","0","717","4.6","5.4"
"Crisp","2020-12-02","53","7310","2","719","4","5.6"
"Crisp","2020-12-03","62","7372","2","721","4.5","5.5"
"Crisp","2020-12-04","60","7432","5","726","5.6","5.9"
"Crisp","2020-12-05","14","7446","4","730","9.7","8"
"Crisp","2020-12-06","6","7452","2","732","12.1","9.5"
"Crisp","2020-12-07","64","7516","13","745","13.9","10"
"Crisp","2020-12-08","25","7541","1","746","14.5","9.6"
"Crisp","2020-12-09","27","7568","4","750","16.1","10"
"Crisp","2020-12-10","53","7621","15","765","19.7","12.1"
"Crisp","2020-12-11","67","7688","12","777","21","13.3"
"Crisp","2020-12-12","15","7703","2","779","18.9","14.3"
"Crisp","2020-12-13","4","7707","0","779","14.1","13.1"
"Crisp","2020-12-14","58","7765","7","786","12.9","13.4"
"Crisp","2020-12-15","82","7847","6","792","13.4","13.9"
"Crisp","2020-12-16","34","7881","7","799","14.2","15.2"
"Crisp","2020-12-17","70","7951","4","803","11","15.3"
"Crisp","2020-12-18","46","7997","8","811","10.9","16"
"Crisp","2020-12-19","15","8012","1","812","10","14.4"
"Crisp","2020-12-20","8","8020","2","814","13.5","13.8"
"Crisp","2020-12-21","90","8110","15","829","14.2","13.6"
"Crisp","2020-12-22","65","8175","8","837","14.9","14.1"
"Crisp","2020-12-23","61","8236","2","839","12.4","13.3"
"Crisp","2020-12-24","15","8251","4","843","15.4","13.2"
"Crisp","2020-12-25","3","8254","0","843","12.9","11.9"
"Crisp","2020-12-26","10","8264","3","846","16.3","13.1"
"Crisp","2020-12-27","4","8268","1","847","16.3","14.9"
"Crisp","2020-12-28","61","8329","6","853","15.3","14.7"
"Crisp","2020-12-29","76","8405","17","870","16.7","15.8"
"Crisp","2020-12-30","85","8490","25","895","20.5","16.5"
"Crisp","2020-12-31","40","8530","5","900","18.4","16.9"
"Crisp","2021-01-01","2","8532","0","900","18.4","15.7"
"Crisp","2021-01-02","6","8538","1","901","16.5","16.4"
"Crisp","2021-01-03","3","8541","2","903","22.5","19.4"
"Crisp","2021-01-04","140","8681","27","930","23.8","19.6"
"Crisp","2021-01-05","91","8772","14","944","22.8","19.8"
"Crisp","2021-01-06","33","8805","3","947","19.9","20.2"
"Crisp","2021-01-07","62","8867","8","955","20","19.2"
"Crisp","2021-01-08","60","8927","6","961","21.4","19.9"
"Crisp","2021-01-09","14","8941","4","965","23.1","19.8"
"Crisp","2021-01-10","10","8951","1","966","15","18.8"
"Crisp","2021-01-11","27","8978","5","971","14.9","19.4"
"Crisp","2021-01-12","79","9057","11","982","14.7","18.8"
"Crisp","2021-01-13","28","9085","7","989","17","18.5"
"Crisp","2021-01-14","62","9147","13","1002","18.1","19.1"
"Crisp","2021-01-15","65","9212","13","1015","19.6","20.5"
"Crisp","2021-01-16","10","9222","2","1017","18.3","20.7"
"Crisp","2021-01-17","6","9228","1","1018","19.3","17.2"
"Crisp","2021-01-18","17","9245","2","1020","18.3","16.6"
"Crisp","2021-01-19","59","9304","7","1027","18","16.4"
"Crisp","2021-01-20","54","9358","20","1047","19.8","18.4"
"Crisp","2021-01-21","28","9386","5","1052","19.3","18.7"
"Crisp","2021-01-22","17","9403","1","1053","17.3","18.4"
"Crisp","2021-01-23","12","9415","2","1055","16.8","17.6"
"Crisp","2021-01-24","6","9421","2","1057","19.2","19.2"
"Crisp","2021-01-25","53","9474","7","1064","19.4","18.9"
"Crisp","2021-01-26","48","9522","8","1072","20.1","19.1"
"Crisp","2021-01-27","16","9538","4","1076","18.4","19.1"
"Crisp","2021-01-28","89","9627","7","1083","16.9","18.1"
"Crisp","2021-01-29","65","9692","6","1089","17.4","17.4"
"Crisp","2021-01-30","10","9702","1","1090","16.5","16.6"
"Crisp","2021-01-31","76","9778","0","1090","11.7","15.5"
"Crisp","2021-02-01","60","9838","8","1098","11.7","15.6"
"Crisp","2021-02-02","29","9867","2","1100","10.3","15.2"
"Crisp","2021-02-03","117","9984","3","1103","7.1","12.8"
"Crisp","2021-02-04","17","10001","1","1104","6.8","11.9"
"Crisp","2021-02-05","82","10083","4","1108","6.2","11.8"
"Crisp","2021-02-06","5","10088","0","1108","4.8","10.6"
"Crisp","2021-02-07","1","10089","0","1108","4.8","8.3"
"Crisp","2021-02-08","0","10089","0","1108","2.9","7.3"
"Dade","2020-02-01","0","0","0","0",".","."
"Dade","2020-02-02","0","0","0","0",".","."
"Dade","2020-02-03","0","0","0","0",".","."
"Dade","2020-02-04","0","0","0","0",".","."
"Dade","2020-02-05","0","0","0","0",".","."
"Dade","2020-02-06","0","0","0","0",".","."
"Dade","2020-02-07","0","0","0","0","0","."
"Dade","2020-02-08","0","0","0","0","0","."
"Dade","2020-02-09","0","0","0","0","0","."
"Dade","2020-02-10","0","0","0","0","0","."
"Dade","2020-02-11","0","0","0","0","0","."
"Dade","2020-02-12","0","0","0","0","0","."
"Dade","2020-02-13","0","0","0","0","0","."
"Dade","2020-02-14","0","0","0","0","0","0"
"Dade","2020-02-15","0","0","0","0","0","0"
"Dade","2020-02-16","0","0","0","0","0","0"
"Dade","2020-02-17","0","0","0","0","0","0"
"Dade","2020-02-18","0","0","0","0","0","0"
"Dade","2020-02-19","0","0","0","0","0","0"
"Dade","2020-02-20","0","0","0","0","0","0"
"Dade","2020-02-21","0","0","0","0","0","0"
"Dade","2020-02-22","0","0","0","0","0","0"
"Dade","2020-02-23","0","0","0","0","0","0"
"Dade","2020-02-24","0","0","0","0","0","0"
"Dade","2020-02-25","0","0","0","0","0","0"
"Dade","2020-02-26","0","0","0","0","0","0"
"Dade","2020-02-27","0","0","0","0","0","0"
"Dade","2020-02-28","0","0","0","0","0","0"
"Dade","2020-02-29","0","0","0","0","0","0"
"Dade","2020-03-01","0","0","0","0","0","0"
"Dade","2020-03-02","0","0","0","0","0","0"
"Dade","2020-03-03","0","0","0","0","0","0"
"Dade","2020-03-04","0","0","0","0","0","0"
"Dade","2020-03-05","0","0","0","0","0","0"
"Dade","2020-03-06","0","0","0","0","0","0"
"Dade","2020-03-07","0","0","0","0","0","0"
"Dade","2020-03-08","0","0","0","0","0","0"
"Dade","2020-03-09","0","0","0","0","0","0"
"Dade","2020-03-10","2","2","0","0","0","0"
"Dade","2020-03-11","1","3","0","0","0","0"
"Dade","2020-03-12","0","3","0","0","0","0"
"Dade","2020-03-13","0","3","0","0","0","0"
"Dade","2020-03-14","0","3","0","0","0","0"
"Dade","2020-03-15","0","3","0","0","0","0"
"Dade","2020-03-16","8","11","0","0","0","0"
"Dade","2020-03-17","8","19","0","0","0","0"
"Dade","2020-03-18","6","25","0","0","0","0"
"Dade","2020-03-19","24","49","0","0","0","0"
"Dade","2020-03-20","2","51","0","0","0","0"
"Dade","2020-03-21","1","52","0","0","0","0"
"Dade","2020-03-22","0","52","0","0","0","0"
"Dade","2020-03-23","9","61","0","0","0","0"
"Dade","2020-03-24","9","70","0","0","0","0"
"Dade","2020-03-25","10","80","0","0","0","0"
"Dade","2020-03-26","13","93","0","0","0","0"
"Dade","2020-03-27","8","101","0","0","0","0"
"Dade","2020-03-28","0","101","0","0","0","0"
"Dade","2020-03-29","0","101","0","0","0","0"
"Dade","2020-03-30","5","106","0","0","0","0"
"Dade","2020-03-31","14","120","0","0","0","0"
"Dade","2020-04-01","11","131","0","0","0","0"
"Dade","2020-04-02","8","139","0","0","0","0"
"Dade","2020-04-03","0","139","0","0","0","0"
"Dade","2020-04-04","0","139","0","0","0","0"
"Dade","2020-04-05","0","139","0","0","0","0"
"Dade","2020-04-06","5","144","0","0","0","0"
"Dade","2020-04-07","3","147","0","0","0","0"
"Dade","2020-04-08","7","154","0","0","0","0"
"Dade","2020-04-09","6","160","0","0","0","0"
"Dade","2020-04-10","9","169","0","0","0","0"
"Dade","2020-04-11","0","169","0","0","0","0"
"Dade","2020-04-12","0","169","0","0","0","0"
"Dade","2020-04-13","1","170","0","0","0","0"
"Dade","2020-04-14","13","183","0","0","0","0"
"Dade","2020-04-15","6","189","0","0","0","0"
"Dade","2020-04-16","7","196","0","0","0","0"
"Dade","2020-04-17","1","197","0","0","0","0"
"Dade","2020-04-18","0","197","0","0","0","0"
"Dade","2020-04-19","1","198","0","0","0","0"
"Dade","2020-04-20","6","204","0","0","0","0"
"Dade","2020-04-21","0","204","0","0","0","0"
"Dade","2020-04-22","2","206","0","0","0","0"
"Dade","2020-04-23","4","210","0","0","0","0"
"Dade","2020-04-24","3","213","0","0","0","0"
"Dade","2020-04-25","0","213","0","0","0","0"
"Dade","2020-04-26","0","213","0","0","0","0"
"Dade","2020-04-27","7","220","0","0","0","0"
"Dade","2020-04-28","9","229","2","2","3.2","1.6"
"Dade","2020-04-29","5","234","0","2","3.2","1.6"
"Dade","2020-04-30","10","244","0","2","3.2","1.6"
"Dade","2020-05-01","5","249","0","2","3.2","1.6"
"Dade","2020-05-02","0","249","0","2","3.2","1.6"
"Dade","2020-05-03","0","249","0","2","3.2","1.6"
"Dade","2020-05-04","6","255","0","2","3.2","1.6"
"Dade","2020-05-05","7","262","0","2","0","1.6"
"Dade","2020-05-06","5","267","2","4","5.7","4.4"
"Dade","2020-05-07","6","273","0","4","5.7","4.4"
"Dade","2020-05-08","2","275","0","4","5.7","4.4"
"Dade","2020-05-09","0","275","0","4","5.7","4.4"
"Dade","2020-05-10","0","275","0","4","5.7","4.4"
"Dade","2020-05-11","11","286","2","6","8.3","5.7"
"Dade","2020-05-12","7","293","0","6","8.3","4.2"
"Dade","2020-05-13","15","308","1","7","3.5","4.6"
"Dade","2020-05-14","3","311","0","7","3.5","4.6"
"Dade","2020-05-15","4","315","0","7","3.5","4.6"
"Dade","2020-05-16","0","315","0","7","3.5","4.6"
"Dade","2020-05-17","1","316","0","7","3.5","4.6"
"Dade","2020-05-18","1","317","0","7","1","4.6"
"Dade","2020-05-19","5","322","1","8","3.8","6.1"
"Dade","2020-05-20","11","333","0","8","2.9","3.2"
"Dade","2020-05-21","7","340","1","9","4.9","4.2"
"Dade","2020-05-22","1","341","0","9","4.9","4.2"
"Dade","2020-05-23","1","342","0","9","4.9","4.2"
"Dade","2020-05-24","0","342","0","9","4.9","4.2"
"Dade","2020-05-25","1","343","0","9","4.9","2.9"
"Dade","2020-05-26","10","353","0","9","2","2.9"
"Dade","2020-05-27","4","357","0","9","2","2.4"
"Dade","2020-05-28","5","362","1","10","2.9","3.9"
"Dade","2020-05-29","1","363","0","10","2.9","3.9"
"Dade","2020-05-30","3","366","0","10","2.9","3.9"
"Dade","2020-05-31","2","368","0","10","2.9","3.9"
"Dade","2020-06-01","5","373","2","12","8.6","6.7"
"Dade","2020-06-02","7","380","0","12","8.6","5.3"
"Dade","2020-06-03","4","384","0","12","8.6","5.3"
"Dade","2020-06-04","3","387","0","12","5.7","4.3"
"Dade","2020-06-05","1","388","0","12","5.7","4.3"
"Dade","2020-06-06","1","389","0","12","5.7","4.3"
"Dade","2020-06-07","0","389","0","12","5.7","4.3"
"Dade","2020-06-08","7","396","0","12","0","4.3"
"Dade","2020-06-09","4","400","0","12","0","4.3"
"Dade","2020-06-10","6","406","0","12","0","4.3"
"Dade","2020-06-11","4","410","0","12","0","2.9"
"Dade","2020-06-12","5","415","0","12","0","2.9"
"Dade","2020-06-13","2","417","1","13","7.1","6.4"
"Dade","2020-06-14","0","417","0","13","7.1","6.4"
"Dade","2020-06-15","7","424","1","14","9.2","4.6"
"Dade","2020-06-16","7","431","1","15","11.2","5.6"
"Dade","2020-06-17","6","437","2","17","16","8"
"Dade","2020-06-18","10","447","0","17","16","8"
"Dade","2020-06-19","0","447","0","17","16","8"
"Dade","2020-06-20","2","449","0","17","8.8","8"
"Dade","2020-06-21","5","454","0","17","8.8","8"
"Dade","2020-06-22","11","465","0","17","6.8","8"
"Dade","2020-06-23","10","475","0","17","4.8","8"
"Dade","2020-06-24","2","477","0","17","0","8"
"Dade","2020-06-25","17","494","4","21","3.4","9.7"
"Dade","2020-06-26","1","495","1","22","17.6","16.8"
"Dade","2020-06-27","2","497","0","22","17.6","13.2"
"Dade","2020-06-28","3","500","1","23","22.4","15.6"
"Dade","2020-06-29","14","514","1","24","23.4","15.1"
"Dade","2020-06-30","13","527","0","24","23.4","14.1"
"Dade","2020-07-01","12","539","1","25","24.6","12.3"
"Dade","2020-07-02","22","561","0","25","21.3","12.3"
"Dade","2020-07-03","1","562","0","25","7","12.3"
"Dade","2020-07-04","1","563","0","25","7","12.3"
"Dade","2020-07-05","2","565","0","25","2.2","12.3"
"Dade","2020-07-06","13","578","1","26","2.3","12.9"
"Dade","2020-07-07","13","591","1","27","3.4","13.4"
"Dade","2020-07-08","7","598","0","27","2.2","13.4"
"Dade","2020-07-09","7","605","0","27","2.2","11.7"
"Dade","2020-07-10","5","610","0","27","2.2","4.6"
"Dade","2020-07-11","0","610","0","27","2.2","4.6"
"Dade","2020-07-12","1","611","0","27","2.2","2.2"
"Dade","2020-07-13","5","616","0","27","1.1","1.7"
"Dade","2020-07-14","6","622","0","27","0","1.7"
"Dade","2020-07-15","12","634","1","28","1.2","1.7"
"Dade","2020-07-16","4","638","0","28","1.2","1.7"
"Dade","2020-07-17","2","640","0","28","1.2","1.7"
"Dade","2020-07-18","0","640","0","28","1.2","1.7"
"Dade","2020-07-19","2","642","0","28","1.2","1.7"
"Dade","2020-07-20","5","647","3","31","9.8","5.4"
"Dade","2020-07-21","9","656","0","31","9.8","4.9"
"Dade","2020-07-22","6","662","0","31","8.6","4.9"
"Dade","2020-07-23","11","673","1","32","9.9","5.5"
"Dade","2020-07-24","6","679","1","33","12.3","6.7"
"Dade","2020-07-25","3","682","0","33","12.3","6.7"
"Dade","2020-07-26","2","684","0","33","12.3","6.7"
"Dade","2020-07-27","20","704","1","34","4.4","7.1"
"Dade","2020-07-28","8","712","2","36","8","8.9"
"Dade","2020-07-29","2","714","0","36","8","8.3"
"Dade","2020-07-30","14","728","0","36","6.7","8.3"
"Dade","2020-07-31","5","733","0","36","4.3","8.3"
"Dade","2020-08-01","0","733","0","36","4.3","8.3"
"Dade","2020-08-02","2","735","0","36","4.3","8.3"
"Dade","2020-08-03","13","748","1","37","4.7","4.5"
"Dade","2020-08-04","7","755","0","37","1.1","4.5"
"Dade","2020-08-05","8","763","0","37","1.1","4.5"
"Dade","2020-08-06","13","776","1","38","2.2","4.4"
"Dade","2020-08-07","10","786","2","40","5.1","4.7"
"Dade","2020-08-08","2","788","0","40","5.1","4.7"
"Dade","2020-08-09","4","792","1","41","8.6","6.5"
"Dade","2020-08-10","19","811","0","41","7.5","6.1"
"Dade","2020-08-11","22","833","3","44","9.5","5.3"
"Dade","2020-08-12","11","844","0","44","9.5","5.3"
"Dade","2020-08-13","24","868","1","45","9","5.6"
"Dade","2020-08-14","17","885","0","45","6.1","5.6"
"Dade","2020-08-15","2","887","0","45","6.1","5.6"
"Dade","2020-08-16","1","888","0","45","2.5","5.6"
"Dade","2020-08-17","6","894","2","47","7.3","7.4"
"Dade","2020-08-18","9","903","0","47","5.4","7.4"
"Dade","2020-08-19","6","909","0","47","5.4","7.4"
"Dade","2020-08-20","6","915","0","47","4.8","6.9"
"Dade","2020-08-21","4","919","0","47","4.8","5.4"
"Dade","2020-08-22","1","920","1","48","19","12.6"
"Dade","2020-08-23","1","921","0","48","19","10.8"
"Dade","2020-08-24","10","931","2","50","17.1","12.2"
"Dade","2020-08-25","8","939","1","51","18.9","12.1"
"Dade","2020-08-26","11","950","0","51","18.9","12.1"
"Dade","2020-08-27","12","962","2","53","21.3","13"
"Dade","2020-08-28","7","969","4","57","29.5","17.1"
"Dade","2020-08-29","5","974","1","58","18","18.5"
"Dade","2020-08-30","0","974","0","58","18","18.5"
"Dade","2020-08-31","16","990","1","59","16.1","16.6"
"Dade","2020-09-01","12","1002","1","60","15.5","17.2"
"Dade","2020-09-02","82","1084","10","70","17.2","18.1"
"Dade","2020-09-03","13","1097","1","71","15.9","18.6"
"Dade","2020-09-04","9","1106","0","71","7.8","18.6"
"Dade","2020-09-05","1","1107","0","71","4.9","11.5"
"Dade","2020-09-06","2","1109","0","71","4.9","11.5"
"Dade","2020-09-07","4","1113","0","71","4","10.1"
"Dade","2020-09-08","15","1128","3","74","5.7","10.6"
"Dade","2020-09-09","114","1242","4","78","4.5","10.8"
"Dade","2020-09-10","11","1253","1","79","4.7","10.3"
"Dade","2020-09-11","4","1257","0","79","4.7","6.2"
"Dade","2020-09-12","3","1260","0","79","4.7","4.8"
"Dade","2020-09-13","0","1260","0","79","4.7","4.8"
"Dade","2020-09-14","6","1266","1","80","7","5.5"
"Dade","2020-09-15","9","1275","0","80","4.2","4.9"
"Dade","2020-09-16","80","1355","3","83","4.2","4.3"
"Dade","2020-09-17","16","1371","1","84","3.8","4.2"
"Dade","2020-09-18","10","1381","0","84","3.8","4.2"
"Dade","2020-09-19","5","1386","0","84","3.8","4.2"
"Dade","2020-09-20","0","1386","0","84","3.8","4.2"
"Dade","2020-09-21","8","1394","0","84","1.4","4.2"
"Dade","2020-09-22","13","1407","0","84","1.4","2.8"
"Dade","2020-09-23","61","1468","0","84","0.9","2.6"
"Dade","2020-09-24","4","1472","1","85","3.6","3.7"
"Dade","2020-09-25","0","1472","0","85","3.6","3.7"
"Dade","2020-09-26","1","1473","0","85","3.6","3.7"
"Dade","2020-09-27","0","1473","0","85","3.6","3.7"
"Dade","2020-09-28","5","1478","2","87","9.3","5.4"
"Dade","2020-09-29","4","1482","0","87","9.3","5.4"
"Dade","2020-09-30","26","1508","2","89","10.4","5.6"
"Dade","2020-10-01","2","1510","0","89","6.8","5.2"
"Dade","2020-10-02","6","1516","0","89","6.8","5.2"
"Dade","2020-10-03","5","1521","2","91","12.5","8"
"Dade","2020-10-04","3","1524","0","91","12.5","8"
"Dade","2020-10-05","12","1536","0","91","6.8","8"
"Dade","2020-10-06","5","1541","2","93","12.5","10.9"
"Dade","2020-10-07","81","1622","0","93","11.4","10.9"
"Dade","2020-10-08","11","1633","0","93","11.4","9.1"
"Dade","2020-10-09","16","1649","1","94","12.3","9.6"
"Dade","2020-10-10","2","1651","0","94","6.6","9.6"
"Dade","2020-10-11","0","1651","0","94","6.6","9.6"
"Dade","2020-10-12","13","1664","0","94","6.6","6.7"
"Dade","2020-10-13","13","1677","0","94","0.9","6.7"
"Dade","2020-10-14","75","1752","7","101","2.2","6.8"
"Dade","2020-10-15","9","1761","0","101","2.2","6.8"
"Dade","2020-10-16","11","1772","0","101","1.3","6.8"
"Dade","2020-10-17","2","1774","0","101","1.3","4"
"Dade","2020-10-18","1","1775","0","101","1.3","4"
"Dade","2020-10-19","8","1783","1","102","3.1","4.9"
"Dade","2020-10-20","8","1791","1","103","4.9","2.9"
"Dade","2020-10-21","96","1887","5","108","4.3","3.3"
"Dade","2020-10-22","6","1893","1","109","6.7","4.5"
"Dade","2020-10-23","11","1904","2","111","9.3","5.3"
"Dade","2020-10-24","7","1911","3","114","15.4","8.4"
"Dade","2020-10-25","0","1911","0","114","15.4","8.4"
"Dade","2020-10-26","17","1928","0","114","13.6","8.4"
"Dade","2020-10-27","12","1940","0","114","11.8","8.4"
"Dade","2020-10-28","57","1997","7","121","12.9","8.6"
"Dade","2020-10-29","14","2011","1","122","11.5","9.1"
"Dade","2020-10-30","9","2020","0","122","8.9","9.1"
"Dade","2020-10-31","13","2033","4","126","7.2","11.3"
"Dade","2020-11-01","2","2035","0","126","7.2","11.3"
"Dade","2020-11-02","15","2050","2","128","9.1","11.4"
"Dade","2020-11-03","7","2057","2","130","13.2","12.5"
"Dade","2020-11-04","130","2187","16","146","13.2","13"
"Dade","2020-11-05","9","2196","0","146","12.1","11.8"
"Dade","2020-11-06","3","2199","1","147","16.9","12.9"
"Dade","2020-11-07","3","2202","0","147","12.5","9.8"
"Dade","2020-11-08","4","2206","1","148","16.1","11.6"
"Dade","2020-11-09","25","2231","3","151","15.9","12.5"
"Dade","2020-11-10","9","2240","0","151","11.8","12.5"
"Dade","2020-11-11","16","2256","0","151","10","11.6"
"Dade","2020-11-12","25","2281","4","155","12.3","12.2"
"Dade","2020-11-13","15","2296","1","156","8.5","12.7"
"Dade","2020-11-14","9","2305","1","157","10.1","11.3"
"Dade","2020-11-15","3","2308","1","158","11.3","13.7"
"Dade","2020-11-16","22","2330","1","159","10.2","13.1"
"Dade","2020-11-17","16","2346","0","159","10.2","11"
"Dade","2020-11-18","173","2519","12","171","11.2","10.6"
"Dade","2020-11-19","16","2535","3","174","11.6","12"
"Dade","2020-11-20","27","2562","2","176","11.7","10.1"
"Dade","2020-11-21","13","2575","0","176","10.1","10.1"
"Dade","2020-11-22","4","2579","1","177","8.9","10.1"
"Dade","2020-11-23","27","2606","2","179","9.4","9.8"
"Dade","2020-11-24","10","2616","0","179","9.4","9.8"
"Dade","2020-11-25","48","2664","9","188","11","11.1"
"Dade","2020-11-26","0","2664","0","188","8.4","10"
"Dade","2020-11-27","8","2672","0","188","7.3","9.5"
"Dade","2020-11-28","3","2675","0","188","7.3","8.7"
"Dade","2020-11-29","7","2682","2","190","7.8","8.4"
"Dade","2020-11-30","27","2709","3","193","8.3","8.9"
"Dade","2020-12-01","14","2723","1","194","9.4","9.4"
"Dade","2020-12-02","122","2845","7","201","7.5","9.3"
"Dade","2020-12-03","21","2866","1","202","8.2","8.3"
"Dade","2020-12-04","27","2893","1","203","8.7","8"
"Dade","2020-12-05","6","2899","1","204","11.1","9.2"
"Dade","2020-12-06","4","2903","0","204","7","7.4"
"Dade","2020-12-07","30","2933","1","205","5.9","7.1"
"Dade","2020-12-08","32","2965","3","208","6.2","7.8"
"Dade","2020-12-09","147","3112","14","222","6.8","7.1"
"Dade","2020-12-10","22","3134","0","222","6.1","7.1"
"Dade","2020-12-11","31","3165","3","225","6.9","7.8"
"Dade","2020-12-12","9","3174","2","227","7.7","9.4"
"Dade","2020-12-13","3","3177","1","228","12.5","9.8"
"Dade","2020-12-14","33","3210","5","233","14.2","10"
"Dade","2020-12-15","24","3234","4","237","15.2","10.7"
"Dade","2020-12-16","158","3392","15","252","15.2","11"
"Dade","2020-12-17","21","3413","1","253","15.9","11"
"Dade","2020-12-18","21","3434","1","254","15.2","11.1"
"Dade","2020-12-19","7","3441","0","254","12","9.9"
"Dade","2020-12-20","3","3444","1","255","12","12.3"
"Dade","2020-12-21","48","3492","7","262","11.9","13.1"
"Dade","2020-12-22","24","3516","2","264","10.8","13"
"Dade","2020-12-23","90","3606","17","281","12.1","13.7"
"Dade","2020-12-24","6","3612","1","282","13.8","14.8"
"Dade","2020-12-25","1","3613","0","282","13.1","14.2"
"Dade","2020-12-26","14","3627","5","287","18.2","15.1"
"Dade","2020-12-27","5","3632","0","287","13.5","12.7"
"Dade","2020-12-28","38","3670","3","290","12.5","12.2"
"Dade","2020-12-29","26","3696","1","291","11.9","11.3"
"Dade","2020-12-30","152","3848","22","313","11.2","11.7"
"Dade","2020-12-31","11","3859","2","315","11.4","12.6"
"Dade","2021-01-01","1","3860","0","315","11.4","12.3"
"Dade","2021-01-02","0","3860","0","315","6.3","12.3"
"Dade","2021-01-03","5","3865","3","318","14.9","14.2"
"Dade","2021-01-04","29","3894","8","326","17.7","15.1"
"Dade","2021-01-05","46","3940","4","330","18.4","15.1"
"Dade","2021-01-06","134","4074","18","348","18.3","14.7"
"Dade","2021-01-07","15","4089","0","348","15.7","13.6"
"Dade","2021-01-08","29","4118","2","350","16.7","14.1"
"Dade","2021-01-09","6","4124","2","352","21.4","13.9"
"Dade","2021-01-10","11","4135","1","353","14.1","14.5"
"Dade","2021-01-11","28","4163","4","357","12.2","15"
"Dade","2021-01-12","17","4180","0","357","11","14.7"
"Dade","2021-01-13","137","4317","20","377","11.2","14.7"
"Dade","2021-01-14","18","4335","2","379","12.8","14.2"
"Dade","2021-01-15","21","4356","3","382","13.8","15.2"
"Dade","2021-01-16","2","4358","2","384","23.3","22.4"
"Dade","2021-01-17","8","4366","3","387","27.4","20.8"
"Dade","2021-01-18","15","4381","0","387","25.4","18.8"
"Dade","2021-01-19","21","4402","3","390","27.4","19.2"
"Dade","2021-01-20","114","4516","8","398","26.3","18.7"
"Dade","2021-01-21","13","4529","0","398","24.7","18.7"
"Dade","2021-01-22","5","4534","0","398","22.7","18.3"
"Dade","2021-01-23","4","4538","1","399","12","17.7"
"Dade","2021-01-24","6","4544","0","399","6.6","17"
"Dade","2021-01-25","17","4561","0","399","6.6","16"
"Dade","2021-01-26","8","4569","0","399","4.6","16"
"Dade","2021-01-27","112","4681","7","406","4.5","15.4"
"Dade","2021-01-28","19","4700","1","407","5.2","15"
"Dade","2021-01-29","6","4706","0","407","5.2","14"
"Dade","2021-01-30","8","4714","1","408","3.4","7.7"
"Dade","2021-01-31","9","4723","2","410","6.6","6.6"
"Dade","2021-02-01","14","4737","1","411","7.6","7.1"
"Dade","2021-02-02","9","4746","1","412","9.2","6.9"
"Dade","2021-02-03","59","4805","5","417","9.5","7"
"Dade","2021-02-04","15","4820","0","417","8.8","7"
"Dade","2021-02-05","8","4828","0","417","8.8","7"
"Dade","2021-02-06","0","4828","0","417","7","5.2"
"Dade","2021-02-07","0","4828","0","417","3.8","5.2"
"Dade","2021-02-08","0","4828","0","417","2.8","5.2"
"Dawson","2020-02-01","0","0","0","0",".","."
"Dawson","2020-02-02","0","0","0","0",".","."
"Dawson","2020-02-03","0","0","0","0",".","."
"Dawson","2020-02-04","0","0","0","0",".","."
"Dawson","2020-02-05","0","0","0","0",".","."
"Dawson","2020-02-06","0","0","0","0",".","."
"Dawson","2020-02-07","0","0","0","0","0","."
"Dawson","2020-02-08","0","0","0","0","0","."
"Dawson","2020-02-09","0","0","0","0","0","."
"Dawson","2020-02-10","0","0","0","0","0","."
"Dawson","2020-02-11","0","0","0","0","0","."
"Dawson","2020-02-12","0","0","0","0","0","."
"Dawson","2020-02-13","0","0","0","0","0","."
"Dawson","2020-02-14","0","0","0","0","0","0"
"Dawson","2020-02-15","0","0","0","0","0","0"
"Dawson","2020-02-16","0","0","0","0","0","0"
"Dawson","2020-02-17","0","0","0","0","0","0"
"Dawson","2020-02-18","0","0","0","0","0","0"
"Dawson","2020-02-19","0","0","0","0","0","0"
"Dawson","2020-02-20","0","0","0","0","0","0"
"Dawson","2020-02-21","0","0","0","0","0","0"
"Dawson","2020-02-22","0","0","0","0","0","0"
"Dawson","2020-02-23","0","0","0","0","0","0"
"Dawson","2020-02-24","0","0","0","0","0","0"
"Dawson","2020-02-25","0","0","0","0","0","0"
"Dawson","2020-02-26","0","0","0","0","0","0"
"Dawson","2020-02-27","0","0","0","0","0","0"
"Dawson","2020-02-28","0","0","0","0","0","0"
"Dawson","2020-02-29","0","0","0","0","0","0"
"Dawson","2020-03-01","0","0","0","0","0","0"
"Dawson","2020-03-02","0","0","0","0","0","0"
"Dawson","2020-03-03","0","0","0","0","0","0"
"Dawson","2020-03-04","0","0","0","0","0","0"
"Dawson","2020-03-05","0","0","0","0","0","0"
"Dawson","2020-03-06","0","0","0","0","0","0"
"Dawson","2020-03-07","0","0","0","0","0","0"
"Dawson","2020-03-08","0","0","0","0","0","0"
"Dawson","2020-03-09","0","0","0","0","0","0"
"Dawson","2020-03-10","0","0","0","0","0","0"
"Dawson","2020-03-11","0","0","0","0","0","0"
"Dawson","2020-03-12","4","4","0","0","0","0"
"Dawson","2020-03-13","2","6","0","0","0","0"
"Dawson","2020-03-14","0","6","0","0","0","0"
"Dawson","2020-03-15","0","6","0","0","0","0"
"Dawson","2020-03-16","4","10","0","0","0","0"
"Dawson","2020-03-17","4","14","0","0","0","0"
"Dawson","2020-03-18","13","27","1","1","1.1","0.5"
"Dawson","2020-03-19","9","36","1","2","2.7","1.3"
"Dawson","2020-03-20","6","42","0","2","2.7","1.3"
"Dawson","2020-03-21","5","47","0","2","2.7","1.3"
"Dawson","2020-03-22","4","51","1","3","6.3","3.1"
"Dawson","2020-03-23","7","58","1","4","8.3","4.1"
"Dawson","2020-03-24","9","67","1","5","9.9","4.9"
"Dawson","2020-03-25","2","69","0","5","8.8","4.9"
"Dawson","2020-03-26","4","73","0","5","7.2","4.9"
"Dawson","2020-03-27","1","74","0","5","7.2","4.9"
"Dawson","2020-03-28","0","74","0","5","7.2","4.9"
"Dawson","2020-03-29","4","78","0","5","3.6","4.9"
"Dawson","2020-03-30","7","85","2","7","5.7","7"
"Dawson","2020-03-31","2","87","0","7","4.1","7"
"Dawson","2020-04-01","0","87","0","7","4.1","6.4"
"Dawson","2020-04-02","1","88","0","7","4.1","5.6"
"Dawson","2020-04-03","0","88","0","7","4.1","5.6"
"Dawson","2020-04-04","1","89","0","7","4.1","5.6"
"Dawson","2020-04-05","2","91","0","7","4.1","3.9"
"Dawson","2020-04-06","15","106","6","13","5.7","5.7"
"Dawson","2020-04-07","5","111","0","13","5.7","4.9"
"Dawson","2020-04-08","5","116","1","14","8.6","6.3"
"Dawson","2020-04-09","5","121","0","14","8.6","6.3"
"Dawson","2020-04-10","10","131","4","18","14.3","9.2"
"Dawson","2020-04-11","1","132","0","18","14.3","9.2"
"Dawson","2020-04-12","0","132","0","18","14.3","9.2"
"Dawson","2020-04-13","6","138","4","22","18.1","11.9"
"Dawson","2020-04-14","3","141","0","22","18.1","11.9"
"Dawson","2020-04-15","3","144","0","22","15.2","11.9"
"Dawson","2020-04-16","8","152","1","23","17","12.8"
"Dawson","2020-04-17","5","157","0","23","11.3","12.8"
"Dawson","2020-04-18","3","160","0","23","11.3","12.8"
"Dawson","2020-04-19","1","161","0","23","11.3","12.8"
"Dawson","2020-04-20","11","172","1","24","3.1","10.6"
"Dawson","2020-04-21","9","181","0","24","3.1","10.6"
"Dawson","2020-04-22","3","184","0","24","3.1","9.2"
"Dawson","2020-04-23","5","189","0","24","1.3","9.2"
"Dawson","2020-04-24","7","196","0","24","1.3","6.3"
"Dawson","2020-04-25","35","231","5","29","3.3","7.3"
"Dawson","2020-04-26","3","234","0","29","3.3","7.3"
"Dawson","2020-04-27","11","245","0","29","2","2.6"
"Dawson","2020-04-28","55","300","1","30","2.3","2.7"
"Dawson","2020-04-29","49","349","1","31","2.6","2.8"
"Dawson","2020-04-30","57","406","0","31","2.6","1.9"
"Dawson","2020-05-01","29","435","0","31","2.6","1.9"
"Dawson","2020-05-02","27","462","1","32","1.1","2.2"
"Dawson","2020-05-03","11","473","0","32","1.1","2.2"
"Dawson","2020-05-04","16","489","0","32","1.1","1.6"
"Dawson","2020-05-05","33","522","2","34","1.7","2"
"Dawson","2020-05-06","28","550","1","35","1.9","2.2"
"Dawson","2020-05-07","26","576","0","35","1.9","2.2"
"Dawson","2020-05-08","54","630","12","47","5.1","3.8"
"Dawson","2020-05-09","17","647","0","47","4.6","2.8"
"Dawson","2020-05-10","3","650","1","48","9.3","5.2"
"Dawson","2020-05-11","53","703","10","58","12","6.5"
"Dawson","2020-05-12","35","738","0","58","11.1","6.4"
"Dawson","2020-05-13","14","752","1","59","11.7","6.8"
"Dawson","2020-05-14","57","809","1","60","11.9","6.9"
"Dawson","2020-05-15","49","858","2","62","9.3","7.2"
"Dawson","2020-05-16","20","878","2","64","10.7","7.6"
"Dawson","2020-05-17","18","896","2","66","7.6","8.4"
"Dawson","2020-05-18","29","925","6","72","7.8","9.9"
"Dawson","2020-05-19","40","965","2","74","8.5","9.8"
"Dawson","2020-05-20","49","1014","1","75","7.8","9.7"
"Dawson","2020-05-21","29","1043","0","75","7.6","9.7"
"Dawson","2020-05-22","34","1077","2","77","7.8","8.6"
"Dawson","2020-05-23","6","1083","0","77","6.4","8.6"
"Dawson","2020-05-24","7","1090","0","77","4.8","6.2"
"Dawson","2020-05-25","3","1093","0","77","1.8","4.8"
"Dawson","2020-05-26","22","1115","0","77","1.1","4.8"
"Dawson","2020-05-27","42","1157","0","77","0.8","4.3"
"Dawson","2020-05-28","20","1177","0","77","0.8","4.2"
"Dawson","2020-05-29","30","1207","1","78","0.5","4.1"
"Dawson","2020-05-30","6","1213","0","78","0.5","3.4"
"Dawson","2020-05-31","6","1219","0","78","0.5","2.6"
"Dawson","2020-06-01","31","1250","0","78","0.5","1.2"
"Dawson","2020-06-02","18","1268","0","78","0.5","0.8"
"Dawson","2020-06-03","38","1306","0","78","0.5","0.7"
"Dawson","2020-06-04","36","1342","0","78","0.5","0.7"
"Dawson","2020-06-05","22","1364","0","78","0","0.2"
"Dawson","2020-06-06","1","1365","0","78","0","0.2"
"Dawson","2020-06-07","6","1371","0","78","0","0.2"
"Dawson","2020-06-08","13","1384","0","78","0","0.2"
"Dawson","2020-06-09","18","1402","0","78","0","0.2"
"Dawson","2020-06-10","15","1417","0","78","0","0.2"
"Dawson","2020-06-11","30","1447","1","79","0.5","0.5"
"Dawson","2020-06-12","18","1465","1","80","1.3","0.6"
"Dawson","2020-06-13","6","1471","0","80","1.3","0.6"
"Dawson","2020-06-14","6","1477","0","80","1.3","0.6"
"Dawson","2020-06-15","15","1492","0","80","1.3","0.6"
"Dawson","2020-06-16","29","1521","0","80","1.3","0.6"
"Dawson","2020-06-17","17","1538","0","80","1.3","0.6"
"Dawson","2020-06-18","15","1553","0","80","0.8","0.6"
"Dawson","2020-06-19","17","1570","0","80","0","0.6"
"Dawson","2020-06-20","2","1572","0","80","0","0.6"
"Dawson","2020-06-21","3","1575","0","80","0","0.6"
"Dawson","2020-06-22","25","1600","3","83","1.7","1.5"
"Dawson","2020-06-23","12","1612","0","83","1.7","1.5"
"Dawson","2020-06-24","25","1637","1","84","2.3","1.8"
"Dawson","2020-06-25","36","1673","3","87","3.5","2.1"
"Dawson","2020-06-26","37","1710","0","87","3.5","1.7"
"Dawson","2020-06-27","18","1728","2","89","5.1","2.5"
"Dawson","2020-06-28","5","1733","0","89","5.1","2.5"
"Dawson","2020-06-29","36","1769","3","92","4.5","3.1"
"Dawson","2020-06-30","35","1804","3","95","5.8","3.7"
"Dawson","2020-07-01","37","1841","2","97","6","4.1"
"Dawson","2020-07-02","30","1871","3","100","6.2","4.8"
"Dawson","2020-07-03","14","1885","2","102","8.2","5.9"
"Dawson","2020-07-04","14","1899","2","104","8.7","6.9"
"Dawson","2020-07-05","5","1904","0","104","8.7","6.9"
"Dawson","2020-07-06","56","1960","5","109","8.8","6.7"
"Dawson","2020-07-07","64","2024","5","114","8.7","7.2"
"Dawson","2020-07-08","55","2079","4","118","8.9","7.5"
"Dawson","2020-07-09","43","2122","3","121","8.5","7.4"
"Dawson","2020-07-10","40","2162","2","123","7.2","7.7"
"Dawson","2020-07-11","6","2168","0","123","5.1","6.9"
"Dawson","2020-07-12","5","2173","1","124","8","8.3"
"Dawson","2020-07-13","25","2198","4","128","9","8.9"
"Dawson","2020-07-14","34","2232","0","128","7.9","8.3"
"Dawson","2020-07-15","32","2264","2","130","7.7","8.3"
"Dawson","2020-07-16","49","2313","8","138","9.1","8.8"
"Dawson","2020-07-17","44","2357","3","141","9.3","8.3"
"Dawson","2020-07-18","10","2367","1","142","10.8","8"
"Dawson","2020-07-19","13","2380","0","142","7.9","8"
"Dawson","2020-07-20","49","2429","7","149","7.7","8.3"
"Dawson","2020-07-21","36","2465","2","151","8.5","8.2"
"Dawson","2020-07-22","48","2513","1","152","7.9","7.8"
"Dawson","2020-07-23","37","2550","3","155","6.7","7.9"
"Dawson","2020-07-24","50","2600","5","160","7.1","8.2"
"Dawson","2020-07-25","11","2611","1","161","7","8.9"
"Dawson","2020-07-26","11","2622","0","161","7","7.5"
"Dawson","2020-07-27","47","2669","8","169","7.4","7.5"
"Dawson","2020-07-28","33","2702","3","172","7.9","8.2"
"Dawson","2020-07-29","33","2735","7","179","10.6","9.3"
"Dawson","2020-07-30","32","2767","5","184","11.7","9.2"
"Dawson","2020-07-31","41","2808","4","188","11.7","9.4"
"Dawson","2020-08-01","27","2835","6","194","13.6","10.3"
"Dawson","2020-08-02","23","2858","7","201","17.9","12.5"
"Dawson","2020-08-03","29","2887","2","203","16.5","11.9"
"Dawson","2020-08-04","28","2915","7","210","18.7","13.3"
"Dawson","2020-08-05","31","2946","7","217","18.9","14.8"
"Dawson","2020-08-06","37","2983","1","218","17.1","14.4"
"Dawson","2020-08-07","46","3029","6","224","17.6","14.6"
"Dawson","2020-08-08","15","3044","1","225","15.3","14.4"
"Dawson","2020-08-09","22","3066","6","231","14.9","16.4"
"Dawson","2020-08-10","56","3122","6","237","15.4","15.9"
"Dawson","2020-08-11","29","3151","3","240","13.3","16"
"Dawson","2020-08-12","31","3182","6","246","12.9","15.9"
"Dawson","2020-08-13","69","3251","5","251","13.5","15.3"
"Dawson","2020-08-14","68","3319","3","254","12.3","14.9"
"Dawson","2020-08-15","10","3329","1","255","12.8","14"
"Dawson","2020-08-16","12","3341","3","258","12.4","13.7"
"Dawson","2020-08-17","21","3362","1","259","11.6","13.5"
"Dawson","2020-08-18","36","3398","3","262","11.3","12.3"
"Dawson","2020-08-19","42","3440","0","262","8.5","10.7"
"Dawson","2020-08-20","75","3515","11","273","9.6","11.6"
"Dawson","2020-08-21","56","3571","0","273","9","10.6"
"Dawson","2020-08-22","27","3598","2","275","8.6","10.7"
"Dawson","2020-08-23","13","3611","1","276","6.1","9.3"
"Dawson","2020-08-24","43","3654","5","281","7.1","9.3"
"Dawson","2020-08-25","29","3683","3","284","7.4","9.3"
"Dawson","2020-08-26","39","3722","2","286","8.1","8.3"
"Dawson","2020-08-27","30","3752","4","290","7.9","8.8"
"Dawson","2020-08-28","52","3804","2","292","8.5","8.7"
"Dawson","2020-08-29","17","3821","2","294","9.1","8.9"
"Dawson","2020-08-30","11","3832","3","297","11.9","9"
"Dawson","2020-08-31","41","3873","2","299","10.9","9"
"Dawson","2020-09-01","32","3905","0","299","9.5","8.4"
"Dawson","2020-09-02","23","3928","3","302","10.6","9.4"
"Dawson","2020-09-03","18","3946","3","305","11.1","9.5"
"Dawson","2020-09-04","40","3986","0","305","10.5","9.5"
"Dawson","2020-09-05","10","3996","1","306","10.3","9.7"
"Dawson","2020-09-06","7","4003","0","306","6.4","9.1"
"Dawson","2020-09-07","9","4012","1","307","7.3","9.1"
"Dawson","2020-09-08","52","4064","6","313","8.9","9.2"
"Dawson","2020-09-09","21","4085","0","313","7","8.8"
"Dawson","2020-09-10","26","4111","3","316","6.3","8.7"
"Dawson","2020-09-11","30","4141","0","316","6.3","8.4"
"Dawson","2020-09-12","4","4145","2","318","12","11.1"
"Dawson","2020-09-13","6","4151","1","319","14.4","10.4"
"Dawson","2020-09-14","32","4183","2","321","13.7","10.5"
"Dawson","2020-09-15","38","4221","3","324","13.2","11.1"
"Dawson","2020-09-16","34","4255","3","327","14.5","10.7"
"Dawson","2020-09-17","28","4283","0","327","12.8","9.6"
"Dawson","2020-09-18","39","4322","1","328","13.2","9.7"
"Dawson","2020-09-19","11","4333","3","331","9.9","11"
"Dawson","2020-09-20","5","4338","1","332","10.4","12.4"
"Dawson","2020-09-21","39","4377","1","333","9.9","11.8"
"Dawson","2020-09-22","34","4411","0","333","8.7","11"
"Dawson","2020-09-23","37","4448","0","333","7.5","11"
"Dawson","2020-09-24","19","4467","2","335","9","10.9"
"Dawson","2020-09-25","25","4492","1","336","9.2","11.2"
"Dawson","2020-09-26","4","4496","0","336","5.3","7.6"
"Dawson","2020-09-27","8","4504","1","337","4.2","7.3"
"Dawson","2020-09-28","37","4541","1","338","4.2","7.1"
"Dawson","2020-09-29","31","4572","2","340","5.2","7"
"Dawson","2020-09-30","25","4597","1","341","5.7","6.6"
"Dawson","2020-10-01","42","4639","2","343","4.9","7"
"Dawson","2020-10-02","45","4684","2","345","5","7.1"
"Dawson","2020-10-03","10","4694","1","346","6.4","5.9"
"Dawson","2020-10-04","11","4705","0","346","4.6","4.4"
"Dawson","2020-10-05","42","4747","1","347","4.6","4.4"
"Dawson","2020-10-06","38","4785","4","351","5.2","5.2"
"Dawson","2020-10-07","48","4833","2","353","5.2","5.5"
"Dawson","2020-10-08","32","4865","5","358","6.7","5.8"
"Dawson","2020-10-09","43","4908","0","358","6.1","5.5"
"Dawson","2020-10-10","17","4925","0","358","4.7","5.5"
"Dawson","2020-10-11","11","4936","3","361","8.6","6.6"
"Dawson","2020-10-12","40","4976","3","364","9.3","6.9"
"Dawson","2020-10-13","20","4996","2","366","9.2","7.2"
"Dawson","2020-10-14","37","5033","0","366","8.6","6.9"
"Dawson","2020-10-15","42","5075","1","367","6.7","6.7"
"Dawson","2020-10-16","51","5126","0","367","6.7","6.4"
"Dawson","2020-10-17","8","5134","1","368","8.5","6.6"
"Dawson","2020-10-18","10","5144","0","368","4.6","6.6"
"Dawson","2020-10-19","35","5179","0","368","3.6","6.4"
"Dawson","2020-10-20","41","5220","3","371","3.2","6.2"
"Dawson","2020-10-21","32","5252","2","373","4.1","6.3"
"Dawson","2020-10-22","49","5301","0","373","3.7","5.2"
"Dawson","2020-10-23","47","5348","1","374","4","5.4"
"Dawson","2020-10-24","23","5371","0","374","2.2","5.4"
"Dawson","2020-10-25","6","5377","3","377","9.4","7"
"Dawson","2020-10-26","39","5416","2","379","10.1","6.8"
"Dawson","2020-10-27","35","5451","0","379","9.1","6.1"
"Dawson","2020-10-28","39","5490","1","380","8.5","6.3"
"Dawson","2020-10-29","29","5519","1","381","9","6.4"
"Dawson","2020-10-30","50","5569","1","382","9","6.5"
"Dawson","2020-10-31","21","5590","1","383","9.7","6"
"Dawson","2020-11-01","12","5602","3","386","6.1","7.8"
"Dawson","2020-11-02","52","5654","4","390","6.5","8.3"
"Dawson","2020-11-03","37","5691","0","390","6.5","7.8"
"Dawson","2020-11-04","31","5722","0","390","6.1","7.3"
"Dawson","2020-11-05","49","5771","1","391","5.9","7.5"
"Dawson","2020-11-06","56","5827","4","395","6.7","7.8"
"Dawson","2020-11-07","19","5846","3","398","8.2","9"
"Dawson","2020-11-08","10","5856","1","399","6.1","6.1"
"Dawson","2020-11-09","51","5907","12","411","8.4","7.4"
"Dawson","2020-11-10","60","5967","6","417","9.8","8.1"
"Dawson","2020-11-11","35","6002","1","418","10.2","8.2"
"Dawson","2020-11-12","38","6040","7","425","12.5","9.2"
"Dawson","2020-11-13","70","6110","9","434","13.4","10"
"Dawson","2020-11-14","20","6130","2","436","12.5","10.4"
"Dawson","2020-11-15","16","6146","2","438","12.9","9.5"
"Dawson","2020-11-16","51","6197","7","445","11.5","9.9"
"Dawson","2020-11-17","64","6261","6","451","11.4","10.6"
"Dawson","2020-11-18","51","6312","5","456","12.4","11.3"
"Dawson","2020-11-19","79","6391","7","463","11","11.8"
"Dawson","2020-11-20","71","6462","13","476","11.8","12.6"
"Dawson","2020-11-21","14","6476","4","480","14.4","13.5"
"Dawson","2020-11-22","22","6498","1","481","13.3","13.1"
"Dawson","2020-11-23","43","6541","5","486","13","12.2"
"Dawson","2020-11-24","44","6585","2","488","12.3","11.9"
"Dawson","2020-11-25","51","6636","13","501","14.6","13.5"
"Dawson","2020-11-26","8","6644","3","504","18.7","14.8"
"Dawson","2020-11-27","66","6710","12","516","18.6","15.2"
"Dawson","2020-11-28","30","6740","5","521","16.9","15.7"
"Dawson","2020-11-29","23","6763","6","527","20","16.7"
"Dawson","2020-11-30","74","6837","11","538","20.5","16.7"
"Dawson","2020-12-01","73","6910","14","552","22.6","17.4"
"Dawson","2020-12-02","64","6974","16","568","22.5","18.5"
"Dawson","2020-12-03","65","7039","4","572","18","18.3"
"Dawson","2020-12-04","74","7113","10","582","17.4","18"
"Dawson","2020-12-05","18","7131","3","585","17.4","17.1"
"Dawson","2020-12-06","14","7145","1","586","14.6","17.3"
"Dawson","2020-12-07","74","7219","9","595","14.3","17.4"
"Dawson","2020-12-08","93","7312","22","617","14.9","18.7"
"Dawson","2020-12-09","90","7402","15","632","13.7","18.1"
"Dawson","2020-12-10","65","7467","11","643","15.2","16.6"
"Dawson","2020-12-11","91","7558","8","651","14.6","16"
"Dawson","2020-12-12","36","7594","9","660","15.8","16.6"
"Dawson","2020-12-13","27","7621","5","665","17.4","16"
"Dawson","2020-12-14","86","7707","20","685","19","16.6"
"Dawson","2020-12-15","108","7815","19","704","18.1","16.5"
"Dawson","2020-12-16","92","7907","25","729","19.6","16.7"
"Dawson","2020-12-17","84","7991","12","741","19.2","17.2"
"Dawson","2020-12-18","106","8097","14","755","19.9","17.2"
"Dawson","2020-12-19","19","8116","7","762","21.6","18.7"
"Dawson","2020-12-20","26","8142","6","768","22.2","19.8"
"Dawson","2020-12-21","92","8234","17","785","21.5","20.2"
"Dawson","2020-12-22","73","8307","19","804","22.7","20.4"
"Dawson","2020-12-23","83","8390","23","827","22.8","21.2"
"Dawson","2020-12-24","64","8454","12","839","23.4","21.3"
"Dawson","2020-12-25","13","8467","8","847","30.3","25.1"
"Dawson","2020-12-26","60","8527","25","872","31","26.3"
"Dawson","2020-12-27","32","8559","11","883","32.6","27.4"
"Dawson","2020-12-28","97","8656","23","906","33.4","27.5"
"Dawson","2020-12-29","78","8734","25","931","34.3","28.5"
"Dawson","2020-12-30","86","8820","15","946","32.8","27.8"
"Dawson","2020-12-31","81","8901","26","972","34.7","29.1"
"Dawson","2021-01-01","16","8917","7","979","32.2","31.3"
"Dawson","2021-01-02","28","8945","11","990","31.8","31.4"
"Dawson","2021-01-03","27","8972","8","998","31.1","31.9"
"Dawson","2021-01-04","92","9064","20","1018","30.9","32.1"
"Dawson","2021-01-05","94","9158","23","1041","29.8","32"
"Dawson","2021-01-06","118","9276","25","1066","30.3","31.5"
"Dawson","2021-01-07","104","9380","24","1090","29","31.9"
"Dawson","2021-01-08","71","9451","10","1100","24.8","28.5"
"Dawson","2021-01-09","40","9491","14","1114","24.2","28"
"Dawson","2021-01-10","30","9521","6","1120","22.8","27"
"Dawson","2021-01-11","91","9612","22","1142","23.1","27"
"Dawson","2021-01-12","76","9688","11","1153","21.7","25.7"
"Dawson","2021-01-13","77","9765","18","1171","22","26.2"
"Dawson","2021-01-14","94","9859","15","1186","21","25"
"Dawson","2021-01-15","50","9909","11","1197","22.1","23.5"
"Dawson","2021-01-16","39","9948","11","1208","21.2","22.7"
"Dawson","2021-01-17","30","9978","9","1217","22.6","22.7"
"Dawson","2021-01-18","49","10027","11","1228","22.4","22.7"
"Dawson","2021-01-19","91","10118","17","1245","23","22.3"
"Dawson","2021-01-20","55","10173","9","1254","22","22"
"Dawson","2021-01-21","78","10251","19","1273","23.2","22.1"
"Dawson","2021-01-22","96","10347","24","1297","23.6","22.9"
"Dawson","2021-01-23","30","10377","4","1301","21.5","21.3"
"Dawson","2021-01-24","25","10402","4","1305","19.5","21"
"Dawson","2021-01-25","68","10470","13","1318","19","20.7"
"Dawson","2021-01-26","71","10541","19","1337","20.1","21.5"
"Dawson","2021-01-27","65","10606","10","1347","20","21"
"Dawson","2021-01-28","62","10668","8","1355","18.4","20.8"
"Dawson","2021-01-29","76","10744","11","1366","16.9","20.2"
"Dawson","2021-01-30","16","10760","2","1368","16.7","19.1"
"Dawson","2021-01-31","25","10785","7","1375","18.4","19"
"Dawson","2021-02-01","46","10831","9","1384","18.5","18.7"
"Dawson","2021-02-02","72","10903","6","1390","15.9","18"
"Dawson","2021-02-03","67","10970","10","1400","15.8","17.9"
"Dawson","2021-02-04","61","11031","5","1405","15.1","16.7"
"Dawson","2021-02-05","29","11060","4","1409","15","15.9"
"Dawson","2021-02-06","14","11074","2","1411","15.3","16"
"Dawson","2021-02-07","5","11079","1","1412","14.2","16.3"
"Dawson","2021-02-08","0","11079","0","1412","11.4","14.9"
"Decatur","2020-02-01","0","0","0","0",".","."
"Decatur","2020-02-02","0","0","0","0",".","."
"Decatur","2020-02-03","0","0","0","0",".","."
"Decatur","2020-02-04","0","0","0","0",".","."
"Decatur","2020-02-05","0","0","0","0",".","."
"Decatur","2020-02-06","0","0","0","0",".","."
"Decatur","2020-02-07","0","0","0","0","0","."
"Decatur","2020-02-08","0","0","0","0","0","."
"Decatur","2020-02-09","0","0","0","0","0","."
"Decatur","2020-02-10","0","0","0","0","0","."
"Decatur","2020-02-11","0","0","0","0","0","."
"Decatur","2020-02-12","0","0","0","0","0","."
"Decatur","2020-02-13","0","0","0","0","0","."
"Decatur","2020-02-14","0","0","0","0","0","0"
"Decatur","2020-02-15","0","0","0","0","0","0"
"Decatur","2020-02-16","0","0","0","0","0","0"
"Decatur","2020-02-17","0","0","0","0","0","0"
"Decatur","2020-02-18","0","0","0","0","0","0"
"Decatur","2020-02-19","1","1","0","0","0","0"
"Decatur","2020-02-20","0","1","0","0","0","0"
"Decatur","2020-02-21","0","1","0","0","0","0"
"Decatur","2020-02-22","0","1","0","0","0","0"
"Decatur","2020-02-23","0","1","0","0","0","0"
"Decatur","2020-02-24","0","1","0","0","0","0"
"Decatur","2020-02-25","0","1","0","0","0","0"
"Decatur","2020-02-26","0","1","0","0","0","0"
"Decatur","2020-02-27","0","1","0","0","0","0"
"Decatur","2020-02-28","0","1","0","0","0","0"
"Decatur","2020-02-29","0","1","0","0","0","0"
"Decatur","2020-03-01","0","1","0","0","0","0"
"Decatur","2020-03-02","0","1","0","0","0","0"
"Decatur","2020-03-03","0","1","0","0","0","0"
"Decatur","2020-03-04","0","1","0","0","0","0"
"Decatur","2020-03-05","0","1","0","0","0","0"
"Decatur","2020-03-06","0","1","0","0","0","0"
"Decatur","2020-03-07","0","1","0","0","0","0"
"Decatur","2020-03-08","0","1","0","0","0","0"
"Decatur","2020-03-09","0","1","0","0","0","0"
"Decatur","2020-03-10","0","1","0","0","0","0"
"Decatur","2020-03-11","0","1","0","0","0","0"
"Decatur","2020-03-12","1","2","0","0","0","0"
"Decatur","2020-03-13","2","4","0","0","0","0"
"Decatur","2020-03-14","1","5","0","0","0","0"
"Decatur","2020-03-15","0","5","0","0","0","0"
"Decatur","2020-03-16","4","9","0","0","0","0"
"Decatur","2020-03-17","5","14","0","0","0","0"
"Decatur","2020-03-18","10","24","0","0","0","0"
"Decatur","2020-03-19","5","29","1","1","2.9","1.4"
"Decatur","2020-03-20","4","33","0","1","2.9","1.4"
"Decatur","2020-03-21","0","33","0","1","2.9","1.4"
"Decatur","2020-03-22","3","36","2","3","12.4","6.2"
"Decatur","2020-03-23","2","38","0","3","12.4","6.2"
"Decatur","2020-03-24","2","40","1","4","19.5","9.8"
"Decatur","2020-03-25","6","46","2","6","24.3","12.1"
"Decatur","2020-03-26","2","48","0","6","21.4","12.1"
"Decatur","2020-03-27","8","56","3","9","26.8","14.8"
"Decatur","2020-03-28","2","58","2","11","41.1","22"
"Decatur","2020-03-29","3","61","2","13","41.1","26.7"
"Decatur","2020-03-30","2","63","1","14","48.2","30.3"
"Decatur","2020-03-31","1","64","0","14","41.1","30.3"
"Decatur","2020-04-01","13","77","3","17","39.6","31.9"
"Decatur","2020-04-02","11","88","1","18","40.9","31.2"
"Decatur","2020-04-03","3","91","2","20","45.1","35.9"
"Decatur","2020-04-04","0","91","0","20","30.8","35.9"
"Decatur","2020-04-05","0","91","0","20","21.3","31.2"
"Decatur","2020-04-06","6","97","3","23","21.3","34.7"
"Decatur","2020-04-07","4","101","0","23","21.3","31.2"
"Decatur","2020-04-08","9","110","2","25","21.1","30.4"
"Decatur","2020-04-09","14","124","2","27","21.9","31.4"
"Decatur","2020-04-10","20","144","2","29","13.8","29.4"
"Decatur","2020-04-11","12","156","2","31","16.2","23.5"
"Decatur","2020-04-12","5","161","3","34","24.7","23"
"Decatur","2020-04-13","20","181","1","35","18.3","19.8"
"Decatur","2020-04-14","31","212","11","46","23.4","22.3"
"Decatur","2020-04-15","17","229","1","47","21","21.1"
"Decatur","2020-04-16","27","256","4","51","21.1","21.5"
"Decatur","2020-04-17","34","290","14","65","25.6","19.7"
"Decatur","2020-04-18","6","296","1","66","25.6","20.9"
"Decatur","2020-04-19","5","301","0","66","17","20.9"
"Decatur","2020-04-20","12","313","3","69","19.9","19.1"
"Decatur","2020-04-21","12","325","2","71","17.2","20.3"
"Decatur","2020-04-22","14","339","2","73","18.4","19.7"
"Decatur","2020-04-23","19","358","3","76","18.5","19.8"
"Decatur","2020-04-24","16","374","2","78","14.4","20"
"Decatur","2020-04-25","1","375","0","78","12","18.8"
"Decatur","2020-04-26","2","377","1","79","19.2","18.1"
"Decatur","2020-04-27","23","400","6","85","19.3","19.6"
"Decatur","2020-04-28","9","409","1","86","18.5","17.9"
"Decatur","2020-04-29","17","426","6","92","21.5","20"
"Decatur","2020-04-30","13","439","0","92","19.3","18.9"
"Decatur","2020-05-01","16","455","1","93","18.4","16.4"
"Decatur","2020-05-02","3","458","0","93","18.4","15.2"
"Decatur","2020-05-03","70","528","3","96","11.9","15.5"
"Decatur","2020-05-04","22","550","1","97","8.8","14.1"
"Decatur","2020-05-05","13","563","0","97","7.2","12.9"
"Decatur","2020-05-06","14","577","4","101","6.2","13.9"
"Decatur","2020-05-07","17","594","0","101","6.2","12.8"
"Decatur","2020-05-08","16","610","4","105","8.9","13.7"
"Decatur","2020-05-09","87","697","2","107","9.2","13.8"
"Decatur","2020-05-10","3","700","1","108","13.4","12.6"
"Decatur","2020-05-11","30","730","0","108","12.7","10.8"
"Decatur","2020-05-12","16","746","3","111","15.4","11.3"
"Decatur","2020-05-13","28","774","4","115","13.4","9.8"
"Decatur","2020-05-14","93","867","2","117","13.7","10"
"Decatur","2020-05-15","22","889","9","126","16","12.4"
"Decatur","2020-05-16","28","917","5","131","18.2","13.7"
"Decatur","2020-05-17","3","920","0","131","13.4","13.4"
"Decatur","2020-05-18","7","927","1","132","15.5","14.1"
"Decatur","2020-05-19","31","958","7","139","16","15.7"
"Decatur","2020-05-20","97","1055","17","156","16.5","14.9"
"Decatur","2020-05-21","15","1070","1","157","17.1","15.4"
"Decatur","2020-05-22","24","1094","2","159","12.5","14.2"
"Decatur","2020-05-23","85","1179","12","171","11.9","15.1"
"Decatur","2020-05-24","3","1182","2","173","21.5","17.4"
"Decatur","2020-05-25","1","1183","0","173","19.4","17.4"
"Decatur","2020-05-26","27","1210","3","176","17.8","16.9"
"Decatur","2020-05-27","147","1357","10","186","16.2","16.4"
"Decatur","2020-05-28","28","1385","9","195","19.9","18.5"
"Decatur","2020-05-29","64","1449","6","201","20","16.2"
"Decatur","2020-05-30","128","1577","7","208","18.8","15.4"
"Decatur","2020-05-31","2","1579","0","208","9.3","15.4"
"Decatur","2020-06-01","147","1726","6","214","9.9","14.6"
"Decatur","2020-06-02","42","1768","2","216","8.9","13.4"
"Decatur","2020-06-03","42","1810","6","222","10","13.1"
"Decatur","2020-06-04","156","1966","7","229","6.1","13"
"Decatur","2020-06-05","21","1987","5","234","8.1","14.1"
"Decatur","2020-06-06","119","2106","4","238","7.8","13.3"
"Decatur","2020-06-07","1","2107","0","238","7.8","8.5"
"Decatur","2020-06-08","24","2131","1","239","7.8","8.8"
"Decatur","2020-06-09","51","2182","2","241","7.7","8.3"
"Decatur","2020-06-10","99","2281","2","243","6","8"
"Decatur","2020-06-11","72","2353","9","252","7.1","6.6"
"Decatur","2020-06-12","11","2364","0","252","3.7","5.9"
"Decatur","2020-06-13","38","2402","3","255","4.4","6.1"
"Decatur","2020-06-14","36","2438","0","255","4.4","6.1"
"Decatur","2020-06-15","90","2528","1","256","3.9","5.9"
"Decatur","2020-06-16","55","2583","1","257","3.6","5.7"
"Decatur","2020-06-17","74","2657","2","259","3.7","4.8"
"Decatur","2020-06-18","46","2703","4","263","3.2","5.1"
"Decatur","2020-06-19","23","2726","0","263","3.2","3.4"
"Decatur","2020-06-20","31","2757","1","264","2.5","3.4"
"Decatur","2020-06-21","44","2801","0","264","2.5","3.4"
"Decatur","2020-06-22","21","2822","0","264","2.3","3.1"
"Decatur","2020-06-23","69","2891","3","267","2.7","3.2"
"Decatur","2020-06-24","20","2911","1","268","3","3.4"
"Decatur","2020-06-25","79","2990","5","273","2.7","2.9"
"Decatur","2020-06-26","13","3003","2","275","4.9","4"
"Decatur","2020-06-27","27","3030","2","277","5.5","4"
"Decatur","2020-06-28","6","3036","0","277","5.5","4"
"Decatur","2020-06-29","60","3096","2","279","6","4.2"
"Decatur","2020-06-30","49","3145","4","283","6.5","4.6"
"Decatur","2020-07-01","100","3245","6","289","6.7","4.8"
"Decatur","2020-07-02","56","3301","2","291","6.3","4.5"
"Decatur","2020-07-03","20","3321","2","293","5.5","5.2"
"Decatur","2020-07-04","31","3352","2","295","5.4","5.4"
"Decatur","2020-07-05","4","3356","1","296","8.9","7.2"
"Decatur","2020-07-06","34","3390","3","299","9.7","7.8"
"Decatur","2020-07-07","43","3433","13","312","12.9","9.7"
"Decatur","2020-07-08","161","3594","23","335","14.1","10.4"
"Decatur","2020-07-09","94","3688","13","348","15.5","10.9"
"Decatur","2020-07-10","73","3761","14","362","16.8","11.2"
"Decatur","2020-07-11","18","3779","3","365","18.3","11.8"
"Decatur","2020-07-12","81","3860","6","371","15.8","12.4"
"Decatur","2020-07-13","49","3909","11","382","17.7","13.7"
"Decatur","2020-07-14","167","4076","24","406","15.5","14.2"
"Decatur","2020-07-15","74","4150","11","417","15.5","14.8"
"Decatur","2020-07-16","194","4344","32","449","15.9","15.7"
"Decatur","2020-07-17","85","4429","8","457","14.5","15.7"
"Decatur","2020-07-18","20","4449","6","463","16.4","17.4"
"Decatur","2020-07-19","9","4458","1","464","17","16.4"
"Decatur","2020-07-20","214","4672","23","487","15.3","16.5"
"Decatur","2020-07-21","102","4774","17","504","15.6","15.5"
"Decatur","2020-07-22","254","5028","29","533","15.1","15.3"
"Decatur","2020-07-23","103","5131","14","547","14.7","15.3"
"Decatur","2020-07-24","129","5260","30","577","16.7","15.6"
"Decatur","2020-07-25","24","5284","13","590","20.1","18.3"
"Decatur","2020-07-26","149","5433","7","597","19.2","18.1"
"Decatur","2020-07-27","80","5513","16","613","20.5","17.9"
"Decatur","2020-07-28","268","5781","53","666","21","18.3"
"Decatur","2020-07-29","89","5870","13","679","21.4","18.3"
"Decatur","2020-07-30","226","6096","26","705","21.1","17.9"
"Decatur","2020-07-31","86","6182","15","720","20.3","18.5"
"Decatur","2020-08-01","18","6200","6","726","17.3","18.7"
"Decatur","2020-08-02","11","6211","3","729","20.6","19.9"
"Decatur","2020-08-03","252","6463","36","765","19.7","20.1"
"Decatur","2020-08-04","155","6618","19","784","18.7","19.8"
"Decatur","2020-08-05","90","6708","25","809","20.6","21"
"Decatur","2020-08-06","238","6946","13","822","19.7","20.4"
"Decatur","2020-08-07","62","7008","5","827","18.4","19.3"
"Decatur","2020-08-08","14","7022","9","836","22.8","20.1"
"Decatur","2020-08-09","31","7053","8","844","22.6","21.6"
"Decatur","2020-08-10","210","7263","18","862","21.7","20.7"
"Decatur","2020-08-11","81","7344","6","868","21.1","19.9"
"Decatur","2020-08-12","64","7408","6","874","18.4","19.5"
"Decatur","2020-08-13","224","7632","19","893","18.9","19.3"
"Decatur","2020-08-14","43","7675","6","899","19.7","19"
"Decatur","2020-08-15","12","7687","3","902","14.1","18.4"
"Decatur","2020-08-16","14","7701","6","908","16.5","19.5"
"Decatur","2020-08-17","120","7821","15","923","17.1","19.4"
"Decatur","2020-08-18","71","7892","10","933","18","19.5"
"Decatur","2020-08-19","50","7942","9","942","19.3","18.8"
"Decatur","2020-08-20","206","8148","21","963","19.5","19.2"
"Decatur","2020-08-21","40","8188","11","974","21.4","20.6"
"Decatur","2020-08-22","5","8193","3","977","26.4","20.3"
"Decatur","2020-08-23","45","8238","5","982","21.9","19.2"
"Decatur","2020-08-24","100","8338","16","998","22.4","19.7"
"Decatur","2020-08-25","64","8402","7","1005","22","20"
"Decatur","2020-08-26","88","8490","16","1021","22","20.6"
"Decatur","2020-08-27","185","8675","16","1037","21.8","20.6"
"Decatur","2020-08-28","36","8711","3","1040","19","20.2"
"Decatur","2020-08-29","11","8722","3","1043","14.4","20.4"
"Decatur","2020-08-30","7","8729","1","1044","14.8","18.4"
"Decatur","2020-08-31","113","8842","7","1051","13.4","17.9"
"Decatur","2020-09-01","96","8938","3","1054","12.3","17.1"
"Decatur","2020-09-02","82","9020","5","1059","10.6","16.3"
"Decatur","2020-09-03","147","9167","14","1073","10.7","16.2"
"Decatur","2020-09-04","165","9332","8","1081","10.2","14.6"
"Decatur","2020-09-05","15","9347","1","1082","7.2","10.8"
"Decatur","2020-09-06","10","9357","0","1082","5.2","10"
"Decatur","2020-09-07","39","9396","1","1083","4.7","9"
"Decatur","2020-09-08","117","9513","5","1088","4.9","8.6"
"Decatur","2020-09-09","72","9585","7","1095","5.4","8"
"Decatur","2020-09-10","117","9702","5","1100","4.6","7.7"
"Decatur","2020-09-11","100","9802","3","1103","4.4","7.3"
"Decatur","2020-09-12","11","9813","0","1103","3.4","5.3"
"Decatur","2020-09-13","20","9833","1","1104","4.1","4.7"
"Decatur","2020-09-14","285","10118","8","1112","4.2","4.4"
"Decatur","2020-09-15","68","10186","0","1112","3.5","4.2"
"Decatur","2020-09-16","79","10265","3","1115","2.7","4"
"Decatur","2020-09-17","150","10415","8","1123","2.8","3.7"
"Decatur","2020-09-18","87","10502","9","1132","3.9","4.1"
"Decatur","2020-09-19","29","10531","3","1135","5.4","4.4"
"Decatur","2020-09-20","10","10541","0","1135","4.7","4.4"
"Decatur","2020-09-21","165","10706","8","1143","5","4.6"
"Decatur","2020-09-22","181","10887","4","1147","5.3","4.4"
"Decatur","2020-09-23","111","10998","3","1150","5.1","3.9"
"Decatur","2020-09-24","159","11157","15","1165","5.7","4.3"
"Decatur","2020-09-25","65","11222","4","1169","5.1","4.5"
"Decatur","2020-09-26","33","11255","7","1176","6.7","6"
"Decatur","2020-09-27","12","11267","1","1177","7.8","6.3"
"Decatur","2020-09-28","112","11379","13","1190","8.8","6.9"
"Decatur","2020-09-29","174","11553","3","1193","8.7","7"
"Decatur","2020-09-30","73","11626","7","1200","9.7","7.4"
"Decatur","2020-10-01","144","11770","11","1211","9.5","7.6"
"Decatur","2020-10-02","108","11878","8","1219","9.6","7.4"
"Decatur","2020-10-03","44","11922","2","1221","7.3","7"
"Decatur","2020-10-04","10","11932","1","1222","7.5","7.7"
"Decatur","2020-10-05","140","12072","12","1234","7.1","7.9"
"Decatur","2020-10-06","111","12183","3","1237","7.2","8"
"Decatur","2020-10-07","66","12249","5","1242","6.9","8.3"
"Decatur","2020-10-08","49","12298","0","1242","5.8","7.6"
"Decatur","2020-10-09","119","12417","2","1244","5","7.3"
"Decatur","2020-10-10","39","12456","1","1245","4.7","6"
"Decatur","2020-10-11","13","12469","0","1245","3.3","5.4"
"Decatur","2020-10-12","150","12619","10","1255","3","5"
"Decatur","2020-10-13","76","12695","2","1257","3","5.1"
"Decatur","2020-10-14","75","12770","6","1263","3.1","5"
"Decatur","2020-10-15","47","12817","2","1265","3.7","4.8"
"Decatur","2020-10-16","56","12873","0","1265","3.4","4.2"
"Decatur","2020-10-17","8","12881","0","1265","3.1","3.9"
"Decatur","2020-10-18","19","12900","1","1266","3.8","3.6"
"Decatur","2020-10-19","134","13034","4","1270","3.3","3.2"
"Decatur","2020-10-20","42","13076","2","1272","3.6","3.3"
"Decatur","2020-10-21","107","13183","5","1277","3.1","3.1"
"Decatur","2020-10-22","61","13244","1","1278","2.8","3.2"
"Decatur","2020-10-23","44","13288","0","1278","2.8","3.1"
"Decatur","2020-10-24","42","13330","9","1287","5.8","4.5"
"Decatur","2020-10-25","8","13338","0","1287","5.1","4.5"
"Decatur","2020-10-26","145","13483","8","1295","5.4","4.4"
"Decatur","2020-10-27","79","13562","4","1299","5.5","4.5"
"Decatur","2020-10-28","46","13608","2","1301","5.4","4.3"
"Decatur","2020-10-29","44","13652","4","1305","6.5","4.6"
"Decatur","2020-10-30","37","13689","1","1306","6.9","4.8"
"Decatur","2020-10-31","9","13698","1","1307","5.4","5.6"
"Decatur","2020-11-01","5","13703","1","1308","8.3","6.7"
"Decatur","2020-11-02","101","13804","9","1317","8.7","7.1"
"Decatur","2020-11-03","74","13878","8","1325","9.6","7.5"
"Decatur","2020-11-04","92","13970","6","1331","9.9","7.7"
"Decatur","2020-11-05","88","14058","6","1337","9.6","8"
"Decatur","2020-11-06","46","14104","2","1339","9.8","8.3"
"Decatur","2020-11-07","9","14113","0","1339","8.2","6.8"
"Decatur","2020-11-08","7","14120","1","1340","7.4","7.8"
"Decatur","2020-11-09","83","14203","3","1343","6.6","7.7"
"Decatur","2020-11-10","113","14316","11","1354","6.5","8"
"Decatur","2020-11-11","61","14377","2","1356","6","7.9"
"Decatur","2020-11-12","48","14425","3","1359","5.9","7.7"
"Decatur","2020-11-13","107","14532","2","1361","5.6","7.7"
"Decatur","2020-11-14","22","14554","3","1364","7.5","7.9"
"Decatur","2020-11-15","10","14564","1","1365","6.9","7.1"
"Decatur","2020-11-16","70","14634","4","1369","7.2","6.9"
"Decatur","2020-11-17","126","14760","7","1376","6.6","6.5"
"Decatur","2020-11-18","40","14800","1","1377","6.5","6.3"
"Decatur","2020-11-19","56","14856","2","1379","6.1","6"
"Decatur","2020-11-20","56","14912","0","1379","5.9","5.7"
"Decatur","2020-11-21","14","14926","0","1379","3.9","5.7"
"Decatur","2020-11-22","8","14934","1","1380","4.3","5.6"
"Decatur","2020-11-23","90","15024","3","1383","3.9","5.6"
"Decatur","2020-11-24","99","15123","2","1385","3.4","5"
"Decatur","2020-11-25","49","15172","4","1389","4.2","5.4"
"Decatur","2020-11-26","6","15178","0","1389","3.7","4.9"
"Decatur","2020-11-27","40","15218","1","1390","4.1","5"
"Decatur","2020-11-28","17","15235","3","1393","6.6","5.3"
"Decatur","2020-11-29","11","15246","1","1394","6.1","5.2"
"Decatur","2020-11-30","126","15372","15","1409","7.3","5.6"
"Decatur","2020-12-01","65","15437","7","1416","8.6","6"
"Decatur","2020-12-02","77","15514","5","1421","8.3","6.3"
"Decatur","2020-12-03","177","15691","15","1436","9.6","6.6"
"Decatur","2020-12-04","58","15749","9","1445","11.4","7.7"
"Decatur","2020-12-05","22","15771","7","1452","13.4","10"
"Decatur","2020-12-06","9","15780","0","1452","12.1","9.1"
"Decatur","2020-12-07","62","15842","4","1456","11.4","9.3"
"Decatur","2020-12-08","58","15900","6","1462","11.3","9.9"
"Decatur","2020-12-09","106","16006","6","1468","11.2","9.8"
"Decatur","2020-12-10","166","16172","15","1483","11.3","10.4"
"Decatur","2020-12-11","87","16259","6","1489","10","10.7"
"Decatur","2020-12-12","34","16293","3","1492","6.7","10.1"
"Decatur","2020-12-13","12","16305","2","1494","9.1","10.6"
"Decatur","2020-12-14","81","16386","11","1505","10.1","10.8"
"Decatur","2020-12-15","79","16465","11","1516","10.7","11"
"Decatur","2020-12-16","62","16527","16","1532","13.5","12.4"
"Decatur","2020-12-17","204","16731","12","1544","13.1","12.2"
"Decatur","2020-12-18","52","16783","4","1548","13.2","11.6"
"Decatur","2020-12-19","20","16803","4","1552","14.8","10.8"
"Decatur","2020-12-20","14","16817","3","1555","15.5","12.3"
"Decatur","2020-12-21","68","16885","12","1567","16.1","13.1"
"Decatur","2020-12-22","62","16947","9","1576","16.1","13.4"
"Decatur","2020-12-23","123","17070","16","1592","14.3","13.9"
"Decatur","2020-12-24","35","17105","9","1601","17.1","15.1"
"Decatur","2020-12-25","5","17110","0","1601","16","14.6"
"Decatur","2020-12-26","18","17128","4","1605","16.4","15.6"
"Decatur","2020-12-27","23","17151","3","1608","15.2","15.3"
"Decatur","2020-12-28","90","17241","7","1615","13.8","14.9"
"Decatur","2020-12-29","144","17385","22","1637","13.9","15"
"Decatur","2020-12-30","115","17500","12","1649","13.5","13.9"
"Decatur","2020-12-31","118","17618","20","1669","12.2","14.7"
"Decatur","2021-01-01","7","17625","0","1669","12.2","14.1"
"Decatur","2021-01-02","21","17646","4","1673","11.8","14.1"
"Decatur","2021-01-03","4","17650","1","1674","13.5","14.3"
"Decatur","2021-01-04","129","17779","28","1702","15.5","14.6"
"Decatur","2021-01-05","141","17920","24","1726","15.7","14.8"
"Decatur","2021-01-06","157","18077","5","1731","14.7","14.1"
"Decatur","2021-01-07","78","18155","12","1743","14.5","13.4"
"Decatur","2021-01-08","211","18366","32","1775","16.6","14.4"
"Decatur","2021-01-09","23","18389","3","1778","15.8","13.8"
"Decatur","2021-01-10","15","18404","5","1783","17","15.2"
"Decatur","2021-01-11","99","18503","11","1794","15.5","15.5"
"Decatur","2021-01-12","119","18622","24","1818","15.9","15.8"
"Decatur","2021-01-13","54","18676","2","1820","16","15.3"
"Decatur","2021-01-14","96","18772","13","1833","15.7","15.1"
"Decatur","2021-01-15","276","19048","25","1858","14.9","15.7"
"Decatur","2021-01-16","30","19078","7","1865","16.3","16.1"
"Decatur","2021-01-17","11","19089","3","1868","15.5","16.2"
"Decatur","2021-01-18","67","19156","3","1871","14.5","15"
"Decatur","2021-01-19","58","19214","4","1875","12.6","14.3"
"Decatur","2021-01-20","84","19298","16","1891","14.8","15.4"
"Decatur","2021-01-21","125","19423","15","1906","14.6","15.2"
"Decatur","2021-01-22","239","19662","30","1936","15.1","15"
"Decatur","2021-01-23","17","19679","3","1939","14.3","15.3"
"Decatur","2021-01-24","5","19684","1","1940","13.2","14.3"
"Decatur","2021-01-25","72","19756","11","1951","14.8","14.6"
"Decatur","2021-01-26","59","19815","10","1961","16.2","14.4"
"Decatur","2021-01-27","48","19863","5","1966","15","14.9"
"Decatur","2021-01-28","64","19927","3","1969","13.9","14.3"
"Decatur","2021-01-29","216","20143","10","1979","12.8","13.9"
"Decatur","2021-01-30","18","20161","1","1980","11.1","12.7"
"Decatur","2021-01-31","10","20171","1","1981","9.6","11.4"
"Decatur","2021-02-01","130","20301","10","1991","8.6","11.7"
"Decatur","2021-02-02","55","20356","4","1995","7.2","11.7"
"Decatur","2021-02-03","87","20443","4","1999","6.3","10.7"
"Decatur","2021-02-04","42","20485","1","2000","6","10"
"Decatur","2021-02-05","93","20578","3","2003","5.8","9.3"
"Decatur","2021-02-06","2","20580","0","2003","5","8"
"Decatur","2021-02-07","3","20583","0","2003","3.6","6.6"
"Decatur","2021-02-08","0","20583","0","2003","2.5","5.5"
"DeKalb","2020-02-01","0","0","0","0",".","."
"DeKalb","2020-02-02","0","0","0","0",".","."
"DeKalb","2020-02-03","1","1","0","0",".","."
"DeKalb","2020-02-04","0","1","0","0",".","."
"DeKalb","2020-02-05","0","1","0","0",".","."
"DeKalb","2020-02-06","0","1","0","0",".","."
"DeKalb","2020-02-07","0","1","0","0","0","."
"DeKalb","2020-02-08","0","1","0","0","0","."
"DeKalb","2020-02-09","0","1","0","0","0","."
"DeKalb","2020-02-10","0","1","0","0","0","."
"DeKalb","2020-02-11","0","1","0","0","0","."
"DeKalb","2020-02-12","0","1","0","0","0","."
"DeKalb","2020-02-13","0","1","0","0","0","."
"DeKalb","2020-02-14","0","1","0","0","0","0"
"DeKalb","2020-02-15","0","1","0","0","0","0"
"DeKalb","2020-02-16","0","1","0","0","0","0"
"DeKalb","2020-02-17","0","1","0","0","0","0"
"DeKalb","2020-02-18","0","1","0","0","0","0"
"DeKalb","2020-02-19","0","1","0","0","0","0"
"DeKalb","2020-02-20","0","1","0","0","0","0"
"DeKalb","2020-02-21","0","1","0","0","0","0"
"DeKalb","2020-02-22","0","1","0","0","0","0"
"DeKalb","2020-02-23","0","1","0","0","0","0"
"DeKalb","2020-02-24","0","1","0","0","0","0"
"DeKalb","2020-02-25","1","2","0","0","0","0"
"DeKalb","2020-02-26","0","2","0","0","0","0"
"DeKalb","2020-02-27","0","2","0","0","0","0"
"DeKalb","2020-02-28","0","2","0","0","0","0"
"DeKalb","2020-02-29","0","2","0","0","0","0"
"DeKalb","2020-03-01","0","2","0","0","0","0"
"DeKalb","2020-03-02","1","3","0","0","0","0"
"DeKalb","2020-03-03","0","3","0","0","0","0"
"DeKalb","2020-03-04","0","3","0","0","0","0"
"DeKalb","2020-03-05","4","7","0","0","0","0"
"DeKalb","2020-03-06","1","8","0","0","0","0"
"DeKalb","2020-03-07","2","10","0","0","0","0"
"DeKalb","2020-03-08","3","13","1","1","4.8","2.4"
"DeKalb","2020-03-09","3","16","0","1","4.8","2.4"
"DeKalb","2020-03-10","6","22","1","2","7.1","3.6"
"DeKalb","2020-03-11","19","41","4","6","10.2","5.1"
"DeKalb","2020-03-12","32","73","3","9","11.5","5.7"
"DeKalb","2020-03-13","62","135","19","28","15.9","7.9"
"DeKalb","2020-03-14","59","194","16","44","19.7","9.9"
"DeKalb","2020-03-15","95","289","24","68","18.6","11.7"
"DeKalb","2020-03-16","176","465","31","99","21.1","12.9"
"DeKalb","2020-03-17","169","634","28","127","21.1","14.1"
"DeKalb","2020-03-18","140","774","23","150","20.4","15.3"
"DeKalb","2020-03-19","147","921","20","170","21","16.3"
"DeKalb","2020-03-20","182","1103","35","205","19.4","17.6"
"DeKalb","2020-03-21","69","1172","20","225","19.7","19.7"
"DeKalb","2020-03-22","103","1275","25","250","19.5","19.1"
"DeKalb","2020-03-23","176","1451","55","305","21.5","21.3"
"DeKalb","2020-03-24","197","1648","56","361","23.2","22.1"
"DeKalb","2020-03-25","220","1868","55","416","24.4","22.4"
"DeKalb","2020-03-26","212","2080","52","468","26","23.5"
"DeKalb","2020-03-27","225","2305","70","538","27.7","23.5"
"DeKalb","2020-03-28","77","2382","22","560","27.6","23.6"
"DeKalb","2020-03-29","67","2449","26","586","29.7","24.6"
"DeKalb","2020-03-30","228","2677","70","656","29.6","25.5"
"DeKalb","2020-03-31","206","2883","50","706","29","26.1"
"DeKalb","2020-04-01","172","3055","36","742","28.4","26.4"
"DeKalb","2020-04-02","193","3248","50","792","28.6","27.3"
"DeKalb","2020-04-03","192","3440","47","839","27.7","27.7"
"DeKalb","2020-04-04","89","3529","19","858","26.6","27.1"
"DeKalb","2020-04-05","50","3579","19","877","26.5","28.1"
"DeKalb","2020-04-06","314","3893","73","950","25.5","27.5"
"DeKalb","2020-04-07","447","4340","64","1014","24","26.5"
"DeKalb","2020-04-08","688","5028","87","1101","22.8","25.6"
"DeKalb","2020-04-09","472","5500","57","1158","20.9","24.7"
"DeKalb","2020-04-10","576","6076","75","1233","19.2","23.5"
"DeKalb","2020-04-11","342","6418","54","1287","18.4","22.5"
"DeKalb","2020-04-12","102","6520","15","1302","15.1","20.8"
"DeKalb","2020-04-13","660","7180","100","1402","14","19.7"
"DeKalb","2020-04-14","722","7902","75","1477","13.4","18.7"
"DeKalb","2020-04-15","670","8572","52","1529","12.7","17.8"
"DeKalb","2020-04-16","825","9397","78","1607","12.3","16.6"
"DeKalb","2020-04-17","924","10321","76","1683","11.6","15.4"
"DeKalb","2020-04-18","425","10746","65","1748","11.6","15"
"DeKalb","2020-04-19","261","11007","29","1777","11.1","13.1"
"DeKalb","2020-04-20","924","11931","81","1858","10.1","12.1"
"DeKalb","2020-04-21","674","12605","92","1950","10.6","12"
"DeKalb","2020-04-22","949","13554","90","2040","10.9","11.8"
"DeKalb","2020-04-23","823","14377","58","2098","10.5","11.4"
"DeKalb","2020-04-24","1146","15523","61","2159","10.1","10.9"
"DeKalb","2020-04-25","510","16033","32","2191","8.8","10.2"
"DeKalb","2020-04-26","242","16275","34","2225","9.2","10.1"
"DeKalb","2020-04-27","723","16998","72","2297","9.4","9.8"
"DeKalb","2020-04-28","842","17840","81","2378","8.8","9.7"
"DeKalb","2020-04-29","1174","19014","71","2449","8.3","9.6"
"DeKalb","2020-04-30","1013","20027","66","2515","8.3","9.4"
"DeKalb","2020-05-01","818","20845","59","2574","8.5","9.3"
"DeKalb","2020-05-02","696","21541","85","2659","9.4","9.1"
"DeKalb","2020-05-03","272","21813","19","2678","8.4","8.8"
"DeKalb","2020-05-04","720","22533","53","2731","8","8.7"
"DeKalb","2020-05-05","754","23287","61","2792","7.8","8.3"
"DeKalb","2020-05-06","1021","24308","46","2838","7.6","7.9"
"DeKalb","2020-05-07","726","25034","46","2884","7.5","7.9"
"DeKalb","2020-05-08","1156","26190","59","2943","7.2","7.9"
"DeKalb","2020-05-09","538","26728","41","2984","6.6","8"
"DeKalb","2020-05-10","239","26967","10","2994","6.2","7.3"
"DeKalb","2020-05-11","1924","28891","101","3095","5.9","6.9"
"DeKalb","2020-05-12","1182","30073","113","3208","6.1","6.9"
"DeKalb","2020-05-13","1057","31130","85","3293","6.6","7.1"
"DeKalb","2020-05-14","1392","32522","102","3395","6.7","7.1"
"DeKalb","2020-05-15","1652","34174","79","3474","6.7","7"
"DeKalb","2020-05-16","760","34934","71","3545","6.9","6.7"
"DeKalb","2020-05-17","391","35325","30","3575","7.4","6.8"
"DeKalb","2020-05-18","1027","36352","79","3654","7.8","6.8"
"DeKalb","2020-05-19","1291","37643","89","3743","7.4","6.7"
"DeKalb","2020-05-20","1275","38918","58","3801","6.9","6.7"
"DeKalb","2020-05-21","1091","40009","93","3894","7.1","6.9"
"DeKalb","2020-05-22","987","40996","95","3989","7.8","7.2"
"DeKalb","2020-05-23","472","41468","36","4025","7.5","7.2"
"DeKalb","2020-05-24","342","41810","37","4062","8","7.7"
"DeKalb","2020-05-25","275","42085","32","4094","8.5","8.1"
"DeKalb","2020-05-26","1566","43651","105","4199","8.5","7.9"
"DeKalb","2020-05-27","1371","45022","90","4289","8.8","7.8"
"DeKalb","2020-05-28","1147","46169","70","4359","8.4","7.8"
"DeKalb","2020-05-29","1165","47334","61","4420","7.8","7.8"
"DeKalb","2020-05-30","546","47880","25","4445","7.4","7.4"
"DeKalb","2020-05-31","413","48293","23","4468","6.6","7.3"
"DeKalb","2020-06-01","1148","49441","80","4548","6","7.2"
"DeKalb","2020-06-02","1325","50766","80","4628","5.9","7.2"
"DeKalb","2020-06-03","1395","52161","77","4705","5.7","7.3"
"DeKalb","2020-06-04","1356","53517","58","4763","5.5","6.9"
"DeKalb","2020-06-05","1140","54657","54","4817","5.4","6.6"
"DeKalb","2020-06-06","593","55250","42","4859","5.7","6.6"
"DeKalb","2020-06-07","324","55574","29","4888","6.2","6.4"
"DeKalb","2020-06-08","1235","56809","91","4979","6.3","6.1"
"DeKalb","2020-06-09","1424","58233","88","5067","6.3","6.1"
"DeKalb","2020-06-10","1464","59697","94","5161","6.4","6.1"
"DeKalb","2020-06-11","1503","61200","64","5225","6.4","5.9"
"DeKalb","2020-06-12","1353","62553","74","5299","6.5","6"
"DeKalb","2020-06-13","690","63243","44","5343","6.4","6.1"
"DeKalb","2020-06-14","369","63612","25","5368","6.1","6.2"
"DeKalb","2020-06-15","1768","65380","94","5462","5.8","6.1"
"DeKalb","2020-06-16","2005","67385","128","5590","5.9","6.1"
"DeKalb","2020-06-17","1746","69131","154","5744","6.2","6.3"
"DeKalb","2020-06-18","1732","70863","136","5880","6.7","6.6"
"DeKalb","2020-06-19","1692","72555","126","6006","7","6.8"
"DeKalb","2020-06-20","737","73292","92","6098","7.9","7.2"
"DeKalb","2020-06-21","345","73637","59","6157","9.3","7.7"
"DeKalb","2020-06-22","2431","76068","198","6355","9.7","7.8"
"DeKalb","2020-06-23","2213","78281","232","6587","10.3","8.1"
"DeKalb","2020-06-24","2015","80296","265","6852","11","8.6"
"DeKalb","2020-06-25","2728","83024","292","7144","11.4","9"
"DeKalb","2020-06-26","2532","85556","289","7433","11.9","9.5"
"DeKalb","2020-06-27","850","86406","105","7538","11.9","9.9"
"DeKalb","2020-06-28","534","86940","102","7640","12.2","10.8"
"DeKalb","2020-06-29","3050","89990","337","7977","12.6","11.2"
"DeKalb","2020-06-30","3526","93516","404","8381","12.7","11.5"
"DeKalb","2020-07-01","3198","96714","386","8767","12.6","11.8"
"DeKalb","2020-07-02","3347","100061","321","9088","12.4","11.9"
"DeKalb","2020-07-03","1013","101074","111","9199","12.4","12.1"
"DeKalb","2020-07-04","374","101448","84","9283","13.8","12.9"
"DeKalb","2020-07-05","535","101983","101","9384","13.8","13"
"DeKalb","2020-07-06","3412","105395","435","9819","14","13.3"
"DeKalb","2020-07-07","3372","108767","394","10213","14.1","13.4"
"DeKalb","2020-07-08","3563","112330","393","10606","13.9","13.2"
"DeKalb","2020-07-09","3774","116104","372","10978","13.9","13.2"
"DeKalb","2020-07-10","3288","119392","293","11271","13.7","13"
"DeKalb","2020-07-11","926","120318","129","11400","12.4","13.1"
"DeKalb","2020-07-12","621","120939","98","11498","12","12.9"
"DeKalb","2020-07-13","3308","124247","296","11794","11.4","12.7"
"DeKalb","2020-07-14","3093","127340","270","12064","11","12.5"
"DeKalb","2020-07-15","3072","130412","289","12353","10.8","12.4"
"DeKalb","2020-07-16","3048","133460","270","12623","10.7","12.3"
"DeKalb","2020-07-17","2762","136222","189","12812","10.4","12"
"DeKalb","2020-07-18","819","137041","102","12914","10.1","11.3"
"DeKalb","2020-07-19","750","137791","130","13044","10.4","11.2"
"DeKalb","2020-07-20","2993","140784","237","13281","10.2","10.8"
"DeKalb","2020-07-21","2743","143527","178","13459","9.9","10.5"
"DeKalb","2020-07-22","2745","146272","147","13606","9.3","10.1"
"DeKalb","2020-07-23","2691","148963","173","13779","9","9.8"
"DeKalb","2020-07-24","2860","151823","215","13994","9.1","9.7"
"DeKalb","2020-07-25","965","152788","99","14093","8.8","9.5"
"DeKalb","2020-07-26","512","153300","58","14151","7.9","9.1"
"DeKalb","2020-07-27","2689","155989","176","14327","7.7","9"
"DeKalb","2020-07-28","2593","158582","157","14484","7.6","8.8"
"DeKalb","2020-07-29","2515","161097","193","14677","8","8.6"
"DeKalb","2020-07-30","2548","163645","194","14871","8.1","8.6"
"DeKalb","2020-07-31","2706","166351","165","15036","7.9","8.5"
"DeKalb","2020-08-01","907","167258","91","15127","7.9","8.3"
"DeKalb","2020-08-02","422","167680","55","15182","8.2","8"
"DeKalb","2020-08-03","2766","170446","172","15354","8.1","7.9"
"DeKalb","2020-08-04","2552","172998","157","15511","8.1","7.9"
"DeKalb","2020-08-05","2311","175309","137","15648","7.9","7.9"
"DeKalb","2020-08-06","2048","177357","131","15779","7.7","7.9"
"DeKalb","2020-08-07","2404","179761","127","15906","7.6","7.8"
"DeKalb","2020-08-08","943","180704","73","15979","7.3","7.6"
"DeKalb","2020-08-09","506","181210","30","16009","6.2","7.2"
"DeKalb","2020-08-10","2659","183869","187","16196","6.4","7.2"
"DeKalb","2020-08-11","2540","186409","136","16332","6.2","7.2"
"DeKalb","2020-08-12","2246","188655","135","16467","6.2","7.1"
"DeKalb","2020-08-13","2128","190783","109","16576","6.1","6.9"
"DeKalb","2020-08-14","2516","193299","122","16698","6","6.8"
"DeKalb","2020-08-15","847","194146","57","16755","5.9","6.6"
"DeKalb","2020-08-16","744","194890","56","16811","6.1","6.2"
"DeKalb","2020-08-17","1722","196612","103","16914","5.9","6.1"
"DeKalb","2020-08-18","1933","198545","108","17022","6","6.1"
"DeKalb","2020-08-19","2133","200678","107","17129","5.8","6"
"DeKalb","2020-08-20","1807","202485","106","17235","5.9","6"
"DeKalb","2020-08-21","2054","204539","104","17339","6","6"
"DeKalb","2020-08-22","855","205394","54","17393","5.9","5.9"
"DeKalb","2020-08-23","537","205931","33","17426","5.7","5.9"
"DeKalb","2020-08-24","2090","208021","114","17540","5.6","5.8"
"DeKalb","2020-08-25","2216","210237","93","17633","5.4","5.7"
"DeKalb","2020-08-26","1776","212013","98","17731","5.5","5.7"
"DeKalb","2020-08-27","1810","213823","101","17832","5.5","5.7"
"DeKalb","2020-08-28","2020","215843","95","17927","5.4","5.7"
"DeKalb","2020-08-29","934","216777","50","17977","5.3","5.6"
"DeKalb","2020-08-30","518","217295","45","18022","5.6","5.7"
"DeKalb","2020-08-31","2311","219606","118","18140","5.6","5.6"
"DeKalb","2020-09-01","2268","221874","108","18248","5.7","5.6"
"DeKalb","2020-09-02","1888","223762","70","18318","5.4","5.5"
"DeKalb","2020-09-03","1809","225571","88","18406","5.3","5.4"
"DeKalb","2020-09-04","1896","227467","89","18495","5.3","5.4"
"DeKalb","2020-09-05","871","228338","26","18521","5","5.1"
"DeKalb","2020-09-06","558","228896","34","18555","4.6","5.1"
"DeKalb","2020-09-07","505","229401","30","18585","4.7","5.2"
"DeKalb","2020-09-08","2228","231629","85","18670","4.6","5.1"
"DeKalb","2020-09-09","2027","233656","80","18750","4.6","5"
"DeKalb","2020-09-10","2046","235702","74","18824","4.4","4.9"
"DeKalb","2020-09-11","2268","237970","62","18886","4.2","4.7"
"DeKalb","2020-09-12","811","238781","48","18934","4.6","4.8"
"DeKalb","2020-09-13","397","239178","27","18961","4.7","4.6"
"DeKalb","2020-09-14","2299","241477","88","19049","4.4","4.6"
"DeKalb","2020-09-15","2143","243620","64","19113","4.3","4.4"
"DeKalb","2020-09-16","1975","245595","60","19173","4.1","4.4"
"DeKalb","2020-09-17","1263","246858","47","19220","4.1","4.3"
"DeKalb","2020-09-18","2723","249581","87","19307","4.2","4.2"
"DeKalb","2020-09-19","985","250566","37","19344","3.9","4.2"
"DeKalb","2020-09-20","506","251072","30","19374","3.8","4.2"
"DeKalb","2020-09-21","2463","253535","94","19468","3.8","4.1"
"DeKalb","2020-09-22","1995","255530","59","19527","3.8","4"
"DeKalb","2020-09-23","2444","257974","85","19612","3.8","4"
"DeKalb","2020-09-24","1960","259934","74","19686","3.8","4"
"DeKalb","2020-09-25","2388","262322","69","19755","3.8","4"
"DeKalb","2020-09-26","898","263220","62","19817","4.2","4.1"
"DeKalb","2020-09-27","401","263621","12","19829","3.8","3.8"
"DeKalb","2020-09-28","2451","266072","91","19920","3.8","3.8"
"DeKalb","2020-09-29","2164","268236","55","19975","3.8","3.8"
"DeKalb","2020-09-30","2180","270416","87","20062","3.8","3.8"
"DeKalb","2020-10-01","2432","272848","72","20134","3.7","3.8"
"DeKalb","2020-10-02","2472","275320","72","20206","3.7","3.8"
"DeKalb","2020-10-03","1052","276372","45","20251","3.3","3.8"
"DeKalb","2020-10-04","503","276875","22","20273","3.5","3.7"
"DeKalb","2020-10-05","2658","279533","98","20371","3.5","3.7"
"DeKalb","2020-10-06","2656","282189","75","20446","3.6","3.7"
"DeKalb","2020-10-07","3049","285238","80","20526","3.4","3.6"
"DeKalb","2020-10-08","2631","287869","82","20608","3.4","3.6"
"DeKalb","2020-10-09","2664","290533","89","20697","3.5","3.6"
"DeKalb","2020-10-10","982","291515","52","20749","3.6","3.5"
"DeKalb","2020-10-11","408","291923","28","20777","4","3.8"
"DeKalb","2020-10-12","1944","293867","66","20843","3.9","3.7"
"DeKalb","2020-10-13","2850","296717","90","20933","4","3.8"
"DeKalb","2020-10-14","2353","299070","95","21028","4.2","3.8"
"DeKalb","2020-10-15","2406","301476","116","21144","4.4","3.9"
"DeKalb","2020-10-16","2573","304049","101","21245","4.5","4"
"DeKalb","2020-10-17","813","304862","54","21299","4.7","4.2"
"DeKalb","2020-10-18","417","305279","17","21316","4.3","4.1"
"DeKalb","2020-10-19","2843","308122","132","21448","4.5","4.2"
"DeKalb","2020-10-20","2533","310655","107","21555","4.6","4.3"
"DeKalb","2020-10-21","2529","313184","94","21649","4.6","4.4"
"DeKalb","2020-10-22","2443","315627","115","21764","4.6","4.5"
"DeKalb","2020-10-23","2973","318600","116","21880","4.6","4.5"
"DeKalb","2020-10-24","952","319552","62","21942","4.5","4.6"
"DeKalb","2020-10-25","717","320269","43","21985","4.8","4.6"
"DeKalb","2020-10-26","3000","323269","141","22126","4.8","4.6"
"DeKalb","2020-10-27","2850","326119","110","22236","4.8","4.7"
"DeKalb","2020-10-28","3303","329422","139","22375","4.8","4.7"
"DeKalb","2020-10-29","1670","331092","90","22465","4.9","4.8"
"DeKalb","2020-10-30","3468","334560","166","22631","5.1","4.8"
"DeKalb","2020-10-31","1048","335608","67","22698","5","4.8"
"DeKalb","2020-11-01","608","336216","50","22748","5.4","5.1"
"DeKalb","2020-11-02","3701","339917","213","22961","5.5","5.2"
"DeKalb","2020-11-03","2569","342486","121","23082","5.6","5.2"
"DeKalb","2020-11-04","3093","345579","165","23247","5.8","5.3"
"DeKalb","2020-11-05","3046","348625","167","23414","5.8","5.4"
"DeKalb","2020-11-06","3347","351972","213","23627","6","5.6"
"DeKalb","2020-11-07","1471","353443","90","23717","6","5.5"
"DeKalb","2020-11-08","790","354233","62","23779","5.9","5.7"
"DeKalb","2020-11-09","3600","357833","257","24036","6.1","5.8"
"DeKalb","2020-11-10","3603","361436","240","24276","6.4","6"
"DeKalb","2020-11-11","2653","364089","184","24460","6.6","6.2"
"DeKalb","2020-11-12","3590","367679","222","24682","6.7","6.3"
"DeKalb","2020-11-13","4189","371868","237","24919","6.6","6.3"
"DeKalb","2020-11-14","1982","373850","146","25065","6.8","6.4"
"DeKalb","2020-11-15","849","374699","79","25144","7","6.5"
"DeKalb","2020-11-16","4580","379279","272","25416","6.9","6.5"
"DeKalb","2020-11-17","4425","383704","213","25629","6.6","6.5"
"DeKalb","2020-11-18","4874","388578","245","25874","6.3","6.5"
"DeKalb","2020-11-19","5207","393785","234","26108","6.1","6.4"
"DeKalb","2020-11-20","5290","399075","192","26300","5.8","6.2"
"DeKalb","2020-11-21","2444","401519","126","26426","5.5","6.2"
"DeKalb","2020-11-22","1283","402802","74","26500","5","6"
"DeKalb","2020-11-23","5163","407965","220","26720","4.7","5.8"
"DeKalb","2020-11-24","4786","412751","280","27000","4.9","5.7"
"DeKalb","2020-11-25","3201","415952","205","27205","5.1","5.7"
"DeKalb","2020-11-26","537","416489","32","27237","5.3","5.7"
"DeKalb","2020-11-27","2004","418493","208","27445","6.3","6"
"DeKalb","2020-11-28","1259","419752","153","27598","7.3","6.4"
"DeKalb","2020-11-29","1107","420859","112","27710","7.9","6.4"
"DeKalb","2020-11-30","4627","425486","453","28163","8.7","6.7"
"DeKalb","2020-12-01","3952","429438","430","28593","9.4","7.1"
"DeKalb","2020-12-02","3795","433233","345","28938","9.8","7.4"
"DeKalb","2020-12-03","3798","437031","371","29309","10.3","7.8"
"DeKalb","2020-12-04","4432","441463","394","29703","10.1","8.2"
"DeKalb","2020-12-05","2039","443502","216","29919","9.9","8.6"
"DeKalb","2020-12-06","939","444441","88","30007","9.8","8.8"
"DeKalb","2020-12-07","4032","448473","424","30431","9.9","9.3"
"DeKalb","2020-12-08","3921","452394","363","30794","9.6","9.5"
"DeKalb","2020-12-09","4208","456602","399","31193","9.7","9.7"
"DeKalb","2020-12-10","3928","460530","413","31606","9.8","10.1"
"DeKalb","2020-12-11","4337","464867","441","32047","10","10"
"DeKalb","2020-12-12","2112","466979","277","32324","10.3","10.1"
"DeKalb","2020-12-13","941","467920","131","32455","11","10.4"
"DeKalb","2020-12-14","4521","472441","492","32947","11","10.5"
"DeKalb","2020-12-15","4175","476616","406","33353","11.1","10.4"
"DeKalb","2020-12-16","4078","480694","369","33722","11.1","10.4"
"DeKalb","2020-12-17","4975","485669","523","34245","11.1","10.4"
"DeKalb","2020-12-18","5109","490778","459","34704","10.9","10.4"
"DeKalb","2020-12-19","2649","493427","266","34970","10.4","10.4"
"DeKalb","2020-12-20","1346","494773","151","35121","10.1","10.5"
"DeKalb","2020-12-21","4992","499765","549","35670","10.1","10.6"
"DeKalb","2020-12-22","4874","504639","501","36171","10.2","10.6"
"DeKalb","2020-12-23","4092","508731","444","36615","10.4","10.7"
"DeKalb","2020-12-24","1630","510361","186","36801","10.5","10.8"
"DeKalb","2020-12-25","336","510697","38","36839","10.9","10.9"
"DeKalb","2020-12-26","1797","512494","327","37166","12","11.2"
"DeKalb","2020-12-27","1401","513895","261","37427","13.1","11.6"
"DeKalb","2020-12-28","4432","518327","612","38039","13.5","11.8"
"DeKalb","2020-12-29","3870","522197","595","38634","14.2","12.2"
"DeKalb","2020-12-30","4034","526231","507","39141","14.5","12.4"
"DeKalb","2020-12-31","2716","528947","312","39453","14.5","12.5"
"DeKalb","2021-01-01","411","529358","67","39520","15.2","13"
"DeKalb","2021-01-02","1897","531255","338","39858","15.1","13.6"
"DeKalb","2021-01-03","789","532044","108","39966","14.4","13.8"
"DeKalb","2021-01-04","3549","535593","565","40531","14.7","14.1"
"DeKalb","2021-01-05","4864","540457","687","41218","14.6","14.4"
"DeKalb","2021-01-06","3375","543832","439","41657","14.6","14.5"
"DeKalb","2021-01-07","4225","548057","676","42333","15.3","14.9"
"DeKalb","2021-01-08","3833","551890","506","42839","14.8","15"
"DeKalb","2021-01-09","2156","554046","377","43216","14.8","15"
"DeKalb","2021-01-10","1307","555353","214","43430","15.2","14.8"
"DeKalb","2021-01-11","3899","559252","521","43951","14.8","14.8"
"DeKalb","2021-01-12","3620","562872","518","44469","14.8","14.7"
"DeKalb","2021-01-13","3748","566620","373","44842","14.4","14.5"
"DeKalb","2021-01-14","4266","570886","539","45381","13.9","14.6"
"DeKalb","2021-01-15","3907","574793","487","45868","13.8","14.3"
"DeKalb","2021-01-16","2013","576806","278","46146","13.3","14"
"DeKalb","2021-01-17","1157","577963","198","46344","13.4","14.3"
"DeKalb","2021-01-18","2488","580451","253","46597","12.9","13.9"
"DeKalb","2021-01-19","3736","584187","401","46998","12.4","13.6"
"DeKalb","2021-01-20","3280","587467","341","47339","12.5","13.4"
"DeKalb","2021-01-21","3410","590877","438","47777","12.5","13.2"
"DeKalb","2021-01-22","3696","594573","388","48165","12.2","13"
"DeKalb","2021-01-23","1758","596331","241","48406","12.2","12.7"
"DeKalb","2021-01-24","1050","597381","166","48572","12","12.7"
"DeKalb","2021-01-25","3854","601235","385","48957","12","12.5"
"DeKalb","2021-01-26","3174","604409","344","49301","12","12.2"
"DeKalb","2021-01-27","3118","607527","276","49577","11.8","12.1"
"DeKalb","2021-01-28","3131","610658","335","49912","11.5","12"
"DeKalb","2021-01-29","3421","614079","326","50238","11.3","11.8"
"DeKalb","2021-01-30","1785","615864","183","50421","10.9","11.5"
"DeKalb","2021-01-31","1091","616955","129","50550","10.3","11.2"
"DeKalb","2021-02-01","3197","620152","262","50812","10","11"
"DeKalb","2021-02-02","2907","623059","234","51046","9.6","10.8"
"DeKalb","2021-02-03","2806","625865","175","51221","9.3","10.5"
"DeKalb","2021-02-04","2160","628025","202","51423","9.1","10.3"
"DeKalb","2021-02-05","2058","630083","129","51552","8.6","10"
"DeKalb","2021-02-06","489","630572","47","51599","8.5","9.7"
"DeKalb","2021-02-07","30","630602","3","51602","8.2","9.3"
"DeKalb","2021-02-08","0","630602","0","51602","7.1","8.6"
"Dodge","2020-02-01","0","0","0","0",".","."
"Dodge","2020-02-02","0","0","0","0",".","."
"Dodge","2020-02-03","0","0","0","0",".","."
"Dodge","2020-02-04","0","0","0","0",".","."
"Dodge","2020-02-05","0","0","0","0",".","."
"Dodge","2020-02-06","0","0","0","0",".","."
"Dodge","2020-02-07","0","0","0","0","0","."
"Dodge","2020-02-08","0","0","0","0","0","."
"Dodge","2020-02-09","0","0","0","0","0","."
"Dodge","2020-02-10","0","0","0","0","0","."
"Dodge","2020-02-11","0","0","0","0","0","."
"Dodge","2020-02-12","0","0","0","0","0","."
"Dodge","2020-02-13","0","0","0","0","0","."
"Dodge","2020-02-14","0","0","0","0","0","0"
"Dodge","2020-02-15","0","0","0","0","0","0"
"Dodge","2020-02-16","0","0","0","0","0","0"
"Dodge","2020-02-17","0","0","0","0","0","0"
"Dodge","2020-02-18","0","0","0","0","0","0"
"Dodge","2020-02-19","0","0","0","0","0","0"
"Dodge","2020-02-20","0","0","0","0","0","0"
"Dodge","2020-02-21","0","0","0","0","0","0"
"Dodge","2020-02-22","0","0","0","0","0","0"
"Dodge","2020-02-23","0","0","0","0","0","0"
"Dodge","2020-02-24","0","0","0","0","0","0"
"Dodge","2020-02-25","0","0","0","0","0","0"
"Dodge","2020-02-26","0","0","0","0","0","0"
"Dodge","2020-02-27","0","0","0","0","0","0"
"Dodge","2020-02-28","0","0","0","0","0","0"
"Dodge","2020-02-29","0","0","0","0","0","0"
"Dodge","2020-03-01","0","0","0","0","0","0"
"Dodge","2020-03-02","0","0","0","0","0","0"
"Dodge","2020-03-03","0","0","0","0","0","0"
"Dodge","2020-03-04","0","0","0","0","0","0"
"Dodge","2020-03-05","0","0","0","0","0","0"
"Dodge","2020-03-06","0","0","0","0","0","0"
"Dodge","2020-03-07","0","0","0","0","0","0"
"Dodge","2020-03-08","0","0","0","0","0","0"
"Dodge","2020-03-09","1","1","1","1","14.3","7.1"
"Dodge","2020-03-10","0","1","0","1","14.3","7.1"
"Dodge","2020-03-11","0","1","0","1","14.3","7.1"
"Dodge","2020-03-12","0","1","0","1","14.3","7.1"
"Dodge","2020-03-13","1","2","0","1","14.3","7.1"
"Dodge","2020-03-14","1","3","0","1","14.3","7.1"
"Dodge","2020-03-15","0","3","0","1","14.3","7.1"
"Dodge","2020-03-16","3","6","0","1","0","7.1"
"Dodge","2020-03-17","10","16","0","1","0","7.1"
"Dodge","2020-03-18","4","20","0","1","0","7.1"
"Dodge","2020-03-19","6","26","0","1","0","7.1"
"Dodge","2020-03-20","6","32","1","2","2.4","8.3"
"Dodge","2020-03-21","0","32","0","2","2.4","8.3"
"Dodge","2020-03-22","1","33","0","2","2.4","8.3"
"Dodge","2020-03-23","3","36","0","2","2.4","1.2"
"Dodge","2020-03-24","8","44","0","2","2.4","1.2"
"Dodge","2020-03-25","6","50","1","3","4.8","2.4"
"Dodge","2020-03-26","4","54","0","3","4.8","2.4"
"Dodge","2020-03-27","2","56","0","3","2.4","2.4"
"Dodge","2020-03-28","0","56","0","3","2.4","2.4"
"Dodge","2020-03-29","1","57","0","3","2.4","2.4"
"Dodge","2020-03-30","1","58","0","3","2.4","2.4"
"Dodge","2020-03-31","2","60","2","5","16.7","9.5"
"Dodge","2020-04-01","1","61","0","5","14.3","9.5"
"Dodge","2020-04-02","5","66","0","5","14.3","9.5"
"Dodge","2020-04-03","6","72","0","5","14.3","8.3"
"Dodge","2020-04-04","5","77","0","5","14.3","8.3"
"Dodge","2020-04-05","0","77","0","5","14.3","8.3"
"Dodge","2020-04-06","2","79","0","5","14.3","8.3"
"Dodge","2020-04-07","1","80","0","5","0","8.3"
"Dodge","2020-04-08","0","80","0","5","0","7.1"
"Dodge","2020-04-09","5","85","1","6","2.9","8.6"
"Dodge","2020-04-10","2","87","0","6","2.9","8.6"
"Dodge","2020-04-11","4","91","2","8","10","12.1"
"Dodge","2020-04-12","3","94","2","10","19.5","16.9"
"Dodge","2020-04-13","10","104","1","11","21","17.6"
"Dodge","2020-04-14","3","107","1","12","25.7","12.9"
"Dodge","2020-04-15","3","110","0","12","25.7","12.9"
"Dodge","2020-04-16","4","114","0","12","22.9","12.9"
"Dodge","2020-04-17","7","121","0","12","22.9","12.9"
"Dodge","2020-04-18","3","124","1","13","20.5","15.2"
"Dodge","2020-04-19","0","124","0","13","11","15.2"
"Dodge","2020-04-20","3","127","0","13","9.5","15.2"
"Dodge","2020-04-21","17","144","2","15","6.4","16.1"
"Dodge","2020-04-22","9","153","0","15","6.4","16.1"
"Dodge","2020-04-23","8","161","0","15","6.4","14.6"
"Dodge","2020-04-24","3","164","0","15","6.4","14.6"
"Dodge","2020-04-25","0","164","0","15","1.7","11.1"
"Dodge","2020-04-26","2","166","0","15","1.7","6.3"
"Dodge","2020-04-27","3","169","0","15","1.7","5.6"
"Dodge","2020-04-28","6","175","0","15","0","3.2"
"Dodge","2020-04-29","10","185","1","16","1.4","3.9"
"Dodge","2020-04-30","8","193","0","16","1.4","3.9"
"Dodge","2020-05-01","3","196","0","16","1.4","3.9"
"Dodge","2020-05-02","1","197","0","16","1.4","1.6"
"Dodge","2020-05-03","8","205","1","17","3.2","2.4"
"Dodge","2020-05-04","11","216","1","18","4.5","3.1"
"Dodge","2020-05-05","3","219","0","18","4.5","2.3"
"Dodge","2020-05-06","3","222","0","18","3.1","2.3"
"Dodge","2020-05-07","0","222","0","18","3.1","2.3"
"Dodge","2020-05-08","3","225","0","18","3.1","2.3"
"Dodge","2020-05-09","2","227","1","19","10.2","5.8"
"Dodge","2020-05-10","0","227","0","19","8.4","5.8"
"Dodge","2020-05-11","4","231","0","19","7.1","5.8"
"Dodge","2020-05-12","4","235","0","19","7.1","5.8"
"Dodge","2020-05-13","6","241","0","19","7.1","5.1"
"Dodge","2020-05-14","2","243","0","19","7.1","5.1"
"Dodge","2020-05-15","5","248","0","19","7.1","5.1"
"Dodge","2020-05-16","12","260","0","19","0","5.1"
"Dodge","2020-05-17","1","261","0","19","0","4.2"
"Dodge","2020-05-18","13","274","1","20","1.1","4.1"
"Dodge","2020-05-19","10","284","1","21","2.5","4.8"
"Dodge","2020-05-20","43","327","2","23","3.2","5.2"
"Dodge","2020-05-21","11","338","0","23","3.2","5.2"
"Dodge","2020-05-22","13","351","0","23","3.2","5.2"
"Dodge","2020-05-23","2","353","0","23","3.2","1.6"
"Dodge","2020-05-24","1","354","0","23","3.2","1.6"
"Dodge","2020-05-25","3","357","0","23","2.1","1.6"
"Dodge","2020-05-26","9","366","0","23","0.7","1.6"
"Dodge","2020-05-27","12","378","0","23","0","1.6"
"Dodge","2020-05-28","9","387","1","24","1.6","2.4"
"Dodge","2020-05-29","85","472","0","24","1.6","2.4"
"Dodge","2020-05-30","5","477","1","25","4.4","3.8"
"Dodge","2020-05-31","1","478","0","25","4.4","3.8"
"Dodge","2020-06-01","10","488","1","26","5.9","4"
"Dodge","2020-06-02","15","503","0","26","5.9","3.3"
"Dodge","2020-06-03","22","525","0","26","5.9","2.9"
"Dodge","2020-06-04","9","534","0","26","4.3","2.9"
"Dodge","2020-06-05","5","539","0","26","4.3","2.9"
"Dodge","2020-06-06","5","544","0","26","1.4","2.9"
"Dodge","2020-06-07","2","546","0","26","1.4","2.9"
"Dodge","2020-06-08","13","559","0","26","0","2.9"
"Dodge","2020-06-09","16","575","0","26","0","2.9"
"Dodge","2020-06-10","12","587","1","27","1.2","3.5"
"Dodge","2020-06-11","18","605","1","28","2","3.1"
"Dodge","2020-06-12","10","615","0","28","2","3.1"
"Dodge","2020-06-13","2","617","0","28","2","1.7"
"Dodge","2020-06-14","2","619","0","28","2","1.7"
"Dodge","2020-06-15","12","631","0","28","2","1"
"Dodge","2020-06-16","9","640","0","28","2","1"
"Dodge","2020-06-17","7","647","1","29","2.8","2"
"Dodge","2020-06-18","7","654","0","29","2","2"
"Dodge","2020-06-19","10","664","1","30","3.5","2.7"
"Dodge","2020-06-20","8","672","1","31","5.3","3.6"
"Dodge","2020-06-21","0","672","0","31","5.3","3.6"
"Dodge","2020-06-22","11","683","4","35","10.4","6.2"
"Dodge","2020-06-23","9","692","0","35","10.4","6.2"
"Dodge","2020-06-24","11","703","1","36","9.7","6.3"
"Dodge","2020-06-25","4","707","0","36","9.7","5.9"
"Dodge","2020-06-26","10","717","1","37","9.7","6.6"
"Dodge","2020-06-27","5","722","1","38","10.8","8"
"Dodge","2020-06-28","0","722","0","38","10.8","8"
"Dodge","2020-06-29","8","730","0","38","5.6","8"
"Dodge","2020-06-30","11","741","2","40","8.2","9.3"
"Dodge","2020-07-01","3","744","0","40","6.9","8.3"
"Dodge","2020-07-02","8","752","0","40","6.9","8.3"
"Dodge","2020-07-03","2","754","0","40","5.5","7.6"
"Dodge","2020-07-04","0","754","0","40","2.6","6.7"
"Dodge","2020-07-05","5","759","1","41","5.5","8.1"
"Dodge","2020-07-06","7","766","0","41","5.5","5.5"
"Dodge","2020-07-07","8","774","0","41","2.9","5.5"
"Dodge","2020-07-08","12","786","0","41","2.9","4.9"
"Dodge","2020-07-09","10","796","0","41","2.9","4.9"
"Dodge","2020-07-10","10","806","1","42","4.3","4.9"
"Dodge","2020-07-11","4","810","1","43","7.9","5.2"
"Dodge","2020-07-12","0","810","0","43","5","5.2"
"Dodge","2020-07-13","5","815","0","43","5","5.2"
"Dodge","2020-07-14","10","825","0","43","5","3.9"
"Dodge","2020-07-15","9","834","1","44","6.6","4.7"
"Dodge","2020-07-16","7","841","0","44","6.6","4.7"
"Dodge","2020-07-17","6","847","1","45","7.5","5.9"
"Dodge","2020-07-18","1","848","0","45","4","5.9"
"Dodge","2020-07-19","0","848","0","45","4","4.5"
"Dodge","2020-07-20","8","856","0","45","4","4.5"
"Dodge","2020-07-21","9","865","2","47","7.1","6.1"
"Dodge","2020-07-22","7","872","0","47","5.6","6.1"
"Dodge","2020-07-23","10","882","0","47","5.6","6.1"
"Dodge","2020-07-24","15","897","1","48","4.1","5.8"
"Dodge","2020-07-25","5","902","2","50","9.8","6.9"
"Dodge","2020-07-26","2","904","1","51","17","10.5"
"Dodge","2020-07-27","9","913","1","52","18.6","11.3"
"Dodge","2020-07-28","14","927","1","53","16.4","11.8"
"Dodge","2020-07-29","7","934","0","53","16.4","11"
"Dodge","2020-07-30","18","952","0","53","16.4","11"
"Dodge","2020-07-31","5","957","0","53","15.5","9.8"
"Dodge","2020-08-01","1","958","0","53","9.8","9.8"
"Dodge","2020-08-02","4","962","2","55","9.8","13.4"
"Dodge","2020-08-03","6","968","0","55","8.2","13.4"
"Dodge","2020-08-04","13","981","4","59","11.5","14"
"Dodge","2020-08-05","10","991","2","61","14.4","15.4"
"Dodge","2020-08-06","20","1011","6","67","18.7","17.5"
"Dodge","2020-08-07","37","1048","3","70","19.8","17.7"
"Dodge","2020-08-08","134","1182","6","76","20.5","15.1"
"Dodge","2020-08-09","6","1188","2","78","18.1","13.9"
"Dodge","2020-08-10","7","1195","1","79","20.1","14.2"
"Dodge","2020-08-11","8","1203","0","79","15.7","13.6"
"Dodge","2020-08-12","23","1226","12","91","20.3","17.4"
"Dodge","2020-08-13","8","1234","0","91","16.1","17.4"
"Dodge","2020-08-14","6","1240","1","92","17.3","18.6"
"Dodge","2020-08-15","8","1248","3","95","22","21.2"
"Dodge","2020-08-16","0","1248","0","95","17.2","17.7"
"Dodge","2020-08-17","9","1257","0","95","15.2","17.7"
"Dodge","2020-08-18","17","1274","1","96","16","15.9"
"Dodge","2020-08-19","19","1293","4","100","11.6","16"
"Dodge","2020-08-20","19","1312","5","105","15.3","15.7"
"Dodge","2020-08-21","13","1325","3","108","16.3","16.8"
"Dodge","2020-08-22","2","1327","1","109","18","20"
"Dodge","2020-08-23","5","1332","0","109","18","17.6"
"Dodge","2020-08-24","10","1342","3","112","22.3","18.8"
"Dodge","2020-08-25","25","1367","8","120","26.1","21"
"Dodge","2020-08-26","11","1378","2","122","25.7","18.6"
"Dodge","2020-08-27","22","1400","3","125","23.8","19.6"
"Dodge","2020-08-28","11","1411","1","126","21.8","19.1"
"Dodge","2020-08-29","8","1419","0","126","14.7","16.4"
"Dodge","2020-08-30","4","1423","1","127","18.3","18.2"
"Dodge","2020-08-31","91","1514","3","130","14.5","18.4"
"Dodge","2020-09-01","77","1591","2","132","10.3","18.2"
"Dodge","2020-09-02","10","1601","1","133","9.1","17.4"
"Dodge","2020-09-03","11","1612","2","135","9.7","16.8"
"Dodge","2020-09-04","7","1619","0","135","8.4","15.1"
"Dodge","2020-09-05","10","1629","0","135","8.4","11.6"
"Dodge","2020-09-06","140","1769","2","137","5.1","11.7"
"Dodge","2020-09-07","6","1775","1","138","7","10.7"
"Dodge","2020-09-08","7","1782","0","138","6.6","8.4"
"Dodge","2020-09-09","7","1789","3","141","11.3","10.2"
"Dodge","2020-09-10","50","1839","7","148","10.7","10.2"
"Dodge","2020-09-11","6","1845","1","149","13.1","10.8"
"Dodge","2020-09-12","12","1857","0","149","13.1","10.8"
"Dodge","2020-09-13","5","1862","1","150","15.7","10.4"
"Dodge","2020-09-14","10","1872","0","150","13.4","10.2"
"Dodge","2020-09-15","13","1885","2","152","15.6","11.1"
"Dodge","2020-09-16","11","1896","2","154","12","11.7"
"Dodge","2020-09-17","80","1976","1","155","10.2","10.5"
"Dodge","2020-09-18","78","2054","3","158","8.4","10.7"
"Dodge","2020-09-19","3","2057","0","158","8.4","10.7"
"Dodge","2020-09-20","1","2058","0","158","5.5","10.6"
"Dodge","2020-09-21","16","2074","2","160","7.3","10.3"
"Dodge","2020-09-22","8","2082","0","160","5.1","10.3"
"Dodge","2020-09-23","43","2125","1","161","2.8","7.4"
"Dodge","2020-09-24","61","2186","3","164","3.4","6.8"
"Dodge","2020-09-25","12","2198","0","164","2.8","5.6"
"Dodge","2020-09-26","5","2203","0","164","2.8","5.6"
"Dodge","2020-09-27","3","2206","1","165","7.6","6.6"
"Dodge","2020-09-28","12","2218","0","165","5.8","6.6"
"Dodge","2020-09-29","5","2223","0","165","5.8","5.5"
"Dodge","2020-09-30","9","2232","2","167","8.6","5.7"
"Dodge","2020-10-01","111","2343","3","170","8.3","5.8"
"Dodge","2020-10-02","10","2353","0","170","8.3","5.6"
"Dodge","2020-10-03","13","2366","2","172","10.5","6.7"
"Dodge","2020-10-04","67","2433","1","173","6","6.8"
"Dodge","2020-10-05","12","2445","3","176","9.5","7.7"
"Dodge","2020-10-06","28","2473","0","176","9.5","7.7"
"Dodge","2020-10-07","3","2476","1","177","11.1","9.9"
"Dodge","2020-10-08","53","2529","6","183","12.4","10.3"
"Dodge","2020-10-09","13","2542","0","183","12.4","10.3"
"Dodge","2020-10-10","7","2549","0","183","10.2","10.3"
"Dodge","2020-10-11","133","2682","12","195","11.2","8.6"
"Dodge","2020-10-12","15","2697","0","195","7.7","8.6"
"Dodge","2020-10-13","10","2707","1","196","9.1","9.3"
"Dodge","2020-10-14","112","2819","12","208","5.9","8.5"
"Dodge","2020-10-15","97","2916","15","223","6.5","9.4"
"Dodge","2020-10-16","7","2923","1","224","8.5","10.4"
"Dodge","2020-10-17","7","2930","1","225","10.5","10.4"
"Dodge","2020-10-18","6","2936","5","230","21.2","16.2"
"Dodge","2020-10-19","26","2962","2","232","22.3","15"
"Dodge","2020-10-20","28","2990","4","236","22.9","16"
"Dodge","2020-10-21","96","3086","17","253","23.9","14.9"
"Dodge","2020-10-22","89","3175","18","271","24.5","15.5"
"Dodge","2020-10-23","15","3190","2","273","24.4","16.5"
"Dodge","2020-10-24","38","3228","6","279","24.6","17.6"
"Dodge","2020-10-25","34","3262","5","284","14.8","18"
"Dodge","2020-10-26","21","3283","2","286","15.1","18.7"
"Dodge","2020-10-27","9","3292","1","287","14.6","18.7"
"Dodge","2020-10-28","46","3338","2","289","12.7","18.3"
"Dodge","2020-10-29","52","3390","5","294","11.2","17.9"
"Dodge","2020-10-30","10","3400","1","295","10.7","17.6"
"Dodge","2020-10-31","7","3407","1","296","10.5","17.6"
"Dodge","2020-11-01","24","3431","2","298","9.6","12.2"
"Dodge","2020-11-02","13","3444","0","298","8.2","11.7"
"Dodge","2020-11-03","22","3466","0","298","6.7","10.6"
"Dodge","2020-11-04","34","3500","0","298","6","9.4"
"Dodge","2020-11-05","47","3547","4","302","5.9","8.5"
"Dodge","2020-11-06","12","3559","0","302","4.4","7.6"
"Dodge","2020-11-07","16","3575","1","303","3.3","6.9"
"Dodge","2020-11-08","26","3601","2","305","3.2","6.4"
"Dodge","2020-11-09","16","3617","1","306","4.1","6.2"
"Dodge","2020-11-10","16","3633","0","306","4.1","5.4"
"Dodge","2020-11-11","5","3638","2","308","9.8","7.9"
"Dodge","2020-11-12","96","3734","4","312","9.2","7.5"
"Dodge","2020-11-13","7","3741","1","313","11.2","7.8"
"Dodge","2020-11-14","8","3749","2","315","13.9","8.6"
"Dodge","2020-11-15","46","3795","7","322","15","9.1"
"Dodge","2020-11-16","17","3812","2","324","15.8","9.9"
"Dodge","2020-11-17","15","3827","2","326","17.7","10.9"
"Dodge","2020-11-18","10","3837","1","327","13.4","11.6"
"Dodge","2020-11-19","50","3887","3","330","13.7","11.4"
"Dodge","2020-11-20","42","3929","3","333","12.6","11.9"
"Dodge","2020-11-21","3","3932","1","334","13.8","13.9"
"Dodge","2020-11-22","4","3936","1","335","15.2","15.1"
"Dodge","2020-11-23","10","3946","0","335","13.5","14.7"
"Dodge","2020-11-24","23","3969","2","337","12.9","15.3"
"Dodge","2020-11-25","45","4014","0","337","11.5","12.4"
"Dodge","2020-11-26","0","4014","0","337","10.6","12.1"
"Dodge","2020-11-27","8","4022","0","337","9.6","11.1"
"Dodge","2020-11-28","6","4028","1","338","7.2","10.5"
"Dodge","2020-11-29","10","4038","2","340","6.5","10.9"
"Dodge","2020-11-30","109","4147","1","341","6.6","10.1"
"Dodge","2020-12-01","21","4168","3","344","7.4","10.1"
"Dodge","2020-12-02","8","4176","1","345","9.2","10.3"
"Dodge","2020-12-03","116","4292","8","353","10.2","10.4"
"Dodge","2020-12-04","20","4312","3","356","12.3","10.9"
"Dodge","2020-12-05","3","4315","1","357","14.7","10.9"
"Dodge","2020-12-06","8","4323","2","359","15.4","10.9"
"Dodge","2020-12-07","9","4332","1","360","16.9","11.7"
"Dodge","2020-12-08","13","4345","3","363","18.1","12.8"
"Dodge","2020-12-09","52","4397","3","366","17.2","13.2"
"Dodge","2020-12-10","74","4471","13","379","18.7","14.4"
"Dodge","2020-12-11","18","4489","2","381","18.1","15.2"
"Dodge","2020-12-12","5","4494","2","383","19.1","16.9"
"Dodge","2020-12-13","7","4501","3","386","21.6","18.5"
"Dodge","2020-12-14","72","4573","3","389","20.6","18.8"
"Dodge","2020-12-15","25","4598","5","394","20.2","19.2"
"Dodge","2020-12-16","87","4685","3","397","19.9","18.5"
"Dodge","2020-12-17","109","4794","10","407","18.7","18.7"
"Dodge","2020-12-18","25","4819","6","413","20.5","19.3"
"Dodge","2020-12-19","9","4828","1","414","16.4","17.7"
"Dodge","2020-12-20","12","4840","4","418","15","18.3"
"Dodge","2020-12-21","20","4860","4","422","17.3","19"
"Dodge","2020-12-22","81","4941","13","435","16.7","18.5"
"Dodge","2020-12-23","43","4984","1","436","16.6","18.2"
"Dodge","2020-12-24","8","4992","2","438","18.8","18.8"
"Dodge","2020-12-25","2","4994","0","438","15.4","18"
"Dodge","2020-12-26","15","5009","7","445","20.5","18.4"
"Dodge","2020-12-27","6","5015","2","447","20.5","17.8"
"Dodge","2020-12-28","26","5041","6","453","20.9","19.1"
"Dodge","2020-12-29","18","5059","4","457","21.8","19.3"
"Dodge","2020-12-30","14","5073","4","461","25.6","21.1"
"Dodge","2020-12-31","158","5231","27","488","24.4","21.6"
"Dodge","2021-01-01","7","5238","1","489","26.5","20.9"
"Dodge","2021-01-02","23","5261","5","494","22.9","21.7"
"Dodge","2021-01-03","2","5263","1","495","25.3","22.9"
"Dodge","2021-01-04","23","5286","4","499","24.5","22.7"
"Dodge","2021-01-05","103","5389","9","508","22.5","22.2"
"Dodge","2021-01-06","50","5439","10","518","21.3","23.4"
"Dodge","2021-01-07","153","5592","17","535","20.5","22.4"
"Dodge","2021-01-08","19","5611","8","543","24.4","25.5"
"Dodge","2021-01-09","23","5634","4","547","23.8","23.4"
"Dodge","2021-01-10","10","5644","3","550","21","23.1"
"Dodge","2021-01-11","38","5682","5","555","20.4","22.4"
"Dodge","2021-01-12","97","5779","5","560","19.8","21.2"
"Dodge","2021-01-13","21","5800","0","560","17","19.2"
"Dodge","2021-01-14","26","5826","5","565","18.1","19.3"
"Dodge","2021-01-15","25","5851","1","566","12.7","18.6"
"Dodge","2021-01-16","10","5861","4","570","15.9","19.9"
"Dodge","2021-01-17","4","5865","1","571","15.2","18.1"
"Dodge","2021-01-18","13","5878","2","573","15.5","17.9"
"Dodge","2021-01-19","126","6004","2","575","15","17.4"
"Dodge","2021-01-20","67","6071","6","581","16.3","16.6"
"Dodge","2021-01-21","114","6185","9","590","14.7","16.4"
"Dodge","2021-01-22","19","6204","1","591","14.9","13.8"
"Dodge","2021-01-23","13","6217","1","592","10.3","13.1"
"Dodge","2021-01-24","5","6222","1","593","9.5","12.4"
"Dodge","2021-01-25","24","6246","3","596","9.1","12.3"
"Dodge","2021-01-26","65","6311","3","599","9.6","12.3"
"Dodge","2021-01-27","68","6379","3","602","8.9","12.6"
"Dodge","2021-01-28","13","6392","3","605","11.1","12.9"
"Dodge","2021-01-29","14","6406","4","609","14.4","14.6"
"Dodge","2021-01-30","19","6425","1","610","14.1","12.2"
"Dodge","2021-01-31","3","6428","1","611","16","12.8"
"Dodge","2021-02-01","23","6451","3","614","16","12.6"
"Dodge","2021-02-02","103","6554","2","616","15.7","12.6"
"Dodge","2021-02-03","48","6602","0","616","15","12"
"Dodge","2021-02-04","67","6669","3","619","12.4","11.7"
"Dodge","2021-02-05","8","6677","1","620","10.1","12.2"
"Dodge","2021-02-06","1","6678","0","620","9.3","11.7"
"Dodge","2021-02-07","0","6678","0","620","4.6","10.3"
"Dodge","2021-02-08","0","6678","0","620","2.7","9.4"
"Dooly","2020-02-01","0","0","0","0",".","."
"Dooly","2020-02-02","0","0","0","0",".","."
"Dooly","2020-02-03","0","0","0","0",".","."
"Dooly","2020-02-04","0","0","0","0",".","."
"Dooly","2020-02-05","0","0","0","0",".","."
"Dooly","2020-02-06","0","0","0","0",".","."
"Dooly","2020-02-07","0","0","0","0","0","."
"Dooly","2020-02-08","0","0","0","0","0","."
"Dooly","2020-02-09","0","0","0","0","0","."
"Dooly","2020-02-10","0","0","0","0","0","."
"Dooly","2020-02-11","0","0","0","0","0","."
"Dooly","2020-02-12","0","0","0","0","0","."
"Dooly","2020-02-13","0","0","0","0","0","."
"Dooly","2020-02-14","0","0","0","0","0","0"
"Dooly","2020-02-15","0","0","0","0","0","0"
"Dooly","2020-02-16","0","0","0","0","0","0"
"Dooly","2020-02-17","0","0","0","0","0","0"
"Dooly","2020-02-18","0","0","0","0","0","0"
"Dooly","2020-02-19","0","0","0","0","0","0"
"Dooly","2020-02-20","0","0","0","0","0","0"
"Dooly","2020-02-21","0","0","0","0","0","0"
"Dooly","2020-02-22","0","0","0","0","0","0"
"Dooly","2020-02-23","0","0","0","0","0","0"
"Dooly","2020-02-24","0","0","0","0","0","0"
"Dooly","2020-02-25","0","0","0","0","0","0"
"Dooly","2020-02-26","0","0","0","0","0","0"
"Dooly","2020-02-27","0","0","0","0","0","0"
"Dooly","2020-02-28","0","0","0","0","0","0"
"Dooly","2020-02-29","0","0","0","0","0","0"
"Dooly","2020-03-01","0","0","0","0","0","0"
"Dooly","2020-03-02","0","0","0","0","0","0"
"Dooly","2020-03-03","0","0","0","0","0","0"
"Dooly","2020-03-04","0","0","0","0","0","0"
"Dooly","2020-03-05","0","0","0","0","0","0"
"Dooly","2020-03-06","0","0","0","0","0","0"
"Dooly","2020-03-07","0","0","0","0","0","0"
"Dooly","2020-03-08","0","0","0","0","0","0"
"Dooly","2020-03-09","0","0","0","0","0","0"
"Dooly","2020-03-10","0","0","0","0","0","0"
"Dooly","2020-03-11","0","0","0","0","0","0"
"Dooly","2020-03-12","0","0","0","0","0","0"
"Dooly","2020-03-13","0","0","0","0","0","0"
"Dooly","2020-03-14","0","0","0","0","0","0"
"Dooly","2020-03-15","0","0","0","0","0","0"
"Dooly","2020-03-16","0","0","0","0","0","0"
"Dooly","2020-03-17","0","0","0","0","0","0"
"Dooly","2020-03-18","0","0","0","0","0","0"
"Dooly","2020-03-19","4","4","0","0","0","0"
"Dooly","2020-03-20","2","6","1","1","7.1","3.6"
"Dooly","2020-03-21","0","6","0","1","7.1","3.6"
"Dooly","2020-03-22","0","6","0","1","7.1","3.6"
"Dooly","2020-03-23","3","9","2","3","16.7","8.3"
"Dooly","2020-03-24","0","9","0","3","16.7","8.3"
"Dooly","2020-03-25","3","12","1","4","21.4","10.7"
"Dooly","2020-03-26","7","19","1","5","23.5","11.7"
"Dooly","2020-03-27","11","30","3","8","20.2","13.7"
"Dooly","2020-03-28","2","32","0","8","20.2","13.7"
"Dooly","2020-03-29","4","36","1","9","23.8","15.5"
"Dooly","2020-03-30","7","43","4","13","22.4","19.6"
"Dooly","2020-03-31","4","47","1","14","26","21.3"
"Dooly","2020-04-01","9","56","3","17","26","23.7"
"Dooly","2020-04-02","21","77","5","22","27.4","25.4"
"Dooly","2020-04-03","6","83","2","24","28.2","24.2"
"Dooly","2020-04-04","4","87","2","26","35.4","27.8"
"Dooly","2020-04-05","0","87","0","26","31.8","27.8"
"Dooly","2020-04-06","12","99","5","31","29.6","26"
"Dooly","2020-04-07","14","113","3","34","29.1","27.5"
"Dooly","2020-04-08","6","119","3","37","31.5","28.7"
"Dooly","2020-04-09","5","124","1","38","30.9","29.1"
"Dooly","2020-04-10","14","138","6","44","32.3","30.3"
"Dooly","2020-04-11","1","139","1","45","39.4","37.4"
"Dooly","2020-04-12","5","144","1","46","42.3","37"
"Dooly","2020-04-13","21","165","13","59","45.2","37.4"
"Dooly","2020-04-14","6","171","0","59","42.1","35.6"
"Dooly","2020-04-15","12","183","2","61","37.3","34.4"
"Dooly","2020-04-16","23","206","3","64","36.4","33.6"
"Dooly","2020-04-17","7","213","0","64","30.2","31.3"
"Dooly","2020-04-18","1","214","1","65","30.2","34.8"
"Dooly","2020-04-19","1","215","0","65","27.4","34.8"
"Dooly","2020-04-20","8","223","2","67","22.1","33.6"
"Dooly","2020-04-21","23","246","8","75","27.1","34.6"
"Dooly","2020-04-22","53","299","27","102","32","34.7"
"Dooly","2020-04-23","5","304","0","102","30.1","33.2"
"Dooly","2020-04-24","5","309","2","104","35.8","33"
"Dooly","2020-04-25","1","310","0","104","21.5","25.9"
"Dooly","2020-04-26","6","316","1","105","23.9","25.6"
"Dooly","2020-04-27","8","324","2","107","23.9","23"
"Dooly","2020-04-28","13","337","6","113","25.5","26.3"
"Dooly","2020-04-29","8","345","1","114","20","26"
"Dooly","2020-04-30","7","352","1","115","22.1","26.1"
"Dooly","2020-05-01","3","355","0","115","16.4","26.1"
"Dooly","2020-05-02","3","358","0","115","16.4","19"
"Dooly","2020-05-03","3","361","0","115","14","19"
"Dooly","2020-05-04","21","382","9","124","16.5","20.2"
"Dooly","2020-05-05","12","394","6","130","17.1","21.3"
"Dooly","2020-05-06","5","399","0","130","15.3","17.7"
"Dooly","2020-05-07","11","410","4","134","18.5","20.3"
"Dooly","2020-05-08","10","420","0","134","18.5","17.4"
"Dooly","2020-05-09","6","426","3","137","25.6","21"
"Dooly","2020-05-10","3","429","1","138","30.4","22.2"
"Dooly","2020-05-11","55","484","7","145","26.1","21.3"
"Dooly","2020-05-12","6","490","1","146","21.3","19.2"
"Dooly","2020-05-13","15","505","4","150","25.1","20.2"
"Dooly","2020-05-14","13","518","1","151","21","19.7"
"Dooly","2020-05-15","12","530","3","154","24.6","21.5"
"Dooly","2020-05-16","3","533","1","155","22.2","23.9"
"Dooly","2020-05-17","5","538","0","155","17.4","23.9"
"Dooly","2020-05-18","15","553","2","157","17.5","21.8"
"Dooly","2020-05-19","80","633","7","164","16.4","18.8"
"Dooly","2020-05-20","11","644","0","164","12.6","18.8"
"Dooly","2020-05-21","9","653","0","164","11.5","16.3"
"Dooly","2020-05-22","6","659","0","164","7.9","16.3"
"Dooly","2020-05-23","3","662","1","165","7.9","15.1"
"Dooly","2020-05-24","3","665","0","165","7.9","12.7"
"Dooly","2020-05-25","4","669","1","166","9.6","13.6"
"Dooly","2020-05-26","14","683","4","170","12.4","14.4"
"Dooly","2020-05-27","40","723","8","178","15.3","13.9"
"Dooly","2020-05-28","32","755","1","179","15.7","13.6"
"Dooly","2020-05-29","34","789","2","181","16.6","12.2"
"Dooly","2020-05-30","2","791","0","181","11.8","9.9"
"Dooly","2020-05-31","4","795","0","181","11.8","9.9"
"Dooly","2020-06-01","19","814","2","183","9.7","9.7"
"Dooly","2020-06-02","21","835","3","186","7.7","10.1"
"Dooly","2020-06-03","22","857","4","190","7.4","11.4"
"Dooly","2020-06-04","27","884","0","190","7","11.4"
"Dooly","2020-06-05","17","901","3","193","8.7","12.6"
"Dooly","2020-06-06","3","904","0","193","8.7","10.2"
"Dooly","2020-06-07","2","906","2","195","22.9","17.4"
"Dooly","2020-06-08","12","918","1","196","22.6","16.2"
"Dooly","2020-06-09","8","926","0","196","20.6","14.1"
"Dooly","2020-06-10","1","927","1","197","32.3","19.9"
"Dooly","2020-06-11","6","933","0","197","32.3","19.6"
"Dooly","2020-06-12","10","943","1","198","31.2","19.9"
"Dooly","2020-06-13","2","945","0","198","31.2","19.9"
"Dooly","2020-06-14","1","946","0","198","16.9","19.9"
"Dooly","2020-06-15","9","955","0","198","15.7","19.2"
"Dooly","2020-06-16","15","970","0","198","15.7","18.2"
"Dooly","2020-06-17","9","979","1","199","3","17.6"
"Dooly","2020-06-18","13","992","1","200","4.1","18.2"
"Dooly","2020-06-19","11","1003","2","202","5.3","18.2"
"Dooly","2020-06-20","3","1006","0","202","5.3","18.2"
"Dooly","2020-06-21","1","1007","0","202","5.3","11.1"
"Dooly","2020-06-22","18","1025","1","203","6.1","10.9"
"Dooly","2020-06-23","14","1039","1","204","7.1","11.4"
"Dooly","2020-06-24","17","1056","2","206","7.2","5.1"
"Dooly","2020-06-25","29","1085","3","209","7.6","5.8"
"Dooly","2020-06-26","40","1125","12","221","9.3","7.3"
"Dooly","2020-06-27","7","1132","2","223","13.3","9.3"
"Dooly","2020-06-28","4","1136","0","223","13.3","9.3"
"Dooly","2020-06-29","15","1151","4","227","16.4","11.2"
"Dooly","2020-06-30","9","1160","0","227","15.3","11.2"
"Dooly","2020-07-01","10","1170","0","227","13.7","10.4"
"Dooly","2020-07-02","4","1174","2","229","19.3","13.4"
"Dooly","2020-07-03","11","1185","0","229","15","12.1"
"Dooly","2020-07-04","1","1186","0","229","11","12.1"
"Dooly","2020-07-05","4","1190","0","229","11","12.1"
"Dooly","2020-07-06","18","1208","3","232","9.5","12.9"
"Dooly","2020-07-07","17","1225","2","234","11.2","13.3"
"Dooly","2020-07-08","9","1234","0","234","11.2","12.4"
"Dooly","2020-07-09","4","1238","0","234","4.1","11.7"
"Dooly","2020-07-10","15","1253","1","235","5","10"
"Dooly","2020-07-11","4","1257","1","236","8.6","9.8"
"Dooly","2020-07-12","2","1259","1","237","15.7","13.3"
"Dooly","2020-07-13","31","1290","4","241","15.2","12.4"
"Dooly","2020-07-14","9","1299","0","241","13.5","12.4"
"Dooly","2020-07-15","20","1319","3","244","15.7","13.4"
"Dooly","2020-07-16","18","1337","2","246","17.2","10.7"
"Dooly","2020-07-17","13","1350","2","248","18.5","11.7"
"Dooly","2020-07-18","0","1350","0","248","14.9","11.7"
"Dooly","2020-07-19","3","1353","0","248","7.8","11.7"
"Dooly","2020-07-20","28","1381","1","249","6.4","10.8"
"Dooly","2020-07-21","16","1397","0","249","6.4","10"
"Dooly","2020-07-22","21","1418","1","250","5","10.3"
"Dooly","2020-07-23","13","1431","0","250","3.4","10.3"
"Dooly","2020-07-24","19","1450","1","251","1.9","10.2"
"Dooly","2020-07-25","5","1455","3","254","10.5","12.7"
"Dooly","2020-07-26","1","1456","1","255","24.8","16.3"
"Dooly","2020-07-27","15","1471","6","261","30","18.2"
"Dooly","2020-07-28","23","1494","2","263","31.2","18.8"
"Dooly","2020-07-29","15","1509","0","263","30.6","17.8"
"Dooly","2020-07-30","19","1528","3","266","32.8","18.1"
"Dooly","2020-07-31","23","1551","2","268","33.3","17.6"
"Dooly","2020-08-01","4","1555","1","269","28.3","19.4"
"Dooly","2020-08-02","0","1555","0","269","14","19.4"
"Dooly","2020-08-03","33","1588","0","269","8.3","19.2"
"Dooly","2020-08-04","8","1596","2","271","10.6","20.9"
"Dooly","2020-08-05","23","1619","5","276","13.7","22.2"
"Dooly","2020-08-06","7","1626","0","276","11.5","22.2"
"Dooly","2020-08-07","18","1644","0","276","10.2","21.8"
"Dooly","2020-08-08","4","1648","0","276","6.7","17.5"
"Dooly","2020-08-09","2","1650","0","276","6.7","10.4"
"Dooly","2020-08-10","27","1677","2","278","7.7","8"
"Dooly","2020-08-11","12","1689","2","280","6.5","8.6"
"Dooly","2020-08-12","12","1701","1","281","4.6","9.2"
"Dooly","2020-08-13","12","1713","2","283","7","9.3"
"Dooly","2020-08-14","10","1723","2","285","9.9","10.1"
"Dooly","2020-08-15","5","1728","1","286","12.7","9.7"
"Dooly","2020-08-16","3","1731","0","286","12.7","9.7"
"Dooly","2020-08-17","8","1739","1","287","13.5","10.6"
"Dooly","2020-08-18","9","1748","0","287","11.1","8.8"
"Dooly","2020-08-19","37","1785","7","294","12.6","8.6"
"Dooly","2020-08-20","8","1793","1","295","12","9.5"
"Dooly","2020-08-21","19","1812","3","298","11.4","10.6"
"Dooly","2020-08-22","2","1814","0","298","8.5","10.6"
"Dooly","2020-08-23","0","1814","0","298","8.5","10.6"
"Dooly","2020-08-24","41","1855","4","302","8.1","10.8"
"Dooly","2020-08-25","8","1863","0","302","8.1","9.6"
"Dooly","2020-08-26","20","1883","1","303","6.1","9.4"
"Dooly","2020-08-27","18","1901","0","303","4.4","8.2"
"Dooly","2020-08-28","26","1927","5","308","4.9","8.1"
"Dooly","2020-08-29","9","1936","1","309","6.4","7.5"
"Dooly","2020-08-30","1","1937","0","309","6.4","7.5"
"Dooly","2020-08-31","17","1954","2","311","6.7","7.4"
"Dooly","2020-09-01","13","1967","1","312","7.8","8"
"Dooly","2020-09-02","15","1982","2","314","9","7.6"
"Dooly","2020-09-03","24","2006","2","316","10.2","7.3"
"Dooly","2020-09-04","31","2037","1","317","7.9","6.4"
"Dooly","2020-09-05","3","2040","0","317","6.3","6.4"
"Dooly","2020-09-06","4","2044","1","318","9.9","8.2"
"Dooly","2020-09-07","0","2044","0","318","8.2","7.5"
"Dooly","2020-09-08","29","2073","5","323","9.6","8.7"
"Dooly","2020-09-09","19","2092","2","325","9.2","9.1"
"Dooly","2020-09-10","15","2107","2","327","9.9","10.1"
"Dooly","2020-09-11","18","2125","2","329","11","9.5"
"Dooly","2020-09-12","4","2129","0","329","11","8.7"
"Dooly","2020-09-13","0","2129","0","329","7.5","8.7"
"Dooly","2020-09-14","28","2157","7","336","11","9.6"
"Dooly","2020-09-15","28","2185","5","341","11.1","10.4"
"Dooly","2020-09-16","14","2199","2","343","11.7","10.4"
"Dooly","2020-09-17","20","2219","0","343","9.8","9.8"
"Dooly","2020-09-18","17","2236","1","344","9","10"
"Dooly","2020-09-19","0","2236","0","344","9","10"
"Dooly","2020-09-20","4","2240","1","345","12.6","10"
"Dooly","2020-09-21","24","2264","4","349","11.4","11.2"
"Dooly","2020-09-22","12","2276","2","351","11.2","11.2"
"Dooly","2020-09-23","13","2289","2","353","11.4","11.5"
"Dooly","2020-09-24","11","2300","1","354","12.7","11.2"
"Dooly","2020-09-25","44","2344","0","354","11.8","10.4"
"Dooly","2020-09-26","3","2347","0","354","11.8","10.4"
"Dooly","2020-09-27","1","2348","0","354","8.3","10.4"
"Dooly","2020-09-28","28","2376","5","359","8.4","9.9"
"Dooly","2020-09-29","21","2397","2","361","7.4","9.3"
"Dooly","2020-09-30","17","2414","3","364","7.7","9.6"
"Dooly","2020-10-01","12","2426","1","365","7.6","10.1"
"Dooly","2020-10-02","17","2443","1","366","8.5","10.1"
"Dooly","2020-10-03","2","2445","1","367","15.6","13.7"
"Dooly","2020-10-04","0","2445","0","367","15.6","11.9"
"Dooly","2020-10-05","23","2468","2","369","14.3","11.4"
"Dooly","2020-10-06","21","2489","0","369","12.9","10.2"
"Dooly","2020-10-07","23","2512","1","370","11","9.4"
"Dooly","2020-10-08","14","2526","0","370","9.8","8.7"
"Dooly","2020-10-09","19","2545","1","371","9.8","9.1"
"Dooly","2020-10-10","3","2548","0","371","2.6","9.1"
"Dooly","2020-10-11","2","2550","0","371","2.6","9.1"
"Dooly","2020-10-12","7","2557","0","371","1.4","7.8"
"Dooly","2020-10-13","20","2577","3","374","3.5","8.2"
"Dooly","2020-10-14","17","2594","1","375","3.7","7.4"
"Dooly","2020-10-15","15","2609","1","376","4.7","7.3"
"Dooly","2020-10-16","14","2623","1","377","5","7.4"
"Dooly","2020-10-17","0","2623","0","377","5","3.8"
"Dooly","2020-10-18","2","2625","0","377","5","3.8"
"Dooly","2020-10-19","12","2637","4","381","9.7","5.5"
"Dooly","2020-10-20","7","2644","1","382","9.6","6.6"
"Dooly","2020-10-21","12","2656","3","385","12.3","8"
"Dooly","2020-10-22","12","2668","0","385","11.4","8"
"Dooly","2020-10-23","10","2678","0","385","10.4","7.7"
"Dooly","2020-10-24","2","2680","0","385","10.4","7.7"
"Dooly","2020-10-25","0","2680","0","385","10.4","7.7"
"Dooly","2020-10-26","25","2705","0","385","5.6","7.7"
"Dooly","2020-10-27","12","2717","1","386","4.8","7.2"
"Dooly","2020-10-28","15","2732","3","389","4","8.2"
"Dooly","2020-10-29","20","2752","1","390","4.8","8.1"
"Dooly","2020-10-30","14","2766","1","391","5.8","8.1"
"Dooly","2020-10-31","3","2769","0","391","5.8","8.1"
"Dooly","2020-11-01","3","2772","2","393","15.3","12.8"
"Dooly","2020-11-02","15","2787","1","394","16.3","10.9"
"Dooly","2020-11-03","23","2810","2","396","16.3","10.5"
"Dooly","2020-11-04","9","2819","2","398","16.6","10.3"
"Dooly","2020-11-05","16","2835","1","399","16.8","10.8"
"Dooly","2020-11-06","19","2854","2","401","17.3","11.5"
"Dooly","2020-11-07","1","2855","0","401","17.3","11.5"
"Dooly","2020-11-08","2","2857","0","401","7.8","11.5"
"Dooly","2020-11-09","19","2876","2","403","8.3","12.3"
"Dooly","2020-11-10","26","2902","4","407","9.3","12.8"
"Dooly","2020-11-11","7","2909","0","407","6.1","11.4"
"Dooly","2020-11-12","20","2929","2","409","6.6","11.7"
"Dooly","2020-11-13","7","2936","0","409","5.1","11.2"
"Dooly","2020-11-14","7","2943","0","409","5.1","11.2"
"Dooly","2020-11-15","1","2944","0","409","5.1","6.4"
"Dooly","2020-11-16","18","2962","2","411","5.2","6.8"
"Dooly","2020-11-17","37","2999","7","418","5.7","7.5"
"Dooly","2020-11-18","28","3027","2","420","6.7","6.4"
"Dooly","2020-11-19","4","3031","0","420","5.3","6"
"Dooly","2020-11-20","4","3035","0","420","5.3","5.2"
"Dooly","2020-11-21","3","3038","1","421","10.1","7.6"
"Dooly","2020-11-22","2","3040","0","421","10.1","7.6"
"Dooly","2020-11-23","32","3072","4","425","10.3","7.7"
"Dooly","2020-11-24","16","3088","0","425","7.6","6.6"
"Dooly","2020-11-25","29","3117","1","426","7","6.9"
"Dooly","2020-11-26","0","3117","0","426","7","6.2"
"Dooly","2020-11-27","5","3122","1","427","9.9","7.6"
"Dooly","2020-11-28","4","3126","0","427","5.1","7.6"
"Dooly","2020-11-29","2","3128","0","427","5.1","7.6"
"Dooly","2020-11-30","7","3135","0","427","3.3","6.8"
"Dooly","2020-12-01","21","3156","3","430","5.4","6.5"
"Dooly","2020-12-02","25","3181","7","437","8.9","8"
"Dooly","2020-12-03","25","3206","9","446","14","10.5"
"Dooly","2020-12-04","7","3213","2","448","15.3","12.6"
"Dooly","2020-12-05","4","3217","2","450","22.4","13.8"
"Dooly","2020-12-06","6","3223","0","450","22.4","13.8"
"Dooly","2020-12-07","26","3249","7","457","26.3","14.8"
"Dooly","2020-12-08","34","3283","2","459","25.1","15.2"
"Dooly","2020-12-09","37","3320","4","463","22.6","15.7"
"Dooly","2020-12-10","42","3362","6","469","19.5","16.8"
"Dooly","2020-12-11","118","3480","1","470","15.5","15.4"
"Dooly","2020-12-12","1","3481","0","470","8.4","15.4"
"Dooly","2020-12-13","1","3482","0","470","8.4","15.4"
"Dooly","2020-12-14","41","3523","13","483","9.1","17.7"
"Dooly","2020-12-15","36","3559","4","487","9.8","17.4"
"Dooly","2020-12-16","4","3563","1","488","11.9","17.2"
"Dooly","2020-12-17","164","3727","7","495","10.4","15"
"Dooly","2020-12-18","10","3737","1","496","11.7","13.6"
"Dooly","2020-12-19","6","3743","2","498","16.5","12.4"
"Dooly","2020-12-20","3","3746","1","499","21.3","14.8"
"Dooly","2020-12-21","31","3777","4","503","18.6","13.8"
"Dooly","2020-12-22","41","3818","8","511","19.8","14.8"
"Dooly","2020-12-23","5","3823","1","512","19.1","15.5"
"Dooly","2020-12-24","3","3826","2","514","28","19.2"
"Dooly","2020-12-25","1","3827","0","514","26.5","19.1"
"Dooly","2020-12-26","2","3829","1","515","28.9","22.7"
"Dooly","2020-12-27","1","3830","1","516","38.4","29.8"
"Dooly","2020-12-28","40","3870","5","521","38.4","28.5"
"Dooly","2020-12-29","32","3902","6","527","38.3","29"
"Dooly","2020-12-30","67","3969","16","543","38.8","28.9"
"Dooly","2020-12-31","12","3981","0","543","29.3","28.6"
"Dooly","2021-01-01","3","3984","2","545","38.8","32.7"
"Dooly","2021-01-02","5","3989","3","548","40.3","34.6"
"Dooly","2021-01-03","5","3994","2","550","31.7","35.1"
"Dooly","2021-01-04","85","4079","17","567","32.8","35.6"
"Dooly","2021-01-05","50","4129","9","576","32.6","35.5"
"Dooly","2021-01-06","33","4162","5","581","31.4","35.1"
"Dooly","2021-01-07","20","4182","5","586","35","32.1"
"Dooly","2021-01-08","13","4195","3","589","28.7","33.8"
"Dooly","2021-01-09","9","4204","4","593","26.5","33.4"
"Dooly","2021-01-10","5","4209","1","594","23.7","27.7"
"Dooly","2021-01-11","46","4255","8","602","23.3","28"
"Dooly","2021-01-12","34","4289","7","609","23.7","28.2"
"Dooly","2021-01-13","38","4327","6","615","23.8","27.6"
"Dooly","2021-01-14","15","4342","2","617","22.1","28.5"
"Dooly","2021-01-15","16","4358","1","618","19.7","24.2"
"Dooly","2021-01-16","7","4365","0","618","13.3","19.9"
"Dooly","2021-01-17","5","4370","2","620","16.2","19.9"
"Dooly","2021-01-18","11","4381","1","621","15","19.2"
"Dooly","2021-01-19","36","4417","9","630","15.6","19.7"
"Dooly","2021-01-20","20","4437","3","633","15.5","19.6"
"Dooly","2021-01-21","14","4451","6","639","19.7","20.9"
"Dooly","2021-01-22","13","4464","3","642","22.1","20.9"
"Dooly","2021-01-23","4","4468","3","645","32.9","23.1"
"Dooly","2021-01-24","3","4471","2","647","36.7","26.4"
"Dooly","2021-01-25","10","4481","1","648","36.8","25.9"
"Dooly","2021-01-26","17","4498","2","650","34.9","25.3"
"Dooly","2021-01-27","8","4506","0","650","32.8","24.1"
"Dooly","2021-01-28","26","4532","4","654","28.8","24.3"
"Dooly","2021-01-29","7","4539","0","654","25.5","23.8"
"Dooly","2021-01-30","3","4542","0","654","14.8","23.8"
"Dooly","2021-01-31","2","4544","1","655","12.4","24.6"
"Dooly","2021-02-01","111","4655","10","665","12.3","24.6"
"Dooly","2021-02-02","4","4659","0","665","10.6","22.8"
"Dooly","2021-02-03","5","4664","0","665","10.6","21.7"
"Dooly","2021-02-04","16","4680","1","666","9.3","19.1"
"Dooly","2021-02-05","9","4689","0","666","9.3","17.4"
"Dooly","2021-02-06","0","4689","0","666","9.3","12.1"
"Dooly","2021-02-07","0","4689","0","666","2.2","7.3"
"Dooly","2021-02-08","0","4689","0","666","0.9","6.6"
"Dougherty","2020-02-01","0","0","0","0",".","."
"Dougherty","2020-02-02","0","0","0","0",".","."
"Dougherty","2020-02-03","0","0","0","0",".","."
"Dougherty","2020-02-04","0","0","0","0",".","."
"Dougherty","2020-02-05","0","0","0","0",".","."
"Dougherty","2020-02-06","0","0","0","0",".","."
"Dougherty","2020-02-07","0","0","0","0","0","."
"Dougherty","2020-02-08","0","0","0","0","0","."
"Dougherty","2020-02-09","0","0","0","0","0","."
"Dougherty","2020-02-10","0","0","0","0","0","."
"Dougherty","2020-02-11","0","0","0","0","0","."
"Dougherty","2020-02-12","0","0","0","0","0","."
"Dougherty","2020-02-13","0","0","0","0","0","."
"Dougherty","2020-02-14","0","0","0","0","0","0"
"Dougherty","2020-02-15","0","0","0","0","0","0"
"Dougherty","2020-02-16","0","0","0","0","0","0"
"Dougherty","2020-02-17","0","0","0","0","0","0"
"Dougherty","2020-02-18","0","0","0","0","0","0"
"Dougherty","2020-02-19","0","0","0","0","0","0"
"Dougherty","2020-02-20","0","0","0","0","0","0"
"Dougherty","2020-02-21","0","0","0","0","0","0"
"Dougherty","2020-02-22","0","0","0","0","0","0"
"Dougherty","2020-02-23","0","0","0","0","0","0"
"Dougherty","2020-02-24","0","0","0","0","0","0"
"Dougherty","2020-02-25","0","0","0","0","0","0"
"Dougherty","2020-02-26","0","0","0","0","0","0"
"Dougherty","2020-02-27","0","0","0","0","0","0"
"Dougherty","2020-02-28","0","0","0","0","0","0"
"Dougherty","2020-02-29","0","0","0","0","0","0"
"Dougherty","2020-03-01","0","0","0","0","0","0"
"Dougherty","2020-03-02","0","0","0","0","0","0"
"Dougherty","2020-03-03","0","0","0","0","0","0"
"Dougherty","2020-03-04","0","0","0","0","0","0"
"Dougherty","2020-03-05","0","0","0","0","0","0"
"Dougherty","2020-03-06","0","0","0","0","0","0"
"Dougherty","2020-03-07","0","0","0","0","0","0"
"Dougherty","2020-03-08","1","1","1","1","14.3","7.1"
"Dougherty","2020-03-09","1","2","0","1","14.3","7.1"
"Dougherty","2020-03-10","0","2","0","1","14.3","7.1"
"Dougherty","2020-03-11","28","30","11","12","19.9","9.9"
"Dougherty","2020-03-12","30","60","11","23","25.1","12.6"
"Dougherty","2020-03-13","20","80","14","37","35.1","17.6"
"Dougherty","2020-03-14","18","98","13","50","45.5","22.7"
"Dougherty","2020-03-15","26","124","11","61","37.2","25.7"
"Dougherty","2020-03-16","78","202","32","93","43.1","28.7"
"Dougherty","2020-03-17","98","300","51","144","50.5","32.4"
"Dougherty","2020-03-18","77","377","33","177","51","35.5"
"Dougherty","2020-03-19","73","450","45","222","54.6","39.9"
"Dougherty","2020-03-20","88","538","38","260","50.8","42.9"
"Dougherty","2020-03-21","67","605","45","305","50","47.7"
"Dougherty","2020-03-22","49","654","30","335","52.7","45"
"Dougherty","2020-03-23","262","916","93","428","51.9","47.5"
"Dougherty","2020-03-24","245","1161","80","508","49.2","49.8"
"Dougherty","2020-03-25","191","1352","71","579","48.4","49.7"
"Dougherty","2020-03-26","143","1495","70","649","46.5","50.6"
"Dougherty","2020-03-27","189","1684","60","709","44.9","47.8"
"Dougherty","2020-03-28","101","1785","40","749","41","45.5"
"Dougherty","2020-03-29","61","1846","36","785","40.7","46.7"
"Dougherty","2020-03-30","208","2054","101","886","42.5","47.2"
"Dougherty","2020-03-31","104","2158","47","933","44.3","46.7"
"Dougherty","2020-04-01","196","2354","51","984","42.7","45.5"
"Dougherty","2020-04-02","188","2542","54","1038","39.8","43.2"
"Dougherty","2020-04-03","141","2683","42","1080","39.6","42.2"
"Dougherty","2020-04-04","59","2742","16","1096","37.8","39.4"
"Dougherty","2020-04-05","59","2801","23","1119","34.9","37.8"
"Dougherty","2020-04-06","289","3090","82","1201","32","37.3"
"Dougherty","2020-04-07","158","3248","34","1235","28.6","36.5"
"Dougherty","2020-04-08","222","3470","49","1284","28.1","35.4"
"Dougherty","2020-04-09","197","3667","46","1330","27.3","33.6"
"Dougherty","2020-04-10","275","3942","71","1401","26.7","33.2"
"Dougherty","2020-04-11","95","4037","12","1413","24.7","31.2"
"Dougherty","2020-04-12","28","4065","6","1419","22.2","28.5"
"Dougherty","2020-04-13","177","4242","35","1454","20.9","26.5"
"Dougherty","2020-04-14","199","4441","39","1493","20.7","24.7"
"Dougherty","2020-04-15","240","4681","46","1539","20.3","24.2"
"Dougherty","2020-04-16","301","4982","36","1575","18.6","23"
"Dougherty","2020-04-17","328","5310","38","1613","16.6","21.7"
"Dougherty","2020-04-18","176","5486","24","1637","16.7","20.7"
"Dougherty","2020-04-19","56","5542","3","1640","14.4","18.3"
"Dougherty","2020-04-20","393","5935","39","1679","13","17"
"Dougherty","2020-04-21","305","6240","37","1716","12","16.3"
"Dougherty","2020-04-22","260","6500","10","1726","9.8","15"
"Dougherty","2020-04-23","94","6594","18","1744","10.8","14.7"
"Dougherty","2020-04-24","302","6896","25","1769","10.3","13.5"
"Dougherty","2020-04-25","138","7034","6","1775","9","12.9"
"Dougherty","2020-04-26","61","7095","7","1782","9.9","12.2"
"Dougherty","2020-04-27","279","7374","22","1804","9.6","11.3"
"Dougherty","2020-04-28","342","7716","24","1828","8.9","10.4"
"Dougherty","2020-04-29","450","8166","26","1854","9.1","9.5"
"Dougherty","2020-04-30","283","8449","28","1882","7.8","9.3"
"Dougherty","2020-05-01","388","8837","25","1907","7.5","8.9"
"Dougherty","2020-05-02","263","9100","7","1914","7.3","8.2"
"Dougherty","2020-05-03","145","9245","9","1923","6.6","8.2"
"Dougherty","2020-05-04","258","9503","17","1940","6.4","8"
"Dougherty","2020-05-05","360","9863","21","1961","6.2","7.5"
"Dougherty","2020-05-06","333","10196","21","1982","6.3","7.7"
"Dougherty","2020-05-07","216","10412","18","2000","6.1","6.9"
"Dougherty","2020-05-08","222","10634","12","2012","5.9","6.7"
"Dougherty","2020-05-09","123","10757","5","2017","6.1","6.7"
"Dougherty","2020-05-10","23","10780","18","2035","16.4","11.5"
"Dougherty","2020-05-11","195","10975","10","2045","16.2","11.3"
"Dougherty","2020-05-12","216","11191","8","2053","15.9","11"
"Dougherty","2020-05-13","301","11492","11","2064","15.5","10.9"
"Dougherty","2020-05-14","389","11881","8","2072","14.6","10.3"
"Dougherty","2020-05-15","482","12363","32","2104","14.8","10.3"
"Dougherty","2020-05-16","167","12530","10","2114","15.1","10.6"
"Dougherty","2020-05-17","71","12601","2","2116","4.3","10.3"
"Dougherty","2020-05-18","204","12805","25","2141","5.3","10.7"
"Dougherty","2020-05-19","330","13135","26","2167","5.9","10.9"
"Dougherty","2020-05-20","259","13394","9","2176","5.9","10.7"
"Dougherty","2020-05-21","382","13776","11","2187","6","10.3"
"Dougherty","2020-05-22","340","14116","13","2200","5.6","10.2"
"Dougherty","2020-05-23","155","14271","6","2206","5.3","10.2"
"Dougherty","2020-05-24","57","14328","3","2209","5.6","5"
"Dougherty","2020-05-25","62","14390","5","2214","5","5.2"
"Dougherty","2020-05-26","252","14642","10","2224","4.5","5.2"
"Dougherty","2020-05-27","237","14879","6","2230","4.3","5.1"
"Dougherty","2020-05-28","187","15066","2","2232","4.1","5"
"Dougherty","2020-05-29","297","15363","10","2242","4","4.8"
"Dougherty","2020-05-30","110","15473","7","2249","4.4","4.8"
"Dougherty","2020-05-31","63","15536","3","2252","4.3","5"
"Dougherty","2020-06-01","285","15821","11","2263","3.7","4.4"
"Dougherty","2020-06-02","267","16088","8","2271","3.6","4"
"Dougherty","2020-06-03","279","16367","5","2276","3.5","3.9"
"Dougherty","2020-06-04","144","16511","3","2279","3.6","3.8"
"Dougherty","2020-06-05","338","16849","8","2287","3.5","3.7"
"Dougherty","2020-06-06","166","17015","14","2301","3.8","4.1"
"Dougherty","2020-06-07","45","17060","1","2302","3.4","3.8"
"Dougherty","2020-06-08","217","17277","5","2307","3.2","3.4"
"Dougherty","2020-06-09","198","17475","2","2309","2.9","3.2"
"Dougherty","2020-06-10","132","17607","5","2314","3.2","3.3"
"Dougherty","2020-06-11","221","17828","7","2321","3.3","3.5"
"Dougherty","2020-06-12","190","18018","9","2330","3.7","3.6"
"Dougherty","2020-06-13","102","18120","7","2337","3.4","3.6"
"Dougherty","2020-06-14","36","18156","1","2338","3.5","3.5"
"Dougherty","2020-06-15","173","18329","10","2348","4","3.6"
"Dougherty","2020-06-16","169","18498","7","2355","4.5","3.7"
"Dougherty","2020-06-17","101","18599","2","2357","4.2","3.7"
"Dougherty","2020-06-18","304","18903","10","2367","4.2","3.8"
"Dougherty","2020-06-19","212","19115","7","2374","4","3.8"
"Dougherty","2020-06-20","43","19158","1","2375","3.4","3.4"
"Dougherty","2020-06-21","112","19270","4","2379","3.5","3.5"
"Dougherty","2020-06-22","276","19546","13","2392","3.3","3.7"
"Dougherty","2020-06-23","174","19720","11","2403","3.6","4.1"
"Dougherty","2020-06-24","304","20024","23","2426","4.4","4.3"
"Dougherty","2020-06-25","102","20126","11","2437","5.5","4.9"
"Dougherty","2020-06-26","257","20383","24","2461","6.4","5.2"
"Dougherty","2020-06-27","177","20560","11","2472","6.9","5.2"
"Dougherty","2020-06-28","63","20623","3","2475","7.1","5.3"
"Dougherty","2020-06-29","161","20784","9","2484","7.2","5.3"
"Dougherty","2020-06-30","329","21113","35","2519","7.8","5.7"
"Dougherty","2020-07-01","322","21435","33","2552","8.2","6.3"
"Dougherty","2020-07-02","311","21746","27","2579","7.9","6.7"
"Dougherty","2020-07-03","52","21798","8","2587","8.8","7.6"
"Dougherty","2020-07-04","138","21936","12","2599","9.1","8"
"Dougherty","2020-07-05","58","21994","5","2604","9.7","8.4"
"Dougherty","2020-07-06","321","22315","51","2655","11.2","9.2"
"Dougherty","2020-07-07","345","22660","47","2702","11.6","9.7"
"Dougherty","2020-07-08","344","23004","31","2733","11.4","9.8"
"Dougherty","2020-07-09","164","23168","16","2749","11.6","9.7"
"Dougherty","2020-07-10","392","23560","31","2780","10.5","9.6"
"Dougherty","2020-07-11","95","23655","11","2791","10.9","10"
"Dougherty","2020-07-12","63","23718","7","2798","11.3","10.5"
"Dougherty","2020-07-13","393","24111","38","2836","10.4","10.8"
"Dougherty","2020-07-14","181","24292","15","2851","9.6","10.6"
"Dougherty","2020-07-15","379","24671","19","2870","9","10.2"
"Dougherty","2020-07-16","404","25075","48","2918","9.3","10.5"
"Dougherty","2020-07-17","398","25473","36","2954","9.5","10"
"Dougherty","2020-07-18","60","25533","6","2960","9.3","10.1"
"Dougherty","2020-07-19","63","25596","14","2974","10.9","11.1"
"Dougherty","2020-07-20","434","26030","30","3004","10.5","10.4"
"Dougherty","2020-07-21","158","26188","16","3020","10.7","10.2"
"Dougherty","2020-07-22","441","26629","32","3052","11.1","10.1"
"Dougherty","2020-07-23","389","27018","24","3076","10.2","9.8"
"Dougherty","2020-07-24","341","27359","20","3096","9.8","9.7"
"Dougherty","2020-07-25","39","27398","9","3105","11.7","10.5"
"Dougherty","2020-07-26","43","27441","6","3111","10.5","10.7"
"Dougherty","2020-07-27","412","27853","30","3141","10.5","10.5"
"Dougherty","2020-07-28","161","28014","13","3154","10.2","10.5"
"Dougherty","2020-07-29","387","28401","27","3181","10.2","10.6"
"Dougherty","2020-07-30","169","28570","21","3202","11.1","10.7"
"Dougherty","2020-07-31","324","28894","16","3218","11","10.4"
"Dougherty","2020-08-01","69","28963","7","3225","9.1","10.4"
"Dougherty","2020-08-02","55","29018","7","3232","8.9","9.7"
"Dougherty","2020-08-03","396","29414","30","3262","9","9.8"
"Dougherty","2020-08-04","197","29611","22","3284","9.4","9.8"
"Dougherty","2020-08-05","420","30031","21","3305","9.1","9.7"
"Dougherty","2020-08-06","273","30304","42","3347","9.6","10.3"
"Dougherty","2020-08-07","431","30735","24","3371","9.7","10.3"
"Dougherty","2020-08-08","162","30897","13","3384","9.3","9.2"
"Dougherty","2020-08-09","37","30934","4","3388","9.1","9"
"Dougherty","2020-08-10","313","31247","29","3417","9.3","9.1"
"Dougherty","2020-08-11","178","31425","14","3431","8.8","9.1"
"Dougherty","2020-08-12","288","31713","17","3448","9","9.1"
"Dougherty","2020-08-13","142","31855","8","3456","7.6","8.6"
"Dougherty","2020-08-14","359","32214","56","3512","9","9.3"
"Dougherty","2020-08-15","69","32283","7","3519","9.3","9.3"
"Dougherty","2020-08-16","97","32380","11","3530","9.4","9.2"
"Dougherty","2020-08-17","255","32635","17","3547","9","9.2"
"Dougherty","2020-08-18","142","32777","18","3565","9.7","9.3"
"Dougherty","2020-08-19","361","33138","23","3588","9.8","9.4"
"Dougherty","2020-08-20","151","33289","9","3597","9.8","8.7"
"Dougherty","2020-08-21","342","33631","20","3617","8.4","8.7"
"Dougherty","2020-08-22","114","33745","6","3623","7.7","8.5"
"Dougherty","2020-08-23","73","33818","7","3630","7.5","8.4"
"Dougherty","2020-08-24","260","34078","21","3651","7.7","8.4"
"Dougherty","2020-08-25","104","34182","4","3655","6.4","8.1"
"Dougherty","2020-08-26","355","34537","15","3670","6.1","7.9"
"Dougherty","2020-08-27","170","34707","7","3677","5.9","7.8"
"Dougherty","2020-08-28","265","34972","19","3696","6","7.2"
"Dougherty","2020-08-29","67","35039","3","3699","5.9","6.8"
"Dougherty","2020-08-30","98","35137","6","3705","5.4","6.5"
"Dougherty","2020-08-31","177","35314","17","3722","5.7","6.7"
"Dougherty","2020-09-01","232","35546","12","3734","5.8","6.1"
"Dougherty","2020-09-02","250","35796","12","3746","5.9","6"
"Dougherty","2020-09-03","106","35902","3","3749","5.7","5.8"
"Dougherty","2020-09-04","297","36199","17","3766","5.5","5.8"
"Dougherty","2020-09-05","181","36380","7","3773","5.4","5.7"
"Dougherty","2020-09-06","42","36422","5","3778","6.3","5.9"
"Dougherty","2020-09-07","134","36556","5","3783","5.4","5.5"
"Dougherty","2020-09-08","293","36849","17","3800","5.5","5.7"
"Dougherty","2020-09-09","253","37102","6","3806","5.2","5.5"
"Dougherty","2020-09-10","220","37322","9","3815","5.4","5.5"
"Dougherty","2020-09-11","226","37548","14","3829","5.4","5.5"
"Dougherty","2020-09-12","109","37657","6","3835","5.7","5.6"
"Dougherty","2020-09-13","35","37692","5","3840","6","6.1"
"Dougherty","2020-09-14","221","37913","17","3857","6.6","6"
"Dougherty","2020-09-15","222","38135","5","3862","6.1","5.8"
"Dougherty","2020-09-16","334","38469","7","3869","6","5.6"
"Dougherty","2020-09-17","277","38746","15","3884","6.2","5.8"
"Dougherty","2020-09-18","161","38907","4","3888","5.7","5.5"
"Dougherty","2020-09-19","109","39016","5","3893","5.5","5.6"
"Dougherty","2020-09-20","34","39050","1","3894","3.9","5"
"Dougherty","2020-09-21","172","39222","9","3903","3.6","5.1"
"Dougherty","2020-09-22","237","39459","10","3913","3.9","5"
"Dougherty","2020-09-23","244","39703","4","3917","3.8","4.9"
"Dougherty","2020-09-24","170","39873","6","3923","3.5","4.9"
"Dougherty","2020-09-25","238","40111","7","3930","3.6","4.6"
"Dougherty","2020-09-26","40","40151","5","3935","4.7","5.1"
"Dougherty","2020-09-27","30","40181","2","3937","5.2","4.6"
"Dougherty","2020-09-28","164","40345","3","3940","4.8","4.2"
"Dougherty","2020-09-29","133","40478","5","3945","4.7","4.3"
"Dougherty","2020-09-30","242","40720","3","3948","4.6","4.2"
"Dougherty","2020-10-01","124","40844","6","3954","4.8","4.2"
"Dougherty","2020-10-02","187","41031","3","3957","4.6","4.1"
"Dougherty","2020-10-03","144","41175","11","3968","3.9","4.3"
"Dougherty","2020-10-04","47","41222","1","3969","3.3","4.3"
"Dougherty","2020-10-05","143","41365","10","3979","4","4.4"
"Dougherty","2020-10-06","357","41722","5","3984","3.7","4.2"
"Dougherty","2020-10-07","328","42050","11","3995","4","4.3"
"Dougherty","2020-10-08","186","42236","4","3999","3.6","4.2"
"Dougherty","2020-10-09","209","42445","8","4007","3.9","4.3"
"Dougherty","2020-10-10","63","42508","3","4010","3.5","3.7"
"Dougherty","2020-10-11","30","42538","2","4012","4.2","3.7"
"Dougherty","2020-10-12","139","42677","6","4018","3.8","3.9"
"Dougherty","2020-10-13","393","43070","10","4028","3.9","3.8"
"Dougherty","2020-10-14","278","43348","3","4031","3.6","3.8"
"Dougherty","2020-10-15","123","43471","4","4035","3.8","3.7"
"Dougherty","2020-10-16","190","43661","4","4039","3.5","3.7"
"Dougherty","2020-10-17","64","43725","3","4042","3.5","3.5"
"Dougherty","2020-10-18","33","43758","3","4045","3.9","4"
"Dougherty","2020-10-19","190","43948","4","4049","3.6","3.7"
"Dougherty","2020-10-20","222","44170","7","4056","3.6","3.8"
"Dougherty","2020-10-21","311","44481","6","4062","3.8","3.7"
"Dougherty","2020-10-22","106","44587","5","4067","4","3.9"
"Dougherty","2020-10-23","189","44776","1","4068","3.7","3.6"
"Dougherty","2020-10-24","129","44905","1","4069","3.2","3.4"
"Dougherty","2020-10-25","41","44946","2","4071","2.6","3.2"
"Dougherty","2020-10-26","203","45149","9","4080","2.9","3.2"
"Dougherty","2020-10-27","156","45305","4","4084","2.8","3.2"
"Dougherty","2020-10-28","237","45542","5","4089","2.9","3.3"
"Dougherty","2020-10-29","297","45839","6","4095","2.5","3.2"
"Dougherty","2020-10-30","178","46017","7","4102","3","3.4"
"Dougherty","2020-10-31","126","46143","4","4106","3.3","3.2"
"Dougherty","2020-11-01","87","46230","4","4110","3.3","2.9"
"Dougherty","2020-11-02","149","46379","4","4114","3","3"
"Dougherty","2020-11-03","197","46576","2","4116","2.8","2.8"
"Dougherty","2020-11-04","215","46791","3","4119","2.7","2.8"
"Dougherty","2020-11-05","224","47015","6","4125","2.8","2.6"
"Dougherty","2020-11-06","159","47174","2","4127","2.4","2.7"
"Dougherty","2020-11-07","117","47291","2","4129","2.2","2.7"
"Dougherty","2020-11-08","43","47334","2","4131","2.2","2.7"
"Dougherty","2020-11-09","147","47481","6","4137","2.4","2.7"
"Dougherty","2020-11-10","236","47717","5","4142","2.6","2.7"
"Dougherty","2020-11-11","222","47939","6","4148","2.7","2.7"
"Dougherty","2020-11-12","187","48126","4","4152","2.7","2.7"
"Dougherty","2020-11-13","194","48320","7","4159","3","2.7"
"Dougherty","2020-11-14","191","48511","5","4164","3.1","2.7"
"Dougherty","2020-11-15","65","48576","5","4169","3.6","2.9"
"Dougherty","2020-11-16","150","48726","6","4175","3.6","3"
"Dougherty","2020-11-17","225","48951","6","4181","3.6","3.1"
"Dougherty","2020-11-18","311","49262","6","4187","3.5","3.1"
"Dougherty","2020-11-19","200","49462","11","4198","4","3.3"
"Dougherty","2020-11-20","265","49727","7","4205","3.9","3.4"
"Dougherty","2020-11-21","71","49798","3","4208","4.1","3.6"
"Dougherty","2020-11-22","39","49837","3","4211","4.1","3.8"
"Dougherty","2020-11-23","246","50083","13","4224","4.3","3.9"
"Dougherty","2020-11-24","155","50238","13","4237","5.1","4.4"
"Dougherty","2020-11-25","243","50481","11","4248","5.5","4.5"
"Dougherty","2020-11-26","323","50804","2","4250","4.8","4.4"
"Dougherty","2020-11-27","86","50890","9","4259","5.9","4.9"
"Dougherty","2020-11-28","107","50997","11","4270","6.8","5.4"
"Dougherty","2020-11-29","52","51049","6","4276","7.3","5.7"
"Dougherty","2020-11-30","187","51236","9","4285","7.2","5.8"
"Dougherty","2020-12-01","373","51609","29","4314","7.1","6.1"
"Dougherty","2020-12-02","501","52110","29","4343","7.3","6.4"
"Dougherty","2020-12-03","207","52317","16","4359","8.3","6.6"
"Dougherty","2020-12-04","286","52603","12","4371","7.4","6.7"
"Dougherty","2020-12-05","67","52670","12","4383","8.5","7.6"
"Dougherty","2020-12-06","56","52726","3","4386","7.7","7.5"
"Dougherty","2020-12-07","174","52900","13","4399","8","7.6"
"Dougherty","2020-12-08","293","53193","20","4419","7.9","7.5"
"Dougherty","2020-12-09","464","53657","22","4441","7.7","7.5"
"Dougherty","2020-12-10","266","53923","16","4457","7.5","7.9"
"Dougherty","2020-12-11","436","54359","30","4487","7.9","7.7"
"Dougherty","2020-12-12","267","54626","15","4502","6.1","7.3"
"Dougherty","2020-12-13","88","54714","12","4514","7.3","7.5"
"Dougherty","2020-12-14","400","55114","39","4553","7.6","7.8"
"Dougherty","2020-12-15","331","55445","43","4596","8.5","8.2"
"Dougherty","2020-12-16","474","55919","31","4627","8.8","8.3"
"Dougherty","2020-12-17","166","56085","19","4646","9.6","8.5"
"Dougherty","2020-12-18","543","56628","52","4698","9.9","8.9"
"Dougherty","2020-12-19","132","56760","15","4713","10.8","8.4"
"Dougherty","2020-12-20","44","56804","10","4723","12.1","9.7"
"Dougherty","2020-12-21","325","57129","41","4764","12.5","10.1"
"Dougherty","2020-12-22","335","57464","34","4798","12.1","10.3"
"Dougherty","2020-12-23","433","57897","26","4824","12","10.4"
"Dougherty","2020-12-24","171","58068","10","4834","11.2","10.4"
"Dougherty","2020-12-25","44","58112","7","4841","12.1","11"
"Dougherty","2020-12-26","160","58272","31","4872","13.2","12"
"Dougherty","2020-12-27","51","58323","13","4885","13.6","12.8"
"Dougherty","2020-12-28","295","58618","31","4916","13.3","12.9"
"Dougherty","2020-12-29","465","59083","49","4965","13.4","12.7"
"Dougherty","2020-12-30","394","59477","54","5019","14.5","13.2"
"Dougherty","2020-12-31","251","59728","36","5055","15.7","13.4"
"Dougherty","2021-01-01","59","59787","7","5062","15.1","13.6"
"Dougherty","2021-01-02","267","60054","45","5107","14.8","14"
"Dougherty","2021-01-03","60","60114","16","5123","14.9","14.3"
"Dougherty","2021-01-04","382","60496","65","5188","15.9","14.6"
"Dougherty","2021-01-05","607","61103","97","5285","16.6","15"
"Dougherty","2021-01-06","378","61481","55","5340","16.8","15.6"
"Dougherty","2021-01-07","249","61730","37","5377","16.8","16.3"
"Dougherty","2021-01-08","407","62137","69","5446","17.6","16.3"
"Dougherty","2021-01-09","88","62225","16","5462","17.7","16.3"
"Dougherty","2021-01-10","71","62296","12","5474","16.3","15.6"
"Dougherty","2021-01-11","364","62660","53","5527","16","15.9"
"Dougherty","2021-01-12","313","62973","40","5567","15.5","16.1"
"Dougherty","2021-01-13","374","63347","57","5624","15.6","16.2"
"Dougherty","2021-01-14","179","63526","25","5649","15.5","16.2"
"Dougherty","2021-01-15","330","63856","50","5699","15.3","16.4"
"Dougherty","2021-01-16","80","63936","14","5713","15.2","16.5"
"Dougherty","2021-01-17","62","63998","8","5721","14.6","15.5"
"Dougherty","2021-01-18","296","64294","49","5770","14.9","15.4"
"Dougherty","2021-01-19","337","64631","40","5810","14.7","15.1"
"Dougherty","2021-01-20","357","64988","36","5846","14","14.8"
"Dougherty","2021-01-21","153","65141","14","5860","13.3","14.4"
"Dougherty","2021-01-22","356","65497","42","5902","12.8","14"
"Dougherty","2021-01-23","142","65639","31","5933","13.5","14.3"
"Dougherty","2021-01-24","56","65695","14","5947","15.2","14.9"
"Dougherty","2021-01-25","268","65963","41","5988","15","14.9"
"Dougherty","2021-01-26","255","66218","26","6014","14.8","14.8"
"Dougherty","2021-01-27","205","66423","24","6038","15","14.5"
"Dougherty","2021-01-28","229","66652","36","6074","15.9","14.6"
"Dougherty","2021-01-29","218","66870","31","6105","16.3","14.6"
"Dougherty","2021-01-30","109","66979","14","6119","15","14.2"
"Dougherty","2021-01-31","57","67036","11","6130","14.2","14.7"
"Dougherty","2021-02-01","233","67269","27","6157","13.7","14.3"
"Dougherty","2021-02-02","155","67424","15","6172","13.6","14.2"
"Dougherty","2021-02-03","205","67629","24","6196","13.6","14.3"
"Dougherty","2021-02-04","195","67824","20","6216","12.8","14.4"
"Dougherty","2021-02-05","170","67994","13","6229","11.9","14.1"
"Dougherty","2021-02-06","45","68039","4","6233","11.3","13.1"
"Dougherty","2021-02-07","28","68067","2","6235","9.6","11.9"
"Dougherty","2021-02-08","0","68067","0","6235","7.9","10.8"
"Douglas","2020-02-01","0","0","0","0",".","."
"Douglas","2020-02-02","0","0","0","0",".","."
"Douglas","2020-02-03","0","0","0","0",".","."
"Douglas","2020-02-04","0","0","0","0",".","."
"Douglas","2020-02-05","0","0","0","0",".","."
"Douglas","2020-02-06","0","0","0","0",".","."
"Douglas","2020-02-07","0","0","0","0","0","."
"Douglas","2020-02-08","0","0","0","0","0","."
"Douglas","2020-02-09","0","0","0","0","0","."
"Douglas","2020-02-10","0","0","0","0","0","."
"Douglas","2020-02-11","0","0","0","0","0","."
"Douglas","2020-02-12","0","0","0","0","0","."
"Douglas","2020-02-13","0","0","0","0","0","."
"Douglas","2020-02-14","0","0","0","0","0","0"
"Douglas","2020-02-15","0","0","0","0","0","0"
"Douglas","2020-02-16","0","0","0","0","0","0"
"Douglas","2020-02-17","0","0","0","0","0","0"
"Douglas","2020-02-18","0","0","0","0","0","0"
"Douglas","2020-02-19","0","0","0","0","0","0"
"Douglas","2020-02-20","0","0","0","0","0","0"
"Douglas","2020-02-21","0","0","0","0","0","0"
"Douglas","2020-02-22","0","0","0","0","0","0"
"Douglas","2020-02-23","0","0","0","0","0","0"
"Douglas","2020-02-24","0","0","0","0","0","0"
"Douglas","2020-02-25","0","0","0","0","0","0"
"Douglas","2020-02-26","0","0","0","0","0","0"
"Douglas","2020-02-27","0","0","0","0","0","0"
"Douglas","2020-02-28","0","0","0","0","0","0"
"Douglas","2020-02-29","0","0","0","0","0","0"
"Douglas","2020-03-01","0","0","0","0","0","0"
"Douglas","2020-03-02","0","0","0","0","0","0"
"Douglas","2020-03-03","0","0","0","0","0","0"
"Douglas","2020-03-04","0","0","0","0","0","0"
"Douglas","2020-03-05","0","0","0","0","0","0"
"Douglas","2020-03-06","1","1","0","0","0","0"
"Douglas","2020-03-07","0","1","0","0","0","0"
"Douglas","2020-03-08","0","1","0","0","0","0"
"Douglas","2020-03-09","0","1","0","0","0","0"
"Douglas","2020-03-10","2","3","0","0","0","0"
"Douglas","2020-03-11","2","5","0","0","0","0"
"Douglas","2020-03-12","6","11","0","0","0","0"
"Douglas","2020-03-13","4","15","1","1","3.6","1.8"
"Douglas","2020-03-14","7","22","1","2","5.6","2.8"
"Douglas","2020-03-15","4","26","0","2","5.6","2.8"
"Douglas","2020-03-16","14","40","3","5","8.7","4.3"
"Douglas","2020-03-17","24","64","2","7","9.9","4.9"
"Douglas","2020-03-18","17","81","8","15","16.6","8.3"
"Douglas","2020-03-19","21","102","5","20","20","10"
"Douglas","2020-03-20","15","117","4","24","20.2","11.9"
"Douglas","2020-03-21","6","123","3","27","25.3","15.5"
"Douglas","2020-03-22","2","125","0","27","25.3","15.5"
"Douglas","2020-03-23","21","146","6","33","26.3","17.5"
"Douglas","2020-03-24","32","178","13","46","31","20.4"
"Douglas","2020-03-25","44","222","12","58","28.1","22.4"
"Douglas","2020-03-26","32","254","6","64","27.4","23.7"
"Douglas","2020-03-27","45","299","17","81","29","24.6"
"Douglas","2020-03-28","26","325","12","93","28.5","26.9"
"Douglas","2020-03-29","9","334","8","101","41.1","33.2"
"Douglas","2020-03-30","40","374","4","105","38.5","32.4"
"Douglas","2020-03-31","53","427","16","121","37","34"
"Douglas","2020-04-01","43","470","10","131","36.4","32.3"
"Douglas","2020-04-02","30","500","7","138","37.1","32.2"
"Douglas","2020-04-03","21","521","5","143","35.1","32"
"Douglas","2020-04-04","15","536","2","145","30.4","29.4"
"Douglas","2020-04-05","2","538","1","146","24.8","33"
"Douglas","2020-04-06","45","583","6","152","25.3","31.9"
"Douglas","2020-04-07","61","644","7","159","22.6","29.8"
"Douglas","2020-04-08","44","688","4","163","20.6","28.5"
"Douglas","2020-04-09","42","730","3","166","18.3","27.7"
"Douglas","2020-04-10","46","776","7","173","17.1","26.1"
"Douglas","2020-04-11","36","812","8","181","18.4","24.4"
"Douglas","2020-04-12","9","821","0","181","11.2","18"
"Douglas","2020-04-13","59","880","6","187","10.8","18"
"Douglas","2020-04-14","65","945","8","195","10.9","16.8"
"Douglas","2020-04-15","42","987","2","197","10.3","15.4"
"Douglas","2020-04-16","84","1071","4","201","9.9","14.1"
"Douglas","2020-04-17","78","1149","5","206","8.7","12.9"
"Douglas","2020-04-18","44","1193","8","214","8.1","13.2"
"Douglas","2020-04-19","24","1217","1","215","8.7","9.9"
"Douglas","2020-04-20","95","1312","12","227","9","9.9"
"Douglas","2020-04-21","95","1407","3","230","7.7","9.3"
"Douglas","2020-04-22","103","1510","6","236","7.9","9.1"
"Douglas","2020-04-23","35","1545","3","239","8.4","9.2"
"Douglas","2020-04-24","110","1655","9","248","8.7","8.7"
"Douglas","2020-04-25","53","1708","1","249","6.3","7.2"
"Douglas","2020-04-26","32","1740","4","253","7.5","8.1"
"Douglas","2020-04-27","90","1830","3","256","6.2","7.6"
"Douglas","2020-04-28","125","1955","9","265","6.8","7.3"
"Douglas","2020-04-29","88","2043","8","273","7.3","7.6"
"Douglas","2020-04-30","102","2145","4","277","6.6","7.5"
"Douglas","2020-05-01","73","2218","4","281","6.2","7.4"
"Douglas","2020-05-02","88","2306","2","283","6.3","6.3"
"Douglas","2020-05-03","22","2328","0","283","4.5","6"
"Douglas","2020-05-04","359","2687","49","332","5.9","6.1"
"Douglas","2020-05-05","97","2784","1","333","5.1","5.9"
"Douglas","2020-05-06","83","2867","6","339","4.8","6"
"Douglas","2020-05-07","78","2945","3","342","4.8","5.7"
"Douglas","2020-05-08","119","3064","6","348","4.7","5.5"
"Douglas","2020-05-09","139","3203","3","351","4.7","5.5"
"Douglas","2020-05-10","9","3212","1","352","6.3","5.4"
"Douglas","2020-05-11","145","3357","6","358","4.9","5.4"
"Douglas","2020-05-12","211","3568","6","364","5.2","5.1"
"Douglas","2020-05-13","212","3780","5","369","4.5","4.6"
"Douglas","2020-05-14","200","3980","3","372","4.2","4.5"
"Douglas","2020-05-15","161","4141","7","379","4.1","4.4"
"Douglas","2020-05-16","89","4230","6","385","4.7","4.7"
"Douglas","2020-05-17","45","4275","5","390","4.7","5.5"
"Douglas","2020-05-18","115","4390","6","396","4.9","4.9"
"Douglas","2020-05-19","189","4579","3","399","4.7","4.9"
"Douglas","2020-05-20","142","4721","4","403","4.8","4.6"
"Douglas","2020-05-21","162","4883","10","413","5.4","4.8"
"Douglas","2020-05-22","125","5008","5","418","5.4","4.7"
"Douglas","2020-05-23","114","5122","8","426","5.4","5.1"
"Douglas","2020-05-24","8","5130","0","426","3.8","4.3"
"Douglas","2020-05-25","8","5138","0","426","3.1","4"
"Douglas","2020-05-26","172","5310","11","437","3.8","4.2"
"Douglas","2020-05-27","143","5453","7","444","4.1","4.4"
"Douglas","2020-05-28","75","5528","7","451","4.5","5"
"Douglas","2020-05-29","210","5738","13","464","4.8","5.1"
"Douglas","2020-05-30","102","5840","3","467","4.3","4.8"
"Douglas","2020-05-31","38","5878","1","468","4.6","4.2"
"Douglas","2020-06-01","118","5996","8","476","5.6","4.3"
"Douglas","2020-06-02","114","6110","8","484","5.7","4.7"
"Douglas","2020-06-03","180","6290","17","501","6.3","5.2"
"Douglas","2020-06-04","140","6430","10","511","6","5.3"
"Douglas","2020-06-05","117","6547","7","518","6","5.4"
"Douglas","2020-06-06","143","6690","2","520","5.8","5"
"Douglas","2020-06-07","60","6750","4","524","6.3","5.5"
"Douglas","2020-06-08","99","6849","7","531","6.4","6"
"Douglas","2020-06-09","159","7008","16","547","6.8","6.3"
"Douglas","2020-06-10","195","7203","12","559","6.4","6.3"
"Douglas","2020-06-11","152","7355","12","571","6.5","6.2"
"Douglas","2020-06-12","218","7573","7","578","6.1","6"
"Douglas","2020-06-13","135","7708","11","589","7","6.4"
"Douglas","2020-06-14","41","7749","11","600","9.9","8.1"
"Douglas","2020-06-15","284","8033","11","611","9.5","7.9"
"Douglas","2020-06-16","153","8186","16","627","9.5","8.2"
"Douglas","2020-06-17","170","8356","21","648","10.4","8.4"
"Douglas","2020-06-18","202","8558","23","671","10.9","8.7"
"Douglas","2020-06-19","178","8736","15","686","11.6","8.9"
"Douglas","2020-06-20","126","8862","7","693","11.3","9.1"
"Douglas","2020-06-21","42","8904","5","698","9.1","9.5"
"Douglas","2020-06-22","229","9133","31","729","10.5","10"
"Douglas","2020-06-23","201","9334","21","750","10.5","10"
"Douglas","2020-06-24","192","9526","29","779","10.9","10.7"
"Douglas","2020-06-25","211","9737","29","808","11.2","11.1"
"Douglas","2020-06-26","271","10008","44","852","12.4","12"
"Douglas","2020-06-27","428","10436","47","899","13.1","12.2"
"Douglas","2020-06-28","66","10502","11","910","13.8","11.5"
"Douglas","2020-06-29","348","10850","40","950","13.5","12"
"Douglas","2020-06-30","322","11172","44","994","14","12.3"
"Douglas","2020-07-01","322","11494","37","1031","13.5","12.2"
"Douglas","2020-07-02","334","11828","48","1079","13.6","12.4"
"Douglas","2020-07-03","98","11926","16","1095","13.6","13"
"Douglas","2020-07-04","38","11964","5","1100","13.9","13.5"
"Douglas","2020-07-05","59","12023","9","1109","13.7","13.7"
"Douglas","2020-07-06","312","12335","37","1146","13.7","13.6"
"Douglas","2020-07-07","299","12634","42","1188","13.8","13.9"
"Douglas","2020-07-08","289","12923","33","1221","13.8","13.6"
"Douglas","2020-07-09","319","13242","35","1256","13.3","13.4"
"Douglas","2020-07-10","329","13571","54","1310","13.3","13.4"
"Douglas","2020-07-11","177","13748","24","1334","13.4","13.6"
"Douglas","2020-07-12","63","13811","12","1346","13.9","13.8"
"Douglas","2020-07-13","329","14140","46","1392","14.2","14"
"Douglas","2020-07-14","310","14450","50","1442","14.5","14.1"
"Douglas","2020-07-15","266","14716","30","1472","14.5","14.1"
"Douglas","2020-07-16","304","15020","27","1499","14.2","13.7"
"Douglas","2020-07-17","264","15284","26","1525","13.2","13.3"
"Douglas","2020-07-18","143","15427","11","1536","12.4","12.9"
"Douglas","2020-07-19","74","15501","10","1546","11.6","12.8"
"Douglas","2020-07-20","309","15810","29","1575","11","12.6"
"Douglas","2020-07-21","265","16075","30","1605","10.3","12.4"
"Douglas","2020-07-22","253","16328","23","1628","10","12.2"
"Douglas","2020-07-23","302","16630","29","1657","10.1","12.1"
"Douglas","2020-07-24","452","17082","38","1695","9.9","11.6"
"Douglas","2020-07-25","414","17496","24","1719","9.6","11"
"Douglas","2020-07-26","46","17542","4","1723","8.9","10.3"
"Douglas","2020-07-27","472","18014","34","1757","8.6","9.8"
"Douglas","2020-07-28","454","18468","46","1803","8.4","9.3"
"Douglas","2020-07-29","439","18907","36","1839","8.3","9.1"
"Douglas","2020-07-30","452","19359","31","1870","7.9","9"
"Douglas","2020-07-31","589","19948","37","1907","7.6","8.7"
"Douglas","2020-08-01","446","20394","21","1928","7.4","8.5"
"Douglas","2020-08-02","41","20435","4","1932","7.6","8.2"
"Douglas","2020-08-03","288","20723","18","1950","7.5","8"
"Douglas","2020-08-04","527","21250","52","2002","7.4","7.9"
"Douglas","2020-08-05","450","21700","34","2036","7.3","7.8"
"Douglas","2020-08-06","526","22226","43","2079","7.5","7.7"
"Douglas","2020-08-07","488","22714","26","2105","7.4","7.5"
"Douglas","2020-08-08","693","23407","46","2151","7.7","7.5"
"Douglas","2020-08-09","56","23463","7","2158","8","7.8"
"Douglas","2020-08-10","241","23704","16","2174","8.1","7.8"
"Douglas","2020-08-11","601","24305","43","2217","7.7","7.6"
"Douglas","2020-08-12","309","24614","21","2238","7.6","7.5"
"Douglas","2020-08-13","502","25116","34","2272","7.4","7.5"
"Douglas","2020-08-14","378","25494","26","2298","7.6","7.5"
"Douglas","2020-08-15","108","25602","9","2307","7.9","7.8"
"Douglas","2020-08-16","273","25875","11","2318","6.7","7.4"
"Douglas","2020-08-17","131","26006","13","2331","7.1","7.6"
"Douglas","2020-08-18","306","26312","22","2353","7.1","7.4"
"Douglas","2020-08-19","298","26610","19","2372","7.1","7.3"
"Douglas","2020-08-20","253","26863","13","2385","6.8","7.1"
"Douglas","2020-08-21","317","27180","28","2413","7.1","7.4"
"Douglas","2020-08-22","281","27461","14","2427","6.6","7.3"
"Douglas","2020-08-23","52","27513","4","2431","7.2","6.9"
"Douglas","2020-08-24","186","27699","12","2443","6.7","6.9"
"Douglas","2020-08-25","223","27922","16","2459","6.7","6.9"
"Douglas","2020-08-26","281","28203","14","2473","6.5","6.8"
"Douglas","2020-08-27","303","28506","19","2492","6.6","6.7"
"Douglas","2020-08-28","273","28779","10","2502","5.9","6.5"
"Douglas","2020-08-29","222","29001","10","2512","5.8","6.2"
"Douglas","2020-08-30","41","29042","3","2515","5.8","6.5"
"Douglas","2020-08-31","196","29238","7","2522","5.4","6"
"Douglas","2020-09-01","336","29574","21","2543","5.2","5.9"
"Douglas","2020-09-02","245","29819","12","2555","5.2","5.8"
"Douglas","2020-09-03","279","30098","18","2573","5.2","5.9"
"Douglas","2020-09-04","235","30333","24","2597","6.2","6"
"Douglas","2020-09-05","138","30471","12","2609","6.8","6.3"
"Douglas","2020-09-06","40","30511","5","2614","7.5","6.6"
"Douglas","2020-09-07","64","30575","9","2623","9","7.2"
"Douglas","2020-09-08","337","30912","21","2644","9","7.1"
"Douglas","2020-09-09","182","31094","14","2658","9.4","7.3"
"Douglas","2020-09-10","307","31401","26","2684","9.7","7.5"
"Douglas","2020-09-11","202","31603","12","2696","9.1","7.6"
"Douglas","2020-09-12","201","31804","10","2706","8.6","7.7"
"Douglas","2020-09-13","54","31858","3","2709","7.6","7.5"
"Douglas","2020-09-14","219","32077","19","2728","6.8","7.9"
"Douglas","2020-09-15","308","32385","16","2744","6.6","7.8"
"Douglas","2020-09-16","152","32537","6","2750","6.1","7.8"
"Douglas","2020-09-17","133","32670","9","2759","5.9","7.8"
"Douglas","2020-09-18","148","32818","19","2778","6.9","8"
"Douglas","2020-09-19","463","33281","17","2795","6.7","7.6"
"Douglas","2020-09-20","59","33340","4","2799","6.8","7.2"
"Douglas","2020-09-21","207","33547","19","2818","6.9","6.9"
"Douglas","2020-09-22","321","33868","17","2835","6.9","6.8"
"Douglas","2020-09-23","194","34062","21","2856","7.9","7"
"Douglas","2020-09-24","144","34206","4","2860","7.3","6.6"
"Douglas","2020-09-25","191","34397","14","2874","6.6","6.7"
"Douglas","2020-09-26","158","34555","10","2884","6.9","6.8"
"Douglas","2020-09-27","34","34589","4","2888","7.6","7.2"
"Douglas","2020-09-28","180","34769","22","2910","8.1","7.5"
"Douglas","2020-09-29","351","35120","19","2929","8.1","7.5"
"Douglas","2020-09-30","169","35289","13","2942","7.6","7.8"
"Douglas","2020-10-01","297","35586","21","2963","8.3","7.8"
"Douglas","2020-10-02","221","35807","18","2981","8.4","7.5"
"Douglas","2020-10-03","165","35972","10","2991","8.3","7.6"
"Douglas","2020-10-04","95","36067","7","2998","7.7","7.7"
"Douglas","2020-10-05","219","36286","22","3020","7.4","7.7"
"Douglas","2020-10-06","314","36600","16","3036","7.4","7.7"
"Douglas","2020-10-07","264","36864","11","3047","6.9","7.2"
"Douglas","2020-10-08","356","37220","22","3069","6.7","7.5"
"Douglas","2020-10-09","237","37457","22","3091","6.9","7.6"
"Douglas","2020-10-10","165","37622","15","3106","7.3","7.8"
"Douglas","2020-10-11","53","37675","2","3108","6.8","7.3"
"Douglas","2020-10-12","146","37821","9","3117","6.3","6.8"
"Douglas","2020-10-13","318","38139","14","3131","6.2","6.8"
"Douglas","2020-10-14","198","38337","15","3146","6.6","6.7"
"Douglas","2020-10-15","286","38623","23","3169","6.9","6.8"
"Douglas","2020-10-16","182","38805","13","3182","6.6","6.7"
"Douglas","2020-10-17","204","39009","25","3207","7.1","7.2"
"Douglas","2020-10-18","46","39055","5","3212","8.1","7.4"
"Douglas","2020-10-19","216","39271","22","3234","8.6","7.4"
"Douglas","2020-10-20","329","39600","13","3247","8.6","7.4"
"Douglas","2020-10-21","229","39829","20","3267","8.7","7.7"
"Douglas","2020-10-22","359","40188","26","3293","8.6","7.8"
"Douglas","2020-10-23","251","40439","16","3309","8.5","7.6"
"Douglas","2020-10-24","124","40563","11","3320","8","7.5"
"Douglas","2020-10-25","74","40637","9","3329","8.2","8.1"
"Douglas","2020-10-26","248","40885","25","3354","8.2","8.4"
"Douglas","2020-10-27","353","41238","28","3382","8.8","8.7"
"Douglas","2020-10-28","240","41478","26","3408","9.1","8.9"
"Douglas","2020-10-29","127","41605","10","3418","9.2","8.9"
"Douglas","2020-10-30","238","41843","11","3429","8.9","8.7"
"Douglas","2020-10-31","239","42082","31","3460","9.5","8.8"
"Douglas","2020-11-01","65","42147","14","3474","10.8","9.5"
"Douglas","2020-11-02","322","42469","31","3505","10.8","9.5"
"Douglas","2020-11-03","221","42690","21","3526","11","9.9"
"Douglas","2020-11-04","249","42939","25","3551","10.9","10"
"Douglas","2020-11-05","395","43334","21","3572","10.5","9.8"
"Douglas","2020-11-06","234","43568","14","3586","10.7","9.8"
"Douglas","2020-11-07","216","43784","22","3608","10.3","9.9"
"Douglas","2020-11-08","81","43865","5","3613","8.1","9.5"
"Douglas","2020-11-09","279","44144","29","3642","8.2","9.5"
"Douglas","2020-11-10","408","44552","36","3678","8.1","9.6"
"Douglas","2020-11-11","155","44707","17","3695","8.3","9.6"
"Douglas","2020-11-12","513","45220","30","3725","8.3","9.4"
"Douglas","2020-11-13","329","45549","35","3760","9","9.9"
"Douglas","2020-11-14","188","45737","21","3781","9.1","9.7"
"Douglas","2020-11-15","75","45812","5","3786","9.2","8.7"
"Douglas","2020-11-16","445","46257","48","3834","9.3","8.7"
"Douglas","2020-11-17","533","46790","45","3879","9.2","8.7"
"Douglas","2020-11-18","526","47316","41","3920","8.8","8.5"
"Douglas","2020-11-19","766","48082","40","3960","8.7","8.5"
"Douglas","2020-11-20","353","48435","41","4001","8.8","8.9"
"Douglas","2020-11-21","256","48691","19","4020","8.3","8.7"
"Douglas","2020-11-22","86","48777","11","4031","9.2","9.2"
"Douglas","2020-11-23","767","49544","55","4086","8.6","9"
"Douglas","2020-11-24","584","50128","37","4123","8.3","8.8"
"Douglas","2020-11-25","204","50332","17","4140","8.4","8.6"
"Douglas","2020-11-26","39","50371","5","4145","9.5","9.1"
"Douglas","2020-11-27","134","50505","17","4162","9.7","9.2"
"Douglas","2020-11-28","110","50615","21","4183","11.3","9.8"
"Douglas","2020-11-29","99","50714","21","4204","12.5","10.8"
"Douglas","2020-11-30","557","51271","85","4289","13.7","11.2"
"Douglas","2020-12-01","576","51847","83","4372","14.8","11.6"
"Douglas","2020-12-02","403","52250","65","4437","15.9","12.2"
"Douglas","2020-12-03","589","52839","74","4511","15.9","12.7"
"Douglas","2020-12-04","405","53244","58","4569","16.1","12.9"
"Douglas","2020-12-05","218","53462","28","4597","15.2","13.3"
"Douglas","2020-12-06","74","53536","9","4606","14","13.2"
"Douglas","2020-12-07","629","54165","82","4688","13.6","13.7"
"Douglas","2020-12-08","603","54768","70","4758","13.2","14"
"Douglas","2020-12-09","334","55102","39","4797","12.6","14.3"
"Douglas","2020-12-10","651","55753","75","4872","12.5","14.2"
"Douglas","2020-12-11","511","56264","61","4933","12.1","14.1"
"Douglas","2020-12-12","264","56528","28","4961","11.8","13.5"
"Douglas","2020-12-13","84","56612","11","4972","11.9","12.9"
"Douglas","2020-12-14","737","57349","107","5079","12.1","12.9"
"Douglas","2020-12-15","801","58150","102","5181","12.3","12.8"
"Douglas","2020-12-16","412","58562","54","5235","12.5","12.6"
"Douglas","2020-12-17","1129","59691","138","5373","12.6","12.5"
"Douglas","2020-12-18","1036","60727","138","5511","12.8","12.5"
"Douglas","2020-12-19","548","61275","66","5577","13","12.4"
"Douglas","2020-12-20","91","61366","16","5593","13.6","12.8"
"Douglas","2020-12-21","523","61889","81","5674","13.8","13"
"Douglas","2020-12-22","1346","63235","136","5810","13.4","12.9"
"Douglas","2020-12-23","1300","64535","173","5983","13.4","13"
"Douglas","2020-12-24","158","64693","37","6020","15","13.8"
"Douglas","2020-12-25","25","64718","2","6022","14.3","13.5"
"Douglas","2020-12-26","258","64976","64","6086","16.1","14.6"
"Douglas","2020-12-27","103","65079","20","6106","16.4","15"
"Douglas","2020-12-28","691","65770","126","6232","16.8","15.3"
"Douglas","2020-12-29","1413","67183","218","6450","17.5","15.5"
"Douglas","2020-12-30","882","68065","170","6620","18.4","15.9"
"Douglas","2020-12-31","655","68720","133","6753","17.9","16.5"
"Douglas","2021-01-01","44","68764","9","6762","19.7","17"
"Douglas","2021-01-02","306","69070","72","6834","19.5","17.8"
"Douglas","2021-01-03","94","69164","21","6855","19.9","18.2"
"Douglas","2021-01-04","767","69931","171","7026","20.5","18.6"
"Douglas","2021-01-05","2884","72815","505","7531","20.8","19.2"
"Douglas","2021-01-06","1024","73839","168","7699","20.4","19.4"
"Douglas","2021-01-07","1298","75137","227","7926","20","19"
"Douglas","2021-01-08","635","75772","105","8031","19.4","19.6"
"Douglas","2021-01-09","274","76046","45","8076","18.4","19"
"Douglas","2021-01-10","103","76149","21","8097","18.1","19"
"Douglas","2021-01-11","751","76900","135","8232","17.5","19"
"Douglas","2021-01-12","1573","78473","205","8437","16.9","18.9"
"Douglas","2021-01-13","1015","79488","131","8568","16.4","18.4"
"Douglas","2021-01-14","1285","80773","175","8743","15.8","17.9"
"Douglas","2021-01-15","1106","81879","140","8883","15.3","17.4"
"Douglas","2021-01-16","880","82759","135","9018","15.1","16.8"
"Douglas","2021-01-17","125","82884","29","9047","15.5","16.8"
"Douglas","2021-01-18","467","83351","83","9130","15.5","16.5"
"Douglas","2021-01-19","1316","84667","194","9324","15.7","16.3"
"Douglas","2021-01-20","773","85440","97","9421","15.7","16"
"Douglas","2021-01-21","986","86426","127","9548","15.6","15.7"
"Douglas","2021-01-22","521","86947","82","9630","16","15.7"
"Douglas","2021-01-23","333","87280","53","9683","16.1","15.6"
"Douglas","2021-01-24","94","87374","9","9692","14.2","14.9"
"Douglas","2021-01-25","862","88236","119","9811","13.6","14.6"
"Douglas","2021-01-26","1060","89296","129","9940","13.2","14.5"
"Douglas","2021-01-27","645","89941","106","10046","13.8","14.7"
"Douglas","2021-01-28","794","90735","116","10162","14","14.8"
"Douglas","2021-01-29","918","91653","117","10279","13.6","14.8"
"Douglas","2021-01-30","298","91951","42","10321","13.3","14.7"
"Douglas","2021-01-31","142","92093","33","10354","15.3","14.7"
"Douglas","2021-02-01","812","92905","128","10482","15.6","14.6"
"Douglas","2021-02-02","580","93485","64","10546","15.4","14.3"
"Douglas","2021-02-03","531","94016","83","10629","15.3","14.5"
"Douglas","2021-02-04","770","94786","84","10713","14.8","14.4"
"Douglas","2021-02-05","548","95334","61","10774","14.5","14.1"
"Douglas","2021-02-06","45","95379","8","10782","15.1","14.2"
"Douglas","2021-02-07","10","95389","0","10782","11.7","13.5"
"Douglas","2021-02-08","0","95389","0","10782","9.5","12.5"
"Early","2020-02-01","0","0","0","0",".","."
"Early","2020-02-02","0","0","0","0",".","."
"Early","2020-02-03","0","0","0","0",".","."
"Early","2020-02-04","0","0","0","0",".","."
"Early","2020-02-05","0","0","0","0",".","."
"Early","2020-02-06","0","0","0","0",".","."
"Early","2020-02-07","0","0","0","0","0","."
"Early","2020-02-08","0","0","0","0","0","."
"Early","2020-02-09","0","0","0","0","0","."
"Early","2020-02-10","0","0","0","0","0","."
"Early","2020-02-11","0","0","0","0","0","."
"Early","2020-02-12","0","0","0","0","0","."
"Early","2020-02-13","0","0","0","0","0","."
"Early","2020-02-14","0","0","0","0","0","0"
"Early","2020-02-15","0","0","0","0","0","0"
"Early","2020-02-16","0","0","0","0","0","0"
"Early","2020-02-17","0","0","0","0","0","0"
"Early","2020-02-18","0","0","0","0","0","0"
"Early","2020-02-19","0","0","0","0","0","0"
"Early","2020-02-20","0","0","0","0","0","0"
"Early","2020-02-21","0","0","0","0","0","0"
"Early","2020-02-22","0","0","0","0","0","0"
"Early","2020-02-23","0","0","0","0","0","0"
"Early","2020-02-24","0","0","0","0","0","0"
"Early","2020-02-25","0","0","0","0","0","0"
"Early","2020-02-26","0","0","0","0","0","0"
"Early","2020-02-27","0","0","0","0","0","0"
"Early","2020-02-28","0","0","0","0","0","0"
"Early","2020-02-29","0","0","0","0","0","0"
"Early","2020-03-01","0","0","0","0","0","0"
"Early","2020-03-02","0","0","0","0","0","0"
"Early","2020-03-03","0","0","0","0","0","0"
"Early","2020-03-04","0","0","0","0","0","0"
"Early","2020-03-05","0","0","0","0","0","0"
"Early","2020-03-06","0","0","0","0","0","0"
"Early","2020-03-07","0","0","0","0","0","0"
"Early","2020-03-08","0","0","0","0","0","0"
"Early","2020-03-09","0","0","0","0","0","0"
"Early","2020-03-10","0","0","0","0","0","0"
"Early","2020-03-11","0","0","0","0","0","0"
"Early","2020-03-12","0","0","0","0","0","0"
"Early","2020-03-13","0","0","0","0","0","0"
"Early","2020-03-14","0","0","0","0","0","0"
"Early","2020-03-15","1","1","0","0","0","0"
"Early","2020-03-16","5","6","2","2","5.7","2.9"
"Early","2020-03-17","1","7","1","3","20","10"
"Early","2020-03-18","6","13","4","7","29.5","14.8"
"Early","2020-03-19","6","19","2","9","34.3","17.1"
"Early","2020-03-20","10","29","2","11","37.1","18.6"
"Early","2020-03-21","0","29","0","11","37.1","18.6"
"Early","2020-03-22","0","29","0","11","37.1","18.6"
"Early","2020-03-23","27","56","10","21","36.7","21.2"
"Early","2020-03-24","23","79","8","29","27.4","23.7"
"Early","2020-03-25","19","98","3","32","20.1","24.8"
"Early","2020-03-26","13","111","5","37","20.9","27.6"
"Early","2020-03-27","16","127","4","41","21.6","29.4"
"Early","2020-03-28","2","129","2","43","35.9","36.5"
"Early","2020-03-29","6","135","3","46","43","40.1"
"Early","2020-03-30","20","155","8","54","43.4","40.1"
"Early","2020-03-31","20","175","10","64","45.6","36.5"
"Early","2020-04-01","23","198","7","71","47.7","33.9"
"Early","2020-04-02","15","213","8","79","49.8","35.3"
"Early","2020-04-03","21","234","9","88","52.4","37"
"Early","2020-04-04","12","246","4","92","42.9","39.4"
"Early","2020-04-05","2","248","2","94","50","46.5"
"Early","2020-04-06","9","257","4","98","50.6","47"
"Early","2020-04-07","23","280","10","108","49.7","47.7"
"Early","2020-04-08","14","294","5","113","50.5","49.1"
"Early","2020-04-09","38","332","12","125","47.3","48.6"
"Early","2020-04-10","24","356","10","135","47.2","49.8"
"Early","2020-04-11","13","369","6","141","49","45.9"
"Early","2020-04-12","0","369","0","141","34.7","42.4"
"Early","2020-04-13","27","396","19","160","38.4","44.5"
"Early","2020-04-14","28","424","8","168","36.3","43"
"Early","2020-04-15","19","443","6","174","35.7","43.1"
"Early","2020-04-16","30","473","7","181","34.5","40.9"
"Early","2020-04-17","16","489","4","185","32.1","39.7"
"Early","2020-04-18","8","497","2","187","29.1","39.1"
"Early","2020-04-19","2","499","1","188","36.3","35.5"
"Early","2020-04-20","8","507","0","188","26.2","32.3"
"Early","2020-04-21","17","524","4","192","25.5","30.9"
"Early","2020-04-22","38","562","5","197","22.9","29.3"
"Early","2020-04-23","16","578","4","201","23.1","28.8"
"Early","2020-04-24","13","591","1","202","20.6","26.4"
"Early","2020-04-25","8","599","1","203","18.8","24"
"Early","2020-04-26","5","604","2","205","17.4","26.8"
"Early","2020-04-27","14","618","4","209","21.5","23.9"
"Early","2020-04-28","14","632","0","209","18.1","21.8"
"Early","2020-04-29","8","640","0","209","16.3","19.6"
"Early","2020-04-30","26","666","2","211","13.8","18.4"
"Early","2020-05-01","14","680","4","215","16.8","18.7"
"Early","2020-05-02","5","685","1","216","17.8","18.3"
"Early","2020-05-03","0","685","0","216","12.1","14.8"
"Early","2020-05-04","3","688","0","216","8","14.8"
"Early","2020-05-05","10","698","1","217","9.5","13.8"
"Early","2020-05-06","9","707","3","220","14.2","15.2"
"Early","2020-05-07","7","714","0","220","13.1","13.5"
"Early","2020-05-08","3","717","0","220","9","12.9"
"Early","2020-05-09","4","721","1","221","9.8","13.8"
"Early","2020-05-10","1","722","1","222","24","18.1"
"Early","2020-05-11","6","728","2","224","28.8","18.4"
"Early","2020-05-12","15","743","2","226","29.3","19.4"
"Early","2020-05-13","8","751","0","226","24.5","19.4"
"Early","2020-05-14","13","764","2","228","26.7","19.9"
"Early","2020-05-15","12","776","2","230","29.1","19.1"
"Early","2020-05-16","6","782","0","230","25.5","17.6"
"Early","2020-05-17","0","782","0","230","11.2","17.6"
"Early","2020-05-18","9","791","2","232","9.7","19.2"
"Early","2020-05-19","15","806","2","234","9.7","19.5"
"Early","2020-05-20","6","812","3","237","16.8","20.7"
"Early","2020-05-21","14","826","0","237","14.6","20.7"
"Early","2020-05-22","25","851","2","239","13.4","21.2"
"Early","2020-05-23","1","852","0","239","13.4","19.4"
"Early","2020-05-24","1","853","0","239","13.4","12.3"
"Early","2020-05-25","9","862","0","239","10.2","9.9"
"Early","2020-05-26","18","880","3","242","10.7","10.2"
"Early","2020-05-27","30","910","0","242","3.5","10.2"
"Early","2020-05-28","16","926","0","242","3.5","9.1"
"Early","2020-05-29","17","943","2","244","4.1","8.7"
"Early","2020-05-30","2","945","0","244","4.1","8.7"
"Early","2020-05-31","0","945","0","244","4.1","8.7"
"Early","2020-06-01","11","956","2","246","6.7","8.4"
"Early","2020-06-02","8","964","0","246","4.3","7.5"
"Early","2020-06-03","13","977","1","247","5.4","4.5"
"Early","2020-06-04","11","988","2","249","8","5.7"
"Early","2020-06-05","8","996","0","249","6.3","5.2"
"Early","2020-06-06","4","1000","0","249","6.3","5.2"
"Early","2020-06-07","1","1001","0","249","6.3","5.2"
"Early","2020-06-08","18","1019","1","250","4.5","5.6"
"Early","2020-06-09","12","1031","0","250","4.5","4.4"
"Early","2020-06-10","7","1038","1","251","5.4","5.4"
"Early","2020-06-11","65","1103","0","251","2.8","5.4"
"Early","2020-06-12","11","1114","1","252","4.1","5.2"
"Early","2020-06-13","0","1114","0","252","4.1","5.2"
"Early","2020-06-14","1","1115","0","252","4.1","5.2"
"Early","2020-06-15","11","1126","2","254","5.9","5.2"
"Early","2020-06-16","16","1142","0","254","5.9","5.2"
"Early","2020-06-17","12","1154","2","256","6.3","5.9"
"Early","2020-06-18","30","1184","5","261","8.7","5.7"
"Early","2020-06-19","28","1212","2","263","8.4","6.3"
"Early","2020-06-20","9","1221","1","264","10","7.1"
"Early","2020-06-21","1","1222","0","264","10","7.1"
"Early","2020-06-22","14","1236","1","265","8.4","7.2"
"Early","2020-06-23","9","1245","1","266","10","8"
"Early","2020-06-24","28","1273","4","270","9.6","8"
"Early","2020-06-25","5","1278","0","270","7.3","8"
"Early","2020-06-26","16","1294","3","273","8.9","8.6"
"Early","2020-06-27","1","1295","0","273","7.3","8.6"
"Early","2020-06-28","2","1297","0","273","7.3","8.6"
"Early","2020-06-29","9","1306","2","275","9.5","8.9"
"Early","2020-06-30","13","1319","3","278","11.2","10.6"
"Early","2020-07-01","20","1339","7","285","14.1","11.9"
"Early","2020-07-02","13","1352","4","289","18.5","12.9"
"Early","2020-07-03","17","1369","4","293","19.2","14.1"
"Early","2020-07-04","19","1388","5","298","23","15.2"
"Early","2020-07-05","2","1390","0","298","23","15.2"
"Early","2020-07-06","24","1414","4","302","22.2","15.8"
"Early","2020-07-07","7","1421","3","305","25","18.1"
"Early","2020-07-08","9","1430","1","306","21.6","17.9"
"Early","2020-07-09","35","1465","5","311","19.3","18.9"
"Early","2020-07-10","16","1481","2","313","17.7","18.5"
"Early","2020-07-11","66","1547","10","323","16.1","19.5"
"Early","2020-07-12","14","1561","0","323","16.1","19.5"
"Early","2020-07-13","25","1586","0","323","13.7","17.9"
"Early","2020-07-14","25","1611","5","328","10.4","17.7"
"Early","2020-07-15","21","1632","1","329","9.5","15.6"
"Early","2020-07-16","11","1643","4","333","12.7","16"
"Early","2020-07-17","13","1656","8","341","19.7","18.7"
"Early","2020-07-18","7","1663","2","343","21.6","18.8"
"Early","2020-07-19","0","1663","0","343","21.6","18.8"
"Early","2020-07-20","10","1673","5","348","28.7","21.2"
"Early","2020-07-21","23","1696","9","357","31.5","21"
"Early","2020-07-22","9","1705","1","358","32.4","21"
"Early","2020-07-23","11","1716","1","359","28.5","20.6"
"Early","2020-07-24","20","1736","1","360","20.4","20.1"
"Early","2020-07-25","14","1750","4","364","20.4","21"
"Early","2020-07-26","2","1752","0","364","20.4","21"
"Early","2020-07-27","16","1768","0","364","13.3","21"
"Early","2020-07-28","17","1785","4","368","11","21.3"
"Early","2020-07-29","16","1801","5","373","13.9","23.2"
"Early","2020-07-30","23","1824","5","378","15.7","22.1"
"Early","2020-07-31","16","1840","6","384","20.4","20.4"
"Early","2020-08-01","16","1856","1","385","17.2","18.8"
"Early","2020-08-02","2","1858","0","385","17.2","18.8"
"Early","2020-08-03","14","1872","0","385","17.2","15.2"
"Early","2020-08-04","35","1907","4","389","15.5","13.2"
"Early","2020-08-05","25","1932","0","389","11","12.5"
"Early","2020-08-06","15","1947","3","392","10.7","13.2"
"Early","2020-08-07","17","1964","2","394","7.1","13.7"
"Early","2020-08-08","9","1973","3","397","10.9","14.1"
"Early","2020-08-09","1","1974","0","397","10.9","14.1"
"Early","2020-08-10","16","1990","4","401","14.5","15.8"
"Early","2020-08-11","18","2008","4","405","16","15.7"
"Early","2020-08-12","16","2024","6","411","21.4","16.2"
"Early","2020-08-13","6","2030","0","411","18.5","14.6"
"Early","2020-08-14","6","2036","2","413","21.6","14.3"
"Early","2020-08-15","15","2051","5","418","21.6","16.3"
"Early","2020-08-16","2","2053","1","419","28.8","19.9"
"Early","2020-08-17","10","2063","2","421","28.1","21.3"
"Early","2020-08-18","17","2080","4","425","28.2","22.1"
"Early","2020-08-19","21","2101","4","429","25.6","23.5"
"Early","2020-08-20","22","2123","4","433","28.2","23.4"
"Early","2020-08-21","17","2140","1","434","24.3","23"
"Early","2020-08-22","5","2145","0","434","19.5","20.6"
"Early","2020-08-23","1","2146","0","434","12.4","20.6"
"Early","2020-08-24","10","2156","1","435","10.9","19.5"
"Early","2020-08-25","16","2172","2","437","9.4","18.8"
"Early","2020-08-26","14","2186","3","440","9.7","17.7"
"Early","2020-08-27","10","2196","1","441","8.5","18.4"
"Early","2020-08-28","17","2213","5","446","11.9","18.1"
"Early","2020-08-29","10","2223","2","448","14.8","17.1"
"Early","2020-08-30","0","2223","0","448","14.8","13.6"
"Early","2020-08-31","11","2234","3","451","17.2","14.1"
"Early","2020-09-01","17","2251","7","458","21.3","15.4"
"Early","2020-09-02","13","2264","5","463","23.8","16.7"
"Early","2020-09-03","16","2280","1","464","23.2","15.9"
"Early","2020-09-04","15","2295","3","467","21.9","16.9"
"Early","2020-09-05","8","2303","1","468","20.8","17.8"
"Early","2020-09-06","3","2306","1","469","25.6","20.2"
"Early","2020-09-07","2","2308","0","469","21.7","19.5"
"Early","2020-09-08","16","2324","2","471","17.6","19.5"
"Early","2020-09-09","32","2356","4","475","13.9","18.8"
"Early","2020-09-10","24","2380","5","480","16","19.6"
"Early","2020-09-11","43","2423","2","482","13.8","17.8"
"Early","2020-09-12","2","2425","0","482","12","16.4"
"Early","2020-09-13","0","2425","0","482","7.2","16.4"
"Early","2020-09-14","46","2471","3","485","8.1","14.9"
"Early","2020-09-15","19","2490","4","489","9.4","13.5"
"Early","2020-09-16","42","2532","3","492","8.6","11.2"
"Early","2020-09-17","42","2574","4","496","7","11.5"
"Early","2020-09-18","38","2612","2","498","7.1","10.4"
"Early","2020-09-19","10","2622","2","500","9.9","11"
"Early","2020-09-20","1","2623","0","500","9.9","8.6"
"Early","2020-09-21","51","2674","4","504","10.1","9.1"
"Early","2020-09-22","45","2719","2","506","7.7","8.6"
"Early","2020-09-23","50","2769","8","514","9","8.8"
"Early","2020-09-24","29","2798","3","517","9.1","8.1"
"Early","2020-09-25","45","2843","4","521","9.6","8.4"
"Early","2020-09-26","3","2846","1","522","11.6","10.7"
"Early","2020-09-27","0","2846","0","522","11.6","10.7"
"Early","2020-09-28","47","2893","0","522","10.4","10.3"
"Early","2020-09-29","31","2924","6","528","12.6","10.2"
"Early","2020-09-30","42","2966","2","530","11","10"
"Early","2020-10-01","33","2999","3","533","10.8","10"
"Early","2020-10-02","23","3022","1","534","10.1","9.9"
"Early","2020-10-03","7","3029","1","535","7.4","9.5"
"Early","2020-10-04","2","3031","0","535","7.4","9.5"
"Early","2020-10-05","40","3071","0","535","7.4","8.9"
"Early","2020-10-06","35","3106","2","537","5.5","9"
"Early","2020-10-07","29","3135","3","540","6.3","8.6"
"Early","2020-10-08","23","3158","2","542","6.2","8.5"
"Early","2020-10-09","16","3174","2","544","7.4","8.7"
"Early","2020-10-10","5","3179","0","544","5.3","6.4"
"Early","2020-10-11","1","3180","0","544","5.3","6.4"
"Early","2020-10-12","32","3212","0","544","5.3","6.4"
"Early","2020-10-13","17","3229","2","546","6.2","5.8"
"Early","2020-10-14","35","3264","2","548","5.5","5.9"
"Early","2020-10-15","6","3270","0","548","4.3","5.2"
"Early","2020-10-16","23","3293","4","552","5","6.2"
"Early","2020-10-17","5","3298","0","552","5","5.2"
"Early","2020-10-18","2","3300","2","554","19.3","12.3"
"Early","2020-10-19","41","3341","5","559","21","13.2"
"Early","2020-10-20","27","3368","2","561","20.4","13.3"
"Early","2020-10-21","34","3402","2","563","20.4","13"
"Early","2020-10-22","22","3424","3","566","22.4","13.3"
"Early","2020-10-23","24","3448","1","567","20.5","12.7"
"Early","2020-10-24","1","3449","0","567","20.5","12.7"
"Early","2020-10-25","4","3453","2","569","13.3","16.3"
"Early","2020-10-26","41","3494","2","571","12.3","16.6"
"Early","2020-10-27","19","3513","2","573","12.7","16.6"
"Early","2020-10-28","39","3552","2","575","12.6","16.5"
"Early","2020-10-29","32","3584","1","576","11.1","16.7"
"Early","2020-10-30","22","3606","3","579","12.5","16.5"
"Early","2020-10-31","2","3608","1","580","19.6","20"
"Early","2020-11-01","0","3608","0","580","12.5","12.9"
"Early","2020-11-02","45","3653","1","581","12.1","12.2"
"Early","2020-11-03","14","3667","2","583","12.6","12.7"
"Early","2020-11-04","29","3696","0","583","11.9","12.3"
"Early","2020-11-05","13","3709","4","587","15.8","13.5"
"Early","2020-11-06","18","3727","1","588","14.7","13.6"
"Early","2020-11-07","4","3731","0","588","7.5","13.6"
"Early","2020-11-08","0","3731","0","588","7.5","10"
"Early","2020-11-09","38","3769","3","591","8.4","10.2"
"Early","2020-11-10","20","3789","3","594","8.5","10.5"
"Early","2020-11-11","38","3827","6","600","10.7","11.3"
"Early","2020-11-12","21","3848","4","604","9","12.4"
"Early","2020-11-13","25","3873","2","606","9.4","12"
"Early","2020-11-14","7","3880","1","607","11.4","9.5"
"Early","2020-11-15","4","3884","1","608","15","11.3"
"Early","2020-11-16","42","3926","2","610","14.6","11.5"
"Early","2020-11-17","14","3940","0","610","12.4","10.4"
"Early","2020-11-18","32","3972","4","614","11.9","11.3"
"Early","2020-11-19","19","3991","4","618","12.2","10.6"
"Early","2020-11-20","15","4006","3","621","13.9","11.7"
"Early","2020-11-21","8","4014","5","626","20.8","16.1"
"Early","2020-11-22","1","4015","0","626","17.3","16.1"
"Early","2020-11-23","17","4032","0","626","16.6","15.6"
"Early","2020-11-24","6","4038","2","628","21.3","16.9"
"Early","2020-11-25","42","4080","1","629","19.9","15.9"
"Early","2020-11-26","2","4082","0","629","16.9","14.6"
"Early","2020-11-27","16","4098","1","630","14.9","14.4"
"Early","2020-11-28","8","4106","2","632","9.6","15.2"
"Early","2020-11-29","4","4110","2","634","16.7","17"
"Early","2020-11-30","41","4151","0","634","16.7","16.6"
"Early","2020-12-01","25","4176","1","635","12.5","16.9"
"Early","2020-12-02","43","4219","3","638","13.2","16.5"
"Early","2020-12-03","20","4239","8","646","18.9","17.9"
"Early","2020-12-04","22","4261","3","649","19.9","17.4"
"Early","2020-12-05","6","4267","2","651","21.1","15.4"
"Early","2020-12-06","1","4268","1","652","28.3","22.5"
"Early","2020-12-07","49","4317","2","654","28.9","22.8"
"Early","2020-12-08","25","4342","6","660","31.7","22.1"
"Early","2020-12-09","76","4418","1","661","30.9","22"
"Early","2020-12-10","34","4452","5","666","27.3","23.1"
"Early","2020-12-11","35","4487","3","669","26.6","23.3"
"Early","2020-12-12","21","4508","3","672","23.9","22.5"
"Early","2020-12-13","4","4512","2","674","16.7","22.5"
"Early","2020-12-14","36","4548","2","676","16.9","22.9"
"Early","2020-12-15","57","4605","9","685","15.7","23.7"
"Early","2020-12-16","35","4640","6","691","18","24.5"
"Early","2020-12-17","17","4657","4","695","19.3","23.3"
"Early","2020-12-18","15","4672","5","700","22.8","24.7"
"Early","2020-12-19","15","4687","4","704","24.6","24.2"
"Early","2020-12-20","0","4687","0","704","17.4","17.1"
"Early","2020-12-21","10","4697","1","705","18.1","17.5"
"Early","2020-12-22","35","4732","8","713","19.1","17.4"
"Early","2020-12-23","34","4766","11","724","21.2","19.6"
"Early","2020-12-24","13","4779","2","726","20.1","19.7"
"Early","2020-12-25","0","4779","0","726","15.3","19.1"
"Early","2020-12-26","2","4781","1","727","18.7","21.6"
"Early","2020-12-27","1","4782","1","728","32.9","25.2"
"Early","2020-12-28","7","4789","0","728","31.5","24.8"
"Early","2020-12-29","30","4819","10","738","33","26"
"Early","2020-12-30","48","4867","17","755","33.4","27.3"
"Early","2020-12-31","43","4910","11","766","34.9","27.5"
"Early","2021-01-01","1","4911","1","767","49.2","32.3"
"Early","2021-01-02","0","4911","0","767","42","30.4"
"Early","2021-01-03","7","4918","4","771","35.9","34.4"
"Early","2021-01-04","49","4967","7","778","38","34.7"
"Early","2021-01-05","64","5031","19","797","37.4","35.2"
"Early","2021-01-06","73","5104","15","812","35.3","34.4"
"Early","2021-01-07","41","5145","8","820","34.5","34.7"
"Early","2021-01-08","44","5189","6","826","22.1","35.7"
"Early","2021-01-09","21","5210","8","834","27.6","34.8"
"Early","2021-01-10","11","5221","2","836","22","29"
"Early","2021-01-11","43","5264","6","842","21.9","30"
"Early","2021-01-12","48","5312","9","851","20.4","28.9"
"Early","2021-01-13","73","5385","7","858","18.8","27.1"
"Early","2021-01-14","63","5448","9","867","18.1","26.3"
"Early","2021-01-15","75","5523","12","879","18.4","20.3"
"Early","2021-01-16","25","5548","12","891","19.8","23.7"
"Early","2021-01-17","3","5551","2","893","26.7","24.4"
"Early","2021-01-18","40","5591","2","895","25.5","23.7"
"Early","2021-01-19","45","5636","10","905","26","23.2"
"Early","2021-01-20","57","5693","8","913","26.6","22.7"
"Early","2021-01-21","70","5763","7","920","26","22"
"Early","2021-01-22","47","5810","8","928","26.1","22.3"
"Early","2021-01-23","20","5830","4","932","22.1","21"
"Early","2021-01-24","1","5831","0","932","12.6","19.7"
"Early","2021-01-25","50","5881","3","935","12.8","19.1"
"Early","2021-01-26","51","5932","7","942","11.5","18.8"
"Early","2021-01-27","66","5998","9","951","11.5","19"
"Early","2021-01-28","56","6054","3","954","10.8","18.4"
"Early","2021-01-29","42","6096","4","958","9.7","17.9"
"Early","2021-01-30","12","6108","0","958","6.9","14.5"
"Early","2021-01-31","2","6110","0","958","6.9","9.8"
"Early","2021-02-01","51","6161","2","960","6.6","9.7"
"Early","2021-02-02","40","6201","4","964","6.1","8.8"
"Early","2021-02-03","43","6244","7","971","6.4","9"
"Early","2021-02-04","56","6300","5","976","7","8.9"
"Early","2021-02-05","30","6330","4","980","7.5","8.6"
"Early","2021-02-06","4","6334","0","980","7.5","7.2"
"Early","2021-02-07","0","6334","0","980","7.5","7.2"
"Early","2021-02-08","0","6334","0","980","6.9","6.8"
"Echols","2020-02-01","0","0","0","0",".","."
"Echols","2020-02-02","0","0","0","0",".","."
"Echols","2020-02-03","0","0","0","0",".","."
"Echols","2020-02-04","0","0","0","0",".","."
"Echols","2020-02-05","0","0","0","0",".","."
"Echols","2020-02-06","0","0","0","0",".","."
"Echols","2020-02-07","0","0","0","0","0","."
"Echols","2020-02-08","0","0","0","0","0","."
"Echols","2020-02-09","0","0","0","0","0","."
"Echols","2020-02-10","0","0","0","0","0","."
"Echols","2020-02-11","0","0","0","0","0","."
"Echols","2020-02-12","0","0","0","0","0","."
"Echols","2020-02-13","0","0","0","0","0","."
"Echols","2020-02-14","0","0","0","0","0","0"
"Echols","2020-02-15","0","0","0","0","0","0"
"Echols","2020-02-16","0","0","0","0","0","0"
"Echols","2020-02-17","0","0","0","0","0","0"
"Echols","2020-02-18","0","0","0","0","0","0"
"Echols","2020-02-19","0","0","0","0","0","0"
"Echols","2020-02-20","0","0","0","0","0","0"
"Echols","2020-02-21","0","0","0","0","0","0"
"Echols","2020-02-22","0","0","0","0","0","0"
"Echols","2020-02-23","0","0","0","0","0","0"
"Echols","2020-02-24","0","0","0","0","0","0"
"Echols","2020-02-25","0","0","0","0","0","0"
"Echols","2020-02-26","0","0","0","0","0","0"
"Echols","2020-02-27","0","0","0","0","0","0"
"Echols","2020-02-28","0","0","0","0","0","0"
"Echols","2020-02-29","0","0","0","0","0","0"
"Echols","2020-03-01","0","0","0","0","0","0"
"Echols","2020-03-02","0","0","0","0","0","0"
"Echols","2020-03-03","0","0","0","0","0","0"
"Echols","2020-03-04","0","0","0","0","0","0"
"Echols","2020-03-05","0","0","0","0","0","0"
"Echols","2020-03-06","0","0","0","0","0","0"
"Echols","2020-03-07","0","0","0","0","0","0"
"Echols","2020-03-08","0","0","0","0","0","0"
"Echols","2020-03-09","0","0","0","0","0","0"
"Echols","2020-03-10","0","0","0","0","0","0"
"Echols","2020-03-11","0","0","0","0","0","0"
"Echols","2020-03-12","0","0","0","0","0","0"
"Echols","2020-03-13","0","0","0","0","0","0"
"Echols","2020-03-14","0","0","0","0","0","0"
"Echols","2020-03-15","0","0","0","0","0","0"
"Echols","2020-03-16","0","0","0","0","0","0"
"Echols","2020-03-17","0","0","0","0","0","0"
"Echols","2020-03-18","0","0","0","0","0","0"
"Echols","2020-03-19","0","0","0","0","0","0"
"Echols","2020-03-20","0","0","0","0","0","0"
"Echols","2020-03-21","0","0","0","0","0","0"
"Echols","2020-03-22","0","0","0","0","0","0"
"Echols","2020-03-23","0","0","0","0","0","0"
"Echols","2020-03-24","0","0","0","0","0","0"
"Echols","2020-03-25","0","0","0","0","0","0"
"Echols","2020-03-26","0","0","0","0","0","0"
"Echols","2020-03-27","1","1","0","0","0","0"
"Echols","2020-03-28","0","1","0","0","0","0"
"Echols","2020-03-29","0","1","0","0","0","0"
"Echols","2020-03-30","0","1","0","0","0","0"
"Echols","2020-03-31","1","2","0","0","0","0"
"Echols","2020-04-01","1","3","0","0","0","0"
"Echols","2020-04-02","2","5","0","0","0","0"
"Echols","2020-04-03","1","6","0","0","0","0"
"Echols","2020-04-04","2","8","0","0","0","0"
"Echols","2020-04-05","1","9","0","0","0","0"
"Echols","2020-04-06","2","11","1","1","7.1","3.6"
"Echols","2020-04-07","1","12","0","1","7.1","3.6"
"Echols","2020-04-08","1","13","0","1","7.1","3.6"
"Echols","2020-04-09","1","14","1","2","21.4","10.7"
"Echols","2020-04-10","0","14","0","2","21.4","10.7"
"Echols","2020-04-11","0","14","0","2","21.4","10.7"
"Echols","2020-04-12","0","14","0","2","21.4","10.7"
"Echols","2020-04-13","1","15","1","3","28.6","17.9"
"Echols","2020-04-14","1","16","1","4","42.9","25"
"Echols","2020-04-15","1","17","0","4","42.9","25"
"Echols","2020-04-16","1","18","0","4","28.6","25"
"Echols","2020-04-17","5","23","1","5","31.4","26.4"
"Echols","2020-04-18","1","24","1","6","45.7","33.6"
"Echols","2020-04-19","1","25","1","7","60","40.7"
"Echols","2020-04-20","1","26","0","7","45.7","37.1"
"Echols","2020-04-21","1","27","0","7","31.4","37.1"
"Echols","2020-04-22","1","28","0","7","31.4","37.1"
"Echols","2020-04-23","0","28","0","7","31.4","30"
"Echols","2020-04-24","0","28","0","7","28.6","30"
"Echols","2020-04-25","0","28","0","7","14.3","30"
"Echols","2020-04-26","0","28","0","7","0","30"
"Echols","2020-04-27","2","30","0","7","0","22.9"
"Echols","2020-04-28","0","30","0","7","0","15.7"
"Echols","2020-04-29","0","30","0","7","0","15.7"
"Echols","2020-04-30","1","31","1","8","14.3","22.9"
"Echols","2020-05-01","4","35","3","11","25","26.8"
"Echols","2020-05-02","0","35","0","11","25","19.6"
"Echols","2020-05-03","0","35","0","11","25","12.5"
"Echols","2020-05-04","5","40","2","13","30.7","15.4"
"Echols","2020-05-05","4","44","0","13","30.7","15.4"
"Echols","2020-05-06","12","56","0","13","30.7","15.4"
"Echols","2020-05-07","6","62","3","16","23.6","18.9"
"Echols","2020-05-08","2","64","0","16","12.9","18.9"
"Echols","2020-05-09","2","66","0","16","12.9","18.9"
"Echols","2020-05-10","0","66","0","16","12.9","18.9"
"Echols","2020-05-11","3","69","1","17","11.9","21.3"
"Echols","2020-05-12","0","69","0","17","11.9","21.3"
"Echols","2020-05-13","17","86","16","33","25.4","28"
"Echols","2020-05-14","13","99","9","42","28.1","25.8"
"Echols","2020-05-15","3","102","2","44","37.6","25.2"
"Echols","2020-05-16","0","102","0","44","37.6","25.2"
"Echols","2020-05-17","0","102","0","44","37.6","25.2"
"Echols","2020-05-18","13","115","7","51","40.6","26.2"
"Echols","2020-05-19","2","117","1","52","47.7","29.8"
"Echols","2020-05-20","27","144","2","54","35.3","30.3"
"Echols","2020-05-21","46","190","13","67","29.5","28.8"
"Echols","2020-05-22","4","194","1","68","23.5","30.6"
"Echols","2020-05-23","0","194","0","68","23.5","30.6"
"Echols","2020-05-24","0","194","0","68","23.5","30.6"
"Echols","2020-05-25","0","194","0","68","15.8","28.2"
"Echols","2020-05-26","14","208","5","73","13.8","30.7"
"Echols","2020-05-27","21","229","6","79","16.8","26"
"Echols","2020-05-28","22","251","6","85","16.7","23.1"
"Echols","2020-05-29","6","257","2","87","17.8","20.7"
"Echols","2020-05-30","0","257","0","87","17.8","20.7"
"Echols","2020-05-31","0","257","0","87","17.8","20.7"
"Echols","2020-06-01","2","259","0","87","17.8","16.8"
"Echols","2020-06-02","8","267","2","89","16.3","15"
"Echols","2020-06-03","66","333","20","109","16.6","16.7"
"Echols","2020-06-04","13","346","3","112","16","16.3"
"Echols","2020-06-05","3","349","0","112","11.2","14.5"
"Echols","2020-06-06","2","351","0","112","11.2","14.5"
"Echols","2020-06-07","3","354","2","114","20.7","19.3"
"Echols","2020-06-08","10","364","0","114","20.7","19.3"
"Echols","2020-06-09","15","379","3","117","20","18.2"
"Echols","2020-06-10","81","460","58","175","25.9","21.2"
"Echols","2020-06-11","68","528","11","186","24.9","20.4"
"Echols","2020-06-12","6","534","3","189","32.1","21.6"
"Echols","2020-06-13","4","538","4","193","46.3","28.8"
"Echols","2020-06-14","3","541","2","195","46.3","33.5"
"Echols","2020-06-15","9","550","2","197","49.5","35.1"
"Echols","2020-06-16","4","554","2","199","53.8","36.9"
"Echols","2020-06-17","41","595","10","209","47.1","36.5"
"Echols","2020-06-18","43","638","4","213","46.1","35.5"
"Echols","2020-06-19","7","645","3","216","45.1","38.6"
"Echols","2020-06-20","0","645","0","216","30.8","38.6"
"Echols","2020-06-21","0","645","0","216","21.3","33.8"
"Echols","2020-06-22","6","651","0","216","18.1","33.8"
"Echols","2020-06-23","1","652","0","216","10.9","32.4"
"Echols","2020-06-24","34","686","6","222","10","28.5"
"Echols","2020-06-25","28","714","0","222","8.6","27.4"
"Echols","2020-06-26","2","716","2","224","16.8","30.9"
"Echols","2020-06-27","0","716","0","224","16.8","23.8"
"Echols","2020-06-28","1","717","1","225","31.1","26.2"
"Echols","2020-06-29","8","725","0","225","31.1","24.6"
"Echols","2020-06-30","15","740","0","225","31.1","21"
"Echols","2020-07-01","24","764","0","225","28.6","19.3"
"Echols","2020-07-02","22","786","4","229","31.2","19.9"
"Echols","2020-07-03","0","786","0","229","16.9","16.8"
"Echols","2020-07-04","0","786","0","229","16.9","16.8"
"Echols","2020-07-05","1","787","0","229","2.6","16.8"
"Echols","2020-07-06","10","797","5","234","9.7","20.4"
"Echols","2020-07-07","14","811","5","239","14.8","23"
"Echols","2020-07-08","47","858","6","245","16.7","22.6"
"Echols","2020-07-09","29","887","4","249","16","23.6"
"Echols","2020-07-10","2","889","0","249","16","16.5"
"Echols","2020-07-11","3","892","1","250","20.8","18.8"
"Echols","2020-07-12","1","893","1","251","35.1","18.8"
"Echols","2020-07-13","6","899","0","251","27.9","18.8"
"Echols","2020-07-14","4","903","0","251","22.8","18.8"
"Echols","2020-07-15","49","952","6","257","22.8","19.7"
"Echols","2020-07-16","29","981","4","261","22.8","19.4"
"Echols","2020-07-17","6","987","0","261","22.8","19.4"
"Echols","2020-07-18","2","989","0","261","18","19.4"
"Echols","2020-07-19","2","991","0","261","3.7","19.4"
"Echols","2020-07-20","10","1001","0","261","3.7","15.8"
"Echols","2020-07-21","2","1003","0","261","3.7","13.3"
"Echols","2020-07-22","13","1016","0","261","2","12.4"
"Echols","2020-07-23","14","1030","1","262","1","11.9"
"Echols","2020-07-24","6","1036","0","262","1","11.9"
"Echols","2020-07-25","0","1036","0","262","1","9.5"
"Echols","2020-07-26","3","1039","2","264","10.5","7.1"
"Echols","2020-07-27","8","1047","4","268","17.7","10.7"
"Echols","2020-07-28","7","1054","0","268","17.7","10.7"
"Echols","2020-07-29","12","1066","2","270","20.1","11"
"Echols","2020-07-30","1","1067","0","270","19","10"
"Echols","2020-07-31","6","1073","3","273","26.2","13.6"
"Echols","2020-08-01","1","1074","1","274","40.5","20.7"
"Echols","2020-08-02","3","1077","0","274","31","20.7"
"Echols","2020-08-03","5","1082","0","274","23.8","20.7"
"Echols","2020-08-04","1","1083","0","274","23.8","20.7"
"Echols","2020-08-05","19","1102","3","277","23.7","21.9"
"Echols","2020-08-06","2","1104","0","277","23.7","21.4"
"Echols","2020-08-07","7","1111","2","279","20.6","23.4"
"Echols","2020-08-08","0","1111","0","279","6.3","23.4"
"Echols","2020-08-09","0","1111","0","279","6.3","18.6"
"Echols","2020-08-10","4","1115","2","281","13.5","18.6"
"Echols","2020-08-11","0","1115","0","281","13.5","18.6"
"Echols","2020-08-12","15","1130","0","281","11.2","17.5"
"Echols","2020-08-13","2","1132","0","281","11.2","17.5"
"Echols","2020-08-14","2","1134","0","281","7.1","13.9"
"Echols","2020-08-15","2","1136","0","281","7.1","6.7"
"Echols","2020-08-16","0","1136","0","281","7.1","6.7"
"Echols","2020-08-17","6","1142","4","285","9.5","11.5"
"Echols","2020-08-18","1","1143","0","285","9.5","11.5"
"Echols","2020-08-19","10","1153","0","285","9.5","10.4"
"Echols","2020-08-20","7","1160","2","287","13.6","12.4"
"Echols","2020-08-21","2","1162","0","287","13.6","10.4"
"Echols","2020-08-22","0","1162","0","287","13.6","10.4"
"Echols","2020-08-23","0","1162","0","287","13.6","10.4"
"Echols","2020-08-24","3","1165","2","289","13.6","11.6"
"Echols","2020-08-25","3","1168","0","289","13.6","11.6"
"Echols","2020-08-26","10","1178","1","290","15","12.3"
"Echols","2020-08-27","15","1193","3","293","13.8","13.7"
"Echols","2020-08-28","4","1197","1","294","17.4","15.5"
"Echols","2020-08-29","0","1197","0","294","17.4","15.5"
"Echols","2020-08-30","0","1197","0","294","17.4","15.5"
"Echols","2020-08-31","7","1204","1","295","9.9","11.8"
"Echols","2020-09-01","7","1211","2","297","14","13.8"
"Echols","2020-09-02","5","1216","0","297","12.6","13.8"
"Echols","2020-09-03","4","1220","0","297","9.7","11.8"
"Echols","2020-09-04","0","1220","0","297","6.1","11.8"
"Echols","2020-09-05","0","1220","0","297","6.1","11.8"
"Echols","2020-09-06","0","1220","0","297","6.1","11.8"
"Echols","2020-09-07","4","1224","0","297","4.1","7"
"Echols","2020-09-08","4","1228","0","297","0","7"
"Echols","2020-09-09","4","1232","1","298","3.6","8.1"
"Echols","2020-09-10","5","1237","0","298","3.6","6.6"
"Echols","2020-09-11","0","1237","0","298","3.6","4.8"
"Echols","2020-09-12","0","1237","0","298","3.6","4.8"
"Echols","2020-09-13","1","1238","0","298","3.6","4.8"
"Echols","2020-09-14","6","1244","0","298","3.6","3.8"
"Echols","2020-09-15","5","1249","0","298","3.6","1.8"
"Echols","2020-09-16","10","1259","0","298","0","1.8"
"Echols","2020-09-17","2","1261","2","300","14.3","8.9"
"Echols","2020-09-18","1","1262","0","300","14.3","8.9"
"Echols","2020-09-19","0","1262","0","300","14.3","8.9"
"Echols","2020-09-20","2","1264","0","300","14.3","8.9"
"Echols","2020-09-21","9","1273","0","300","14.3","8.9"
"Echols","2020-09-22","3","1276","0","300","14.3","8.9"
"Echols","2020-09-23","9","1285","1","301","15.9","7.9"
"Echols","2020-09-24","4","1289","0","301","1.6","7.9"
"Echols","2020-09-25","0","1289","0","301","1.6","7.9"
"Echols","2020-09-26","0","1289","0","301","1.6","7.9"
"Echols","2020-09-27","0","1289","0","301","1.6","7.9"
"Echols","2020-09-28","4","1293","1","302","5.2","9.7"
"Echols","2020-09-29","1","1294","0","302","5.2","9.7"
"Echols","2020-09-30","7","1301","1","303","5.6","10.7"
"Echols","2020-10-01","3","1304","0","303","5.6","3.6"
"Echols","2020-10-02","7","1311","0","303","5.6","3.6"
"Echols","2020-10-03","1","1312","0","303","5.6","3.6"
"Echols","2020-10-04","0","1312","0","303","5.6","3.6"
"Echols","2020-10-05","2","1314","2","305","16.3","10.7"
"Echols","2020-10-06","7","1321","0","305","16.3","10.7"
"Echols","2020-10-07","3","1324","0","305","14.3","9.9"
"Echols","2020-10-08","1","1325","0","305","14.3","9.9"
"Echols","2020-10-09","3","1328","0","305","14.3","9.9"
"Echols","2020-10-10","1","1329","0","305","14.3","9.9"
"Echols","2020-10-11","0","1329","0","305","14.3","9.9"
"Echols","2020-10-12","1","1330","0","305","0","8.2"
"Echols","2020-10-13","1","1331","0","305","0","8.2"
"Echols","2020-10-14","4","1335","0","305","0","7.1"
"Echols","2020-10-15","1","1336","0","305","0","7.1"
"Echols","2020-10-16","2","1338","0","305","0","7.1"
"Echols","2020-10-17","2","1340","0","305","0","7.1"
"Echols","2020-10-18","0","1340","0","305","0","7.1"
"Echols","2020-10-19","3","1343","0","305","0","0"
"Echols","2020-10-20","2","1345","1","306","7.1","3.6"
"Echols","2020-10-21","3","1348","0","306","7.1","3.6"
"Echols","2020-10-22","2","1350","0","306","7.1","3.6"
"Echols","2020-10-23","4","1354","1","307","10.7","5.4"
"Echols","2020-10-24","1","1355","1","308","25","12.5"
"Echols","2020-10-25","1","1356","0","308","25","12.5"
"Echols","2020-10-26","6","1362","0","308","25","12.5"
"Echols","2020-10-27","0","1362","0","308","17.9","12.5"
"Echols","2020-10-28","5","1367","0","308","17.9","12.5"
"Echols","2020-10-29","0","1367","0","308","17.9","12.5"
"Echols","2020-10-30","1","1368","0","308","14.3","12.5"
"Echols","2020-10-31","0","1368","0","308","0","12.5"
"Echols","2020-11-01","0","1368","0","308","0","12.5"
"Echols","2020-11-02","0","1368","0","308","0","12.5"
"Echols","2020-11-03","2","1370","0","308","0","8.9"
"Echols","2020-11-04","4","1374","0","308","0","8.9"
"Echols","2020-11-05","1","1375","0","308","0","8.9"
"Echols","2020-11-06","1","1376","0","308","0","7.1"
"Echols","2020-11-07","1","1377","1","309","14.3","7.1"
"Echols","2020-11-08","1","1378","0","309","14.3","7.1"
"Echols","2020-11-09","5","1383","1","310","17.1","8.6"
"Echols","2020-11-10","1","1384","0","310","17.1","8.6"
"Echols","2020-11-11","1","1385","0","310","17.1","8.6"
"Echols","2020-11-12","12","1397","1","311","18.3","9.2"
"Echols","2020-11-13","3","1400","1","312","23.1","11.5"
"Echols","2020-11-14","0","1400","0","312","8.8","11.5"
"Echols","2020-11-15","0","1400","0","312","8.8","11.5"
"Echols","2020-11-16","4","1404","1","313","9.5","13.3"
"Echols","2020-11-17","3","1407","1","314","14.3","15.7"
"Echols","2020-11-18","2","1409","0","314","14.3","15.7"
"Echols","2020-11-19","3","1412","2","316","22.6","20.5"
"Echols","2020-11-20","4","1416","2","318","25","24"
"Echols","2020-11-21","0","1416","0","318","25","16.9"
"Echols","2020-11-22","0","1416","0","318","25","16.9"
"Echols","2020-11-23","2","1418","1","319","28.6","19"
"Echols","2020-11-24","5","1423","2","321","29.5","21.9"
"Echols","2020-11-25","3","1426","1","322","34.3","24.3"
"Echols","2020-11-26","0","1426","0","322","24.8","23.7"
"Echols","2020-11-27","1","1427","0","322","17.6","21.3"
"Echols","2020-11-28","1","1428","0","322","17.6","21.3"
"Echols","2020-11-29","0","1428","0","322","17.6","21.3"
"Echols","2020-11-30","19","1447","6","328","15","21.8"
"Echols","2020-12-01","9","1456","3","331","14","21.8"
"Echols","2020-12-02","12","1468","4","335","14","24.2"
"Echols","2020-12-03","2","1470","0","335","14","19.4"
"Echols","2020-12-04","1","1471","1","336","28.3","23"
"Echols","2020-12-05","0","1471","0","336","28.3","23"
"Echols","2020-12-06","0","1471","0","336","28.3","23"
"Echols","2020-12-07","13","1484","2","338","26","20.5"
"Echols","2020-12-08","5","1489","1","339","24.1","19.1"
"Echols","2020-12-09","16","1505","3","342","22","18"
"Echols","2020-12-10","5","1510","2","344","27.7","20.9"
"Echols","2020-12-11","9","1519","2","346","16.6","22.5"
"Echols","2020-12-12","0","1519","0","346","16.6","22.5"
"Echols","2020-12-13","0","1519","0","346","16.6","22.5"
"Echols","2020-12-14","13","1532","3","349","17.7","21.9"
"Echols","2020-12-15","1","1533","1","350","29.1","26.6"
"Echols","2020-12-16","15","1548","1","351","27.4","24.7"
"Echols","2020-12-17","7","1555","5","356","31.9","29.8"
"Echols","2020-12-18","3","1558","3","359","43","29.8"
"Echols","2020-12-19","0","1558","0","359","43","29.8"
"Echols","2020-12-20","0","1558","0","359","43","29.8"
"Echols","2020-12-21","4","1562","2","361","46.9","32.3"
"Echols","2020-12-22","3","1565","0","361","32.6","30.9"
"Echols","2020-12-23","29","1594","4","365","33.6","30.5"
"Echols","2020-12-24","1","1595","0","365","23.4","27.7"
"Echols","2020-12-25","1","1596","1","366","23.4","33.2"
"Echols","2020-12-26","1","1597","1","367","37.7","40.4"
"Echols","2020-12-27","1","1598","0","367","37.7","40.4"
"Echols","2020-12-28","1","1599","0","367","30.5","38.7"
"Echols","2020-12-29","0","1599","0","367","30.5","31.6"
"Echols","2020-12-30","25","1624","4","371","30.9","32.2"
"Echols","2020-12-31","0","1624","0","371","30.9","27.1"
"Echols","2021-01-01","0","1624","0","371","16.6","20"
"Echols","2021-01-02","1","1625","0","371","2.3","20"
"Echols","2021-01-03","1","1626","0","371","2.3","20"
"Echols","2021-01-04","7","1633","2","373","6.4","18.5"
"Echols","2021-01-05","5","1638","1","374","9.2","19.9"
"Echols","2021-01-06","34","1672","6","380","9.5","20.2"
"Echols","2021-01-07","10","1682","1","381","10.9","20.9"
"Echols","2021-01-08","5","1687","1","382","13.7","15.2"
"Echols","2021-01-09","7","1694","5","387","23.9","13.1"
"Echols","2021-01-10","2","1696","1","388","31.1","16.7"
"Echols","2021-01-11","0","1696","0","388","27","16.7"
"Echols","2021-01-12","1","1697","0","388","24.2","16.7"
"Echols","2021-01-13","35","1732","1","389","22","15.8"
"Echols","2021-01-14","7","1739","1","390","22.7","16.8"
"Echols","2021-01-15","5","1744","0","390","19.8","16.8"
"Echols","2021-01-16","3","1747","0","390","9.6","16.8"
"Echols","2021-01-17","0","1747","0","390","2.4","16.8"
"Echols","2021-01-18","3","1750","1","391","7.2","17.1"
"Echols","2021-01-19","4","1754","1","392","10.8","17.5"
"Echols","2021-01-20","14","1768","2","394","12.4","17.2"
"Echols","2021-01-21","4","1772","0","394","10.4","16.5"
"Echols","2021-01-22","3","1775","1","395","15.1","17.5"
"Echols","2021-01-23","4","1779","1","396","18.7","14.1"
"Echols","2021-01-24","4","1783","3","399","29.4","15.9"
"Echols","2021-01-25","2","1785","0","399","24.7","15.9"
"Echols","2021-01-26","0","1785","0","399","21.1","15.9"
"Echols","2021-01-27","17","1802","1","400","19.9","16.2"
"Echols","2021-01-28","1","1803","0","400","19.9","15.1"
"Echols","2021-01-29","6","1809","1","401","17.5","16.3"
"Echols","2021-01-30","0","1809","0","401","13.9","16.3"
"Echols","2021-01-31","0","1809","0","401","3.2","16.3"
"Echols","2021-02-01","3","1812","1","402","8","16.3"
"Echols","2021-02-02","3","1815","1","403","12.7","16.9"
"Echols","2021-02-03","14","1829","1","404","12.9","16.4"
"Echols","2021-02-04","1","1830","0","404","12.9","16.4"
"Echols","2021-02-05","0","1830","0","404","10.5","14"
"Echols","2021-02-06","0","1830","0","404","10.5","12.2"
"Echols","2021-02-07","0","1830","0","404","10.5","6.9"
"Echols","2021-02-08","0","1830","0","404","5.8","6.9"
"Effingham","2020-02-01","0","0","0","0",".","."
"Effingham","2020-02-02","0","0","0","0",".","."
"Effingham","2020-02-03","0","0","0","0",".","."
"Effingham","2020-02-04","0","0","0","0",".","."
"Effingham","2020-02-05","0","0","0","0",".","."
"Effingham","2020-02-06","0","0","0","0",".","."
"Effingham","2020-02-07","0","0","0","0","0","."
"Effingham","2020-02-08","0","0","0","0","0","."
"Effingham","2020-02-09","0","0","0","0","0","."
"Effingham","2020-02-10","0","0","0","0","0","."
"Effingham","2020-02-11","0","0","0","0","0","."
"Effingham","2020-02-12","0","0","0","0","0","."
"Effingham","2020-02-13","0","0","0","0","0","."
"Effingham","2020-02-14","0","0","0","0","0","0"
"Effingham","2020-02-15","0","0","0","0","0","0"
"Effingham","2020-02-16","0","0","0","0","0","0"
"Effingham","2020-02-17","0","0","0","0","0","0"
"Effingham","2020-02-18","0","0","0","0","0","0"
"Effingham","2020-02-19","0","0","0","0","0","0"
"Effingham","2020-02-20","0","0","0","0","0","0"
"Effingham","2020-02-21","0","0","0","0","0","0"
"Effingham","2020-02-22","0","0","0","0","0","0"
"Effingham","2020-02-23","0","0","0","0","0","0"
"Effingham","2020-02-24","0","0","0","0","0","0"
"Effingham","2020-02-25","0","0","0","0","0","0"
"Effingham","2020-02-26","0","0","0","0","0","0"
"Effingham","2020-02-27","0","0","0","0","0","0"
"Effingham","2020-02-28","0","0","0","0","0","0"
"Effingham","2020-02-29","0","0","0","0","0","0"
"Effingham","2020-03-01","0","0","0","0","0","0"
"Effingham","2020-03-02","0","0","0","0","0","0"
"Effingham","2020-03-03","0","0","0","0","0","0"
"Effingham","2020-03-04","0","0","0","0","0","0"
"Effingham","2020-03-05","0","0","0","0","0","0"
"Effingham","2020-03-06","0","0","0","0","0","0"
"Effingham","2020-03-07","0","0","0","0","0","0"
"Effingham","2020-03-08","0","0","0","0","0","0"
"Effingham","2020-03-09","0","0","0","0","0","0"
"Effingham","2020-03-10","0","0","0","0","0","0"
"Effingham","2020-03-11","3","3","0","0","0","0"
"Effingham","2020-03-12","1","4","0","0","0","0"
"Effingham","2020-03-13","0","4","0","0","0","0"
"Effingham","2020-03-14","5","9","0","0","0","0"
"Effingham","2020-03-15","10","19","2","2","2.9","1.4"
"Effingham","2020-03-16","17","36","0","2","2.9","1.4"
"Effingham","2020-03-17","34","70","1","3","3.3","1.6"
"Effingham","2020-03-18","16","86","0","3","3.3","1.6"
"Effingham","2020-03-19","6","92","1","4","5.7","2.8"
"Effingham","2020-03-20","13","105","0","4","5.7","2.8"
"Effingham","2020-03-21","1","106","0","4","5.7","2.8"
"Effingham","2020-03-22","1","107","1","5","17.1","10"
"Effingham","2020-03-23","18","125","0","5","17.1","10"
"Effingham","2020-03-24","26","151","0","5","16.7","10"
"Effingham","2020-03-25","18","169","2","7","18.3","10.8"
"Effingham","2020-03-26","10","179","1","8","17.3","11.5"
"Effingham","2020-03-27","15","194","2","10","19.2","12.4"
"Effingham","2020-03-28","3","197","2","12","28.7","17.2"
"Effingham","2020-03-29","0","197","0","12","14.4","15.8"
"Effingham","2020-03-30","14","211","3","15","17.5","17.3"
"Effingham","2020-03-31","11","222","1","16","18.8","17.7"
"Effingham","2020-04-01","15","237","1","17","18.2","18.2"
"Effingham","2020-04-02","16","253","1","18","17.6","17.5"
"Effingham","2020-04-03","21","274","1","19","16.4","17.8"
"Effingham","2020-04-04","3","277","0","19","6.9","17.8"
"Effingham","2020-04-05","5","282","0","19","6.9","10.7"
"Effingham","2020-04-06","30","312","1","20","4.3","10.9"
"Effingham","2020-04-07","18","330","0","20","3","10.9"
"Effingham","2020-04-08","21","351","0","20","2","10.1"
"Effingham","2020-04-09","29","380","1","21","1.6","9.6"
"Effingham","2020-04-10","17","397","3","24","3.5","9.9"
"Effingham","2020-04-11","8","405","1","25","5.3","6.1"
"Effingham","2020-04-12","0","405","0","25","5.3","6.1"
"Effingham","2020-04-13","18","423","2","27","6.4","5.3"
"Effingham","2020-04-14","33","456","1","28","6.8","4.9"
"Effingham","2020-04-15","14","470","0","28","6.8","4.4"
"Effingham","2020-04-16","17","487","1","29","7.2","4.4"
"Effingham","2020-04-17","24","511","4","33","7","5.3"
"Effingham","2020-04-18","11","522","1","34","6.5","5.9"
"Effingham","2020-04-19","4","526","0","34","6.5","5.9"
"Effingham","2020-04-20","22","548","2","36","6.3","6.3"
"Effingham","2020-04-21","52","600","3","39","6.6","6.7"
"Effingham","2020-04-22","40","640","1","40","7","6.9"
"Effingham","2020-04-23","34","674","1","41","6.6","6.9"
"Effingham","2020-04-24","22","696","0","41","4.2","5.6"
"Effingham","2020-04-25","6","702","0","41","2.9","4.7"
"Effingham","2020-04-26","4","706","0","41","2.9","4.7"
"Effingham","2020-04-27","15","721","0","41","1.6","3.9"
"Effingham","2020-04-28","19","740","0","41","0.8","3.7"
"Effingham","2020-04-29","33","773","1","42","0.9","3.9"
"Effingham","2020-04-30","20","793","0","42","0.4","3.5"
"Effingham","2020-05-01","17","810","2","44","2.1","3.2"
"Effingham","2020-05-02","9","819","0","44","2.1","2.5"
"Effingham","2020-05-03","8","827","0","44","2.1","2.5"
"Effingham","2020-05-04","19","846","0","44","2.1","1.9"
"Effingham","2020-05-05","9","855","0","44","2.1","1.4"
"Effingham","2020-05-06","19","874","0","44","1.7","1.3"
"Effingham","2020-05-07","12","886","0","44","1.7","1.1"
"Effingham","2020-05-08","268","1154","6","50","0.3","1.2"
"Effingham","2020-05-09","4","1158","0","50","0.3","1.2"
"Effingham","2020-05-10","4","1162","0","50","0.3","1.2"
"Effingham","2020-05-11","15","1177","0","50","0.3","1.2"
"Effingham","2020-05-12","26","1203","0","50","0.3","1.2"
"Effingham","2020-05-13","19","1222","0","50","0.3","1"
"Effingham","2020-05-14","38","1260","0","50","0.3","1"
"Effingham","2020-05-15","215","1475","10","60","0.7","0.5"
"Effingham","2020-05-16","5","1480","0","60","0.7","0.5"
"Effingham","2020-05-17","6","1486","0","60","0.7","0.5"
"Effingham","2020-05-18","16","1502","0","60","0.7","0.5"
"Effingham","2020-05-19","22","1524","2","62","2","1.1"
"Effingham","2020-05-20","25","1549","0","62","2","1.1"
"Effingham","2020-05-21","25","1574","0","62","2","1.1"
"Effingham","2020-05-22","103","1677","13","75","3.1","1.9"
"Effingham","2020-05-23","10","1687","0","75","3.1","1.9"
"Effingham","2020-05-24","1","1688","0","75","3.1","1.9"
"Effingham","2020-05-25","8","1696","0","75","3.1","1.9"
"Effingham","2020-05-26","42","1738","1","76","2.1","2.1"
"Effingham","2020-05-27","22","1760","0","76","2.1","2.1"
"Effingham","2020-05-28","27","1787","1","77","2.7","2.3"
"Effingham","2020-05-29","42","1829","0","77","0.9","2"
"Effingham","2020-05-30","8","1837","0","77","0.9","2"
"Effingham","2020-05-31","14","1851","0","77","0.9","2"
"Effingham","2020-06-01","40","1891","0","77","0.9","2"
"Effingham","2020-06-02","37","1928","2","79","1.3","1.7"
"Effingham","2020-06-03","20","1948","1","80","2","2.1"
"Effingham","2020-06-04","29","1977","0","80","1.5","2.1"
"Effingham","2020-06-05","17","1994","0","80","1.5","1.2"
"Effingham","2020-06-06","7","2001","0","80","1.5","1.2"
"Effingham","2020-06-07","7","2008","0","80","1.5","1.2"
"Effingham","2020-06-08","30","2038","3","83","2.9","1.9"
"Effingham","2020-06-09","24","2062","1","84","2.7","2"
"Effingham","2020-06-10","17","2079","1","85","2.9","2.4"
"Effingham","2020-06-11","36","2115","3","88","4.1","2.8"
"Effingham","2020-06-12","25","2140","2","90","5.2","3.3"
"Effingham","2020-06-13","15","2155","0","90","5.2","3.3"
"Effingham","2020-06-14","11","2166","0","90","5.2","3.3"
"Effingham","2020-06-15","37","2203","3","93","4.9","3.9"
"Effingham","2020-06-16","48","2251","4","97","5.5","4.1"
"Effingham","2020-06-17","31","2282","4","101","6.5","4.7"
"Effingham","2020-06-18","42","2324","2","103","6","5"
"Effingham","2020-06-19","40","2364","2","105","5.6","5.4"
"Effingham","2020-06-20","70","2434","1","106","5.8","5.5"
"Effingham","2020-06-21","15","2449","4","110","9.6","7.4"
"Effingham","2020-06-22","91","2540","11","121","10.2","7.5"
"Effingham","2020-06-23","59","2599","10","131","11.4","8.5"
"Effingham","2020-06-24","97","2696","8","139","10.7","8.6"
"Effingham","2020-06-25","116","2812","6","145","10.8","8.4"
"Effingham","2020-06-26","71","2883","6","151","11.3","8.4"
"Effingham","2020-06-27","41","2924","7","158","13.5","9.7"
"Effingham","2020-06-28","17","2941","1","159","10.6","10.1"
"Effingham","2020-06-29","85","3026","11","170","10.7","10.4"
"Effingham","2020-06-30","114","3140","17","187","10.4","10.9"
"Effingham","2020-07-01","78","3218","9","196","10.9","10.8"
"Effingham","2020-07-02","102","3320","13","209","11.9","11.4"
"Effingham","2020-07-03","44","3364","7","216","13","12.1"
"Effingham","2020-07-04","18","3382","3","219","12.9","13.2"
"Effingham","2020-07-05","30","3412","4","223","14","12.3"
"Effingham","2020-07-06","205","3617","20","243","13.6","12.1"
"Effingham","2020-07-07","163","3780","24","267","13.5","12"
"Effingham","2020-07-08","141","3921","14","281","13.3","12.1"
"Effingham","2020-07-09","163","4084","57","338","16.5","14.2"
"Effingham","2020-07-10","145","4229","12","350","15.4","14.2"
"Effingham","2020-07-11","26","4255","10","360","18.5","15.7"
"Effingham","2020-07-12","29","4284","6","366","19.5","16.8"
"Effingham","2020-07-13","109","4393","18","384","20.5","17"
"Effingham","2020-07-14","122","4515","18","402","20.5","17"
"Effingham","2020-07-15","173","4688","22","424","20.9","17.1"
"Effingham","2020-07-16","106","4794","21","445","18.7","17.6"
"Effingham","2020-07-17","157","4951","15","460","18.9","17.2"
"Effingham","2020-07-18","30","4981","7","467","16.8","17.6"
"Effingham","2020-07-19","38","5019","5","472","15.7","17.6"
"Effingham","2020-07-20","170","5189","18","490","14.8","17.7"
"Effingham","2020-07-21","88","5277","10","500","14.4","17.4"
"Effingham","2020-07-22","171","5448","13","513","13.6","17.3"
"Effingham","2020-07-23","57","5505","11","524","13.6","16.2"
"Effingham","2020-07-24","159","5664","10","534","13.1","16"
"Effingham","2020-07-25","44","5708","10","544","13","14.9"
"Effingham","2020-07-26","23","5731","7","551","15.5","15.6"
"Effingham","2020-07-27","99","5830","20","571","16.8","15.8"
"Effingham","2020-07-28","77","5907","19","590","18.7","16.6"
"Effingham","2020-07-29","146","6053","14","604","19","16.3"
"Effingham","2020-07-30","82","6135","19","623","19.6","16.6"
"Effingham","2020-07-31","129","6264","13","636","20.1","16.6"
"Effingham","2020-08-01","38","6302","5","641","18.8","15.9"
"Effingham","2020-08-02","34","6336","3","644","15.7","15.6"
"Effingham","2020-08-03","100","6436","23","667","16.1","16.5"
"Effingham","2020-08-04","49","6485","13","680","16.3","17.5"
"Effingham","2020-08-05","149","6634","11","691","16","17.5"
"Effingham","2020-08-06","94","6728","13","704","14.7","17.1"
"Effingham","2020-08-07","181","6909","19","723","14.7","17.4"
"Effingham","2020-08-08","36","6945","5","728","14.9","16.8"
"Effingham","2020-08-09","21","6966","5","733","17","16.3"
"Effingham","2020-08-10","99","7065","19","752","16.4","16.3"
"Effingham","2020-08-11","108","7173","12","764","14.2","15.3"
"Effingham","2020-08-12","165","7338","18","782","14.7","15.4"
"Effingham","2020-08-13","82","7420","12","794","14.9","14.8"
"Effingham","2020-08-14","163","7583","11","805","14.3","14.5"
"Effingham","2020-08-15","26","7609","4","809","14.5","14.7"
"Effingham","2020-08-16","31","7640","10","819","15.7","16.4"
"Effingham","2020-08-17","100","7740","19","838","15.7","16.1"
"Effingham","2020-08-18","84","7824","14","852","16.5","15.4"
"Effingham","2020-08-19","230","8054","28","880","16.7","15.7"
"Effingham","2020-08-20","99","8153","15","895","16.8","15.8"
"Effingham","2020-08-21","174","8327","19","914","17.4","15.8"
"Effingham","2020-08-22","32","8359","6","920","17.8","16.2"
"Effingham","2020-08-23","34","8393","3","923","14.5","15.1"
"Effingham","2020-08-24","96","8489","8","931","13","14.3"
"Effingham","2020-08-25","70","8559","10","941","12.6","14.6"
"Effingham","2020-08-26","165","8724","24","965","13","14.8"
"Effingham","2020-08-27","75","8799","5","970","11.8","14.3"
"Effingham","2020-08-28","194","8993","15","985","11.3","14.3"
"Effingham","2020-08-29","19","9012","6","991","13.1","15.5"
"Effingham","2020-08-30","36","9048","9","1000","15.4","15"
"Effingham","2020-08-31","84","9132","18","1018","17.3","15.1"
"Effingham","2020-09-01","73","9205","9","1027","17","14.8"
"Effingham","2020-09-02","162","9367","19","1046","16.6","14.8"
"Effingham","2020-09-03","55","9422","7","1053","17.5","14.6"
"Effingham","2020-09-04","134","9556","17","1070","18.2","14.8"
"Effingham","2020-09-05","24","9580","2","1072","14.9","14"
"Effingham","2020-09-06","19","9599","7","1079","16.6","16"
"Effingham","2020-09-07","15","9614","2","1081","15.4","16.4"
"Effingham","2020-09-08","89","9703","8","1089","14.9","16"
"Effingham","2020-09-09","172","9875","19","1108","14.9","15.7"
"Effingham","2020-09-10","64","9939","7","1115","14.6","16"
"Effingham","2020-09-11","107","10046","10","1125","14.1","16.2"
"Effingham","2020-09-12","34","10080","5","1130","15","15"
"Effingham","2020-09-13","45","10125","8","1138","12.3","14.4"
"Effingham","2020-09-14","101","10226","8","1146","11.5","13.5"
"Effingham","2020-09-15","62","10288","5","1151","11.4","13.2"
"Effingham","2020-09-16","62","10350","6","1157","11.2","13"
"Effingham","2020-09-17","78","10428","10","1167","11.5","13"
"Effingham","2020-09-18","156","10584","8","1175","10.9","12.5"
"Effingham","2020-09-19","26","10610","3","1178","10.4","12.7"
"Effingham","2020-09-20","16","10626","3","1181","10.6","11.4"
"Effingham","2020-09-21","89","10715","8","1189","10.7","11.1"
"Effingham","2020-09-22","63","10778","4","1193","10.5","10.9"
"Effingham","2020-09-23","127","10905","18","1211","11.1","11.2"
"Effingham","2020-09-24","56","10961","4","1215","10.3","10.9"
"Effingham","2020-09-25","107","11068","9","1224","10.8","10.8"
"Effingham","2020-09-26","17","11085","2","1226","10.8","10.6"
"Effingham","2020-09-27","9","11094","3","1229","12.9","11.7"
"Effingham","2020-09-28","79","11173","5","1234","12.5","11.6"
"Effingham","2020-09-29","61","11234","12","1246","14.4","12.4"
"Effingham","2020-09-30","127","11361","23","1269","15","13"
"Effingham","2020-10-01","67","11428","6","1275","15.2","12.8"
"Effingham","2020-10-02","109","11537","9","1284","15.2","13"
"Effingham","2020-10-03","51","11588","1","1285","13.8","12.3"
"Effingham","2020-10-04","15","11603","3","1288","11.9","12.4"
"Effingham","2020-10-05","85","11688","6","1294","12","12.3"
"Effingham","2020-10-06","107","11795","7","1301","10.1","12.3"
"Effingham","2020-10-07","156","11951","13","1314","8.7","11.8"
"Effingham","2020-10-08","76","12027","7","1321","8.8","12"
"Effingham","2020-10-09","223","12250","29","1350","9.4","12.3"
"Effingham","2020-10-10","42","12292","9","1359","12.2","13"
"Effingham","2020-10-11","19","12311","3","1362","11.6","11.8"
"Effingham","2020-10-12","78","12389","8","1370","12.1","12"
"Effingham","2020-10-13","111","12500","10","1380","12.4","11.3"
"Effingham","2020-10-14","70","12570","16","1396","14.5","11.6"
"Effingham","2020-10-15","89","12659","13","1409","15.3","12"
"Effingham","2020-10-16","179","12838","16","1425","14.7","12.1"
"Effingham","2020-10-17","24","12862","3","1428","13.4","12.8"
"Effingham","2020-10-18","29","12891","6","1434","14.1","12.9"
"Effingham","2020-10-19","103","12994","6","1440","13.5","12.8"
"Effingham","2020-10-20","105","13099","12","1452","13.8","13.1"
"Effingham","2020-10-21","66","13165","10","1462","12.7","13.6"
"Effingham","2020-10-22","93","13258","7","1469","11.7","13.5"
"Effingham","2020-10-23","155","13413","14","1483","11.7","13.2"
"Effingham","2020-10-24","27","13440","5","1488","12.6","13"
"Effingham","2020-10-25","34","13474","7","1495","12.6","13.4"
"Effingham","2020-10-26","87","13561","6","1501","12.7","13.1"
"Effingham","2020-10-27","89","13650","8","1509","12.4","13.1"
"Effingham","2020-10-28","78","13728","5","1514","11.1","11.9"
"Effingham","2020-10-29","94","13822","8","1522","11.3","11.5"
"Effingham","2020-10-30","178","14000","7","1529","10.5","11.1"
"Effingham","2020-10-31","34","14034","3","1532","9.2","10.9"
"Effingham","2020-11-01","18","14052","3","1535","8.6","10.6"
"Effingham","2020-11-02","65","14117","6","1541","8.9","10.8"
"Effingham","2020-11-03","119","14236","8","1549","8.6","10.5"
"Effingham","2020-11-04","67","14303","10","1559","9.8","10.5"
"Effingham","2020-11-05","87","14390","7","1566","9.8","10.5"
"Effingham","2020-11-06","153","14543","6","1572","9.8","10.2"
"Effingham","2020-11-07","28","14571","6","1578","11.6","10.4"
"Effingham","2020-11-08","33","14604","3","1581","10.5","9.5"
"Effingham","2020-11-09","102","14706","14","1595","11.1","10"
"Effingham","2020-11-10","90","14796","10","1605","11.7","10.2"
"Effingham","2020-11-11","56","14852","6","1611","11.1","10.5"
"Effingham","2020-11-12","120","14972","11","1622","11.3","10.5"
"Effingham","2020-11-13","168","15140","7","1629","11.3","10.6"
"Effingham","2020-11-14","42","15182","4","1633","9.6","10.6"
"Effingham","2020-11-15","31","15213","7","1640","11.6","11"
"Effingham","2020-11-16","109","15322","12","1652","11.2","11.2"
"Effingham","2020-11-17","120","15442","7","1659","10.4","11.1"
"Effingham","2020-11-18","72","15514","8","1667","10.5","10.8"
"Effingham","2020-11-19","82","15596","9","1676","10.7","11"
"Effingham","2020-11-20","216","15812","8","1684","10.7","11"
"Effingham","2020-11-21","35","15847","4","1688","10.9","10.3"
"Effingham","2020-11-22","36","15883","4","1692","9.3","10.4"
"Effingham","2020-11-23","94","15977","5","1697","8.5","9.8"
"Effingham","2020-11-24","67","16044","10","1707","9.8","10.1"
"Effingham","2020-11-25","99","16143","8","1715","9.4","9.9"
"Effingham","2020-11-26","12","16155","2","1717","10.2","10.5"
"Effingham","2020-11-27","49","16204","13","1730","13.4","12.1"
"Effingham","2020-11-28","36","16240","7","1737","14.6","12.8"
"Effingham","2020-11-29","33","16273","2","1739","13.9","11.6"
"Effingham","2020-11-30","98","16371","8","1747","14.3","11.4"
"Effingham","2020-12-01","79","16450","8","1755","13.6","11.7"
"Effingham","2020-12-02","117","16567","6","1761","13.2","11.3"
"Effingham","2020-12-03","66","16633","5","1766","11.9","11"
"Effingham","2020-12-04","145","16778","17","1783","9.7","11.6"
"Effingham","2020-12-05","41","16819","5","1788","8.7","11.6"
"Effingham","2020-12-06","38","16857","9","1797","11.2","12.5"
"Effingham","2020-12-07","86","16943","10","1807","11.7","13"
"Effingham","2020-12-08","99","17042","7","1814","11.3","12.4"
"Effingham","2020-12-09","109","17151","8","1822","11.6","12.4"
"Effingham","2020-12-10","88","17239","7","1829","11.7","11.8"
"Effingham","2020-12-11","191","17430","15","1844","11.1","10.4"
"Effingham","2020-12-12","66","17496","13","1857","12.2","10.4"
"Effingham","2020-12-13","45","17541","6","1863","10.7","11"
"Effingham","2020-12-14","160","17701","18","1881","10.6","11.2"
"Effingham","2020-12-15","128","17829","21","1902","12","11.6"
"Effingham","2020-12-16","154","17983","13","1915","12.1","11.9"
"Effingham","2020-12-17","111","18094","12","1927","12.5","12.1"
"Effingham","2020-12-18","208","18302","21","1948","12.9","12"
"Effingham","2020-12-19","44","18346","5","1953","11.7","11.9"
"Effingham","2020-12-20","39","18385","7","1960","12.3","11.5"
"Effingham","2020-12-21","129","18514","26","1986","13.6","12.1"
"Effingham","2020-12-22","96","18610","10","1996","12.7","12.4"
"Effingham","2020-12-23","122","18732","17","2013","13.5","12.8"
"Effingham","2020-12-24","67","18799","11","2024","14.3","13.4"
"Effingham","2020-12-25","20","18819","3","2027","15","13.9"
"Effingham","2020-12-26","62","18881","10","2037","15.7","13.7"
"Effingham","2020-12-27","45","18926","11","2048","16.6","14.5"
"Effingham","2020-12-28","118","19044","21","2069","16.3","15"
"Effingham","2020-12-29","219","19263","24","2093","16.4","14.6"
"Effingham","2020-12-30","136","19399","27","2120","17.2","15.4"
"Effingham","2020-12-31","88","19487","9","2129","16.3","15.3"
"Effingham","2021-01-01","27","19514","12","2141","20.6","17.8"
"Effingham","2021-01-02","41","19555","8","2149","21","18.4"
"Effingham","2021-01-03","39","19594","15","2164","23","19.8"
"Effingham","2021-01-04","89","19683","18","2182","23.4","19.8"
"Effingham","2021-01-05","137","19820","27","2209","24.6","20.5"
"Effingham","2021-01-06","134","19954","21","2230","24","20.6"
"Effingham","2021-01-07","177","20131","28","2258","24.8","20.6"
"Effingham","2021-01-08","307","20438","28","2286","19.8","20.2"
"Effingham","2021-01-09","68","20506","17","2303","20.6","20.8"
"Effingham","2021-01-10","55","20561","8","2311","17.2","20.1"
"Effingham","2021-01-11","152","20713","29","2340","17","20.2"
"Effingham","2021-01-12","190","20903","33","2373","16.7","20.6"
"Effingham","2021-01-13","189","21092","25","2398","16.3","20.2"
"Effingham","2021-01-14","131","21223","22","2420","16.4","20.6"
"Effingham","2021-01-15","245","21468","29","2449","16.8","18.3"
"Effingham","2021-01-16","64","21532","16","2465","16.8","18.7"
"Effingham","2021-01-17","51","21583","9","2474","17.3","17.2"
"Effingham","2021-01-18","184","21767","19","2493","16","16.5"
"Effingham","2021-01-19","142","21909","24","2517","16","16.3"
"Effingham","2021-01-20","202","22111","16","2533","15.2","15.8"
"Effingham","2021-01-21","139","22250","18","2551","14.7","15.6"
"Effingham","2021-01-22","286","22536","28","2579","14.4","15.6"
"Effingham","2021-01-23","72","22608","20","2599","14.8","15.8"
"Effingham","2021-01-24","53","22661","20","2619","17.6","17.5"
"Effingham","2021-01-25","197","22858","33","2652","18.5","17.3"
"Effingham","2021-01-26","196","23054","39","2691","19","17.5"
"Effingham","2021-01-27","205","23259","32","2723","20.1","17.6"
"Effingham","2021-01-28","176","23435","27","2750","20.4","17.5"
"Effingham","2021-01-29","261","23696","40","2790","21.2","17.8"
"Effingham","2021-01-30","74","23770","12","2802","19.6","17.2"
"Effingham","2021-01-31","55","23825","11","2813","17","17.3"
"Effingham","2021-02-01","192","24017","19","2832","16","17.3"
"Effingham","2021-02-02","170","24187","25","2857","15.3","17.1"
"Effingham","2021-02-03","136","24323","16","2873","14.7","17.4"
"Effingham","2021-02-04","177","24500","29","2902","14.9","17.7"
"Effingham","2021-02-05","170","24670","11","2913","13.6","17.4"
"Effingham","2021-02-06","13","24683","1","2914","12.4","16"
"Effingham","2021-02-07","0","24683","0","2914","9.6","13.3"
"Effingham","2021-02-08","0","24683","0","2914","8.1","12.1"
"Elbert","2020-02-01","0","0","0","0",".","."
"Elbert","2020-02-02","0","0","0","0",".","."
"Elbert","2020-02-03","0","0","0","0",".","."
"Elbert","2020-02-04","0","0","0","0",".","."
"Elbert","2020-02-05","0","0","0","0",".","."
"Elbert","2020-02-06","0","0","0","0",".","."
"Elbert","2020-02-07","0","0","0","0","0","."
"Elbert","2020-02-08","0","0","0","0","0","."
"Elbert","2020-02-09","0","0","0","0","0","."
"Elbert","2020-02-10","0","0","0","0","0","."
"Elbert","2020-02-11","0","0","0","0","0","."
"Elbert","2020-02-12","0","0","0","0","0","."
"Elbert","2020-02-13","0","0","0","0","0","."
"Elbert","2020-02-14","0","0","0","0","0","0"
"Elbert","2020-02-15","0","0","0","0","0","0"
"Elbert","2020-02-16","0","0","0","0","0","0"
"Elbert","2020-02-17","0","0","0","0","0","0"
"Elbert","2020-02-18","0","0","0","0","0","0"
"Elbert","2020-02-19","0","0","0","0","0","0"
"Elbert","2020-02-20","0","0","0","0","0","0"
"Elbert","2020-02-21","0","0","0","0","0","0"
"Elbert","2020-02-22","0","0","0","0","0","0"
"Elbert","2020-02-23","0","0","0","0","0","0"
"Elbert","2020-02-24","0","0","0","0","0","0"
"Elbert","2020-02-25","0","0","0","0","0","0"
"Elbert","2020-02-26","0","0","0","0","0","0"
"Elbert","2020-02-27","0","0","0","0","0","0"
"Elbert","2020-02-28","0","0","0","0","0","0"
"Elbert","2020-02-29","0","0","0","0","0","0"
"Elbert","2020-03-01","0","0","0","0","0","0"
"Elbert","2020-03-02","0","0","0","0","0","0"
"Elbert","2020-03-03","0","0","0","0","0","0"
"Elbert","2020-03-04","0","0","0","0","0","0"
"Elbert","2020-03-05","0","0","0","0","0","0"
"Elbert","2020-03-06","0","0","0","0","0","0"
"Elbert","2020-03-07","0","0","0","0","0","0"
"Elbert","2020-03-08","0","0","0","0","0","0"
"Elbert","2020-03-09","1","1","0","0","0","0"
"Elbert","2020-03-10","0","1","0","0","0","0"
"Elbert","2020-03-11","0","1","0","0","0","0"
"Elbert","2020-03-12","0","1","0","0","0","0"
"Elbert","2020-03-13","0","1","0","0","0","0"
"Elbert","2020-03-14","0","1","0","0","0","0"
"Elbert","2020-03-15","0","1","0","0","0","0"
"Elbert","2020-03-16","4","5","0","0","0","0"
"Elbert","2020-03-17","2","7","0","0","0","0"
"Elbert","2020-03-18","13","20","0","0","0","0"
"Elbert","2020-03-19","4","24","0","0","0","0"
"Elbert","2020-03-20","6","30","0","0","0","0"
"Elbert","2020-03-21","0","30","0","0","0","0"
"Elbert","2020-03-22","0","30","0","0","0","0"
"Elbert","2020-03-23","2","32","0","0","0","0"
"Elbert","2020-03-24","4","36","0","0","0","0"
"Elbert","2020-03-25","7","43","0","0","0","0"
"Elbert","2020-03-26","6","49","0","0","0","0"
"Elbert","2020-03-27","6","55","1","1","2.4","1.2"
"Elbert","2020-03-28","6","61","0","1","2.4","1.2"
"Elbert","2020-03-29","4","65","0","1","2.4","1.2"
"Elbert","2020-03-30","1","66","0","1","2.4","1.2"
"Elbert","2020-03-31","4","70","0","1","2.4","1.2"
"Elbert","2020-04-01","3","73","1","2","7.1","3.6"
"Elbert","2020-04-02","3","76","0","2","7.1","3.6"
"Elbert","2020-04-03","6","82","0","2","4.8","3.6"
"Elbert","2020-04-04","4","86","0","2","4.8","3.6"
"Elbert","2020-04-05","3","89","0","2","4.8","3.6"
"Elbert","2020-04-06","2","91","0","2","4.8","3.6"
"Elbert","2020-04-07","7","98","3","5","10.9","6.6"
"Elbert","2020-04-08","1","99","0","5","6.1","6.6"
"Elbert","2020-04-09","2","101","0","5","6.1","6.6"
"Elbert","2020-04-10","1","102","0","5","6.1","5.4"
"Elbert","2020-04-11","2","104","0","5","6.1","5.4"
"Elbert","2020-04-12","1","105","0","5","6.1","5.4"
"Elbert","2020-04-13","5","110","1","6","9","6.9"
"Elbert","2020-04-14","5","115","0","6","2.9","6.9"
"Elbert","2020-04-15","10","125","0","6","2.9","4.5"
"Elbert","2020-04-16","2","127","0","6","2.9","4.5"
"Elbert","2020-04-17","7","134","1","7","4.9","5.5"
"Elbert","2020-04-18","1","135","0","7","4.9","5.5"
"Elbert","2020-04-19","3","138","0","7","4.9","5.5"
"Elbert","2020-04-20","9","147","3","10","6.8","7.9"
"Elbert","2020-04-21","7","154","2","12","10.9","6.9"
"Elbert","2020-04-22","9","163","1","13","12.5","7.7"
"Elbert","2020-04-23","5","168","1","14","15.3","9.1"
"Elbert","2020-04-24","12","180","3","17","16.9","10.9"
"Elbert","2020-04-25","4","184","0","17","16.9","10.9"
"Elbert","2020-04-26","2","186","0","17","16.9","10.9"
"Elbert","2020-04-27","12","198","5","22","18","12.4"
"Elbert","2020-04-28","6","204","0","22","14","12.4"
"Elbert","2020-04-29","9","213","0","22","12.4","12.4"
"Elbert","2020-04-30","22","235","7","29","14.1","14.7"
"Elbert","2020-05-01","12","247","0","29","10.5","13.7"
"Elbert","2020-05-02","1","248","0","29","10.5","13.7"
"Elbert","2020-05-03","2","250","1","30","17.6","17.3"
"Elbert","2020-05-04","25","275","0","30","11.7","14.9"
"Elbert","2020-05-05","29","304","1","31","12.2","13.1"
"Elbert","2020-05-06","22","326","2","33","13.5","12.9"
"Elbert","2020-05-07","12","338","0","33","8.9","11.5"
"Elbert","2020-05-08","9","347","1","34","10.5","10.5"
"Elbert","2020-05-09","5","352","0","34","10.5","10.5"
"Elbert","2020-05-10","2","354","1","35","10.5","14.1"
"Elbert","2020-05-11","15","369","2","37","12.4","12.1"
"Elbert","2020-05-12","30","399","2","39","12.9","12.5"
"Elbert","2020-05-13","10","409","0","39","11.6","12.5"
"Elbert","2020-05-14","14","423","1","40","12.6","10.8"
"Elbert","2020-05-15","15","438","1","41","12","11.2"
"Elbert","2020-05-16","1","439","0","41","12","11.2"
"Elbert","2020-05-17","2","441","0","41","4.8","7.7"
"Elbert","2020-05-18","18","459","1","42","3.7","8.1"
"Elbert","2020-05-19","20","479","1","43","3.5","8.2"
"Elbert","2020-05-20","18","497","2","45","5.1","8.3"
"Elbert","2020-05-21","12","509","1","46","5.2","8.9"
"Elbert","2020-05-22","13","522","0","46","4.3","8.1"
"Elbert","2020-05-23","3","525","0","46","4.3","8.1"
"Elbert","2020-05-24","8","533","3","49","9.6","7.2"
"Elbert","2020-05-25","4","537","0","49","8.8","6.3"
"Elbert","2020-05-26","19","556","0","49","8.1","5.8"
"Elbert","2020-05-27","23","579","0","49","6.5","5.8"
"Elbert","2020-05-28","19","598","1","50","6.1","5.7"
"Elbert","2020-05-29","9","607","0","50","6.1","5.2"
"Elbert","2020-05-30","6","613","1","51","8.5","6.4"
"Elbert","2020-05-31","4","617","0","51","3.1","6.4"
"Elbert","2020-06-01","16","633","0","51","3.1","6"
"Elbert","2020-06-02","23","656","0","51","3.1","5.6"
"Elbert","2020-06-03","15","671","1","52","4.1","5.3"
"Elbert","2020-06-04","13","684","2","54","5.5","5.8"
"Elbert","2020-06-05","14","698","1","55","6.6","6.3"
"Elbert","2020-06-06","5","703","0","55","4.2","6.3"
"Elbert","2020-06-07","12","715","0","55","4.2","3.7"
"Elbert","2020-06-08","12","727","0","55","4.2","3.7"
"Elbert","2020-06-09","7","734","0","55","4.2","3.7"
"Elbert","2020-06-10","8","742","0","55","3.2","3.7"
"Elbert","2020-06-11","10","752","0","55","1","3.3"
"Elbert","2020-06-12","11","763","0","55","0","3.3"
"Elbert","2020-06-13","2","765","0","55","0","2.1"
"Elbert","2020-06-14","1","766","0","55","0","2.1"
"Elbert","2020-06-15","18","784","1","56","0.8","2.5"
"Elbert","2020-06-16","10","794","0","56","0.8","2.5"
"Elbert","2020-06-17","17","811","1","57","1.6","2.4"
"Elbert","2020-06-18","16","827","2","59","3.4","2.2"
"Elbert","2020-06-19","10","837","0","59","3.4","1.7"
"Elbert","2020-06-20","7","844","0","59","3.4","1.7"
"Elbert","2020-06-21","6","850","0","59","3.4","1.7"
"Elbert","2020-06-22","18","868","1","60","3.4","2.1"
"Elbert","2020-06-23","17","885","2","62","5.1","2.9"
"Elbert","2020-06-24","18","903","0","62","4.3","2.9"
"Elbert","2020-06-25","21","924","3","65","4.5","4"
"Elbert","2020-06-26","18","942","3","68","6.9","5.2"
"Elbert","2020-06-27","6","948","3","71","14","8.7"
"Elbert","2020-06-28","4","952","0","71","14","8.7"
"Elbert","2020-06-29","19","971","0","71","13.2","8.3"
"Elbert","2020-06-30","14","985","1","72","12.6","8.8"
"Elbert","2020-07-01","9","994","1","73","14.2","9.2"
"Elbert","2020-07-02","9","1003","2","75","15.3","9.9"
"Elbert","2020-07-03","9","1012","0","75","12.9","9.9"
"Elbert","2020-07-04","2","1014","0","75","5.8","9.9"
"Elbert","2020-07-05","9","1023","2","77","9","11.5"
"Elbert","2020-07-06","27","1050","3","80","10.5","11.9"
"Elbert","2020-07-07","29","1079","4","84","11.5","12"
"Elbert","2020-07-08","17","1096","3","87","12.4","13.3"
"Elbert","2020-07-09","18","1114","1","88","10","12.7"
"Elbert","2020-07-10","8","1122","0","88","10","11.5"
"Elbert","2020-07-11","6","1128","1","89","12.4","9.1"
"Elbert","2020-07-12","7","1135","0","89","9.3","9.1"
"Elbert","2020-07-13","18","1153","2","91","9.3","9.9"
"Elbert","2020-07-14","21","1174","4","95","10","10.7"
"Elbert","2020-07-15","16","1190","1","96","8.4","10.4"
"Elbert","2020-07-16","15","1205","5","101","12.3","11.2"
"Elbert","2020-07-17","22","1227","5","106","15.6","12.8"
"Elbert","2020-07-18","3","1230","0","106","13.2","12.8"
"Elbert","2020-07-19","4","1234","0","106","13.2","11.2"
"Elbert","2020-07-20","25","1259","1","107","12.2","10.7"
"Elbert","2020-07-21","19","1278","2","109","11","10.5"
"Elbert","2020-07-22","24","1302","0","109","10.1","9.2"
"Elbert","2020-07-23","18","1320","2","111","6.9","9.6"
"Elbert","2020-07-24","27","1347","4","115","5.8","10.7"
"Elbert","2020-07-25","10","1357","5","120","12.9","13.1"
"Elbert","2020-07-26","9","1366","3","123","17.7","15.4"
"Elbert","2020-07-27","20","1386","3","126","19.3","15.7"
"Elbert","2020-07-28","15","1401","3","129","20.6","15.8"
"Elbert","2020-07-29","21","1422","3","132","22.6","16.4"
"Elbert","2020-07-30","19","1441","6","138","25.6","16.2"
"Elbert","2020-07-31","13","1454","2","140","25.7","15.7"
"Elbert","2020-08-01","15","1469","4","144","22.3","17.6"
"Elbert","2020-08-02","6","1475","1","145","19.9","18.8"
"Elbert","2020-08-03","13","1488","5","150","23.3","21.3"
"Elbert","2020-08-04","19","1507","2","152","21.9","21.3"
"Elbert","2020-08-05","21","1528","2","154","21.3","22"
"Elbert","2020-08-06","11","1539","1","155","18","21.8"
"Elbert","2020-08-07","15","1554","2","157","17.8","21.7"
"Elbert","2020-08-08","5","1559","1","158","16.8","19.6"
"Elbert","2020-08-09","9","1568","0","158","14.4","17.2"
"Elbert","2020-08-10","11","1579","0","158","8.9","16.1"
"Elbert","2020-08-11","8","1587","2","160","11","16.5"
"Elbert","2020-08-12","11","1598","3","163","13.5","17.4"
"Elbert","2020-08-13","16","1614","3","166","14.9","16.5"
"Elbert","2020-08-14","21","1635","8","174","18.4","18.1"
"Elbert","2020-08-15","6","1641","0","174","15.6","16.2"
"Elbert","2020-08-16","10","1651","1","175","17","15.7"
"Elbert","2020-08-17","14","1665","1","176","18","13.5"
"Elbert","2020-08-18","10","1675","3","179","18.8","14.9"
"Elbert","2020-08-19","44","1719","0","179","14.9","14.2"
"Elbert","2020-08-20","44","1763","2","181","12.8","13.9"
"Elbert","2020-08-21","23","1786","2","183","8.6","13.5"
"Elbert","2020-08-22","6","1792","0","183","8.6","12.1"
"Elbert","2020-08-23","10","1802","0","183","7.2","12.1"
"Elbert","2020-08-24","26","1828","6","189","9.5","13.8"
"Elbert","2020-08-25","20","1848","2","191","6.6","12.7"
"Elbert","2020-08-26","92","1940","6","197","7.5","11.2"
"Elbert","2020-08-27","22","1962","1","198","7.5","10.2"
"Elbert","2020-08-28","39","2001","11","209","10.3","9.5"
"Elbert","2020-08-29","9","2010","2","211","13.5","11.1"
"Elbert","2020-08-30","11","2021","1","212","14.8","11"
"Elbert","2020-08-31","21","2042","4","216","14.2","11.9"
"Elbert","2020-09-01","76","2118","20","236","16.6","11.6"
"Elbert","2020-09-02","34","2152","7","243","18.6","13.1"
"Elbert","2020-09-03","24","2176","4","247","20.3","13.9"
"Elbert","2020-09-04","18","2194","2","249","17.9","14.1"
"Elbert","2020-09-05","40","2234","1","250","15","14.3"
"Elbert","2020-09-06","24","2258","4","254","16.1","15.5"
"Elbert","2020-09-07","15","2273","3","257","16.3","15.2"
"Elbert","2020-09-08","26","2299","5","262","15.3","15.9"
"Elbert","2020-09-09","62","2361","22","284","17.4","18"
"Elbert","2020-09-10","19","2380","5","289","18.8","19.5"
"Elbert","2020-09-11","23","2403","1","290","17.8","17.8"
"Elbert","2020-09-12","26","2429","0","290","17.4","16.2"
"Elbert","2020-09-13","8","2437","2","292","18.6","17.4"
"Elbert","2020-09-14","21","2458","4","296","18.5","17.4"
"Elbert","2020-09-15","13","2471","2","298","17.9","16.6"
"Elbert","2020-09-16","16","2487","3","301","15.5","16.5"
"Elbert","2020-09-17","14","2501","1","302","12.8","15.8"
"Elbert","2020-09-18","20","2521","2","304","13.6","15.7"
"Elbert","2020-09-19","8","2529","1","305","15.4","16.4"
"Elbert","2020-09-20","3","2532","0","305","11.8","15.2"
"Elbert","2020-09-21","13","2545","3","308","12.4","15.4"
"Elbert","2020-09-22","16","2561","1","309","11.1","14.5"
"Elbert","2020-09-23","17","2578","1","310","9.3","12.4"
"Elbert","2020-09-24","19","2597","1","311","9","10.9"
"Elbert","2020-09-25","31","2628","0","311","7.6","10.6"
"Elbert","2020-09-26","12","2640","3","314","9.4","12.4"
"Elbert","2020-09-27","7","2647","2","316","13.4","12.6"
"Elbert","2020-09-28","16","2663","3","319","12.8","12.6"
"Elbert","2020-09-29","39","2702","3","322","13","12.1"
"Elbert","2020-09-30","12","2714","0","322","12.2","10.7"
"Elbert","2020-10-01","12","2726","1","323","12.6","10.8"
"Elbert","2020-10-02","25","2751","2","325","13.8","10.7"
"Elbert","2020-10-03","33","2784","1","326","10.6","10"
"Elbert","2020-10-04","33","2817","3","329","7.8","10.6"
"Elbert","2020-10-05","19","2836","1","330","5.9","9.4"
"Elbert","2020-10-06","20","2856","2","332","6.2","9.6"
"Elbert","2020-10-07","20","2876","2","334","7.7","9.9"
"Elbert","2020-10-08","62","2938","4","338","7.4","10"
"Elbert","2020-10-09","21","2959","5","343","9.7","11.7"
"Elbert","2020-10-10","16","2975","4","347","12.8","11.7"
"Elbert","2020-10-11","35","3010","1","348","11.9","9.9"
"Elbert","2020-10-12","18","3028","2","350","12.7","9.3"
"Elbert","2020-10-13","26","3054","3","353","13","9.6"
"Elbert","2020-10-14","20","3074","1","354","12.3","10"
"Elbert","2020-10-15","24","3098","5","359","14.3","10.9"
"Elbert","2020-10-16","44","3142","5","364","12.5","11.1"
"Elbert","2020-10-17","6","3148","1","365","11.3","12.1"
"Elbert","2020-10-18","75","3223","1","366","11.1","11.5"
"Elbert","2020-10-19","46","3269","5","371","11.1","11.9"
"Elbert","2020-10-20","47","3316","6","377","11.3","12.1"
"Elbert","2020-10-21","38","3354","6","383","12.8","12.5"
"Elbert","2020-10-22","56","3410","1","384","10.1","12.2"
"Elbert","2020-10-23","68","3478","1","385","8.7","10.6"
"Elbert","2020-10-24","5","3483","1","386","9.1","10.2"
"Elbert","2020-10-25","6","3489","1","387","11.3","11.2"
"Elbert","2020-10-26","54","3543","5","392","11.1","11.1"
"Elbert","2020-10-27","69","3612","7","399","10.7","11"
"Elbert","2020-10-28","48","3660","4","403","9.7","11.2"
"Elbert","2020-10-29","17","3677","0","403","9.4","9.7"
"Elbert","2020-10-30","89","3766","6","409","10.2","9.4"
"Elbert","2020-10-31","9","3775","0","409","7.3","8.2"
"Elbert","2020-11-01","34","3809","3","412","6.2","8.8"
"Elbert","2020-11-02","21","3830","7","419","9.6","10.4"
"Elbert","2020-11-03","15","3845","7","426","14.8","12.8"
"Elbert","2020-11-04","30","3875","5","431","16","12.8"
"Elbert","2020-11-05","30","3905","6","437","18.9","14.2"
"Elbert","2020-11-06","44","3949","6","443","19.9","15"
"Elbert","2020-11-07","59","4008","6","449","21.3","14.3"
"Elbert","2020-11-08","37","4045","3","452","21.2","13.7"
"Elbert","2020-11-09","41","4086","6","458","18.6","14.1"
"Elbert","2020-11-10","45","4131","10","468","15.1","15"
"Elbert","2020-11-11","19","4150","4","472","15.7","15.9"
"Elbert","2020-11-12","28","4178","6","478","15.9","17.4"
"Elbert","2020-11-13","84","4262","1","479","14.1","17"
"Elbert","2020-11-14","15","4277","2","481","14.6","17.9"
"Elbert","2020-11-15","14","4291","1","482","14.4","17.8"
"Elbert","2020-11-16","37","4328","5","487","14.3","16.4"
"Elbert","2020-11-17","60","4388","8","495","13","14"
"Elbert","2020-11-18","23","4411","4","499","12.5","14.1"
"Elbert","2020-11-19","52","4463","6","505","11.1","13.5"
"Elbert","2020-11-20","18","4481","2","507","12.5","13.3"
"Elbert","2020-11-21","21","4502","3","510","12.6","13.6"
"Elbert","2020-11-22","46","4548","5","515","13.1","13.8"
"Elbert","2020-11-23","26","4574","6","521","14.5","14.4"
"Elbert","2020-11-24","24","4598","2","523","13.8","13.4"
"Elbert","2020-11-25","21","4619","2","525","12.7","12.6"
"Elbert","2020-11-26","16","4635","0","525","11","11"
"Elbert","2020-11-27","21","4656","3","528","11.5","12"
"Elbert","2020-11-28","13","4669","7","535","17.1","14.9"
"Elbert","2020-11-29","13","4682","1","536","16.7","14.9"
"Elbert","2020-11-30","34","4716","6","542","15.9","15.2"
"Elbert","2020-12-01","17","4733","1","543","15.6","14.7"
"Elbert","2020-12-02","21","4754","0","543","14.2","13.4"
"Elbert","2020-12-03","50","4804","2","545","14.8","12.9"
"Elbert","2020-12-04","26","4830","5","550","15.5","13.5"
"Elbert","2020-12-05","11","4841","2","552","10.4","13.8"
"Elbert","2020-12-06","9","4850","4","556","15.6","16.2"
"Elbert","2020-12-07","27","4877","6","562","16.3","16.1"
"Elbert","2020-12-08","59","4936","9","571","17.6","16.6"
"Elbert","2020-12-09","35","4971","7","578","20.5","17.3"
"Elbert","2020-12-10","38","5009","9","587","23.3","19"
"Elbert","2020-12-11","47","5056","15","602","25.1","20.3"
"Elbert","2020-12-12","19","5075","9","611","29.3","19.8"
"Elbert","2020-12-13","13","5088","5","616","28.4","22"
"Elbert","2020-12-14","40","5128","8","624","28.1","22.2"
"Elbert","2020-12-15","33","5161","9","633","29.8","23.7"
"Elbert","2020-12-16","61","5222","13","646","30","25.2"
"Elbert","2020-12-17","55","5277","9","655","29","26.1"
"Elbert","2020-12-18","20","5297","6","661","28.7","26.9"
"Elbert","2020-12-19","14","5311","2","663","24","26.6"
"Elbert","2020-12-20","19","5330","3","666","20.7","24.6"
"Elbert","2020-12-21","29","5359","7","673","21.3","24.7"
"Elbert","2020-12-22","61","5420","5","678","18.6","24.2"
"Elbert","2020-12-23","38","5458","9","687","18.9","24.5"
"Elbert","2020-12-24","57","5515","8","695","18.6","23.8"
"Elbert","2020-12-25","5","5520","3","698","22.9","25.8"
"Elbert","2020-12-26","19","5539","8","706","26.8","25.4"
"Elbert","2020-12-27","16","5555","5","711","29.1","24.9"
"Elbert","2020-12-28","30","5585","8","719","29.4","25.4"
"Elbert","2020-12-29","32","5617","12","731","33.6","26.1"
"Elbert","2020-12-30","49","5666","9","740","32.8","25.9"
"Elbert","2020-12-31","42","5708","9","749","33.9","26.2"
"Elbert","2021-01-01","8","5716","2","751","28.9","25.9"
"Elbert","2021-01-02","24","5740","10","761","28.8","27.8"
"Elbert","2021-01-03","17","5757","3","764","26.9","28"
"Elbert","2021-01-04","36","5793","7","771","25.9","27.6"
"Elbert","2021-01-05","38","5831","10","781","24.3","28.9"
"Elbert","2021-01-06","50","5881","5","786","23.1","28"
"Elbert","2021-01-07","38","5919","7","793","22.6","28.3"
"Elbert","2021-01-08","36","5955","7","800","21.8","25.4"
"Elbert","2021-01-09","37","5992","10","810","19.8","24.3"
"Elbert","2021-01-10","23","6015","7","817","21.6","24.2"
"Elbert","2021-01-11","55","6070","11","828","21.7","23.8"
"Elbert","2021-01-12","56","6126","21","849","23.3","23.8"
"Elbert","2021-01-13","33","6159","10","859","26.2","24.6"
"Elbert","2021-01-14","43","6202","6","865","25.5","24.1"
"Elbert","2021-01-15","35","6237","8","873","26","23.9"
"Elbert","2021-01-16","18","6255","9","882","29.3","24.5"
"Elbert","2021-01-17","12","6267","5","887","30.9","26.2"
"Elbert","2021-01-18","45","6312","7","894","30.3","26"
"Elbert","2021-01-19","34","6346","11","905","29.5","26.4"
"Elbert","2021-01-20","35","6381","6","911","27.6","26.9"
"Elbert","2021-01-21","33","6414","7","918","28.7","27.1"
"Elbert","2021-01-22","34","6448","10","928","29.6","27.8"
"Elbert","2021-01-23","25","6473","9","937","27.6","28.5"
"Elbert","2021-01-24","17","6490","5","942","25.9","28.4"
"Elbert","2021-01-25","28","6518","4","946","25.7","28"
"Elbert","2021-01-26","38","6556","12","958","25.6","27.6"
"Elbert","2021-01-27","48","6604","2","960","23.7","25.7"
"Elbert","2021-01-28","28","6632","10","970","25.8","27.2"
"Elbert","2021-01-29","19","6651","2","972","23.1","26.4"
"Elbert","2021-01-30","18","6669","3","975","20.3","24"
"Elbert","2021-01-31","18","6687","5","980","20.1","23"
"Elbert","2021-02-01","26","6713","4","984","20.3","23"
"Elbert","2021-02-02","28","6741","7","991","19.3","22.4"
"Elbert","2021-02-03","36","6777","1","992","19.1","21.4"
"Elbert","2021-02-04","13","6790","1","993","15.1","20.5"
"Elbert","2021-02-05","8","6798","0","993","13.6","18.4"
"Elbert","2021-02-06","3","6801","0","993","11.2","15.8"
"Elbert","2021-02-07","3","6804","0","993","7.3","13.7"
"Elbert","2021-02-08","0","6804","0","993","5.1","12.7"
"Emanuel","2020-02-01","0","0","0","0",".","."
"Emanuel","2020-02-02","0","0","0","0",".","."
"Emanuel","2020-02-03","0","0","0","0",".","."
"Emanuel","2020-02-04","0","0","0","0",".","."
"Emanuel","2020-02-05","0","0","0","0",".","."
"Emanuel","2020-02-06","0","0","0","0",".","."
"Emanuel","2020-02-07","0","0","0","0","0","."
"Emanuel","2020-02-08","0","0","0","0","0","."
"Emanuel","2020-02-09","0","0","0","0","0","."
"Emanuel","2020-02-10","0","0","0","0","0","."
"Emanuel","2020-02-11","0","0","0","0","0","."
"Emanuel","2020-02-12","0","0","0","0","0","."
"Emanuel","2020-02-13","0","0","0","0","0","."
"Emanuel","2020-02-14","0","0","0","0","0","0"
"Emanuel","2020-02-15","0","0","0","0","0","0"
"Emanuel","2020-02-16","0","0","0","0","0","0"
"Emanuel","2020-02-17","0","0","0","0","0","0"
"Emanuel","2020-02-18","0","0","0","0","0","0"
"Emanuel","2020-02-19","0","0","0","0","0","0"
"Emanuel","2020-02-20","0","0","0","0","0","0"
"Emanuel","2020-02-21","0","0","0","0","0","0"
"Emanuel","2020-02-22","0","0","0","0","0","0"
"Emanuel","2020-02-23","0","0","0","0","0","0"
"Emanuel","2020-02-24","0","0","0","0","0","0"
"Emanuel","2020-02-25","0","0","0","0","0","0"
"Emanuel","2020-02-26","0","0","0","0","0","0"
"Emanuel","2020-02-27","0","0","0","0","0","0"
"Emanuel","2020-02-28","0","0","0","0","0","0"
"Emanuel","2020-02-29","0","0","0","0","0","0"
"Emanuel","2020-03-01","0","0","0","0","0","0"
"Emanuel","2020-03-02","0","0","0","0","0","0"
"Emanuel","2020-03-03","0","0","0","0","0","0"
"Emanuel","2020-03-04","0","0","0","0","0","0"
"Emanuel","2020-03-05","0","0","0","0","0","0"
"Emanuel","2020-03-06","0","0","0","0","0","0"
"Emanuel","2020-03-07","0","0","0","0","0","0"
"Emanuel","2020-03-08","0","0","0","0","0","0"
"Emanuel","2020-03-09","0","0","0","0","0","0"
"Emanuel","2020-03-10","0","0","0","0","0","0"
"Emanuel","2020-03-11","2","2","0","0","0","0"
"Emanuel","2020-03-12","0","2","0","0","0","0"
"Emanuel","2020-03-13","0","2","0","0","0","0"
"Emanuel","2020-03-14","0","2","0","0","0","0"
"Emanuel","2020-03-15","1","3","0","0","0","0"
"Emanuel","2020-03-16","9","12","0","0","0","0"
"Emanuel","2020-03-17","1","13","0","0","0","0"
"Emanuel","2020-03-18","5","18","0","0","0","0"
"Emanuel","2020-03-19","4","22","1","1","3.6","1.8"
"Emanuel","2020-03-20","4","26","0","1","3.6","1.8"
"Emanuel","2020-03-21","0","26","0","1","3.6","1.8"
"Emanuel","2020-03-22","1","27","0","1","3.6","1.8"
"Emanuel","2020-03-23","2","29","0","1","3.6","1.8"
"Emanuel","2020-03-24","4","33","0","1","3.6","1.8"
"Emanuel","2020-03-25","2","35","0","1","3.6","1.8"
"Emanuel","2020-03-26","2","37","0","1","0","1.8"
"Emanuel","2020-03-27","0","37","0","1","0","1.8"
"Emanuel","2020-03-28","1","38","0","1","0","1.8"
"Emanuel","2020-03-29","0","38","0","1","0","1.8"
"Emanuel","2020-03-30","3","41","0","1","0","1.8"
"Emanuel","2020-03-31","2","43","0","1","0","1.8"
"Emanuel","2020-04-01","7","50","1","2","2","2.8"
"Emanuel","2020-04-02","3","53","1","3","6.8","3.4"
"Emanuel","2020-04-03","1","54","0","3","6.8","3.4"
"Emanuel","2020-04-04","1","55","0","3","6.8","3.4"
"Emanuel","2020-04-05","2","57","0","3","6.8","3.4"
"Emanuel","2020-04-06","8","65","0","3","6.8","3.4"
"Emanuel","2020-04-07","8","73","0","3","6.8","3.4"
"Emanuel","2020-04-08","7","80","1","4","6.8","4.4"
"Emanuel","2020-04-09","6","86","0","4","2","4.4"
"Emanuel","2020-04-10","10","96","0","4","2","4.4"
"Emanuel","2020-04-11","1","97","0","4","2","4.4"
"Emanuel","2020-04-12","4","101","1","5","5.6","6.2"
"Emanuel","2020-04-13","6","107","1","6","8","7.4"
"Emanuel","2020-04-14","6","113","2","8","12.8","9.8"
"Emanuel","2020-04-15","4","117","1","9","14.3","10.5"
"Emanuel","2020-04-16","15","132","2","11","16.2","9.1"
"Emanuel","2020-04-17","12","144","0","11","16.2","9.1"
"Emanuel","2020-04-18","0","144","0","11","16.2","9.1"
"Emanuel","2020-04-19","7","151","1","12","14.7","10.1"
"Emanuel","2020-04-20","8","159","0","12","12.3","10.1"
"Emanuel","2020-04-21","11","170","0","12","7.5","10.1"
"Emanuel","2020-04-22","4","174","0","12","3.9","9.1"
"Emanuel","2020-04-23","8","182","0","12","2","9.1"
"Emanuel","2020-04-24","6","188","0","12","2","9.1"
"Emanuel","2020-04-25","2","190","0","12","2","9.1"
"Emanuel","2020-04-26","2","192","0","12","0","7.3"
"Emanuel","2020-04-27","6","198","2","14","4.8","8.5"
"Emanuel","2020-04-28","2","200","1","15","11.9","9.7"
"Emanuel","2020-04-29","9","209","0","15","11.9","7.9"
"Emanuel","2020-04-30","5","214","0","15","11.9","7"
"Emanuel","2020-05-01","10","224","0","15","11.9","7"
"Emanuel","2020-05-02","5","229","0","15","11.9","7"
"Emanuel","2020-05-03","3","232","0","15","11.9","6"
"Emanuel","2020-05-04","21","253","0","15","7.1","6"
"Emanuel","2020-05-05","9","262","0","15","0","6"
"Emanuel","2020-05-06","8","270","1","16","1.8","6.8"
"Emanuel","2020-05-07","10","280","0","16","1.8","6.8"
"Emanuel","2020-05-08","96","376","0","16","1.8","6.8"
"Emanuel","2020-05-09","6","382","0","16","1.8","6.8"
"Emanuel","2020-05-10","0","382","0","16","1.8","6.8"
"Emanuel","2020-05-11","15","397","0","16","1.8","4.5"
"Emanuel","2020-05-12","13","410","0","16","1.8","0.9"
"Emanuel","2020-05-13","14","424","0","16","0","0.9"
"Emanuel","2020-05-14","4","428","0","16","0","0.9"
"Emanuel","2020-05-15","12","440","2","18","2.4","2.1"
"Emanuel","2020-05-16","4","444","0","18","2.4","2.1"
"Emanuel","2020-05-17","3","447","0","18","2.4","2.1"
"Emanuel","2020-05-18","11","458","1","19","3.7","2.7"
"Emanuel","2020-05-19","11","469","0","19","3.7","2.7"
"Emanuel","2020-05-20","14","483","0","19","3.7","1.8"
"Emanuel","2020-05-21","21","504","0","19","3.7","1.8"
"Emanuel","2020-05-22","19","523","0","19","1.3","1.8"
"Emanuel","2020-05-23","12","535","1","20","2.5","2.4"
"Emanuel","2020-05-24","5","540","0","20","2.5","2.4"
"Emanuel","2020-05-25","1","541","0","20","1.2","2.4"
"Emanuel","2020-05-26","6","547","0","20","1.2","2.4"
"Emanuel","2020-05-27","6","553","0","20","1.2","2.4"
"Emanuel","2020-05-28","20","573","1","21","1.9","2.8"
"Emanuel","2020-05-29","13","586","0","21","1.9","1.6"
"Emanuel","2020-05-30","2","588","0","21","0.7","1.6"
"Emanuel","2020-05-31","0","588","0","21","0.7","1.6"
"Emanuel","2020-06-01","8","596","1","22","2.5","1.8"
"Emanuel","2020-06-02","19","615","0","22","2.5","1.8"
"Emanuel","2020-06-03","5","620","1","23","5.4","3.3"
"Emanuel","2020-06-04","10","630","2","25","7.5","4.7"
"Emanuel","2020-06-05","6","636","0","25","7.5","4.7"
"Emanuel","2020-06-06","1","637","0","25","7.5","4.1"
"Emanuel","2020-06-07","2","639","0","25","7.5","4.1"
"Emanuel","2020-06-08","10","649","0","25","5.7","4.1"
"Emanuel","2020-06-09","8","657","0","25","5.7","4.1"
"Emanuel","2020-06-10","21","678","3","28","4.9","5.1"
"Emanuel","2020-06-11","12","690","3","31","5.6","6.6"
"Emanuel","2020-06-12","19","709","7","38","10.9","9.2"
"Emanuel","2020-06-13","10","719","0","38","10.9","9.2"
"Emanuel","2020-06-14","5","724","0","38","10.9","9.2"
"Emanuel","2020-06-15","20","744","4","42","13.7","9.7"
"Emanuel","2020-06-16","22","766","6","48","17.6","11.7"
"Emanuel","2020-06-17","13","779","4","52","20","12.4"
"Emanuel","2020-06-18","23","802","4","56","18.9","12.3"
"Emanuel","2020-06-19","20","822","1","57","14.3","12.6"
"Emanuel","2020-06-20","9","831","2","59","17.5","14.2"
"Emanuel","2020-06-21","12","843","2","61","19.9","15.4"
"Emanuel","2020-06-22","50","893","13","74","20.8","17.2"
"Emanuel","2020-06-23","36","929","2","76","17.7","17.6"
"Emanuel","2020-06-24","54","983","14","90","17","18.5"
"Emanuel","2020-06-25","49","1032","16","106","19.1","19"
"Emanuel","2020-06-26","28","1060","3","109","20","17.2"
"Emanuel","2020-06-27","23","1083","3","112","18.7","18.1"
"Emanuel","2020-06-28","5","1088","1","113","19.1","19.5"
"Emanuel","2020-06-29","51","1139","4","117","16.5","18.6"
"Emanuel","2020-06-30","142","1281","10","127","16.7","17.2"
"Emanuel","2020-07-01","64","1345","8","135","14.8","15.9"
"Emanuel","2020-07-02","62","1407","13","148","13.2","16.2"
"Emanuel","2020-07-03","22","1429","5","153","14.9","17.4"
"Emanuel","2020-07-04","20","1449","6","159","17.3","18"
"Emanuel","2020-07-05","13","1462","1","160","15.5","17.3"
"Emanuel","2020-07-06","49","1511","12","172","17.9","17.2"
"Emanuel","2020-07-07","37","1548","3","175","18.1","17.4"
"Emanuel","2020-07-08","49","1597","8","183","18.6","16.7"
"Emanuel","2020-07-09","50","1647","3","186","16.5","14.8"
"Emanuel","2020-07-10","100","1747","5","191","13.9","14.4"
"Emanuel","2020-07-11","14","1761","2","193","11.7","14.5"
"Emanuel","2020-07-12","5","1766","1","194","13.5","14.5"
"Emanuel","2020-07-13","40","1806","6","200","12.1","15"
"Emanuel","2020-07-14","54","1860","4","204","12","15"
"Emanuel","2020-07-15","55","1915","8","212","11.7","15.2"
"Emanuel","2020-07-16","68","1983","5","217","11.9","14.2"
"Emanuel","2020-07-17","45","2028","7","224","13.4","13.7"
"Emanuel","2020-07-18","24","2052","2","226","12.6","12.1"
"Emanuel","2020-07-19","4","2056","1","227","13.3","13.4"
"Emanuel","2020-07-20","10","2066","3","230","15.5","13.8"
"Emanuel","2020-07-21","145","2211","41","271","18.4","15.2"
"Emanuel","2020-07-22","68","2279","19","290","20.4","16"
"Emanuel","2020-07-23","44","2323","4","294","20.6","16.3"
"Emanuel","2020-07-24","52","2375","14","308","22.2","17.8"
"Emanuel","2020-07-25","143","2518","17","325","22.7","17.7"
"Emanuel","2020-07-26","8","2526","0","325","19.2","16.2"
"Emanuel","2020-07-27","33","2559","6","331","17.5","16.5"
"Emanuel","2020-07-28","70","2629","38","369","21.2","19.8"
"Emanuel","2020-07-29","97","2726","27","396","21.2","20.8"
"Emanuel","2020-07-30","59","2785","18","414","24.2","22.4"
"Emanuel","2020-07-31","55","2840","17","431","24.8","23.5"
"Emanuel","2020-08-01","61","2901","21","452","28","25.4"
"Emanuel","2020-08-02","28","2929","3","455","29.6","24.4"
"Emanuel","2020-08-03","16","2945","7","462","33.2","25.3"
"Emanuel","2020-08-04","37","2982","7","469","28.2","24.7"
"Emanuel","2020-08-05","107","3089","45","514","30.2","25.7"
"Emanuel","2020-08-06","52","3141","19","533","31","27.6"
"Emanuel","2020-08-07","48","3189","11","544","29.9","27.4"
"Emanuel","2020-08-08","31","3220","9","553","29.1","28.6"
"Emanuel","2020-08-09","8","3228","1","554","29.4","29.5"
"Emanuel","2020-08-10","21","3249","4","558","25.9","29.5"
"Emanuel","2020-08-11","23","3272","5","563","26.3","27.2"
"Emanuel","2020-08-12","46","3318","7","570","22.4","26.3"
"Emanuel","2020-08-13","50","3368","6","576","18.9","25"
"Emanuel","2020-08-14","54","3422","16","592","19.9","24.9"
"Emanuel","2020-08-15","64","3486","6","598","17.1","23.1"
"Emanuel","2020-08-16","10","3496","1","599","16.7","23.1"
"Emanuel","2020-08-17","13","3509","3","602","17.3","21.6"
"Emanuel","2020-08-18","52","3561","7","609","16.1","21.2"
"Emanuel","2020-08-19","70","3631","7","616","15.4","18.9"
"Emanuel","2020-08-20","72","3703","10","626","15.6","17.3"
"Emanuel","2020-08-21","55","3758","9","635","13.7","16.8"
"Emanuel","2020-08-22","29","3787","6","641","15.4","16.2"
"Emanuel","2020-08-23","12","3799","1","642","15.1","15.9"
"Emanuel","2020-08-24","53","3852","7","649","13.7","15.5"
"Emanuel","2020-08-25","43","3895","4","653","13.1","14.6"
"Emanuel","2020-08-26","42","3937","11","664","15.4","15.4"
"Emanuel","2020-08-27","60","3997","14","678","16.8","16.2"
"Emanuel","2020-08-28","108","4105","22","700","17.3","15.5"
"Emanuel","2020-08-29","48","4153","13","713","18.3","16.8"
"Emanuel","2020-08-30","24","4177","3","716","18.9","17"
"Emanuel","2020-08-31","39","4216","11","727","21","17.4"
"Emanuel","2020-09-01","92","4308","20","747","22.8","17.9"
"Emanuel","2020-09-02","33","4341","10","757","23.4","19.4"
"Emanuel","2020-09-03","65","4406","13","770","22.9","19.8"
"Emanuel","2020-09-04","120","4526","23","793","22.7","20"
"Emanuel","2020-09-05","41","4567","15","808","24.1","21.2"
"Emanuel","2020-09-06","15","4582","5","813","27","23"
"Emanuel","2020-09-07","10","4592","1","814","24.4","22.7"
"Emanuel","2020-09-08","82","4674","18","832","24.5","23.6"
"Emanuel","2020-09-09","40","4714","9","841","23.4","23.4"
"Emanuel","2020-09-10","56","4770","13","854","23.8","23.4"
"Emanuel","2020-09-11","91","4861","12","866","23","22.8"
"Emanuel","2020-09-12","29","4890","11","877","23.2","23.6"
"Emanuel","2020-09-13","8","4898","3","880","23.8","25.4"
"Emanuel","2020-09-14","47","4945","7","887","24.5","24.5"
"Emanuel","2020-09-15","96","5041","14","901","23.4","23.9"
"Emanuel","2020-09-16","44","5085","4","905","21.5","22.4"
"Emanuel","2020-09-17","35","5120","10","915","22.3","23"
"Emanuel","2020-09-18","68","5188","18","933","24.1","23.6"
"Emanuel","2020-09-19","27","5215","6","939","21.9","22.5"
"Emanuel","2020-09-20","6","5221","0","939","16.5","20.2"
"Emanuel","2020-09-21","30","5251","5","944","16.8","20.6"
"Emanuel","2020-09-22","87","5338","12","956","16.7","20"
"Emanuel","2020-09-23","17","5355","1","957","16.2","18.9"
"Emanuel","2020-09-24","29","5384","2","959","13.1","17.7"
"Emanuel","2020-09-25","85","5469","17","976","12.2","18.2"
"Emanuel","2020-09-26","10","5479","1","977","10.5","16.2"
"Emanuel","2020-09-27","5","5484","0","977","10.5","13.5"
"Emanuel","2020-09-28","29","5513","4","981","10.1","13.4"
"Emanuel","2020-09-29","67","5580","12","993","10.6","13.7"
"Emanuel","2020-09-30","17","5597","5","998","14","15.1"
"Emanuel","2020-10-01","25","5622","3","1001","14.7","13.9"
"Emanuel","2020-10-02","83","5705","12","1013","13.9","13.1"
"Emanuel","2020-10-03","10","5715","2","1015","15.4","12.9"
"Emanuel","2020-10-04","4","5719","0","1015","15.4","12.9"
"Emanuel","2020-10-05","29","5748","4","1019","15.4","12.7"
"Emanuel","2020-10-06","66","5814","6","1025","14.1","12.4"
"Emanuel","2020-10-07","26","5840","4","1029","12.1","13.1"
"Emanuel","2020-10-08","24","5864","5","1034","13.4","14"
"Emanuel","2020-10-09","43","5907","3","1037","12.3","13.1"
"Emanuel","2020-10-10","13","5920","2","1039","11.6","13.5"
"Emanuel","2020-10-11","3","5923","1","1040","16.4","15.9"
"Emanuel","2020-10-12","11","5934","3","1043","18.3","16.8"
"Emanuel","2020-10-13","49","5983","4","1047","18.2","16.2"
"Emanuel","2020-10-14","24","6007","2","1049","17.2","14.6"
"Emanuel","2020-10-15","26","6033","7","1056","18.1","15.7"
"Emanuel","2020-10-16","46","6079","7","1063","19.2","15.8"
"Emanuel","2020-10-17","19","6098","4","1067","20","15.8"
"Emanuel","2020-10-18","4","6102","2","1069","22.4","19.4"
"Emanuel","2020-10-19","13","6115","0","1069","18.5","18.4"
"Emanuel","2020-10-20","45","6160","10","1079","20.5","19.4"
"Emanuel","2020-10-21","25","6185","4","1083","21.6","19.4"
"Emanuel","2020-10-22","27","6212","9","1092","22.5","20.3"
"Emanuel","2020-10-23","27","6239","5","1097","23","21.1"
"Emanuel","2020-10-24","49","6288","26","1123","27.6","23.8"
"Emanuel","2020-10-25","3","6291","0","1123","20.4","21.4"
"Emanuel","2020-10-26","22","6313","1","1124","21.1","19.8"
"Emanuel","2020-10-27","46","6359","6","1130","19.8","20.2"
"Emanuel","2020-10-28","16","6375","1","1131","18.4","20"
"Emanuel","2020-10-29","13","6388","2","1133","15.8","19.2"
"Emanuel","2020-10-30","34","6422","3","1136","14.4","18.7"
"Emanuel","2020-10-31","5","6427","2","1138","12.6","20.1"
"Emanuel","2020-11-01","4","6431","0","1138","12.6","16.5"
"Emanuel","2020-11-02","21","6452","2","1140","13.3","17.2"
"Emanuel","2020-11-03","31","6483","3","1143","12.8","16.3"
"Emanuel","2020-11-04","17","6500","2","1145","13.6","16"
"Emanuel","2020-11-05","15","6515","2","1147","13.3","14.6"
"Emanuel","2020-11-06","48","6563","7","1154","14.1","14.3"
"Emanuel","2020-11-07","7","6570","2","1156","12.5","12.5"
"Emanuel","2020-11-08","7","6577","2","1158","16.6","14.6"
"Emanuel","2020-11-09","17","6594","1","1159","16.1","14.7"
"Emanuel","2020-11-10","38","6632","2","1161","15.4","14.1"
"Emanuel","2020-11-11","18","6650","0","1161","13.7","13.7"
"Emanuel","2020-11-12","6","6656","0","1161","11.8","12.6"
"Emanuel","2020-11-13","41","6697","2","1163","10.5","12.3"
"Emanuel","2020-11-14","2","6699","0","1163","6.4","9.4"
"Emanuel","2020-11-15","7","6706","1","1164","4.3","10.5"
"Emanuel","2020-11-16","13","6719","0","1164","3.5","9.8"
"Emanuel","2020-11-17","48","6767","2","1166","3.3","9.4"
"Emanuel","2020-11-18","20","6787","2","1168","4.8","9.3"
"Emanuel","2020-11-19","15","6802","1","1169","5.7","8.8"
"Emanuel","2020-11-20","48","6850","1","1170","5.3","7.9"
"Emanuel","2020-11-21","7","6857","0","1170","5.3","5.8"
"Emanuel","2020-11-22","6","6863","1","1171","5.7","5"
"Emanuel","2020-11-23","22","6885","0","1171","5.7","4.6"
"Emanuel","2020-11-24","33","6918","2","1173","5.9","4.6"
"Emanuel","2020-11-25","10","6928","1","1174","5.9","5.3"
"Emanuel","2020-11-26","7","6935","0","1174","5","5.3"
"Emanuel","2020-11-27","14","6949","2","1176","6.7","6"
"Emanuel","2020-11-28","8","6957","3","1179","12.1","8.7"
"Emanuel","2020-11-29","5","6962","2","1181","15.4","10.5"
"Emanuel","2020-11-30","12","6974","2","1183","17.8","11.7"
"Emanuel","2020-12-01","50","7024","5","1188","18.4","12.1"
"Emanuel","2020-12-02","11","7035","3","1191","20.8","13.4"
"Emanuel","2020-12-03","7","7042","0","1191","20.8","12.9"
"Emanuel","2020-12-04","35","7077","4","1195","20.4","13.6"
"Emanuel","2020-12-05","10","7087","3","1198","19.3","15.7"
"Emanuel","2020-12-06","1","7088","0","1198","13.6","14.5"
"Emanuel","2020-12-07","30","7118","3","1201","12.7","15.2"
"Emanuel","2020-12-08","59","7177","6","1207","12.7","15.5"
"Emanuel","2020-12-09","21","7198","3","1210","10.8","15.8"
"Emanuel","2020-12-10","21","7219","2","1212","12.2","16.5"
"Emanuel","2020-12-11","30","7249","2","1214","11.5","16"
"Emanuel","2020-12-12","10","7259","0","1214","7.2","13.3"
"Emanuel","2020-12-13","6","7265","3","1217","14.4","14"
"Emanuel","2020-12-14","23","7288","5","1222","16.1","14.4"
"Emanuel","2020-12-15","81","7369","4","1226","15.3","14"
"Emanuel","2020-12-16","36","7405","9","1235","16.8","13.8"
"Emanuel","2020-12-17","34","7439","4","1239","17.2","14.7"
"Emanuel","2020-12-18","22","7461","4","1243","18.8","15.2"
"Emanuel","2020-12-19","7","7468","2","1245","22.9","15.1"
"Emanuel","2020-12-20","9","7477","3","1248","20.5","17.4"
"Emanuel","2020-12-21","48","7525","12","1260","21","18.5"
"Emanuel","2020-12-22","94","7619","19","1279","23.2","19.2"
"Emanuel","2020-12-23","70","7689","6","1285","20.8","18.8"
"Emanuel","2020-12-24","4","7693","1","1286","22.7","19.9"
"Emanuel","2020-12-25","2","7695","0","1286","20.1","19.5"
"Emanuel","2020-12-26","14","7709","6","1292","22.1","22.5"
"Emanuel","2020-12-27","10","7719","4","1296","23.1","21.8"
"Emanuel","2020-12-28","89","7808","16","1312","22.1","21.5"
"Emanuel","2020-12-29","132","7940","29","1341","22.3","22.7"
"Emanuel","2020-12-30","50","7990","9","1350","23.7","22.2"
"Emanuel","2020-12-31","44","8034","4","1354","21.4","22.1"
"Emanuel","2021-01-01","10","8044","1","1355","22.8","21.5"
"Emanuel","2021-01-02","14","8058","6","1361","22.8","22.5"
"Emanuel","2021-01-03","15","8073","6","1367","22.8","23"
"Emanuel","2021-01-04","43","8116","8","1375","22.9","22.5"
"Emanuel","2021-01-05","235","8351","45","1420","22.5","22.4"
"Emanuel","2021-01-06","25","8376","5","1425","22.8","23.3"
"Emanuel","2021-01-07","26","8402","6","1431","24.8","23.1"
"Emanuel","2021-01-08","24","8426","6","1437","27","24.9"
"Emanuel","2021-01-09","9","8435","1","1438","22.4","22.6"
"Emanuel","2021-01-10","12","8447","6","1444","23.8","23.3"
"Emanuel","2021-01-11","31","8478","11","1455","26.3","24.6"
"Emanuel","2021-01-12","30","8508","6","1461","26.4","24.5"
"Emanuel","2021-01-13","64","8572","6","1467","24.9","23.8"
"Emanuel","2021-01-14","33","8605","7","1474","24.6","24.7"
"Emanuel","2021-01-15","38","8643","3","1477","22.2","24.6"
"Emanuel","2021-01-16","9","8652","2","1479","23.7","23.1"
"Emanuel","2021-01-17","10","8662","1","1480","18","20.9"
"Emanuel","2021-01-18","9","8671","0","1480","13","19.6"
"Emanuel","2021-01-19","27","8698","1","1481","10.6","18.5"
"Emanuel","2021-01-20","45","8743","8","1489","11.8","18.3"
"Emanuel","2021-01-21","42","8785","6","1495","10.8","17.7"
"Emanuel","2021-01-22","45","8830","6","1501","11.6","16.9"
"Emanuel","2021-01-23","8","8838","2","1503","12","17.9"
"Emanuel","2021-01-24","12","8850","1","1504","11.8","14.9"
"Emanuel","2021-01-25","26","8876","1","1505","12.3","12.6"
"Emanuel","2021-01-26","21","8897","3","1508","13.8","12.2"
"Emanuel","2021-01-27","32","8929","8","1516","14.9","13.3"
"Emanuel","2021-01-28","16","8945","1","1517","13.7","12.3"
"Emanuel","2021-01-29","23","8968","2","1519","13.1","12.3"
"Emanuel","2021-01-30","16","8984","1","1520","10.4","11.2"
"Emanuel","2021-01-31","11","8995","0","1520","9.2","10.5"
"Emanuel","2021-02-01","24","9019","2","1522","9.8","11.1"
"Emanuel","2021-02-02","36","9055","6","1528","10.2","12"
"Emanuel","2021-02-03","23","9078","4","1532","9.1","12"
"Emanuel","2021-02-04","22","9100","6","1538","12.1","12.9"
"Emanuel","2021-02-05","11","9111","0","1538","10.8","12"
"Emanuel","2021-02-06","3","9114","0","1538","10","10.2"
"Emanuel","2021-02-07","1","9115","0","1538","10","9.6"
"Emanuel","2021-02-08","0","9115","0","1538","8.8","9.3"
"Evans","2020-02-01","0","0","0","0",".","."
"Evans","2020-02-02","0","0","0","0",".","."
"Evans","2020-02-03","0","0","0","0",".","."
"Evans","2020-02-04","0","0","0","0",".","."
"Evans","2020-02-05","0","0","0","0",".","."
"Evans","2020-02-06","0","0","0","0",".","."
"Evans","2020-02-07","0","0","0","0","0","."
"Evans","2020-02-08","0","0","0","0","0","."
"Evans","2020-02-09","0","0","0","0","0","."
"Evans","2020-02-10","0","0","0","0","0","."
"Evans","2020-02-11","0","0","0","0","0","."
"Evans","2020-02-12","0","0","0","0","0","."
"Evans","2020-02-13","0","0","0","0","0","."
"Evans","2020-02-14","0","0","0","0","0","0"
"Evans","2020-02-15","0","0","0","0","0","0"
"Evans","2020-02-16","0","0","0","0","0","0"
"Evans","2020-02-17","0","0","0","0","0","0"
"Evans","2020-02-18","0","0","0","0","0","0"
"Evans","2020-02-19","0","0","0","0","0","0"
"Evans","2020-02-20","0","0","0","0","0","0"
"Evans","2020-02-21","0","0","0","0","0","0"
"Evans","2020-02-22","0","0","0","0","0","0"
"Evans","2020-02-23","0","0","0","0","0","0"
"Evans","2020-02-24","0","0","0","0","0","0"
"Evans","2020-02-25","0","0","0","0","0","0"
"Evans","2020-02-26","0","0","0","0","0","0"
"Evans","2020-02-27","0","0","0","0","0","0"
"Evans","2020-02-28","0","0","0","0","0","0"
"Evans","2020-02-29","0","0","0","0","0","0"
"Evans","2020-03-01","0","0","0","0","0","0"
"Evans","2020-03-02","0","0","0","0","0","0"
"Evans","2020-03-03","0","0","0","0","0","0"
"Evans","2020-03-04","0","0","0","0","0","0"
"Evans","2020-03-05","0","0","0","0","0","0"
"Evans","2020-03-06","7","7","0","0","0","0"
"Evans","2020-03-07","0","7","0","0","0","0"
"Evans","2020-03-08","8","15","0","0","0","0"
"Evans","2020-03-09","0","15","0","0","0","0"
"Evans","2020-03-10","0","15","0","0","0","0"
"Evans","2020-03-11","0","15","0","0","0","0"
"Evans","2020-03-12","0","15","0","0","0","0"
"Evans","2020-03-13","0","15","0","0","0","0"
"Evans","2020-03-14","0","15","0","0","0","0"
"Evans","2020-03-15","0","15","0","0","0","0"
"Evans","2020-03-16","1","16","0","0","0","0"
"Evans","2020-03-17","1","17","0","0","0","0"
"Evans","2020-03-18","1","18","0","0","0","0"
"Evans","2020-03-19","0","18","0","0","0","0"
"Evans","2020-03-20","1","19","0","0","0","0"
"Evans","2020-03-21","0","19","0","0","0","0"
"Evans","2020-03-22","0","19","0","0","0","0"
"Evans","2020-03-23","0","19","0","0","0","0"
"Evans","2020-03-24","6","25","0","0","0","0"
"Evans","2020-03-25","4","29","0","0","0","0"
"Evans","2020-03-26","6","35","0","0","0","0"
"Evans","2020-03-27","1","36","0","0","0","0"
"Evans","2020-03-28","0","36","0","0","0","0"
"Evans","2020-03-29","0","36","0","0","0","0"
"Evans","2020-03-30","5","41","0","0","0","0"
"Evans","2020-03-31","0","41","0","0","0","0"
"Evans","2020-04-01","0","41","0","0","0","0"
"Evans","2020-04-02","9","50","0","0","0","0"
"Evans","2020-04-03","1","51","0","0","0","0"
"Evans","2020-04-04","3","54","0","0","0","0"
"Evans","2020-04-05","2","56","0","0","0","0"
"Evans","2020-04-06","2","58","0","0","0","0"
"Evans","2020-04-07","6","64","0","0","0","0"
"Evans","2020-04-08","4","68","0","0","0","0"
"Evans","2020-04-09","8","76","1","1","1.8","0.9"
"Evans","2020-04-10","5","81","0","1","1.8","0.9"
"Evans","2020-04-11","2","83","0","1","1.8","0.9"
"Evans","2020-04-12","0","83","0","1","1.8","0.9"
"Evans","2020-04-13","0","83","0","1","1.8","0.9"
"Evans","2020-04-14","11","94","1","2","3.1","1.5"
"Evans","2020-04-15","4","98","0","2","3.1","1.5"
"Evans","2020-04-16","9","107","0","2","1.3","1.5"
"Evans","2020-04-17","6","113","1","3","3.7","2.7"
"Evans","2020-04-18","3","116","0","3","3.7","2.7"
"Evans","2020-04-19","0","116","0","3","3.7","2.7"
"Evans","2020-04-20","2","118","0","3","3.7","2.7"
"Evans","2020-04-21","14","132","0","3","2.4","2.7"
"Evans","2020-04-22","9","141","0","3","2.4","2.7"
"Evans","2020-04-23","4","145","0","3","2.4","1.8"
"Evans","2020-04-24","6","151","0","3","0","1.8"
"Evans","2020-04-25","6","157","0","3","0","1.8"
"Evans","2020-04-26","0","157","0","3","0","1.8"
"Evans","2020-04-27","3","160","0","3","0","1.8"
"Evans","2020-04-28","5","165","0","3","0","1.2"
"Evans","2020-04-29","5","170","0","3","0","1.2"
"Evans","2020-04-30","12","182","0","3","0","1.2"
"Evans","2020-05-01","7","189","0","3","0","0"
"Evans","2020-05-02","2","191","0","3","0","0"
"Evans","2020-05-03","0","191","0","3","0","0"
"Evans","2020-05-04","5","196","0","3","0","0"
"Evans","2020-05-05","4","200","0","3","0","0"
"Evans","2020-05-06","19","219","0","3","0","0"
"Evans","2020-05-07","1","220","0","3","0","0"
"Evans","2020-05-08","5","225","0","3","0","0"
"Evans","2020-05-09","2","227","0","3","0","0"
"Evans","2020-05-10","1","228","0","3","0","0"
"Evans","2020-05-11","4","232","0","3","0","0"
"Evans","2020-05-12","4","236","0","3","0","0"
"Evans","2020-05-13","6","242","0","3","0","0"
"Evans","2020-05-14","4","246","0","3","0","0"
"Evans","2020-05-15","8","254","0","3","0","0"
"Evans","2020-05-16","44","298","0","3","0","0"
"Evans","2020-05-17","0","298","0","3","0","0"
"Evans","2020-05-18","6","304","0","3","0","0"
"Evans","2020-05-19","5","309","0","3","0","0"
"Evans","2020-05-20","8","317","0","3","0","0"
"Evans","2020-05-21","10","327","0","3","0","0"
"Evans","2020-05-22","5","332","0","3","0","0"
"Evans","2020-05-23","1","333","0","3","0","0"
"Evans","2020-05-24","0","333","0","3","0","0"
"Evans","2020-05-25","0","333","0","3","0","0"
"Evans","2020-05-26","2","335","0","3","0","0"
"Evans","2020-05-27","4","339","0","3","0","0"
"Evans","2020-05-28","1","340","0","3","0","0"
"Evans","2020-05-29","13","353","0","3","0","0"
"Evans","2020-05-30","5","358","0","3","0","0"
"Evans","2020-05-31","0","358","0","3","0","0"
"Evans","2020-06-01","6","364","0","3","0","0"
"Evans","2020-06-02","2","366","0","3","0","0"
"Evans","2020-06-03","7","373","0","3","0","0"
"Evans","2020-06-04","7","380","0","3","0","0"
"Evans","2020-06-05","4","384","0","3","0","0"
"Evans","2020-06-06","2","386","0","3","0","0"
"Evans","2020-06-07","2","388","0","3","0","0"
"Evans","2020-06-08","9","397","1","4","1.6","0.8"
"Evans","2020-06-09","5","402","0","4","1.6","0.8"
"Evans","2020-06-10","3","405","1","5","6.3","3.2"
"Evans","2020-06-11","14","419","0","5","6.3","3.2"
"Evans","2020-06-12","2","421","0","5","6.3","3.2"
"Evans","2020-06-13","1","422","0","5","6.3","3.2"
"Evans","2020-06-14","0","422","0","5","6.3","3.2"
"Evans","2020-06-15","5","427","0","5","4.8","3.2"
"Evans","2020-06-16","39","466","1","6","5.1","3.4"
"Evans","2020-06-17","10","476","0","6","0.4","3.4"
"Evans","2020-06-18","33","509","1","7","0.8","3.6"
"Evans","2020-06-19","7","516","0","7","0.8","3.6"
"Evans","2020-06-20","2","518","0","7","0.8","3.6"
"Evans","2020-06-21","2","520","1","8","7.9","7.1"
"Evans","2020-06-22","11","531","1","9","9.2","7"
"Evans","2020-06-23","12","543","0","9","8.9","7"
"Evans","2020-06-24","16","559","0","9","8.9","4.6"
"Evans","2020-06-25","7","566","0","9","8.4","4.6"
"Evans","2020-06-26","11","577","0","9","8.4","4.6"
"Evans","2020-06-27","4","581","0","9","8.4","4.6"
"Evans","2020-06-28","4","585","2","11","8.4","8.2"
"Evans","2020-06-29","10","595","1","12","8.6","8.9"
"Evans","2020-06-30","13","608","2","14","10.8","9.8"
"Evans","2020-07-01","13","621","1","15","11.9","10.4"
"Evans","2020-07-02","13","634","0","15","11.9","10.2"
"Evans","2020-07-03","12","646","2","17","14.2","11.3"
"Evans","2020-07-04","9","655","1","18","15.8","12.1"
"Evans","2020-07-05","4","659","2","20","15.8","12.1"
"Evans","2020-07-06","10","669","5","25","21.6","15.1"
"Evans","2020-07-07","11","680","1","26","20.7","15.7"
"Evans","2020-07-08","29","709","10","36","24.5","18.2"
"Evans","2020-07-09","16","725","5","41","28.9","20.4"
"Evans","2020-07-10","14","739","7","48","33.7","24"
"Evans","2020-07-11","7","746","2","50","36.2","26"
"Evans","2020-07-12","7","753","5","55","39.3","27.5"
"Evans","2020-07-13","22","775","5","60","35.4","28.5"
"Evans","2020-07-14","16","791","4","64","37.6","29.1"
"Evans","2020-07-15","11","802","4","68","37.9","31.2"
"Evans","2020-07-16","29","831","11","79","38.9","33.9"
"Evans","2020-07-17","7","838","1","80","33.8","33.7"
"Evans","2020-07-18","3","841","1","81","34.4","35.3"
"Evans","2020-07-19","1","842","0","81","24.2","31.7"
"Evans","2020-07-20","30","872","11","92","26.2","30.8"
"Evans","2020-07-21","37","909","13","105","27.7","32.7"
"Evans","2020-07-22","17","926","7","112","28.4","33.1"
"Evans","2020-07-23","17","943","2","114","24.6","31.7"
"Evans","2020-07-24","24","967","10","124","28.5","31.1"
"Evans","2020-07-25","9","976","4","128","30.1","32.3"
"Evans","2020-07-26","4","980","3","131","40.8","32.5"
"Evans","2020-07-27","17","997","3","134","38.1","32.2"
"Evans","2020-07-28","13","1010","3","137","36.4","32"
"Evans","2020-07-29","11","1021","2","139","33.1","30.7"
"Evans","2020-07-30","17","1038","7","146","37.3","31"
"Evans","2020-07-31","12","1050","3","149","34.9","31.7"
"Evans","2020-08-01","1","1051","1","150","42.9","36.5"
"Evans","2020-08-02","4","1055","3","153","42.9","41.9"
"Evans","2020-08-03","10","1065","2","155","43.2","40.7"
"Evans","2020-08-04","30","1095","3","158","41.3","38.9"
"Evans","2020-08-05","11","1106","2","160","41.3","37.2"
"Evans","2020-08-06","11","1117","3","163","39.4","38.3"
"Evans","2020-08-07","10","1127","3","166","40.1","37.5"
"Evans","2020-08-08","4","1131","2","168","32.9","37.9"
"Evans","2020-08-09","5","1136","1","169","25.1","34"
"Evans","2020-08-10","10","1146","4","173","27.9","35.6"
"Evans","2020-08-11","11","1157","4","177","31.7","36.5"
"Evans","2020-08-12","14","1171","3","180","32.2","36.7"
"Evans","2020-08-13","15","1186","3","183","31.1","35.2"
"Evans","2020-08-14","16","1202","1","184","27.7","33.9"
"Evans","2020-08-15","6","1208","1","185","23","27.9"
"Evans","2020-08-16","2","1210","0","185","20.1","22.6"
"Evans","2020-08-17","10","1220","2","187","17.2","22.6"
"Evans","2020-08-18","16","1236","1","188","12.9","22.3"
"Evans","2020-08-19","9","1245","2","190","13.1","22.6"
"Evans","2020-08-20","10","1255","1","191","11.6","21.4"
"Evans","2020-08-21","11","1266","1","192","12","19.9"
"Evans","2020-08-22","6","1272","3","195","16.8","19.9"
"Evans","2020-08-23","6","1278","0","195","16.8","18.4"
"Evans","2020-08-24","10","1288","0","195","13.9","15.6"
"Evans","2020-08-25","12","1300","2","197","15.4","14.2"
"Evans","2020-08-26","7","1307","2","199","16.3","14.7"
"Evans","2020-08-27","9","1316","1","200","16.5","14.1"
"Evans","2020-08-28","20","1336","3","203","17.3","14.7"
"Evans","2020-08-29","7","1343","1","204","12.2","14.5"
"Evans","2020-08-30","8","1351","1","205","14","15.4"
"Evans","2020-08-31","12","1363","2","207","16.4","15.2"
"Evans","2020-09-01","7","1370","2","209","18.1","16.8"
"Evans","2020-09-02","6","1376","2","211","18.8","17.6"
"Evans","2020-09-03","11","1387","0","211","17.2","16.8"
"Evans","2020-09-04","8","1395","2","213","18.6","18"
"Evans","2020-09-05","8","1403","1","214","18.4","15.3"
"Evans","2020-09-06","4","1407","0","214","16.6","15.3"
"Evans","2020-09-07","4","1411","0","214","14.2","15.3"
"Evans","2020-09-08","15","1426","4","218","13.9","16"
"Evans","2020-09-09","8","1434","0","218","9.2","14"
"Evans","2020-09-10","16","1450","1","219","10.1","13.6"
"Evans","2020-09-11","10","1460","0","219","6.5","12.6"
"Evans","2020-09-12","5","1465","0","219","4.7","11.5"
"Evans","2020-09-13","6","1471","1","220","7.1","11.8"
"Evans","2020-09-14","13","1484","0","220","7.1","10.6"
"Evans","2020-09-15","13","1497","1","221","4.4","9.2"
"Evans","2020-09-16","15","1512","0","221","4.4","6.8"
"Evans","2020-09-17","16","1528","2","223","5.3","7.7"
"Evans","2020-09-18","12","1540","1","224","6.5","6.5"
"Evans","2020-09-19","6","1546","0","224","6.5","5.6"
"Evans","2020-09-20","4","1550","0","224","4.1","5.6"
"Evans","2020-09-21","11","1561","0","224","4.1","5.6"
"Evans","2020-09-22","12","1573","2","226","5.4","4.9"
"Evans","2020-09-23","60","1633","2","228","5.8","5.1"
"Evans","2020-09-24","5","1638","2","230","9.8","7.5"
"Evans","2020-09-25","7","1645","1","231","10.6","8.5"
"Evans","2020-09-26","0","1645","0","231","10.6","8.5"
"Evans","2020-09-27","1","1646","0","231","10.6","7.3"
"Evans","2020-09-28","12","1658","3","234","14.2","9.1"
"Evans","2020-09-29","4","1662","0","234","11.8","8.6"
"Evans","2020-09-30","7","1669","0","234","11.3","8.6"
"Evans","2020-10-01","19","1688","0","234","5.6","7.7"
"Evans","2020-10-02","15","1703","0","234","3.6","7.1"
"Evans","2020-10-03","4","1707","0","234","3.6","7.1"
"Evans","2020-10-04","5","1712","0","234","3.6","7.1"
"Evans","2020-10-05","24","1736","1","235","0.6","7.4"
"Evans","2020-10-06","5","1741","0","235","0.6","6.2"
"Evans","2020-10-07","18","1759","1","236","1.4","6.4"
"Evans","2020-10-08","16","1775","4","240","5","5.3"
"Evans","2020-10-09","11","1786","1","241","6.3","4.9"
"Evans","2020-10-10","10","1796","0","241","6.3","4.9"
"Evans","2020-10-11","8","1804","1","242","8","5.8"
"Evans","2020-10-12","11","1815","1","243","8.7","4.7"
"Evans","2020-10-13","15","1830","7","250","15.4","8"
"Evans","2020-10-14","10","1840","0","250","14.6","8"
"Evans","2020-10-15","10","1850","2","252","13.9","9.4"
"Evans","2020-10-16","4","1854","0","252","12.6","9.4"
"Evans","2020-10-17","7","1861","3","255","18.7","12.5"
"Evans","2020-10-18","4","1865","0","255","16.9","12.5"
"Evans","2020-10-19","10","1875","3","258","19.9","14.3"
"Evans","2020-10-20","13","1888","4","262","17.7","16.5"
"Evans","2020-10-21","12","1900","0","262","17.7","16.1"
"Evans","2020-10-22","4","1904","0","262","14.8","14.4"
"Evans","2020-10-23","6","1910","1","263","17.2","14.9"
"Evans","2020-10-24","4","1914","0","263","11.1","14.9"
"Evans","2020-10-25","8","1922","1","264","12.8","14.9"
"Evans","2020-10-26","9","1931","1","265","10.1","15"
"Evans","2020-10-27","5","1936","1","266","8.6","13.1"
"Evans","2020-10-28","12","1948","2","268","11","14.3"
"Evans","2020-10-29","42","1990","1","269","11.3","13.1"
"Evans","2020-10-30","21","2011","0","269","9","13.1"
"Evans","2020-10-31","4","2015","2","271","16.1","13.6"
"Evans","2020-11-01","1","2016","0","271","14.3","13.6"
"Evans","2020-11-02","5","2021","0","271","12.7","11.4"
"Evans","2020-11-03","5","2026","1","272","12.7","10.7"
"Evans","2020-11-04","10","2036","2","274","13.2","12.1"
"Evans","2020-11-05","8","2044","1","275","14.6","13"
"Evans","2020-11-06","7","2051","1","276","16.7","12.8"
"Evans","2020-11-07","3","2054","0","276","9.5","12.8"
"Evans","2020-11-08","0","2054","0","276","9.5","11.9"
"Evans","2020-11-09","7","2061","0","276","9.5","11.1"
"Evans","2020-11-10","6","2067","0","276","6.7","9.7"
"Evans","2020-11-11","11","2078","1","277","5.1","9.2"
"Evans","2020-11-12","5","2083","1","278","6.2","10.4"
"Evans","2020-11-13","11","2094","0","278","4.2","10.4"
"Evans","2020-11-14","4","2098","0","278","4.2","6.8"
"Evans","2020-11-15","2","2100","1","279","11.3","10.4"
"Evans","2020-11-16","14","2114","3","282","14.4","12"
"Evans","2020-11-17","6","2120","2","284","19.1","12.9"
"Evans","2020-11-18","6","2126","0","284","17.8","11.5"
"Evans","2020-11-19","13","2139","3","287","18.3","12.2"
"Evans","2020-11-20","6","2145","0","287","18.3","11.2"
"Evans","2020-11-21","2","2147","0","287","18.3","11.2"
"Evans","2020-11-22","8","2155","1","288","12.9","12.1"
"Evans","2020-11-23","4","2159","0","288","9.8","12.1"
"Evans","2020-11-24","9","2168","0","288","5.1","12.1"
"Evans","2020-11-25","4","2172","0","288","5.1","11.5"
"Evans","2020-11-26","3","2175","0","288","1.8","10"
"Evans","2020-11-27","4","2179","0","288","1.8","10"
"Evans","2020-11-28","4","2183","0","288","1.8","10"
"Evans","2020-11-29","5","2188","1","289","2.9","7.9"
"Evans","2020-11-30","17","2205","1","290","3.7","6.8"
"Evans","2020-12-01","6","2211","1","291","6.1","5.6"
"Evans","2020-12-02","5","2216","0","291","6.1","5.6"
"Evans","2020-12-03","6","2222","0","291","6.1","3.9"
"Evans","2020-12-04","4","2226","0","291","6.1","3.9"
"Evans","2020-12-05","3","2229","2","293","15.6","8.7"
"Evans","2020-12-06","8","2237","0","293","12.7","7.8"
"Evans","2020-12-07","9","2246","2","295","15.1","9.4"
"Evans","2020-12-08","7","2253","0","295","12.7","9.4"
"Evans","2020-12-09","6","2259","1","296","15.1","10.6"
"Evans","2020-12-10","14","2273","1","297","16.1","11.1"
"Evans","2020-12-11","8","2281","0","297","16.1","11.1"
"Evans","2020-12-12","5","2286","2","299","12.3","13.9"
"Evans","2020-12-13","2","2288","0","299","12.3","12.5"
"Evans","2020-12-14","17","2305","3","302","11.6","13.4"
"Evans","2020-12-15","19","2324","5","307","15.4","14"
"Evans","2020-12-16","10","2334","0","307","13","14"
"Evans","2020-12-17","16","2350","5","312","16.5","16.3"
"Evans","2020-12-18","10","2360","2","314","19.3","17.7"
"Evans","2020-12-19","10","2370","1","315","15","13.7"
"Evans","2020-12-20","7","2377","0","315","15","13.7"
"Evans","2020-12-21","14","2391","1","316","13.5","12.6"
"Evans","2020-12-22","18","2409","5","321","13.7","14.6"
"Evans","2020-12-23","11","2420","2","323","16.3","14.7"
"Evans","2020-12-24","3","2423","0","323","11.9","14.2"
"Evans","2020-12-25","0","2423","0","323","9","14.2"
"Evans","2020-12-26","5","2428","0","323","7.6","11.3"
"Evans","2020-12-27","1","2429","0","323","7.6","11.3"
"Evans","2020-12-28","7","2436","1","324","8.6","11.1"
"Evans","2020-12-29","13","2449","1","325","5.7","9.7"
"Evans","2020-12-30","8","2457","3","328","8.5","12.4"
"Evans","2020-12-31","4","2461","3","331","19.2","15.5"
"Evans","2021-01-01","0","2461","0","331","19.2","14.1"
"Evans","2021-01-02","1","2462","0","331","19.2","13.4"
"Evans","2021-01-03","1","2463","0","331","19.2","13.4"
"Evans","2021-01-04","7","2470","2","333","21.3","14.9"
"Evans","2021-01-05","10","2480","2","335","23","14.4"
"Evans","2021-01-06","8","2488","1","336","19.4","14"
"Evans","2021-01-07","12","2500","3","339","12.3","15.8"
"Evans","2021-01-08","10","2510","3","342","16.6","17.9"
"Evans","2021-01-09","1","2511","1","343","30.9","25"
"Evans","2021-01-10","5","2516","0","343","30.9","25"
"Evans","2021-01-11","18","2534","4","347","30","25.6"
"Evans","2021-01-12","15","2549","2","349","29","26"
"Evans","2021-01-13","15","2564","2","351","29.1","24.3"
"Evans","2021-01-14","5","2569","1","352","28.4","20.4"
"Evans","2021-01-15","6","2575","1","353","26.5","21.5"
"Evans","2021-01-16","0","2575","0","353","12.2","21.5"
"Evans","2021-01-17","4","2579","1","354","15.8","23.3"
"Evans","2021-01-18","10","2589","0","354","12.6","21.3"
"Evans","2021-01-19","9","2598","2","356","13.9","21.4"
"Evans","2021-01-20","25","2623","7","363","16","22.6"
"Evans","2021-01-21","9","2632","0","363","13.1","20.8"
"Evans","2021-01-22","10","2642","3","366","15","20.8"
"Evans","2021-01-23","4","2646","0","366","15","13.6"
"Evans","2021-01-24","4","2650","2","368","18.6","17.2"
"Evans","2021-01-25","17","2667","7","375","24.5","18.6"
"Evans","2021-01-26","17","2684","3","378","23.8","18.9"
"Evans","2021-01-27","32","2716","2","380","20.7","18.4"
"Evans","2021-01-28","13","2729","3","383","24","18.6"
"Evans","2021-01-29","14","2743","4","387","23.8","19.4"
"Evans","2021-01-30","2","2745","0","387","23.8","19.4"
"Evans","2021-01-31","1","2746","0","387","16.7","17.6"
"Evans","2021-02-01","44","2790","2","389","11.4","18"
"Evans","2021-02-02","6","2796","3","392","16.1","19.9"
"Evans","2021-02-03","7","2803","1","393","17.2","19"
"Evans","2021-02-04","30","2833","13","406","20.1","22.1"
"Evans","2021-02-05","9","2842","0","406","16","19.9"
"Evans","2021-02-06","1","2843","0","406","16","19.9"
"Evans","2021-02-07","0","2843","0","406","16","16.3"
"Evans","2021-02-08","0","2843","0","406","15.4","13.4"
"Fannin","2020-02-01","0","0","0","0",".","."
"Fannin","2020-02-02","0","0","0","0",".","."
"Fannin","2020-02-03","0","0","0","0",".","."
"Fannin","2020-02-04","0","0","0","0",".","."
"Fannin","2020-02-05","0","0","0","0",".","."
"Fannin","2020-02-06","0","0","0","0",".","."
"Fannin","2020-02-07","0","0","0","0","0","."
"Fannin","2020-02-08","0","0","0","0","0","."
"Fannin","2020-02-09","0","0","0","0","0","."
"Fannin","2020-02-10","0","0","0","0","0","."
"Fannin","2020-02-11","0","0","0","0","0","."
"Fannin","2020-02-12","0","0","0","0","0","."
"Fannin","2020-02-13","0","0","0","0","0","."
"Fannin","2020-02-14","0","0","0","0","0","0"
"Fannin","2020-02-15","0","0","0","0","0","0"
"Fannin","2020-02-16","0","0","0","0","0","0"
"Fannin","2020-02-17","0","0","0","0","0","0"
"Fannin","2020-02-18","0","0","0","0","0","0"
"Fannin","2020-02-19","0","0","0","0","0","0"
"Fannin","2020-02-20","0","0","0","0","0","0"
"Fannin","2020-02-21","0","0","0","0","0","0"
"Fannin","2020-02-22","0","0","0","0","0","0"
"Fannin","2020-02-23","0","0","0","0","0","0"
"Fannin","2020-02-24","0","0","0","0","0","0"
"Fannin","2020-02-25","0","0","0","0","0","0"
"Fannin","2020-02-26","0","0","0","0","0","0"
"Fannin","2020-02-27","0","0","0","0","0","0"
"Fannin","2020-02-28","0","0","0","0","0","0"
"Fannin","2020-02-29","0","0","0","0","0","0"
"Fannin","2020-03-01","0","0","0","0","0","0"
"Fannin","2020-03-02","0","0","0","0","0","0"
"Fannin","2020-03-03","0","0","0","0","0","0"
"Fannin","2020-03-04","0","0","0","0","0","0"
"Fannin","2020-03-05","0","0","0","0","0","0"
"Fannin","2020-03-06","0","0","0","0","0","0"
"Fannin","2020-03-07","0","0","0","0","0","0"
"Fannin","2020-03-08","0","0","0","0","0","0"
"Fannin","2020-03-09","0","0","0","0","0","0"
"Fannin","2020-03-10","1","1","0","0","0","0"
"Fannin","2020-03-11","0","1","0","0","0","0"
"Fannin","2020-03-12","2","3","0","0","0","0"
"Fannin","2020-03-13","3","6","0","0","0","0"
"Fannin","2020-03-14","0","6","0","0","0","0"
"Fannin","2020-03-15","2","8","0","0","0","0"
"Fannin","2020-03-16","1","9","0","0","0","0"
"Fannin","2020-03-17","5","14","1","1","2.9","1.4"
"Fannin","2020-03-18","1","15","0","1","2.9","1.4"
"Fannin","2020-03-19","1","16","0","1","2.9","1.4"
"Fannin","2020-03-20","6","22","1","2","5.2","2.6"
"Fannin","2020-03-21","1","23","0","2","5.2","2.6"
"Fannin","2020-03-22","1","24","0","2","5.2","2.6"
"Fannin","2020-03-23","5","29","1","3","8.1","4"
"Fannin","2020-03-24","4","33","0","3","5.2","4"
"Fannin","2020-03-25","11","44","0","3","5.2","4"
"Fannin","2020-03-26","13","57","0","3","5.2","4"
"Fannin","2020-03-27","10","67","0","3","2.9","4"
"Fannin","2020-03-28","1","68","0","3","2.9","4"
"Fannin","2020-03-29","5","73","2","5","8.6","6.9"
"Fannin","2020-03-30","3","76","0","5","5.7","6.9"
"Fannin","2020-03-31","4","80","0","5","5.7","5.5"
"Fannin","2020-04-01","3","83","0","5","5.7","5.5"
"Fannin","2020-04-02","7","90","0","5","5.7","5.5"
"Fannin","2020-04-03","12","102","0","5","5.7","4.3"
"Fannin","2020-04-04","5","107","1","6","8.6","5.7"
"Fannin","2020-04-05","1","108","0","6","2.9","5.7"
"Fannin","2020-04-06","5","113","1","7","5.7","5.7"
"Fannin","2020-04-07","8","121","3","10","11.1","8.4"
"Fannin","2020-04-08","5","126","0","10","11.1","8.4"
"Fannin","2020-04-09","3","129","1","11","15.8","10.8"
"Fannin","2020-04-10","2","131","1","12","23","14.3"
"Fannin","2020-04-11","5","136","0","12","20.1","14.3"
"Fannin","2020-04-12","2","138","0","12","20.1","11.5"
"Fannin","2020-04-13","3","141","0","12","17.3","11.5"
"Fannin","2020-04-14","5","146","0","12","11.9","11.5"
"Fannin","2020-04-15","5","151","0","12","11.9","11.5"
"Fannin","2020-04-16","10","161","0","12","7.1","11.5"
"Fannin","2020-04-17","7","168","0","12","0","11.5"
"Fannin","2020-04-18","6","174","0","12","0","10.1"
"Fannin","2020-04-19","8","182","0","12","0","10.1"
"Fannin","2020-04-20","5","187","0","12","0","8.6"
"Fannin","2020-04-21","11","198","0","12","0","6"
"Fannin","2020-04-22","10","208","0","12","0","6"
"Fannin","2020-04-23","14","222","0","12","0","3.6"
"Fannin","2020-04-24","22","244","0","12","0","0"
"Fannin","2020-04-25","13","257","0","12","0","0"
"Fannin","2020-04-26","5","262","1","13","2.9","1.4"
"Fannin","2020-04-27","19","281","0","13","2.9","1.4"
"Fannin","2020-04-28","23","304","0","13","2.9","1.4"
"Fannin","2020-04-29","19","323","0","13","2.9","1.4"
"Fannin","2020-04-30","15","338","1","14","3.8","1.9"
"Fannin","2020-05-01","13","351","0","14","3.8","1.9"
"Fannin","2020-05-02","4","355","0","14","3.8","1.9"
"Fannin","2020-05-03","4","359","0","14","1","1.9"
"Fannin","2020-05-04","18","377","0","14","1","1.9"
"Fannin","2020-05-05","11","388","0","14","1","1.9"
"Fannin","2020-05-06","21","409","2","16","2.3","2.6"
"Fannin","2020-05-07","14","423","0","16","1.4","2.6"
"Fannin","2020-05-08","17","440","0","16","1.4","2.6"
"Fannin","2020-05-09","8","448","0","16","1.4","2.6"
"Fannin","2020-05-10","5","453","0","16","1.4","1.2"
"Fannin","2020-05-11","14","467","0","16","1.4","1.2"
"Fannin","2020-05-12","39","506","2","18","2.1","1.5"
"Fannin","2020-05-13","14","520","0","18","0.7","1.5"
"Fannin","2020-05-14","14","534","0","18","0.7","1"
"Fannin","2020-05-15","23","557","1","19","1.4","1.4"
"Fannin","2020-05-16","3","560","0","19","1.4","1.4"
"Fannin","2020-05-17","8","568","0","19","1.4","1.4"
"Fannin","2020-05-18","13","581","0","19","1.4","1.4"
"Fannin","2020-05-19","35","616","0","19","0.6","1.4"
"Fannin","2020-05-20","23","639","0","19","0.6","0.7"
"Fannin","2020-05-21","31","670","0","19","0.6","0.7"
"Fannin","2020-05-22","31","701","0","19","0","0.7"
"Fannin","2020-05-23","3","704","0","19","0","0.7"
"Fannin","2020-05-24","7","711","0","19","0","0.7"
"Fannin","2020-05-25","5","716","0","19","0","0.7"
"Fannin","2020-05-26","30","746","1","20","0.5","0.5"
"Fannin","2020-05-27","33","779","2","22","1.3","1"
"Fannin","2020-05-28","29","808","0","22","1.3","1"
"Fannin","2020-05-29","16","824","0","22","1.3","0.7"
"Fannin","2020-05-30","2","826","1","23","8.5","4.2"
"Fannin","2020-05-31","12","838","2","25","10.9","5.4"
"Fannin","2020-06-01","18","856","1","26","11.7","5.8"
"Fannin","2020-06-02","31","887","0","26","11.2","5.8"
"Fannin","2020-06-03","17","904","0","26","10.3","5.8"
"Fannin","2020-06-04","27","931","2","28","11.4","6.4"
"Fannin","2020-06-05","24","955","2","30","12.6","7"
"Fannin","2020-06-06","18","973","2","32","7","7.7"
"Fannin","2020-06-07","3","976","0","32","4.6","7.7"
"Fannin","2020-06-08","25","1001","2","34","5","8.3"
"Fannin","2020-06-09","34","1035","2","36","5.8","8.5"
"Fannin","2020-06-10","19","1054","2","38","7.3","8.8"
"Fannin","2020-06-11","27","1081","0","38","6.3","8.8"
"Fannin","2020-06-12","24","1105","1","39","5.7","9.1"
"Fannin","2020-06-13","3","1108","0","39","4.1","5.5"
"Fannin","2020-06-14","0","1108","0","39","4.1","4.4"
"Fannin","2020-06-15","22","1130","2","41","4.2","4.6"
"Fannin","2020-06-16","21","1151","1","42","4.1","4.9"
"Fannin","2020-06-17","20","1171","2","44","4","5.7"
"Fannin","2020-06-18","17","1188","1","45","4.8","5.6"
"Fannin","2020-06-19","12","1200","0","45","4.2","5"
"Fannin","2020-06-20","0","1200","0","45","4.2","4.2"
"Fannin","2020-06-21","2","1202","0","45","4.2","4.2"
"Fannin","2020-06-22","17","1219","1","46","3.8","4"
"Fannin","2020-06-23","24","1243","0","46","3.1","3.6"
"Fannin","2020-06-24","26","1269","2","48","2.8","3.4"
"Fannin","2020-06-25","22","1291","1","49","2.6","3.7"
"Fannin","2020-06-26","21","1312","0","49","2.6","3.4"
"Fannin","2020-06-27","18","1330","2","51","4.2","4.2"
"Fannin","2020-06-28","4","1334","0","51","4.2","4.2"
"Fannin","2020-06-29","17","1351","2","53","5","4.4"
"Fannin","2020-06-30","30","1381","4","57","6.9","5"
"Fannin","2020-07-01","13","1394","0","57","5.8","4.3"
"Fannin","2020-07-02","18","1412","0","57","5.2","3.9"
"Fannin","2020-07-03","15","1427","0","57","5.2","3.9"
"Fannin","2020-07-04","6","1433","0","57","3.6","3.9"
"Fannin","2020-07-05","5","1438","0","57","3.6","3.9"
"Fannin","2020-07-06","33","1471","2","59","2.8","3.9"
"Fannin","2020-07-07","22","1493","1","60","1.5","4.2"
"Fannin","2020-07-08","19","1512","3","63","3.8","4.8"
"Fannin","2020-07-09","31","1543","4","67","5.6","5.4"
"Fannin","2020-07-10","50","1593","2","69","6.2","5.7"
"Fannin","2020-07-11","4","1597","1","70","9.8","6.7"
"Fannin","2020-07-12","4","1601","1","71","13.3","8.5"
"Fannin","2020-07-13","47","1648","4","75","13.7","8.2"
"Fannin","2020-07-14","26","1674","7","82","16.9","9.2"
"Fannin","2020-07-15","26","1700","4","86","16.8","10.3"
"Fannin","2020-07-16","35","1735","4","90","16.6","11.1"
"Fannin","2020-07-17","36","1771","7","97","18.8","12.5"
"Fannin","2020-07-18","0","1771","0","97","15.2","12.5"
"Fannin","2020-07-19","7","1778","1","98","13.7","13.5"
"Fannin","2020-07-20","47","1825","4","102","13.7","13.7"
"Fannin","2020-07-21","19","1844","2","104","11.4","14.1"
"Fannin","2020-07-22","34","1878","2","106","10","13.4"
"Fannin","2020-07-23","21","1899","0","106","8.4","12.5"
"Fannin","2020-07-24","32","1931","4","110","7.4","13.1"
"Fannin","2020-07-25","6","1937","3","113","14.5","14.9"
"Fannin","2020-07-26","4","1941","0","113","12.5","13.1"
"Fannin","2020-07-27","20","1961","2","115","12.7","13.2"
"Fannin","2020-07-28","22","1983","3","118","13.1","12.3"
"Fannin","2020-07-29","10","1993","1","119","13.7","11.9"
"Fannin","2020-07-30","32","2025","3","122","15.1","11.7"
"Fannin","2020-07-31","18","2043","1","123","14.1","10.7"
"Fannin","2020-08-01","5","2048","0","123","6.9","10.7"
"Fannin","2020-08-02","4","2052","0","123","6.9","9.7"
"Fannin","2020-08-03","32","2084","2","125","6.4","9.6"
"Fannin","2020-08-04","28","2112","1","126","5","9.1"
"Fannin","2020-08-05","20","2132","2","128","5","9.3"
"Fannin","2020-08-06","22","2154","3","131","5.6","10.3"
"Fannin","2020-08-07","33","2187","1","132","5.2","9.6"
"Fannin","2020-08-08","4","2191","0","132","5.2","6.1"
"Fannin","2020-08-09","7","2198","0","132","5.2","6.1"
"Fannin","2020-08-10","22","2220","2","134","5.6","6"
"Fannin","2020-08-11","23","2243","3","137","7","6"
"Fannin","2020-08-12","33","2276","2","139","6.4","5.7"
"Fannin","2020-08-13","33","2309","6","145","7.1","6.3"
"Fannin","2020-08-14","34","2343","1","146","7","6.1"
"Fannin","2020-08-15","11","2354","0","146","7","6.1"
"Fannin","2020-08-16","11","2365","1","147","8.3","6.8"
"Fannin","2020-08-17","33","2398","2","149","7.9","6.8"
"Fannin","2020-08-18","20","2418","0","149","6","6.5"
"Fannin","2020-08-19","51","2469","2","151","5.7","6.1"
"Fannin","2020-08-20","41","2510","1","152","3.5","5.3"
"Fannin","2020-08-21","71","2581","2","154","3.5","5.3"
"Fannin","2020-08-22","6","2587","0","154","3.5","5.3"
"Fannin","2020-08-23","5","2592","1","155","5","6.7"
"Fannin","2020-08-24","30","2622","3","158","5.6","6.8"
"Fannin","2020-08-25","19","2641","2","160","7.1","6.6"
"Fannin","2020-08-26","62","2703","3","163","7.2","6.5"
"Fannin","2020-08-27","24","2727","1","164","7.5","5.5"
"Fannin","2020-08-28","36","2763","4","168","8.7","6.1"
"Fannin","2020-08-29","22","2785","7","175","13.2","8.3"
"Fannin","2020-08-30","87","2872","18","193","13.3","9.2"
"Fannin","2020-08-31","35","2907","3","196","13.1","9.3"
"Fannin","2020-09-01","46","2953","4","200","12.8","10"
"Fannin","2020-09-02","41","2994","8","208","14.9","11.1"
"Fannin","2020-09-03","21","3015","0","208","14.3","10.9"
"Fannin","2020-09-04","86","3101","18","226","15.7","12.2"
"Fannin","2020-09-05","16","3117","2","228","13","13.1"
"Fannin","2020-09-06","7","3124","0","228","10","11.7"
"Fannin","2020-09-07","4","3128","2","230","15.9","14.5"
"Fannin","2020-09-08","43","3171","3","233","15.7","14.3"
"Fannin","2020-09-09","10","3181","2","235","15.8","15.4"
"Fannin","2020-09-10","18","3199","1","236","16.6","15.5"
"Fannin","2020-09-11","48","3247","10","246","16.6","16.1"
"Fannin","2020-09-12","23","3270","7","253","19.1","16"
"Fannin","2020-09-13","8","3278","1","254","20.9","15.5"
"Fannin","2020-09-14","37","3315","3","257","14.9","15.4"
"Fannin","2020-09-15","17","3332","5","262","18.1","16.9"
"Fannin","2020-09-16","44","3376","2","264","15.9","15.8"
"Fannin","2020-09-17","51","3427","13","277","18.8","17.7"
"Fannin","2020-09-18","56","3483","4","281","16.8","16.7"
"Fannin","2020-09-19","8","3491","0","281","12.5","15.8"
"Fannin","2020-09-20","10","3501","1","282","12.1","16.5"
"Fannin","2020-09-21","35","3536","3","285","12.2","13.5"
"Fannin","2020-09-22","25","3561","3","288","9.7","13.9"
"Fannin","2020-09-23","21","3582","1","289","9.7","12.8"
"Fannin","2020-09-24","34","3616","3","292","7.3","13"
"Fannin","2020-09-25","62","3678","2","294","6.8","11.8"
"Fannin","2020-09-26","14","3692","0","294","6.8","9.6"
"Fannin","2020-09-27","7","3699","1","295","7.4","9.7"
"Fannin","2020-09-28","32","3731","2","297","7","9.6"
"Fannin","2020-09-29","23","3754","5","302","8.4","9.1"
"Fannin","2020-09-30","32","3786","3","305","9.1","9.4"
"Fannin","2020-10-01","30","3816","1","306","8.3","7.8"
"Fannin","2020-10-02","39","3855","3","309","9","7.9"
"Fannin","2020-10-03","7","3862","3","312","15.1","10.9"
"Fannin","2020-10-04","4","3866","1","313","16.6","12"
"Fannin","2020-10-05","59","3925","4","317","16.7","11.9"
"Fannin","2020-10-06","26","3951","3","320","15.2","11.8"
"Fannin","2020-10-07","15","3966","2","322","15.8","12.4"
"Fannin","2020-10-08","29","3995","6","328","18.3","13.3"
"Fannin","2020-10-09","35","4030","1","329","17.6","13.3"
"Fannin","2020-10-10","8","4038","3","332","16.8","15.9"
"Fannin","2020-10-11","5","4043","1","333","16.1","16.4"
"Fannin","2020-10-12","54","4097","0","333","15.1","15.9"
"Fannin","2020-10-13","23","4120","3","336","15.3","15.3"
"Fannin","2020-10-14","20","4140","1","337","14.2","15"
"Fannin","2020-10-15","30","4170","4","341","13.1","15.7"
"Fannin","2020-10-16","36","4206","0","341","12.7","15.1"
"Fannin","2020-10-17","1","4207","0","341","7.3","12.1"
"Fannin","2020-10-18","5","4212","1","342","7.3","11.7"
"Fannin","2020-10-19","41","4253","4","346","8.7","11.9"
"Fannin","2020-10-20","25","4278","1","347","7.4","11.4"
"Fannin","2020-10-21","19","4297","2","349","8.2","11.2"
"Fannin","2020-10-22","43","4340","4","353","7.7","10.4"
"Fannin","2020-10-23","28","4368","4","357","9.7","11.2"
"Fannin","2020-10-24","3","4371","0","357","9.7","8.5"
"Fannin","2020-10-25","6","4377","1","358","9.2","8.3"
"Fannin","2020-10-26","29","4406","3","361","9.3","9"
"Fannin","2020-10-27","30","4436","3","364","10.2","8.8"
"Fannin","2020-10-28","22","4458","1","365","9.3","8.8"
"Fannin","2020-10-29","24","4482","1","366","8.6","8.1"
"Fannin","2020-10-30","43","4525","0","366","6.5","8.1"
"Fannin","2020-10-31","8","4533","0","366","6.5","8.1"
"Fannin","2020-11-01","9","4542","1","367","5.7","7.5"
"Fannin","2020-11-02","31","4573","4","371","6.1","7.7"
"Fannin","2020-11-03","21","4594","3","374","6.7","8.4"
"Fannin","2020-11-04","20","4614","0","374","6.1","7.7"
"Fannin","2020-11-05","30","4644","0","374","5.5","7"
"Fannin","2020-11-06","33","4677","0","374","5.5","6"
"Fannin","2020-11-07","7","4684","3","377","11.6","9.1"
"Fannin","2020-11-08","9","4693","0","377","10","7.9"
"Fannin","2020-11-09","49","4742","0","377","8.2","7.1"
"Fannin","2020-11-10","53","4795","7","384","8","7.4"
"Fannin","2020-11-11","25","4820","3","387","9.7","7.9"
"Fannin","2020-11-12","68","4888","19","406","13.7","9.6"
"Fannin","2020-11-13","52","4940","7","413","15.6","10.6"
"Fannin","2020-11-14","10","4950","1","414","10.9","11.3"
"Fannin","2020-11-15","6","4956","0","414","10.9","10.5"
"Fannin","2020-11-16","77","5033","6","420","12.1","10.1"
"Fannin","2020-11-17","27","5060","2","422","11.2","9.6"
"Fannin","2020-11-18","55","5115","5","427","10.8","10.3"
"Fannin","2020-11-19","73","5188","6","433","8","10.9"
"Fannin","2020-11-20","47","5235","1","434","6.4","11"
"Fannin","2020-11-21","15","5250","2","436","6.9","8.9"
"Fannin","2020-11-22","12","5262","0","436","6.9","8.9"
"Fannin","2020-11-23","68","5330","7","443","7.2","9.6"
"Fannin","2020-11-24","50","5380","3","446","7","9.1"
"Fannin","2020-11-25","60","5440","7","453","7.4","9.1"
"Fannin","2020-11-26","6","5446","0","453","6.2","7.1"
"Fannin","2020-11-27","43","5489","4","457","7.2","6.8"
"Fannin","2020-11-28","18","5507","2","459","6.9","6.9"
"Fannin","2020-11-29","10","5517","2","461","9.8","8.3"
"Fannin","2020-11-30","69","5586","5","466","9.3","8.3"
"Fannin","2020-12-01","80","5666","5","471","9.4","8.2"
"Fannin","2020-12-02","65","5731","16","487","11.2","9.3"
"Fannin","2020-12-03","70","5801","10","497","13.3","9.7"
"Fannin","2020-12-04","65","5866","11","508","14.3","10.8"
"Fannin","2020-12-05","18","5884","1","509","13.6","10.2"
"Fannin","2020-12-06","7","5891","0","509","10.7","10.2"
"Fannin","2020-12-07","79","5970","14","523","12.2","10.8"
"Fannin","2020-12-08","54","6024","12","535","14.5","11.9"
"Fannin","2020-12-09","157","6181","6","541","11.5","11.4"
"Fannin","2020-12-10","61","6242","7","548","11.1","12.2"
"Fannin","2020-12-11","71","6313","13","561","11.3","12.8"
"Fannin","2020-12-12","20","6333","7","568","15.5","14.5"
"Fannin","2020-12-13","7","6340","2","570","19.6","15.1"
"Fannin","2020-12-14","83","6423","8","578","18.4","15.3"
"Fannin","2020-12-15","68","6491","5","583","16.3","15.4"
"Fannin","2020-12-16","174","6665","17","600","17.2","14.3"
"Fannin","2020-12-17","88","6753","10","610","17.1","14.1"
"Fannin","2020-12-18","34","6787","5","615","16.6","14"
"Fannin","2020-12-19","12","6799","0","615","11.6","13.6"
"Fannin","2020-12-20","15","6814","3","618","10.4","15"
"Fannin","2020-12-21","102","6916","9","627","10.3","14.4"
"Fannin","2020-12-22","56","6972","7","634","11","13.7"
"Fannin","2020-12-23","156","7128","9","643","10.5","13.8"
"Fannin","2020-12-24","33","7161","6","649","11.4","14.3"
"Fannin","2020-12-25","5","7166","1","650","12.2","14.4"
"Fannin","2020-12-26","8","7174","2","652","15.8","13.7"
"Fannin","2020-12-27","4","7178","1","653","16.5","13.4"
"Fannin","2020-12-28","81","7259","14","667","17.7","14"
"Fannin","2020-12-29","49","7308","13","680","19.7","15.4"
"Fannin","2020-12-30","63","7371","21","701","23.6","17"
"Fannin","2020-12-31","71","7442","15","716","24","17.7"
"Fannin","2021-01-01","11","7453","2","718","23.8","18"
"Fannin","2021-01-02","4","7457","2","720","27.4","21.6"
"Fannin","2021-01-03","6","7463","1","721","26.2","21.3"
"Fannin","2021-01-04","83","7546","15","736","26.3","22"
"Fannin","2021-01-05","101","7647","16","752","24.7","22.2"
"Fannin","2021-01-06","98","7745","17","769","22.5","23"
"Fannin","2021-01-07","96","7841","18","787","22.1","23.1"
"Fannin","2021-01-08","51","7892","13","800","23.2","23.5"
"Fannin","2021-01-09","13","7905","2","802","18.2","22.8"
"Fannin","2021-01-10","12","7917","2","804","18.2","22.2"
"Fannin","2021-01-11","76","7993","21","825","19.6","22.9"
"Fannin","2021-01-12","63","8056","17","842","21.2","23"
"Fannin","2021-01-13","66","8122","24","866","23.9","23.2"
"Fannin","2021-01-14","63","8185","16","882","24.8","23.5"
"Fannin","2021-01-15","58","8243","12","894","24.2","23.7"
"Fannin","2021-01-16","20","8263","5","899","25.5","21.9"
"Fannin","2021-01-17","11","8274","2","901","25.7","22"
"Fannin","2021-01-18","88","8362","22","923","25.4","22.5"
"Fannin","2021-01-19","66","8428","13","936","24.3","22.8"
"Fannin","2021-01-20","63","8491","8","944","21","22.4"
"Fannin","2021-01-21","49","8540","9","953","19.9","22.4"
"Fannin","2021-01-22","42","8582","7","960","19.4","21.8"
"Fannin","2021-01-23","9","8591","2","962","19","22.3"
"Fannin","2021-01-24","18","8609","3","965","18.8","22.3"
"Fannin","2021-01-25","67","8676","16","981","18.6","22"
"Fannin","2021-01-26","41","8717","3","984","16.8","20.6"
"Fannin","2021-01-27","137","8854","18","1002","16.9","18.9"
"Fannin","2021-01-28","42","8896","5","1007","16","18"
"Fannin","2021-01-29","59","8955","10","1017","16","17.7"
"Fannin","2021-01-30","13","8968","4","1021","17.2","18.1"
"Fannin","2021-01-31","10","8978","2","1023","17.7","18.2"
"Fannin","2021-02-01","49","9027","9","1032","16.9","17.8"
"Fannin","2021-02-02","34","9061","2","1034","16.7","16.8"
"Fannin","2021-02-03","127","9188","7","1041","15.6","16.3"
"Fannin","2021-02-04","28","9216","2","1043","14.9","15.5"
"Fannin","2021-02-05","27","9243","0","1043","12.5","14.3"
"Fannin","2021-02-06","6","9249","1","1044","10.5","13.9"
"Fannin","2021-02-07","0","9249","0","1044","7.7","12.7"
"Fannin","2021-02-08","0","9249","0","1044","5","11"
"Fayette","2020-02-01","0","0","0","0",".","."
"Fayette","2020-02-02","0","0","0","0",".","."
"Fayette","2020-02-03","0","0","0","0",".","."
"Fayette","2020-02-04","0","0","0","0",".","."
"Fayette","2020-02-05","0","0","0","0",".","."
"Fayette","2020-02-06","0","0","0","0",".","."
"Fayette","2020-02-07","0","0","0","0","0","."
"Fayette","2020-02-08","0","0","0","0","0","."
"Fayette","2020-02-09","0","0","0","0","0","."
"Fayette","2020-02-10","0","0","0","0","0","."
"Fayette","2020-02-11","0","0","0","0","0","."
"Fayette","2020-02-12","0","0","0","0","0","."
"Fayette","2020-02-13","0","0","0","0","0","."
"Fayette","2020-02-14","0","0","0","0","0","0"
"Fayette","2020-02-15","0","0","0","0","0","0"
"Fayette","2020-02-16","0","0","0","0","0","0"
"Fayette","2020-02-17","0","0","0","0","0","0"
"Fayette","2020-02-18","0","0","0","0","0","0"
"Fayette","2020-02-19","0","0","0","0","0","0"
"Fayette","2020-02-20","0","0","0","0","0","0"
"Fayette","2020-02-21","0","0","0","0","0","0"
"Fayette","2020-02-22","0","0","0","0","0","0"
"Fayette","2020-02-23","0","0","0","0","0","0"
"Fayette","2020-02-24","0","0","0","0","0","0"
"Fayette","2020-02-25","0","0","0","0","0","0"
"Fayette","2020-02-26","0","0","0","0","0","0"
"Fayette","2020-02-27","0","0","0","0","0","0"
"Fayette","2020-02-28","0","0","0","0","0","0"
"Fayette","2020-02-29","0","0","0","0","0","0"
"Fayette","2020-03-01","0","0","0","0","0","0"
"Fayette","2020-03-02","0","0","0","0","0","0"
"Fayette","2020-03-03","0","0","0","0","0","0"
"Fayette","2020-03-04","0","0","0","0","0","0"
"Fayette","2020-03-05","0","0","0","0","0","0"
"Fayette","2020-03-06","0","0","0","0","0","0"
"Fayette","2020-03-07","0","0","0","0","0","0"
"Fayette","2020-03-08","4","4","4","4","14.3","7.1"
"Fayette","2020-03-09","1","5","0","4","14.3","7.1"
"Fayette","2020-03-10","1","6","1","5","28.6","14.3"
"Fayette","2020-03-11","1","7","0","5","28.6","14.3"
"Fayette","2020-03-12","8","15","0","5","28.6","14.3"
"Fayette","2020-03-13","11","26","0","5","28.6","14.3"
"Fayette","2020-03-14","4","30","0","5","28.6","14.3"
"Fayette","2020-03-15","2","32","2","7","28.6","21.4"
"Fayette","2020-03-16","13","45","3","10","31.9","23.1"
"Fayette","2020-03-17","18","63","4","14","20.8","24.7"
"Fayette","2020-03-18","23","86","3","17","22.6","25.6"
"Fayette","2020-03-19","20","106","3","20","24.8","26.7"
"Fayette","2020-03-20","43","149","12","32","28.7","28.7"
"Fayette","2020-03-21","6","155","2","34","33.5","31"
"Fayette","2020-03-22","3","158","2","36","28.7","28.7"
"Fayette","2020-03-23","39","197","3","39","26.6","29.2"
"Fayette","2020-03-24","52","249","8","47","25.6","23.2"
"Fayette","2020-03-25","45","294","8","55","26.3","24.4"
"Fayette","2020-03-26","36","330","7","62","26.9","25.8"
"Fayette","2020-03-27","20","350","3","65","25","26.9"
"Fayette","2020-03-28","15","365","6","71","26","29.8"
"Fayette","2020-03-29","4","369","3","74","27.2","28"
"Fayette","2020-03-30","44","413","5","79","27.7","27.1"
"Fayette","2020-03-31","26","439","3","82","27.2","26.4"
"Fayette","2020-04-01","41","480","11","93","28.5","27.4"
"Fayette","2020-04-02","33","513","5","98","27.8","27.4"
"Fayette","2020-04-03","52","565","11","109","28.7","26.9"
"Fayette","2020-04-04","7","572","1","110","25","25.5"
"Fayette","2020-04-05","6","578","2","112","19.1","23.1"
"Fayette","2020-04-06","23","601","3","115","19.3","23.5"
"Fayette","2020-04-07","42","643","6","121","19.7","23.4"
"Fayette","2020-04-08","48","691","2","123","16.5","22.5"
"Fayette","2020-04-09","48","739","6","129","16.1","22"
"Fayette","2020-04-10","66","805","9","138","15","21.9"
"Fayette","2020-04-11","19","824","2","140","14.5","19.8"
"Fayette","2020-04-12","10","834","1","141","11.2","15.1"
"Fayette","2020-04-13","23","857","5","146","12.4","15.9"
"Fayette","2020-04-14","47","904","3","149","11.3","15.5"
"Fayette","2020-04-15","52","956","4","153","11.8","14.1"
"Fayette","2020-04-16","49","1005","5","158","11.5","13.8"
"Fayette","2020-04-17","49","1054","4","162","10.7","12.9"
"Fayette","2020-04-18","23","1077","2","164","10.4","12.5"
"Fayette","2020-04-19","6","1083","0","164","9","10.1"
"Fayette","2020-04-20","40","1123","3","167","6.9","9.7"
"Fayette","2020-04-21","46","1169","2","169","6.7","9"
"Fayette","2020-04-22","60","1229","2","171","6","8.9"
"Fayette","2020-04-23","38","1267","0","171","4.6","8"
"Fayette","2020-04-24","51","1318","4","175","4.5","7.6"
"Fayette","2020-04-25","30","1348","0","175","3.3","6.9"
"Fayette","2020-04-26","27","1375","3","178","4.9","6.9"
"Fayette","2020-04-27","91","1466","2","180","4.1","5.5"
"Fayette","2020-04-28","67","1533","1","181","3.7","5.2"
"Fayette","2020-04-29","69","1602","4","185","4.1","5"
"Fayette","2020-04-30","62","1664","1","186","4.3","4.4"
"Fayette","2020-05-01","61","1725","4","190","4.1","4.3"
"Fayette","2020-05-02","28","1753","0","190","4.1","3.7"
"Fayette","2020-05-03","18","1771","0","190","2.5","3.7"
"Fayette","2020-05-04","70","1841","1","191","2.4","3.3"
"Fayette","2020-05-05","78","1919","1","192","2.4","3"
"Fayette","2020-05-06","76","1995","3","195","2.1","3.1"
"Fayette","2020-05-07","65","2060","2","197","2.3","3.3"
"Fayette","2020-05-08","54","2114","1","198","1.7","2.9"
"Fayette","2020-05-09","23","2137","1","199","2.3","3.2"
"Fayette","2020-05-10","22","2159","0","199","2.3","2.4"
"Fayette","2020-05-11","86","2245","2","201","2.4","2.4"
"Fayette","2020-05-12","79","2324","2","203","2.6","2.5"
"Fayette","2020-05-13","107","2431","5","208","2.7","2.4"
"Fayette","2020-05-14","84","2515","3","211","2.8","2.5"
"Fayette","2020-05-15","84","2599","1","212","2.7","2.2"
"Fayette","2020-05-16","35","2634","3","215","3.3","2.8"
"Fayette","2020-05-17","23","2657","0","215","3.3","2.8"
"Fayette","2020-05-18","105","2762","1","216","3.1","2.7"
"Fayette","2020-05-19","96","2858","1","217","2.9","2.7"
"Fayette","2020-05-20","106","2964","1","218","2.3","2.5"
"Fayette","2020-05-21","45","3009","3","221","2.8","2.8"
"Fayette","2020-05-22","74","3083","2","223","3","2.8"
"Fayette","2020-05-23","47","3130","0","223","1.8","2.5"
"Fayette","2020-05-24","25","3155","1","224","2.3","2.8"
"Fayette","2020-05-25","17","3172","0","224","2.2","2.6"
"Fayette","2020-05-26","135","3307","3","227","2.4","2.6"
"Fayette","2020-05-27","101","3408","1","228","2.4","2.3"
"Fayette","2020-05-28","59","3467","1","229","1.7","2.2"
"Fayette","2020-05-29","94","3561","5","234","2","2.5"
"Fayette","2020-05-30","25","3586","0","234","2","1.9"
"Fayette","2020-05-31","27","3613","1","235","2","2.2"
"Fayette","2020-06-01","104","3717","1","236","2.1","2.2"
"Fayette","2020-06-02","133","3850","1","237","1.9","2.1"
"Fayette","2020-06-03","74","3924","0","237","1.8","2.1"
"Fayette","2020-06-04","56","3980","1","238","1.8","1.7"
"Fayette","2020-06-05","94","4074","3","241","1.5","1.8"
"Fayette","2020-06-06","33","4107","1","242","1.9","2"
"Fayette","2020-06-07","39","4146","1","243","1.8","1.9"
"Fayette","2020-06-08","109","4255","2","245","1.9","2"
"Fayette","2020-06-09","108","4363","0","245","1.8","1.8"
"Fayette","2020-06-10","94","4457","0","245","1.8","1.8"
"Fayette","2020-06-11","71","4528","1","246","1.7","1.8"
"Fayette","2020-06-12","83","4611","0","246","1.3","1.4"
"Fayette","2020-06-13","31","4642","0","246","0.8","1.4"
"Fayette","2020-06-14","37","4679","4","250","2","1.9"
"Fayette","2020-06-15","129","4808","10","260","2.9","2.4"
"Fayette","2020-06-16","126","4934","7","267","3.6","2.7"
"Fayette","2020-06-17","108","5042","8","275","4.7","3.2"
"Fayette","2020-06-18","79","5121","5","280","5.4","3.6"
"Fayette","2020-06-19","99","5220","6","286","6.3","3.8"
"Fayette","2020-06-20","47","5267","7","293","8.4","4.6"
"Fayette","2020-06-21","36","5303","2","295","7.7","4.8"
"Fayette","2020-06-22","242","5545","14","309","7.4","5.1"
"Fayette","2020-06-23","146","5691","4","313","7","5.3"
"Fayette","2020-06-24","177","5868","4","317","6.2","5.5"
"Fayette","2020-06-25","153","6021","3","320","5.6","5.5"
"Fayette","2020-06-26","203","6224","9","329","5.4","5.8"
"Fayette","2020-06-27","51","6275","5","334","4.6","6.5"
"Fayette","2020-06-28","30","6305","2","336","4.8","6.2"
"Fayette","2020-06-29","187","6492","13","349","5","6.2"
"Fayette","2020-06-30","211","6703","11","360","5.3","6.1"
"Fayette","2020-07-01","154","6857","10","370","5.9","6.1"
"Fayette","2020-07-02","145","7002","12","382","6.8","6.2"
"Fayette","2020-07-03","75","7077","6","388","7.3","6.4"
"Fayette","2020-07-04","28","7105","4","392","8","6.3"
"Fayette","2020-07-05","41","7146","13","405","11.6","8.2"
"Fayette","2020-07-06","174","7320","18","423","12","8.5"
"Fayette","2020-07-07","205","7525","17","440","12.5","8.9"
"Fayette","2020-07-08","154","7679","14","454","12.9","9.4"
"Fayette","2020-07-09","187","7866","24","478","13.5","10.2"
"Fayette","2020-07-10","175","8041","16","494","13.7","10.5"
"Fayette","2020-07-11","50","8091","9","503","14.2","11.1"
"Fayette","2020-07-12","37","8128","2","505","10.4","11"
"Fayette","2020-07-13","175","8303","15","520","10.2","11.1"
"Fayette","2020-07-14","223","8526","10","530","9.6","11.1"
"Fayette","2020-07-15","191","8717","15","545","9.5","11.2"
"Fayette","2020-07-16","163","8880","11","556","8.6","11.1"
"Fayette","2020-07-17","146","9026","11","567","8.4","11"
"Fayette","2020-07-18","53","9079","6","573","7.4","10.8"
"Fayette","2020-07-19","48","9127","5","578","8.1","9.3"
"Fayette","2020-07-20","151","9278","10","588","7.9","9"
"Fayette","2020-07-21","100","9378","16","604","9.5","9.6"
"Fayette","2020-07-22","152","9530","14","618","9.7","9.6"
"Fayette","2020-07-23","186","9716","14","632","9.8","9.2"
"Fayette","2020-07-24","154","9870","14","646","10","9.2"
"Fayette","2020-07-25","50","9920","2","648","9","8.2"
"Fayette","2020-07-26","38","9958","10","658","11.3","9.7"
"Fayette","2020-07-27","213","10171","16","674","11.4","9.6"
"Fayette","2020-07-28","166","10337","15","689","10.4","9.9"
"Fayette","2020-07-29","154","10491","9","698","9.9","9.8"
"Fayette","2020-07-30","124","10615","16","714","10.7","10.2"
"Fayette","2020-07-31","160","10775","8","722","10.1","10.1"
"Fayette","2020-08-01","82","10857","6","728","10.6","9.8"
"Fayette","2020-08-02","43","10900","3","731","7.8","9.5"
"Fayette","2020-08-03","163","11063","13","744","7.9","9.6"
"Fayette","2020-08-04","148","11211","15","759","8","9.2"
"Fayette","2020-08-05","148","11359","7","766","7.9","8.9"
"Fayette","2020-08-06","151","11510","6","772","6.6","8.6"
"Fayette","2020-08-07","170","11680","12","784","6.9","8.5"
"Fayette","2020-08-08","102","11782","6","790","6.7","8.6"
"Fayette","2020-08-09","66","11848","12","802","8.3","8"
"Fayette","2020-08-10","166","12014","8","810","7.8","7.8"
"Fayette","2020-08-11","191","12205","12","822","7.3","7.6"
"Fayette","2020-08-12","209","12414","11","833","7.4","7.6"
"Fayette","2020-08-13","208","12622","6","839","7.2","6.9"
"Fayette","2020-08-14","321","12943","14","853","6.8","6.8"
"Fayette","2020-08-15","141","13084","8","861","6.8","6.7"
"Fayette","2020-08-16","68","13152","4","865","5","6.7"
"Fayette","2020-08-17","193","13345","7","872","4.9","6.3"
"Fayette","2020-08-18","174","13519","9","881","4.7","6"
"Fayette","2020-08-19","194","13713","8","889","4.5","5.9"
"Fayette","2020-08-20","144","13857","9","898","5","6.1"
"Fayette","2020-08-21","167","14024","7","905","5","5.9"
"Fayette","2020-08-22","51","14075","0","905","4.2","5.5"
"Fayette","2020-08-23","46","14121","6","911","5.2","5.1"
"Fayette","2020-08-24","172","14293","11","922","5.6","5.2"
"Fayette","2020-08-25","151","14444","8","930","5.6","5.2"
"Fayette","2020-08-26","124","14568","7","937","5.8","5.2"
"Fayette","2020-08-27","175","14743","9","946","5.7","5.3"
"Fayette","2020-08-28","150","14893","11","957","6.1","5.6"
"Fayette","2020-08-29","84","14977","3","960","6.6","5.4"
"Fayette","2020-08-30","36","15013","3","963","6","5.6"
"Fayette","2020-08-31","147","15160","11","974","6.1","5.9"
"Fayette","2020-09-01","139","15299","6","980","6","5.8"
"Fayette","2020-09-02","129","15428","6","986","5.8","5.8"
"Fayette","2020-09-03","132","15560","5","991","5.6","5.7"
"Fayette","2020-09-04","145","15705","7","998","5.3","5.7"
"Fayette","2020-09-05","76","15781","4","1002","5.5","6.1"
"Fayette","2020-09-06","47","15828","2","1004","4.9","5.5"
"Fayette","2020-09-07","37","15865","0","1004","3.9","5"
"Fayette","2020-09-08","130","15995","5","1009","3.8","4.9"
"Fayette","2020-09-09","172","16167","3","1012","3.4","4.6"
"Fayette","2020-09-10","184","16351","7","1019","3.4","4.5"
"Fayette","2020-09-11","158","16509","7","1026","3.3","4.3"
"Fayette","2020-09-12","51","16560","3","1029","3.4","4.5"
"Fayette","2020-09-13","55","16615","2","1031","3.3","4.1"
"Fayette","2020-09-14","163","16778","10","1041","4.2","4"
"Fayette","2020-09-15","156","16934","7","1048","4.3","4.1"
"Fayette","2020-09-16","163","17097","7","1055","4.7","4"
"Fayette","2020-09-17","118","17215","6","1061","4.9","4.1"
"Fayette","2020-09-18","133","17348","5","1066","4.8","4"
"Fayette","2020-09-19","71","17419","6","1072","5.1","4.3"
"Fayette","2020-09-20","37","17456","2","1074","5.4","4.4"
"Fayette","2020-09-21","165","17621","4","1078","4.8","4.5"
"Fayette","2020-09-22","254","17875","12","1090","4.9","4.6"
"Fayette","2020-09-23","180","18055","8","1098","4.9","4.8"
"Fayette","2020-09-24","127","18182","4","1102","4.6","4.7"
"Fayette","2020-09-25","243","18425","6","1108","4.4","4.6"
"Fayette","2020-09-26","47","18472","2","1110","3.8","4.5"
"Fayette","2020-09-27","46","18518","1","1111","3.4","4.4"
"Fayette","2020-09-28","135","18653","9","1120","4","4.4"
"Fayette","2020-09-29","225","18878","6","1126","3.7","4.3"
"Fayette","2020-09-30","160","19038","11","1137","4","4.5"
"Fayette","2020-10-01","134","19172","4","1141","4","4.3"
"Fayette","2020-10-02","230","19402","9","1150","4.2","4.3"
"Fayette","2020-10-03","60","19462","2","1152","4.1","4"
"Fayette","2020-10-04","60","19522","1","1153","4","3.7"
"Fayette","2020-10-05","200","19722","3","1156","3.3","3.6"
"Fayette","2020-10-06","296","20018","4","1160","3.1","3.4"
"Fayette","2020-10-07","203","20221","6","1166","2.5","3.3"
"Fayette","2020-10-08","190","20411","8","1174","2.7","3.4"
"Fayette","2020-10-09","362","20773","8","1182","2.5","3.3"
"Fayette","2020-10-10","90","20863","2","1184","2.3","3.2"
"Fayette","2020-10-11","64","20927","3","1187","2.7","3.4"
"Fayette","2020-10-12","193","21120","9","1196","3.2","3.2"
"Fayette","2020-10-13","192","21312","8","1204","3.6","3.3"
"Fayette","2020-10-14","162","21474","5","1209","3.6","3.1"
"Fayette","2020-10-15","210","21684","22","1231","4.5","3.6"
"Fayette","2020-10-16","208","21892","7","1238","4.7","3.6"
"Fayette","2020-10-17","81","21973","6","1244","5.4","3.9"
"Fayette","2020-10-18","41","22014","1","1245","5.1","3.9"
"Fayette","2020-10-19","180","22194","6","1251","4.9","4"
"Fayette","2020-10-20","244","22438","8","1259","4.8","4.2"
"Fayette","2020-10-21","222","22660","10","1269","5","4.3"
"Fayette","2020-10-22","239","22899","7","1276","3.9","4.2"
"Fayette","2020-10-23","214","23113","15","1291","4.4","4.5"
"Fayette","2020-10-24","84","23197","7","1298","4.5","5"
"Fayette","2020-10-25","68","23265","3","1301","4.8","5"
"Fayette","2020-10-26","262","23527","4","1305","4.6","4.7"
"Fayette","2020-10-27","348","23875","14","1319","4.7","4.7"
"Fayette","2020-10-28","215","24090","17","1336","5.2","5.1"
"Fayette","2020-10-29","289","24379","14","1350","5.4","4.7"
"Fayette","2020-10-30","263","24642","13","1363","5.1","4.8"
"Fayette","2020-10-31","103","24745","9","1372","5.2","4.9"
"Fayette","2020-11-01","68","24813","3","1375","5.2","5"
"Fayette","2020-11-02","246","25059","9","1384","5.5","5"
"Fayette","2020-11-03","247","25306","11","1395","5.6","5.1"
"Fayette","2020-11-04","223","25529","16","1411","5.5","5.3"
"Fayette","2020-11-05","259","25788","8","1419","5.2","5.3"
"Fayette","2020-11-06","286","26074","12","1431","5.1","5.1"
"Fayette","2020-11-07","129","26203","12","1443","5.2","5.2"
"Fayette","2020-11-08","74","26277","3","1446","5.1","5.2"
"Fayette","2020-11-09","312","26589","23","1469","5.7","5.6"
"Fayette","2020-11-10","364","26953","18","1487","5.7","5.6"
"Fayette","2020-11-11","246","27199","18","1505","5.8","5.6"
"Fayette","2020-11-12","343","27542","24","1529","6.3","5.8"
"Fayette","2020-11-13","272","27814","15","1544","6.5","5.8"
"Fayette","2020-11-14","158","27972","11","1555","6.2","5.7"
"Fayette","2020-11-15","94","28066","11","1566","7.3","6.2"
"Fayette","2020-11-16","365","28431","15","1581","6.8","6.2"
"Fayette","2020-11-17","349","28780","19","1600","6.9","6.3"
"Fayette","2020-11-18","414","29194","37","1637","7.1","6.4"
"Fayette","2020-11-19","452","29646","20","1657","6.7","6.5"
"Fayette","2020-11-20","506","30152","28","1685","6.7","6.6"
"Fayette","2020-11-21","184","30336","12","1697","6.7","6.4"
"Fayette","2020-11-22","134","30470","9","1706","6","6.6"
"Fayette","2020-11-23","450","30920","34","1740","6.4","6.6"
"Fayette","2020-11-24","371","31291","28","1768","6.7","6.8"
"Fayette","2020-11-25","429","31720","43","1811","6.9","7"
"Fayette","2020-11-26","23","31743","3","1814","8.1","7.4"
"Fayette","2020-11-27","214","31957","34","1848","9.6","8.2"
"Fayette","2020-11-28","140","32097","22","1870","10.9","8.8"
"Fayette","2020-11-29","141","32238","19","1889","11.9","8.9"
"Fayette","2020-11-30","436","32674","52","1941","12.5","9.5"
"Fayette","2020-12-01","426","33100","38","1979","12.7","9.7"
"Fayette","2020-12-02","440","33540","39","2018","12.5","9.7"
"Fayette","2020-12-03","346","33886","32","2050","12","10.1"
"Fayette","2020-12-04","434","34320","49","2099","11.3","10.5"
"Fayette","2020-12-05","205","34525","23","2122","10.7","10.8"
"Fayette","2020-12-06","103","34628","14","2136","10.7","11.3"
"Fayette","2020-12-07","416","35044","37","2173","10.3","11.4"
"Fayette","2020-12-08","470","35514","46","2219","10.4","11.6"
"Fayette","2020-12-09","360","35874","32","2251","10.4","11.5"
"Fayette","2020-12-10","348","36222","43","2294","10.9","11.4"
"Fayette","2020-12-11","397","36619","29","2323","10.3","10.8"
"Fayette","2020-12-12","219","36838","23","2346","10.2","10.4"
"Fayette","2020-12-13","111","36949","16","2362","10.3","10.5"
"Fayette","2020-12-14","480","37429","40","2402","10.2","10.3"
"Fayette","2020-12-15","387","37816","47","2449","10.6","10.5"
"Fayette","2020-12-16","419","38235","41","2490","10.7","10.6"
"Fayette","2020-12-17","431","38666","57","2547","10.8","10.8"
"Fayette","2020-12-18","418","39084","60","2607","11.8","11.1"
"Fayette","2020-12-19","205","39289","29","2636","12.3","11.3"
"Fayette","2020-12-20","142","39431","25","2661","12.8","11.6"
"Fayette","2020-12-21","436","39867","51","2712","13.3","11.8"
"Fayette","2020-12-22","385","40252","49","2761","13.4","12"
"Fayette","2020-12-23","389","40641","49","2810","13.8","12.2"
"Fayette","2020-12-24","276","40917","40","2850","13.9","12.4"
"Fayette","2020-12-25","65","40982","8","2858","13.7","12.7"
"Fayette","2020-12-26","185","41167","26","2884","13.6","13"
"Fayette","2020-12-27","142","41309","39","2923","15","13.9"
"Fayette","2020-12-28","515","41824","79","3002","15.6","14.4"
"Fayette","2020-12-29","419","42243","72","3074","16.2","14.8"
"Fayette","2020-12-30","408","42651","58","3132","16.4","15.1"
"Fayette","2020-12-31","359","43010","42","3174","16","15"
"Fayette","2021-01-01","71","43081","13","3187","16.9","15.3"
"Fayette","2021-01-02","238","43319","26","3213","16.4","15"
"Fayette","2021-01-03","178","43497","37","3250","15.5","15.3"
"Fayette","2021-01-04","465","43962","72","3322","15.5","15.5"
"Fayette","2021-01-05","584","44546","82","3404","15.1","15.6"
"Fayette","2021-01-06","581","45127","87","3491","15.2","15.8"
"Fayette","2021-01-07","542","45669","76","3567","15.5","15.8"
"Fayette","2021-01-08","411","46080","55","3622","14.8","15.8"
"Fayette","2021-01-09","190","46270","39","3661","16.2","16.3"
"Fayette","2021-01-10","146","46416","28","3689","15.9","15.7"
"Fayette","2021-01-11","462","46878","51","3740","15.3","15.4"
"Fayette","2021-01-12","510","47388","51","3791","14.7","14.9"
"Fayette","2021-01-13","460","47848","39","3830","13.8","14.5"
"Fayette","2021-01-14","515","48363","60","3890","13.5","14.5"
"Fayette","2021-01-15","404","48767","45","3935","13.1","14"
"Fayette","2021-01-16","252","49019","32","3967","12","14.1"
"Fayette","2021-01-17","148","49167","26","3993","11.8","13.9"
"Fayette","2021-01-18","373","49540","32","4025","11.4","13.4"
"Fayette","2021-01-19","464","50004","51","4076","11.6","13.2"
"Fayette","2021-01-20","470","50474","38","4114","11.5","12.7"
"Fayette","2021-01-21","404","50878","42","4156","11.4","12.4"
"Fayette","2021-01-22","418","51296","47","4203","11.4","12.3"
"Fayette","2021-01-23","198","51494","15","4218","10.6","11.3"
"Fayette","2021-01-24","140","51634","28","4246","11","11.4"
"Fayette","2021-01-25","483","52117","37","4283","10.9","11.1"
"Fayette","2021-01-26","382","52499","31","4314","10.4","11"
"Fayette","2021-01-27","404","52903","24","4338","10.1","10.8"
"Fayette","2021-01-28","423","53326","50","4388","10.3","10.8"
"Fayette","2021-01-29","370","53696","33","4421","10","10.7"
"Fayette","2021-01-30","197","53893","23","4444","10.6","10.6"
"Fayette","2021-01-31","143","54036","31","4475","10.8","10.9"
"Fayette","2021-02-01","472","54508","43","4518","11","10.9"
"Fayette","2021-02-02","437","54945","37","4555","11.1","10.8"
"Fayette","2021-02-03","381","55326","32","4587","11.4","10.8"
"Fayette","2021-02-04","354","55680","37","4624","11.2","10.8"
"Fayette","2021-02-05","252","55932","20","4644","11.1","10.6"
"Fayette","2021-02-06","59","55991","3","4647","10.2","10.4"
"Fayette","2021-02-07","3","55994","0","4647","7.1","8.9"
"Fayette","2021-02-08","0","55994","0","4647","5.8","8.4"
"Floyd","2020-02-01","0","0","0","0",".","."
"Floyd","2020-02-02","0","0","0","0",".","."
"Floyd","2020-02-03","0","0","0","0",".","."
"Floyd","2020-02-04","0","0","0","0",".","."
"Floyd","2020-02-05","0","0","0","0",".","."
"Floyd","2020-02-06","0","0","0","0",".","."
"Floyd","2020-02-07","0","0","0","0","0","."
"Floyd","2020-02-08","0","0","0","0","0","."
"Floyd","2020-02-09","0","0","0","0","0","."
"Floyd","2020-02-10","0","0","0","0","0","."
"Floyd","2020-02-11","0","0","0","0","0","."
"Floyd","2020-02-12","0","0","0","0","0","."
"Floyd","2020-02-13","0","0","0","0","0","."
"Floyd","2020-02-14","0","0","0","0","0","0"
"Floyd","2020-02-15","0","0","0","0","0","0"
"Floyd","2020-02-16","0","0","0","0","0","0"
"Floyd","2020-02-17","0","0","0","0","0","0"
"Floyd","2020-02-18","0","0","0","0","0","0"
"Floyd","2020-02-19","0","0","0","0","0","0"
"Floyd","2020-02-20","0","0","0","0","0","0"
"Floyd","2020-02-21","0","0","0","0","0","0"
"Floyd","2020-02-22","0","0","0","0","0","0"
"Floyd","2020-02-23","0","0","0","0","0","0"
"Floyd","2020-02-24","0","0","0","0","0","0"
"Floyd","2020-02-25","0","0","0","0","0","0"
"Floyd","2020-02-26","0","0","0","0","0","0"
"Floyd","2020-02-27","0","0","0","0","0","0"
"Floyd","2020-02-28","0","0","0","0","0","0"
"Floyd","2020-02-29","0","0","0","0","0","0"
"Floyd","2020-03-01","0","0","0","0","0","0"
"Floyd","2020-03-02","0","0","0","0","0","0"
"Floyd","2020-03-03","0","0","0","0","0","0"
"Floyd","2020-03-04","0","0","0","0","0","0"
"Floyd","2020-03-05","0","0","0","0","0","0"
"Floyd","2020-03-06","10","10","2","2","2.9","1.4"
"Floyd","2020-03-07","2","12","0","2","2.9","1.4"
"Floyd","2020-03-08","1","13","0","2","2.9","1.4"
"Floyd","2020-03-09","10","23","1","3","4.3","2.1"
"Floyd","2020-03-10","9","32","2","5","7.5","3.7"
"Floyd","2020-03-11","29","61","4","9","9.4","4.7"
"Floyd","2020-03-12","45","106","6","15","11.3","5.7"
"Floyd","2020-03-13","23","129","3","18","10.3","6.6"
"Floyd","2020-03-14","3","132","0","18","10.3","6.6"
"Floyd","2020-03-15","10","142","1","19","11.8","7.3"
"Floyd","2020-03-16","34","176","1","20","10.8","7.5"
"Floyd","2020-03-17","38","214","2","22","8.3","7.9"
"Floyd","2020-03-18","25","239","5","27","9.2","9.3"
"Floyd","2020-03-19","34","273","3","30","8.6","10"
"Floyd","2020-03-20","39","312","1","31","7.1","8.7"
"Floyd","2020-03-21","12","324","1","32","8.3","9.3"
"Floyd","2020-03-22","21","345","2","34","8.2","10"
"Floyd","2020-03-23","45","390","6","40","9.7","10.2"
"Floyd","2020-03-24","30","420","5","45","11.3","9.8"
"Floyd","2020-03-25","27","447","4","49","10.6","9.9"
"Floyd","2020-03-26","108","555","14","63","11.2","9.9"
"Floyd","2020-03-27","18","573","0","63","10.8","8.9"
"Floyd","2020-03-28","24","597","5","68","12.6","10.4"
"Floyd","2020-03-29","22","619","5","73","14.5","11.3"
"Floyd","2020-03-30","63","682","6","79","13.9","11.8"
"Floyd","2020-03-31","47","729","8","87","14","12.7"
"Floyd","2020-04-01","53","782","11","98","14.8","12.7"
"Floyd","2020-04-02","49","831","4","102","14.1","12.7"
"Floyd","2020-04-03","53","884","6","108","15.8","13.3"
"Floyd","2020-04-04","35","919","4","112","14.4","13.5"
"Floyd","2020-04-05","15","934","2","114","13.1","13.8"
"Floyd","2020-04-06","27","961","3","117","13.3","13.6"
"Floyd","2020-04-07","57","1018","5","122","12.1","13.1"
"Floyd","2020-04-08","54","1072","7","129","11","12.9"
"Floyd","2020-04-09","47","1119","4","133","11.1","12.6"
"Floyd","2020-04-10","41","1160","3","136","10.5","13.1"
"Floyd","2020-04-11","17","1177","1","137","9.7","12.1"
"Floyd","2020-04-12","9","1186","0","137","7.8","10.4"
"Floyd","2020-04-13","20","1206","1","138","6.9","10.1"
"Floyd","2020-04-14","26","1232","3","141","7.3","9.7"
"Floyd","2020-04-15","91","1323","6","147","6.4","8.7"
"Floyd","2020-04-16","89","1412","5","152","6","8.5"
"Floyd","2020-04-17","99","1511","13","165","6.8","8.7"
"Floyd","2020-04-18","46","1557","1","166","6.3","8"
"Floyd","2020-04-19","10","1567","0","166","6.3","7"
"Floyd","2020-04-20","145","1712","4","170","6","6.4"
"Floyd","2020-04-21","71","1783","6","176","5.5","6.4"
"Floyd","2020-04-22","81","1864","4","180","5.3","5.9"
"Floyd","2020-04-23","29","1893","0","180","4.5","5.2"
"Floyd","2020-04-24","101","1994","5","185","3.3","5.1"
"Floyd","2020-04-25","60","2054","5","190","4.2","5.2"
"Floyd","2020-04-26","5","2059","0","190","4.2","5.2"
"Floyd","2020-04-27","106","2165","6","196","4.6","5.3"
"Floyd","2020-04-28","176","2341","34","230","6.2","5.9"
"Floyd","2020-04-29","54","2395","5","235","6.8","6"
"Floyd","2020-04-30","195","2590","5","240","7.2","5.8"
"Floyd","2020-05-01","70","2660","2","242","6.9","5.1"
"Floyd","2020-05-02","152","2812","4","246","6","5.1"
"Floyd","2020-05-03","9","2821","1","247","7.6","5.9"
"Floyd","2020-05-04","37","2858","5","252","8.8","6.7"
"Floyd","2020-05-05","81","2939","3","255","6.5","6.3"
"Floyd","2020-05-06","127","3066","5","260","5.8","6.3"
"Floyd","2020-05-07","155","3221","3","263","5.7","6.4"
"Floyd","2020-05-08","119","3340","2","265","5.5","6.2"
"Floyd","2020-05-09","136","3476","3","268","5.4","5.7"
"Floyd","2020-05-10","9","3485","0","268","3.9","5.7"
"Floyd","2020-05-11","171","3656","11","279","2.8","5.8"
"Floyd","2020-05-12","168","3824","2","281","2.5","4.5"
"Floyd","2020-05-13","201","4025","18","299","3.2","4.5"
"Floyd","2020-05-14","201","4226","20","319","4.3","5"
"Floyd","2020-05-15","171","4397","7","326","4.7","5.1"
"Floyd","2020-05-16","83","4480","3","329","4.9","5.2"
"Floyd","2020-05-17","2","4482","0","329","4.9","4.4"
"Floyd","2020-05-18","251","4733","10","339","4.5","3.7"
"Floyd","2020-05-19","278","5011","4","343","4.6","3.5"
"Floyd","2020-05-20","213","5224","9","352","3.9","3.6"
"Floyd","2020-05-21","495","5719","9","361","2.7","3.5"
"Floyd","2020-05-22","452","6171","7","368","2.4","3.5"
"Floyd","2020-05-23","306","6477","7","375","2.2","3.5"
"Floyd","2020-05-24","7","6484","0","375","2.2","3.5"
"Floyd","2020-05-25","52","6536","0","375","1.6","3.1"
"Floyd","2020-05-26","327","6863","24","399","2.5","3.5"
"Floyd","2020-05-27","337","7200","10","409","2.3","3.1"
"Floyd","2020-05-28","368","7568","12","421","2.5","2.6"
"Floyd","2020-05-29","421","7989","19","440","2.9","2.6"
"Floyd","2020-05-30","175","8164","6","446","3.1","2.6"
"Floyd","2020-05-31","16","8180","0","446","3.1","2.6"
"Floyd","2020-06-01","484","8664","30","476","4","2.8"
"Floyd","2020-06-02","464","9128","30","506","3.8","3.1"
"Floyd","2020-06-03","338","9466","12","518","3.9","3.1"
"Floyd","2020-06-04","385","9851","18","536","4.1","3.3"
"Floyd","2020-06-05","408","10259","12","548","3.9","3.4"
"Floyd","2020-06-06","182","10441","10","558","4.2","3.6"
"Floyd","2020-06-07","21","10462","3","561","6.2","4.7"
"Floyd","2020-06-08","469","10931","49","610","6.8","5.4"
"Floyd","2020-06-09","344","11275","18","628","6.7","5.2"
"Floyd","2020-06-10","304","11579","25","653","7.3","5.6"
"Floyd","2020-06-11","350","11929","16","669","7.3","5.7"
"Floyd","2020-06-12","318","12247","26","695","8.1","6"
"Floyd","2020-06-13","77","12324","5","700","8.2","6.2"
"Floyd","2020-06-14","18","12342","0","700","6.2","6.2"
"Floyd","2020-06-15","490","12832","32","732","5.6","6.2"
"Floyd","2020-06-16","331","13163","15","747","5.5","6.1"
"Floyd","2020-06-17","402","13565","36","783","5.6","6.5"
"Floyd","2020-06-18","344","13909","30","813","6.2","6.8"
"Floyd","2020-06-19","325","14234","23","836","6","7.1"
"Floyd","2020-06-20","165","14399","19","855","6.8","7.5"
"Floyd","2020-06-21","24","14423","1","856","7.4","6.8"
"Floyd","2020-06-22","515","14938","34","890","7.4","6.5"
"Floyd","2020-06-23","451","15389","31","921","7.7","6.6"
"Floyd","2020-06-24","466","15855","46","967","7.8","6.7"
"Floyd","2020-06-25","571","16426","56","1023","8","7.1"
"Floyd","2020-06-26","509","16935","44","1067","8.2","7.1"
"Floyd","2020-06-27","220","17155","21","1088","7.9","7.3"
"Floyd","2020-06-28","38","17193","3","1091","8.5","7.9"
"Floyd","2020-06-29","931","18124","101","1192","9.1","8.2"
"Floyd","2020-06-30","658","18782","79","1271","9.8","8.8"
"Floyd","2020-07-01","836","19618","71","1342","9.6","8.7"
"Floyd","2020-07-02","889","20507","78","1420","9.5","8.7"
"Floyd","2020-07-03","307","20814","26","1446","9.4","8.8"
"Floyd","2020-07-04","32","20846","9","1455","12.1","10"
"Floyd","2020-07-05","30","20876","8","1463","14.8","11.6"
"Floyd","2020-07-06","867","21743","103","1566","14.9","12"
"Floyd","2020-07-07","1091","22834","86","1652","14.3","12.1"
"Floyd","2020-07-08","931","23765","72","1724","14.2","11.9"
"Floyd","2020-07-09","699","24464","64","1788","14.3","11.9"
"Floyd","2020-07-10","673","25137","55","1843","14.2","11.8"
"Floyd","2020-07-11","125","25262","19","1862","12.4","12.2"
"Floyd","2020-07-12","34","25296","10","1872","12.8","13.8"
"Floyd","2020-07-13","794","26090","84","1956","12.6","13.8"
"Floyd","2020-07-14","860","26950","108","2064","13.3","13.8"
"Floyd","2020-07-15","749","27699","75","2139","13.6","13.9"
"Floyd","2020-07-16","761","28460","82","2221","13.8","14"
"Floyd","2020-07-17","742","29202","67","2288","13.9","14.1"
"Floyd","2020-07-18","279","29481","30","2318","13.3","12.8"
"Floyd","2020-07-19","33","29514","11","2329","13.9","13.3"
"Floyd","2020-07-20","694","30208","78","2407","14","13.3"
"Floyd","2020-07-21","651","30859","79","2486","13.9","13.6"
"Floyd","2020-07-22","513","31372","53","2539","13.9","13.8"
"Floyd","2020-07-23","638","32010","86","2625","14.3","14.1"
"Floyd","2020-07-24","643","32653","65","2690","14.5","14.2"
"Floyd","2020-07-25","151","32804","24","2714","15.2","14.3"
"Floyd","2020-07-26","63","32867","24","2738","15.9","14.9"
"Floyd","2020-07-27","691","33558","69","2807","15.7","14.8"
"Floyd","2020-07-28","622","34180","69","2876","15.6","14.7"
"Floyd","2020-07-29","484","34664","53","2929","15.7","14.8"
"Floyd","2020-07-30","477","35141","45","2974","15.1","14.7"
"Floyd","2020-07-31","500","35641","30","3004","14.5","14.5"
"Floyd","2020-08-01","222","35863","19","3023","13.4","14.3"
"Floyd","2020-08-02","36","35899","2","3025","8.8","12.3"
"Floyd","2020-08-03","591","36490","70","3095","9.1","12.4"
"Floyd","2020-08-04","575","37065","64","3159","9.1","12.3"
"Floyd","2020-08-05","549","37614","83","3242","9.7","12.7"
"Floyd","2020-08-06","475","38089","65","3307","10.3","12.7"
"Floyd","2020-08-07","671","38760","79","3386","11.1","12.8"
"Floyd","2020-08-08","253","39013","31","3417","11.6","12.5"
"Floyd","2020-08-09","74","39087","19","3436","14.5","11.6"
"Floyd","2020-08-10","824","39911","110","3546","14.7","11.9"
"Floyd","2020-08-11","620","40531","42","3588","14.1","11.6"
"Floyd","2020-08-12","526","41057","55","3643","13.4","11.5"
"Floyd","2020-08-13","512","41569","43","3686","12.7","11.5"
"Floyd","2020-08-14","573","42142","59","3745","12.5","11.8"
"Floyd","2020-08-15","208","42350","17","3762","11.9","11.7"
"Floyd","2020-08-16","81","42431","8","3770","9.6","12.1"
"Floyd","2020-08-17","247","42678","21","3791","8.9","11.8"
"Floyd","2020-08-18","634","43312","71","3862","9.6","11.8"
"Floyd","2020-08-19","606","43918","45","3907","9.1","11.3"
"Floyd","2020-08-20","666","44584","57","3964","9.1","10.9"
"Floyd","2020-08-21","740","45324","51","4015","8.7","10.6"
"Floyd","2020-08-22","157","45481","21","4036","9.4","10.6"
"Floyd","2020-08-23","53","45534","5","4041","9.3","9.5"
"Floyd","2020-08-24","679","46213","59","4100","9.4","9.1"
"Floyd","2020-08-25","427","46640","39","4139","9.1","9.3"
"Floyd","2020-08-26","706","47346","34","4173","8.7","8.9"
"Floyd","2020-08-27","716","48062","58","4231","8.6","8.9"
"Floyd","2020-08-28","552","48614","47","4278","8.9","8.8"
"Floyd","2020-08-29","122","48736","14","4292","8.6","9"
"Floyd","2020-08-30","34","48770","7","4299","10.2","9.8"
"Floyd","2020-08-31","547","49317","70","4369","10.8","10.1"
"Floyd","2020-09-01","192","49509","30","4399","11.7","10.4"
"Floyd","2020-09-02","392","49901","40","4439","12.5","10.6"
"Floyd","2020-09-03","376","50277","32","4471","12.5","10.6"
"Floyd","2020-09-04","379","50656","47","4518","13.1","11"
"Floyd","2020-09-05","220","50876","16","4534","12.5","10.5"
"Floyd","2020-09-06","29","50905","5","4539","12","11.1"
"Floyd","2020-09-07","22","50927","5","4544","13.4","12.1"
"Floyd","2020-09-08","131","51058","23","4567","13.7","12.7"
"Floyd","2020-09-09","445","51503","36","4603","13.4","12.9"
"Floyd","2020-09-10","343","51846","34","4637","13.6","13.1"
"Floyd","2020-09-11","317","52163","57","4694","14.4","13.7"
"Floyd","2020-09-12","96","52259","15","4709","15.6","14"
"Floyd","2020-09-13","40","52299","7","4716","15.6","13.8"
"Floyd","2020-09-14","364","52663","53","4769","14.5","13.9"
"Floyd","2020-09-15","219","52882","29","4798","13.8","13.8"
"Floyd","2020-09-16","308","53190","38","4836","14.5","13.9"
"Floyd","2020-09-17","95","53285","10","4846","14.5","14.1"
"Floyd","2020-09-18","387","53672","51","4897","13.9","14.1"
"Floyd","2020-09-19","157","53829","22","4919","13.6","14.6"
"Floyd","2020-09-20","37","53866","10","4929","15","15.3"
"Floyd","2020-09-21","334","54200","40","4969","14.6","14.5"
"Floyd","2020-09-22","132","54332","11","4980","13.9","13.9"
"Floyd","2020-09-23","346","54678","27","5007","13.3","13.9"
"Floyd","2020-09-24","255","54933","26","5033","13.2","13.9"
"Floyd","2020-09-25","285","55218","26","5059","12.6","13.2"
"Floyd","2020-09-26","68","55286","7","5066","12.1","12.9"
"Floyd","2020-09-27","28","55314","8","5074","12.3","13.7"
"Floyd","2020-09-28","248","55562","39","5113","12.9","13.7"
"Floyd","2020-09-29","100","55662","13","5126","13.5","13.7"
"Floyd","2020-09-30","344","56006","14","5140","13","13.1"
"Floyd","2020-10-01","288","56294","25","5165","12.8","13"
"Floyd","2020-10-02","328","56622","27","5192","12.7","12.6"
"Floyd","2020-10-03","243","56865","11","5203","11.8","12"
"Floyd","2020-10-04","134","56999","6","5209","8.4","10.4"
"Floyd","2020-10-05","257","57256","25","5234","7.5","10.2"
"Floyd","2020-10-06","309","57565","13","5247","6.3","9.9"
"Floyd","2020-10-07","465","58030","34","5281","6.7","9.9"
"Floyd","2020-10-08","392","58422","32","5313","6.7","9.7"
"Floyd","2020-10-09","366","58788","23","5336","6.4","9.5"
"Floyd","2020-10-10","107","58895","13","5349","7.5","9.7"
"Floyd","2020-10-11","44","58939","13","5362","11.1","9.7"
"Floyd","2020-10-12","120","59059","16","5378","11.6","9.6"
"Floyd","2020-10-13","154","59213","14","5392","12.3","9.3"
"Floyd","2020-10-14","552","59765","48","5440","12.5","9.6"
"Floyd","2020-10-15","318","60083","40","5480","13.1","9.9"
"Floyd","2020-10-16","355","60438","51","5531","14.3","10.3"
"Floyd","2020-10-17","130","60568","17","5548","14.4","10.9"
"Floyd","2020-10-18","53","60621","14","5562","13.9","12.5"
"Floyd","2020-10-19","253","60874","54","5616","15.1","13.3"
"Floyd","2020-10-20","195","61069","24","5640","15.5","13.9"
"Floyd","2020-10-21","463","61532","41","5681","15.6","14"
"Floyd","2020-10-22","298","61830","32","5713","15.3","14.2"
"Floyd","2020-10-23","393","62223","52","5765","15.1","14.7"
"Floyd","2020-10-24","139","62362","18","5783","15.1","14.8"
"Floyd","2020-10-25","60","62422","9","5792","13.5","13.7"
"Floyd","2020-10-26","352","62774","60","5852","12.9","14"
"Floyd","2020-10-27","204","62978","29","5881","13.1","14.3"
"Floyd","2020-10-28","452","63430","49","5930","13.4","14.5"
"Floyd","2020-10-29","175","63605","23","5953","13.8","14.5"
"Floyd","2020-10-30","327","63932","37","5990","13.5","14.3"
"Floyd","2020-10-31","148","64080","17","6007","13.3","14.2"
"Floyd","2020-11-01","73","64153","14","6021","13.9","13.7"
"Floyd","2020-11-02","331","64484","57","6078","13.9","13.4"
"Floyd","2020-11-03","167","64651","22","6100","13.8","13.5"
"Floyd","2020-11-04","383","65034","41","6141","13.7","13.6"
"Floyd","2020-11-05","309","65343","44","6185","13.9","13.8"
"Floyd","2020-11-06","277","65620","39","6224","14.3","13.9"
"Floyd","2020-11-07","134","65754","18","6242","14.6","13.9"
"Floyd","2020-11-08","50","65804","15","6257","16.1","15"
"Floyd","2020-11-09","367","66171","48","6305","15.5","14.7"
"Floyd","2020-11-10","174","66345","26","6331","15.8","14.8"
"Floyd","2020-11-11","227","66572","33","6364","16.3","15"
"Floyd","2020-11-12","464","67036","61","6425","16.2","15"
"Floyd","2020-11-13","490","67526","57","6482","15.8","15.1"
"Floyd","2020-11-14","121","67647","20","6502","16.3","15.4"
"Floyd","2020-11-15","80","67727","23","6525","16.1","16.1"
"Floyd","2020-11-16","348","68075","44","6569","16","15.8"
"Floyd","2020-11-17","146","68221","17","6586","15.6","15.7"
"Floyd","2020-11-18","566","68787","56","6642","14.9","15.6"
"Floyd","2020-11-19","384","69171","43","6685","14.6","15.4"
"Floyd","2020-11-20","515","69686","48","6733","14.3","15.1"
"Floyd","2020-11-21","174","69860","27","6760","14.1","15.2"
"Floyd","2020-11-22","74","69934","24","6784","14.7","15.4"
"Floyd","2020-11-23","519","70453","60","6844","14.5","15.3"
"Floyd","2020-11-24","178","70631","16","6860","14.1","14.8"
"Floyd","2020-11-25","433","71064","89","6949","15.7","15.3"
"Floyd","2020-11-26","73","71137","11","6960","16.2","15.4"
"Floyd","2020-11-27","191","71328","35","6995","17.5","15.9"
"Floyd","2020-11-28","133","71461","33","7028","18.8","16.5"
"Floyd","2020-11-29","76","71537","19","7047","17.8","16.2"
"Floyd","2020-11-30","563","72100","69","7116","17.9","16.2"
"Floyd","2020-12-01","243","72343","38","7154","18.8","16.5"
"Floyd","2020-12-02","542","72885","61","7215","17.5","16.6"
"Floyd","2020-12-03","455","73340","76","7291","17.7","17"
"Floyd","2020-12-04","280","73620","23","7314","16.3","16.9"
"Floyd","2020-12-05","185","73805","39","7353","15.7","17.3"
"Floyd","2020-12-06","96","73901","25","7378","15.9","16.8"
"Floyd","2020-12-07","576","74477","99","7477","16.6","17.2"
"Floyd","2020-12-08","360","74837","37","7514","15.8","17.3"
"Floyd","2020-12-09","607","75444","94","7608","16.4","17"
"Floyd","2020-12-10","439","75883","64","7672","16.1","16.9"
"Floyd","2020-12-11","618","76501","64","7736","16.4","16.3"
"Floyd","2020-12-12","265","76766","39","7775","15.5","15.6"
"Floyd","2020-12-13","95","76861","25","7800","15.6","15.7"
"Floyd","2020-12-14","551","77412","98","7898","15.6","16.1"
"Floyd","2020-12-15","425","77837","55","7953","16","15.9"
"Floyd","2020-12-16","665","78502","118","8071","16.3","16.4"
"Floyd","2020-12-17","534","79036","68","8139","16.1","16.1"
"Floyd","2020-12-18","546","79582","83","8222","16.8","16.6"
"Floyd","2020-12-19","254","79836","45","8267","17.2","16.4"
"Floyd","2020-12-20","98","79934","25","8292","17.1","16.3"
"Floyd","2020-12-21","612","80546","117","8409","17.3","16.5"
"Floyd","2020-12-22","381","80927","74","8483","18.2","17.1"
"Floyd","2020-12-23","719","81646","119","8602","18","17.2"
"Floyd","2020-12-24","301","81947","73","8675","19.7","17.9"
"Floyd","2020-12-25","50","81997","12","8687","20.9","18.9"
"Floyd","2020-12-26","168","82165","60","8747","23.5","20.4"
"Floyd","2020-12-27","133","82298","39","8786","24.1","20.6"
"Floyd","2020-12-28","941","83239","175","8961","24","20.6"
"Floyd","2020-12-29","280","83519","77","9038","25.1","21.7"
"Floyd","2020-12-30","868","84387","148","9186","25.2","21.6"
"Floyd","2020-12-31","716","85103","128","9314","24.3","22"
"Floyd","2021-01-01","101","85204","34","9348","25.7","23.3"
"Floyd","2021-01-02","86","85290","24","9372","24.6","24"
"Floyd","2021-01-03","111","85401","29","9401","24.1","24.1"
"Floyd","2021-01-04","831","86232","164","9565","24.3","24.1"
"Floyd","2021-01-05","350","86582","97","9662","24.3","24.7"
"Floyd","2021-01-06","616","87198","115","9777","24.5","24.9"
"Floyd","2021-01-07","612","87810","100","9877","24.3","24.3"
"Floyd","2021-01-08","661","88471","78","9955","21.2","23.4"
"Floyd","2021-01-09","257","88728","41","9996","19.5","22"
"Floyd","2021-01-10","108","88836","27","10023","19.3","21.7"
"Floyd","2021-01-11","219","89055","51","10074","19.8","22"
"Floyd","2021-01-12","424","89479","33","10107","17","20.6"
"Floyd","2021-01-13","477","89956","77","10184","16.6","20.6"
"Floyd","2021-01-14","543","90499","45","10229","15.5","19.9"
"Floyd","2021-01-15","657","91156","75","10304","15.4","18.3"
"Floyd","2021-01-16","172","91328","30","10334","15.6","17.5"
"Floyd","2021-01-17","94","91422","20","10354","15.1","17.2"
"Floyd","2021-01-18","262","91684","24","10378","13.1","16.4"
"Floyd","2021-01-19","279","91963","24","10402","13.2","15.1"
"Floyd","2021-01-20","565","92528","56","10458","12.3","14.5"
"Floyd","2021-01-21","220","92748","34","10492","13.3","14.4"
"Floyd","2021-01-22","352","93100","36","10528","13.2","14.3"
"Floyd","2021-01-23","194","93294","22","10550","12.3","14"
"Floyd","2021-01-24","97","93391","10","10560","10.7","12.9"
"Floyd","2021-01-25","280","93671","27","10587","10.8","11.9"
"Floyd","2021-01-26","259","93930","21","10608","10.7","12"
"Floyd","2021-01-27","522","94452","73","10681","11.3","11.8"
"Floyd","2021-01-28","312","94764","20","10701","10","11.7"
"Floyd","2021-01-29","275","95039","29","10730","10","11.6"
"Floyd","2021-01-30","137","95176","21","10751","10.6","11.5"
"Floyd","2021-01-31","80","95256","20","10771","12.7","11.7"
"Floyd","2021-02-01","236","95492","12","10783","12.1","11.4"
"Floyd","2021-02-02","221","95713","19","10802","12.1","11.4"
"Floyd","2021-02-03","411","96124","41","10843","11.6","11.4"
"Floyd","2021-02-04","219","96343","16","10859","11.7","10.8"
"Floyd","2021-02-05","181","96524","12","10871","11.1","10.6"
"Floyd","2021-02-06","15","96539","1","10872","9.9","10.3"
"Floyd","2021-02-07","4","96543","1","10873","9.9","11.3"
"Floyd","2021-02-08","0","96543","0","10873","9.2","10.6"
"Forsyth","2020-02-01","0","0","0","0",".","."
"Forsyth","2020-02-02","0","0","0","0",".","."
"Forsyth","2020-02-03","0","0","0","0",".","."
"Forsyth","2020-02-04","0","0","0","0",".","."
"Forsyth","2020-02-05","0","0","0","0",".","."
"Forsyth","2020-02-06","0","0","0","0",".","."
"Forsyth","2020-02-07","0","0","0","0","0","."
"Forsyth","2020-02-08","0","0","0","0","0","."
"Forsyth","2020-02-09","0","0","0","0","0","."
"Forsyth","2020-02-10","0","0","0","0","0","."
"Forsyth","2020-02-11","0","0","0","0","0","."
"Forsyth","2020-02-12","0","0","0","0","0","."
"Forsyth","2020-02-13","0","0","0","0","0","."
"Forsyth","2020-02-14","0","0","0","0","0","0"
"Forsyth","2020-02-15","0","0","0","0","0","0"
"Forsyth","2020-02-16","0","0","0","0","0","0"
"Forsyth","2020-02-17","0","0","0","0","0","0"
"Forsyth","2020-02-18","0","0","0","0","0","0"
"Forsyth","2020-02-19","0","0","0","0","0","0"
"Forsyth","2020-02-20","0","0","0","0","0","0"
"Forsyth","2020-02-21","0","0","0","0","0","0"
"Forsyth","2020-02-22","0","0","0","0","0","0"
"Forsyth","2020-02-23","0","0","0","0","0","0"
"Forsyth","2020-02-24","0","0","0","0","0","0"
"Forsyth","2020-02-25","0","0","0","0","0","0"
"Forsyth","2020-02-26","0","0","0","0","0","0"
"Forsyth","2020-02-27","0","0","0","0","0","0"
"Forsyth","2020-02-28","0","0","0","0","0","0"
"Forsyth","2020-02-29","0","0","0","0","0","0"
"Forsyth","2020-03-01","0","0","0","0","0","0"
"Forsyth","2020-03-02","0","0","0","0","0","0"
"Forsyth","2020-03-03","0","0","0","0","0","0"
"Forsyth","2020-03-04","2","2","0","0","0","0"
"Forsyth","2020-03-05","0","2","0","0","0","0"
"Forsyth","2020-03-06","1","3","0","0","0","0"
"Forsyth","2020-03-07","1","4","1","1","14.3","7.1"
"Forsyth","2020-03-08","0","4","0","1","14.3","7.1"
"Forsyth","2020-03-09","4","8","0","1","14.3","7.1"
"Forsyth","2020-03-10","3","11","0","1","14.3","7.1"
"Forsyth","2020-03-11","8","19","1","2","16.1","8"
"Forsyth","2020-03-12","29","48","1","3","16.6","8.3"
"Forsyth","2020-03-13","17","65","0","3","16.6","8.3"
"Forsyth","2020-03-14","5","70","0","3","2.3","8.3"
"Forsyth","2020-03-15","5","75","1","4","5.1","9.7"
"Forsyth","2020-03-16","41","116","3","7","6.2","10.2"
"Forsyth","2020-03-17","56","172","3","10","6.9","10.6"
"Forsyth","2020-03-18","37","209","3","13","6.3","11.2"
"Forsyth","2020-03-19","33","242","1","14","6.3","11.4"
"Forsyth","2020-03-20","46","288","6","20","8.1","12.3"
"Forsyth","2020-03-21","6","294","1","21","10.5","6.4"
"Forsyth","2020-03-22","8","302","2","23","11.2","8.2"
"Forsyth","2020-03-23","26","328","3","26","11.8","9"
"Forsyth","2020-03-24","48","376","6","32","12.8","9.9"
"Forsyth","2020-03-25","38","414","0","32","11.7","9"
"Forsyth","2020-03-26","41","455","7","39","13.7","10"
"Forsyth","2020-03-27","24","479","5","44","14.8","11.5"
"Forsyth","2020-03-28","19","498","6","50","16.9","13.7"
"Forsyth","2020-03-29","9","507","1","51","14.9","13.1"
"Forsyth","2020-03-30","52","559","7","58","15.2","13.5"
"Forsyth","2020-03-31","35","594","9","67","17.1","15"
"Forsyth","2020-04-01","25","619","5","72","20","15.8"
"Forsyth","2020-04-02","18","637","2","74","19.1","16.4"
"Forsyth","2020-04-03","30","667","6","80","19","16.9"
"Forsyth","2020-04-04","4","671","0","80","14.5","15.7"
"Forsyth","2020-04-05","5","676","2","82","18.6","16.8"
"Forsyth","2020-04-06","35","711","6","88","19.1","17.2"
"Forsyth","2020-04-07","34","745","3","91","16.7","16.9"
"Forsyth","2020-04-08","46","791","5","96","15.4","17.7"
"Forsyth","2020-04-09","53","844","8","104","16","17.6"
"Forsyth","2020-04-10","45","889","6","110","15","17"
"Forsyth","2020-04-11","21","910","2","112","16.4","15.4"
"Forsyth","2020-04-12","13","923","3","115","14","16.3"
"Forsyth","2020-04-13","42","965","4","119","12.9","16"
"Forsyth","2020-04-14","55","1020","6","125","13.2","15"
"Forsyth","2020-04-15","50","1070","4","129","12.8","14.1"
"Forsyth","2020-04-16","64","1134","9","138","12.6","14.3"
"Forsyth","2020-04-17","80","1214","3","141","11.3","13.2"
"Forsyth","2020-04-18","43","1257","3","144","10.9","13.6"
"Forsyth","2020-04-19","35","1292","5","149","9.6","11.8"
"Forsyth","2020-04-20","72","1364","4","153","9.1","11"
"Forsyth","2020-04-21","65","1429","5","158","8.6","10.9"
"Forsyth","2020-04-22","89","1518","10","168","9.1","10.9"
"Forsyth","2020-04-23","90","1608","6","174","8","10.3"
"Forsyth","2020-04-24","111","1719","4","178","8","9.6"
"Forsyth","2020-04-25","66","1785","0","178","7","9"
"Forsyth","2020-04-26","41","1826","3","181","6","7.8"
"Forsyth","2020-04-27","86","1912","11","192","7","8.1"
"Forsyth","2020-04-28","107","2019","10","202","7.3","7.9"
"Forsyth","2020-04-29","107","2126","8","210","6.7","7.9"
"Forsyth","2020-04-30","101","2227","3","213","6.2","7.1"
"Forsyth","2020-05-01","116","2343","3","216","6.1","7"
"Forsyth","2020-05-02","65","2408","3","219","6.7","6.9"
"Forsyth","2020-05-03","50","2458","3","222","6.5","6.3"
"Forsyth","2020-05-04","145","2603","7","229","5.4","6.2"
"Forsyth","2020-05-05","138","2741","3","232","4.4","5.8"
"Forsyth","2020-05-06","132","2873","4","236","3.7","5.2"
"Forsyth","2020-05-07","99","2972","6","242","4.2","5.2"
"Forsyth","2020-05-08","292","3264","14","256","4.5","5.3"
"Forsyth","2020-05-09","275","3539","11","267","4.4","5.6"
"Forsyth","2020-05-10","40","3579","1","268","3.9","5.2"
"Forsyth","2020-05-11","177","3756","19","287","4.8","5.1"
"Forsyth","2020-05-12","192","3948","6","293","4.9","4.6"
"Forsyth","2020-05-13","243","4191","3","296","4.6","4.2"
"Forsyth","2020-05-14","149","4340","7","303","4.4","4.3"
"Forsyth","2020-05-15","326","4666","11","314","4.2","4.4"
"Forsyth","2020-05-16","92","4758","5","319","4.4","4.4"
"Forsyth","2020-05-17","52","4810","3","322","4.9","4.4"
"Forsyth","2020-05-18","275","5085","18","340","4.3","4.5"
"Forsyth","2020-05-19","373","5458","12","352","4.3","4.6"
"Forsyth","2020-05-20","172","5630","8","360","4.8","4.7"
"Forsyth","2020-05-21","272","5902","7","367","4.5","4.5"
"Forsyth","2020-05-22","231","6133","5","372","4.3","4.3"
"Forsyth","2020-05-23","95","6228","9","381","4.9","4.7"
"Forsyth","2020-05-24","79","6307","0","381","4.1","4.5"
"Forsyth","2020-05-25","64","6371","0","381","3.2","3.7"
"Forsyth","2020-05-26","262","6633","12","393","3.3","3.8"
"Forsyth","2020-05-27","252","6885","7","400","3.1","3.9"
"Forsyth","2020-05-28","185","7070","2","402","2.9","3.7"
"Forsyth","2020-05-29","193","7263","6","408","3","3.7"
"Forsyth","2020-05-30","67","7330","1","409","1.9","3.4"
"Forsyth","2020-05-31","55","7385","1","410","2.1","3.1"
"Forsyth","2020-06-01","219","7604","11","421","2.8","3"
"Forsyth","2020-06-02","169","7773","10","431","3","3.2"
"Forsyth","2020-06-03","396","8169","7","438","2.9","3"
"Forsyth","2020-06-04","217","8386","12","450","3.5","3.2"
"Forsyth","2020-06-05","190","8576","7","457","3.6","3.3"
"Forsyth","2020-06-06","96","8672","4","461","4","2.9"
"Forsyth","2020-06-07","44","8716","4","465","5","3.6"
"Forsyth","2020-06-08","186","8902","7","472","4.8","3.8"
"Forsyth","2020-06-09","210","9112","7","479","4.5","3.8"
"Forsyth","2020-06-10","187","9299","3","482","4.5","3.7"
"Forsyth","2020-06-11","254","9553","6","488","4","3.8"
"Forsyth","2020-06-12","216","9769","6","494","3.9","3.7"
"Forsyth","2020-06-13","100","9869","6","500","4.1","4.1"
"Forsyth","2020-06-14","46","9915","2","502","3.5","4.2"
"Forsyth","2020-06-15","254","10169","14","516","3.7","4.3"
"Forsyth","2020-06-16","234","10403","22","538","4.6","4.5"
"Forsyth","2020-06-17","212","10615","20","558","5.7","5.1"
"Forsyth","2020-06-18","283","10898","24","582","6.6","5.3"
"Forsyth","2020-06-19","288","11186","16","598","7","5.4"
"Forsyth","2020-06-20","120","11306","8","606","7.1","5.6"
"Forsyth","2020-06-21","75","11381","10","616","8.3","5.9"
"Forsyth","2020-06-22","340","11721","56","672","9.9","6.8"
"Forsyth","2020-06-23","245","11966","36","708","10.7","7.6"
"Forsyth","2020-06-24","257","12223","25","733","10.7","8.2"
"Forsyth","2020-06-25","386","12609","40","773","11","8.8"
"Forsyth","2020-06-26","502","13111","36","809","11.2","9.1"
"Forsyth","2020-06-27","177","13288","17","826","11.6","9.3"
"Forsyth","2020-06-28","79","13367","16","842","12.6","10.5"
"Forsyth","2020-06-29","409","13776","42","884","11.7","10.8"
"Forsyth","2020-06-30","428","14204","51","935","11.3","11"
"Forsyth","2020-07-01","612","14816","67","1002","11.5","11.1"
"Forsyth","2020-07-02","556","15372","55","1057","11.4","11.2"
"Forsyth","2020-07-03","187","15559","22","1079","12.1","11.6"
"Forsyth","2020-07-04","113","15672","12","1091","12.2","11.9"
"Forsyth","2020-07-05","97","15769","18","1109","12","12.3"
"Forsyth","2020-07-06","480","16249","60","1169","12.3","12"
"Forsyth","2020-07-07","511","16760","60","1229","12.3","11.8"
"Forsyth","2020-07-08","1058","17818","101","1330","12.1","11.8"
"Forsyth","2020-07-09","498","18316","49","1379","12.1","11.8"
"Forsyth","2020-07-10","575","18891","73","1452","12.2","12.2"
"Forsyth","2020-07-11","128","19019","14","1466","12.3","12.2"
"Forsyth","2020-07-12","102","19121","19","1485","12.3","12.1"
"Forsyth","2020-07-13","445","19566","42","1527","11.8","12.1"
"Forsyth","2020-07-14","441","20007","41","1568","11.5","11.9"
"Forsyth","2020-07-15","403","20410","50","1618","11.9","12"
"Forsyth","2020-07-16","619","21029","98","1716","12.7","12.4"
"Forsyth","2020-07-17","446","21475","33","1749","12","12.1"
"Forsyth","2020-07-18","213","21688","40","1789","13.1","12.7"
"Forsyth","2020-07-19","161","21849","17","1806","12","12.1"
"Forsyth","2020-07-20","432","22281","73","1879","13","12.4"
"Forsyth","2020-07-21","407","22688","68","1947","14.1","12.8"
"Forsyth","2020-07-22","818","23506","53","2000","13.2","12.6"
"Forsyth","2020-07-23","528","24034","71","2071","12.9","12.8"
"Forsyth","2020-07-24","389","24423","48","2119","13.6","12.8"
"Forsyth","2020-07-25","180","24603","32","2151","13.5","13.3"
"Forsyth","2020-07-26","95","24698","7","2158","13","12.5"
"Forsyth","2020-07-27","492","25190","57","2215","12.2","12.6"
"Forsyth","2020-07-28","426","25616","40","2255","11.2","12.6"
"Forsyth","2020-07-29","710","26326","63","2318","11.5","12.4"
"Forsyth","2020-07-30","365","26691","33","2351","10.9","11.9"
"Forsyth","2020-07-31","357","27048","23","2374","10.1","11.8"
"Forsyth","2020-08-01","173","27221","28","2402","9.8","11.6"
"Forsyth","2020-08-02","118","27339","15","2417","10.6","11.8"
"Forsyth","2020-08-03","388","27727","42","2459","10.5","11.4"
"Forsyth","2020-08-04","337","28064","38","2497","10.8","11"
"Forsyth","2020-08-05","758","28822","53","2550","10.5","11"
"Forsyth","2020-08-06","420","29242","46","2596","10.8","10.8"
"Forsyth","2020-08-07","358","29600","28","2624","11","10.5"
"Forsyth","2020-08-08","128","29728","12","2636","10","9.9"
"Forsyth","2020-08-09","128","29856","17","2653","10.1","10.3"
"Forsyth","2020-08-10","504","30360","42","2695","9.7","10.1"
"Forsyth","2020-08-11","453","30813","57","2752","9.9","10.3"
"Forsyth","2020-08-12","727","31540","54","2806","10","10.2"
"Forsyth","2020-08-13","349","31889","18","2824","9.1","10"
"Forsyth","2020-08-14","475","32364","24","2848","8.7","9.9"
"Forsyth","2020-08-15","136","32500","12","2860","8.7","9.3"
"Forsyth","2020-08-16","119","32619","8","2868","7.7","8.9"
"Forsyth","2020-08-17","421","33040","37","2905","7.8","8.8"
"Forsyth","2020-08-18","404","33444","29","2934","7","8.5"
"Forsyth","2020-08-19","666","34110","42","2976","6.9","8.4"
"Forsyth","2020-08-20","465","34575","32","3008","7.1","8.1"
"Forsyth","2020-08-21","504","35079","33","3041","7.3","8"
"Forsyth","2020-08-22","191","35270","21","3062","7.6","8.1"
"Forsyth","2020-08-23","147","35417","13","3075","7.9","7.8"
"Forsyth","2020-08-24","429","35846","28","3103","7.6","7.7"
"Forsyth","2020-08-25","561","36407","33","3136","7.4","7.2"
"Forsyth","2020-08-26","494","36901","43","3179","7.8","7.3"
"Forsyth","2020-08-27","440","37341","40","3219","8.1","7.6"
"Forsyth","2020-08-28","448","37789","30","3249","8.1","7.7"
"Forsyth","2020-08-29","179","37968","22","3271","8.3","8"
"Forsyth","2020-08-30","114","38082","4","3275","7.5","7.7"
"Forsyth","2020-08-31","503","38585","41","3316","7.8","7.7"
"Forsyth","2020-09-01","454","39039","48","3364","8.4","7.9"
"Forsyth","2020-09-02","634","39673","37","3401","8","7.9"
"Forsyth","2020-09-03","456","40129","27","3428","7.6","7.8"
"Forsyth","2020-09-04","437","40566","34","3462","7.7","7.9"
"Forsyth","2020-09-05","152","40718","17","3479","7.6","7.9"
"Forsyth","2020-09-06","87","40805","15","3494","9.5","8.5"
"Forsyth","2020-09-07","85","40890","8","3502","9.7","8.7"
"Forsyth","2020-09-08","692","41582","39","3541","9","8.7"
"Forsyth","2020-09-09","678","42260","30","3571","8.8","8.4"
"Forsyth","2020-09-10","418","42678","27","3598","8.9","8.2"
"Forsyth","2020-09-11","396","43074","27","3625","8.7","8.2"
"Forsyth","2020-09-12","141","43215","15","3640","8.7","8.1"
"Forsyth","2020-09-13","139","43354","15","3655","7.7","8.6"
"Forsyth","2020-09-14","486","43840","20","3675","7","8.3"
"Forsyth","2020-09-15","394","44234","28","3703","7.2","8.1"
"Forsyth","2020-09-16","532","44766","30","3733","7.4","8.1"
"Forsyth","2020-09-17","447","45213","18","3751","7","7.9"
"Forsyth","2020-09-18","441","45654","18","3769","6.6","7.7"
"Forsyth","2020-09-19","149","45803","11","3780","6.2","7.4"
"Forsyth","2020-09-20","136","45939","17","3797","6.4","7.1"
"Forsyth","2020-09-21","457","46396","18","3815","6.4","6.7"
"Forsyth","2020-09-22","371","46767","20","3835","6.1","6.7"
"Forsyth","2020-09-23","485","47252","20","3855","5.9","6.6"
"Forsyth","2020-09-24","336","47588","19","3874","6.2","6.6"
"Forsyth","2020-09-25","366","47954","15","3889","6.2","6.4"
"Forsyth","2020-09-26","113","48067","12","3901","6.6","6.4"
"Forsyth","2020-09-27","120","48187","9","3910","5.9","6.2"
"Forsyth","2020-09-28","416","48603","23","3933","6.1","6.3"
"Forsyth","2020-09-29","383","48986","12","3945","5.8","6"
"Forsyth","2020-09-30","496","49482","23","3968","5.9","5.9"
"Forsyth","2020-10-01","362","49844","10","3978","5.5","5.8"
"Forsyth","2020-10-02","396","50240","17","3995","5.5","5.8"
"Forsyth","2020-10-03","172","50412","12","4007","5","5.8"
"Forsyth","2020-10-04","88","50500","4","4011","4.6","5.2"
"Forsyth","2020-10-05","463","50963","16","4027","4.3","5.2"
"Forsyth","2020-10-06","437","51400","13","4040","4.2","5"
"Forsyth","2020-10-07","598","51998","33","4073","4.4","5.1"
"Forsyth","2020-10-08","354","52352","12","4085","4.5","5"
"Forsyth","2020-10-09","381","52733","24","4109","4.7","5.1"
"Forsyth","2020-10-10","126","52859","7","4116","4.5","4.8"
"Forsyth","2020-10-11","113","52972","4","4120","4.4","4.5"
"Forsyth","2020-10-12","406","53378","22","4142","4.7","4.5"
"Forsyth","2020-10-13","390","53768","22","4164","5.1","4.6"
"Forsyth","2020-10-14","568","54336","23","4187","4.8","4.6"
"Forsyth","2020-10-15","349","54685","21","4208","5.2","4.8"
"Forsyth","2020-10-16","357","55042","17","4225","5","4.9"
"Forsyth","2020-10-17","126","55168","8","4233","5.1","4.8"
"Forsyth","2020-10-18","96","55264","5","4238","5.3","4.9"
"Forsyth","2020-10-19","438","55702","21","4259","5.3","5"
"Forsyth","2020-10-20","456","56158","10","4269","4.8","4.9"
"Forsyth","2020-10-21","681","56839","40","4309","5","4.9"
"Forsyth","2020-10-22","499","57338","26","4335","4.9","5.1"
"Forsyth","2020-10-23","571","57909","37","4372","5.2","5.1"
"Forsyth","2020-10-24","157","58066","18","4390","5.9","5.5"
"Forsyth","2020-10-25","186","58252","21","4411","6.8","6.1"
"Forsyth","2020-10-26","526","58778","19","4430","6.6","5.9"
"Forsyth","2020-10-27","473","59251","21","4451","6.9","5.8"
"Forsyth","2020-10-28","700","59951","40","4491","6.9","6"
"Forsyth","2020-10-29","486","60437","34","4525","7.1","6"
"Forsyth","2020-10-30","528","60965","36","4561","7.2","6.2"
"Forsyth","2020-10-31","268","61233","23","4584","6.8","6.3"
"Forsyth","2020-11-01","175","61408","13","4597","6.2","6.5"
"Forsyth","2020-11-02","564","61972","42","4639","6.8","6.7"
"Forsyth","2020-11-03","492","62464","28","4667","7","6.9"
"Forsyth","2020-11-04","641","63105","45","4712","7.1","7"
"Forsyth","2020-11-05","577","63682","40","4752","7.1","7.1"
"Forsyth","2020-11-06","551","64233","37","4789","7.1","7.2"
"Forsyth","2020-11-07","263","64496","33","4822","7.7","7.2"
"Forsyth","2020-11-08","196","64692","23","4845","8.3","7.3"
"Forsyth","2020-11-09","693","65385","70","4915","8.7","7.7"
"Forsyth","2020-11-10","640","66025","50","4965","9","8"
"Forsyth","2020-11-11","491","66516","46","5011","9.3","8.2"
"Forsyth","2020-11-12","626","67142","61","5072","9.7","8.4"
"Forsyth","2020-11-13","717","67859","84","5156","10.4","8.8"
"Forsyth","2020-11-14","334","68193","38","5194","10.3","9"
"Forsyth","2020-11-15","217","68410","38","5232","11.1","9.7"
"Forsyth","2020-11-16","696","69106","59","5291","10.9","9.8"
"Forsyth","2020-11-17","851","69957","58","5349","10.7","9.8"
"Forsyth","2020-11-18","1135","71092","95","5444","10.6","9.9"
"Forsyth","2020-11-19","807","71899","57","5501","10.2","10"
"Forsyth","2020-11-20","691","72590","56","5557","9.7","10.1"
"Forsyth","2020-11-21","415","73005","61","5618","10.1","10.2"
"Forsyth","2020-11-22","296","73301","28","5646","9","10"
"Forsyth","2020-11-23","736","74037","73","5719","9.2","10"
"Forsyth","2020-11-24","544","74581","51","5770","9.6","10.1"
"Forsyth","2020-11-25","1075","75656","126","5896","10","10.3"
"Forsyth","2020-11-26","112","75768","36","5932","13.6","11.9"
"Forsyth","2020-11-27","630","76398","88","6020","14.5","12.1"
"Forsyth","2020-11-28","315","76713","71","6091","15.6","12.9"
"Forsyth","2020-11-29","268","76981","48","6139","16.8","12.9"
"Forsyth","2020-11-30","842","77823","115","6254","17.3","13.3"
"Forsyth","2020-12-01","706","78529","89","6343","17.8","13.7"
"Forsyth","2020-12-02","970","79499","155","6498","18.4","14.2"
"Forsyth","2020-12-03","711","80210","88","6586","15.6","14.6"
"Forsyth","2020-12-04","703","80913","92","6678","15.5","15"
"Forsyth","2020-12-05","323","81236","40","6718","14","14.8"
"Forsyth","2020-12-06","276","81512","50","6768","14","15.4"
"Forsyth","2020-12-07","894","82406","89","6857","13.5","15.4"
"Forsyth","2020-12-08","848","83254","155","7012","14.3","16.1"
"Forsyth","2020-12-09","1039","84293","142","7154","14","16.2"
"Forsyth","2020-12-10","772","85065","103","7257","14.1","14.8"
"Forsyth","2020-12-11","989","86054","114","7371","13.9","14.7"
"Forsyth","2020-12-12","516","86570","67","7438","14","14"
"Forsyth","2020-12-13","248","86818","44","7482","13.9","14"
"Forsyth","2020-12-14","1048","87866","146","7628","14.5","14"
"Forsyth","2020-12-15","917","88783","143","7771","14.1","14.2"
"Forsyth","2020-12-16","1056","89839","137","7908","14","14"
"Forsyth","2020-12-17","904","90743","129","8037","14.1","14.1"
"Forsyth","2020-12-18","982","91725","142","8179","14.6","14.2"
"Forsyth","2020-12-19","393","92118","68","8247","15.2","14.6"
"Forsyth","2020-12-20","338","92456","62","8309","15.3","14.6"
"Forsyth","2020-12-21","909","93365","178","8487","16.1","15.3"
"Forsyth","2020-12-22","926","94291","137","8624","16","15"
"Forsyth","2020-12-23","989","95280","160","8784","16.4","15.2"
"Forsyth","2020-12-24","513","95793","99","8883","17.1","15.6"
"Forsyth","2020-12-25","61","95854","22","8905","20.2","17.4"
"Forsyth","2020-12-26","351","96205","87","8992","21.3","18.2"
"Forsyth","2020-12-27","319","96524","91","9083","22.7","19"
"Forsyth","2020-12-28","1131","97655","228","9311","22.8","19.5"
"Forsyth","2020-12-29","773","98428","185","9496","24.1","20"
"Forsyth","2020-12-30","951","99379","171","9667","24.4","20.4"
"Forsyth","2020-12-31","646","100025","142","9809","24.8","21"
"Forsyth","2021-01-01","135","100160","48","9857","24.7","22.5"
"Forsyth","2021-01-02","252","100412","75","9932","25.4","23.4"
"Forsyth","2021-01-03","349","100761","98","10030","25.4","24"
"Forsyth","2021-01-04","1081","101842","251","10281","25.8","24.3"
"Forsyth","2021-01-05","1090","102932","202","10483","25","24.6"
"Forsyth","2021-01-06","1023","103955","216","10699","25.5","24.9"
"Forsyth","2021-01-07","1025","104980","170","10869","24.7","24.7"
"Forsyth","2021-01-08","930","105910","178","11047","22.3","23.5"
"Forsyth","2021-01-09","465","106375","109","11156","21.4","23.4"
"Forsyth","2021-01-10","324","106699","74","11230","20.7","23"
"Forsyth","2021-01-11","1030","107729","179","11409","19.9","22.8"
"Forsyth","2021-01-12","1046","108775","194","11603","19.9","22.4"
"Forsyth","2021-01-13","975","109750","158","11761","19.2","22.3"
"Forsyth","2021-01-14","1014","110764","188","11949","19.4","22.1"
"Forsyth","2021-01-15","854","111618","167","12116","19.5","20.9"
"Forsyth","2021-01-16","440","112058","97","12213","19.3","20.4"
"Forsyth","2021-01-17","310","112368","59","12272","18.8","19.7"
"Forsyth","2021-01-18","842","113210","132","12404","18.5","19.2"
"Forsyth","2021-01-19","963","114173","161","12565","18.3","19.1"
"Forsyth","2021-01-20","866","115039","152","12717","18.4","18.8"
"Forsyth","2021-01-21","833","115872","114","12831","17.8","18.6"
"Forsyth","2021-01-22","830","116702","123","12954","17.1","18.3"
"Forsyth","2021-01-23","348","117050","66","13020","16.6","18"
"Forsyth","2021-01-24","334","117384","60","13080","16.5","17.6"
"Forsyth","2021-01-25","947","118331","131","13211","16.2","17.4"
"Forsyth","2021-01-26","817","119148","143","13354","16.3","17.3"
"Forsyth","2021-01-27","795","119943","97","13451","15.6","17"
"Forsyth","2021-01-28","836","120779","108","13559","15.5","16.6"
"Forsyth","2021-01-29","750","121529","113","13672","15.5","16.3"
"Forsyth","2021-01-30","372","121901","52","13724","14.8","15.7"
"Forsyth","2021-01-31","283","122184","61","13785","15.3","15.9"
"Forsyth","2021-02-01","815","122999","97","13882","15","15.6"
"Forsyth","2021-02-02","766","123765","94","13976","14.3","15.3"
"Forsyth","2021-02-03","674","124439","70","14046","14","14.8"
"Forsyth","2021-02-04","636","125075","66","14112","13.6","14.6"
"Forsyth","2021-02-05","388","125463","31","14143","12.6","14.1"
"Forsyth","2021-02-06","117","125580","23","14166","13.4","14.1"
"Forsyth","2021-02-07","18","125598","6","14172","15.1","15.2"
"Forsyth","2021-02-08","0","125598","0","14172","13.4","14.2"
"Franklin","2020-02-01","0","0","0","0",".","."
"Franklin","2020-02-02","0","0","0","0",".","."
"Franklin","2020-02-03","0","0","0","0",".","."
"Franklin","2020-02-04","0","0","0","0",".","."
"Franklin","2020-02-05","0","0","0","0",".","."
"Franklin","2020-02-06","0","0","0","0",".","."
"Franklin","2020-02-07","1","1","0","0","0","."
"Franklin","2020-02-08","0","1","0","0","0","."
"Franklin","2020-02-09","0","1","0","0","0","."
"Franklin","2020-02-10","0","1","0","0","0","."
"Franklin","2020-02-11","0","1","0","0","0","."
"Franklin","2020-02-12","0","1","0","0","0","."
"Franklin","2020-02-13","0","1","0","0","0","."
"Franklin","2020-02-14","0","1","0","0","0","0"
"Franklin","2020-02-15","0","1","0","0","0","0"
"Franklin","2020-02-16","0","1","0","0","0","0"
"Franklin","2020-02-17","0","1","0","0","0","0"
"Franklin","2020-02-18","0","1","0","0","0","0"
"Franklin","2020-02-19","0","1","0","0","0","0"
"Franklin","2020-02-20","0","1","0","0","0","0"
"Franklin","2020-02-21","0","1","0","0","0","0"
"Franklin","2020-02-22","0","1","0","0","0","0"
"Franklin","2020-02-23","0","1","0","0","0","0"
"Franklin","2020-02-24","0","1","0","0","0","0"
"Franklin","2020-02-25","0","1","0","0","0","0"
"Franklin","2020-02-26","0","1","0","0","0","0"
"Franklin","2020-02-27","0","1","0","0","0","0"
"Franklin","2020-02-28","0","1","0","0","0","0"
"Franklin","2020-02-29","0","1","0","0","0","0"
"Franklin","2020-03-01","0","1","0","0","0","0"
"Franklin","2020-03-02","0","1","0","0","0","0"
"Franklin","2020-03-03","0","1","0","0","0","0"
"Franklin","2020-03-04","0","1","0","0","0","0"
"Franklin","2020-03-05","0","1","0","0","0","0"
"Franklin","2020-03-06","0","1","0","0","0","0"
"Franklin","2020-03-07","0","1","0","0","0","0"
"Franklin","2020-03-08","0","1","0","0","0","0"
"Franklin","2020-03-09","0","1","0","0","0","0"
"Franklin","2020-03-10","0","1","0","0","0","0"
"Franklin","2020-03-11","2","3","0","0","0","0"
"Franklin","2020-03-12","4","7","0","0","0","0"
"Franklin","2020-03-13","3","10","0","0","0","0"
"Franklin","2020-03-14","0","10","0","0","0","0"
"Franklin","2020-03-15","1","11","0","0","0","0"
"Franklin","2020-03-16","1","12","0","0","0","0"
"Franklin","2020-03-17","2","14","0","0","0","0"
"Franklin","2020-03-18","0","14","0","0","0","0"
"Franklin","2020-03-19","4","18","0","0","0","0"
"Franklin","2020-03-20","1","19","0","0","0","0"
"Franklin","2020-03-21","4","23","0","0","0","0"
"Franklin","2020-03-22","1","24","0","0","0","0"
"Franklin","2020-03-23","5","29","2","2","5.7","2.9"
"Franklin","2020-03-24","2","31","0","2","5.7","2.9"
"Franklin","2020-03-25","5","36","1","3","8.6","4.3"
"Franklin","2020-03-26","14","50","2","5","10.6","5.3"
"Franklin","2020-03-27","3","53","0","5","10.6","5.3"
"Franklin","2020-03-28","0","53","0","5","10.6","5.3"
"Franklin","2020-03-29","1","54","0","5","10.6","5.3"
"Franklin","2020-03-30","1","55","0","5","4.9","5.3"
"Franklin","2020-03-31","2","57","0","5","4.9","5.3"
"Franklin","2020-04-01","5","62","0","5","2","5.3"
"Franklin","2020-04-02","1","63","0","5","0","5.3"
"Franklin","2020-04-03","2","65","0","5","0","5.3"
"Franklin","2020-04-04","2","67","0","5","0","5.3"
"Franklin","2020-04-05","0","67","0","5","0","5.3"
"Franklin","2020-04-06","2","69","1","6","7.1","6"
"Franklin","2020-04-07","2","71","0","6","7.1","6"
"Franklin","2020-04-08","0","71","0","6","7.1","4.6"
"Franklin","2020-04-09","1","72","0","6","7.1","3.6"
"Franklin","2020-04-10","3","75","0","6","7.1","3.6"
"Franklin","2020-04-11","1","76","0","6","7.1","3.6"
"Franklin","2020-04-12","0","76","0","6","7.1","3.6"
"Franklin","2020-04-13","1","77","0","6","0","3.6"
"Franklin","2020-04-14","0","77","0","6","0","3.6"
"Franklin","2020-04-15","2","79","1","7","7.1","7.1"
"Franklin","2020-04-16","10","89","0","7","7.1","7.1"
"Franklin","2020-04-17","3","92","2","9","16.7","11.9"
"Franklin","2020-04-18","3","95","0","9","16.7","11.9"
"Franklin","2020-04-19","0","95","0","9","16.7","11.9"
"Franklin","2020-04-20","1","96","0","9","16.7","8.3"
"Franklin","2020-04-21","3","99","0","9","16.7","8.3"
"Franklin","2020-04-22","8","107","0","9","9.5","8.3"
"Franklin","2020-04-23","4","111","1","10","13.1","10.1"
"Franklin","2020-04-24","5","116","2","12","9.3","13"
"Franklin","2020-04-25","0","116","0","12","9.3","13"
"Franklin","2020-04-26","0","116","0","12","9.3","13"
"Franklin","2020-04-27","5","121","0","12","9.3","13"
"Franklin","2020-04-28","4","125","0","12","9.3","13"
"Franklin","2020-04-29","10","135","2","14","12.1","10.8"
"Franklin","2020-04-30","7","142","2","16","12.7","12.9"
"Franklin","2020-05-01","5","147","0","16","6.9","8.1"
"Franklin","2020-05-02","3","150","0","16","6.9","8.1"
"Franklin","2020-05-03","1","151","0","16","6.9","8.1"
"Franklin","2020-05-04","11","162","0","16","6.9","8.1"
"Franklin","2020-05-05","2","164","0","16","6.9","8.1"
"Franklin","2020-05-06","3","167","0","16","4.1","8.1"
"Franklin","2020-05-07","8","175","0","16","0","6.3"
"Franklin","2020-05-08","113","288","2","18","0.3","3.6"
"Franklin","2020-05-09","4","292","0","18","0.3","3.6"
"Franklin","2020-05-10","4","296","0","18","0.3","3.6"
"Franklin","2020-05-11","6","302","0","18","0.3","3.6"
"Franklin","2020-05-12","82","384","2","20","0.6","3.8"
"Franklin","2020-05-13","5","389","0","20","0.6","2.3"
"Franklin","2020-05-14","5","394","0","20","0.6","0.3"
"Franklin","2020-05-15","59","453","3","23","1.1","0.7"
"Franklin","2020-05-16","3","456","0","23","1.1","0.7"
"Franklin","2020-05-17","3","459","0","23","1.1","0.7"
"Franklin","2020-05-18","13","472","1","24","2.2","1.2"
"Franklin","2020-05-19","46","518","1","25","2.1","1.4"
"Franklin","2020-05-20","5","523","0","25","2.1","1.4"
"Franklin","2020-05-21","5","528","1","26","5","2.8"
"Franklin","2020-05-22","51","579","10","36","7.1","4.1"
"Franklin","2020-05-23","1","580","0","36","7.1","4.1"
"Franklin","2020-05-24","1","581","0","36","7.1","4.1"
"Franklin","2020-05-25","1","582","0","36","6","4.1"
"Franklin","2020-05-26","54","636","15","51","9.6","5.9"
"Franklin","2020-05-27","15","651","0","51","9.6","5.9"
"Franklin","2020-05-28","90","741","14","65","9","7"
"Franklin","2020-05-29","11","752","0","65","6.2","6.6"
"Franklin","2020-05-30","5","757","1","66","9","8.1"
"Franklin","2020-05-31","12","769","0","66","9","8.1"
"Franklin","2020-06-01","6","775","0","66","9","7.5"
"Franklin","2020-06-02","161","936","5","71","5.5","7.6"
"Franklin","2020-06-03","14","950","0","71","5.5","7.6"
"Franklin","2020-06-04","12","962","0","71","3.3","6.1"
"Franklin","2020-06-05","6","968","0","71","3.3","4.7"
"Franklin","2020-06-06","7","975","0","71","0.4","4.7"
"Franklin","2020-06-07","4","979","0","71","0.4","4.7"
"Franklin","2020-06-08","9","988","0","71","0.4","4.7"
"Franklin","2020-06-09","79","1067","5","76","0.9","3.2"
"Franklin","2020-06-10","5","1072","0","76","0.9","3.2"
"Franklin","2020-06-11","17","1089","3","79","3.4","3.4"
"Franklin","2020-06-12","79","1168","4","83","4.1","3.7"
"Franklin","2020-06-13","4","1172","0","83","4.1","2.3"
"Franklin","2020-06-14","15","1187","1","84","5.1","2.8"
"Franklin","2020-06-15","14","1201","0","84","5.1","2.8"
"Franklin","2020-06-16","47","1248","5","89","5.7","3.3"
"Franklin","2020-06-17","15","1263","0","89","5.7","3.3"
"Franklin","2020-06-18","19","1282","3","92","5.5","4.4"
"Franklin","2020-06-19","65","1347","3","95","5.4","4.8"
"Franklin","2020-06-20","3","1350","1","96","10.1","7.1"
"Franklin","2020-06-21","7","1357","1","97","11.2","8.2"
"Franklin","2020-06-22","15","1372","0","97","11.2","8.2"
"Franklin","2020-06-23","83","1455","3","100","10.2","8"
"Franklin","2020-06-24","17","1472","2","102","11.9","8.8"
"Franklin","2020-06-25","16","1488","1","103","10.6","8"
"Franklin","2020-06-26","140","1628","5","108","10.4","7.9"
"Franklin","2020-06-27","10","1638","1","109","7.1","8.6"
"Franklin","2020-06-28","6","1644","1","110","7.4","9.3"
"Franklin","2020-06-29","29","1673","2","112","8.4","9.8"
"Franklin","2020-06-30","148","1821","16","128","9.4","9.8"
"Franklin","2020-07-01","19","1840","2","130","9.2","10.6"
"Franklin","2020-07-02","161","2001","16","146","9.8","10.2"
"Franklin","2020-07-03","9","2010","0","146","9.3","9.8"
"Franklin","2020-07-04","8","2018","0","146","7.8","7.5"
"Franklin","2020-07-05","12","2030","0","146","5.5","6.4"
"Franklin","2020-07-06","12","2042","1","147","5.7","7"
"Franklin","2020-07-07","186","2228","15","162","5.3","7.3"
"Franklin","2020-07-08","23","2251","1","163","4.4","6.8"
"Franklin","2020-07-09","13","2264","1","164","4.1","6.9"
"Franklin","2020-07-10","172","2436","6","170","4.6","6.9"
"Franklin","2020-07-11","13","2449","4","174","9","8.4"
"Franklin","2020-07-12","8","2457","1","175","10.7","8.1"
"Franklin","2020-07-13","14","2471","3","178","12.6","9.1"
"Franklin","2020-07-14","216","2687","18","196","12.7","9"
"Franklin","2020-07-15","34","2721","4","200","13.7","9"
"Franklin","2020-07-16","16","2737","4","204","16.2","10.1"
"Franklin","2020-07-17","20","2757","2","206","17.1","10.8"
"Franklin","2020-07-18","12","2769","7","213","21.1","15"
"Franklin","2020-07-19","14","2783","4","217","23.3","17"
"Franklin","2020-07-20","19","2802","3","220","22.5","17.6"
"Franklin","2020-07-21","220","3022","14","234","22.3","17.5"
"Franklin","2020-07-22","30","3052","3","237","22","17.9"
"Franklin","2020-07-23","26","3078","7","244","22.3","19.2"
"Franklin","2020-07-24","15","3093","5","249","25.6","21.4"
"Franklin","2020-07-25","18","3111","4","253","20.5","20.8"
"Franklin","2020-07-26","20","3131","5","258","19.9","21.6"
"Franklin","2020-07-27","16","3147","2","260","19.5","21"
"Franklin","2020-07-28","255","3402","14","274","19.4","20.8"
"Franklin","2020-07-29","23","3425","4","278","20.4","21.2"
"Franklin","2020-07-30","18","3443","5","283","20.5","21.4"
"Franklin","2020-07-31","19","3462","5","288","19.5","22.6"
"Franklin","2020-08-01","27","3489","8","296","20.6","20.5"
"Franklin","2020-08-02","8","3497","2","298","20.6","20.3"
"Franklin","2020-08-03","21","3518","5","303","22.2","20.8"
"Franklin","2020-08-04","210","3728","9","312","22","20.7"
"Franklin","2020-08-05","27","3755","1","313","20.1","20.2"
"Franklin","2020-08-06","13","3768","4","317","20.5","20.5"
"Franklin","2020-08-07","156","3924","23","340","18.8","19.2"
"Franklin","2020-08-08","18","3942","3","343","17","18.8"
"Franklin","2020-08-09","11","3953","1","344","14.7","17.7"
"Franklin","2020-08-10","22","3975","2","346","12.6","17.4"
"Franklin","2020-08-11","106","4081","8","354","13.1","17.6"
"Franklin","2020-08-12","12","4093","5","359","18.5","19.3"
"Franklin","2020-08-13","19","4112","4","363","17.1","18.8"
"Franklin","2020-08-14","121","4233","13","376","16.6","17.7"
"Franklin","2020-08-15","7","4240","0","376","14.2","15.6"
"Franklin","2020-08-16","16","4256","2","378","14.7","14.7"
"Franklin","2020-08-17","17","4273","2","380","15","13.8"
"Franklin","2020-08-18","110","4383","12","392","15.5","14.3"
"Franklin","2020-08-19","32","4415","7","399","12.7","15.6"
"Franklin","2020-08-20","18","4433","6","405","14.4","15.8"
"Franklin","2020-08-21","115","4548","15","420","14.8","15.7"
"Franklin","2020-08-22","17","4565","4","424","18.1","16.2"
"Franklin","2020-08-23","15","4580","4","428","20.2","17.4"
"Franklin","2020-08-24","19","4599","1","429","19.2","17.1"
"Franklin","2020-08-25","155","4754","15","444","19.1","17.3"
"Franklin","2020-08-26","28","4782","3","447","17.5","15.1"
"Franklin","2020-08-27","24","4806","3","450","14.5","14.5"
"Franklin","2020-08-28","198","5004","11","461","13.4","14.1"
"Franklin","2020-08-29","6","5010","0","461","10.1","14.1"
"Franklin","2020-08-30","11","5021","1","462","7.5","13.9"
"Franklin","2020-08-31","31","5052","3","465","8.2","13.7"
"Franklin","2020-09-01","173","5225","20","485","8.4","13.7"
"Franklin","2020-09-02","19","5244","3","488","9.2","13.3"
"Franklin","2020-09-03","21","5265","7","495","12.1","13.3"
"Franklin","2020-09-04","237","5502","29","524","13.1","13.3"
"Franklin","2020-09-05","19","5521","7","531","18.4","14.2"
"Franklin","2020-09-06","15","5536","3","534","19.9","13.7"
"Franklin","2020-09-07","15","5551","2","536","20.4","14.3"
"Franklin","2020-09-08","186","5737","19","555","20.2","14.3"
"Franklin","2020-09-09","34","5771","4","559","19.7","14.4"
"Franklin","2020-09-10","22","5793","1","560","15.6","13.9"
"Franklin","2020-09-11","172","5965","13","573","14.9","14"
"Franklin","2020-09-12","20","5985","4","577","12.5","15.4"
"Franklin","2020-09-13","11","5996","1","578","10.9","15.4"
"Franklin","2020-09-14","44","6040","5","583","10.6","15.5"
"Franklin","2020-09-15","135","6175","17","600","11","15.6"
"Franklin","2020-09-16","25","6200","5","605","12.2","15.9"
"Franklin","2020-09-17","30","6230","1","606","12","13.8"
"Franklin","2020-09-18","200","6430","14","620","11.9","13.4"
"Franklin","2020-09-19","9","6439","2","622","12.2","12.4"
"Franklin","2020-09-20","23","6462","5","627","14","12.5"
"Franklin","2020-09-21","103","6565","3","630","12.8","11.7"
"Franklin","2020-09-22","190","6755","19","649","12.5","11.7"
"Franklin","2020-09-23","17","6772","2","651","11.3","11.7"
"Franklin","2020-09-24","24","6796","3","654","12.6","12.3"
"Franklin","2020-09-25","166","6962","8","662","12.3","12.1"
"Franklin","2020-09-26","10","6972","0","662","9.1","10.7"
"Franklin","2020-09-27","8","6980","0","662","6","10"
"Franklin","2020-09-28","17","6997","1","663","6.4","9.6"
"Franklin","2020-09-29","139","7136","8","671","5.8","9.1"
"Franklin","2020-09-30","20","7156","0","671","4.1","7.7"
"Franklin","2020-10-01","13","7169","2","673","4.5","8.6"
"Franklin","2020-10-02","135","7304","6","679","4.5","8.4"
"Franklin","2020-10-03","11","7315","1","680","5.8","7.4"
"Franklin","2020-10-04","16","7331","3","683","8.5","7.2"
"Franklin","2020-10-05","80","7411","2","685","8","7.2"
"Franklin","2020-10-06","153","7564","13","698","8.4","7.1"
"Franklin","2020-10-07","22","7586","3","701","10.3","7.2"
"Franklin","2020-10-08","25","7611","3","704","9.8","7.2"
"Franklin","2020-10-09","142","7753","13","717","10.5","7.5"
"Franklin","2020-10-10","12","7765","1","718","10.4","8.1"
"Franklin","2020-10-11","6","7771","0","718","7.7","8.1"
"Franklin","2020-10-12","35","7806","5","723","9.4","8.7"
"Franklin","2020-10-13","102","7908","11","734","9.7","9.1"
"Franklin","2020-10-14","25","7933","5","739","10.7","10.5"
"Franklin","2020-10-15","58","7991","11","750","11.6","10.7"
"Franklin","2020-10-16","131","8122","20","770","12.5","11.5"
"Franklin","2020-10-17","10","8132","0","770","11.3","10.9"
"Franklin","2020-10-18","17","8149","3","773","13.8","10.8"
"Franklin","2020-10-19","76","8225","20","793","15.6","12.5"
"Franklin","2020-10-20","75","8300","13","806","16.5","13.1"
"Franklin","2020-10-21","42","8342","3","809","14.7","12.7"
"Franklin","2020-10-22","29","8371","4","813","13.9","12.8"
"Franklin","2020-10-23","108","8479","9","822","12.9","12.7"
"Franklin","2020-10-24","14","8493","7","829","20.1","15.7"
"Franklin","2020-10-25","9","8502","1","830","19.1","16.5"
"Franklin","2020-10-26","24","8526","0","830","15.4","15.5"
"Franklin","2020-10-27","101","8627","20","850","15.7","16.1"
"Franklin","2020-10-28","27","8654","6","856","17.9","16.3"
"Franklin","2020-10-29","28","8682","4","860","18","15.9"
"Franklin","2020-10-30","111","8793","17","877","19","16"
"Franklin","2020-10-31","14","8807","3","880","14.9","17.5"
"Franklin","2020-11-01","14","8821","2","882","15.3","17.2"
"Franklin","2020-11-02","40","8861","10","892","18.9","17.1"
"Franklin","2020-11-03","118","8979","14","906","17.8","16.8"
"Franklin","2020-11-04","20","8999","6","912","18.9","18.4"
"Franklin","2020-11-05","40","9039","3","915","17.9","17.9"
"Franklin","2020-11-06","99","9138","12","927","17.5","18.2"
"Franklin","2020-11-07","34","9172","6","933","16.9","15.9"
"Franklin","2020-11-08","12","9184","1","934","16.1","15.7"
"Franklin","2020-11-09","42","9226","4","938","13.9","16.4"
"Franklin","2020-11-10","111","9337","10","948","13.4","15.6"
"Franklin","2020-11-11","30","9367","5","953","11.5","15.2"
"Franklin","2020-11-12","36","9403","11","964","14.8","16.4"
"Franklin","2020-11-13","131","9534","16","980","14.8","16.2"
"Franklin","2020-11-14","21","9555","8","988","17.8","17.3"
"Franklin","2020-11-15","16","9571","8","996","23.7","19.9"
"Franklin","2020-11-16","60","9631","6","1002","23.8","18.8"
"Franklin","2020-11-17","132","9763","14","1016","24","18.7"
"Franklin","2020-11-18","52","9815","7","1023","23.6","17.6"
"Franklin","2020-11-19","59","9874","5","1028","20.4","17.6"
"Franklin","2020-11-20","134","10008","15","1043","20.3","17.6"
"Franklin","2020-11-21","28","10036","3","1046","16.4","17.1"
"Franklin","2020-11-22","15","10051","7","1053","15.9","19.8"
"Franklin","2020-11-23","55","10106","10","1063","17","20.4"
"Franklin","2020-11-24","141","10247","28","1091","18.4","21.2"
"Franklin","2020-11-25","45","10292","8","1099","19","21.3"
"Franklin","2020-11-26","18","10310","3","1102","20.2","20.3"
"Franklin","2020-11-27","30","10340","8","1110","22.4","21.3"
"Franklin","2020-11-28","27","10367","5","1115","23.5","19.9"
"Franklin","2020-11-29","12","10379","3","1118","20.4","18.1"
"Franklin","2020-11-30","51","10430","8","1126","20","18.5"
"Franklin","2020-12-01","119","10549","26","1152","20.3","19.3"
"Franklin","2020-12-02","58","10607","12","1164","20.7","19.9"
"Franklin","2020-12-03","98","10705","10","1174","19.8","20"
"Franklin","2020-12-04","140","10845","23","1197","18.3","20.4"
"Franklin","2020-12-05","30","10875","9","1206","20","21.7"
"Franklin","2020-12-06","19","10894","6","1212","20.9","20.7"
"Franklin","2020-12-07","57","10951","10","1222","21.2","20.6"
"Franklin","2020-12-08","196","11147","35","1257","20.6","20.5"
"Franklin","2020-12-09","35","11182","4","1261","19.3","20"
"Franklin","2020-12-10","82","11264","7","1268","19.1","19.4"
"Franklin","2020-12-11","165","11429","39","1307","20.1","19.2"
"Franklin","2020-12-12","34","11463","8","1315","19.2","19.6"
"Franklin","2020-12-13","14","11477","6","1321","20.8","20.8"
"Franklin","2020-12-14","75","11552","17","1338","21.5","21.3"
"Franklin","2020-12-15","135","11687","30","1368","22.1","21.4"
"Franklin","2020-12-16","49","11736","12","1380","24","21.6"
"Franklin","2020-12-17","69","11805","19","1399","26.7","22.9"
"Franklin","2020-12-18","154","11959","33","1432","26.4","23.2"
"Franklin","2020-12-19","24","11983","9","1441","28.4","23.8"
"Franklin","2020-12-20","28","12011","9","1450","26.9","23.8"
"Franklin","2020-12-21","58","12069","19","1469","28.3","24.9"
"Franklin","2020-12-22","157","12226","44","1513","29.1","25.6"
"Franklin","2020-12-23","81","12307","15","1528","28.3","26.1"
"Franklin","2020-12-24","91","12398","18","1546","27.2","26.9"
"Franklin","2020-12-25","8","12406","3","1549","29.5","27.9"
"Franklin","2020-12-26","30","12436","13","1562","30.3","29.3"
"Franklin","2020-12-27","34","12470","8","1570","29.1","28"
"Franklin","2020-12-28","62","12532","23","1593","29.7","29"
"Franklin","2020-12-29","207","12739","32","1625","27.9","28.5"
"Franklin","2020-12-30","60","12799","10","1635","27.6","27.9"
"Franklin","2020-12-31","114","12913","21","1656","27.4","27.3"
"Franklin","2021-01-01","23","12936","9","1665","27.7","28.6"
"Franklin","2021-01-02","44","12980","23","1688","28.9","29.6"
"Franklin","2021-01-03","29","13009","16","1704","33.5","31.3"
"Franklin","2021-01-04","63","13072","22","1726","33.1","31.4"
"Franklin","2021-01-05","303","13375","53","1779","33.4","30.7"
"Franklin","2021-01-06","173","13548","26","1805","33.2","30.4"
"Franklin","2021-01-07","137","13685","16","1821","32.2","29.8"
"Franklin","2021-01-08","135","13820","21","1842","28.9","28.3"
"Franklin","2021-01-09","36","13856","14","1856","27","28"
"Franklin","2021-01-10","34","13890","7","1863","22","27.7"
"Franklin","2021-01-11","68","13958","21","1884","21.4","27.3"
"Franklin","2021-01-12","118","14076","12","1896","20.4","26.9"
"Franklin","2021-01-13","88","14164","12","1908","20.2","26.7"
"Franklin","2021-01-14","91","14255","18","1926","21.4","26.8"
"Franklin","2021-01-15","53","14308","12","1938","22.4","25.6"
"Franklin","2021-01-16","35","14343","7","1945","19.7","23.3"
"Franklin","2021-01-17","20","14363","3","1948","18.9","20.4"
"Franklin","2021-01-18","49","14412","11","1959","17.7","19.6"
"Franklin","2021-01-19","115","14527","16","1975","18.2","19.3"
"Franklin","2021-01-20","125","14652","19","1994","18.4","19.3"
"Franklin","2021-01-21","55","14707","12","2006","18.7","20"
"Franklin","2021-01-22","59","14766","6","2012","16.9","19.7"
"Franklin","2021-01-23","20","14786","5","2017","17.6","18.7"
"Franklin","2021-01-24","17","14803","1","2018","16.3","17.6"
"Franklin","2021-01-25","47","14850","8","2026","15.6","16.6"
"Franklin","2021-01-26","102","14952","17","2043","16","17.1"
"Franklin","2021-01-27","57","15009","10","2053","16.3","17.4"
"Franklin","2021-01-28","35","15044","6","2059","15.6","17.2"
"Franklin","2021-01-29","41","15085","6","2065","16.3","16.6"
"Franklin","2021-01-30","24","15109","6","2071","16.3","17"
"Franklin","2021-01-31","16","15125","4","2075","19","17.7"
"Franklin","2021-02-01","50","15175","11","2086","19.7","17.6"
"Franklin","2021-02-02","97","15272","5","2091","18.1","17"
"Franklin","2021-02-03","43","15315","11","2102","19.2","17.8"
"Franklin","2021-02-04","38","15353","8","2110","19.8","17.7"
"Franklin","2021-02-05","85","15438","0","2110","17.7","17"
"Franklin","2021-02-06","7","15445","2","2112","18.2","17.2"
"Franklin","2021-02-07","2","15447","0","2112","14.6","16.8"
"Franklin","2021-02-08","0","15447","0","2112","11.5","15.6"
"Fulton","2020-02-01","0","0","0","0",".","."
"Fulton","2020-02-02","0","0","0","0",".","."
"Fulton","2020-02-03","0","0","0","0",".","."
"Fulton","2020-02-04","0","0","0","0",".","."
"Fulton","2020-02-05","0","0","0","0",".","."
"Fulton","2020-02-06","0","0","0","0",".","."
"Fulton","2020-02-07","0","0","0","0","0","."
"Fulton","2020-02-08","0","0","0","0","0","."
"Fulton","2020-02-09","0","0","0","0","0","."
"Fulton","2020-02-10","0","0","0","0","0","."
"Fulton","2020-02-11","0","0","0","0","0","."
"Fulton","2020-02-12","0","0","0","0","0","."
"Fulton","2020-02-13","0","0","0","0","0","."
"Fulton","2020-02-14","0","0","0","0","0","0"
"Fulton","2020-02-15","0","0","0","0","0","0"
"Fulton","2020-02-16","0","0","0","0","0","0"
"Fulton","2020-02-17","0","0","0","0","0","0"
"Fulton","2020-02-18","0","0","0","0","0","0"
"Fulton","2020-02-19","0","0","0","0","0","0"
"Fulton","2020-02-20","0","0","0","0","0","0"
"Fulton","2020-02-21","0","0","0","0","0","0"
"Fulton","2020-02-22","0","0","0","0","0","0"
"Fulton","2020-02-23","0","0","0","0","0","0"
"Fulton","2020-02-24","0","0","0","0","0","0"
"Fulton","2020-02-25","0","0","0","0","0","0"
"Fulton","2020-02-26","0","0","0","0","0","0"
"Fulton","2020-02-27","1","1","0","0","0","0"
"Fulton","2020-02-28","0","1","0","0","0","0"
"Fulton","2020-02-29","1","2","0","0","0","0"
"Fulton","2020-03-01","0","2","0","0","0","0"
"Fulton","2020-03-02","0","2","0","0","0","0"
"Fulton","2020-03-03","3","5","2","2","9.5","4.8"
"Fulton","2020-03-04","8","13","0","2","9.5","4.8"
"Fulton","2020-03-05","9","22","4","6","15.9","7.9"
"Fulton","2020-03-06","3","25","0","6","15.9","7.9"
"Fulton","2020-03-07","5","30","0","6","15.9","7.9"
"Fulton","2020-03-08","5","35","0","6","15.9","7.9"
"Fulton","2020-03-09","109","144","2","8","16.1","8.1"
"Fulton","2020-03-10","70","214","9","17","8.4","9"
"Fulton","2020-03-11","70","284","13","30","11.1","10.3"
"Fulton","2020-03-12","78","362","8","38","6.2","11"
"Fulton","2020-03-13","106","468","24","62","9.5","12.7"
"Fulton","2020-03-14","34","502","11","73","14.1","15"
"Fulton","2020-03-15","46","548","16","89","19","17.5"
"Fulton","2020-03-16","204","752","46","135","22","19.1"
"Fulton","2020-03-17","270","1022","45","180","22.5","15.5"
"Fulton","2020-03-18","224","1246","54","234","23.3","17.2"
"Fulton","2020-03-19","251","1497","53","287","24.9","15.6"
"Fulton","2020-03-20","263","1760","71","358","25.5","17.5"
"Fulton","2020-03-21","75","1835","20","378","24.7","19.4"
"Fulton","2020-03-22","124","1959","27","405","22.8","20.9"
"Fulton","2020-03-23","363","2322","103","508","23.7","22.8"
"Fulton","2020-03-24","354","2676","95","603","25.1","23.8"
"Fulton","2020-03-25","379","3055","115","718","26","24.7"
"Fulton","2020-03-26","306","3361","76","794","26.5","25.7"
"Fulton","2020-03-27","311","3672","82","876","26.5","26"
"Fulton","2020-03-28","118","3790","36","912","27","25.9"
"Fulton","2020-03-29","120","3910","41","953","28.8","25.8"
"Fulton","2020-03-30","392","4302","101","1054","28.4","26"
"Fulton","2020-03-31","425","4727","111","1165","28.3","26.7"
"Fulton","2020-04-01","447","5174","113","1278","27.6","26.8"
"Fulton","2020-04-02","355","5529","67","1345","26.7","26.6"
"Fulton","2020-04-03","284","5813","87","1432","27.3","26.9"
"Fulton","2020-04-04","118","5931","25","1457","26","26.5"
"Fulton","2020-04-05","99","6030","17","1474","23.6","26.2"
"Fulton","2020-04-06","484","6514","73","1547","22","25.2"
"Fulton","2020-04-07","575","7089","106","1653","21","24.6"
"Fulton","2020-04-08","541","7630","83","1736","19.5","23.6"
"Fulton","2020-04-09","553","8183","77","1813","18.8","22.8"
"Fulton","2020-04-10","589","8772","70","1883","16.1","21.7"
"Fulton","2020-04-11","441","9213","51","1934","14.8","20.4"
"Fulton","2020-04-12","155","9368","32","1966","15.3","19.4"
"Fulton","2020-04-13","681","10049","67","2033","14.5","18.3"
"Fulton","2020-04-14","619","10668","64","2097","13.4","17.2"
"Fulton","2020-04-15","617","11285","42","2139","12.1","15.8"
"Fulton","2020-04-16","513","11798","66","2205","12","15.4"
"Fulton","2020-04-17","676","12474","81","2286","12","14.1"
"Fulton","2020-04-18","378","12852","41","2327","11.9","13.3"
"Fulton","2020-04-19","453","13305","210","2537","15.6","15.4"
"Fulton","2020-04-20","797","14102","56","2593","15.2","14.8"
"Fulton","2020-04-21","1650","15752","95","2688","14.5","13.9"
"Fulton","2020-04-22","1138","16890","90","2778","14.7","13.4"
"Fulton","2020-04-23","1010","17900","91","2869","14.1","13.1"
"Fulton","2020-04-24","1490","19390","71","2940","13.1","12.6"
"Fulton","2020-04-25","856","20246","34","2974","12.1","12"
"Fulton","2020-04-26","268","20514","46","3020","7.9","11.8"
"Fulton","2020-04-27","698","21212","52","3072","8","11.6"
"Fulton","2020-04-28","1783","22995","92","3164","7.9","11.2"
"Fulton","2020-04-29","2203","25198","179","3343","7.9","11.3"
"Fulton","2020-04-30","2023","27221","72","3415","7.2","10.6"
"Fulton","2020-05-01","2265","29486","167","3582","7.5","10.3"
"Fulton","2020-05-02","1032","30518","52","3634","7.7","9.9"
"Fulton","2020-05-03","754","31272","47","3681","6.1","7"
"Fulton","2020-05-04","2317","33589","228","3909","6.5","7.2"
"Fulton","2020-05-05","1858","35447","75","3984","6.3","7.1"
"Fulton","2020-05-06","2092","37539","82","4066","5.7","6.8"
"Fulton","2020-05-07","1409","38948","75","4141","6","6.6"
"Fulton","2020-05-08","1492","40440","39","4180","5.3","6.4"
"Fulton","2020-05-09","592","41032","37","4217","5.5","6.6"
"Fulton","2020-05-10","337","41369","29","4246","5.8","6"
"Fulton","2020-05-11","1608","42977","59","4305","4.9","5.7"
"Fulton","2020-05-12","1725","44702","90","4395","5.1","5.7"
"Fulton","2020-05-13","1566","46268","52","4447","5","5.4"
"Fulton","2020-05-14","1650","47918","116","4563","5.2","5.6"
"Fulton","2020-05-15","1931","49849","51","4614","5.2","5.3"
"Fulton","2020-05-16","873","50722","28","4642","4.8","5.1"
"Fulton","2020-05-17","480","51202","30","4672","4.5","5.1"
"Fulton","2020-05-18","1579","52781","71","4743","4.6","4.8"
"Fulton","2020-05-19","1665","54446","59","4802","4.4","4.7"
"Fulton","2020-05-20","2015","56461","58","4860","4.3","4.6"
"Fulton","2020-05-21","1330","57791","43","4903","3.8","4.5"
"Fulton","2020-05-22","1655","59446","60","4963","3.9","4.6"
"Fulton","2020-05-23","940","60386","40","5003","4","4.4"
"Fulton","2020-05-24","446","60832","31","5034","4.1","4.3"
"Fulton","2020-05-25","234","61066","15","5049","4.4","4.5"
"Fulton","2020-05-26","2565","63631","94","5143","4.4","4.4"
"Fulton","2020-05-27","2117","65748","73","5216","4.5","4.4"
"Fulton","2020-05-28","2056","67804","55","5271","4.4","4.1"
"Fulton","2020-05-29","1762","69566","51","5322","4.3","4.1"
"Fulton","2020-05-30","534","70100","9","5331","4","4"
"Fulton","2020-05-31","327","70427","15","5346","3.6","3.9"
"Fulton","2020-06-01","1283","71710","61","5407","3.4","3.9"
"Fulton","2020-06-02","1679","73389","63","5470","3.4","3.9"
"Fulton","2020-06-03","1888","75277","78","5548","3.5","4"
"Fulton","2020-06-04","1776","77053","47","5595","3.5","4"
"Fulton","2020-06-05","1731","78784","60","5655","3.6","4"
"Fulton","2020-06-06","1250","80034","60","5715","4","4"
"Fulton","2020-06-07","553","80587","27","5742","4.1","3.8"
"Fulton","2020-06-08","1673","82260","55","5797","3.9","3.6"
"Fulton","2020-06-09","2049","84309","71","5868","3.8","3.6"
"Fulton","2020-06-10","1965","86274","93","5961","3.9","3.7"
"Fulton","2020-06-11","2167","88441","80","6041","4","3.8"
"Fulton","2020-06-12","1896","90337","72","6113","4.1","3.8"
"Fulton","2020-06-13","1224","91561","60","6173","4.1","4.1"
"Fulton","2020-06-14","510","92071","29","6202","4.2","4.1"
"Fulton","2020-06-15","2480","94551","105","6307","4.4","4.1"
"Fulton","2020-06-16","2525","97076","169","6476","4.8","4.3"
"Fulton","2020-06-17","2302","99378","163","6639","5.2","4.5"
"Fulton","2020-06-18","2244","101622","186","6825","5.8","4.9"
"Fulton","2020-06-19","2563","104185","181","7006","6.3","5.2"
"Fulton","2020-06-20","1624","105809","139","7145","6.8","5.5"
"Fulton","2020-06-21","564","106373","73","7218","7.8","6"
"Fulton","2020-06-22","2897","109270","306","7524","8.7","6.5"
"Fulton","2020-06-23","3096","112366","309","7833","9.2","7"
"Fulton","2020-06-24","3104","115470","339","8172","9.8","7.5"
"Fulton","2020-06-25","3435","118905","415","8587","10.3","8.1"
"Fulton","2020-06-26","5277","124182","557","9144","10.8","8.5"
"Fulton","2020-06-27","2535","126717","302","9446","11.3","9"
"Fulton","2020-06-28","1256","127973","207","9653","11.8","9.8"
"Fulton","2020-06-29","5342","133315","623","10276","11.9","10.3"
"Fulton","2020-06-30","5378","138693","632","10908","12.2","10.7"
"Fulton","2020-07-01","5169","143862","613","11521","12.3","11"
"Fulton","2020-07-02","5606","149468","707","12228","12.4","11.4"
"Fulton","2020-07-03","2375","151843","290","12518","12.6","11.7"
"Fulton","2020-07-04","531","152374","75","12593","13","12.1"
"Fulton","2020-07-05","600","152974","129","12722","13.7","12.7"
"Fulton","2020-07-06","6164","159138","836","13558","13.9","12.9"
"Fulton","2020-07-07","6087","165225","787","14345","14.1","13.2"
"Fulton","2020-07-08","5665","170890","745","15090","14.3","13.3"
"Fulton","2020-07-09","4724","175614","628","15718","14.4","13.4"
"Fulton","2020-07-10","4766","180380","680","16398","14.7","13.7"
"Fulton","2020-07-11","2256","182636","356","16754","14.9","13.9"
"Fulton","2020-07-12","1902","184538","248","17002","13.7","13.7"
"Fulton","2020-07-13","6755","191293","947","17949","13.8","13.9"
"Fulton","2020-07-14","5566","196859","733","18682","13.8","14"
"Fulton","2020-07-15","5427","202286","708","19390","13.8","14.1"
"Fulton","2020-07-16","6415","208701","888","20278","13.9","14.1"
"Fulton","2020-07-17","5752","214453","618","20896","13.4","14"
"Fulton","2020-07-18","2746","217199","361","21257","13","14"
"Fulton","2020-07-19","845","218044","96","21353","12.8","13.2"
"Fulton","2020-07-20","5881","223925","754","22107","12.6","13.2"
"Fulton","2020-07-21","4951","228876","647","22754","12.6","13.2"
"Fulton","2020-07-22","5356","234232","758","23512","12.7","13.3"
"Fulton","2020-07-23","5718","239950","599","24111","12.3","13.1"
"Fulton","2020-07-24","5099","245049","669","24780","12.6","13"
"Fulton","2020-07-25","2183","247232","271","25051","12.5","12.7"
"Fulton","2020-07-26","695","247927","55","25106","12","12.4"
"Fulton","2020-07-27","5291","253218","513","25619","11.5","12.1"
"Fulton","2020-07-28","4660","257878","504","26123","11.2","11.9"
"Fulton","2020-07-29","4732","262610","556","26679","10.9","11.8"
"Fulton","2020-07-30","4518","267128","495","27174","11","11.6"
"Fulton","2020-07-31","4292","271420","457","27631","10.6","11.6"
"Fulton","2020-08-01","2000","273420","240","27871","10.5","11.5"
"Fulton","2020-08-02","658","274078","66","27937","10.8","11.4"
"Fulton","2020-08-03","4360","278438","412","28349","10.8","11.2"
"Fulton","2020-08-04","4546","282984","408","28757","10.5","10.9"
"Fulton","2020-08-05","4740","287724","439","29196","10.2","10.5"
"Fulton","2020-08-06","4457","292181","379","29575","9.8","10.4"
"Fulton","2020-08-07","4185","296366","307","29882","9.4","10"
"Fulton","2020-08-08","2079","298445","166","30048","8.8","9.7"
"Fulton","2020-08-09","779","299224","71","30119","8.7","9.8"
"Fulton","2020-08-10","4110","303334","292","30411","8.3","9.6"
"Fulton","2020-08-11","3277","306611","196","30607","7.9","9.2"
"Fulton","2020-08-12","2897","309508","173","30780","7.4","8.8"
"Fulton","2020-08-13","2988","312496","155","30935","7","8.4"
"Fulton","2020-08-14","4119","316615","194","31129","6.6","8"
"Fulton","2020-08-15","1820","318435","109","31238","6.3","7.5"
"Fulton","2020-08-16","1413","319848","121","31359","6.2","7.4"
"Fulton","2020-08-17","2905","322753","197","31556","6.2","7.2"
"Fulton","2020-08-18","3111","325864","155","31711","6","7"
"Fulton","2020-08-19","3594","329458","190","31901","5.9","6.7"
"Fulton","2020-08-20","2808","332266","158","32059","6","6.5"
"Fulton","2020-08-21","3238","335504","172","32231","6.1","6.3"
"Fulton","2020-08-22","1637","337141","95","32326","6.1","6.2"
"Fulton","2020-08-23","773","337914","65","32391","6","6.1"
"Fulton","2020-08-24","3233","341147","178","32569","5.8","6"
"Fulton","2020-08-25","2900","344047","173","32742","6","6"
"Fulton","2020-08-26","2778","346825","163","32905","6.1","6"
"Fulton","2020-08-27","3274","350099","142","33047","5.9","5.9"
"Fulton","2020-08-28","2947","353046","142","33189","5.8","5.9"
"Fulton","2020-08-29","2021","355067","105","33294","5.7","5.9"
"Fulton","2020-08-30","682","355749","51","33345","5.6","5.8"
"Fulton","2020-08-31","2960","358709","155","33500","5.6","5.7"
"Fulton","2020-09-01","3538","362247","145","33645","5.3","5.6"
"Fulton","2020-09-02","3610","365857","170","33815","5.1","5.6"
"Fulton","2020-09-03","3374","369231","164","33979","5.2","5.5"
"Fulton","2020-09-04","2988","372219","137","34116","5.2","5.5"
"Fulton","2020-09-05","1194","373413","71","34187","5.3","5.5"
"Fulton","2020-09-06","674","374087","47","34234","5.2","5.4"
"Fulton","2020-09-07","732","374819","40","34274","5.2","5.4"
"Fulton","2020-09-08","3725","378544","179","34453","5.3","5.3"
"Fulton","2020-09-09","3562","382106","162","34615","5.3","5.2"
"Fulton","2020-09-10","3416","385522","130","34745","5.2","5.2"
"Fulton","2020-09-11","3185","388707","123","34868","5.1","5.1"
"Fulton","2020-09-12","1571","390278","62","34930","4.8","5"
"Fulton","2020-09-13","753","391031","60","34990","4.9","5.1"
"Fulton","2020-09-14","3451","394482","160","35150","4.8","5"
"Fulton","2020-09-15","3146","397628","124","35274","4.7","5"
"Fulton","2020-09-16","3276","400904","115","35389","4.5","4.9"
"Fulton","2020-09-17","2507","403411","90","35479","4.5","4.8"
"Fulton","2020-09-18","3006","406417","104","35583","4.4","4.7"
"Fulton","2020-09-19","1553","407970","63","35646","4.5","4.6"
"Fulton","2020-09-20","501","408471","29","35675","4.1","4.5"
"Fulton","2020-09-21","3286","411757","129","35804","4","4.4"
"Fulton","2020-09-22","2900","414657","97","35901","4","4.3"
"Fulton","2020-09-23","3381","418038","93","35994","3.8","4.2"
"Fulton","2020-09-24","3044","421082","101","36095","3.8","4.1"
"Fulton","2020-09-25","3057","424139","107","36202","3.8","4.1"
"Fulton","2020-09-26","1363","425502","56","36258","3.8","4.1"
"Fulton","2020-09-27","548","426050","21","36279","3.5","3.8"
"Fulton","2020-09-28","3133","429183","108","36387","3.5","3.8"
"Fulton","2020-09-29","3146","432329","89","36476","3.4","3.7"
"Fulton","2020-09-30","3445","435774","125","36601","3.5","3.7"
"Fulton","2020-10-01","3527","439301","79","36680","3.4","3.6"
"Fulton","2020-10-02","3334","442635","115","36795","3.4","3.6"
"Fulton","2020-10-03","1796","444431","66","36861","3.3","3.6"
"Fulton","2020-10-04","761","445192","38","36899","3.5","3.5"
"Fulton","2020-10-05","3925","449117","143","37042","3.5","3.5"
"Fulton","2020-10-06","3985","453102","107","37149","3.5","3.4"
"Fulton","2020-10-07","4237","457339","129","37278","3.4","3.5"
"Fulton","2020-10-08","3664","461003","111","37389","3.5","3.4"
"Fulton","2020-10-09","3644","464647","134","37523","3.5","3.4"
"Fulton","2020-10-10","1792","466439","58","37581","3.5","3.4"
"Fulton","2020-10-11","671","467110","46","37627","3.7","3.6"
"Fulton","2020-10-12","2452","469562","102","37729","3.8","3.7"
"Fulton","2020-10-13","3846","473408","163","37892","4","3.8"
"Fulton","2020-10-14","3505","476913","137","38029","4.2","3.8"
"Fulton","2020-10-15","3396","480309","137","38166","4.3","3.9"
"Fulton","2020-10-16","3346","483655","167","38333","4.5","4"
"Fulton","2020-10-17","1616","485271","86","38419","4.8","4.1"
"Fulton","2020-10-18","709","485980","39","38458","4.6","4.2"
"Fulton","2020-10-19","3939","489919","184","38642","4.7","4.2"
"Fulton","2020-10-20","3729","493648","181","38823","4.8","4.4"
"Fulton","2020-10-21","4376","498024","194","39017","4.8","4.5"
"Fulton","2020-10-22","3615","501639","190","39207","5","4.7"
"Fulton","2020-10-23","3830","505469","194","39401","5","4.8"
"Fulton","2020-10-24","1983","507452","110","39511","5","4.9"
"Fulton","2020-10-25","1382","508834","81","39592","5.1","4.8"
"Fulton","2020-10-26","4156","512990","216","39808","5.2","4.9"
"Fulton","2020-10-27","4389","517379","151","39959","5","4.9"
"Fulton","2020-10-28","4297","521676","192","40151","5","4.9"
"Fulton","2020-10-29","3109","524785","145","40296","4.9","4.9"
"Fulton","2020-10-30","3823","528608","186","40482","4.9","4.9"
"Fulton","2020-10-31","1956","530564","117","40599","4.9","5"
"Fulton","2020-11-01","1133","531697","93","40692","5.3","5.2"
"Fulton","2020-11-02","4446","536143","243","40935","5.3","5.2"
"Fulton","2020-11-03","4151","540294","206","41141","5.5","5.2"
"Fulton","2020-11-04","4043","544337","224","41365","5.7","5.3"
"Fulton","2020-11-05","4380","548717","235","41600","5.8","5.3"
"Fulton","2020-11-06","4240","552957","218","41818","5.8","5.3"
"Fulton","2020-11-07","2430","555387","190","42008","6.1","5.5"
"Fulton","2020-11-08","1145","556532","115","42123","6.3","5.8"
"Fulton","2020-11-09","4876","561408","317","42440","6.5","5.9"
"Fulton","2020-11-10","5069","566477","280","42720","6.6","6"
"Fulton","2020-11-11","4350","570827","284","43004","6.7","6.2"
"Fulton","2020-11-12","5189","576016","281","43285","6.7","6.2"
"Fulton","2020-11-13","5797","581813","323","43608","6.8","6.3"
"Fulton","2020-11-14","3040","584853","201","43809","6.6","6.3"
"Fulton","2020-11-15","1289","586142","119","43928","6.5","6.4"
"Fulton","2020-11-16","5915","592057","346","44274","6.4","6.4"
"Fulton","2020-11-17","6414","598471","323","44597","6.3","6.4"
"Fulton","2020-11-18","7588","606059","329","44926","6","6.4"
"Fulton","2020-11-19","7458","613517","360","45286","5.9","6.3"
"Fulton","2020-11-20","7748","621265","346","45632","5.8","6.3"
"Fulton","2020-11-21","4520","625785","227","45859","5.5","6.1"
"Fulton","2020-11-22","1862","627647","107","45966","5","5.8"
"Fulton","2020-11-23","8220","635867","395","46361","4.9","5.6"
"Fulton","2020-11-24","7391","643258","405","46766","5","5.6"
"Fulton","2020-11-25","5835","649093","416","47182","5.4","5.7"
"Fulton","2020-11-26","798","649891","54","47236","5.6","5.8"
"Fulton","2020-11-27","2624","652515","265","47501","6.4","6.1"
"Fulton","2020-11-28","2298","654813","239","47740","7.2","6.4"
"Fulton","2020-11-29","2078","656891","204","47944","7.8","6.4"
"Fulton","2020-11-30","6509","663400","598","48542","8.4","6.7"
"Fulton","2020-12-01","6023","669423","476","49018","8.8","6.9"
"Fulton","2020-12-02","5839","675262","506","49524","9","7.2"
"Fulton","2020-12-03","5880","681142","530","50054","9.3","7.5"
"Fulton","2020-12-04","5814","686956","483","50537","9","7.7"
"Fulton","2020-12-05","3320","690276","301","50838","8.9","8"
"Fulton","2020-12-06","1376","691652","158","50996","9.1","8.4"
"Fulton","2020-12-07","6131","697783","604","51600","9.2","8.8"
"Fulton","2020-12-08","6102","703885","525","52125","9.3","9"
"Fulton","2020-12-09","6405","710290","561","52686","9.3","9.1"
"Fulton","2020-12-10","6010","716300","564","53250","9.4","9.3"
"Fulton","2020-12-11","6336","722636","562","53812","9.4","9.2"
"Fulton","2020-12-12","3485","726121","335","54147","9.5","9.2"
"Fulton","2020-12-13","1526","727647","185","54332","9.6","9.3"
"Fulton","2020-12-14","7831","735478","870","55202","9.8","9.5"
"Fulton","2020-12-15","7895","743373","725","55927","9.9","9.6"
"Fulton","2020-12-16","7867","751240","716","56643","9.9","9.6"
"Fulton","2020-12-17","8046","759286","772","57415","9.9","9.6"
"Fulton","2020-12-18","8071","767357","736","58151","10","9.7"
"Fulton","2020-12-19","4657","772014","429","58580","9.9","9.7"
"Fulton","2020-12-20","2066","774080","221","58801","9.7","9.7"
"Fulton","2020-12-21","9932","784012","954","59755","9.5","9.6"
"Fulton","2020-12-22","8576","792588","873","60628","9.6","9.8"
"Fulton","2020-12-23","7241","799829","709","61337","9.7","9.8"
"Fulton","2020-12-24","2655","802484","331","61668","10.2","10"
"Fulton","2020-12-25","612","803096","96","61764","11.1","10.5"
"Fulton","2020-12-26","2835","805931","439","62203","12","11"
"Fulton","2020-12-27","1864","807795","316","62519","12.9","11.3"
"Fulton","2020-12-28","8508","816303","1151","63670","13.4","11.5"
"Fulton","2020-12-29","7168","823471","938","64608","13.9","11.8"
"Fulton","2020-12-30","6878","830349","885","65493","14.3","12"
"Fulton","2020-12-31","3456","833805","438","65931","14.3","12.2"
"Fulton","2021-01-01","684","834489","110","66041","14.4","12.7"
"Fulton","2021-01-02","3395","837884","574","66615","14.6","13.3"
"Fulton","2021-01-03","1302","839186","219","66834","14.6","13.7"
"Fulton","2021-01-04","7849","847035","1266","68100","14.9","14.2"
"Fulton","2021-01-05","9336","856371","1342","69442","15.1","14.5"
"Fulton","2021-01-06","7466","863837","967","70409","15.1","14.7"
"Fulton","2021-01-07","7200","871037","1047","71456","15.4","14.9"
"Fulton","2021-01-08","6153","877190","768","72224","14.9","14.6"
"Fulton","2021-01-09","3795","880985","543","72767","14.5","14.6"
"Fulton","2021-01-10","1660","882645","291","73058","14.6","14.6"
"Fulton","2021-01-11","7130","889775","933","73991","14.2","14.6"
"Fulton","2021-01-12","7516","897291","846","74837","13.7","14.4"
"Fulton","2021-01-13","6858","904149","811","75648","13.6","14.4"
"Fulton","2021-01-14","6156","910305","802","76450","13.4","14.4"
"Fulton","2021-01-15","6303","916608","720","77170","13.2","14"
"Fulton","2021-01-16","3683","920291","491","77661","13.1","13.8"
"Fulton","2021-01-17","1715","922006","258","77919","12.7","13.7"
"Fulton","2021-01-18","4278","926284","490","78409","12.5","13.3"
"Fulton","2021-01-19","7157","933441","767","79176","12.4","13.1"
"Fulton","2021-01-20","6778","940219","752","79928","12.3","12.9"
"Fulton","2021-01-21","5797","946016","645","80573","12","12.7"
"Fulton","2021-01-22","5966","951982","652","81225","12","12.6"
"Fulton","2021-01-23","3136","955118","398","81623","11.9","12.5"
"Fulton","2021-01-24","1628","956746","242","81865","11.8","12.3"
"Fulton","2021-01-25","6862","963608","751","82616","11.8","12.1"
"Fulton","2021-01-26","6556","970164","654","83270","11.7","12"
"Fulton","2021-01-27","5888","976052","531","83801","11.4","11.8"
"Fulton","2021-01-28","5304","981356","519","84320","11.2","11.6"
"Fulton","2021-01-29","5541","986897","477","84797","10.8","11.4"
"Fulton","2021-01-30","2681","989578","281","85078","10.5","11.2"
"Fulton","2021-01-31","1450","991028","164","85242","10","10.9"
"Fulton","2021-02-01","5787","996815","548","85790","9.8","10.8"
"Fulton","2021-02-02","5564","1002379","403","86193","9.4","10.5"
"Fulton","2021-02-03","5343","1007722","358","86551","9.1","10.2"
"Fulton","2021-02-04","3897","1011619","320","86871","8.9","10"
"Fulton","2021-02-05","3096","1014715","270","87141","8.9","9.9"
"Fulton","2021-02-06","759","1015474","85","87226","9","9.8"
"Fulton","2021-02-07","93","1015567","20","87246","10.4","10.2"
"Fulton","2021-02-08","0","1015567","0","87246","9.1","9.4"
"Gilmer","2020-02-01","0","0","0","0",".","."
"Gilmer","2020-02-02","0","0","0","0",".","."
"Gilmer","2020-02-03","0","0","0","0",".","."
"Gilmer","2020-02-04","0","0","0","0",".","."
"Gilmer","2020-02-05","0","0","0","0",".","."
"Gilmer","2020-02-06","0","0","0","0",".","."
"Gilmer","2020-02-07","0","0","0","0","0","."
"Gilmer","2020-02-08","0","0","0","0","0","."
"Gilmer","2020-02-09","0","0","0","0","0","."
"Gilmer","2020-02-10","0","0","0","0","0","."
"Gilmer","2020-02-11","0","0","0","0","0","."
"Gilmer","2020-02-12","0","0","0","0","0","."
"Gilmer","2020-02-13","0","0","0","0","0","."
"Gilmer","2020-02-14","0","0","0","0","0","0"
"Gilmer","2020-02-15","0","0","0","0","0","0"
"Gilmer","2020-02-16","0","0","0","0","0","0"
"Gilmer","2020-02-17","0","0","0","0","0","0"
"Gilmer","2020-02-18","0","0","0","0","0","0"
"Gilmer","2020-02-19","0","0","0","0","0","0"
"Gilmer","2020-02-20","0","0","0","0","0","0"
"Gilmer","2020-02-21","0","0","0","0","0","0"
"Gilmer","2020-02-22","0","0","0","0","0","0"
"Gilmer","2020-02-23","0","0","0","0","0","0"
"Gilmer","2020-02-24","0","0","0","0","0","0"
"Gilmer","2020-02-25","0","0","0","0","0","0"
"Gilmer","2020-02-26","0","0","0","0","0","0"
"Gilmer","2020-02-27","0","0","0","0","0","0"
"Gilmer","2020-02-28","0","0","0","0","0","0"
"Gilmer","2020-02-29","0","0","0","0","0","0"
"Gilmer","2020-03-01","0","0","0","0","0","0"
"Gilmer","2020-03-02","0","0","0","0","0","0"
"Gilmer","2020-03-03","0","0","0","0","0","0"
"Gilmer","2020-03-04","0","0","0","0","0","0"
"Gilmer","2020-03-05","0","0","0","0","0","0"
"Gilmer","2020-03-06","0","0","0","0","0","0"
"Gilmer","2020-03-07","0","0","0","0","0","0"
"Gilmer","2020-03-08","0","0","0","0","0","0"
"Gilmer","2020-03-09","0","0","0","0","0","0"
"Gilmer","2020-03-10","0","0","0","0","0","0"
"Gilmer","2020-03-11","0","0","0","0","0","0"
"Gilmer","2020-03-12","0","0","0","0","0","0"
"Gilmer","2020-03-13","1","1","0","0","0","0"
"Gilmer","2020-03-14","0","1","0","0","0","0"
"Gilmer","2020-03-15","0","1","0","0","0","0"
"Gilmer","2020-03-16","0","1","0","0","0","0"
"Gilmer","2020-03-17","0","1","0","0","0","0"
"Gilmer","2020-03-18","2","3","0","0","0","0"
"Gilmer","2020-03-19","4","7","1","1","3.6","1.8"
"Gilmer","2020-03-20","7","14","0","1","3.6","1.8"
"Gilmer","2020-03-21","2","16","0","1","3.6","1.8"
"Gilmer","2020-03-22","1","17","0","1","3.6","1.8"
"Gilmer","2020-03-23","3","20","0","1","3.6","1.8"
"Gilmer","2020-03-24","4","24","0","1","3.6","1.8"
"Gilmer","2020-03-25","4","28","0","1","3.6","1.8"
"Gilmer","2020-03-26","2","30","0","1","0","1.8"
"Gilmer","2020-03-27","7","37","0","1","0","1.8"
"Gilmer","2020-03-28","2","39","0","1","0","1.8"
"Gilmer","2020-03-29","0","39","0","1","0","1.8"
"Gilmer","2020-03-30","5","44","0","1","0","1.8"
"Gilmer","2020-03-31","4","48","0","1","0","1.8"
"Gilmer","2020-04-01","2","50","0","1","0","1.8"
"Gilmer","2020-04-02","2","52","0","1","0","0"
"Gilmer","2020-04-03","5","57","0","1","0","0"
"Gilmer","2020-04-04","0","57","0","1","0","0"
"Gilmer","2020-04-05","3","60","0","1","0","0"
"Gilmer","2020-04-06","5","65","0","1","0","0"
"Gilmer","2020-04-07","6","71","2","3","4.8","2.4"
"Gilmer","2020-04-08","9","80","1","4","6.3","3.2"
"Gilmer","2020-04-09","7","87","2","6","10.4","5.2"
"Gilmer","2020-04-10","6","93","2","8","15.2","7.6"
"Gilmer","2020-04-11","4","97","0","8","15.2","7.6"
"Gilmer","2020-04-12","0","97","0","8","15.2","7.6"
"Gilmer","2020-04-13","6","103","0","8","15.2","7.6"
"Gilmer","2020-04-14","8","111","1","9","12.2","8.5"
"Gilmer","2020-04-15","5","116","0","9","10.6","8.5"
"Gilmer","2020-04-16","8","124","0","9","6.5","8.5"
"Gilmer","2020-04-17","10","134","3","12","6.1","10.6"
"Gilmer","2020-04-18","7","141","1","13","8.1","11.7"
"Gilmer","2020-04-19","3","144","2","15","17.6","16.4"
"Gilmer","2020-04-20","8","152","0","15","17.6","16.4"
"Gilmer","2020-04-21","17","169","2","17","17.5","14.9"
"Gilmer","2020-04-22","10","179","2","19","20.4","15.5"
"Gilmer","2020-04-23","13","192","2","21","22.6","14.6"
"Gilmer","2020-04-24","24","216","0","21","18.3","12.2"
"Gilmer","2020-04-25","8","224","3","24","21.6","14.9"
"Gilmer","2020-04-26","12","236","0","24","12.1","14.9"
"Gilmer","2020-04-27","9","245","2","26","15.3","16.5"
"Gilmer","2020-04-28","16","261","3","29","16.3","16.9"
"Gilmer","2020-04-29","19","280","3","32","15.7","18"
"Gilmer","2020-04-30","13","293","2","34","15.7","19.1"
"Gilmer","2020-05-01","13","306","0","34","15.7","17"
"Gilmer","2020-05-02","5","311","0","34","10.3","16"
"Gilmer","2020-05-03","13","324","0","34","10.3","11.2"
"Gilmer","2020-05-04","11","335","0","34","7.1","11.2"
"Gilmer","2020-05-05","21","356","1","35","5.1","10.7"
"Gilmer","2020-05-06","39","395","6","41","5.1","10.4"
"Gilmer","2020-05-07","40","435","3","44","3.9","9.8"
"Gilmer","2020-05-08","42","477","2","46","4.6","10.1"
"Gilmer","2020-05-09","1","478","0","46","4.6","7.5"
"Gilmer","2020-05-10","15","493","0","46","4.6","7.5"
"Gilmer","2020-05-11","62","555","3","49","5.3","6.2"
"Gilmer","2020-05-12","61","616","5","54","5.8","5.5"
"Gilmer","2020-05-13","34","650","2","56","4.5","4.8"
"Gilmer","2020-05-14","31","681","3","59","4.8","4.4"
"Gilmer","2020-05-15","38","719","1","60","4.5","4.5"
"Gilmer","2020-05-16","5","724","1","61","7.3","6"
"Gilmer","2020-05-17","12","736","1","62","8.5","6.6"
"Gilmer","2020-05-18","27","763","0","62","7.8","6.6"
"Gilmer","2020-05-19","40","803","6","68","8.8","7.3"
"Gilmer","2020-05-20","51","854","4","72","9.1","6.8"
"Gilmer","2020-05-21","67","921","7","79","9.2","7"
"Gilmer","2020-05-22","40","961","2","81","9.5","7"
"Gilmer","2020-05-23","13","974","1","82","7.8","7.5"
"Gilmer","2020-05-24","5","979","1","83","9.4","9"
"Gilmer","2020-05-25","7","986","0","83","9.4","8.6"
"Gilmer","2020-05-26","59","1045","3","86","8","8.4"
"Gilmer","2020-05-27","61","1106","2","88","7.4","8.2"
"Gilmer","2020-05-28","56","1162","2","90","6.4","7.8"
"Gilmer","2020-05-29","24","1186","0","90","5.7","7.6"
"Gilmer","2020-05-30","12","1198","2","92","6.9","7.4"
"Gilmer","2020-05-31","13","1211","0","92","4.1","6.8"
"Gilmer","2020-06-01","41","1252","0","92","4.1","6.8"
"Gilmer","2020-06-02","38","1290","3","95","4.5","6.2"
"Gilmer","2020-06-03","48","1338","3","98","4.9","6.1"
"Gilmer","2020-06-04","47","1385","1","99","4.7","5.5"
"Gilmer","2020-06-05","20","1405","0","99","4.7","5.2"
"Gilmer","2020-06-06","8","1413","1","100","4.1","5.5"
"Gilmer","2020-06-07","8","1421","0","100","4.1","4.1"
"Gilmer","2020-06-08","35","1456","3","103","5.3","4.7"
"Gilmer","2020-06-09","30","1486","0","103","4.2","4.3"
"Gilmer","2020-06-10","23","1509","1","104","3.9","4.4"
"Gilmer","2020-06-11","26","1535","2","106","4.7","4.7"
"Gilmer","2020-06-12","69","1604","1","107","4.9","4.8"
"Gilmer","2020-06-13","11","1615","0","107","3.2","3.6"
"Gilmer","2020-06-14","12","1627","0","107","3.2","3.6"
"Gilmer","2020-06-15","22","1649","0","107","1.9","3.6"
"Gilmer","2020-06-16","24","1673","1","108","2.5","3.4"
"Gilmer","2020-06-17","27","1700","0","108","1.9","2.9"
"Gilmer","2020-06-18","19","1719","0","108","0.8","2.8"
"Gilmer","2020-06-19","29","1748","3","111","2.1","3.5"
"Gilmer","2020-06-20","5","1753","0","111","2.1","2.6"
"Gilmer","2020-06-21","8","1761","0","111","2.1","2.6"
"Gilmer","2020-06-22","28","1789","0","111","2.1","2"
"Gilmer","2020-06-23","18","1807","0","111","1.5","2"
"Gilmer","2020-06-24","32","1839","0","111","1.5","1.7"
"Gilmer","2020-06-25","24","1863","0","111","1.5","1.1"
"Gilmer","2020-06-26","26","1889","0","111","0","1"
"Gilmer","2020-06-27","9","1898","0","111","0","1"
"Gilmer","2020-06-28","9","1907","1","112","1.6","1.8"
"Gilmer","2020-06-29","48","1955","3","115","2.5","2.3"
"Gilmer","2020-06-30","23","1978","2","117","3.7","2.6"
"Gilmer","2020-07-01","31","2009","0","117","3.7","2.6"
"Gilmer","2020-07-02","31","2040","4","121","5.6","3.5"
"Gilmer","2020-07-03","12","2052","0","121","5.6","2.8"
"Gilmer","2020-07-04","8","2060","0","121","5.6","2.8"
"Gilmer","2020-07-05","10","2070","0","121","4","2.8"
"Gilmer","2020-07-06","38","2108","6","127","5.3","3.9"
"Gilmer","2020-07-07","41","2149","9","136","7.2","5.5"
"Gilmer","2020-07-08","54","2203","8","144","9.4","6.5"
"Gilmer","2020-07-09","33","2236","6","150","10.1","7.8"
"Gilmer","2020-07-10","45","2281","2","152","10.7","8.2"
"Gilmer","2020-07-11","7","2288","2","154","14.8","10.2"
"Gilmer","2020-07-12","16","2304","4","158","18.4","11.2"
"Gilmer","2020-07-13","40","2344","6","164","18.3","11.8"
"Gilmer","2020-07-14","49","2393","8","172","17.5","12.4"
"Gilmer","2020-07-15","30","2423","4","176","17.3","13.3"
"Gilmer","2020-07-16","38","2461","6","182","16.9","13.5"
"Gilmer","2020-07-17","53","2514","11","193","19.3","15"
"Gilmer","2020-07-18","17","2531","10","203","23.6","19.2"
"Gilmer","2020-07-19","7","2538","1","204","22","20.2"
"Gilmer","2020-07-20","55","2593","12","216","23","20.6"
"Gilmer","2020-07-21","41","2634","14","230","25.6","21.5"
"Gilmer","2020-07-22","23","2657","4","234","26.1","21.7"
"Gilmer","2020-07-23","42","2699","2","236","24.6","20.7"
"Gilmer","2020-07-24","36","2735","5","241","23.6","21.4"
"Gilmer","2020-07-25","15","2750","1","242","16.1","19.9"
"Gilmer","2020-07-26","13","2763","5","247","19.6","20.8"
"Gilmer","2020-07-27","54","2817","3","250","17.3","20.1"
"Gilmer","2020-07-28","31","2848","6","256","15.2","20.4"
"Gilmer","2020-07-29","22","2870","3","259","14.6","20.4"
"Gilmer","2020-07-30","51","2921","6","265","15.6","20.1"
"Gilmer","2020-07-31","33","2954","5","270","15.8","19.7"
"Gilmer","2020-08-01","19","2973","6","276","19.4","17.7"
"Gilmer","2020-08-02","32","3005","4","280","15.6","17.6"
"Gilmer","2020-08-03","82","3087","3","283","15.4","16.3"
"Gilmer","2020-08-04","27","3114","4","287","14.7","14.9"
"Gilmer","2020-08-05","37","3151","1","288","13.2","13.9"
"Gilmer","2020-08-06","29","3180","6","294","14.4","15"
"Gilmer","2020-08-07","25","3205","2","296","13.4","14.6"
"Gilmer","2020-08-08","10","3215","2","298","11.8","15.6"
"Gilmer","2020-08-09","24","3239","2","300","11.2","13.4"
"Gilmer","2020-08-10","45","3284","7","307","12.9","14.1"
"Gilmer","2020-08-11","35","3319","3","310","12","13.4"
"Gilmer","2020-08-12","128","3447","10","320","12.7","12.9"
"Gilmer","2020-08-13","40","3487","4","324","11.2","12.8"
"Gilmer","2020-08-14","58","3545","2","326","10.5","12"
"Gilmer","2020-08-15","7","3552","0","326","7.7","9.7"
"Gilmer","2020-08-16","8","3560","1","327","8.3","9.7"
"Gilmer","2020-08-17","45","3605","2","329","6.7","9.8"
"Gilmer","2020-08-18","18","3623","4","333","8.6","10.3"
"Gilmer","2020-08-19","29","3652","3","336","9","10.9"
"Gilmer","2020-08-20","38","3690","1","337","7.9","9.6"
"Gilmer","2020-08-21","17","3707","2","339","9.1","9.8"
"Gilmer","2020-08-22","11","3718","3","342","13","10.4"
"Gilmer","2020-08-23","36","3754","2","344","12","10.2"
"Gilmer","2020-08-24","61","3815","2","346","11.9","9.3"
"Gilmer","2020-08-25","39","3854","2","348","9.4","9"
"Gilmer","2020-08-26","25","3879","2","350","9.1","9"
"Gilmer","2020-08-27","24","3903","0","350","8.7","8.3"
"Gilmer","2020-08-28","35","3938","0","350","7","8.1"
"Gilmer","2020-08-29","9","3947","1","351","4.7","8.9"
"Gilmer","2020-08-30","36","3983","0","351","3.9","8"
"Gilmer","2020-08-31","56","4039","3","354","4.2","8"
"Gilmer","2020-09-01","38","4077","3","357","4.6","7"
"Gilmer","2020-09-02","15","4092","2","359","5.4","7.2"
"Gilmer","2020-09-03","66","4158","1","360","5.6","7.2"
"Gilmer","2020-09-04","56","4214","2","362","6.1","6.6"
"Gilmer","2020-09-05","17","4231","0","362","4.5","4.6"
"Gilmer","2020-09-06","11","4242","0","362","4.5","4.2"
"Gilmer","2020-09-07","13","4255","0","362","3.8","4"
"Gilmer","2020-09-08","67","4322","3","365","3.3","3.9"
"Gilmer","2020-09-09","36","4358","1","366","1.8","3.6"
"Gilmer","2020-09-10","36","4394","3","369","2.7","4.2"
"Gilmer","2020-09-11","50","4444","0","369","2.2","4.2"
"Gilmer","2020-09-12","2","4446","0","369","2.2","3.4"
"Gilmer","2020-09-13","11","4457","1","370","3.5","4"
"Gilmer","2020-09-14","69","4526","1","371","3.7","3.7"
"Gilmer","2020-09-15","34","4560","1","372","3.5","3.4"
"Gilmer","2020-09-16","35","4595","0","372","3.1","2.4"
"Gilmer","2020-09-17","27","4622","2","374","3","2.9"
"Gilmer","2020-09-18","59","4681","2","376","3.5","2.8"
"Gilmer","2020-09-19","52","4733","0","376","3.5","2.8"
"Gilmer","2020-09-20","14","4747","0","376","2.2","2.8"
"Gilmer","2020-09-21","36","4783","3","379","3.2","3.4"
"Gilmer","2020-09-22","29","4812","0","379","2.7","3.1"
"Gilmer","2020-09-23","30","4842","1","380","3.2","3.2"
"Gilmer","2020-09-24","40","4882","1","381","2.5","2.7"
"Gilmer","2020-09-25","23","4905","1","382","2.6","3.1"
"Gilmer","2020-09-26","10","4915","1","383","4.1","3.8"
"Gilmer","2020-09-27","8","4923","0","383","4.1","3.1"
"Gilmer","2020-09-28","37","4960","3","386","4","3.6"
"Gilmer","2020-09-29","25","4985","1","387","4.6","3.7"
"Gilmer","2020-09-30","32","5017","1","388","4.6","3.9"
"Gilmer","2020-10-01","36","5053","1","389","4.6","3.6"
"Gilmer","2020-10-02","107","5160","7","396","4.9","3.8"
"Gilmer","2020-10-03","32","5192","4","400","5.3","4.7"
"Gilmer","2020-10-04","41","5233","8","408","8.1","6.1"
"Gilmer","2020-10-05","48","5281","3","411","7.8","5.9"
"Gilmer","2020-10-06","36","5317","4","415","8.8","6.7"
"Gilmer","2020-10-07","82","5399","9","424","10","7.3"
"Gilmer","2020-10-08","91","5490","8","432","10.8","7.7"
"Gilmer","2020-10-09","55","5545","3","435","10.7","7.8"
"Gilmer","2020-10-10","12","5557","2","437","11.3","8.3"
"Gilmer","2020-10-11","10","5567","1","438","9.9","9"
"Gilmer","2020-10-12","49","5616","3","441","9.9","8.8"
"Gilmer","2020-10-13","76","5692","4","445","9","8.9"
"Gilmer","2020-10-14","40","5732","8","453","10.3","10.1"
"Gilmer","2020-10-15","38","5770","3","456","10.2","10.5"
"Gilmer","2020-10-16","45","5815","2","458","10.1","10.4"
"Gilmer","2020-10-17","23","5838","0","458","7.7","9.5"
"Gilmer","2020-10-18","7","5845","3","461","12.4","11.1"
"Gilmer","2020-10-19","44","5889","1","462","11.8","10.8"
"Gilmer","2020-10-20","38","5927","0","462","11.1","10.1"
"Gilmer","2020-10-21","81","6008","12","474","10.3","10.3"
"Gilmer","2020-10-22","28","6036","2","476","10.2","10.2"
"Gilmer","2020-10-23","42","6078","4","480","10.9","10.5"
"Gilmer","2020-10-24","11","6089","1","481","12.2","10"
"Gilmer","2020-10-25","14","6103","0","481","6.1","9.2"
"Gilmer","2020-10-26","59","6162","7","488","7.5","9.7"
"Gilmer","2020-10-27","33","6195","0","488","7.5","9.3"
"Gilmer","2020-10-28","35","6230","2","490","6.2","8.3"
"Gilmer","2020-10-29","48","6278","7","497","7.3","8.7"
"Gilmer","2020-10-30","53","6331","2","499","6.4","8.7"
"Gilmer","2020-10-31","16","6347","4","503","8.7","10.5"
"Gilmer","2020-11-01","12","6359","4","507","13.5","9.8"
"Gilmer","2020-11-02","41","6400","2","509","12.5","10"
"Gilmer","2020-11-03","33","6433","2","511","13.3","10.4"
"Gilmer","2020-11-04","47","6480","3","514","13.4","9.8"
"Gilmer","2020-11-05","77","6557","3","517","11.9","9.6"
"Gilmer","2020-11-06","43","6600","2","519","12","9.2"
"Gilmer","2020-11-07","12","6612","2","521","10.8","9.8"
"Gilmer","2020-11-08","11","6623","2","523","8.7","11.1"
"Gilmer","2020-11-09","37","6660","4","527","9.5","11"
"Gilmer","2020-11-10","46","6706","3","530","9.6","11.5"
"Gilmer","2020-11-11","59","6765","11","541","11.3","12.4"
"Gilmer","2020-11-12","85","6850","5","546","11.6","11.8"
"Gilmer","2020-11-13","39","6889","2","548","11.7","11.9"
"Gilmer","2020-11-14","26","6915","1","549","9.9","10.3"
"Gilmer","2020-11-15","12","6927","1","550","8.5","8.6"
"Gilmer","2020-11-16","61","6988","5","555","8.1","8.8"
"Gilmer","2020-11-17","93","7081","3","558","7.6","8.6"
"Gilmer","2020-11-18","58","7139","3","561","5.7","8.5"
"Gilmer","2020-11-19","80","7219","2","563","5.2","8.4"
"Gilmer","2020-11-20","38","7257","2","565","5.2","8.5"
"Gilmer","2020-11-21","24","7281","1","566","5.3","7.6"
"Gilmer","2020-11-22","18","7299","1","567","4.9","6.7"
"Gilmer","2020-11-23","42","7341","7","574","6.1","7.1"
"Gilmer","2020-11-24","104","7445","10","584","7","7.3"
"Gilmer","2020-11-25","59","7504","8","592","8.2","6.9"
"Gilmer","2020-11-26","31","7535","2","594","8.8","7"
"Gilmer","2020-11-27","63","7598","7","601","9.6","7.4"
"Gilmer","2020-11-28","37","7635","7","608","11.7","8.5"
"Gilmer","2020-11-29","20","7655","7","615","15.9","10.4"
"Gilmer","2020-11-30","83","7738","15","630","16.1","11.1"
"Gilmer","2020-12-01","65","7803","12","642","17.4","12.2"
"Gilmer","2020-12-02","67","7870","10","652","17.6","12.9"
"Gilmer","2020-12-03","54","7924","6","658","18.2","13.5"
"Gilmer","2020-12-04","71","7995","12","670","19.1","14.3"
"Gilmer","2020-12-05","30","8025","5","675","18.7","15.2"
"Gilmer","2020-12-06","26","8051","6","681","17","16.5"
"Gilmer","2020-12-07","83","8134","15","696","17","16.6"
"Gilmer","2020-12-08","50","8184","12","708","17.8","17.6"
"Gilmer","2020-12-09","87","8271","11","719","17.5","17.5"
"Gilmer","2020-12-10","74","8345","9","728","17.6","17.9"
"Gilmer","2020-12-11","94","8439","9","737","16.6","17.8"
"Gilmer","2020-12-12","79","8518","7","744","15.5","17.1"
"Gilmer","2020-12-13","50","8568","5","749","13.6","15.3"
"Gilmer","2020-12-14","135","8703","9","758","12","14.5"
"Gilmer","2020-12-15","79","8782","22","780","12.5","15.2"
"Gilmer","2020-12-16","100","8882","15","795","12.9","15.2"
"Gilmer","2020-12-17","49","8931","8","803","13.5","15.6"
"Gilmer","2020-12-18","133","9064","16","819","13.8","15.2"
"Gilmer","2020-12-19","82","9146","5","824","13.4","14.5"
"Gilmer","2020-12-20","25","9171","6","830","15.4","14.5"
"Gilmer","2020-12-21","128","9299","15","845","16.1","14.1"
"Gilmer","2020-12-22","72","9371","14","859","14.9","13.7"
"Gilmer","2020-12-23","94","9465","22","881","16.1","14.5"
"Gilmer","2020-12-24","99","9564","10","891","15.3","14.4"
"Gilmer","2020-12-25","12","9576","7","898","21.9","17.8"
"Gilmer","2020-12-26","24","9600","6","904","24.6","19"
"Gilmer","2020-12-27","34","9634","13","917","26.6","21"
"Gilmer","2020-12-28","87","9721","21","938","28.4","22.3"
"Gilmer","2020-12-29","97","9818","15","953","27.8","21.4"
"Gilmer","2020-12-30","63","9881","16","969","28.1","22.1"
"Gilmer","2020-12-31","88","9969","23","992","30.4","22.8"
"Gilmer","2021-01-01","13","9982","6","998","28.6","25.3"
"Gilmer","2021-01-02","11","9993","5","1003","31.6","28.1"
"Gilmer","2021-01-03","35","10028","7","1010","29","27.8"
"Gilmer","2021-01-04","71","10099","21","1031","29.7","29.1"
"Gilmer","2021-01-05","88","10187","19","1050","30.6","29.2"
"Gilmer","2021-01-06","102","10289","25","1075","30.5","29.3"
"Gilmer","2021-01-07","73","10362","24","1099","31.5","30.9"
"Gilmer","2021-01-08","61","10423","24","1123","30.5","29.6"
"Gilmer","2021-01-09","28","10451","10","1133","29.1","30.3"
"Gilmer","2021-01-10","36","10487","6","1139","28.6","28.8"
"Gilmer","2021-01-11","82","10569","19","1158","27.7","28.7"
"Gilmer","2021-01-12","128","10697","16","1174","26.4","28.5"
"Gilmer","2021-01-13","69","10766","20","1194","27","28.8"
"Gilmer","2021-01-14","168","10934","14","1208","23.5","27.5"
"Gilmer","2021-01-15","87","11021","20","1228","21.2","25.8"
"Gilmer","2021-01-16","39","11060","14","1242","21.2","25.2"
"Gilmer","2021-01-17","30","11090","7","1249","22.2","25.4"
"Gilmer","2021-01-18","78","11168","19","1268","22.3","25"
"Gilmer","2021-01-19","125","11293","15","1283","22.3","24.3"
"Gilmer","2021-01-20","156","11449","17","1300","19.7","23.4"
"Gilmer","2021-01-21","74","11523","13","1313","21","22.3"
"Gilmer","2021-01-22","64","11587","7","1320","19.3","20.2"
"Gilmer","2021-01-23","38","11625","12","1332","18.7","19.9"
"Gilmer","2021-01-24","16","11641","3","1335","18","20.1"
"Gilmer","2021-01-25","100","11741","28","1363","18.5","20.4"
"Gilmer","2021-01-26","70","11811","14","1377","19.7","21"
"Gilmer","2021-01-27","95","11906","14","1391","20.2","20"
"Gilmer","2021-01-28","62","11968","9","1400","19.8","20.4"
"Gilmer","2021-01-29","69","12037","12","1412","20.7","20"
"Gilmer","2021-01-30","48","12085","9","1421","18.9","18.8"
"Gilmer","2021-01-31","35","12120","8","1429","19.5","18.7"
"Gilmer","2021-02-01","92","12212","20","1449","18.6","18.6"
"Gilmer","2021-02-02","65","12277","14","1463","18.8","19.2"
"Gilmer","2021-02-03","70","12347","13","1476","19.3","19.8"
"Gilmer","2021-02-04","81","12428","16","1492","20.1","19.9"
"Gilmer","2021-02-05","41","12469","6","1498","19.7","20.2"
"Gilmer","2021-02-06","3","12472","0","1498","17","17.9"
"Gilmer","2021-02-07","1","12473","0","1498","13.7","16.6"
"Gilmer","2021-02-08","0","12473","0","1498","10.6","14.6"
"Glascock","2020-02-01","0","0","0","0",".","."
"Glascock","2020-02-02","0","0","0","0",".","."
"Glascock","2020-02-03","0","0","0","0",".","."
"Glascock","2020-02-04","0","0","0","0",".","."
"Glascock","2020-02-05","0","0","0","0",".","."
"Glascock","2020-02-06","0","0","0","0",".","."
"Glascock","2020-02-07","0","0","0","0","0","."
"Glascock","2020-02-08","0","0","0","0","0","."
"Glascock","2020-02-09","0","0","0","0","0","."
"Glascock","2020-02-10","0","0","0","0","0","."
"Glascock","2020-02-11","0","0","0","0","0","."
"Glascock","2020-02-12","0","0","0","0","0","."
"Glascock","2020-02-13","0","0","0","0","0","."
"Glascock","2020-02-14","0","0","0","0","0","0"
"Glascock","2020-02-15","0","0","0","0","0","0"
"Glascock","2020-02-16","0","0","0","0","0","0"
"Glascock","2020-02-17","0","0","0","0","0","0"
"Glascock","2020-02-18","0","0","0","0","0","0"
"Glascock","2020-02-19","0","0","0","0","0","0"
"Glascock","2020-02-20","0","0","0","0","0","0"
"Glascock","2020-02-21","0","0","0","0","0","0"
"Glascock","2020-02-22","0","0","0","0","0","0"
"Glascock","2020-02-23","0","0","0","0","0","0"
"Glascock","2020-02-24","0","0","0","0","0","0"
"Glascock","2020-02-25","0","0","0","0","0","0"
"Glascock","2020-02-26","0","0","0","0","0","0"
"Glascock","2020-02-27","0","0","0","0","0","0"
"Glascock","2020-02-28","0","0","0","0","0","0"
"Glascock","2020-02-29","0","0","0","0","0","0"
"Glascock","2020-03-01","0","0","0","0","0","0"
"Glascock","2020-03-02","0","0","0","0","0","0"
"Glascock","2020-03-03","0","0","0","0","0","0"
"Glascock","2020-03-04","0","0","0","0","0","0"
"Glascock","2020-03-05","0","0","0","0","0","0"
"Glascock","2020-03-06","0","0","0","0","0","0"
"Glascock","2020-03-07","0","0","0","0","0","0"
"Glascock","2020-03-08","0","0","0","0","0","0"
"Glascock","2020-03-09","0","0","0","0","0","0"
"Glascock","2020-03-10","0","0","0","0","0","0"
"Glascock","2020-03-11","0","0","0","0","0","0"
"Glascock","2020-03-12","0","0","0","0","0","0"
"Glascock","2020-03-13","0","0","0","0","0","0"
"Glascock","2020-03-14","0","0","0","0","0","0"
"Glascock","2020-03-15","0","0","0","0","0","0"
"Glascock","2020-03-16","0","0","0","0","0","0"
"Glascock","2020-03-17","0","0","0","0","0","0"
"Glascock","2020-03-18","0","0","0","0","0","0"
"Glascock","2020-03-19","1","1","0","0","0","0"
"Glascock","2020-03-20","1","2","0","0","0","0"
"Glascock","2020-03-21","0","2","0","0","0","0"
"Glascock","2020-03-22","1","3","0","0","0","0"
"Glascock","2020-03-23","0","3","0","0","0","0"
"Glascock","2020-03-24","0","3","0","0","0","0"
"Glascock","2020-03-25","1","4","0","0","0","0"
"Glascock","2020-03-26","0","4","0","0","0","0"
"Glascock","2020-03-27","2","6","0","0","0","0"
"Glascock","2020-03-28","0","6","0","0","0","0"
"Glascock","2020-03-29","0","6","0","0","0","0"
"Glascock","2020-03-30","1","7","0","0","0","0"
"Glascock","2020-03-31","0","7","0","0","0","0"
"Glascock","2020-04-01","1","8","0","0","0","0"
"Glascock","2020-04-02","0","8","0","0","0","0"
"Glascock","2020-04-03","0","8","0","0","0","0"
"Glascock","2020-04-04","0","8","0","0","0","0"
"Glascock","2020-04-05","1","9","0","0","0","0"
"Glascock","2020-04-06","0","9","0","0","0","0"
"Glascock","2020-04-07","1","10","0","0","0","0"
"Glascock","2020-04-08","0","10","0","0","0","0"
"Glascock","2020-04-09","0","10","0","0","0","0"
"Glascock","2020-04-10","0","10","0","0","0","0"
"Glascock","2020-04-11","0","10","0","0","0","0"
"Glascock","2020-04-12","0","10","0","0","0","0"
"Glascock","2020-04-13","1","11","0","0","0","0"
"Glascock","2020-04-14","2","13","0","0","0","0"
"Glascock","2020-04-15","1","14","0","0","0","0"
"Glascock","2020-04-16","1","15","0","0","0","0"
"Glascock","2020-04-17","0","15","0","0","0","0"
"Glascock","2020-04-18","0","15","0","0","0","0"
"Glascock","2020-04-19","0","15","0","0","0","0"
"Glascock","2020-04-20","1","16","0","0","0","0"
"Glascock","2020-04-21","2","18","0","0","0","0"
"Glascock","2020-04-22","1","19","0","0","0","0"
"Glascock","2020-04-23","1","20","0","0","0","0"
"Glascock","2020-04-24","0","20","0","0","0","0"
"Glascock","2020-04-25","2","22","0","0","0","0"
"Glascock","2020-04-26","1","23","0","0","0","0"
"Glascock","2020-04-27","0","23","0","0","0","0"
"Glascock","2020-04-28","0","23","0","0","0","0"
"Glascock","2020-04-29","0","23","0","0","0","0"
"Glascock","2020-04-30","0","23","0","0","0","0"
"Glascock","2020-05-01","10","33","0","0","0","0"
"Glascock","2020-05-02","1","34","0","0","0","0"
"Glascock","2020-05-03","0","34","0","0","0","0"
"Glascock","2020-05-04","2","36","0","0","0","0"
"Glascock","2020-05-05","3","39","0","0","0","0"
"Glascock","2020-05-06","0","39","0","0","0","0"
"Glascock","2020-05-07","2","41","0","0","0","0"
"Glascock","2020-05-08","1","42","0","0","0","0"
"Glascock","2020-05-09","0","42","0","0","0","0"
"Glascock","2020-05-10","0","42","0","0","0","0"
"Glascock","2020-05-11","0","42","0","0","0","0"
"Glascock","2020-05-12","4","46","0","0","0","0"
"Glascock","2020-05-13","0","46","0","0","0","0"
"Glascock","2020-05-14","0","46","0","0","0","0"
"Glascock","2020-05-15","2","48","0","0","0","0"
"Glascock","2020-05-16","2","50","0","0","0","0"
"Glascock","2020-05-17","0","50","0","0","0","0"
"Glascock","2020-05-18","0","50","0","0","0","0"
"Glascock","2020-05-19","0","50","0","0","0","0"
"Glascock","2020-05-20","1","51","0","0","0","0"
"Glascock","2020-05-21","1","52","0","0","0","0"
"Glascock","2020-05-22","1","53","0","0","0","0"
"Glascock","2020-05-23","0","53","0","0","0","0"
"Glascock","2020-05-24","2","55","0","0","0","0"
"Glascock","2020-05-25","0","55","0","0","0","0"
"Glascock","2020-05-26","4","59","0","0","0","0"
"Glascock","2020-05-27","0","59","0","0","0","0"
"Glascock","2020-05-28","1","60","0","0","0","0"
"Glascock","2020-05-29","0","60","0","0","0","0"
"Glascock","2020-05-30","0","60","0","0","0","0"
"Glascock","2020-05-31","1","61","0","0","0","0"
"Glascock","2020-06-01","0","61","0","0","0","0"
"Glascock","2020-06-02","1","62","1","1","14.3","7.1"
"Glascock","2020-06-03","0","62","0","1","14.3","7.1"
"Glascock","2020-06-04","4","66","0","1","14.3","7.1"
"Glascock","2020-06-05","0","66","0","1","14.3","7.1"
"Glascock","2020-06-06","0","66","0","1","14.3","7.1"
"Glascock","2020-06-07","0","66","0","1","14.3","7.1"
"Glascock","2020-06-08","0","66","0","1","14.3","7.1"
"Glascock","2020-06-09","0","66","0","1","0","7.1"
"Glascock","2020-06-10","2","68","0","1","0","7.1"
"Glascock","2020-06-11","1","69","0","1","0","7.1"
"Glascock","2020-06-12","0","69","0","1","0","7.1"
"Glascock","2020-06-13","0","69","0","1","0","7.1"
"Glascock","2020-06-14","0","69","0","1","0","7.1"
"Glascock","2020-06-15","1","70","0","1","0","7.1"
"Glascock","2020-06-16","1","71","1","2","14.3","7.1"
"Glascock","2020-06-17","3","74","0","2","14.3","7.1"
"Glascock","2020-06-18","3","77","0","2","14.3","7.1"
"Glascock","2020-06-19","2","79","0","2","14.3","7.1"
"Glascock","2020-06-20","1","80","0","2","14.3","7.1"
"Glascock","2020-06-21","2","82","0","2","14.3","7.1"
"Glascock","2020-06-22","0","82","0","2","14.3","7.1"
"Glascock","2020-06-23","1","83","0","2","0","7.1"
"Glascock","2020-06-24","3","86","0","2","0","7.1"
"Glascock","2020-06-25","5","91","0","2","0","7.1"
"Glascock","2020-06-26","1","92","0","2","0","7.1"
"Glascock","2020-06-27","1","93","0","2","0","7.1"
"Glascock","2020-06-28","5","98","1","3","2.9","8.6"
"Glascock","2020-06-29","8","106","0","3","2.9","8.6"
"Glascock","2020-06-30","6","112","1","4","5.2","2.6"
"Glascock","2020-07-01","2","114","1","5","12.4","6.2"
"Glascock","2020-07-02","0","114","0","5","12.4","6.2"
"Glascock","2020-07-03","0","114","0","5","12.4","6.2"
"Glascock","2020-07-04","2","116","0","5","12.4","6.2"
"Glascock","2020-07-05","2","118","0","5","9.5","6.2"
"Glascock","2020-07-06","3","121","0","5","9.5","6.2"
"Glascock","2020-07-07","3","124","0","5","7.1","6.2"
"Glascock","2020-07-08","6","130","0","5","0","6.2"
"Glascock","2020-07-09","0","130","0","5","0","6.2"
"Glascock","2020-07-10","4","134","0","5","0","6.2"
"Glascock","2020-07-11","3","137","0","5","0","6.2"
"Glascock","2020-07-12","3","140","0","5","0","4.8"
"Glascock","2020-07-13","3","143","1","6","4.8","7.1"
"Glascock","2020-07-14","3","146","0","6","4.8","6"
"Glascock","2020-07-15","5","151","0","6","4.8","2.4"
"Glascock","2020-07-16","1","152","0","6","4.8","2.4"
"Glascock","2020-07-17","1","153","0","6","4.8","2.4"
"Glascock","2020-07-18","1","154","0","6","4.8","2.4"
"Glascock","2020-07-19","1","155","0","6","4.8","2.4"
"Glascock","2020-07-20","0","155","0","6","0","2.4"
"Glascock","2020-07-21","2","157","0","6","0","2.4"
"Glascock","2020-07-22","1","158","0","6","0","2.4"
"Glascock","2020-07-23","1","159","0","6","0","2.4"
"Glascock","2020-07-24","1","160","0","6","0","2.4"
"Glascock","2020-07-25","1","161","1","7","14.3","9.5"
"Glascock","2020-07-26","1","162","0","7","14.3","9.5"
"Glascock","2020-07-27","1","163","0","7","14.3","7.1"
"Glascock","2020-07-28","2","165","0","7","14.3","7.1"
"Glascock","2020-07-29","1","166","1","8","28.6","14.3"
"Glascock","2020-07-30","0","166","0","8","28.6","14.3"
"Glascock","2020-07-31","3","169","1","9","33.3","16.7"
"Glascock","2020-08-01","4","173","0","9","19","16.7"
"Glascock","2020-08-02","0","173","0","9","19","16.7"
"Glascock","2020-08-03","2","175","0","9","19","16.7"
"Glascock","2020-08-04","3","178","1","10","23.8","19"
"Glascock","2020-08-05","0","178","0","10","9.5","19"
"Glascock","2020-08-06","1","179","0","10","9.5","19"
"Glascock","2020-08-07","2","181","1","11","11.9","22.6"
"Glascock","2020-08-08","2","183","0","11","11.9","15.5"
"Glascock","2020-08-09","3","186","0","11","11.9","15.5"
"Glascock","2020-08-10","2","188","0","11","11.9","15.5"
"Glascock","2020-08-11","2","190","0","11","7.1","15.5"
"Glascock","2020-08-12","4","194","1","12","10.7","10.1"
"Glascock","2020-08-13","1","195","0","12","10.7","10.1"
"Glascock","2020-08-14","3","198","0","12","3.6","7.7"
"Glascock","2020-08-15","4","202","0","12","3.6","7.7"
"Glascock","2020-08-16","0","202","0","12","3.6","7.7"
"Glascock","2020-08-17","3","205","3","15","17.9","14.9"
"Glascock","2020-08-18","3","208","0","15","17.9","12.5"
"Glascock","2020-08-19","1","209","0","15","14.3","12.5"
"Glascock","2020-08-20","3","212","1","16","19","14.9"
"Glascock","2020-08-21","2","214","0","16","19","11.3"
"Glascock","2020-08-22","2","216","0","16","19","11.3"
"Glascock","2020-08-23","2","218","0","16","19","11.3"
"Glascock","2020-08-24","1","219","0","16","4.8","11.3"
"Glascock","2020-08-25","3","222","0","16","4.8","11.3"
"Glascock","2020-08-26","2","224","0","16","4.8","9.5"
"Glascock","2020-08-27","5","229","1","17","2.9","11"
"Glascock","2020-08-28","3","232","1","18","7.6","13.3"
"Glascock","2020-08-29","0","232","0","18","7.6","13.3"
"Glascock","2020-08-30","1","233","0","18","7.6","13.3"
"Glascock","2020-08-31","3","236","0","18","7.6","6.2"
"Glascock","2020-09-01","2","238","0","18","7.6","6.2"
"Glascock","2020-09-02","2","240","0","18","7.6","6.2"
"Glascock","2020-09-03","4","244","2","20","11.9","7.4"
"Glascock","2020-09-04","0","244","0","20","7.1","7.4"
"Glascock","2020-09-05","1","245","0","20","7.1","7.4"
"Glascock","2020-09-06","3","248","0","20","7.1","7.4"
"Glascock","2020-09-07","0","248","0","20","7.1","7.4"
"Glascock","2020-09-08","0","248","0","20","7.1","7.4"
"Glascock","2020-09-09","3","251","0","20","7.1","7.4"
"Glascock","2020-09-10","4","255","0","20","0","6"
"Glascock","2020-09-11","1","256","0","20","0","3.6"
"Glascock","2020-09-12","0","256","0","20","0","3.6"
"Glascock","2020-09-13","0","256","0","20","0","3.6"
"Glascock","2020-09-14","6","262","1","21","2.4","4.8"
"Glascock","2020-09-15","1","263","0","21","2.4","4.8"
"Glascock","2020-09-16","0","263","0","21","2.4","4.8"
"Glascock","2020-09-17","2","265","0","21","2.4","1.2"
"Glascock","2020-09-18","2","267","0","21","2.4","1.2"
"Glascock","2020-09-19","1","268","0","21","2.4","1.2"
"Glascock","2020-09-20","0","268","0","21","2.4","1.2"
"Glascock","2020-09-21","7","275","0","21","0","1.2"
"Glascock","2020-09-22","8","283","0","21","0","1.2"
"Glascock","2020-09-23","3","286","0","21","0","1.2"
"Glascock","2020-09-24","0","286","0","21","0","1.2"
"Glascock","2020-09-25","0","286","0","21","0","1.2"
"Glascock","2020-09-26","0","286","0","21","0","1.2"
"Glascock","2020-09-27","0","286","0","21","0","1.2"
"Glascock","2020-09-28","1","287","0","21","0","0"
"Glascock","2020-09-29","1","288","0","21","0","0"
"Glascock","2020-09-30","1","289","1","22","14.3","7.1"
"Glascock","2020-10-01","0","289","0","22","14.3","7.1"
"Glascock","2020-10-02","1","290","0","22","14.3","7.1"
"Glascock","2020-10-03","1","291","0","22","14.3","7.1"
"Glascock","2020-10-04","2","293","0","22","14.3","7.1"
"Glascock","2020-10-05","6","299","0","22","14.3","7.1"
"Glascock","2020-10-06","14","313","0","22","14.3","7.1"
"Glascock","2020-10-07","1","314","0","22","0","7.1"
"Glascock","2020-10-08","2","316","0","22","0","7.1"
"Glascock","2020-10-09","4","320","0","22","0","7.1"
"Glascock","2020-10-10","1","321","0","22","0","7.1"
"Glascock","2020-10-11","2","323","0","22","0","7.1"
"Glascock","2020-10-12","4","327","0","22","0","7.1"
"Glascock","2020-10-13","5","332","0","22","0","7.1"
"Glascock","2020-10-14","3","335","1","23","4.8","2.4"
"Glascock","2020-10-15","5","340","1","24","7.6","3.8"
"Glascock","2020-10-16","4","344","1","25","11.2","5.6"
"Glascock","2020-10-17","1","345","0","25","11.2","5.6"
"Glascock","2020-10-18","1","346","0","25","11.2","5.6"
"Glascock","2020-10-19","1","347","0","25","11.2","5.6"
"Glascock","2020-10-20","62","409","4","29","12.1","6.1"
"Glascock","2020-10-21","1","410","0","29","7.4","6.1"
"Glascock","2020-10-22","4","414","0","29","4.5","6.1"
"Glascock","2020-10-23","2","416","0","29","0.9","6.1"
"Glascock","2020-10-24","3","419","0","29","0.9","6.1"
"Glascock","2020-10-25","0","419","0","29","0.9","6.1"
"Glascock","2020-10-26","1","420","0","29","0.9","6.1"
"Glascock","2020-10-27","61","481","1","30","0.2","6.2"
"Glascock","2020-10-28","5","486","0","30","0.2","3.8"
"Glascock","2020-10-29","66","552","0","30","0.2","2.4"
"Glascock","2020-10-30","1","553","0","30","0.2","0.6"
"Glascock","2020-10-31","4","557","0","30","0.2","0.6"
"Glascock","2020-11-01","1","558","0","30","0.2","0.6"
"Glascock","2020-11-02","8","566","1","31","2","1.5"
"Glascock","2020-11-03","72","638","0","31","1.8","1"
"Glascock","2020-11-04","1","639","0","31","1.8","1"
"Glascock","2020-11-05","2","641","1","32","8.9","4.6"
"Glascock","2020-11-06","1","642","0","32","8.9","4.6"
"Glascock","2020-11-07","2","644","0","32","8.9","4.6"
"Glascock","2020-11-08","2","646","1","33","16.1","8.2"
"Glascock","2020-11-09","5","651","2","35","20","11"
"Glascock","2020-11-10","6","657","2","37","24.8","13.3"
"Glascock","2020-11-11","3","660","2","39","34.3","18"
"Glascock","2020-11-12","6","666","1","40","29.5","19.2"
"Glascock","2020-11-13","2","668","0","40","29.5","19.2"
"Glascock","2020-11-14","1","669","0","40","29.5","19.2"
"Glascock","2020-11-15","0","669","0","40","22.4","19.2"
"Glascock","2020-11-16","2","671","0","40","16.7","18.3"
"Glascock","2020-11-17","63","734","1","41","12.1","18.4"
"Glascock","2020-11-18","0","734","0","41","2.6","18.4"
"Glascock","2020-11-19","2","736","0","41","0.2","14.9"
"Glascock","2020-11-20","0","736","0","41","0.2","14.9"
"Glascock","2020-11-21","2","738","0","41","0.2","14.9"
"Glascock","2020-11-22","2","740","0","41","0.2","11.3"
"Glascock","2020-11-23","3","743","0","41","0.2","8.4"
"Glascock","2020-11-24","5","748","0","41","0","6.1"
"Glascock","2020-11-25","1","749","0","41","0","1.3"
"Glascock","2020-11-26","0","749","0","41","0","0.1"
"Glascock","2020-11-27","3","752","0","41","0","0.1"
"Glascock","2020-11-28","0","752","0","41","0","0.1"
"Glascock","2020-11-29","0","752","0","41","0","0.1"
"Glascock","2020-11-30","3","755","0","41","0","0.1"
"Glascock","2020-12-01","7","762","1","42","2","1"
"Glascock","2020-12-02","3","765","1","43","6.8","3.4"
"Glascock","2020-12-03","3","768","0","43","6.8","3.4"
"Glascock","2020-12-04","6","774","1","44","9.2","4.6"
"Glascock","2020-12-05","0","774","0","44","9.2","4.6"
"Glascock","2020-12-06","1","775","0","44","9.2","4.6"
"Glascock","2020-12-07","1","776","1","45","23.5","11.7"
"Glascock","2020-12-08","6","782","1","46","23.8","12.9"
"Glascock","2020-12-09","1","783","1","47","33.3","20.1"
"Glascock","2020-12-10","6","789","1","48","35.7","21.3"
"Glascock","2020-12-11","11","800","0","48","33.3","21.3"
"Glascock","2020-12-12","0","800","0","48","33.3","21.3"
"Glascock","2020-12-13","2","802","2","50","47.6","28.4"
"Glascock","2020-12-14","5","807","3","53","41.9","32.7"
"Glascock","2020-12-15","5","812","1","54","42.4","33.1"
"Glascock","2020-12-16","1","813","0","54","28.1","30.7"
"Glascock","2020-12-17","3","816","1","55","30.5","33.1"
"Glascock","2020-12-18","7","823","1","56","32.5","32.9"
"Glascock","2020-12-19","1","824","0","56","32.5","32.9"
"Glascock","2020-12-20","0","824","0","56","18.2","32.9"
"Glascock","2020-12-21","12","836","3","59","13.2","27.6"
"Glascock","2020-12-22","5","841","2","61","16.1","29.2"
"Glascock","2020-12-23","1","842","0","61","16.1","22.1"
"Glascock","2020-12-24","1","843","1","62","25.6","28"
"Glascock","2020-12-25","0","843","0","62","23.6","28"
"Glascock","2020-12-26","3","846","0","62","23.6","28"
"Glascock","2020-12-27","2","848","1","63","30.7","24.5"
"Glascock","2020-12-28","6","854","0","63","27.1","20.2"
"Glascock","2020-12-29","1","855","1","64","35.7","25.9"
"Glascock","2020-12-30","10","865","2","66","38.6","27.3"
"Glascock","2020-12-31","6","871","2","68","29","27.3"
"Glascock","2021-01-01","0","871","0","68","29","26.3"
"Glascock","2021-01-02","0","871","0","68","29","26.3"
"Glascock","2021-01-03","1","872","1","69","36.2","33.5"
"Glascock","2021-01-04","1","873","1","70","50.5","38.8"
"Glascock","2021-01-05","2","875","0","70","36.2","36"
"Glascock","2021-01-06","4","879","0","70","33.3","36"
"Glascock","2021-01-07","8","887","3","73","33.9","31.5"
"Glascock","2021-01-08","0","887","0","73","33.9","31.5"
"Glascock","2021-01-09","1","888","0","73","33.9","31.5"
"Glascock","2021-01-10","0","888","0","73","19.6","27.9"
"Glascock","2021-01-11","6","894","3","76","12.5","31.5"
"Glascock","2021-01-12","5","899","0","76","12.5","24.3"
"Glascock","2021-01-13","4","903","2","78","19.6","26.5"
"Glascock","2021-01-14","6","909","2","80","19","26.5"
"Glascock","2021-01-15","3","912","1","81","23.8","28.9"
"Glascock","2021-01-16","2","914","0","81","23.8","28.9"
"Glascock","2021-01-17","3","917","1","82","28.6","24.1"
"Glascock","2021-01-18","4","921","2","84","28.6","20.5"
"Glascock","2021-01-19","3","924","1","85","33.3","22.9"
"Glascock","2021-01-20","9","933","0","85","26.2","22.9"
"Glascock","2021-01-21","2","935","0","85","21.4","20.2"
"Glascock","2021-01-22","5","940","2","87","22.4","23.1"
"Glascock","2021-01-23","1","941","0","87","22.4","23.1"
"Glascock","2021-01-24","2","943","0","87","17.6","23.1"
"Glascock","2021-01-25","11","954","3","90","14.4","21.5"
"Glascock","2021-01-26","4","958","2","92","16.8","25"
"Glascock","2021-01-27","8","966","1","93","18.5","22.4"
"Glascock","2021-01-28","5","971","2","95","24.3","22.8"
"Glascock","2021-01-29","5","976","1","96","21.4","21.9"
"Glascock","2021-01-30","6","982","0","96","21.4","21.9"
"Glascock","2021-01-31","2","984","1","97","28.5","23.1"
"Glascock","2021-02-01","4","988","1","98","28.2","21.3"
"Glascock","2021-02-02","3","991","1","99","25.8","21.3"
"Glascock","2021-02-03","4","995","1","100","27.6","23.1"
"Glascock","2021-02-04","1","996","0","100","21.9","23.1"
"Glascock","2021-02-05","4","1000","2","102","26.2","23.8"
"Glascock","2021-02-06","3","1003","2","104","35.7","28.6"
"Glascock","2021-02-07","0","1003","0","104","28.6","28.6"
"Glascock","2021-02-08","0","1003","0","104","25","26.6"
"Glynn","2020-02-01","0","0","0","0",".","."
"Glynn","2020-02-02","0","0","0","0",".","."
"Glynn","2020-02-03","0","0","0","0",".","."
"Glynn","2020-02-04","0","0","0","0",".","."
"Glynn","2020-02-05","0","0","0","0",".","."
"Glynn","2020-02-06","0","0","0","0",".","."
"Glynn","2020-02-07","0","0","0","0","0","."
"Glynn","2020-02-08","0","0","0","0","0","."
"Glynn","2020-02-09","0","0","0","0","0","."
"Glynn","2020-02-10","0","0","0","0","0","."
"Glynn","2020-02-11","0","0","0","0","0","."
"Glynn","2020-02-12","0","0","0","0","0","."
"Glynn","2020-02-13","0","0","0","0","0","."
"Glynn","2020-02-14","0","0","0","0","0","0"
"Glynn","2020-02-15","0","0","0","0","0","0"
"Glynn","2020-02-16","0","0","0","0","0","0"
"Glynn","2020-02-17","0","0","0","0","0","0"
"Glynn","2020-02-18","0","0","0","0","0","0"
"Glynn","2020-02-19","0","0","0","0","0","0"
"Glynn","2020-02-20","0","0","0","0","0","0"
"Glynn","2020-02-21","0","0","0","0","0","0"
"Glynn","2020-02-22","0","0","0","0","0","0"
"Glynn","2020-02-23","0","0","0","0","0","0"
"Glynn","2020-02-24","0","0","0","0","0","0"
"Glynn","2020-02-25","0","0","0","0","0","0"
"Glynn","2020-02-26","0","0","0","0","0","0"
"Glynn","2020-02-27","0","0","0","0","0","0"
"Glynn","2020-02-28","0","0","0","0","0","0"
"Glynn","2020-02-29","0","0","0","0","0","0"
"Glynn","2020-03-01","0","0","0","0","0","0"
"Glynn","2020-03-02","1","1","0","0","0","0"
"Glynn","2020-03-03","0","1","0","0","0","0"
"Glynn","2020-03-04","0","1","0","0","0","0"
"Glynn","2020-03-05","0","1","0","0","0","0"
"Glynn","2020-03-06","0","1","0","0","0","0"
"Glynn","2020-03-07","0","1","0","0","0","0"
"Glynn","2020-03-08","11","12","0","0","0","0"
"Glynn","2020-03-09","0","12","0","0","0","0"
"Glynn","2020-03-10","15","27","0","0","0","0"
"Glynn","2020-03-11","2","29","0","0","0","0"
"Glynn","2020-03-12","4","33","0","0","0","0"
"Glynn","2020-03-13","4","37","0","0","0","0"
"Glynn","2020-03-14","0","37","0","0","0","0"
"Glynn","2020-03-15","8","45","1","1","1.8","0.9"
"Glynn","2020-03-16","2","47","0","1","1.8","0.9"
"Glynn","2020-03-17","17","64","2","3","3.5","1.7"
"Glynn","2020-03-18","11","75","0","3","3.5","1.7"
"Glynn","2020-03-19","38","113","0","3","3.5","1.7"
"Glynn","2020-03-20","41","154","1","4","3.8","1.9"
"Glynn","2020-03-21","7","161","0","4","3.8","1.9"
"Glynn","2020-03-22","10","171","0","4","2","1.9"
"Glynn","2020-03-23","29","200","2","6","3","2.4"
"Glynn","2020-03-24","27","227","0","6","1.3","2.4"
"Glynn","2020-03-25","30","257","2","8","2.3","2.9"
"Glynn","2020-03-26","27","284","2","10","3.3","3.4"
"Glynn","2020-03-27","20","304","0","10","3","3.4"
"Glynn","2020-03-28","8","312","0","10","3","3.4"
"Glynn","2020-03-29","8","320","0","10","3","2.5"
"Glynn","2020-03-30","25","345","0","10","2","2.5"
"Glynn","2020-03-31","23","368","0","10","2","1.7"
"Glynn","2020-04-01","18","386","1","11","1.9","2.1"
"Glynn","2020-04-02","18","404","0","11","0.8","2.1"
"Glynn","2020-04-03","14","418","0","11","0.8","1.9"
"Glynn","2020-04-04","2","420","0","11","0.8","1.9"
"Glynn","2020-04-05","6","426","0","11","0.8","1.9"
"Glynn","2020-04-06","6","432","0","11","0.8","1.4"
"Glynn","2020-04-07","12","444","0","11","0.8","1.4"
"Glynn","2020-04-08","11","455","0","11","0","0.9"
"Glynn","2020-04-09","4","459","1","12","3.6","2.2"
"Glynn","2020-04-10","9","468","0","12","3.6","2.2"
"Glynn","2020-04-11","9","477","0","12","3.6","2.2"
"Glynn","2020-04-12","16","493","4","16","7.1","4"
"Glynn","2020-04-13","10","503","1","17","8.6","4.7"
"Glynn","2020-04-14","20","523","0","17","8.6","4.7"
"Glynn","2020-04-15","14","537","1","18","9.6","4.8"
"Glynn","2020-04-16","29","566","0","18","6","4.8"
"Glynn","2020-04-17","30","596","1","19","6.5","5"
"Glynn","2020-04-18","17","613","1","20","7.3","5.5"
"Glynn","2020-04-19","11","624","2","22","6.4","6.8"
"Glynn","2020-04-20","60","684","0","22","4.9","6.8"
"Glynn","2020-04-21","35","719","0","22","4.9","6.8"
"Glynn","2020-04-22","22","741","0","22","3.9","6.8"
"Glynn","2020-04-23","178","919","1","23","4","5"
"Glynn","2020-04-24","87","1006","4","27","4.2","5.3"
"Glynn","2020-04-25","12","1018","0","27","3.3","5.3"
"Glynn","2020-04-26","6","1024","0","27","0.7","3.5"
"Glynn","2020-04-27","48","1072","0","27","0.7","2.8"
"Glynn","2020-04-28","162","1234","2","29","0.9","2.9"
"Glynn","2020-04-29","70","1304","0","29","0.9","2.4"
"Glynn","2020-04-30","132","1436","1","30","0.9","2.5"
"Glynn","2020-05-01","62","1498","0","30","0.3","2.2"
"Glynn","2020-05-02","38","1536","0","30","0.3","1.8"
"Glynn","2020-05-03","9","1545","0","30","0.3","0.5"
"Glynn","2020-05-04","57","1602","3","33","1","0.9"
"Glynn","2020-05-05","156","1758","0","33","0.9","0.9"
"Glynn","2020-05-06","147","1905","0","33","0.9","0.9"
"Glynn","2020-05-07","108","2013","0","33","0.8","0.8"
"Glynn","2020-05-08","117","2130","0","33","0.8","0.5"
"Glynn","2020-05-09","80","2210","0","33","0.8","0.5"
"Glynn","2020-05-10","6","2216","0","33","0.8","0.5"
"Glynn","2020-05-11","176","2392","2","35","0.2","0.6"
"Glynn","2020-05-12","331","2723","3","38","0.3","0.6"
"Glynn","2020-05-13","140","2863","2","40","0.5","0.7"
"Glynn","2020-05-14","165","3028","1","41","0.6","0.7"
"Glynn","2020-05-15","99","3127","1","42","0.7","0.7"
"Glynn","2020-05-16","31","3158","0","42","0.7","0.7"
"Glynn","2020-05-17","9","3167","0","42","0.7","0.7"
"Glynn","2020-05-18","131","3298","3","45","0.9","0.5"
"Glynn","2020-05-19","95","3393","1","46","0.9","0.6"
"Glynn","2020-05-20","70","3463","1","47","0.9","0.7"
"Glynn","2020-05-21","59","3522","1","48","1.1","0.8"
"Glynn","2020-05-22","121","3643","8","56","1.9","1.3"
"Glynn","2020-05-23","163","3806","4","60","2.2","1.5"
"Glynn","2020-05-24","9","3815","2","62","5.4","3.1"
"Glynn","2020-05-25","26","3841","0","62","5.1","3"
"Glynn","2020-05-26","202","4043","8","70","5.5","3.2"
"Glynn","2020-05-27","111","4154","1","71","5.4","3.2"
"Glynn","2020-05-28","141","4295","3","74","5.5","3.3"
"Glynn","2020-05-29","191","4486","7","81","5","3.5"
"Glynn","2020-05-30","155","4641","14","95","6","4.1"
"Glynn","2020-05-31","11","4652","0","95","2.8","4.1"
"Glynn","2020-06-01","181","4833","3","98","3","4.1"
"Glynn","2020-06-02","154","4987","7","105","3.1","4.3"
"Glynn","2020-06-03","223","5210","9","114","3.6","4.5"
"Glynn","2020-06-04","119","5329","7","121","4.1","4.8"
"Glynn","2020-06-05","197","5526","9","130","4.2","4.6"
"Glynn","2020-06-06","118","5644","4","134","3.4","4.7"
"Glynn","2020-06-07","6","5650","0","134","3.4","3.1"
"Glynn","2020-06-08","356","6006","17","151","3.9","3.5"
"Glynn","2020-06-09","154","6160","3","154","3.5","3.3"
"Glynn","2020-06-10","316","6476","7","161","3.3","3.4"
"Glynn","2020-06-11","264","6740","25","186","3.8","3.9"
"Glynn","2020-06-12","209","6949","11","197","3.9","4.1"
"Glynn","2020-06-13","91","7040","3","200","3.9","3.6"
"Glynn","2020-06-14","20","7060","1","201","4.6","4"
"Glynn","2020-06-15","423","7483","23","224","4.7","4.3"
"Glynn","2020-06-16","288","7771","29","253","5.8","4.7"
"Glynn","2020-06-17","290","8061","27","280","6.8","5"
"Glynn","2020-06-18","332","8393","69","349","8.5","6.1"
"Glynn","2020-06-19","513","8906","70","419","9.6","6.8"
"Glynn","2020-06-20","200","9106","33","452","11.5","7.7"
"Glynn","2020-06-21","30","9136","5","457","13.2","8.9"
"Glynn","2020-06-22","740","9876","120","577","14.7","9.7"
"Glynn","2020-06-23","1031","10907","90","667","14.6","10.2"
"Glynn","2020-06-24","637","11544","88","755","15.2","11"
"Glynn","2020-06-25","565","12109","90","845","14.5","11.5"
"Glynn","2020-06-26","654","12763","80","925","14.3","12"
"Glynn","2020-06-27","205","12968","28","953","13.9","12.7"
"Glynn","2020-06-28","36","13004","1","954","11.9","12.6"
"Glynn","2020-06-29","715","13719","86","1040","11.3","13"
"Glynn","2020-06-30","822","14541","76","1116","11.4","13"
"Glynn","2020-07-01","453","14994","71","1187","11.6","13.4"
"Glynn","2020-07-02","354","15348","43","1230","11.1","12.8"
"Glynn","2020-07-03","53","15401","4","1234","10.4","12.4"
"Glynn","2020-07-04","26","15427","4","1238","10.7","12.3"
"Glynn","2020-07-05","28","15455","5","1243","12.8","12.4"
"Glynn","2020-07-06","419","15874","65","1308","13.3","12.3"
"Glynn","2020-07-07","401","16275","37","1345","13.3","12.4"
"Glynn","2020-07-08","588","16863","38","1383","12","11.8"
"Glynn","2020-07-09","326","17189","43","1426","12.2","11.6"
"Glynn","2020-07-10","436","17625","35","1461","12.2","11.3"
"Glynn","2020-07-11","257","17882","27","1488","11.5","11.1"
"Glynn","2020-07-12","71","17953","23","1511","13.6","13.2"
"Glynn","2020-07-13","431","18384","60","1571","13.4","13.4"
"Glynn","2020-07-14","558","18942","55","1626","13.5","13.4"
"Glynn","2020-07-15","498","19440","53","1679","14.1","13"
"Glynn","2020-07-16","364","19804","46","1725","14","13.1"
"Glynn","2020-07-17","396","20200","38","1763","14.2","13.2"
"Glynn","2020-07-18","147","20347","40","1803","16.6","14.1"
"Glynn","2020-07-19","70","20417","13","1816","14.6","14.1"
"Glynn","2020-07-20","449","20866","38","1854","13.9","13.6"
"Glynn","2020-07-21","426","21292","46","1900","14","13.7"
"Glynn","2020-07-22","459","21751","30","1930","13.4","13.7"
"Glynn","2020-07-23","305","22056","24","1954","12.7","13.4"
"Glynn","2020-07-24","354","22410","34","1988","12.7","13.5"
"Glynn","2020-07-25","160","22570","18","2006","10.4","13.5"
"Glynn","2020-07-26","36","22606","7","2013","10.6","12.6"
"Glynn","2020-07-27","336","22942","25","2038","10.4","12.1"
"Glynn","2020-07-28","484","23426","66","2104","10.8","12.4"
"Glynn","2020-07-29","371","23797","33","2137","11.2","12.3"
"Glynn","2020-07-30","254","24051","43","2180","12.5","12.6"
"Glynn","2020-07-31","266","24317","21","2201","12.2","12.5"
"Glynn","2020-08-01","116","24433","13","2214","12.2","11.3"
"Glynn","2020-08-02","53","24486","13","2227","12.9","11.7"
"Glynn","2020-08-03","190","24676","27","2254","13.9","12.2"
"Glynn","2020-08-04","586","25262","57","2311","13.3","12.1"
"Glynn","2020-08-05","498","25760","40","2351","13.2","12.2"
"Glynn","2020-08-06","279","26039","31","2382","12.4","12.4"
"Glynn","2020-08-07","318","26357","24","2406","12.3","12.3"
"Glynn","2020-08-08","196","26553","20","2426","12.2","12.2"
"Glynn","2020-08-09","63","26616","12","2438","11.4","12.2"
"Glynn","2020-08-10","344","26960","28","2466","10.5","12.2"
"Glynn","2020-08-11","342","27302","22","2488","10.1","11.7"
"Glynn","2020-08-12","433","27735","29","2517","9.9","11.6"
"Glynn","2020-08-13","270","28005","13","2530","9","10.7"
"Glynn","2020-08-14","253","28258","24","2554","9.3","10.8"
"Glynn","2020-08-15","125","28383","12","2566","9.2","10.7"
"Glynn","2020-08-16","42","28425","7","2573","8.8","10.1"
"Glynn","2020-08-17","116","28541","11","2584","9","9.8"
"Glynn","2020-08-18","330","28871","36","2620","9.7","9.9"
"Glynn","2020-08-19","358","29229","22","2642","9.6","9.7"
"Glynn","2020-08-20","282","29511","32","2674","10.5","9.8"
"Glynn","2020-08-21","183","29694","10","2684","9.9","9.6"
"Glynn","2020-08-22","182","29876","20","2704","10.1","9.7"
"Glynn","2020-08-23","67","29943","5","2709","8.8","8.8"
"Glynn","2020-08-24","346","30289","33","2742","8.8","8.9"
"Glynn","2020-08-25","347","30636","40","2782","8.9","9.3"
"Glynn","2020-08-26","385","31021","31","2813","9.2","9.4"
"Glynn","2020-08-27","364","31385","42","2855","9.2","9.9"
"Glynn","2020-08-28","276","31661","23","2878","9.6","9.8"
"Glynn","2020-08-29","100","31761","14","2892","10.1","10.1"
"Glynn","2020-08-30","50","31811","11","2903","12.1","10.5"
"Glynn","2020-08-31","388","32199","38","2941","12.2","10.5"
"Glynn","2020-09-01","348","32547","31","2972","11.8","10.4"
"Glynn","2020-09-02","388","32935","29","3001","11.7","10.5"
"Glynn","2020-09-03","376","33311","30","3031","11.2","10.2"
"Glynn","2020-09-04","299","33610","19","3050","10.9","10.3"
"Glynn","2020-09-05","111","33721","9","3059","10.1","10.1"
"Glynn","2020-09-06","85","33806","6","3065","8","10"
"Glynn","2020-09-07","174","33980","19","3084","8.1","10.1"
"Glynn","2020-09-08","499","34479","22","3106","7.5","9.6"
"Glynn","2020-09-09","381","34860","17","3123","7","9.4"
"Glynn","2020-09-10","434","35294","24","3147","6.7","9"
"Glynn","2020-09-11","286","35580","12","3159","6.4","8.7"
"Glynn","2020-09-12","158","35738","10","3169","6.1","8.1"
"Glynn","2020-09-13","52","35790","5","3174","6.5","7.2"
"Glynn","2020-09-14","338","36128","21","3195","5.8","7"
"Glynn","2020-09-15","291","36419","21","3216","6.2","6.8"
"Glynn","2020-09-16","241","36660","9","3225","6.1","6.6"
"Glynn","2020-09-17","332","36992","12","3237","5.8","6.3"
"Glynn","2020-09-18","190","37182","6","3243","5.7","6"
"Glynn","2020-09-19","113","37295","0","3243","4.8","5.5"
"Glynn","2020-09-20","43","37338","4","3247","4.7","5.6"
"Glynn","2020-09-21","263","37601","11","3258","4.5","5.1"
"Glynn","2020-09-22","179","37780","7","3265","4","5.1"
"Glynn","2020-09-23","219","37999","8","3273","4","5"
"Glynn","2020-09-24","221","38220","9","3282","4","4.9"
"Glynn","2020-09-25","170","38390","6","3288","4.1","4.9"
"Glynn","2020-09-26","127","38517","10","3298","5.2","5"
"Glynn","2020-09-27","38","38555","5","3303","5.8","5.3"
"Glynn","2020-09-28","245","38800","12","3315","5.9","5.2"
"Glynn","2020-09-29","120","38920","4","3319","5.8","4.9"
"Glynn","2020-09-30","168","39088","2","3321","5.4","4.7"
"Glynn","2020-10-01","240","39328","8","3329","5.3","4.7"
"Glynn","2020-10-02","210","39538","12","3341","5.6","4.9"
"Glynn","2020-10-03","88","39626","1","3342","4.7","4.9"
"Glynn","2020-10-04","45","39671","2","3344","3.4","4.6"
"Glynn","2020-10-05","269","39940","8","3352","3.2","4.5"
"Glynn","2020-10-06","197","40137","8","3360","3.3","4.5"
"Glynn","2020-10-07","247","40384","6","3366","3.4","4.4"
"Glynn","2020-10-08","270","40654","11","3377","3.5","4.4"
"Glynn","2020-10-09","158","40812","8","3385","3.5","4.5"
"Glynn","2020-10-10","137","40949","4","3389","3.7","4.2"
"Glynn","2020-10-11","34","40983","0","3389","3.1","3.3"
"Glynn","2020-10-12","188","41171","5","3394","3","3.1"
"Glynn","2020-10-13","219","41390","17","3411","3.6","3.4"
"Glynn","2020-10-14","257","41647","11","3422","3.8","3.6"
"Glynn","2020-10-15","319","41966","13","3435","3.8","3.7"
"Glynn","2020-10-16","232","42198","9","3444","3.7","3.6"
"Glynn","2020-10-17","86","42284","1","3445","3.4","3.6"
"Glynn","2020-10-18","39","42323","2","3447","4.1","3.6"
"Glynn","2020-10-19","328","42651","15","3462","4.4","3.7"
"Glynn","2020-10-20","151","42802","14","3476","4.6","4.1"
"Glynn","2020-10-21","205","43007","19","3495","5.3","4.6"
"Glynn","2020-10-22","300","43307","21","3516","5.8","4.8"
"Glynn","2020-10-23","220","43527","8","3524","5.7","4.7"
"Glynn","2020-10-24","165","43692","12","3536","6.6","5"
"Glynn","2020-10-25","45","43737","8","3544","8.4","6.3"
"Glynn","2020-10-26","287","44024","21","3565","8.8","6.6"
"Glynn","2020-10-27","164","44188","8","3573","8.2","6.4"
"Glynn","2020-10-28","284","44472","16","3589","7.6","6.5"
"Glynn","2020-10-29","331","44803","19","3608","7.5","6.6"
"Glynn","2020-10-30","307","45110","14","3622","7.6","6.7"
"Glynn","2020-10-31","89","45199","6","3628","7.5","7.1"
"Glynn","2020-11-01","46","45245","5","3633","6.5","7.5"
"Glynn","2020-11-02","269","45514","12","3645","6.1","7.5"
"Glynn","2020-11-03","156","45670","9","3654","6.3","7.2"
"Glynn","2020-11-04","230","45900","24","3678","6.9","7.3"
"Glynn","2020-11-05","384","46284","17","3695","6.8","7.1"
"Glynn","2020-11-06","238","46522","13","3708","6.9","7.2"
"Glynn","2020-11-07","114","46636","4","3712","6.4","7"
"Glynn","2020-11-08","35","46671","4","3716","6.5","6.5"
"Glynn","2020-11-09","317","46988","21","3737","6.8","6.5"
"Glynn","2020-11-10","216","47204","14","3751","6.9","6.6"
"Glynn","2020-11-11","257","47461","15","3766","6.3","6.6"
"Glynn","2020-11-12","393","47854","28","3794","6.6","6.7"
"Glynn","2020-11-13","213","48067","18","3812","7.1","7"
"Glynn","2020-11-14","183","48250","9","3821","7.3","6.8"
"Glynn","2020-11-15","46","48296","4","3825","6.9","6.7"
"Glynn","2020-11-16","338","48634","19","3844","6.7","6.8"
"Glynn","2020-11-17","268","48902","20","3864","6.9","6.9"
"Glynn","2020-11-18","358","49260","15","3879","6.6","6.4"
"Glynn","2020-11-19","476","49736","19","3898","6.2","6.4"
"Glynn","2020-11-20","312","50048","21","3919","5.9","6.5"
"Glynn","2020-11-21","84","50132","2","3921","5.6","6.4"
"Glynn","2020-11-22","74","50206","10","3931","6.3","6.6"
"Glynn","2020-11-23","429","50635","23","3954","6.2","6.5"
"Glynn","2020-11-24","261","50896","18","3972","6.2","6.5"
"Glynn","2020-11-25","305","51201","16","3988","6.3","6.5"
"Glynn","2020-11-26","68","51269","3","3991","6.4","6.3"
"Glynn","2020-11-27","118","51387","5","3996","6","6"
"Glynn","2020-11-28","106","51493","6","4002","6.5","6"
"Glynn","2020-11-29","52","51545","4","4006","5.6","6"
"Glynn","2020-11-30","395","51940","30","4036","6","6.1"
"Glynn","2020-12-01","189","52129","5","4041","5.4","5.8"
"Glynn","2020-12-02","309","52438","20","4061","5.5","5.9"
"Glynn","2020-12-03","304","52742","21","4082","5.9","6.1"
"Glynn","2020-12-04","240","52982","11","4093","5.9","6"
"Glynn","2020-12-05","100","53082","10","4103","6.6","6.5"
"Glynn","2020-12-06","48","53130","2","4105","6.1","5.8"
"Glynn","2020-12-07","349","53479","26","4131","6","6"
"Glynn","2020-12-08","242","53721","16","4147","6.6","6"
"Glynn","2020-12-09","327","54048","12","4159","6.2","5.9"
"Glynn","2020-12-10","237","54285","19","4178","6.4","6.1"
"Glynn","2020-12-11","227","54512","16","4194","6.7","6.3"
"Glynn","2020-12-12","200","54712","18","4212","6.6","6.6"
"Glynn","2020-12-13","51","54763","5","4217","7.4","6.7"
"Glynn","2020-12-14","376","55139","37","4254","7.7","6.9"
"Glynn","2020-12-15","323","55462","34","4288","8.3","7.4"
"Glynn","2020-12-16","427","55889","26","4314","8.6","7.4"
"Glynn","2020-12-17","519","56408","36","4350","8.5","7.4"
"Glynn","2020-12-18","367","56775","36","4386","8.9","7.8"
"Glynn","2020-12-19","88","56863","8","4394","8.9","7.7"
"Glynn","2020-12-20","86","56949","14","4408","9.8","8.6"
"Glynn","2020-12-21","634","57583","62","4470","9.8","8.8"
"Glynn","2020-12-22","416","57999","37","4507","9.6","8.9"
"Glynn","2020-12-23","463","58462","47","4554","10.1","9.4"
"Glynn","2020-12-24","109","58571","7","4561","10.1","9.3"
"Glynn","2020-12-25","47","58618","6","4567","10.5","9.7"
"Glynn","2020-12-26","202","58820","37","4604","11.8","10.3"
"Glynn","2020-12-27","70","58890","14","4618","12.3","11.1"
"Glynn","2020-12-28","522","59412","67","4685","12.8","11.3"
"Glynn","2020-12-29","409","59821","44","4729","13","11.3"
"Glynn","2020-12-30","549","60370","48","4777","12.8","11.5"
"Glynn","2020-12-31","434","60804","49","4826","13.5","11.8"
"Glynn","2021-01-01","74","60878","12","4838","14","12.3"
"Glynn","2021-01-02","102","60980","14","4852","13.4","12.6"
"Glynn","2021-01-03","73","61053","12","4864","12.9","12.6"
"Glynn","2021-01-04","719","61772","119","4983","13.4","13.1"
"Glynn","2021-01-05","597","62369","71","5054","13.6","13.3"
"Glynn","2021-01-06","443","62812","46","5100","13.8","13.3"
"Glynn","2021-01-07","486","63298","43","5143","13.4","13.5"
"Glynn","2021-01-08","420","63718","45","5188","12.7","13.3"
"Glynn","2021-01-09","195","63913","24","5212","12.4","12.9"
"Glynn","2021-01-10","48","63961","3","5215","11","11.9"
"Glynn","2021-01-11","574","64535","48","5263","9.8","11.6"
"Glynn","2021-01-12","487","65022","39","5302","9.3","11.4"
"Glynn","2021-01-13","435","65457","40","5342","9.1","11.4"
"Glynn","2021-01-14","509","65966","49","5391","9.2","11.3"
"Glynn","2021-01-15","501","66467","38","5429","8.8","10.7"
"Glynn","2021-01-16","122","66589","11","5440","8.3","10.4"
"Glynn","2021-01-17","63","66652","11","5451","9.9","10.4"
"Glynn","2021-01-18","513","67165","61","5512","10.4","10.1"
"Glynn","2021-01-19","434","67599","43","5555","10.7","10"
"Glynn","2021-01-20","579","68178","53","5608","10.7","9.9"
"Glynn","2021-01-21","487","68665","31","5639","10.2","9.7"
"Glynn","2021-01-22","447","69112","41","5680","10.4","9.6"
"Glynn","2021-01-23","263","69375","23","5703","10.4","9.3"
"Glynn","2021-01-24","73","69448","15","5718","10.8","10.4"
"Glynn","2021-01-25","604","70052","65","5783","10.7","10.5"
"Glynn","2021-01-26","545","70597","78","5861","11.3","11"
"Glynn","2021-01-27","499","71096","43","5904","11.2","10.9"
"Glynn","2021-01-28","548","71644","40","5944","11.4","10.8"
"Glynn","2021-01-29","565","72209","46","5990","11.2","10.8"
"Glynn","2021-01-30","95","72304","14","6004","12.1","11.2"
"Glynn","2021-01-31","132","72436","44","6048","13.9","12.4"
"Glynn","2021-02-01","568","73004","54","6102","13.7","12.2"
"Glynn","2021-02-02","453","73457","55","6157","13.4","12.3"
"Glynn","2021-02-03","370","73827","34","6191","13.5","12.3"
"Glynn","2021-02-04","578","74405","39","6230","13.4","12.4"
"Glynn","2021-02-05","396","74801","16","6246","12.8","12"
"Glynn","2021-02-06","29","74830","3","6249","12.2","12.1"
"Glynn","2021-02-07","5","74835","0","6249","7.4","10.7"
"Glynn","2021-02-08","0","74835","0","6249","6.1","9.9"
"Gordon","2020-02-01","0","0","0","0",".","."
"Gordon","2020-02-02","0","0","0","0",".","."
"Gordon","2020-02-03","0","0","0","0",".","."
"Gordon","2020-02-04","0","0","0","0",".","."
"Gordon","2020-02-05","0","0","0","0",".","."
"Gordon","2020-02-06","0","0","0","0",".","."
"Gordon","2020-02-07","0","0","0","0","0","."
"Gordon","2020-02-08","0","0","0","0","0","."
"Gordon","2020-02-09","0","0","0","0","0","."
"Gordon","2020-02-10","0","0","0","0","0","."
"Gordon","2020-02-11","0","0","0","0","0","."
"Gordon","2020-02-12","0","0","0","0","0","."
"Gordon","2020-02-13","0","0","0","0","0","."
"Gordon","2020-02-14","0","0","0","0","0","0"
"Gordon","2020-02-15","0","0","0","0","0","0"
"Gordon","2020-02-16","0","0","0","0","0","0"
"Gordon","2020-02-17","0","0","0","0","0","0"
"Gordon","2020-02-18","0","0","0","0","0","0"
"Gordon","2020-02-19","0","0","0","0","0","0"
"Gordon","2020-02-20","0","0","0","0","0","0"
"Gordon","2020-02-21","0","0","0","0","0","0"
"Gordon","2020-02-22","0","0","0","0","0","0"
"Gordon","2020-02-23","0","0","0","0","0","0"
"Gordon","2020-02-24","0","0","0","0","0","0"
"Gordon","2020-02-25","0","0","0","0","0","0"
"Gordon","2020-02-26","0","0","0","0","0","0"
"Gordon","2020-02-27","0","0","0","0","0","0"
"Gordon","2020-02-28","0","0","0","0","0","0"
"Gordon","2020-02-29","0","0","0","0","0","0"
"Gordon","2020-03-01","0","0","0","0","0","0"
"Gordon","2020-03-02","1","1","1","1","14.3","7.1"
"Gordon","2020-03-03","0","1","0","1","14.3","7.1"
"Gordon","2020-03-04","0","1","0","1","14.3","7.1"
"Gordon","2020-03-05","0","1","0","1","14.3","7.1"
"Gordon","2020-03-06","0","1","0","1","14.3","7.1"
"Gordon","2020-03-07","0","1","0","1","14.3","7.1"
"Gordon","2020-03-08","4","5","2","3","21.4","10.7"
"Gordon","2020-03-09","4","9","0","3","7.1","10.7"
"Gordon","2020-03-10","3","12","0","3","7.1","10.7"
"Gordon","2020-03-11","10","22","1","4","8.6","11.4"
"Gordon","2020-03-12","9","31","0","4","8.6","11.4"
"Gordon","2020-03-13","10","41","4","8","14.3","14.3"
"Gordon","2020-03-14","2","43","0","8","14.3","14.3"
"Gordon","2020-03-15","10","53","2","10","10","15.7"
"Gordon","2020-03-16","19","72","1","11","10.8","8.9"
"Gordon","2020-03-17","7","79","1","12","12.8","10"
"Gordon","2020-03-18","3","82","0","12","11.4","10"
"Gordon","2020-03-19","12","94","4","16","16.1","12.3"
"Gordon","2020-03-20","14","108","6","22","16.5","15.4"
"Gordon","2020-03-21","4","112","0","22","16.5","15.4"
"Gordon","2020-03-22","8","120","2","24","17.2","13.6"
"Gordon","2020-03-23","17","137","0","24","16.5","13.6"
"Gordon","2020-03-24","4","141","0","24","14.5","13.6"
"Gordon","2020-03-25","12","153","0","24","14.5","12.9"
"Gordon","2020-03-26","12","165","0","24","9.7","12.9"
"Gordon","2020-03-27","11","176","0","24","3.6","10.1"
"Gordon","2020-03-28","11","187","3","27","7.5","12"
"Gordon","2020-03-29","3","190","0","27","3.9","10.6"
"Gordon","2020-03-30","4","194","0","27","3.9","10.2"
"Gordon","2020-03-31","13","207","1","28","5","9.7"
"Gordon","2020-04-01","9","216","2","30","8.2","11.3"
"Gordon","2020-04-02","11","227","0","30","8.2","8.9"
"Gordon","2020-04-03","7","234","1","31","10.2","6.9"
"Gordon","2020-04-04","6","240","0","31","6.3","6.9"
"Gordon","2020-04-05","2","242","0","31","6.3","5.1"
"Gordon","2020-04-06","12","254","1","32","7.5","5.7"
"Gordon","2020-04-07","7","261","0","32","6.4","5.7"
"Gordon","2020-04-08","29","290","11","43","8.7","8.4"
"Gordon","2020-04-09","8","298","2","45","12.2","10.2"
"Gordon","2020-04-10","9","307","2","47","13.4","11.8"
"Gordon","2020-04-11","6","313","0","47","13.4","9.8"
"Gordon","2020-04-12","6","319","1","48","15.7","11"
"Gordon","2020-04-13","10","329","0","48","14.5","11"
"Gordon","2020-04-14","20","349","3","51","16.7","11.5"
"Gordon","2020-04-15","37","386","7","58","14","11.3"
"Gordon","2020-04-16","24","410","3","61","12.2","12.2"
"Gordon","2020-04-17","35","445","2","63","9.8","11.6"
"Gordon","2020-04-18","8","453","2","65","13.4","13.4"
"Gordon","2020-04-19","4","457","1","66","14.6","15.2"
"Gordon","2020-04-20","32","489","2","68","15.5","15"
"Gordon","2020-04-21","29","518","4","72","15.3","16"
"Gordon","2020-04-22","32","550","3","75","13.9","14"
"Gordon","2020-04-23","23","573","2","77","13.4","12.8"
"Gordon","2020-04-24","145","718","1","78","12.7","11.3"
"Gordon","2020-04-25","116","834","2","80","9.4","11.4"
"Gordon","2020-04-26","32","866","0","80","5.8","10.2"
"Gordon","2020-04-27","199","1065","0","80","4.9","10.2"
"Gordon","2020-04-28","65","1130","5","85","4","9.7"
"Gordon","2020-04-29","127","1257","3","88","3","8.5"
"Gordon","2020-04-30","143","1400","32","120","5","9.2"
"Gordon","2020-05-01","71","1471","1","121","5.1","8.9"
"Gordon","2020-05-02","16","1487","1","122","5.7","7.5"
"Gordon","2020-05-03","8","1495","0","122","5.7","5.8"
"Gordon","2020-05-04","27","1522","0","122","5.7","5.3"
"Gordon","2020-05-05","33","1555","3","125","5.9","5"
"Gordon","2020-05-06","32","1587","1","126","6","4.5"
"Gordon","2020-05-07","16","1603","0","126","2.8","3.9"
"Gordon","2020-05-08","30","1633","3","129","4.1","4.6"
"Gordon","2020-05-09","27","1660","1","130","3.7","4.7"
"Gordon","2020-05-10","11","1671","1","131","5","5.4"
"Gordon","2020-05-11","54","1725","1","132","5.3","5.5"
"Gordon","2020-05-12","48","1773","1","133","4.3","5.1"
"Gordon","2020-05-13","44","1817","2","135","4.5","5.3"
"Gordon","2020-05-14","29","1846","2","137","5.5","4.1"
"Gordon","2020-05-15","28","1874","0","137","4","4"
"Gordon","2020-05-16","16","1890","0","137","3.5","3.6"
"Gordon","2020-05-17","6","1896","0","137","2.2","3.6"
"Gordon","2020-05-18","32","1928","1","138","2.4","3.8"
"Gordon","2020-05-19","61","1989","0","138","2.1","3.2"
"Gordon","2020-05-20","39","2028","1","139","1.8","3.1"
"Gordon","2020-05-21","42","2070","3","142","1.8","3.6"
"Gordon","2020-05-22","35","2105","3","145","3.1","3.5"
"Gordon","2020-05-23","21","2126","0","145","3.1","3.3"
"Gordon","2020-05-24","12","2138","1","146","4.2","3.2"
"Gordon","2020-05-25","10","2148","1","147","5.2","3.8"
"Gordon","2020-05-26","63","2211","4","151","6.1","4.1"
"Gordon","2020-05-27","54","2265","1","152","6","3.9"
"Gordon","2020-05-28","40","2305","7","159","7.5","4.7"
"Gordon","2020-05-29","51","2356","4","163","7.4","5.2"
"Gordon","2020-05-30","22","2378","1","164","8.1","5.6"
"Gordon","2020-05-31","16","2394","1","165","7.8","6"
"Gordon","2020-06-01","76","2470","3","168","6.9","6.1"
"Gordon","2020-06-02","62","2532","1","169","6.2","6.2"
"Gordon","2020-06-03","74","2606","8","177","7.5","6.8"
"Gordon","2020-06-04","61","2667","3","180","5.7","6.6"
"Gordon","2020-06-05","64","2731","6","186","5.9","6.7"
"Gordon","2020-06-06","18","2749","2","188","6.9","7.5"
"Gordon","2020-06-07","11","2760","2","190","8.6","8.2"
"Gordon","2020-06-08","65","2825","9","199","10","8.4"
"Gordon","2020-06-09","83","2908","4","203","10.4","8.3"
"Gordon","2020-06-10","46","2954","5","208","10.4","9"
"Gordon","2020-06-11","59","3013","2","210","10.2","8"
"Gordon","2020-06-12","42","3055","3","213","9.9","7.9"
"Gordon","2020-06-13","21","3076","2","215","9.7","8.3"
"Gordon","2020-06-14","10","3086","2","217","9.9","9.3"
"Gordon","2020-06-15","30","3116","5","222","10.3","10.2"
"Gordon","2020-06-16","79","3195","3","225","10.2","10.3"
"Gordon","2020-06-17","91","3286","7","232","9.7","10.1"
"Gordon","2020-06-18","42","3328","1","233","9.6","9.9"
"Gordon","2020-06-19","57","3385","5","238","9.8","9.9"
"Gordon","2020-06-20","15","3400","0","238","8.5","9.1"
"Gordon","2020-06-21","20","3420","6","244","9.9","9.9"
"Gordon","2020-06-22","47","3467","5","249","9","9.7"
"Gordon","2020-06-23","85","3552","8","257","9.8","10"
"Gordon","2020-06-24","63","3615","8","265","10.6","10.2"
"Gordon","2020-06-25","53","3668","6","271","11.8","10.7"
"Gordon","2020-06-26","58","3726","5","276","11.8","10.8"
"Gordon","2020-06-27","20","3746","3","279","14","11.2"
"Gordon","2020-06-28","24","3770","6","285","13.2","11.6"
"Gordon","2020-06-29","60","3830","10","295","14.1","11.6"
"Gordon","2020-06-30","63","3893","9","304","14.8","12.3"
"Gordon","2020-07-01","55","3948","8","312","15.1","12.8"
"Gordon","2020-07-02","63","4011","4","316","14.4","13.1"
"Gordon","2020-07-03","39","4050","4","320","14.6","13.2"
"Gordon","2020-07-04","15","4065","2","322","14.3","14.2"
"Gordon","2020-07-05","16","4081","3","325","13.5","13.3"
"Gordon","2020-07-06","221","4302","21","346","12.4","13.3"
"Gordon","2020-07-07","192","4494","18","364","11.7","13.3"
"Gordon","2020-07-08","197","4691","15","379","10.7","12.9"
"Gordon","2020-07-09","180","4871","27","406","12","13.2"
"Gordon","2020-07-10","136","5007","17","423","12.3","13.4"
"Gordon","2020-07-11","27","5034","4","427","12.5","13.4"
"Gordon","2020-07-12","25","5059","7","434","13.8","13.6"
"Gordon","2020-07-13","105","5164","23","457","15.6","14"
"Gordon","2020-07-14","101","5265","14","471","16.2","14"
"Gordon","2020-07-15","79","5344","16","487","18","14.4"
"Gordon","2020-07-16","92","5436","14","501","18.1","15"
"Gordon","2020-07-17","84","5520","12","513","18.3","15.3"
"Gordon","2020-07-18","57","5577","18","531","20.7","16.6"
"Gordon","2020-07-19","21","5598","3","534","18.8","16.3"
"Gordon","2020-07-20","222","5820","44","578","18.5","17"
"Gordon","2020-07-21","124","5944","24","602","19.3","17.7"
"Gordon","2020-07-22","134","6078","25","627","19","18.5"
"Gordon","2020-07-23","207","6285","31","658","19","18.5"
"Gordon","2020-07-24","192","6477","26","684","18.9","18.6"
"Gordon","2020-07-25","60","6537","17","701","18.4","19.6"
"Gordon","2020-07-26","22","6559","5","706","19.6","19.2"
"Gordon","2020-07-27","225","6784","26","732","18.4","18.5"
"Gordon","2020-07-28","212","6996","39","771","18.3","18.8"
"Gordon","2020-07-29","173","7169","31","802","18.2","18.6"
"Gordon","2020-07-30","177","7346","23","825","17.9","18.5"
"Gordon","2020-07-31","175","7521","24","849","17.9","18.4"
"Gordon","2020-08-01","39","7560","8","857","16.8","17.6"
"Gordon","2020-08-02","29","7589","7","864","17","18.3"
"Gordon","2020-08-03","187","7776","19","883","16.8","17.6"
"Gordon","2020-08-04","306","8082","36","919","15.9","17.1"
"Gordon","2020-08-05","275","8357","44","963","15.6","16.9"
"Gordon","2020-08-06","137","8494","10","973","14.8","16.4"
"Gordon","2020-08-07","174","8668","16","989","14.2","16.1"
"Gordon","2020-08-08","33","8701","6","995","13.8","15.3"
"Gordon","2020-08-09","29","8730","6","1001","13.3","15.2"
"Gordon","2020-08-10","209","8939","23","1024","13.4","15.1"
"Gordon","2020-08-11","199","9138","16","1040","12.9","14.4"
"Gordon","2020-08-12","168","9306","10","1050","11.5","13.5"
"Gordon","2020-08-13","166","9472","13","1063","11.6","13.2"
"Gordon","2020-08-14","170","9642","12","1075","11.3","12.7"
"Gordon","2020-08-15","44","9686","3","1078","9.6","11.7"
"Gordon","2020-08-16","35","9721","9","1087","10.3","11.8"
"Gordon","2020-08-17","89","9810","17","1104","11.5","12.5"
"Gordon","2020-08-18","234","10044","15","1119","11.3","12.1"
"Gordon","2020-08-19","188","10232","10","1129","11.2","11.3"
"Gordon","2020-08-20","193","10425","6","1135","10.5","11"
"Gordon","2020-08-21","189","10614","11","1146","10.3","10.8"
"Gordon","2020-08-22","58","10672","3","1149","10.1","9.9"
"Gordon","2020-08-23","23","10695","6","1155","10.1","10.2"
"Gordon","2020-08-24","171","10866","11","1166","8.3","9.9"
"Gordon","2020-08-25","242","11108","11","1177","8.1","9.7"
"Gordon","2020-08-26","173","11281","11","1188","8.2","9.7"
"Gordon","2020-08-27","170","11451","16","1204","9.1","9.8"
"Gordon","2020-08-28","165","11616","18","1222","9.8","10.1"
"Gordon","2020-08-29","35","11651","2","1224","9.9","10"
"Gordon","2020-08-30","18","11669","5","1229","10.2","10.2"
"Gordon","2020-08-31","157","11826","13","1242","10.4","9.4"
"Gordon","2020-09-01","243","12069","14","1256","10.6","9.3"
"Gordon","2020-09-02","202","12271","11","1267","10.5","9.3"
"Gordon","2020-09-03","78","12349","8","1275","10.6","9.9"
"Gordon","2020-09-04","96","12445","8","1283","10.2","10"
"Gordon","2020-09-05","52","12497","4","1287","10.5","10.2"
"Gordon","2020-09-06","19","12516","2","1289","8","9.1"
"Gordon","2020-09-07","23","12539","4","1293","9.3","9.9"
"Gordon","2020-09-08","227","12766","31","1324","10.5","10.5"
"Gordon","2020-09-09","174","12940","17","1341","11.1","10.8"
"Gordon","2020-09-10","112","13052","10","1351","10.9","10.7"
"Gordon","2020-09-11","127","13179","8","1359","10.6","10.4"
"Gordon","2020-09-12","25","13204","2","1361","10.7","10.6"
"Gordon","2020-09-13","29","13233","4","1365","11.1","9.6"
"Gordon","2020-09-14","115","13348","8","1373","9.6","9.5"
"Gordon","2020-09-15","276","13624","19","1392","8.7","9.6"
"Gordon","2020-09-16","186","13810","13","1405","8.3","9.7"
"Gordon","2020-09-17","116","13926","4","1409","7.5","9.2"
"Gordon","2020-09-18","118","14044","4","1413","7.1","8.8"
"Gordon","2020-09-19","58","14102","5","1418","7.2","8.9"
"Gordon","2020-09-20","19","14121","4","1422","8.2","9.7"
"Gordon","2020-09-21","85","14206","8","1430","8.5","9.1"
"Gordon","2020-09-22","294","14500","18","1448","8.4","8.5"
"Gordon","2020-09-23","157","14657","13","1461","8.6","8.4"
"Gordon","2020-09-24","90","14747","5","1466","8.9","8.2"
"Gordon","2020-09-25","90","14837","6","1472","9.4","8.2"
"Gordon","2020-09-26","48","14885","10","1482","11.1","9.1"
"Gordon","2020-09-27","24","14909","2","1484","9.3","8.8"
"Gordon","2020-09-28","91","15000","11","1495","9.7","9.1"
"Gordon","2020-09-29","244","15244","12","1507","9.5","9"
"Gordon","2020-09-30","142","15386","9","1516","9.2","8.9"
"Gordon","2020-10-01","78","15464","6","1522","9.6","9.2"
"Gordon","2020-10-02","93","15557","4","1526","9.2","9.3"
"Gordon","2020-10-03","60","15617","2","1528","6.7","8.9"
"Gordon","2020-10-04","24","15641","0","1528","5.5","7.4"
"Gordon","2020-10-05","93","15734","6","1534","4.7","7.2"
"Gordon","2020-10-06","258","15992","27","1561","5.5","7.5"
"Gordon","2020-10-07","181","16173","12","1573","5.6","7.4"
"Gordon","2020-10-08","143","16316","19","1592","6.4","8"
"Gordon","2020-10-09","122","16438","17","1609","7.7","8.5"
"Gordon","2020-10-10","99","16537","17","1626","9.7","8.2"
"Gordon","2020-10-11","43","16580","8","1634","12.4","8.9"
"Gordon","2020-10-12","138","16718","27","1661","14.2","9.5"
"Gordon","2020-10-13","362","17080","44","1705","14.5","10"
"Gordon","2020-10-14","266","17346","36","1741","15.5","10.5"
"Gordon","2020-10-15","109","17455","14","1755","15.4","10.9"
"Gordon","2020-10-16","152","17607","18","1773","15.1","11.4"
"Gordon","2020-10-17","71","17678","15","1788","15.7","12.7"
"Gordon","2020-10-18","37","17715","13","1801","18","15.2"
"Gordon","2020-10-19","107","17822","20","1821","17.9","16.1"
"Gordon","2020-10-20","386","18208","50","1871","18","16.2"
"Gordon","2020-10-21","263","18471","34","1905","17.9","16.7"
"Gordon","2020-10-22","112","18583","18","1923","18.4","16.9"
"Gordon","2020-10-23","138","18721","15","1938","18.3","16.7"
"Gordon","2020-10-24","67","18788","12","1950","17.8","16.7"
"Gordon","2020-10-25","51","18839","9","1959","15.3","16.7"
"Gordon","2020-10-26","125","18964","19","1978","14.8","16.4"
"Gordon","2020-10-27","346","19310","33","2011","14.3","16.2"
"Gordon","2020-10-28","276","19586","30","2041","14","16"
"Gordon","2020-10-29","157","19743","24","2065","13.9","16.1"
"Gordon","2020-10-30","118","19861","6","2071","13.1","15.7"
"Gordon","2020-10-31","56","19917","9","2080","12.8","15.3"
"Gordon","2020-11-01","37","19954","5","2085","12.2","13.8"
"Gordon","2020-11-02","114","20068","16","2101","12.1","13.4"
"Gordon","2020-11-03","245","20313","23","2124","12","13.2"
"Gordon","2020-11-04","209","20522","22","2146","12","13"
"Gordon","2020-11-05","122","20644","7","2153","10.6","12.3"
"Gordon","2020-11-06","134","20778","10","2163","11","12"
"Gordon","2020-11-07","71","20849","11","2174","10.9","11.8"
"Gordon","2020-11-08","40","20889","7","2181","11.4","11.8"
"Gordon","2020-11-09","137","21026","27","2208","12.3","12.2"
"Gordon","2020-11-10","275","21301","56","2264","13.8","12.9"
"Gordon","2020-11-11","242","21543","36","2300","14.4","13.2"
"Gordon","2020-11-12","153","21696","15","2315","15","12.8"
"Gordon","2020-11-13","134","21830","12","2327","15.2","13.1"
"Gordon","2020-11-14","113","21943","14","2341","14.8","12.8"
"Gordon","2020-11-15","44","21987","12","2353","16.2","13.8"
"Gordon","2020-11-16","116","22103","23","2376","16.2","14.2"
"Gordon","2020-11-17","396","22499","61","2437","15.5","14.7"
"Gordon","2020-11-18","280","22779","43","2480","15.6","15"
"Gordon","2020-11-19","115","22894","14","2494","15.9","15.5"
"Gordon","2020-11-20","158","23052","17","2511","16.2","15.7"
"Gordon","2020-11-21","68","23120","13","2524","17.1","16"
"Gordon","2020-11-22","57","23177","8","2532","15.2","15.7"
"Gordon","2020-11-23","121","23298","14","2546","14.1","15.1"
"Gordon","2020-11-24","452","23750","69","2615","14","14.8"
"Gordon","2020-11-25","332","24082","51","2666","14","14.8"
"Gordon","2020-11-26","25","24107","2","2668","13.4","14.7"
"Gordon","2020-11-27","73","24180","17","2685","15.2","15.7"
"Gordon","2020-11-28","82","24262","13","2698","14.8","15.9"
"Gordon","2020-11-29","55","24317","12","2710","15.9","15.6"
"Gordon","2020-11-30","163","24480","24","2734","16.3","15.2"
"Gordon","2020-12-01","355","24835","43","2777","15.9","15"
"Gordon","2020-12-02","300","25135","45","2822","15.8","14.9"
"Gordon","2020-12-03","168","25303","25","2847","16.8","15.1"
"Gordon","2020-12-04","180","25483","22","2869","15.2","15.2"
"Gordon","2020-12-05","59","25542","11","2880","15.6","15.2"
"Gordon","2020-12-06","63","25605","13","2893","15.5","15.7"
"Gordon","2020-12-07","164","25769","29","2922","15.9","16.1"
"Gordon","2020-12-08","390","26159","52","2974","16.1","16"
"Gordon","2020-12-09","336","26495","34","3008","15.4","15.6"
"Gordon","2020-12-10","170","26665","16","3024","14.6","15.7"
"Gordon","2020-12-11","127","26792","23","3047","15.4","15.3"
"Gordon","2020-12-12","86","26878","14","3061","15.1","15.4"
"Gordon","2020-12-13","56","26934","13","3074","15.5","15.5"
"Gordon","2020-12-14","130","27064","18","3092","14.9","15.4"
"Gordon","2020-12-15","453","27517","50","3142","14.6","15.3"
"Gordon","2020-12-16","396","27913","63","3205","15.4","15.4"
"Gordon","2020-12-17","106","28019","15","3220","16.1","15.3"
"Gordon","2020-12-18","121","28140","21","3241","16","15.7"
"Gordon","2020-12-19","70","28210","14","3255","16.5","15.8"
"Gordon","2020-12-20","53","28263","16","3271","17.5","16.5"
"Gordon","2020-12-21","125","28388","18","3289","17.6","16.2"
"Gordon","2020-12-22","457","28845","70","3359","18.2","16.4"
"Gordon","2020-12-23","333","29178","55","3414","18.3","16.8"
"Gordon","2020-12-24","50","29228","8","3422","18.5","17.3"
"Gordon","2020-12-25","31","29259","13","3435","22.1","19"
"Gordon","2020-12-26","71","29330","21","3456","23.4","20"
"Gordon","2020-12-27","79","29409","24","3480","23.4","20.5"
"Gordon","2020-12-28","174","29583","39","3519","24.6","21.1"
"Gordon","2020-12-29","530","30113","102","3621","25.2","21.7"
"Gordon","2020-12-30","394","30507","72","3693","25.4","21.8"
"Gordon","2020-12-31","97","30604","19","3712","25.9","22.2"
"Gordon","2021-01-01","42","30646","25","3737","28.4","25.2"
"Gordon","2021-01-02","60","30706","15","3752","27.8","25.6"
"Gordon","2021-01-03","52","30758","14","3766","27.3","25.4"
"Gordon","2021-01-04","78","30836","15","3781","26.8","25.7"
"Gordon","2021-01-05","642","31478","121","3902","26.8","26"
"Gordon","2021-01-06","399","31877","52","3954","26","25.7"
"Gordon","2021-01-07","123","32000","18","3972","25.3","25.6"
"Gordon","2021-01-08","128","32128","19","3991","18.9","23.7"
"Gordon","2021-01-09","72","32200","26","4017","20.5","24.1"
"Gordon","2021-01-10","69","32269","20","4037","20.8","24"
"Gordon","2021-01-11","121","32390","24","4061","20.9","23.9"
"Gordon","2021-01-12","440","32830","66","4127","20.3","23.6"
"Gordon","2021-01-13","429","33259","56","4183","20.4","23.2"
"Gordon","2021-01-14","116","33375","19","4202","20.6","23"
"Gordon","2021-01-15","127","33502","25","4227","21.3","20.1"
"Gordon","2021-01-16","79","33581","13","4240","18.5","19.5"
"Gordon","2021-01-17","47","33628","10","4250","17.4","19.1"
"Gordon","2021-01-18","121","33749","24","4274","17.4","19.1"
"Gordon","2021-01-19","448","34197","58","4332","17.1","18.7"
"Gordon","2021-01-20","134","34331","20","4352","17.4","18.9"
"Gordon","2021-01-21","112","34443","11","4363","16.4","18.5"
"Gordon","2021-01-22","125","34568","16","4379","15.4","18.4"
"Gordon","2021-01-23","70","34638","11","4390","15.3","16.9"
"Gordon","2021-01-24","70","34708","17","4407","15.8","16.6"
"Gordon","2021-01-25","121","34829","23","4430","15.6","16.5"
"Gordon","2021-01-26","400","35229","64","4494","16.1","16.6"
"Gordon","2021-01-27","112","35341","14","4508","15.7","16.5"
"Gordon","2021-01-28","112","35453","16","4524","16.4","16.4"
"Gordon","2021-01-29","125","35578","14","4538","16.1","15.8"
"Gordon","2021-01-30","48","35626","9","4547","16.6","16"
"Gordon","2021-01-31","37","35663","5","4552","15","15.4"
"Gordon","2021-02-01","133","35796","22","4574","14.7","15.2"
"Gordon","2021-02-02","148","35944","13","4587","13.7","14.9"
"Gordon","2021-02-03","112","36056","15","4602","13.8","14.8"
"Gordon","2021-02-04","81","36137","10","4612","13.5","14.9"
"Gordon","2021-02-05","55","36192","4","4616","12.9","14.5"
"Gordon","2021-02-06","16","36208","5","4621","14.7","15.7"
"Gordon","2021-02-07","1","36209","0","4621","12.8","13.9"
"Gordon","2021-02-08","0","36209","0","4621","10.4","12.6"
"Grady","2020-02-01","0","0","0","0",".","."
"Grady","2020-02-02","0","0","0","0",".","."
"Grady","2020-02-03","0","0","0","0",".","."
"Grady","2020-02-04","0","0","0","0",".","."
"Grady","2020-02-05","0","0","0","0",".","."
"Grady","2020-02-06","0","0","0","0",".","."
"Grady","2020-02-07","0","0","0","0","0","."
"Grady","2020-02-08","0","0","0","0","0","."
"Grady","2020-02-09","0","0","0","0","0","."
"Grady","2020-02-10","0","0","0","0","0","."
"Grady","2020-02-11","0","0","0","0","0","."
"Grady","2020-02-12","0","0","0","0","0","."
"Grady","2020-02-13","0","0","0","0","0","."
"Grady","2020-02-14","0","0","0","0","0","0"
"Grady","2020-02-15","0","0","0","0","0","0"
"Grady","2020-02-16","0","0","0","0","0","0"
"Grady","2020-02-17","0","0","0","0","0","0"
"Grady","2020-02-18","0","0","0","0","0","0"
"Grady","2020-02-19","0","0","0","0","0","0"
"Grady","2020-02-20","0","0","0","0","0","0"
"Grady","2020-02-21","0","0","0","0","0","0"
"Grady","2020-02-22","0","0","0","0","0","0"
"Grady","2020-02-23","0","0","0","0","0","0"
"Grady","2020-02-24","0","0","0","0","0","0"
"Grady","2020-02-25","0","0","0","0","0","0"
"Grady","2020-02-26","0","0","0","0","0","0"
"Grady","2020-02-27","0","0","0","0","0","0"
"Grady","2020-02-28","0","0","0","0","0","0"
"Grady","2020-02-29","0","0","0","0","0","0"
"Grady","2020-03-01","0","0","0","0","0","0"
"Grady","2020-03-02","0","0","0","0","0","0"
"Grady","2020-03-03","0","0","0","0","0","0"
"Grady","2020-03-04","0","0","0","0","0","0"
"Grady","2020-03-05","0","0","0","0","0","0"
"Grady","2020-03-06","0","0","0","0","0","0"
"Grady","2020-03-07","0","0","0","0","0","0"
"Grady","2020-03-08","0","0","0","0","0","0"
"Grady","2020-03-09","0","0","0","0","0","0"
"Grady","2020-03-10","0","0","0","0","0","0"
"Grady","2020-03-11","0","0","0","0","0","0"
"Grady","2020-03-12","0","0","0","0","0","0"
"Grady","2020-03-13","0","0","0","0","0","0"
"Grady","2020-03-14","0","0","0","0","0","0"
"Grady","2020-03-15","0","0","0","0","0","0"
"Grady","2020-03-16","1","1","0","0","0","0"
"Grady","2020-03-17","1","2","0","0","0","0"
"Grady","2020-03-18","0","2","0","0","0","0"
"Grady","2020-03-19","2","4","0","0","0","0"
"Grady","2020-03-20","2","6","0","0","0","0"
"Grady","2020-03-21","0","6","0","0","0","0"
"Grady","2020-03-22","0","6","0","0","0","0"
"Grady","2020-03-23","2","8","0","0","0","0"
"Grady","2020-03-24","0","8","0","0","0","0"
"Grady","2020-03-25","1","9","0","0","0","0"
"Grady","2020-03-26","3","12","0","0","0","0"
"Grady","2020-03-27","0","12","0","0","0","0"
"Grady","2020-03-28","0","12","0","0","0","0"
"Grady","2020-03-29","3","15","3","3","14.3","7.1"
"Grady","2020-03-30","3","18","2","5","23.8","11.9"
"Grady","2020-03-31","10","28","4","9","29.5","14.8"
"Grady","2020-04-01","3","31","2","11","39","19.5"
"Grady","2020-04-02","4","35","3","14","49.8","24.9"
"Grady","2020-04-03","6","41","3","17","56.9","28.5"
"Grady","2020-04-04","2","43","2","19","71.2","35.6"
"Grady","2020-04-05","1","44","1","20","71.2","42.7"
"Grady","2020-04-06","3","47","2","22","71.2","47.5"
"Grady","2020-04-07","7","54","5","27","75.7","52.6"
"Grady","2020-04-08","6","60","3","30","73.3","56.2"
"Grady","2020-04-09","24","84","10","40","68.5","59.1"
"Grady","2020-04-10","4","88","2","42","68.5","62.7"
"Grady","2020-04-11","1","89","0","42","54.3","62.7"
"Grady","2020-04-12","3","92","3","45","54.3","62.7"
"Grady","2020-04-13","3","95","2","47","54.3","62.7"
"Grady","2020-04-14","25","120","6","53","47.5","61.6"
"Grady","2020-04-15","3","123","1","54","45.1","59.2"
"Grady","2020-04-16","5","128","3","57","47.7","58.1"
"Grady","2020-04-17","4","132","4","61","54.9","61.7"
"Grady","2020-04-18","2","134","1","62","62","58.1"
"Grady","2020-04-19","0","134","0","62","47.7","51"
"Grady","2020-04-20","1","135","1","63","52.5","53.4"
"Grady","2020-04-21","0","135","0","63","49","48.3"
"Grady","2020-04-22","3","138","1","64","49","47.1"
"Grady","2020-04-23","1","139","0","64","40.5","44.1"
"Grady","2020-04-24","4","143","2","66","33.3","44.1"
"Grady","2020-04-25","1","144","1","67","40.5","51.2"
"Grady","2020-04-26","0","144","0","67","40.5","44.1"
"Grady","2020-04-27","6","150","1","68","28.6","40.5"
"Grady","2020-04-28","3","153","1","69","33.3","41.2"
"Grady","2020-04-29","1","154","0","69","28.6","38.8"
"Grady","2020-04-30","3","157","0","69","28.6","34.5"
"Grady","2020-05-01","2","159","0","69","21.4","27.4"
"Grady","2020-05-02","48","207","0","69","7.1","23.8"
"Grady","2020-05-03","1","208","1","70","21.4","31"
"Grady","2020-05-04","2","210","2","72","33.3","31"
"Grady","2020-05-05","4","214","2","74","35.7","34.5"
"Grady","2020-05-06","1","215","0","74","35.7","32.1"
"Grady","2020-05-07","4","219","2","76","42.9","35.7"
"Grady","2020-05-08","0","219","0","76","42.9","32.1"
"Grady","2020-05-09","0","219","0","76","42.9","25"
"Grady","2020-05-10","100","319","4","80","29.1","25.3"
"Grady","2020-05-11","2","321","0","80","14.9","24.1"
"Grady","2020-05-12","93","414","3","83","8.2","21.9"
"Grady","2020-05-13","1","415","0","83","8.2","21.9"
"Grady","2020-05-14","5","420","0","83","1","21.9"
"Grady","2020-05-15","3","423","2","85","10.6","26.7"
"Grady","2020-05-16","3","426","2","87","20.1","31.5"
"Grady","2020-05-17","0","426","0","87","19.5","24.3"
"Grady","2020-05-18","2","428","0","87","19.5","17.2"
"Grady","2020-05-19","28","456","3","90","20.6","14.4"
"Grady","2020-05-20","6","462","0","90","20.6","14.4"
"Grady","2020-05-21","32","494","4","94","22.4","11.7"
"Grady","2020-05-22","11","505","0","94","12.8","11.7"
"Grady","2020-05-23","49","554","6","100","5.1","12.6"
"Grady","2020-05-24","1","555","0","100","5.1","12.3"
"Grady","2020-05-25","2","557","0","100","5.1","12.3"
"Grady","2020-05-26","30","587","9","109","7.8","14.2"
"Grady","2020-05-27","0","587","0","109","7.8","14.2"
"Grady","2020-05-28","53","640","6","115","7.7","15"
"Grady","2020-05-29","4","644","3","118","18.4","15.6"
"Grady","2020-05-30","1","645","0","118","16.6","10.8"
"Grady","2020-05-31","53","698","1","119","16.9","11"
"Grady","2020-06-01","8","706","2","121","20.5","12.8"
"Grady","2020-06-02","55","761","6","127","17.7","12.8"
"Grady","2020-06-03","33","794","1","128","18.2","13"
"Grady","2020-06-04","14","808","0","128","16.5","12.1"
"Grady","2020-06-05","59","867","0","128","5.8","12.1"
"Grady","2020-06-06","8","875","0","128","5.8","11.2"
"Grady","2020-06-07","6","881","0","128","5.6","11.2"
"Grady","2020-06-08","52","933","3","131","2.8","11.6"
"Grady","2020-06-09","25","958","0","131","1.3","9.5"
"Grady","2020-06-10","17","975","1","132","1.7","9.9"
"Grady","2020-06-11","18","993","0","132","1.7","9.1"
"Grady","2020-06-12","23","1016","1","133","2.3","4.1"
"Grady","2020-06-13","2","1018","0","133","2.3","4.1"
"Grady","2020-06-14","8","1026","2","135","5.9","5.7"
"Grady","2020-06-15","31","1057","0","135","5","3.9"
"Grady","2020-06-16","12","1069","1","136","6.2","3.7"
"Grady","2020-06-17","22","1091","1","137","6","3.8"
"Grady","2020-06-18","10","1101","0","137","6","3.8"
"Grady","2020-06-19","32","1133","3","140","6.8","4.5"
"Grady","2020-06-20","7","1140","0","140","6.8","4.5"
"Grady","2020-06-21","2","1142","0","140","3.2","4.5"
"Grady","2020-06-22","30","1172","0","140","3.2","4.1"
"Grady","2020-06-23","12","1184","0","140","2","4.1"
"Grady","2020-06-24","25","1209","1","141","1.9","4"
"Grady","2020-06-25","28","1237","3","144","3.4","4.7"
"Grady","2020-06-26","26","1263","3","147","3.8","5.3"
"Grady","2020-06-27","4","1267","0","147","3.8","5.3"
"Grady","2020-06-28","3","1270","0","147","3.8","3.5"
"Grady","2020-06-29","26","1296","0","147","3.8","3.5"
"Grady","2020-06-30","24","1320","0","147","3.8","2.9"
"Grady","2020-07-01","16","1336","1","148","4.1","3"
"Grady","2020-07-02","23","1359","1","149","3.2","3.3"
"Grady","2020-07-03","13","1372","0","149","1.5","2.6"
"Grady","2020-07-04","7","1379","0","149","1.5","2.6"
"Grady","2020-07-05","19","1398","1","150","2.3","3"
"Grady","2020-07-06","25","1423","2","152","3.4","3.6"
"Grady","2020-07-07","37","1460","2","154","4.2","4"
"Grady","2020-07-08","51","1511","3","157","4.1","4.1"
"Grady","2020-07-09","37","1548","1","158","3.9","3.5"
"Grady","2020-07-10","32","1580","4","162","5.7","3.6"
"Grady","2020-07-11","5","1585","0","162","5.7","3.6"
"Grady","2020-07-12","6","1591","2","164","9.7","6"
"Grady","2020-07-13","22","1613","4","168","11.1","7.3"
"Grady","2020-07-14","32","1645","14","182","16.6","10.4"
"Grady","2020-07-15","25","1670","1","183","16.4","10.2"
"Grady","2020-07-16","27","1697","3","186","17.6","10.7"
"Grady","2020-07-17","35","1732","5","191","17.8","11.7"
"Grady","2020-07-18","6","1738","2","193","22.6","14.1"
"Grady","2020-07-19","5","1743","1","194","20.7","15.2"
"Grady","2020-07-20","39","1782","8","202","21","16.1"
"Grady","2020-07-21","26","1808","3","205","16.4","16.5"
"Grady","2020-07-22","27","1835","4","209","17.9","17.1"
"Grady","2020-07-23","28","1863","2","211","17.4","17.5"
"Grady","2020-07-24","28","1891","3","214","16.9","17.3"
"Grady","2020-07-25","16","1907","5","219","16.6","19.6"
"Grady","2020-07-26","1","1908","1","220","28","24.3"
"Grady","2020-07-27","35","1943","2","222","25.9","23.4"
"Grady","2020-07-28","39","1982","10","232","27.9","22.1"
"Grady","2020-07-29","19","2001","3","235","28","23"
"Grady","2020-07-30","33","2034","7","242","30","23.7"
"Grady","2020-07-31","35","2069","11","253","33","24.9"
"Grady","2020-08-01","12","2081","5","258","34.5","25.5"
"Grady","2020-08-02","4","2085","1","259","23.8","25.9"
"Grady","2020-08-03","31","2116","3","262","24.3","25.1"
"Grady","2020-08-04","35","2151","8","270","23.9","25.9"
"Grady","2020-08-05","43","2194","3","273","22.7","25.4"
"Grady","2020-08-06","27","2221","4","277","21.8","25.9"
"Grady","2020-08-07","27","2248","6","283","20.5","26.7"
"Grady","2020-08-08","16","2264","4","287","18.1","26.3"
"Grady","2020-08-09","20","2284","4","291","17.4","20.6"
"Grady","2020-08-10","26","2310","3","294","17.6","21"
"Grady","2020-08-11","27","2337","4","298","16.5","20.2"
"Grady","2020-08-12","26","2363","1","299","16","19.4"
"Grady","2020-08-13","21","2384","4","303","16.6","19.2"
"Grady","2020-08-14","57","2441","11","314","16.2","18.3"
"Grady","2020-08-15","7","2448","2","316","16.7","17.4"
"Grady","2020-08-16","10","2458","2","318","16.7","17"
"Grady","2020-08-17","24","2482","3","321","16.9","17.2"
"Grady","2020-08-18","26","2508","7","328","18.6","17.5"
"Grady","2020-08-19","24","2532","4","332","20.4","18.2"
"Grady","2020-08-20","22","2554","2","334","19","17.8"
"Grady","2020-08-21","26","2580","3","337","17.9","17.1"
"Grady","2020-08-22","5","2585","2","339","19.5","18.1"
"Grady","2020-08-23","10","2595","2","341","19.5","18.1"
"Grady","2020-08-24","18","2613","2","343","19.3","18.1"
"Grady","2020-08-25","18","2631","7","350","21","19.8"
"Grady","2020-08-26","19","2650","3","353","20.9","20.7"
"Grady","2020-08-27","18","2668","5","358","23.6","21.3"
"Grady","2020-08-28","11","2679","0","358","21.9","19.9"
"Grady","2020-08-29","3","2682","1","359","21","20.3"
"Grady","2020-08-30","4","2686","1","360","21.7","20.6"
"Grady","2020-08-31","18","2704","1","361","20.9","20.1"
"Grady","2020-09-01","20","2724","3","364","17.5","19.3"
"Grady","2020-09-02","27","2751","6","370","18.4","19.7"
"Grady","2020-09-03","26","2777","4","374","16.6","20.1"
"Grady","2020-09-04","8","2785","1","375","18.4","20.2"
"Grady","2020-09-05","3","2788","0","375","13.7","17.3"
"Grady","2020-09-06","6","2794","2","377","14.9","18.3"
"Grady","2020-09-07","9","2803","3","380","18.8","19.9"
"Grady","2020-09-08","25","2828","2","382","17.8","17.7"
"Grady","2020-09-09","16","2844","1","383","15.5","17"
"Grady","2020-09-10","17","2861","4","387","16.7","16.7"
"Grady","2020-09-11","14","2875","3","390","18","18.2"
"Grady","2020-09-12","9","2884","1","391","19.6","16.6"
"Grady","2020-09-13","8","2892","0","391","14.8","14.8"
"Grady","2020-09-14","43","2935","8","399","12.7","15.8"
"Grady","2020-09-15","17","2952","2","401","13.2","15.5"
"Grady","2020-09-16","32","2984","1","402","12.8","14.2"
"Grady","2020-09-17","24","3008","2","404","10.6","13.7"
"Grady","2020-09-18","19","3027","0","404","7.6","12.8"
"Grady","2020-09-19","6","3033","0","404","6","12.8"
"Grady","2020-09-20","4","3037","1","405","9.5","12.2"
"Grady","2020-09-21","35","3072","0","405","6.9","9.8"
"Grady","2020-09-22","25","3097","2","407","6.4","9.8"
"Grady","2020-09-23","27","3124","3","410","7.5","10.1"
"Grady","2020-09-24","29","3153","0","410","6.3","8.5"
"Grady","2020-09-25","14","3167","1","411","7.3","7.4"
"Grady","2020-09-26","6","3173","0","411","7.3","6.6"
"Grady","2020-09-27","8","3181","4","415","10.9","10.2"
"Grady","2020-09-28","22","3203","1","416","11.5","9.2"
"Grady","2020-09-29","19","3222","2","418","11.9","9.1"
"Grady","2020-09-30","34","3256","2","420","11.2","9.3"
"Grady","2020-10-01","25","3281","2","422","12.3","9.3"
"Grady","2020-10-02","34","3315","4","426","13","10.1"
"Grady","2020-10-03","12","3327","3","429","16.5","11.9"
"Grady","2020-10-04","9","3336","2","431","12.6","11.7"
"Grady","2020-10-05","30","3366","1","432","12.4","12"
"Grady","2020-10-06","32","3398","0","432","10.9","11.4"
"Grady","2020-10-07","16","3414","0","432","10","10.6"
"Grady","2020-10-08","24","3438","0","432","8.9","10.6"
"Grady","2020-10-09","16","3454","2","434","9","11"
"Grady","2020-10-10","6","3460","1","435","7.8","12.2"
"Grady","2020-10-11","0","3460","0","435","4.6","8.6"
"Grady","2020-10-12","24","3484","3","438","6","9.2"
"Grady","2020-10-13","17","3501","1","439","6.8","8.8"
"Grady","2020-10-14","10","3511","0","439","6.8","8.4"
"Grady","2020-10-15","17","3528","1","440","7.6","8.3"
"Grady","2020-10-16","10","3538","1","441","7.3","8.1"
"Grady","2020-10-17","2","3540","0","441","4.9","6.4"
"Grady","2020-10-18","1","3541","0","441","4.9","4.8"
"Grady","2020-10-19","15","3556","0","441","3.1","4.5"
"Grady","2020-10-20","12","3568","2","443","4.6","5.7"
"Grady","2020-10-21","16","3584","0","443","4.6","5.7"
"Grady","2020-10-22","18","3602","1","444","4.6","6.1"
"Grady","2020-10-23","16","3618","2","446","5","6.1"
"Grady","2020-10-24","4","3622","0","446","5","4.9"
"Grady","2020-10-25","8","3630","1","447","6.7","5.8"
"Grady","2020-10-26","23","3653","0","447","6.7","4.9"
"Grady","2020-10-27","15","3668","1","448","5.3","5"
"Grady","2020-10-28","10","3678","2","450","8.2","6.4"
"Grady","2020-10-29","12","3690","0","450","7.4","6"
"Grady","2020-10-30","11","3701","2","452","8.2","6.6"
"Grady","2020-10-31","6","3707","2","454","13","9"
"Grady","2020-11-01","3","3710","1","455","15.9","11.3"
"Grady","2020-11-02","18","3728","1","456","16.7","11.7"
"Grady","2020-11-03","11","3739","2","458","18.4","11.8"
"Grady","2020-11-04","23","3762","0","458","15.5","11.8"
"Grady","2020-11-05","16","3778","0","458","15.5","11.4"
"Grady","2020-11-06","12","3790","1","459","14.1","11.1"
"Grady","2020-11-07","8","3798","0","459","9.3","11.1"
"Grady","2020-11-08","4","3802","0","459","4.6","10.3"
"Grady","2020-11-09","17","3819","1","460","4.6","10.7"
"Grady","2020-11-10","15","3834","1","461","3","10.7"
"Grady","2020-11-11","13","3847","1","462","4.1","9.8"
"Grady","2020-11-12","18","3865","0","462","4.1","9.8"
"Grady","2020-11-13","22","3887","1","463","3.5","8.8"
"Grady","2020-11-14","7","3894","1","464","5.6","7.5"
"Grady","2020-11-15","5","3899","0","464","5.6","5.1"
"Grady","2020-11-16","21","3920","1","465","5.4","5"
"Grady","2020-11-17","17","3937","2","467","6.2","4.6"
"Grady","2020-11-18","18","3955","3","470","7.4","5.8"
"Grady","2020-11-19","19","3974","1","471","8.2","6.1"
"Grady","2020-11-20","17","3991","2","473","9.2","6.4"
"Grady","2020-11-21","8","3999","3","476","12.5","9.1"
"Grady","2020-11-22","2","4001","2","478","26.8","16.2"
"Grady","2020-11-23","19","4020","0","478","26.1","15.8"
"Grady","2020-11-24","20","4040","2","480","25.9","16"
"Grady","2020-11-25","25","4065","1","481","24.1","15.8"
"Grady","2020-11-26","5","4070","0","481","23.3","15.8"
"Grady","2020-11-27","8","4078","0","481","21.6","15.4"
"Grady","2020-11-28","10","4088","0","481","16.3","14.4"
"Grady","2020-11-29","11","4099","1","482","3.3","15.1"
"Grady","2020-11-30","28","4127","2","484","4.3","15.2"
"Grady","2020-12-01","16","4143","0","484","2.9","14.4"
"Grady","2020-12-02","14","4157","2","486","4.4","14.2"
"Grady","2020-12-03","20","4177","4","490","7.2","15.3"
"Grady","2020-12-04","15","4192","0","490","7.2","14.4"
"Grady","2020-12-05","7","4199","4","494","15.4","15.8"
"Grady","2020-12-06","8","4207","3","497","19.4","11.4"
"Grady","2020-12-07","22","4229","3","500","20.4","12.3"
"Grady","2020-12-08","40","4269","2","502","21.1","12"
"Grady","2020-12-09","18","4287","2","504","20.6","12.5"
"Grady","2020-12-10","16","4303","1","505","18.7","12.9"
"Grady","2020-12-11","31","4334","3","508","20","13.6"
"Grady","2020-12-12","5","4339","1","509","14.7","15.1"
"Grady","2020-12-13","9","4348","2","511","12.6","16"
"Grady","2020-12-14","37","4385","2","513","11.4","15.9"
"Grady","2020-12-15","31","4416","5","518","13","17"
"Grady","2020-12-16","21","4437","5","523","14.8","17.7"
"Grady","2020-12-17","24","4461","8","531","18.7","18.7"
"Grady","2020-12-18","27","4488","4","535","19.4","19.7"
"Grady","2020-12-19","13","4501","2","537","18.7","16.7"
"Grady","2020-12-20","4","4505","2","539","22.7","17.6"
"Grady","2020-12-21","39","4544","8","547","24.9","18.1"
"Grady","2020-12-22","40","4584","6","553","24.7","18.8"
"Grady","2020-12-23","20","4604","3","556","23.4","19.1"
"Grady","2020-12-24","9","4613","2","558","21.8","20.3"
"Grady","2020-12-25","8","4621","3","561","25.1","22.2"
"Grady","2020-12-26","13","4634","6","567","29.5","24.1"
"Grady","2020-12-27","14","4648","3","570","25.4","24"
"Grady","2020-12-28","41","4689","15","585","27.7","26.3"
"Grady","2020-12-29","33","4722","9","594","29.5","27.1"
"Grady","2020-12-30","51","4773","10","604","30.1","26.8"
"Grady","2020-12-31","19","4792","5","609","30.7","26.3"
"Grady","2021-01-01","14","4806","6","615","31.5","28.3"
"Grady","2021-01-02","16","4822","6","621","30.2","29.9"
"Grady","2021-01-03","26","4848","11","632","33.2","29.3"
"Grady","2021-01-04","60","4908","22","654","33.2","30.5"
"Grady","2021-01-05","51","4959","13","667","33","31.2"
"Grady","2021-01-06","47","5006","13","680","34.1","32.1"
"Grady","2021-01-07","40","5046","14","694","35.4","33"
"Grady","2021-01-08","36","5082","10","704","33.2","32.3"
"Grady","2021-01-09","23","5105","6","710","31.6","30.9"
"Grady","2021-01-10","13","5118","5","715","31","32.1"
"Grady","2021-01-11","46","5164","7","722","28","30.6"
"Grady","2021-01-12","38","5202","7","729","26.9","30"
"Grady","2021-01-13","54","5256","11","740","25.9","30"
"Grady","2021-01-14","35","5291","5","745","22.9","29.2"
"Grady","2021-01-15","21","5312","3","748","21","27.1"
"Grady","2021-01-16","21","5333","7","755","22.1","26.8"
"Grady","2021-01-17","6","5339","2","757","21.3","26.2"
"Grady","2021-01-18","48","5387","11","768","22.4","25.2"
"Grady","2021-01-19","33","5420","1","769","20.2","23.6"
"Grady","2021-01-20","41","5461","5","774","19.1","22.5"
"Grady","2021-01-21","33","5494","6","780","19.6","21.3"
"Grady","2021-01-22","24","5518","5","785","20.5","20.8"
"Grady","2021-01-23","12","5530","1","786","17","19.5"
"Grady","2021-01-24","8","5538","2","788","15.8","18.6"
"Grady","2021-01-25","51","5589","12","800","15.9","19.1"
"Grady","2021-01-26","36","5625","5","805","17.4","18.8"
"Grady","2021-01-27","21","5646","5","810","19.1","19.1"
"Grady","2021-01-28","34","5680","13","823","21.9","20.8"
"Grady","2021-01-29","12","5692","4","827","23.7","22.1"
"Grady","2021-01-30","11","5703","0","827","22.5","19.8"
"Grady","2021-01-31","11","5714","1","828","20.3","18"
"Grady","2021-02-01","47","5761","3","831","17.8","16.8"
"Grady","2021-02-02","16","5777","0","831","15.8","16.6"
"Grady","2021-02-03","15","5792","5","836","17.2","18.1"
"Grady","2021-02-04","25","5817","1","837","12.3","17.1"
"Grady","2021-02-05","143","5960","5","842","8","15.9"
"Grady","2021-02-06","3","5963","0","842","8","15.3"
"Grady","2021-02-07","4","5967","1","843","10.3","15.3"
"Grady","2021-02-08","0","5967","0","843","9.4","13.6"
"Greene","2020-02-01","0","0","0","0",".","."
"Greene","2020-02-02","0","0","0","0",".","."
"Greene","2020-02-03","0","0","0","0",".","."
"Greene","2020-02-04","0","0","0","0",".","."
"Greene","2020-02-05","0","0","0","0",".","."
"Greene","2020-02-06","0","0","0","0",".","."
"Greene","2020-02-07","0","0","0","0","0","."
"Greene","2020-02-08","0","0","0","0","0","."
"Greene","2020-02-09","0","0","0","0","0","."
"Greene","2020-02-10","0","0","0","0","0","."
"Greene","2020-02-11","0","0","0","0","0","."
"Greene","2020-02-12","0","0","0","0","0","."
"Greene","2020-02-13","0","0","0","0","0","."
"Greene","2020-02-14","0","0","0","0","0","0"
"Greene","2020-02-15","0","0","0","0","0","0"
"Greene","2020-02-16","0","0","0","0","0","0"
"Greene","2020-02-17","0","0","0","0","0","0"
"Greene","2020-02-18","0","0","0","0","0","0"
"Greene","2020-02-19","0","0","0","0","0","0"
"Greene","2020-02-20","0","0","0","0","0","0"
"Greene","2020-02-21","0","0","0","0","0","0"
"Greene","2020-02-22","0","0","0","0","0","0"
"Greene","2020-02-23","0","0","0","0","0","0"
"Greene","2020-02-24","0","0","0","0","0","0"
"Greene","2020-02-25","0","0","0","0","0","0"
"Greene","2020-02-26","0","0","0","0","0","0"
"Greene","2020-02-27","0","0","0","0","0","0"
"Greene","2020-02-28","0","0","0","0","0","0"
"Greene","2020-02-29","0","0","0","0","0","0"
"Greene","2020-03-01","0","0","0","0","0","0"
"Greene","2020-03-02","0","0","0","0","0","0"
"Greene","2020-03-03","0","0","0","0","0","0"
"Greene","2020-03-04","0","0","0","0","0","0"
"Greene","2020-03-05","0","0","0","0","0","0"
"Greene","2020-03-06","0","0","0","0","0","0"
"Greene","2020-03-07","0","0","0","0","0","0"
"Greene","2020-03-08","0","0","0","0","0","0"
"Greene","2020-03-09","0","0","0","0","0","0"
"Greene","2020-03-10","0","0","0","0","0","0"
"Greene","2020-03-11","0","0","0","0","0","0"
"Greene","2020-03-12","2","2","0","0","0","0"
"Greene","2020-03-13","2","4","0","0","0","0"
"Greene","2020-03-14","2","6","0","0","0","0"
"Greene","2020-03-15","3","9","1","1","4.8","2.4"
"Greene","2020-03-16","3","12","0","1","4.8","2.4"
"Greene","2020-03-17","5","17","2","3","10.5","5.2"
"Greene","2020-03-18","7","24","0","3","10.5","5.2"
"Greene","2020-03-19","2","26","0","3","10.5","5.2"
"Greene","2020-03-20","4","30","0","3","10.5","5.2"
"Greene","2020-03-21","1","31","1","4","24.8","12.4"
"Greene","2020-03-22","0","31","0","4","20","12.4"
"Greene","2020-03-23","7","38","1","5","22","13.4"
"Greene","2020-03-24","6","44","2","7","21.1","15.8"
"Greene","2020-03-25","11","55","2","9","23.7","17.1"
"Greene","2020-03-26","6","61","5","14","35.6","23"
"Greene","2020-03-27","3","64","0","14","35.6","23"
"Greene","2020-03-28","2","66","1","15","28.4","26.6"
"Greene","2020-03-29","1","67","1","16","42.7","31.4"
"Greene","2020-03-30","21","88","4","20","43.4","32.7"
"Greene","2020-03-31","4","92","2","22","45.8","33.4"
"Greene","2020-04-01","3","95","0","22","43.2","33.4"
"Greene","2020-04-02","4","99","0","22","31.3","33.4"
"Greene","2020-04-03","0","99","0","22","31.3","33.4"
"Greene","2020-04-04","0","99","0","22","24.1","26.3"
"Greene","2020-04-05","0","99","0","22","9.9","26.3"
"Greene","2020-04-06","2","101","1","23","14.3","28.8"
"Greene","2020-04-07","5","106","2","25","12.9","29.3"
"Greene","2020-04-08","9","115","1","26","14.4","28.8"
"Greene","2020-04-09","8","123","0","26","14.4","22.9"
"Greene","2020-04-10","5","128","1","27","17.3","24.3"
"Greene","2020-04-11","0","128","0","27","17.3","20.7"
"Greene","2020-04-12","0","128","0","27","17.3","13.6"
"Greene","2020-04-13","6","134","1","28","12.5","13.4"
"Greene","2020-04-14","8","142","4","32","14","13.4"
"Greene","2020-04-15","7","149","4","36","20.5","17.5"
"Greene","2020-04-16","7","156","1","37","22.6","18.5"
"Greene","2020-04-17","2","158","2","39","34","25.7"
"Greene","2020-04-18","1","159","1","40","48.3","32.8"
"Greene","2020-04-19","3","162","0","40","48.3","32.8"
"Greene","2020-04-20","8","170","0","40","45.9","29.2"
"Greene","2020-04-21","17","187","0","40","38.8","26.4"
"Greene","2020-04-22","6","193","2","42","35.4","28"
"Greene","2020-04-23","9","202","2","44","36.5","29.5"
"Greene","2020-04-24","5","207","2","46","27.9","31"
"Greene","2020-04-25","11","218","1","47","14.9","31.6"
"Greene","2020-04-26","2","220","1","48","22.1","35.2"
"Greene","2020-04-27","8","228","0","48","22.1","34"
"Greene","2020-04-28","8","236","0","48","22.1","30.4"
"Greene","2020-04-29","9","245","2","50","20.5","27.9"
"Greene","2020-04-30","20","265","1","51","18","27.3"
"Greene","2020-05-01","3","268","0","51","12.3","20.1"
"Greene","2020-05-02","1","269","0","51","11","13"
"Greene","2020-05-03","4","273","0","51","3.9","13"
"Greene","2020-05-04","12","285","0","51","3.9","13"
"Greene","2020-05-05","8","293","0","51","3.9","13"
"Greene","2020-05-06","4","297","0","51","0.7","10.6"
"Greene","2020-05-07","7","304","0","51","0","9"
"Greene","2020-05-08","5","309","0","51","0","6.2"
"Greene","2020-05-09","3","312","1","52","4.8","7.9"
"Greene","2020-05-10","1","313","0","52","4.8","4.3"
"Greene","2020-05-11","12","325","0","52","4.8","4.3"
"Greene","2020-05-12","9","334","2","54","7.9","5.9"
"Greene","2020-05-13","8","342","0","54","7.9","4.3"
"Greene","2020-05-14","5","347","0","54","7.9","4"
"Greene","2020-05-15","10","357","2","56","10.8","5.4"
"Greene","2020-05-16","3","360","0","56","6","5.4"
"Greene","2020-05-17","3","363","0","56","6","5.4"
"Greene","2020-05-18","10","373","0","56","6","5.4"
"Greene","2020-05-19","9","382","0","56","2.9","5.4"
"Greene","2020-05-20","5","387","0","56","2.9","5.4"
"Greene","2020-05-21","4","391","0","56","2.9","5.4"
"Greene","2020-05-22","5","396","0","56","0","5.4"
"Greene","2020-05-23","2","398","0","56","0","3"
"Greene","2020-05-24","3","401","0","56","0","3"
"Greene","2020-05-25","0","401","0","56","0","3"
"Greene","2020-05-26","16","417","1","57","0.9","1.9"
"Greene","2020-05-27","17","434","0","57","0.9","1.9"
"Greene","2020-05-28","16","450","1","58","1.8","2.3"
"Greene","2020-05-29","14","464","0","58","1.8","0.9"
"Greene","2020-05-30","10","474","0","58","1.8","0.9"
"Greene","2020-05-31","7","481","0","58","1.8","0.9"
"Greene","2020-06-01","13","494","1","59","2.9","1.4"
"Greene","2020-06-02","18","512","2","61","3.6","2.2"
"Greene","2020-06-03","26","538","1","62","4.1","2.5"
"Greene","2020-06-04","18","556","3","65","5.6","3.7"
"Greene","2020-06-05","17","573","2","67","7.3","4.5"
"Greene","2020-06-06","5","578","2","69","13","7.4"
"Greene","2020-06-07","8","586","0","69","13","7.4"
"Greene","2020-06-08","8","594","2","71","15.5","9.2"
"Greene","2020-06-09","24","618","0","71","13.9","8.7"
"Greene","2020-06-10","11","629","0","71","13.3","8.7"
"Greene","2020-06-11","36","665","0","71","11","8.3"
"Greene","2020-06-12","16","681","0","71","9.3","8.3"
"Greene","2020-06-13","5","686","0","71","3.6","8.3"
"Greene","2020-06-14","4","690","1","72","7.1","10.1"
"Greene","2020-06-15","17","707","0","72","3.6","9.5"
"Greene","2020-06-16","16","723","2","74","5.4","9.6"
"Greene","2020-06-17","6","729","0","74","5.4","9.4"
"Greene","2020-06-18","18","747","2","76","6.9","9"
"Greene","2020-06-19","19","766","0","76","6.9","8.1"
"Greene","2020-06-20","8","774","2","78","10.5","7"
"Greene","2020-06-21","3","777","0","78","6.9","7"
"Greene","2020-06-22","20","797","0","78","6.9","5.3"
"Greene","2020-06-23","20","817","1","79","5.9","5.6"
"Greene","2020-06-24","41","858","4","83","7.3","6.3"
"Greene","2020-06-25","23","881","1","84","6.3","6.6"
"Greene","2020-06-26","15","896","1","85","7.3","7.1"
"Greene","2020-06-27","7","903","5","90","13.9","12.2"
"Greene","2020-06-28","5","908","1","91","16.7","11.8"
"Greene","2020-06-29","25","933","1","92","17.3","12.1"
"Greene","2020-06-30","22","955","1","93","17.2","11.6"
"Greene","2020-07-01","23","978","3","96","17.7","12.5"
"Greene","2020-07-02","23","1001","5","101","20.2","13.3"
"Greene","2020-07-03","10","1011","3","104","23.5","15.4"
"Greene","2020-07-04","8","1019","3","107","18.7","16.3"
"Greene","2020-07-05","16","1035","3","110","18.5","17.6"
"Greene","2020-07-06","45","1080","7","117","20.2","18.7"
"Greene","2020-07-07","34","1114","5","122","21.6","19.4"
"Greene","2020-07-08","39","1153","7","129","22.3","20"
"Greene","2020-07-09","27","1180","6","135","22.4","21.3"
"Greene","2020-07-10","24","1204","0","135","18.1","20.8"
"Greene","2020-07-11","11","1215","3","138","16.6","17.7"
"Greene","2020-07-12","7","1222","2","140","18","18.3"
"Greene","2020-07-13","39","1261","11","151","19.8","20"
"Greene","2020-07-14","34","1295","4","155","19.4","20.5"
"Greene","2020-07-15","24","1319","4","159","19.2","20.8"
"Greene","2020-07-16","24","1343","2","161","17.3","19.8"
"Greene","2020-07-17","28","1371","3","164","18.8","18.4"
"Greene","2020-07-18","14","1385","5","169","20","18.3"
"Greene","2020-07-19","30","1415","2","171","16.9","17.5"
"Greene","2020-07-20","34","1449","3","174","14.1","17"
"Greene","2020-07-21","21","1470","5","179","15.8","17.6"
"Greene","2020-07-22","32","1502","12","191","18.8","19"
"Greene","2020-07-23","42","1544","11","202","21.3","19.3"
"Greene","2020-07-24","16","1560","2","204","21.6","20.2"
"Greene","2020-07-25","50","1610","6","210","18.2","19.1"
"Greene","2020-07-26","14","1624","4","214","21.3","19.1"
"Greene","2020-07-27","31","1655","4","218","21.9","18"
"Greene","2020-07-28","21","1676","4","222","21.2","18.5"
"Greene","2020-07-29","21","1697","8","230","21.3","20.1"
"Greene","2020-07-30","25","1722","4","234","19.9","20.6"
"Greene","2020-07-31","17","1739","7","241","24","22.8"
"Greene","2020-08-01","47","1786","7","248","24.4","21.3"
"Greene","2020-08-02","19","1805","8","256","26.3","23.8"
"Greene","2020-08-03","33","1838","8","264","27.9","24.9"
"Greene","2020-08-04","12","1850","5","269","31.2","26.2"
"Greene","2020-08-05","37","1887","9","278","29.2","25.3"
"Greene","2020-08-06","18","1905","4","282","30.1","25"
"Greene","2020-08-07","36","1941","8","290","27.4","25.7"
"Greene","2020-08-08","39","1980","3","293","26.4","25.4"
"Greene","2020-08-09","17","1997","2","295","22","24.2"
"Greene","2020-08-10","50","2047","9","304","21.1","24.5"
"Greene","2020-08-11","28","2075","8","312","19.3","25.2"
"Greene","2020-08-12","21","2096","4","316","18.5","23.9"
"Greene","2020-08-13","39","2135","8","324","18.3","24.2"
"Greene","2020-08-14","32","2167","2","326","16","21.7"
"Greene","2020-08-15","17","2184","2","328","16.6","21.5"
"Greene","2020-08-16","15","2199","2","330","16.8","19.4"
"Greene","2020-08-17","24","2223","6","336","17.8","19.5"
"Greene","2020-08-18","23","2246","4","340","16.2","17.7"
"Greene","2020-08-19","16","2262","4","344","17","17.8"
"Greene","2020-08-20","19","2281","4","348","17.1","17.7"
"Greene","2020-08-21","51","2332","2","350","16.8","16.4"
"Greene","2020-08-22","20","2352","5","355","18.7","17.6"
"Greene","2020-08-23","9","2361","0","355","16.8","16.8"
"Greene","2020-08-24","26","2387","4","359","15.4","16.6"
"Greene","2020-08-25","8","2395","1","360","14.7","15.4"
"Greene","2020-08-26","17","2412","3","363","13.6","15.3"
"Greene","2020-08-27","11","2423","2","365","13.2","15.2"
"Greene","2020-08-28","29","2452","1","366","13.2","15"
"Greene","2020-08-29","12","2464","1","367","10.8","14.7"
"Greene","2020-08-30","9","2473","2","369","14","15.4"
"Greene","2020-08-31","23","2496","6","375","15.5","15.4"
"Greene","2020-09-01","24","2520","4","379","16.1","15.4"
"Greene","2020-09-02","15","2535","1","380","14.5","14.1"
"Greene","2020-09-03","24","2559","4","384","14.3","13.8"
"Greene","2020-09-04","49","2608","4","388","15","14.1"
"Greene","2020-09-05","17","2625","1","389","14.6","12.7"
"Greene","2020-09-06","9","2634","0","389","11.4","12.7"
"Greene","2020-09-07","15","2649","3","392","10.6","13"
"Greene","2020-09-08","37","2686","2","394","9","12.5"
"Greene","2020-09-09","26","2712","1","395","8.6","11.5"
"Greene","2020-09-10","34","2746","3","398","7.4","10.9"
"Greene","2020-09-11","42","2788","3","401","7.3","11.1"
"Greene","2020-09-12","7","2795","1","402","8.5","11.6"
"Greene","2020-09-13","9","2804","0","402","8.5","10"
"Greene","2020-09-14","28","2832","2","404","6.7","8.6"
"Greene","2020-09-15","32","2864","1","405","6.3","7.7"
"Greene","2020-09-16","26","2890","1","406","6.3","7.5"
"Greene","2020-09-17","32","2922","1","407","5.5","6.5"
"Greene","2020-09-18","70","2992","0","407","4.5","5.9"
"Greene","2020-09-19","19","3011","0","407","2.5","5.5"
"Greene","2020-09-20","8","3019","1","408","4.2","6.4"
"Greene","2020-09-21","36","3055","0","408","3.2","4.9"
"Greene","2020-09-22","15","3070","1","409","3.7","5"
"Greene","2020-09-23","29","3099","0","409","3.2","4.8"
"Greene","2020-09-24","12","3111","0","409","2.7","4.1"
"Greene","2020-09-25","26","3137","2","411","3.8","4.2"
"Greene","2020-09-26","4","3141","2","413","11","6.7"
"Greene","2020-09-27","5","3146","0","413","9.2","6.7"
"Greene","2020-09-28","11","3157","1","414","10.5","6.9"
"Greene","2020-09-29","28","3185","0","414","9.5","6.6"
"Greene","2020-09-30","31","3216","0","414","9.5","6.4"
"Greene","2020-10-01","18","3234","2","416","11.1","6.9"
"Greene","2020-10-02","40","3274","2","418","10.7","7.3"
"Greene","2020-10-03","55","3329","1","419","3.9","7.4"
"Greene","2020-10-04","9","3338","1","420","5.4","7.3"
"Greene","2020-10-05","33","3371","3","423","5.4","8"
"Greene","2020-10-06","57","3428","1","424","5.7","7.6"
"Greene","2020-10-07","31","3459","0","424","5.7","7.6"
"Greene","2020-10-08","45","3504","2","426","4.7","7.9"
"Greene","2020-10-09","26","3530","1","427","4.6","7.7"
"Greene","2020-10-10","43","3573","1","428","4.7","4.3"
"Greene","2020-10-11","7","3580","3","431","9.2","7.3"
"Greene","2020-10-12","39","3619","2","433","8.6","7"
"Greene","2020-10-13","26","3645","1","434","8.9","7.3"
"Greene","2020-10-14","18","3663","0","434","8.9","7.3"
"Greene","2020-10-15","19","3682","0","434","8.3","6.5"
"Greene","2020-10-16","57","3739","0","434","7.7","6.2"
"Greene","2020-10-17","4","3743","0","434","7.4","6"
"Greene","2020-10-18","6","3749","0","434","1.3","5.2"
"Greene","2020-10-19","19","3768","3","437","2.8","5.7"
"Greene","2020-10-20","26","3794","2","439","3.4","6.1"
"Greene","2020-10-21","40","3834","3","442","4.4","6.7"
"Greene","2020-10-22","37","3871","1","443","4.8","6.5"
"Greene","2020-10-23","15","3886","1","444","5.8","6.8"
"Greene","2020-10-24","19","3905","2","446","7.3","7.3"
"Greene","2020-10-25","8","3913","2","448","10.8","6.1"
"Greene","2020-10-26","34","3947","1","449","9","5.9"
"Greene","2020-10-27","22","3969","1","450","8.6","6"
"Greene","2020-10-28","22","3991","0","450","7.5","6"
"Greene","2020-10-29","18","4009","3","453","9.5","7.1"
"Greene","2020-10-30","46","4055","4","457","9.8","7.8"
"Greene","2020-10-31","32","4087","2","459","9.2","8.2"
"Greene","2020-11-01","18","4105","2","461","7.2","9"
"Greene","2020-11-02","25","4130","2","463","7.9","8.4"
"Greene","2020-11-03","26","4156","3","466","8.9","8.7"
"Greene","2020-11-04","64","4220","1","467","9.1","8.3"
"Greene","2020-11-05","11","4231","0","467","6.7","8.1"
"Greene","2020-11-06","25","4256","0","467","5.5","7.6"
"Greene","2020-11-07","17","4273","3","470","7.1","8.1"
"Greene","2020-11-08","6","4279","0","470","5.5","6.4"
"Greene","2020-11-09","34","4313","4","474","6.1","7"
"Greene","2020-11-10","41","4354","3","477","5.5","7.2"
"Greene","2020-11-11","43","4397","1","478","5.6","7.3"
"Greene","2020-11-12","18","4415","1","479","6.4","6.6"
"Greene","2020-11-13","36","4451","0","479","6.4","5.9"
"Greene","2020-11-14","30","4481","0","479","3.9","5.5"
"Greene","2020-11-15","15","4496","1","480","4.8","5.2"
"Greene","2020-11-16","79","4575","10","490","4.9","5.5"
"Greene","2020-11-17","47","4622","2","492","4.5","5"
"Greene","2020-11-18","52","4674","5","497","5.5","5.6"
"Greene","2020-11-19","70","4744","1","498","4.9","5.7"
"Greene","2020-11-20","104","4848","5","503","5.6","6"
"Greene","2020-11-21","20","4868","1","504","6.3","5.1"
"Greene","2020-11-22","10","4878","2","506","8.3","6.5"
"Greene","2020-11-23","158","5036","11","517","7.4","6.2"
"Greene","2020-11-24","77","5113","8","525","8.3","6.4"
"Greene","2020-11-25","84","5197","9","534","8.5","7"
"Greene","2020-11-26","5","5202","0","534","8.3","6.6"
"Greene","2020-11-27","44","5246","1","535","7.9","6.8"
"Greene","2020-11-28","19","5265","5","540","11","8.6"
"Greene","2020-11-29","16","5281","3","543","10.8","9.5"
"Greene","2020-11-30","83","5364","5","548","10.6","9"
"Greene","2020-12-01","43","5407","9","557","12.1","10.2"
"Greene","2020-12-02","47","5454","7","564","12.7","10.6"
"Greene","2020-12-03","60","5514","11","575","15.4","11.8"
"Greene","2020-12-04","77","5591","8","583","16.5","12.2"
"Greene","2020-12-05","25","5616","3","586","14.5","12.7"
"Greene","2020-12-06","18","5634","2","588","13.4","12.1"
"Greene","2020-12-07","52","5686","9","597","15","12.8"
"Greene","2020-12-08","54","5740","6","603","13.6","12.9"
"Greene","2020-12-09","44","5784","4","607","12.8","12.8"
"Greene","2020-12-10","35","5819","5","612","12.2","13.8"
"Greene","2020-12-11","30","5849","4","616","12.6","14.6"
"Greene","2020-12-12","62","5911","12","628","13.7","14.1"
"Greene","2020-12-13","31","5942","5","633","14.4","13.9"
"Greene","2020-12-14","104","6046","14","647","13.8","14.4"
"Greene","2020-12-15","126","6172","30","677","15.6","14.6"
"Greene","2020-12-16","71","6243","9","686","16.2","14.5"
"Greene","2020-12-17","44","6287","8","694","16.7","14.4"
"Greene","2020-12-18","63","6350","13","707","17.7","15.2"
"Greene","2020-12-19","50","6400","8","715","17.3","15.5"
"Greene","2020-12-20","29","6429","5","720","17.4","15.9"
"Greene","2020-12-21","84","6513","27","747","20.1","17"
"Greene","2020-12-22","59","6572","13","760","19.8","17.7"
"Greene","2020-12-23","72","6644","23","783","22.6","19.4"
"Greene","2020-12-24","77","6721","11","794","22","19.4"
"Greene","2020-12-25","7","6728","4","798","27.3","22.5"
"Greene","2020-12-26","46","6774","12","810","28.7","23"
"Greene","2020-12-27","44","6818","18","828","32.1","24.8"
"Greene","2020-12-28","68","6886","18","846","31.3","25.7"
"Greene","2020-12-29","55","6941","14","860","31.8","25.8"
"Greene","2020-12-30","51","6992","11","871","30.3","26.4"
"Greene","2020-12-31","42","7034","14","885","33","27.5"
"Greene","2021-01-01","9","7043","5","890","32.8","30"
"Greene","2021-01-02","18","7061","9","899","36.2","32.4"
"Greene","2021-01-03","42","7103","7","906","32.7","32.4"
"Greene","2021-01-04","39","7142","11","917","33","32.1"
"Greene","2021-01-05","64","7206","16","933","32.9","32.3"
"Greene","2021-01-06","70","7276","13","946","32.5","31.4"
"Greene","2021-01-07","79","7355","14","960","30.2","31.6"
"Greene","2021-01-08","65","7420","14","974","25.4","29.1"
"Greene","2021-01-09","43","7463","19","993","24.6","30.4"
"Greene","2021-01-10","27","7490","6","999","25.3","29"
"Greene","2021-01-11","62","7552","14","1013","24.5","28.8"
"Greene","2021-01-12","103","7655","19","1032","23.6","28.3"
"Greene","2021-01-13","74","7729","17","1049","24.2","28.4"
"Greene","2021-01-14","50","7779","13","1062","25.4","27.8"
"Greene","2021-01-15","51","7830","7","1069","24.3","24.8"
"Greene","2021-01-16","44","7874","12","1081","21.9","23.2"
"Greene","2021-01-17","19","7893","4","1085","21.7","23.5"
"Greene","2021-01-18","67","7960","9","1094","20.4","22.5"
"Greene","2021-01-19","54","8014","10","1104","20.4","22"
"Greene","2021-01-20","48","8062","8","1112","19.5","21.9"
"Greene","2021-01-21","42","8104","8","1120","18.5","22"
"Greene","2021-01-22","71","8175","15","1135","19.6","21.9"
"Greene","2021-01-23","52","8227","11","1146","18.7","20.3"
"Greene","2021-01-24","29","8256","10","1156","20.6","21.2"
"Greene","2021-01-25","56","8312","10","1166","21.3","20.8"
"Greene","2021-01-26","46","8358","11","1177","22","21.2"
"Greene","2021-01-27","52","8410","8","1185","21.9","20.7"
"Greene","2021-01-28","40","8450","9","1194","22.3","20.4"
"Greene","2021-01-29","46","8496","5","1199","20.9","20.2"
"Greene","2021-01-30","25","8521","5","1204","20.7","19.7"
"Greene","2021-01-31","25","8546","6","1210","19.2","19.9"
"Greene","2021-02-01","62","8608","8","1218","18.5","19.9"
"Greene","2021-02-02","50","8658","8","1226","17.4","19.7"
"Greene","2021-02-03","42","8700","9","1235","18.2","20"
"Greene","2021-02-04","51","8751","1","1236","15.3","18.8"
"Greene","2021-02-05","36","8787","6","1242","16.1","18.5"
"Greene","2021-02-06","19","8806","5","1247","17","18.9"
"Greene","2021-02-07","8","8814","0","1247","13.6","16.4"
"Greene","2021-02-08","0","8814","0","1247","11.8","15.1"
"Gwinnett","2020-02-01","0","0","0","0",".","."
"Gwinnett","2020-02-02","0","0","0","0",".","."
"Gwinnett","2020-02-03","0","0","0","0",".","."
"Gwinnett","2020-02-04","1","1","0","0",".","."
"Gwinnett","2020-02-05","0","1","0","0",".","."
"Gwinnett","2020-02-06","0","1","0","0",".","."
"Gwinnett","2020-02-07","0","1","0","0","0","."
"Gwinnett","2020-02-08","0","1","0","0","0","."
"Gwinnett","2020-02-09","0","1","0","0","0","."
"Gwinnett","2020-02-10","0","1","0","0","0","."
"Gwinnett","2020-02-11","0","1","0","0","0","."
"Gwinnett","2020-02-12","0","1","0","0","0","."
"Gwinnett","2020-02-13","0","1","0","0","0","."
"Gwinnett","2020-02-14","0","1","0","0","0","0"
"Gwinnett","2020-02-15","0","1","0","0","0","0"
"Gwinnett","2020-02-16","0","1","0","0","0","0"
"Gwinnett","2020-02-17","0","1","0","0","0","0"
"Gwinnett","2020-02-18","0","1","0","0","0","0"
"Gwinnett","2020-02-19","0","1","0","0","0","0"
"Gwinnett","2020-02-20","0","1","0","0","0","0"
"Gwinnett","2020-02-21","0","1","0","0","0","0"
"Gwinnett","2020-02-22","0","1","0","0","0","0"
"Gwinnett","2020-02-23","0","1","0","0","0","0"
"Gwinnett","2020-02-24","0","1","0","0","0","0"
"Gwinnett","2020-02-25","1","2","0","0","0","0"
"Gwinnett","2020-02-26","0","2","0","0","0","0"
"Gwinnett","2020-02-27","0","2","0","0","0","0"
"Gwinnett","2020-02-28","0","2","0","0","0","0"
"Gwinnett","2020-02-29","0","2","0","0","0","0"
"Gwinnett","2020-03-01","0","2","0","0","0","0"
"Gwinnett","2020-03-02","0","2","0","0","0","0"
"Gwinnett","2020-03-03","0","2","0","0","0","0"
"Gwinnett","2020-03-04","4","6","2","2","7.1","3.6"
"Gwinnett","2020-03-05","0","6","0","2","7.1","3.6"
"Gwinnett","2020-03-06","2","8","0","2","7.1","3.6"
"Gwinnett","2020-03-07","6","14","4","6","16.7","8.3"
"Gwinnett","2020-03-08","0","14","0","6","16.7","8.3"
"Gwinnett","2020-03-09","8","22","0","6","16.7","8.3"
"Gwinnett","2020-03-10","11","33","1","7","18","9"
"Gwinnett","2020-03-11","9","42","0","7","10.8","9"
"Gwinnett","2020-03-12","35","77","4","11","12.5","9.8"
"Gwinnett","2020-03-13","31","108","2","13","13.4","10.3"
"Gwinnett","2020-03-14","25","133","3","16","5.6","11.1"
"Gwinnett","2020-03-15","15","148","1","17","6.5","11.6"
"Gwinnett","2020-03-16","89","237","6","23","7.5","12.1"
"Gwinnett","2020-03-17","135","372","16","39","7.9","12.9"
"Gwinnett","2020-03-18","155","527","17","56","9.4","10.1"
"Gwinnett","2020-03-19","128","655","18","74","9.8","11.1"
"Gwinnett","2020-03-20","152","807","16","90","10.4","11.9"
"Gwinnett","2020-03-21","54","861","12","102","11.9","8.7"
"Gwinnett","2020-03-22","20","881","3","105","13.1","9.8"
"Gwinnett","2020-03-23","188","1069","22","127","13.8","10.6"
"Gwinnett","2020-03-24","134","1203","26","153","14.8","11.4"
"Gwinnett","2020-03-25","126","1329","19","172","15.4","12.4"
"Gwinnett","2020-03-26","148","1477","19","191","15.3","12.5"
"Gwinnett","2020-03-27","163","1640","21","212","15.6","13"
"Gwinnett","2020-03-28","30","1670","10","222","17.2","14.5"
"Gwinnett","2020-03-29","33","1703","7","229","18.1","15.6"
"Gwinnett","2020-03-30","178","1881","34","263","19.1","16.4"
"Gwinnett","2020-03-31","144","2025","32","295","19.5","17.2"
"Gwinnett","2020-04-01","151","2176","31","326","20.3","17.9"
"Gwinnett","2020-04-02","143","2319","22","348","20.7","18"
"Gwinnett","2020-04-03","164","2483","22","370","20.7","18.2"
"Gwinnett","2020-04-04","47","2530","3","373","16.9","17"
"Gwinnett","2020-04-05","23","2553","1","374","14.5","16.3"
"Gwinnett","2020-04-06","229","2782","40","414","14.2","16.7"
"Gwinnett","2020-04-07","241","3023","31","445","12.9","16.2"
"Gwinnett","2020-04-08","274","3297","45","490","12.3","16.3"
"Gwinnett","2020-04-09","295","3592","55","545","12.8","16.7"
"Gwinnett","2020-04-10","289","3881","46","591","13.1","16.9"
"Gwinnett","2020-04-11","178","4059","23","614","14.1","15.5"
"Gwinnett","2020-04-12","76","4135","23","637","17.8","16.1"
"Gwinnett","2020-04-13","322","4457","67","704","18.3","16.3"
"Gwinnett","2020-04-14","399","4856","52","756","18.3","15.6"
"Gwinnett","2020-04-15","406","5262","75","831","18.6","15.5"
"Gwinnett","2020-04-16","335","5597","52","883","18.1","15.5"
"Gwinnett","2020-04-17","507","6104","82","965","18.2","15.7"
"Gwinnett","2020-04-18","273","6377","55","1020","19.2","16.6"
"Gwinnett","2020-04-19","127","6504","33","1053","18.6","18.2"
"Gwinnett","2020-04-20","821","7325","84","1137","17.1","17.7"
"Gwinnett","2020-04-21","577","7902","117","1254","18.1","18.2"
"Gwinnett","2020-04-22","1125","9027","137","1391","17.2","17.9"
"Gwinnett","2020-04-23","460","9487","88","1479","17.7","17.9"
"Gwinnett","2020-04-24","612","10099","80","1559","17.3","17.7"
"Gwinnett","2020-04-25","311","10410","42","1601","16.3","17.8"
"Gwinnett","2020-04-26","180","10590","22","1623","14.4","16.5"
"Gwinnett","2020-04-27","737","11327","77","1700","14.4","15.7"
"Gwinnett","2020-04-28","618","11945","100","1800","13.8","16"
"Gwinnett","2020-04-29","609","12554","76","1876","13.9","15.5"
"Gwinnett","2020-04-30","990","13544","87","1963","12.4","15.1"
"Gwinnett","2020-05-01","800","14344","90","2053","12.1","14.7"
"Gwinnett","2020-05-02","409","14753","40","2093","11.6","14"
"Gwinnett","2020-05-03","189","14942","43","2136","13.1","13.7"
"Gwinnett","2020-05-04","677","15619","111","2247","13.9","14.2"
"Gwinnett","2020-05-05","672","16291","93","2340","13.6","13.7"
"Gwinnett","2020-05-06","674","16965","89","2429","13.7","13.8"
"Gwinnett","2020-05-07","737","17702","55","2484","13.5","13"
"Gwinnett","2020-05-08","1562","19264","87","2571","12.7","12.4"
"Gwinnett","2020-05-09","335","19599","51","2622","13.5","12.5"
"Gwinnett","2020-05-10","221","19820","24","2646","11.8","12.4"
"Gwinnett","2020-05-11","822","20642","69","2715","10.7","12.3"
"Gwinnett","2020-05-12","881","21523","66","2781","9.7","11.7"
"Gwinnett","2020-05-13","907","22430","82","2863","9.1","11.4"
"Gwinnett","2020-05-14","1020","23450","91","2954","9.4","11.4"
"Gwinnett","2020-05-15","1157","24607","88","3042","9.6","11.2"
"Gwinnett","2020-05-16","658","25265","59","3101","8.8","11.1"
"Gwinnett","2020-05-17","308","25573","30","3131","8.6","10.2"
"Gwinnett","2020-05-18","1167","26740","102","3233","8.6","9.6"
"Gwinnett","2020-05-19","1156","27896","97","3330","8.8","9.3"
"Gwinnett","2020-05-20","1194","29090","119","3449","8.9","9"
"Gwinnett","2020-05-21","1254","30344","86","3535","8.6","9"
"Gwinnett","2020-05-22","1394","31738","132","3667","8.9","9.3"
"Gwinnett","2020-05-23","997","32735","84","3751","8.8","8.8"
"Gwinnett","2020-05-24","646","33381","51","3802","8.5","8.6"
"Gwinnett","2020-05-25","684","34065","36","3838","8","8.3"
"Gwinnett","2020-05-26","1716","35781","151","3989","8.1","8.4"
"Gwinnett","2020-05-27","1733","37514","163","4152","8","8.5"
"Gwinnett","2020-05-28","1572","39086","111","4263","8","8.3"
"Gwinnett","2020-05-29","1434","40520","112","4375","7.8","8.3"
"Gwinnett","2020-05-30","941","41461","80","4455","7.8","8.3"
"Gwinnett","2020-05-31","506","41967","39","4494","7.8","8.2"
"Gwinnett","2020-06-01","1550","43517","142","4636","8.3","8.2"
"Gwinnett","2020-06-02","1646","45163","165","4801","8.5","8.3"
"Gwinnett","2020-06-03","1713","46876","129","4930","8.3","8.1"
"Gwinnett","2020-06-04","1690","48566","148","5078","8.5","8.3"
"Gwinnett","2020-06-05","1286","49852","123","5201","8.7","8.3"
"Gwinnett","2020-06-06","1046","50898","113","5314","9.1","8.4"
"Gwinnett","2020-06-07","555","51453","71","5385","9.8","8.8"
"Gwinnett","2020-06-08","1611","53064","171","5556","10","9.2"
"Gwinnett","2020-06-09","1546","54610","139","5695","9.9","9.2"
"Gwinnett","2020-06-10","1846","56456","165","5860","10.1","9.2"
"Gwinnett","2020-06-11","1772","58228","183","6043","10.3","9.4"
"Gwinnett","2020-06-12","1703","59931","146","6189","10.1","9.4"
"Gwinnett","2020-06-13","1141","61072","151","6340","10.5","9.8"
"Gwinnett","2020-06-14","661","61733","99","6439","10.8","10.3"
"Gwinnett","2020-06-15","2065","63798","269","6708","11.2","10.6"
"Gwinnett","2020-06-16","1733","65531","219","6927","11.7","10.8"
"Gwinnett","2020-06-17","1758","67289","289","7216","12.7","11.4"
"Gwinnett","2020-06-18","1616","68905","253","7469","13.5","11.9"
"Gwinnett","2020-06-19","1816","70721","262","7731","14.3","12.2"
"Gwinnett","2020-06-20","907","71628","196","7927","15.5","13"
"Gwinnett","2020-06-21","399","72027","100","8027","17","13.9"
"Gwinnett","2020-06-22","2283","74310","423","8450","17.8","14.5"
"Gwinnett","2020-06-23","1729","76039","325","8775","18.6","15.2"
"Gwinnett","2020-06-24","1703","77742","304","9079","18.8","15.8"
"Gwinnett","2020-06-25","2080","79822","389","9468","19.3","16.4"
"Gwinnett","2020-06-26","1960","81782","340","9808","19.7","17"
"Gwinnett","2020-06-27","1197","82979","210","10018","19.1","17.3"
"Gwinnett","2020-06-28","517","83496","82","10100","17.8","17.4"
"Gwinnett","2020-06-29","2225","85721","310","10410","17.1","17.5"
"Gwinnett","2020-06-30","2172","87893","342","10752","16.7","17.7"
"Gwinnett","2020-07-01","2078","89971","326","11078","16.4","17.6"
"Gwinnett","2020-07-02","2355","92326","345","11423","15.8","17.6"
"Gwinnett","2020-07-03","1247","93573","212","11635","15.8","17.7"
"Gwinnett","2020-07-04","614","94187","110","11745","15.8","17.5"
"Gwinnett","2020-07-05","676","94863","135","11880","16.4","17.1"
"Gwinnett","2020-07-06","2452","97315","448","12328","17","17.1"
"Gwinnett","2020-07-07","2626","99941","409","12737","17","16.9"
"Gwinnett","2020-07-08","2530","102471","367","13104","16.8","16.6"
"Gwinnett","2020-07-09","2458","104929","356","13460","16.8","16.3"
"Gwinnett","2020-07-10","2351","107280","346","13806","16.5","16.1"
"Gwinnett","2020-07-11","1107","108387","225","14031","16.8","16.3"
"Gwinnett","2020-07-12","375","108762","70","14101","16.6","16.5"
"Gwinnett","2020-07-13","2529","111291","315","14416","15.8","16.4"
"Gwinnett","2020-07-14","2132","113423","317","14733","15.7","16.4"
"Gwinnett","2020-07-15","2360","115783","307","15040","15.5","16.2"
"Gwinnett","2020-07-16","2805","118588","389","15429","15.4","16.1"
"Gwinnett","2020-07-17","2216","120804","277","15706","15.1","15.8"
"Gwinnett","2020-07-18","1348","122152","187","15893","14.2","15.5"
"Gwinnett","2020-07-19","547","122699","97","15990","14","15.3"
"Gwinnett","2020-07-20","2452","125151","307","16297","14.1","14.9"
"Gwinnett","2020-07-21","2167","127318","282","16579","13.8","14.8"
"Gwinnett","2020-07-22","2427","129745","287","16866","13.6","14.6"
"Gwinnett","2020-07-23","2199","131944","280","17146","13.5","14.4"
"Gwinnett","2020-07-24","2051","133995","245","17391","13.4","14.2"
"Gwinnett","2020-07-25","1279","135274","172","17563","13.3","13.7"
"Gwinnett","2020-07-26","445","135719","43","17606","12.2","13.1"
"Gwinnett","2020-07-27","2269","137988","274","17880","12.1","13.1"
"Gwinnett","2020-07-28","1904","139892","230","18110","12","12.9"
"Gwinnett","2020-07-29","2068","141960","240","18350","11.9","12.8"
"Gwinnett","2020-07-30","2234","144194","256","18606","11.8","12.6"
"Gwinnett","2020-07-31","2090","146284","188","18794","11.3","12.4"
"Gwinnett","2020-08-01","1493","147777","160","18954","10.9","12.1"
"Gwinnett","2020-08-02","564","148341","76","19030","11.5","11.8"
"Gwinnett","2020-08-03","2123","150464","212","19242","11.2","11.6"
"Gwinnett","2020-08-04","1936","152400","210","19452","11","11.5"
"Gwinnett","2020-08-05","1953","154353","203","19655","10.8","11.4"
"Gwinnett","2020-08-06","2059","156412","219","19874","10.7","11.2"
"Gwinnett","2020-08-07","1853","158265","173","20047","10.8","11.1"
"Gwinnett","2020-08-08","1163","159428","104","20151","10.5","10.7"
"Gwinnett","2020-08-09","612","160040","54","20205","9.9","10.7"
"Gwinnett","2020-08-10","2283","162323","226","20431","9.8","10.5"
"Gwinnett","2020-08-11","1723","164046","162","20593","9.6","10.3"
"Gwinnett","2020-08-12","1821","165867","164","20757","9.4","10.1"
"Gwinnett","2020-08-13","1674","167541","127","20884","9","9.9"
"Gwinnett","2020-08-14","2041","169582","159","21043","8.8","9.8"
"Gwinnett","2020-08-15","1211","170793","114","21157","8.8","9.7"
"Gwinnett","2020-08-16","594","171387","68","21225","9.2","9.5"
"Gwinnett","2020-08-17","1841","173228","156","21381","9","9.4"
"Gwinnett","2020-08-18","1798","175026","154","21535","8.9","9.3"
"Gwinnett","2020-08-19","1787","176813","133","21668","8.7","9.1"
"Gwinnett","2020-08-20","1846","178659","136","21804","8.6","8.8"
"Gwinnett","2020-08-21","1809","180468","153","21957","8.7","8.8"
"Gwinnett","2020-08-22","1275","181743","85","22042","8.3","8.6"
"Gwinnett","2020-08-23","487","182230","36","22078","7.8","8.5"
"Gwinnett","2020-08-24","1758","183988","125","22203","7.6","8.3"
"Gwinnett","2020-08-25","1585","185573","111","22314","7.3","8.1"
"Gwinnett","2020-08-26","1620","187193","133","22447","7.5","8.1"
"Gwinnett","2020-08-27","1720","188913","112","22559","7.3","8"
"Gwinnett","2020-08-28","1739","190652","106","22665","7","7.9"
"Gwinnett","2020-08-29","1186","191838","75","22740","6.9","7.6"
"Gwinnett","2020-08-30","594","192432","35","22775","6.7","7.3"
"Gwinnett","2020-08-31","1833","194265","117","22892","6.6","7.1"
"Gwinnett","2020-09-01","1684","195949","105","22997","6.5","6.9"
"Gwinnett","2020-09-02","1664","197613","118","23115","6.4","6.9"
"Gwinnett","2020-09-03","1746","199359","105","23220","6.3","6.8"
"Gwinnett","2020-09-04","1756","201115","115","23335","6.4","6.7"
"Gwinnett","2020-09-05","980","202095","64","23399","6.4","6.7"
"Gwinnett","2020-09-06","473","202568","32","23431","6.5","6.6"
"Gwinnett","2020-09-07","706","203274","55","23486","6.7","6.7"
"Gwinnett","2020-09-08","1902","205176","120","23606","6.7","6.6"
"Gwinnett","2020-09-09","1661","206837","110","23716","6.7","6.5"
"Gwinnett","2020-09-10","1948","208785","129","23845","6.7","6.5"
"Gwinnett","2020-09-11","1739","210524","95","23940","6.6","6.5"
"Gwinnett","2020-09-12","1035","211559","49","23989","6.3","6.4"
"Gwinnett","2020-09-13","337","211896","23","24012","6.3","6.4"
"Gwinnett","2020-09-14","1816","213712","96","24108","6","6.3"
"Gwinnett","2020-09-15","1486","215198","75","24183","5.8","6.3"
"Gwinnett","2020-09-16","1582","216780","81","24264","5.6","6.1"
"Gwinnett","2020-09-17","1280","218060","70","24334","5.4","6.1"
"Gwinnett","2020-09-18","1241","219301","62","24396","5.4","6"
"Gwinnett","2020-09-19","1271","220572","72","24468","5.5","5.9"
"Gwinnett","2020-09-20","292","220864","22","24490","5.6","6"
"Gwinnett","2020-09-21","1812","222676","80","24570","5.5","5.7"
"Gwinnett","2020-09-22","1548","224224","80","24650","5.5","5.6"
"Gwinnett","2020-09-23","1754","225978","79","24729","5.4","5.5"
"Gwinnett","2020-09-24","1887","227865","81","24810","5.2","5.3"
"Gwinnett","2020-09-25","1737","229602","85","24895","5.2","5.3"
"Gwinnett","2020-09-26","870","230472","69","24964","5.5","5.5"
"Gwinnett","2020-09-27","578","231050","40","25004","5.4","5.5"
"Gwinnett","2020-09-28","1883","232933","77","25081","5.4","5.4"
"Gwinnett","2020-09-29","1405","234338","80","25161","5.5","5.5"
"Gwinnett","2020-09-30","1868","236206","102","25263","5.6","5.5"
"Gwinnett","2020-10-01","2183","238389","96","25359","5.6","5.4"
"Gwinnett","2020-10-02","1820","240209","82","25441","5.6","5.4"
"Gwinnett","2020-10-03","1471","241680","50","25491","4.9","5.2"
"Gwinnett","2020-10-04","578","242258","37","25528","4.8","5.1"
"Gwinnett","2020-10-05","1754","244012","101","25629","5.1","5.2"
"Gwinnett","2020-10-06","2121","246133","85","25714","4.8","5.2"
"Gwinnett","2020-10-07","2211","248344","115","25829","4.8","5.2"
"Gwinnett","2020-10-08","2114","250458","102","25931","4.9","5.2"
"Gwinnett","2020-10-09","1974","252432","95","26026","4.9","5.2"
"Gwinnett","2020-10-10","1490","253922","64","26090","5","5"
"Gwinnett","2020-10-11","425","254347","41","26131","5.5","5.2"
"Gwinnett","2020-10-12","1808","256155","76","26207","5.3","5.2"
"Gwinnett","2020-10-13","2061","258216","118","26325","5.5","5.2"
"Gwinnett","2020-10-14","1975","260191","102","26427","5.5","5.2"
"Gwinnett","2020-10-15","2393","262584","152","26579","5.7","5.3"
"Gwinnett","2020-10-16","2038","264622","117","26696","5.9","5.4"
"Gwinnett","2020-10-17","1516","266138","68","26764","5.9","5.5"
"Gwinnett","2020-10-18","596","266734","62","26826","6","5.8"
"Gwinnett","2020-10-19","2138","268872","92","26918","6","5.7"
"Gwinnett","2020-10-20","2102","270974","129","27047","6.1","5.8"
"Gwinnett","2020-10-21","2780","273754","149","27196","6.1","5.8"
"Gwinnett","2020-10-22","2040","275794","120","27316","6","5.9"
"Gwinnett","2020-10-23","1844","277638","130","27446","6.2","6.1"
"Gwinnett","2020-10-24","1610","279248","99","27545","6.5","6.2"
"Gwinnett","2020-10-25","793","280041","75","27620","6.3","6.2"
"Gwinnett","2020-10-26","2136","282177","134","27754","6.6","6.3"
"Gwinnett","2020-10-27","2435","284612","138","27892","6.5","6.3"
"Gwinnett","2020-10-28","2745","287357","157","28049","6.6","6.4"
"Gwinnett","2020-10-29","1976","289333","145","28194","6.8","6.4"
"Gwinnett","2020-10-30","2173","291506","154","28348","6.8","6.5"
"Gwinnett","2020-10-31","1693","293199","134","28482","7.1","6.8"
"Gwinnett","2020-11-01","698","293897","71","28553","7.2","6.8"
"Gwinnett","2020-11-02","2672","296569","151","28704","7.1","6.8"
"Gwinnett","2020-11-03","2137","298706","182","28886","7.5","7"
"Gwinnett","2020-11-04","2158","300864","149","29035","7.7","7.1"
"Gwinnett","2020-11-05","2713","303577","186","29221","7.6","7.2"
"Gwinnett","2020-11-06","2688","306265","194","29415","7.6","7.2"
"Gwinnett","2020-11-07","1829","308094","161","29576","7.7","7.4"
"Gwinnett","2020-11-08","805","308899","106","29682","8.2","7.7"
"Gwinnett","2020-11-09","2711","311610","245","29927","8.6","7.9"
"Gwinnett","2020-11-10","2943","314553","241","30168","8.6","8"
"Gwinnett","2020-11-11","2375","316928","199","30367","8.8","8.2"
"Gwinnett","2020-11-12","2938","319866","255","30622","9.1","8.3"
"Gwinnett","2020-11-13","3097","322963","259","30881","9.2","8.4"
"Gwinnett","2020-11-14","1471","324434","164","31045","9.6","8.6"
"Gwinnett","2020-11-15","1003","325437","118","31163","9.4","8.8"
"Gwinnett","2020-11-16","3262","328699","264","31427","9.2","8.9"
"Gwinnett","2020-11-17","2919","331618","238","31665","9.2","8.9"
"Gwinnett","2020-11-18","2975","334593","210","31875","9","8.9"
"Gwinnett","2020-11-19","3489","338082","259","32134","8.9","9"
"Gwinnett","2020-11-20","3410","341492","297","32431","8.9","9.1"
"Gwinnett","2020-11-21","2237","343729","189","32620","8.5","9"
"Gwinnett","2020-11-22","1281","345010","108","32728","8","8.7"
"Gwinnett","2020-11-23","3432","348442","296","33024","8.1","8.7"
"Gwinnett","2020-11-24","3111","351553","350","33374","8.6","8.9"
"Gwinnett","2020-11-25","3327","354880","319","33693","8.9","9"
"Gwinnett","2020-11-26","407","355287","45","33738","9.4","9.2"
"Gwinnett","2020-11-27","2650","357937","412","34150","10.4","9.7"
"Gwinnett","2020-11-28","1816","359753","332","34482","11.8","10.2"
"Gwinnett","2020-11-29","1236","360989","245","34727","13.5","10.7"
"Gwinnett","2020-11-30","4196","365185","589","35316","14.2","11.2"
"Gwinnett","2020-12-01","4065","369250","594","35910","14.7","11.6"
"Gwinnett","2020-12-02","3497","372747","481","36391","15.3","12.1"
"Gwinnett","2020-12-03","4016","376763","545","36936","15.7","12.6"
"Gwinnett","2020-12-04","3942","380705","553","37489","15.4","12.9"
"Gwinnett","2020-12-05","2219","382924","343","37832","15","13.4"
"Gwinnett","2020-12-06","1288","384212","249","38081","15","14.2"
"Gwinnett","2020-12-07","4288","388500","639","38720","15.1","14.7"
"Gwinnett","2020-12-08","4013","392513","667","39387","15.4","15"
"Gwinnett","2020-12-09","4069","396582","569","39956","15.4","15.4"
"Gwinnett","2020-12-10","4467","401049","693","40649","15.7","15.7"
"Gwinnett","2020-12-11","4068","405117","684","41333","16.1","15.8"
"Gwinnett","2020-12-12","3099","408216","526","41859","16.3","15.7"
"Gwinnett","2020-12-13","1487","409703","316","42175","16.6","15.8"
"Gwinnett","2020-12-14","4694","414397","779","42954","16.8","16"
"Gwinnett","2020-12-15","4695","419092","761","43715","16.8","16.1"
"Gwinnett","2020-12-16","3781","422873","582","44297","17","16.2"
"Gwinnett","2020-12-17","5015","427888","913","45210","17.3","16.5"
"Gwinnett","2020-12-18","4916","432804","812","46022","17.3","16.7"
"Gwinnett","2020-12-19","3477","436281","632","46654","17.5","16.9"
"Gwinnett","2020-12-20","1950","438231","511","47165","18.2","17.4"
"Gwinnett","2020-12-21","5118","443349","982","48147","18.6","17.7"
"Gwinnett","2020-12-22","4741","448090","896","49043","18.9","17.9"
"Gwinnett","2020-12-23","3941","452031","669","49712","19.2","18.1"
"Gwinnett","2020-12-24","3073","455104","538","50250","19.1","18.2"
"Gwinnett","2020-12-25","375","455479","69","50319","19.3","18.3"
"Gwinnett","2020-12-26","2799","458278","757","51076","20.6","19"
"Gwinnett","2020-12-27","1924","460202","558","51634","21","19.6"
"Gwinnett","2020-12-28","4965","465167","1079","52713","21.4","20"
"Gwinnett","2020-12-29","4873","470040","1232","53945","22.3","20.6"
"Gwinnett","2020-12-30","3837","473877","859","54804","23.1","21.1"
"Gwinnett","2020-12-31","3321","477198","608","55412","23.2","21.1"
"Gwinnett","2021-01-01","867","478065","218","55630","24.1","21.7"
"Gwinnett","2021-01-02","2981","481046","772","56402","24","22.3"
"Gwinnett","2021-01-03","1091","482137","279","56681","23.5","22.2"
"Gwinnett","2021-01-04","5189","487326","1229","57910","23.8","22.6"
"Gwinnett","2021-01-05","6133","493459","1439","59349","23.5","22.9"
"Gwinnett","2021-01-06","4011","497470","841","60190","23.3","23.2"
"Gwinnett","2021-01-07","5915","503385","1486","61676","24.3","23.7"
"Gwinnett","2021-01-08","4678","508063","1062","62738","23.9","24"
"Gwinnett","2021-01-09","3397","511460","888","63626","24","24"
"Gwinnett","2021-01-10","1974","513434","516","64142","24","23.8"
"Gwinnett","2021-01-11","4939","518373","1110","65252","23.9","23.8"
"Gwinnett","2021-01-12","4608","522981","934","66186","23.4","23.4"
"Gwinnett","2021-01-13","3373","526354","479","66665","22.4","22.9"
"Gwinnett","2021-01-14","4422","530776","966","67631","22","23.1"
"Gwinnett","2021-01-15","4305","535081","889","68520","21.7","22.8"
"Gwinnett","2021-01-16","2430","537511","644","69164","21.7","22.8"
"Gwinnett","2021-01-17","1776","539287","520","69684","22.2","23.1"
"Gwinnett","2021-01-18","3856","543143","735","70419","21.7","22.8"
"Gwinnett","2021-01-19","4115","547258","730","71149","21.3","22.4"
"Gwinnett","2021-01-20","3207","550465","442","71591","21.3","21.9"
"Gwinnett","2021-01-21","4173","554638","741","72332","20.7","21.3"
"Gwinnett","2021-01-22","4183","558821","700","73032","20.1","20.9"
"Gwinnett","2021-01-23","2183","561004","506","73538","19.6","20.7"
"Gwinnett","2021-01-24","1781","562785","409","73947","18.7","20.5"
"Gwinnett","2021-01-25","4511","567296","685","74632","18.2","19.9"
"Gwinnett","2021-01-26","3743","571039","629","75261","18.1","19.7"
"Gwinnett","2021-01-27","3019","574058","421","75682","18.1","19.7"
"Gwinnett","2021-01-28","3910","577968","649","76331","17.9","19.3"
"Gwinnett","2021-01-29","3562","581530","476","76807","17.4","18.8"
"Gwinnett","2021-01-30","2417","583947","375","77182","16.3","18"
"Gwinnett","2021-01-31","1494","585441","301","77483","15.9","17.3"
"Gwinnett","2021-02-01","3882","589323","502","77985","15.6","16.9"
"Gwinnett","2021-02-02","3206","592529","375","78360","14.9","16.5"
"Gwinnett","2021-02-03","2370","594899","257","78617","14.4","16.3"
"Gwinnett","2021-02-04","2826","597725","396","79013","14.1","16"
"Gwinnett","2021-02-05","2096","599821","293","79306","14.2","15.8"
"Gwinnett","2021-02-06","624","600445","96","79402","14.1","15.2"
"Gwinnett","2021-02-07","56","600501","8","79410","13.3","14.6"
"Gwinnett","2021-02-08","0","600501","0","79410","11.5","13.5"
"Habersham","2020-02-01","0","0","0","0",".","."
"Habersham","2020-02-02","0","0","0","0",".","."
"Habersham","2020-02-03","0","0","0","0",".","."
"Habersham","2020-02-04","0","0","0","0",".","."
"Habersham","2020-02-05","0","0","0","0",".","."
"Habersham","2020-02-06","0","0","0","0",".","."
"Habersham","2020-02-07","0","0","0","0","0","."
"Habersham","2020-02-08","0","0","0","0","0","."
"Habersham","2020-02-09","0","0","0","0","0","."
"Habersham","2020-02-10","0","0","0","0","0","."
"Habersham","2020-02-11","0","0","0","0","0","."
"Habersham","2020-02-12","0","0","0","0","0","."
"Habersham","2020-02-13","0","0","0","0","0","."
"Habersham","2020-02-14","0","0","0","0","0","0"
"Habersham","2020-02-15","0","0","0","0","0","0"
"Habersham","2020-02-16","0","0","0","0","0","0"
"Habersham","2020-02-17","0","0","0","0","0","0"
"Habersham","2020-02-18","0","0","0","0","0","0"
"Habersham","2020-02-19","0","0","0","0","0","0"
"Habersham","2020-02-20","0","0","0","0","0","0"
"Habersham","2020-02-21","0","0","0","0","0","0"
"Habersham","2020-02-22","0","0","0","0","0","0"
"Habersham","2020-02-23","0","0","0","0","0","0"
"Habersham","2020-02-24","0","0","0","0","0","0"
"Habersham","2020-02-25","0","0","0","0","0","0"
"Habersham","2020-02-26","0","0","0","0","0","0"
"Habersham","2020-02-27","0","0","0","0","0","0"
"Habersham","2020-02-28","0","0","0","0","0","0"
"Habersham","2020-02-29","0","0","0","0","0","0"
"Habersham","2020-03-01","0","0","0","0","0","0"
"Habersham","2020-03-02","0","0","0","0","0","0"
"Habersham","2020-03-03","0","0","0","0","0","0"
"Habersham","2020-03-04","0","0","0","0","0","0"
"Habersham","2020-03-05","0","0","0","0","0","0"
"Habersham","2020-03-06","0","0","0","0","0","0"
"Habersham","2020-03-07","0","0","0","0","0","0"
"Habersham","2020-03-08","0","0","0","0","0","0"
"Habersham","2020-03-09","0","0","0","0","0","0"
"Habersham","2020-03-10","1","1","0","0","0","0"
"Habersham","2020-03-11","1","2","0","0","0","0"
"Habersham","2020-03-12","1","3","0","0","0","0"
"Habersham","2020-03-13","0","3","0","0","0","0"
"Habersham","2020-03-14","0","3","0","0","0","0"
"Habersham","2020-03-15","0","3","0","0","0","0"
"Habersham","2020-03-16","4","7","0","0","0","0"
"Habersham","2020-03-17","4","11","0","0","0","0"
"Habersham","2020-03-18","9","20","0","0","0","0"
"Habersham","2020-03-19","14","34","0","0","0","0"
"Habersham","2020-03-20","6","40","0","0","0","0"
"Habersham","2020-03-21","7","47","0","0","0","0"
"Habersham","2020-03-22","10","57","0","0","0","0"
"Habersham","2020-03-23","12","69","0","0","0","0"
"Habersham","2020-03-24","10","79","0","0","0","0"
"Habersham","2020-03-25","8","87","0","0","0","0"
"Habersham","2020-03-26","4","91","0","0","0","0"
"Habersham","2020-03-27","2","93","0","0","0","0"
"Habersham","2020-03-28","0","93","0","0","0","0"
"Habersham","2020-03-29","0","93","0","0","0","0"
"Habersham","2020-03-30","3","96","0","0","0","0"
"Habersham","2020-03-31","5","101","0","0","0","0"
"Habersham","2020-04-01","3","104","0","0","0","0"
"Habersham","2020-04-02","1","105","0","0","0","0"
"Habersham","2020-04-03","5","110","0","0","0","0"
"Habersham","2020-04-04","0","110","0","0","0","0"
"Habersham","2020-04-05","0","110","0","0","0","0"
"Habersham","2020-04-06","3","113","1","1","4.8","2.4"
"Habersham","2020-04-07","3","116","0","1","4.8","2.4"
"Habersham","2020-04-08","4","120","0","1","4.8","2.4"
"Habersham","2020-04-09","1","121","1","2","19","9.5"
"Habersham","2020-04-10","8","129","1","3","20.8","10.4"
"Habersham","2020-04-11","0","129","0","3","20.8","10.4"
"Habersham","2020-04-12","0","129","0","3","20.8","10.4"
"Habersham","2020-04-13","3","132","1","4","20.8","12.8"
"Habersham","2020-04-14","12","144","3","7","24.4","14.6"
"Habersham","2020-04-15","5","149","3","10","33","18.9"
"Habersham","2020-04-16","17","166","8","18","25.4","22.2"
"Habersham","2020-04-17","21","187","11","29","31.1","26"
"Habersham","2020-04-18","2","189","1","30","38.3","29.5"
"Habersham","2020-04-19","0","189","0","30","38.3","29.5"
"Habersham","2020-04-20","18","207","2","32","35.1","28"
"Habersham","2020-04-21","13","220","3","35","34.8","29.6"
"Habersham","2020-04-22","19","239","1","36","27","30"
"Habersham","2020-04-23","15","254","5","41","25","25.2"
"Habersham","2020-04-24","17","271","2","43","19.2","25.2"
"Habersham","2020-04-25","2","273","0","43","12.1","25.2"
"Habersham","2020-04-26","2","275","1","44","19.2","28.7"
"Habersham","2020-04-27","18","293","2","46","19.2","27.2"
"Habersham","2020-04-28","62","355","10","56","18.2","26.5"
"Habersham","2020-04-29","247","602","49","105","20.3","23.6"
"Habersham","2020-04-30","279","881","56","161","18.4","21.7"
"Habersham","2020-05-01","22","903","3","164","18.7","19"
"Habersham","2020-05-02","8","911","0","164","18.7","15.4"
"Habersham","2020-05-03","17","928","0","164","11.5","15.4"
"Habersham","2020-05-04","11","939","0","164","10","14.6"
"Habersham","2020-05-05","28","967","0","164","7.6","12.9"
"Habersham","2020-05-06","15","982","1","165","5.8","13"
"Habersham","2020-05-07","23","1005","1","166","3.5","11"
"Habersham","2020-05-08","35","1040","1","167","2","10.3"
"Habersham","2020-05-09","8","1048","0","167","2","10.3"
"Habersham","2020-05-10","0","1048","0","167","2","6.8"
"Habersham","2020-05-11","20","1068","3","170","4.1","7"
"Habersham","2020-05-12","17","1085","2","172","5.8","6.7"
"Habersham","2020-05-13","13","1098","3","175","8.1","7"
"Habersham","2020-05-14","17","1115","4","179","10.9","7.2"
"Habersham","2020-05-15","111","1226","84","263","21.3","11.6"
"Habersham","2020-05-16","9","1235","0","263","21.3","11.6"
"Habersham","2020-05-17","9","1244","0","263","21.3","11.6"
"Habersham","2020-05-18","45","1289","1","264","19.5","11.8"
"Habersham","2020-05-19","71","1360","7","271","19.2","12.5"
"Habersham","2020-05-20","49","1409","4","275","17.1","12.6"
"Habersham","2020-05-21","55","1464","8","283","15.8","13.3"
"Habersham","2020-05-22","61","1525","8","291","6.8","14.1"
"Habersham","2020-05-23","13","1538","1","292","7.9","14.6"
"Habersham","2020-05-24","2","1540","1","293","15.1","18.2"
"Habersham","2020-05-25","1","1541","0","293","14.8","17.1"
"Habersham","2020-05-26","22","1563","4","297","16","17.6"
"Habersham","2020-05-27","15","1578","4","301","18.6","17.8"
"Habersham","2020-05-28","31","1609","2","303","17.4","16.6"
"Habersham","2020-05-29","14","1623","0","303","15.6","11.2"
"Habersham","2020-05-30","9","1632","1","304","16.1","12"
"Habersham","2020-05-31","5","1637","1","305","11.8","13.4"
"Habersham","2020-06-01","18","1655","2","307","13.4","14.1"
"Habersham","2020-06-02","25","1680","1","308","11.3","13.6"
"Habersham","2020-06-03","30","1710","6","314","10.4","14.5"
"Habersham","2020-06-04","26","1736","7","321","13.3","15.4"
"Habersham","2020-06-05","16","1752","4","325","16.9","16.2"
"Habersham","2020-06-06","16","1768","2","327","17.1","16.6"
"Habersham","2020-06-07","5","1773","3","330","22.8","17.3"
"Habersham","2020-06-08","70","1843","19","349","25.1","19.2"
"Habersham","2020-06-09","39","1882","1","350","24.9","18.1"
"Habersham","2020-06-10","15","1897","7","357","28.7","19.5"
"Habersham","2020-06-11","20","1917","4","361","27.7","20.5"
"Habersham","2020-06-12","24","1941","4","365","26.5","21.7"
"Habersham","2020-06-13","10","1951","0","365","24.7","20.9"
"Habersham","2020-06-14","3","1954","0","365","16.1","19.5"
"Habersham","2020-06-15","68","2022","7","372","13.7","19.4"
"Habersham","2020-06-16","25","2047","2","374","14.5","19.7"
"Habersham","2020-06-17","23","2070","8","382","12.8","20.8"
"Habersham","2020-06-18","29","2099","4","386","11.9","19.8"
"Habersham","2020-06-19","28","2127","4","390","11.6","19"
"Habersham","2020-06-20","19","2146","1","391","12.3","18.5"
"Habersham","2020-06-21","2","2148","0","391","12.3","14.2"
"Habersham","2020-06-22","25","2173","4","395","13.2","13.5"
"Habersham","2020-06-23","28","2201","0","395","12","13.3"
"Habersham","2020-06-24","32","2233","12","407","12.4","12.6"
"Habersham","2020-06-25","62","2295","25","432","16.2","14.1"
"Habersham","2020-06-26","18","2313","6","438","18.9","15.3"
"Habersham","2020-06-27","21","2334","6","444","22.2","17.3"
"Habersham","2020-06-28","25","2359","8","452","26.8","19.6"
"Habersham","2020-06-29","50","2409","14","466","28.5","20.8"
"Habersham","2020-06-30","42","2451","7","473","30.9","21.5"
"Habersham","2020-07-01","22","2473","3","476","27.5","20"
"Habersham","2020-07-02","33","2506","2","478","22.6","19.4"
"Habersham","2020-07-03","34","2540","6","484","20.4","19.6"
"Habersham","2020-07-04","26","2566","3","487","17.9","20.1"
"Habersham","2020-07-05","26","2592","3","490","15","20.9"
"Habersham","2020-07-06","41","2633","6","496","13.1","20.8"
"Habersham","2020-07-07","65","2698","8","504","12.5","21.7"
"Habersham","2020-07-08","62","2760","14","518","13.8","20.6"
"Habersham","2020-07-09","67","2827","11","529","15.2","18.9"
"Habersham","2020-07-10","34","2861","9","538","16.5","18.4"
"Habersham","2020-07-11","49","2910","22","560","21.3","19.6"
"Habersham","2020-07-12","48","2958","13","573","23.5","19.2"
"Habersham","2020-07-13","28","2986","13","586","28","20.6"
"Habersham","2020-07-14","59","3045","12","598","29.2","20.8"
"Habersham","2020-07-15","106","3151","18","616","28.4","21.1"
"Habersham","2020-07-16","65","3216","15","631","29.3","22.3"
"Habersham","2020-07-17","60","3276","9","640","27.7","22.1"
"Habersham","2020-07-18","22","3298","3","643","23.2","22.2"
"Habersham","2020-07-19","29","3327","4","647","21.3","22.4"
"Habersham","2020-07-20","48","3375","9","656","17.4","22.7"
"Habersham","2020-07-21","88","3463","25","681","18.5","23.8"
"Habersham","2020-07-22","64","3527","10","691","18.3","23.4"
"Habersham","2020-07-23","67","3594","14","705","18","23.7"
"Habersham","2020-07-24","64","3658","24","729","21.2","24.5"
"Habersham","2020-07-25","39","3697","14","743","24.4","23.8"
"Habersham","2020-07-26","25","3722","6","749","25.9","23.6"
"Habersham","2020-07-27","42","3764","15","764","28.3","22.8"
"Habersham","2020-07-28","74","3838","16","780","27.3","22.9"
"Habersham","2020-07-29","93","3931","23","803","28.6","23.5"
"Habersham","2020-07-30","70","4001","15","818","28.7","23.4"
"Habersham","2020-07-31","60","4061","9","827","25.5","23.4"
"Habersham","2020-08-01","41","4102","12","839","24.5","24.5"
"Habersham","2020-08-02","11","4113","4","843","26.3","26.1"
"Habersham","2020-08-03","27","4140","10","853","26.5","27.4"
"Habersham","2020-08-04","67","4207","12","865","26","26.6"
"Habersham","2020-08-05","83","4290","16","881","25.2","26.9"
"Habersham","2020-08-06","52","4342","2","883","22.7","25.7"
"Habersham","2020-08-07","61","4403","12","895","23.3","24.4"
"Habersham","2020-08-08","11","4414","1","896","20.5","22.5"
"Habersham","2020-08-09","30","4444","6","902","18.1","22.2"
"Habersham","2020-08-10","46","4490","9","911","15.6","21.1"
"Habersham","2020-08-11","52","4542","8","919","15.3","20.6"
"Habersham","2020-08-12","60","4602","9","928","14.7","19.9"
"Habersham","2020-08-13","48","4650","3","931","15","18.8"
"Habersham","2020-08-14","26","4676","2","933","13.3","18.3"
"Habersham","2020-08-15","12","4688","1","934","13.2","16.8"
"Habersham","2020-08-16","30","4718","6","940","13.2","15.6"
"Habersham","2020-08-17","36","4754","2","942","11.2","13.4"
"Habersham","2020-08-18","50","4804","8","950","11.3","13.3"
"Habersham","2020-08-19","106","4910","11","961","10.6","12.6"
"Habersham","2020-08-20","37","4947","2","963","10.5","12.7"
"Habersham","2020-08-21","46","4993","2","965","10","11.6"
"Habersham","2020-08-22","61","5054","6","971","10.2","11.7"
"Habersham","2020-08-23","15","5069","1","972","8.3","10.7"
"Habersham","2020-08-24","42","5111","8","980","10.2","10.7"
"Habersham","2020-08-25","32","5143","3","983","9.3","10.3"
"Habersham","2020-08-26","126","5269","11","994","9.1","9.8"
"Habersham","2020-08-27","70","5339","9","1003","10.1","10.3"
"Habersham","2020-08-28","57","5396","4","1007","10.5","10.3"
"Habersham","2020-08-29","86","5482","13","1020","11.3","10.7"
"Habersham","2020-08-30","54","5536","4","1024","11.4","9.8"
"Habersham","2020-08-31","53","5589","7","1031","10.5","10.4"
"Habersham","2020-09-01","50","5639","6","1037","10.9","10.1"
"Habersham","2020-09-02","74","5713","5","1042","10.6","9.8"
"Habersham","2020-09-03","58","5771","5","1047","10","10.1"
"Habersham","2020-09-04","66","5837","2","1049","9.4","10"
"Habersham","2020-09-05","93","5930","6","1055","8.2","9.7"
"Habersham","2020-09-06","38","5968","6","1061","9.4","10.4"
"Habersham","2020-09-07","27","5995","4","1065","9.6","10.1"
"Habersham","2020-09-08","52","6047","7","1072","9.8","10.4"
"Habersham","2020-09-09","71","6118","17","1089","12.3","11.5"
"Habersham","2020-09-10","59","6177","9","1098","13.2","11.6"
"Habersham","2020-09-11","83","6260","16","1114","15.6","12.5"
"Habersham","2020-09-12","65","6325","11","1125","17.1","12.6"
"Habersham","2020-09-13","25","6350","3","1128","16.5","13"
"Habersham","2020-09-14","80","6430","18","1146","17.6","13.6"
"Habersham","2020-09-15","68","6498","10","1156","17.8","13.8"
"Habersham","2020-09-16","87","6585","7","1163","15.5","13.9"
"Habersham","2020-09-17","49","6634","8","1171","15.7","14.5"
"Habersham","2020-09-18","84","6718","12","1183","15","15.3"
"Habersham","2020-09-19","78","6796","10","1193","14.4","15.7"
"Habersham","2020-09-20","12","6808","3","1196","16.2","16.4"
"Habersham","2020-09-21","72","6880","13","1209","15.6","16.6"
"Habersham","2020-09-22","92","6972","20","1229","16.6","17.2"
"Habersham","2020-09-23","86","7058","15","1244","18","16.7"
"Habersham","2020-09-24","45","7103","9","1253","18.5","17.1"
"Habersham","2020-09-25","60","7163","10","1263","18.8","16.9"
"Habersham","2020-09-26","90","7253","13","1276","19","16.7"
"Habersham","2020-09-27","16","7269","2","1278","17.3","16.8"
"Habersham","2020-09-28","85","7354","17","1295","17.5","16.6"
"Habersham","2020-09-29","79","7433","15","1310","17.1","16.9"
"Habersham","2020-09-30","68","7501","17","1327","18.2","18.1"
"Habersham","2020-10-01","82","7583","16","1343","18.2","18.3"
"Habersham","2020-10-02","79","7662","17","1360","18.9","18.8"
"Habersham","2020-10-03","77","7739","8","1368","18.3","18.7"
"Habersham","2020-10-04","30","7769","6","1374","19.3","18.3"
"Habersham","2020-10-05","87","7856","10","1384","18.1","17.8"
"Habersham","2020-10-06","102","7958","10","1394","16.8","17"
"Habersham","2020-10-07","118","8076","7","1401","14.1","16.2"
"Habersham","2020-10-08","64","8140","9","1410","13.3","15.7"
"Habersham","2020-10-09","85","8225","2","1412","10.6","14.7"
"Habersham","2020-10-10","56","8281","3","1415","9.9","14.1"
"Habersham","2020-10-11","8","8289","3","1418","12.4","15.9"
"Habersham","2020-10-12","47","8336","5","1423","12.2","15.2"
"Habersham","2020-10-13","88","8424","4","1427","11.5","14.2"
"Habersham","2020-10-14","45","8469","4","1431","11.9","13"
"Habersham","2020-10-15","57","8526","6","1437","11.4","12.4"
"Habersham","2020-10-16","40","8566","0","1437","11.1","10.8"
"Habersham","2020-10-17","44","8610","5","1442","11.9","10.9"
"Habersham","2020-10-18","8","8618","1","1443","8.4","10.4"
"Habersham","2020-10-19","46","8664","10","1453","9.9","11.1"
"Habersham","2020-10-20","59","8723","4","1457","10.3","10.9"
"Habersham","2020-10-21","95","8818","8","1465","10.2","11"
"Habersham","2020-10-22","58","8876","5","1470","9.9","10.7"
"Habersham","2020-10-23","42","8918","2","1472","10.6","10.8"
"Habersham","2020-10-24","40","8958","5","1477","10.8","11.3"
"Habersham","2020-10-25","16","8974","3","1480","11.7","10"
"Habersham","2020-10-26","54","9028","4","1484","9.6","9.8"
"Habersham","2020-10-27","44","9072","5","1489","10.3","10.3"
"Habersham","2020-10-28","53","9125","4","1493","10.1","10.2"
"Habersham","2020-10-29","44","9169","9","1502","11.8","10.9"
"Habersham","2020-10-30","37","9206","3","1505","12.3","11.5"
"Habersham","2020-10-31","17","9223","3","1508","13","11.9"
"Habersham","2020-11-01","17","9240","1","1509","11.2","11.4"
"Habersham","2020-11-02","61","9301","8","1517","12","10.8"
"Habersham","2020-11-03","52","9353","0","1517","10.4","10.3"
"Habersham","2020-11-04","49","9402","5","1522","10.8","10.5"
"Habersham","2020-11-05","43","9445","3","1525","8.8","10.3"
"Habersham","2020-11-06","44","9489","6","1531","9.6","11"
"Habersham","2020-11-07","16","9505","3","1534","9.8","11.4"
"Habersham","2020-11-08","16","9521","3","1537","11.6","11.4"
"Habersham","2020-11-09","76","9597","17","1554","13","12.5"
"Habersham","2020-11-10","88","9685","30","1584","17.8","14.1"
"Habersham","2020-11-11","74","9759","13","1597","18.9","14.8"
"Habersham","2020-11-12","63","9822","15","1612","21.3","15.1"
"Habersham","2020-11-13","70","9892","13","1625","22","15.8"
"Habersham","2020-11-14","46","9938","11","1636","22.7","16.3"
"Habersham","2020-11-15","19","9957","3","1639","22.3","17"
"Habersham","2020-11-16","112","10069","37","1676","23.8","18.4"
"Habersham","2020-11-17","94","10163","14","1690","21.1","19.5"
"Habersham","2020-11-18","113","10276","22","1712","21.4","20.1"
"Habersham","2020-11-19","120","10396","24","1736","20.8","21"
"Habersham","2020-11-20","90","10486","12","1748","20.1","21"
"Habersham","2020-11-21","40","10526","6","1754","18.8","20.8"
"Habersham","2020-11-22","113","10639","8","1762","17.5","19.9"
"Habersham","2020-11-23","100","10739","19","1781","15.5","19.7"
"Habersham","2020-11-24","178","10917","35","1816","16.2","18.7"
"Habersham","2020-11-25","119","11036","32","1848","17.3","19.3"
"Habersham","2020-11-26","19","11055","2","1850","15.9","18.4"
"Habersham","2020-11-27","88","11143","26","1876","18.2","19.2"
"Habersham","2020-11-28","72","11215","15","1891","19.1","18.9"
"Habersham","2020-11-29","50","11265","22","1913","24.4","20.9"
"Habersham","2020-11-30","137","11402","27","1940","24.5","20"
"Habersham","2020-12-01","222","11624","23","1963","23.1","19.7"
"Habersham","2020-12-02","190","11814","30","1993","21.5","19.4"
"Habersham","2020-12-03","159","11973","22","2015","22","19"
"Habersham","2020-12-04","128","12101","34","2049","21.6","19.9"
"Habersham","2020-12-05","82","12183","20","2069","22.1","20.6"
"Habersham","2020-12-06","49","12232","18","2087","21.1","22.7"
"Habersham","2020-12-07","300","12532","50","2137","20.6","22.5"
"Habersham","2020-12-08","182","12714","21","2158","20.8","22"
"Habersham","2020-12-09","170","12884","29","2187","21","21.3"
"Habersham","2020-12-10","221","13105","26","2213","20.7","21.3"
"Habersham","2020-12-11","104","13209","19","2232","19.5","20.5"
"Habersham","2020-12-12","108","13317","27","2259","19.6","20.8"
"Habersham","2020-12-13","61","13378","16","2275","18.1","19.6"
"Habersham","2020-12-14","264","13642","37","2312","17.7","19.2"
"Habersham","2020-12-15","216","13858","35","2347","18.4","19.6"
"Habersham","2020-12-16","253","14111","40","2387","18.2","19.6"
"Habersham","2020-12-17","127","14238","37","2424","20.7","20.7"
"Habersham","2020-12-18","135","14373","25","2449","20.7","20.1"
"Habersham","2020-12-19","136","14509","25","2474","19.8","19.7"
"Habersham","2020-12-20","60","14569","14","2488","19.3","18.7"
"Habersham","2020-12-21","230","14799","49","2537","20.4","19"
"Habersham","2020-12-22","180","14979","34","2571","20.8","19.6"
"Habersham","2020-12-23","200","15179","57","2628","22.6","20.4"
"Habersham","2020-12-24","148","15327","26","2654","20.9","20.8"
"Habersham","2020-12-25","10","15337","4","2658","24","22.3"
"Habersham","2020-12-26","86","15423","21","2679","24.9","22.3"
"Habersham","2020-12-27","49","15472","18","2697","26.8","23.1"
"Habersham","2020-12-28","172","15644","46","2743","27.6","24"
"Habersham","2020-12-29","272","15916","56","2799","27.8","24.3"
"Habersham","2020-12-30","174","16090","40","2839","27","24.8"
"Habersham","2020-12-31","206","16296","39","2878","27.2","24.1"
"Habersham","2021-01-01","38","16334","9","2887","24.9","24.4"
"Habersham","2021-01-02","22","16356","6","2893","25.3","25.1"
"Habersham","2021-01-03","93","16449","25","2918","23.9","25.3"
"Habersham","2021-01-04","221","16670","38","2956","22.5","25"
"Habersham","2021-01-05","189","16859","60","3016","24.1","25.9"
"Habersham","2021-01-06","243","17102","55","3071","24","25.5"
"Habersham","2021-01-07","199","17301","40","3111","24.2","25.7"
"Habersham","2021-01-08","134","17435","37","3148","24.8","24.8"
"Habersham","2021-01-09","82","17517","20","3168","24.4","24.8"
"Habersham","2021-01-10","115","17632","15","3183","22.4","23.1"
"Habersham","2021-01-11","93","17725","27","3210","24.1","23.3"
"Habersham","2021-01-12","168","17893","31","3241","22.2","23.1"
"Habersham","2021-01-13","195","18088","22","3263","20.6","22.3"
"Habersham","2021-01-14","92","18180","24","3287","21.4","22.8"
"Habersham","2021-01-15","85","18265","14","3301","19.8","22.3"
"Habersham","2021-01-16","58","18323","11","3312","19","21.7"
"Habersham","2021-01-17","23","18346","7","3319","21.5","22"
"Habersham","2021-01-18","79","18425","12","3331","19.6","21.8"
"Habersham","2021-01-19","93","18518","12","3343","18.8","20.5"
"Habersham","2021-01-20","218","18736","18","3361","18.3","19.4"
"Habersham","2021-01-21","90","18826","10","3371","16.2","18.8"
"Habersham","2021-01-22","79","18905","13","3384","16.2","18"
"Habersham","2021-01-23","44","18949","5","3389","15.1","17.1"
"Habersham","2021-01-24","45","18994","11","3400","14.2","17.9"
"Habersham","2021-01-25","64","19058","11","3411","14.5","17"
"Habersham","2021-01-26","77","19135","11","3422","14.7","16.7"
"Habersham","2021-01-27","73","19208","20","3442","17.5","17.9"
"Habersham","2021-01-28","83","19291","9","3451","17.4","16.8"
"Habersham","2021-01-29","79","19370","18","3469","18.3","17.3"
"Habersham","2021-01-30","39","19409","15","3484","22.2","18.7"
"Habersham","2021-01-31","35","19444","3","3487","19.9","17.1"
"Habersham","2021-02-01","65","19509","14","3501","20.6","17.5"
"Habersham","2021-02-02","71","19580","8","3509","20.1","17.4"
"Habersham","2021-02-03","74","19654","9","3518","17.9","17.7"
"Habersham","2021-02-04","62","19716","10","3528","18.7","18.1"
"Habersham","2021-02-05","41","19757","9","3537","18.6","18.5"
"Habersham","2021-02-06","5","19762","2","3539","18.8","20.5"
"Habersham","2021-02-07","1","19763","1","3540","31.9","25.9"
"Habersham","2021-02-08","0","19763","0","3540","28.8","24.7"
"Hall","2020-02-01","0","0","0","0",".","."
"Hall","2020-02-02","0","0","0","0",".","."
"Hall","2020-02-03","0","0","0","0",".","."
"Hall","2020-02-04","0","0","0","0",".","."
"Hall","2020-02-05","0","0","0","0",".","."
"Hall","2020-02-06","0","0","0","0",".","."
"Hall","2020-02-07","0","0","0","0","0","."
"Hall","2020-02-08","0","0","0","0","0","."
"Hall","2020-02-09","0","0","0","0","0","."
"Hall","2020-02-10","0","0","0","0","0","."
"Hall","2020-02-11","0","0","0","0","0","."
"Hall","2020-02-12","0","0","0","0","0","."
"Hall","2020-02-13","0","0","0","0","0","."
"Hall","2020-02-14","0","0","0","0","0","0"
"Hall","2020-02-15","0","0","0","0","0","0"
"Hall","2020-02-16","0","0","0","0","0","0"
"Hall","2020-02-17","0","0","0","0","0","0"
"Hall","2020-02-18","0","0","0","0","0","0"
"Hall","2020-02-19","0","0","0","0","0","0"
"Hall","2020-02-20","0","0","0","0","0","0"
"Hall","2020-02-21","0","0","0","0","0","0"
"Hall","2020-02-22","0","0","0","0","0","0"
"Hall","2020-02-23","0","0","0","0","0","0"
"Hall","2020-02-24","0","0","0","0","0","0"
"Hall","2020-02-25","0","0","0","0","0","0"
"Hall","2020-02-26","0","0","0","0","0","0"
"Hall","2020-02-27","0","0","0","0","0","0"
"Hall","2020-02-28","0","0","0","0","0","0"
"Hall","2020-02-29","0","0","0","0","0","0"
"Hall","2020-03-01","0","0","0","0","0","0"
"Hall","2020-03-02","0","0","0","0","0","0"
"Hall","2020-03-03","0","0","0","0","0","0"
"Hall","2020-03-04","0","0","0","0","0","0"
"Hall","2020-03-05","6","6","0","0","0","0"
"Hall","2020-03-06","0","6","0","0","0","0"
"Hall","2020-03-07","0","6","0","0","0","0"
"Hall","2020-03-08","0","6","0","0","0","0"
"Hall","2020-03-09","0","6","0","0","0","0"
"Hall","2020-03-10","3","9","0","0","0","0"
"Hall","2020-03-11","2","11","0","0","0","0"
"Hall","2020-03-12","9","20","0","0","0","0"
"Hall","2020-03-13","8","28","1","1","1.8","0.9"
"Hall","2020-03-14","4","32","0","1","1.8","0.9"
"Hall","2020-03-15","24","56","1","2","2.4","1.2"
"Hall","2020-03-16","41","97","2","4","3.1","1.5"
"Hall","2020-03-17","45","142","2","6","3.7","1.9"
"Hall","2020-03-18","69","211","2","8","4.1","2.1"
"Hall","2020-03-19","88","299","6","14","5.1","2.6"
"Hall","2020-03-20","74","373","6","20","4.5","3.1"
"Hall","2020-03-21","42","415","5","25","6.2","4"
"Hall","2020-03-22","37","452","4","29","7.1","4.8"
"Hall","2020-03-23","53","505","10","39","9.1","6.1"
"Hall","2020-03-24","47","552","3","42","9.4","6.6"
"Hall","2020-03-25","56","608","8","50","11","7.6"
"Hall","2020-03-26","48","656","7","57","12.1","8.6"
"Hall","2020-03-27","23","679","6","63","14.7","9.6"
"Hall","2020-03-28","3","682","1","64","17.8","12"
"Hall","2020-03-29","2","684","0","64","16.2","11.7"
"Hall","2020-03-30","31","715","8","72","17.2","13.2"
"Hall","2020-03-31","21","736","7","79","21.1","15.2"
"Hall","2020-04-01","50","786","13","92","22.7","16.9"
"Hall","2020-04-02","36","822","8","100","23.8","18"
"Hall","2020-04-03","17","839","5","105","24.3","19.5"
"Hall","2020-04-04","2","841","1","106","26.7","22.2"
"Hall","2020-04-05","5","846","0","106","26.7","21.5"
"Hall","2020-04-06","51","897","11","117","26.1","21.6"
"Hall","2020-04-07","24","921","1","118","21.9","21.5"
"Hall","2020-04-08","38","959","9","127","21.6","22.2"
"Hall","2020-04-09","47","1006","9","136","21.1","22.5"
"Hall","2020-04-10","43","1049","13","149","21.3","22.8"
"Hall","2020-04-11","21","1070","5","154","17.5","22.1"
"Hall","2020-04-12","7","1077","1","155","19.6","23.1"
"Hall","2020-04-13","61","1138","15","170","20","23"
"Hall","2020-04-14","68","1206","15","185","22.5","22.2"
"Hall","2020-04-15","76","1282","24","209","23.7","22.6"
"Hall","2020-04-16","73","1355","16","225","24.1","22.6"
"Hall","2020-04-17","106","1461","23","248","22.8","22.1"
"Hall","2020-04-18","65","1526","11","259","21.9","19.7"
"Hall","2020-04-19","16","1542","0","259","19.8","19.7"
"Hall","2020-04-20","109","1651","25","284","19.6","19.8"
"Hall","2020-04-21","132","1783","25","309","19.1","20.8"
"Hall","2020-04-22","167","1950","26","335","16.9","20.3"
"Hall","2020-04-23","142","2092","22","357","15.9","20"
"Hall","2020-04-24","195","2287","26","383","14.7","18.8"
"Hall","2020-04-25","163","2450","10","393","13.2","17.5"
"Hall","2020-04-26","8","2458","1","394","15","17.4"
"Hall","2020-04-27","111","2569","16","410","13.8","16.7"
"Hall","2020-04-28","221","2790","24","434","12.6","15.9"
"Hall","2020-04-29","178","2968","12","446","11.4","14.1"
"Hall","2020-04-30","225","3193","24","470","10.7","13.3"
"Hall","2020-05-01","438","3631","39","509","10","12.4"
"Hall","2020-05-02","206","3837","17","526","10.3","11.8"
"Hall","2020-05-03","57","3894","3","529","9.3","12.1"
"Hall","2020-05-04","176","4070","23","552","9.1","11.4"
"Hall","2020-05-05","239","4309","14","566","8.4","10.5"
"Hall","2020-05-06","202","4511","23","589","9.1","10.2"
"Hall","2020-05-07","192","4703","15","604","8.6","9.7"
"Hall","2020-05-08","251","4954","10","614","7.9","9"
"Hall","2020-05-09","664","5618","28","642","7.4","8.9"
"Hall","2020-05-10","42","5660","2","644","7.3","8.3"
"Hall","2020-05-11","192","5852","12","656","6.3","7.7"
"Hall","2020-05-12","316","6168","13","669","6.1","7.2"
"Hall","2020-05-13","304","6472","12","681","5","7"
"Hall","2020-05-14","253","6725","19","700","5","6.8"
"Hall","2020-05-15","977","7702","60","760","5.3","6.6"
"Hall","2020-05-16","265","7967","16","776","5.5","6.5"
"Hall","2020-05-17","67","8034","9","785","6.8","7"
"Hall","2020-05-18","247","8281","28","813","7.5","6.9"
"Hall","2020-05-19","370","8651","51","864","8.9","7.5"
"Hall","2020-05-20","529","9180","50","914","9.7","7.3"
"Hall","2020-05-21","219","9399","34","948","10.8","7.9"
"Hall","2020-05-22","513","9912","50","998","11.3","8.3"
"Hall","2020-05-23","247","10159","4","1002","10.7","8.1"
"Hall","2020-05-24","89","10248","32","1034","13.9","10.3"
"Hall","2020-05-25","35","10283","5","1039","14.3","10.9"
"Hall","2020-05-26","239","10522","102","1141","18.5","13.7"
"Hall","2020-05-27","540","11062","38","1179","18.1","13.9"
"Hall","2020-05-28","281","11343","44","1223","18.1","14.5"
"Hall","2020-05-29","243","11586","36","1259","18.9","15.1"
"Hall","2020-05-30","350","11936","50","1309","20.7","15.7"
"Hall","2020-05-31","39","11975","7","1316","18.1","16"
"Hall","2020-06-01","223","12198","69","1385","20.5","17.4"
"Hall","2020-06-02","293","12491","30","1415","15.8","17.2"
"Hall","2020-06-03","301","12792","52","1467","17.3","17.7"
"Hall","2020-06-04","383","13175","66","1533","17.5","17.8"
"Hall","2020-06-05","325","13500","49","1582","17.6","18.2"
"Hall","2020-06-06","445","13945","33","1615","16.6","18.6"
"Hall","2020-06-07","93","14038","26","1641","18","18.1"
"Hall","2020-06-08","188","14226","44","1685","16.9","18.7"
"Hall","2020-06-09","250","14476","28","1713","17.1","16.5"
"Hall","2020-06-10","586","15062","71","1784","16.3","16.8"
"Hall","2020-06-11","407","15469","46","1830","15.5","16.5"
"Hall","2020-06-12","250","15719","71","1901","17.4","17.5"
"Hall","2020-06-13","590","16309","59","1960","17.8","17.2"
"Hall","2020-06-14","57","16366","6","1966","15.3","16.6"
"Hall","2020-06-15","319","16685","30","1996","13.3","15.1"
"Hall","2020-06-16","286","16971","25","2021","12.9","15"
"Hall","2020-06-17","636","17607","82","2103","13","14.7"
"Hall","2020-06-18","405","18012","61","2164","13.6","14.5"
"Hall","2020-06-19","266","18278","81","2245","13.9","15.6"
"Hall","2020-06-20","362","18640","29","2274","13.6","15.7"
"Hall","2020-06-21","76","18716","6","2280","13.2","14.2"
"Hall","2020-06-22","518","19234","158","2438","16.2","14.8"
"Hall","2020-06-23","232","19466","14","2452","15.8","14.4"
"Hall","2020-06-24","827","20293","45","2497","14.8","13.9"
"Hall","2020-06-25","807","21100","87","2584","14.2","13.9"
"Hall","2020-06-26","383","21483","47","2631","11.6","12.7"
"Hall","2020-06-27","645","22128","60","2691","11.7","12.7"
"Hall","2020-06-28","130","22258","22","2713","13","13.1"
"Hall","2020-06-29","549","22807","91","2804","11","13.6"
"Hall","2020-06-30","535","23342","80","2884","12.3","14.1"
"Hall","2020-07-01","366","23708","57","2941","13.8","14.3"
"Hall","2020-07-02","658","24366","94","3035","14.3","14.2"
"Hall","2020-07-03","425","24791","89","3124","15.5","13.5"
"Hall","2020-07-04","428","25219","37","3161","15.4","13.6"
"Hall","2020-07-05","264","25483","62","3223","16.4","14.7"
"Hall","2020-07-06","672","26155","103","3326","16.2","13.6"
"Hall","2020-07-07","803","26958","105","3431","15.9","14.1"
"Hall","2020-07-08","1313","28271","344","3775","17.4","15.6"
"Hall","2020-07-09","1432","29703","318","4093","18.6","16.4"
"Hall","2020-07-10","1059","30762","316","4409","19.8","17.7"
"Hall","2020-07-11","999","31761","266","4675","22.4","18.9"
"Hall","2020-07-12","462","32223","179","4854","24.6","20.5"
"Hall","2020-07-13","1768","33991","521","5375","26.6","21.4"
"Hall","2020-07-14","1181","35172","340","5715","28.8","22.4"
"Hall","2020-07-15","1749","36921","384","6099","28.2","22.8"
"Hall","2020-07-16","1630","38551","306","6405","27.7","23.1"
"Hall","2020-07-17","1206","39757","321","6726","27.3","23.6"
"Hall","2020-07-18","705","40462","133","6859","26.2","24.3"
"Hall","2020-07-19","481","40943","98","6957","23.5","24.1"
"Hall","2020-07-20","1608","42551","509","7466","23.9","25.2"
"Hall","2020-07-21","1020","43571","204","7670","22.6","25.7"
"Hall","2020-07-22","1292","44863","310","7980","22.9","25.6"
"Hall","2020-07-23","1397","46260","276","8256","23","25.4"
"Hall","2020-07-24","1047","47307","222","8478","22.3","24.8"
"Hall","2020-07-25","996","48303","210","8688","22.6","24.4"
"Hall","2020-07-26","603","48906","187","8875","24.1","23.8"
"Hall","2020-07-27","1106","50012","302","9177","23.5","23.7"
"Hall","2020-07-28","724","50736","136","9313","23.3","23"
"Hall","2020-07-29","939","51675","234","9547","23.4","23.2"
"Hall","2020-07-30","1339","53014","286","9833","23.7","23.4"
"Hall","2020-07-31","911","53925","204","10037","23.8","23.1"
"Hall","2020-08-01","1042","54967","182","10219","23.3","23"
"Hall","2020-08-02","573","55540","136","10355","22.3","23.2"
"Hall","2020-08-03","529","56069","82","10437","20.6","22"
"Hall","2020-08-04","579","56648","203","10640","22.9","23.1"
"Hall","2020-08-05","706","57354","240","10880","24.2","23.8"
"Hall","2020-08-06","924","58278","195","11075","24.2","23.9"
"Hall","2020-08-07","384","58662","83","11158","24.1","24"
"Hall","2020-08-08","263","58925","34","11192","23.4","23.4"
"Hall","2020-08-09","543","59468","129","11321","23.4","22.9"
"Hall","2020-08-10","834","60302","165","11486","24","22.3"
"Hall","2020-08-11","622","60924","131","11617","22","22.5"
"Hall","2020-08-12","488","61412","89","11706","19.8","22"
"Hall","2020-08-13","753","62165","103","11809","18.7","21.5"
"Hall","2020-08-14","439","62604","88","11897","18.5","21.3"
"Hall","2020-08-15","295","62899","40","11937","18.6","21"
"Hall","2020-08-16","477","63376","109","12046","18.5","20.9"
"Hall","2020-08-17","441","63817","82","12128","18.3","21.2"
"Hall","2020-08-18","411","64228","78","12206","18","20"
"Hall","2020-08-19","423","64651","75","12281","17.9","18.9"
"Hall","2020-08-20","997","65648","111","12392","17.6","18.1"
"Hall","2020-08-21","630","66278","77","12469","16.4","17.5"
"Hall","2020-08-22","737","67015","77","12546","16","17.3"
"Hall","2020-08-23","217","67232","54","12600","16.3","17.4"
"Hall","2020-08-24","660","67892","96","12696","15.7","17"
"Hall","2020-08-25","702","68594","73","12769","14.5","16.2"
"Hall","2020-08-26","706","69300","137","12906","14.7","16.3"
"Hall","2020-08-27","1099","70399","107","13013","14.5","16"
"Hall","2020-08-28","696","71095","53","13066","13.9","15.2"
"Hall","2020-08-29","629","71724","32","13098","13.1","14.5"
"Hall","2020-08-30","447","72171","106","13204","12.9","14.6"
"Hall","2020-08-31","573","72744","97","13301","13.3","14.5"
"Hall","2020-09-01","488","73232","78","13379","14.1","14.3"
"Hall","2020-09-02","786","74018","97","13476","13.1","13.9"
"Hall","2020-09-03","719","74737","53","13529","12.7","13.6"
"Hall","2020-09-04","669","75406","31","13560","12.3","13.1"
"Hall","2020-09-05","645","76051","25","13585","12.1","12.6"
"Hall","2020-09-06","285","76336","51","13636","11.3","12.1"
"Hall","2020-09-07","234","76570","36","13672","11.1","12.2"
"Hall","2020-09-08","487","77057","111","13783","12","13.1"
"Hall","2020-09-09","899","77956","64","13847","11.3","12.2"
"Hall","2020-09-10","962","78918","85","13932","11.5","12.1"
"Hall","2020-09-11","701","79619","98","14030","12.8","12.6"
"Hall","2020-09-12","647","80266","69","14099","13.8","13"
"Hall","2020-09-13","136","80402","26","14125","14","12.6"
"Hall","2020-09-14","615","81017","93","14218","13.9","12.5"
"Hall","2020-09-15","805","81822","78","14296","12.1","12.1"
"Hall","2020-09-16","716","82538","60","14356","12.3","11.8"
"Hall","2020-09-17","764","83302","77","14433","12.4","12"
"Hall","2020-09-18","829","84131","63","14496","11.5","12.2"
"Hall","2020-09-19","729","84860","76","14572","11.5","12.6"
"Hall","2020-09-20","192","85052","18","14590","10.1","12"
"Hall","2020-09-21","562","85614","89","14679","10.2","12.1"
"Hall","2020-09-22","869","86483","91","14770","10.3","11.2"
"Hall","2020-09-23","697","87180","128","14898","11.7","12"
"Hall","2020-09-24","793","87973","60","14958","11.4","11.9"
"Hall","2020-09-25","710","88683","76","15034","11.8","11.7"
"Hall","2020-09-26","437","89120","54","15088","12.1","11.8"
"Hall","2020-09-27","109","89229","19","15107","13.2","11.7"
"Hall","2020-09-28","616","89845","68","15175","12.6","11.4"
"Hall","2020-09-29","824","90669","76","15251","12.4","11.3"
"Hall","2020-09-30","757","91426","35","15286","10.4","11.1"
"Hall","2020-10-01","1041","92467","80","15366","10.4","10.9"
"Hall","2020-10-02","532","92999","93","15459","11.4","11.6"
"Hall","2020-10-03","669","93668","83","15542","11.4","11.8"
"Hall","2020-10-04","243","93911","55","15597","12.2","12.7"
"Hall","2020-10-05","613","94524","97","15694","12.8","12.7"
"Hall","2020-10-06","696","95220","55","15749","12.7","12.5"
"Hall","2020-10-07","1026","96246","88","15837","13.2","11.8"
"Hall","2020-10-08","805","97051","60","15897","13.2","11.8"
"Hall","2020-10-09","652","97703","25","15922","11.2","11.3"
"Hall","2020-10-10","758","98461","37","15959","10.2","10.8"
"Hall","2020-10-11","129","98590","23","15982","9.5","10.8"
"Hall","2020-10-12","337","98927","41","16023","8.9","10.9"
"Hall","2020-10-13","663","99590","28","16051","8.4","10.5"
"Hall","2020-10-14","703","100293","39","16090","8","10.6"
"Hall","2020-10-15","770","101063","50","16140","7.9","10.5"
"Hall","2020-10-16","638","101701","32","16172","8","9.6"
"Hall","2020-10-17","526","102227","46","16218","8.6","9.4"
"Hall","2020-10-18","196","102423","18","16236","7.3","8.4"
"Hall","2020-10-19","466","102889","42","16278","6.9","7.9"
"Hall","2020-10-20","563","103452","42","16320","7.4","7.9"
"Hall","2020-10-21","883","104335","37","16357","7.2","7.6"
"Hall","2020-10-22","789","105124","64","16421","7.4","7.6"
"Hall","2020-10-23","614","105738","31","16452","7.4","7.7"
"Hall","2020-10-24","706","106444","45","16497","7.1","7.8"
"Hall","2020-10-25","198","106642","28","16525","7.8","7.6"
"Hall","2020-10-26","414","107056","36","16561","7.7","7.3"
"Hall","2020-10-27","620","107676","45","16606","7.7","7.5"
"Hall","2020-10-28","693","108369","28","16634","7.7","7.4"
"Hall","2020-10-29","550","108919","32","16666","7.3","7.4"
"Hall","2020-10-30","735","109654","58","16724","7.7","7.6"
"Hall","2020-10-31","584","110238","35","16759","7.7","7.4"
"Hall","2020-11-01","234","110472","34","16793","7.7","7.8"
"Hall","2020-11-02","406","110878","65","16858","8.8","8.3"
"Hall","2020-11-03","544","111422","56","16914","9.2","8.5"
"Hall","2020-11-04","704","112126","29","16943","9.2","8.5"
"Hall","2020-11-05","348","112474","54","16997","10.6","9"
"Hall","2020-11-06","657","113131","38","17035","10.3","9"
"Hall","2020-11-07","574","113705","64","17099","11.1","9.4"
"Hall","2020-11-08","152","113857","18","17117","10.7","9.2"
"Hall","2020-11-09","573","114430","89","17206","10.6","9.7"
"Hall","2020-11-10","629","115059","61","17267","10.5","9.9"
"Hall","2020-11-11","1019","116078","70","17337","10.9","10.1"
"Hall","2020-11-12","765","116843","94","17431","10.5","10.5"
"Hall","2020-11-13","500","117343","52","17483","11.1","10.7"
"Hall","2020-11-14","816","118159","69","17552","10.7","10.9"
"Hall","2020-11-15","146","118305","14","17566","10.4","10.5"
"Hall","2020-11-16","607","118912","76","17642","10","10.3"
"Hall","2020-11-17","1052","119964","114","17756","10.1","10.3"
"Hall","2020-11-18","822","120786","71","17827","10.4","10.7"
"Hall","2020-11-19","1123","121909","100","17927","9.9","10.2"
"Hall","2020-11-20","756","122665","78","18005","9.9","10.5"
"Hall","2020-11-21","632","123297","72","18077","10.3","10.5"
"Hall","2020-11-22","266","123563","37","18114","10.9","10.7"
"Hall","2020-11-23","738","124301","112","18226","11.3","10.6"
"Hall","2020-11-24","1197","125498","135","18361","11.4","10.8"
"Hall","2020-11-25","736","126234","95","18456","12","11.2"
"Hall","2020-11-26","394","126628","22","18478","11.5","10.7"
"Hall","2020-11-27","391","127019","63","18541","12.3","11.1"
"Hall","2020-11-28","940","127959","179","18720","13.4","11.9"
"Hall","2020-11-29","377","128336","114","18834","15.8","13.3"
"Hall","2020-11-30","990","129326","212","19046","16.7","14"
"Hall","2020-12-01","1564","130890","232","19278","17.2","14.3"
"Hall","2020-12-02","895","131785","137","19415","17.5","14.7"
"Hall","2020-12-03","1247","133032","239","19654","19.4","15.5"
"Hall","2020-12-04","1010","134042","192","19846","19.9","16.1"
"Hall","2020-12-05","1136","135178","164","20010","19.2","16.3"
"Hall","2020-12-06","453","135631","101","20111","18.1","16.9"
"Hall","2020-12-07","1114","136745","252","20363","18.2","17.4"
"Hall","2020-12-08","1350","138095","226","20589","18.5","17.8"
"Hall","2020-12-09","1005","139100","189","20778","19","18.3"
"Hall","2020-12-10","1272","140372","241","21019","19","19.2"
"Hall","2020-12-11","1189","141561","206","21225","18.7","19.3"
"Hall","2020-12-12","1194","142755","265","21490","19.8","19.5"
"Hall","2020-12-13","546","143301","140","21630","20.3","19.2"
"Hall","2020-12-14","1261","144562","314","21944","20.7","19.4"
"Hall","2020-12-15","1648","146210","311","22255","21","19.7"
"Hall","2020-12-16","1169","147379","291","22546","21.8","20.4"
"Hall","2020-12-17","1350","148729","312","22858","22.4","20.7"
"Hall","2020-12-18","1534","150263","314","23172","22.9","20.8"
"Hall","2020-12-19","901","151164","192","23364","22.7","21.3"
"Hall","2020-12-20","452","151616","116","23480","22.7","21.5"
"Hall","2020-12-21","1163","152779","305","23785","22.9","21.8"
"Hall","2020-12-22","1349","154128","309","24094","23.5","22.2"
"Hall","2020-12-23","1332","155460","246","24340","22.6","22.2"
"Hall","2020-12-24","910","156370","193","24533","22.3","22.4"
"Hall","2020-12-25","89","156459","20","24553","22.6","22.7"
"Hall","2020-12-26","764","157223","168","24721","22.7","22.7"
"Hall","2020-12-27","504","157727","173","24894","23.9","23.3"
"Hall","2020-12-28","1063","158790","329","25223","24.6","23.8"
"Hall","2020-12-29","1285","160075","324","25547","24.9","24.2"
"Hall","2020-12-30","1209","161284","306","25853","25.9","24.3"
"Hall","2020-12-31","1242","162526","247","26100","25.7","24"
"Hall","2021-01-01","326","162852","109","26209","27.3","25"
"Hall","2021-01-02","709","163561","142","26351","27","24.9"
"Hall","2021-01-03","780","164341","287","26638","27.4","25.7"
"Hall","2021-01-04","906","165247","242","26880","26.8","25.7"
"Hall","2021-01-05","1558","166805","374","27254","26.6","25.8"
"Hall","2021-01-06","1910","168715","455","27709","26.4","26.2"
"Hall","2021-01-07","1262","169977","342","28051","27.4","26.6"
"Hall","2021-01-08","1202","171179","258","28309","25.7","26.5"
"Hall","2021-01-09","851","172030","194","28503","26.1","26.6"
"Hall","2021-01-10","522","172552","136","28639","24.6","26"
"Hall","2021-01-11","1017","173569","257","28896","24.4","25.6"
"Hall","2021-01-12","1084","174653","213","29109","23.7","25.2"
"Hall","2021-01-13","1191","175844","277","29386","23.7","25"
"Hall","2021-01-14","899","176743","161","29547","22.3","24.9"
"Hall","2021-01-15","1373","178116","252","29799","21.9","23.8"
"Hall","2021-01-16","659","178775","130","29929","21.5","23.8"
"Hall","2021-01-17","452","179227","125","30054","21.7","23.1"
"Hall","2021-01-18","671","179898","143","30197","21.1","22.7"
"Hall","2021-01-19","1183","181081","163","30360","20.3","22"
"Hall","2021-01-20","1028","182109","146","30506","19","21.3"
"Hall","2021-01-21","976","183085","156","30662","18.7","20.5"
"Hall","2021-01-22","1151","184236","185","30847","18.4","20.1"
"Hall","2021-01-23","500","184736","76","30923","17.7","19.6"
"Hall","2021-01-24","411","185147","91","31014","17","19.3"
"Hall","2021-01-25","747","185894","135","31149","16.5","18.8"
"Hall","2021-01-26","1014","186908","119","31268","16.2","18.2"
"Hall","2021-01-27","918","187826","123","31391","16.1","17.5"
"Hall","2021-01-28","956","188782","100","31491","15.3","17"
"Hall","2021-01-29","775","189557","94","31585","14.7","16.6"
"Hall","2021-01-30","503","190060","63","31648","14.4","16"
"Hall","2021-01-31","405","190465","65","31713","13.5","15.2"
"Hall","2021-02-01","561","191026","93","31806","13.3","14.9"
"Hall","2021-02-02","828","191854","107","31913","13.4","14.8"
"Hall","2021-02-03","737","192591","89","32002","13.2","14.7"
"Hall","2021-02-04","922","193513","75","32077","12.9","14.1"
"Hall","2021-02-05","252","193765","35","32112","13.2","14"
"Hall","2021-02-06","44","193809","5","32117","13","13.7"
"Hall","2021-02-07","0","193809","0","32117","10.7","12.1"
"Hall","2021-02-08","0","193809","0","32117","8.3","10.8"
"Hancock","2020-02-01","0","0","0","0",".","."
"Hancock","2020-02-02","0","0","0","0",".","."
"Hancock","2020-02-03","0","0","0","0",".","."
"Hancock","2020-02-04","0","0","0","0",".","."
"Hancock","2020-02-05","0","0","0","0",".","."
"Hancock","2020-02-06","0","0","0","0",".","."
"Hancock","2020-02-07","0","0","0","0","0","."
"Hancock","2020-02-08","0","0","0","0","0","."
"Hancock","2020-02-09","0","0","0","0","0","."
"Hancock","2020-02-10","0","0","0","0","0","."
"Hancock","2020-02-11","0","0","0","0","0","."
"Hancock","2020-02-12","0","0","0","0","0","."
"Hancock","2020-02-13","0","0","0","0","0","."
"Hancock","2020-02-14","0","0","0","0","0","0"
"Hancock","2020-02-15","0","0","0","0","0","0"
"Hancock","2020-02-16","0","0","0","0","0","0"
"Hancock","2020-02-17","0","0","0","0","0","0"
"Hancock","2020-02-18","0","0","0","0","0","0"
"Hancock","2020-02-19","0","0","0","0","0","0"
"Hancock","2020-02-20","0","0","0","0","0","0"
"Hancock","2020-02-21","0","0","0","0","0","0"
"Hancock","2020-02-22","0","0","0","0","0","0"
"Hancock","2020-02-23","0","0","0","0","0","0"
"Hancock","2020-02-24","0","0","0","0","0","0"
"Hancock","2020-02-25","0","0","0","0","0","0"
"Hancock","2020-02-26","0","0","0","0","0","0"
"Hancock","2020-02-27","0","0","0","0","0","0"
"Hancock","2020-02-28","0","0","0","0","0","0"
"Hancock","2020-02-29","0","0","0","0","0","0"
"Hancock","2020-03-01","0","0","0","0","0","0"
"Hancock","2020-03-02","0","0","0","0","0","0"
"Hancock","2020-03-03","0","0","0","0","0","0"
"Hancock","2020-03-04","0","0","0","0","0","0"
"Hancock","2020-03-05","0","0","0","0","0","0"
"Hancock","2020-03-06","0","0","0","0","0","0"
"Hancock","2020-03-07","0","0","0","0","0","0"
"Hancock","2020-03-08","0","0","0","0","0","0"
"Hancock","2020-03-09","0","0","0","0","0","0"
"Hancock","2020-03-10","0","0","0","0","0","0"
"Hancock","2020-03-11","0","0","0","0","0","0"
"Hancock","2020-03-12","0","0","0","0","0","0"
"Hancock","2020-03-13","0","0","0","0","0","0"
"Hancock","2020-03-14","0","0","0","0","0","0"
"Hancock","2020-03-15","1","1","0","0","0","0"
"Hancock","2020-03-16","0","1","0","0","0","0"
"Hancock","2020-03-17","0","1","0","0","0","0"
"Hancock","2020-03-18","0","1","0","0","0","0"
"Hancock","2020-03-19","1","2","0","0","0","0"
"Hancock","2020-03-20","0","2","0","0","0","0"
"Hancock","2020-03-21","0","2","0","0","0","0"
"Hancock","2020-03-22","0","2","0","0","0","0"
"Hancock","2020-03-23","0","2","0","0","0","0"
"Hancock","2020-03-24","1","3","0","0","0","0"
"Hancock","2020-03-25","4","7","0","0","0","0"
"Hancock","2020-03-26","1","8","0","0","0","0"
"Hancock","2020-03-27","1","9","0","0","0","0"
"Hancock","2020-03-28","0","9","0","0","0","0"
"Hancock","2020-03-29","1","10","0","0","0","0"
"Hancock","2020-03-30","0","10","0","0","0","0"
"Hancock","2020-03-31","0","10","0","0","0","0"
"Hancock","2020-04-01","4","14","0","0","0","0"
"Hancock","2020-04-02","0","14","0","0","0","0"
"Hancock","2020-04-03","2","16","1","1","7.1","3.6"
"Hancock","2020-04-04","2","18","0","1","7.1","3.6"
"Hancock","2020-04-05","0","18","0","1","7.1","3.6"
"Hancock","2020-04-06","1","19","0","1","7.1","3.6"
"Hancock","2020-04-07","1","20","0","1","7.1","3.6"
"Hancock","2020-04-08","1","21","0","1","7.1","3.6"
"Hancock","2020-04-09","3","24","0","1","7.1","3.6"
"Hancock","2020-04-10","5","29","3","4","8.6","7.9"
"Hancock","2020-04-11","0","29","0","4","8.6","7.9"
"Hancock","2020-04-12","0","29","0","4","8.6","7.9"
"Hancock","2020-04-13","1","30","0","4","8.6","7.9"
"Hancock","2020-04-14","0","30","0","4","8.6","7.9"
"Hancock","2020-04-15","0","30","0","4","8.6","7.9"
"Hancock","2020-04-16","2","32","1","5","15.7","11.4"
"Hancock","2020-04-17","3","35","1","6","11.9","10.2"
"Hancock","2020-04-18","4","39","2","8","19","13.8"
"Hancock","2020-04-19","1","40","0","8","19","13.8"
"Hancock","2020-04-20","12","52","3","11","22.6","15.6"
"Hancock","2020-04-21","39","91","6","17","24.8","16.7"
"Hancock","2020-04-22","1","92","0","17","24.8","16.7"
"Hancock","2020-04-23","3","95","1","18","22.4","19.1"
"Hancock","2020-04-24","5","100","0","18","17.7","14.8"
"Hancock","2020-04-25","4","104","3","21","21.2","20.1"
"Hancock","2020-04-26","2","106","2","23","35.5","27.3"
"Hancock","2020-04-27","4","110","0","23","32","27.3"
"Hancock","2020-04-28","38","148","9","32","33.1","29"
"Hancock","2020-04-29","24","172","9","41","38.5","31.7"
"Hancock","2020-04-30","16","188","8","49","40.9","31.7"
"Hancock","2020-05-01","21","209","12","61","49","33.4"
"Hancock","2020-05-02","3","212","1","62","43.1","32.2"
"Hancock","2020-05-03","5","217","3","65","37.4","36.5"
"Hancock","2020-05-04","66","283","26","91","43","37.5"
"Hancock","2020-05-05","28","311","3","94","41.2","37.2"
"Hancock","2020-05-06","3","314","2","96","45.3","41.9"
"Hancock","2020-05-07","3","317","3","99","52.5","46.7"
"Hancock","2020-05-08","14","331","6","105","50.4","49.7"
"Hancock","2020-05-09","3","334","3","108","59.9","51.5"
"Hancock","2020-05-10","0","334","0","108","51.4","44.4"
"Hancock","2020-05-11","9","343","2","110","48.9","46"
"Hancock","2020-05-12","9","352","3","113","52.2","46.7"
"Hancock","2020-05-13","5","357","3","116","51.2","48.3"
"Hancock","2020-05-14","3","360","2","118","46.4","49.5"
"Hancock","2020-05-15","38","398","12","130","44.8","47.6"
"Hancock","2020-05-16","4","402","1","131","34.1","47"
"Hancock","2020-05-17","0","402","0","131","34.1","42.7"
"Hancock","2020-05-18","18","420","3","134","33.3","41.1"
"Hancock","2020-05-19","9","429","0","134","28.6","40.4"
"Hancock","2020-05-20","33","462","1","135","20.4","35.8"
"Hancock","2020-05-21","3","465","0","135","10.9","28.7"
"Hancock","2020-05-22","26","491","2","137","7.5","26.2"
"Hancock","2020-05-23","4","495","4","141","18.2","26.2"
"Hancock","2020-05-24","2","497","1","142","25.3","29.7"
"Hancock","2020-05-25","5","502","3","145","31.5","32.4"
"Hancock","2020-05-26","16","518","1","146","32.4","30.5"
"Hancock","2020-05-27","15","533","1","147","32.9","26.7"
"Hancock","2020-05-28","7","540","0","147","32.9","21.9"
"Hancock","2020-05-29","3","543","0","147","31.8","19.7"
"Hancock","2020-05-30","8","551","2","149","21.1","19.7"
"Hancock","2020-05-31","4","555","0","149","14","19.7"
"Hancock","2020-06-01","10","565","1","150","6.8","19.2"
"Hancock","2020-06-02","30","595","2","152","6.9","19.7"
"Hancock","2020-06-03","32","627","2","154","6.8","19.9"
"Hancock","2020-06-04","4","631","0","154","6.8","19.9"
"Hancock","2020-06-05","5","636","0","154","6.8","19.3"
"Hancock","2020-06-06","1","637","1","155","17.6","19.3"
"Hancock","2020-06-07","4","641","0","155","17.6","15.8"
"Hancock","2020-06-08","10","651","1","156","17.6","12.2"
"Hancock","2020-06-09","23","674","0","156","16.6","11.8"
"Hancock","2020-06-10","11","685","1","157","17","11.9"
"Hancock","2020-06-11","4","689","0","157","17","11.9"
"Hancock","2020-06-12","8","697","1","158","18.8","12.8"
"Hancock","2020-06-13","2","699","0","158","4.5","11"
"Hancock","2020-06-14","5","704","0","158","4.5","11"
"Hancock","2020-06-15","9","713","1","159","4.7","11.1"
"Hancock","2020-06-16","16","729","2","161","6.5","11.5"
"Hancock","2020-06-17","9","738","0","161","5.2","11.1"
"Hancock","2020-06-18","5","743","0","161","5.2","11.1"
"Hancock","2020-06-19","10","753","2","163","6.2","12.5"
"Hancock","2020-06-20","3","756","0","163","6.2","5.4"
"Hancock","2020-06-21","0","756","0","163","6.2","5.4"
"Hancock","2020-06-22","8","764","0","163","4.6","4.7"
"Hancock","2020-06-23","29","793","1","164","3.3","4.9"
"Hancock","2020-06-24","19","812","2","166","4.9","5"
"Hancock","2020-06-25","4","816","0","166","4.9","5"
"Hancock","2020-06-26","13","829","1","167","3.1","4.7"
"Hancock","2020-06-27","6","835","1","168","5.5","5.9"
"Hancock","2020-06-28","2","837","0","168","5.5","5.9"
"Hancock","2020-06-29","7","844","0","168","5.5","5.1"
"Hancock","2020-06-30","25","869","3","171","6.7","5"
"Hancock","2020-07-01","38","907","3","174","6.3","5.6"
"Hancock","2020-07-02","12","919","0","174","6.3","5.6"
"Hancock","2020-07-03","2","921","1","175","12.4","7.7"
"Hancock","2020-07-04","2","923","1","176","17.1","11.3"
"Hancock","2020-07-05","3","926","0","176","17.1","11.3"
"Hancock","2020-07-06","22","948","4","180","19.7","12.6"
"Hancock","2020-07-07","13","961","2","182","20.2","13.5"
"Hancock","2020-07-08","16","977","3","185","21.8","14"
"Hancock","2020-07-09","6","983","2","187","26.5","16.4"
"Hancock","2020-07-10","11","994","4","191","24.6","18.5"
"Hancock","2020-07-11","5","999","2","193","23.1","20.1"
"Hancock","2020-07-12","3","1002","0","193","23.1","20.1"
"Hancock","2020-07-13","10","1012","5","198","27.7","23.7"
"Hancock","2020-07-14","29","1041","4","202","27.5","23.8"
"Hancock","2020-07-15","38","1079","8","210","27.8","24.8"
"Hancock","2020-07-16","8","1087","1","211","24.8","25.7"
"Hancock","2020-07-17","7","1094","0","211","19.6","22.1"
"Hancock","2020-07-18","6","1100","0","211","13.9","18.5"
"Hancock","2020-07-19","6","1106","2","213","18.7","20.9"
"Hancock","2020-07-20","13","1119","2","215","13.7","20.7"
"Hancock","2020-07-21","34","1153","5","220","13.9","20.7"
"Hancock","2020-07-22","30","1183","7","227","14.2","21"
"Hancock","2020-07-23","11","1194","2","229","15","19.9"
"Hancock","2020-07-24","8","1202","2","231","18.6","19.1"
"Hancock","2020-07-25","11","1213","1","232","19.9","16.9"
"Hancock","2020-07-26","7","1220","2","234","19.2","18.9"
"Hancock","2020-07-27","8","1228","1","235","18.8","16.2"
"Hancock","2020-07-28","32","1260","7","242","19.8","16.8"
"Hancock","2020-07-29","11","1271","0","242","16.5","15.3"
"Hancock","2020-07-30","10","1281","1","243","15.3","15.1"
"Hancock","2020-07-31","16","1297","2","245","13.5","16"
"Hancock","2020-08-01","5","1302","0","245","12.2","16"
"Hancock","2020-08-02","5","1307","1","246","11","15.1"
"Hancock","2020-08-03","8","1315","0","246","9.2","14"
"Hancock","2020-08-04","24","1339","1","247","6.7","13.2"
"Hancock","2020-08-05","22","1361","5","252","9.9","13.2"
"Hancock","2020-08-06","6","1367","3","255","15.6","15.5"
"Hancock","2020-08-07","12","1379","3","258","17.4","15.5"
"Hancock","2020-08-08","5","1384","0","258","17.4","14.8"
"Hancock","2020-08-09","5","1389","3","261","23.1","17.1"
"Hancock","2020-08-10","5","1394","0","261","23.1","16.2"
"Hancock","2020-08-11","34","1428","6","267","25.1","15.9"
"Hancock","2020-08-12","21","1449","2","269","23.2","16.5"
"Hancock","2020-08-13","5","1454","2","271","21.7","18.7"
"Hancock","2020-08-14","15","1469","2","273","20.1","18.7"
"Hancock","2020-08-15","4","1473","0","273","20.1","18.7"
"Hancock","2020-08-16","2","1475","0","273","11.5","17.3"
"Hancock","2020-08-17","11","1486","0","273","11.5","17.3"
"Hancock","2020-08-18","17","1503","0","273","9","17"
"Hancock","2020-08-19","10","1513","1","274","9","16.1"
"Hancock","2020-08-20","4","1517","0","274","3.3","12.5"
"Hancock","2020-08-21","21","1538","1","275","2.1","11.1"
"Hancock","2020-08-22","4","1542","0","275","2.1","11.1"
"Hancock","2020-08-23","2","1544","0","275","2.1","6.8"
"Hancock","2020-08-24","6","1550","2","277","6.9","9.2"
"Hancock","2020-08-25","20","1570","3","280","9","9"
"Hancock","2020-08-26","6","1576","0","280","7.6","8.3"
"Hancock","2020-08-27","5","1581","0","280","7.6","5.5"
"Hancock","2020-08-28","11","1592","1","281","8.2","5.2"
"Hancock","2020-08-29","11","1603","0","281","8.2","5.2"
"Hancock","2020-08-30","0","1603","0","281","8.2","5.2"
"Hancock","2020-08-31","20","1623","1","282","4.2","5.5"
"Hancock","2020-09-01","10","1633","4","286","7.7","8.4"
"Hancock","2020-09-02","11","1644","1","287","9","8.3"
"Hancock","2020-09-03","7","1651","2","289","13.1","10.3"
"Hancock","2020-09-04","7","1658","1","290","13.8","11"
"Hancock","2020-09-05","10","1668","0","290","13.8","11"
"Hancock","2020-09-06","5","1673","0","290","13.8","11"
"Hancock","2020-09-07","1","1674","1","291","27.4","15.8"
"Hancock","2020-09-08","16","1690","1","292","22.6","15.2"
"Hancock","2020-09-09","13","1703","0","292","21.3","15.2"
"Hancock","2020-09-10","7","1710","1","293","19.3","16.2"
"Hancock","2020-09-11","4","1714","1","294","20.8","17.3"
"Hancock","2020-09-12","1","1715","0","294","20.8","17.3"
"Hancock","2020-09-13","3","1718","0","294","20.8","17.3"
"Hancock","2020-09-14","4","1722","0","294","6.5","17"
"Hancock","2020-09-15","11","1733","0","294","5.6","14.1"
"Hancock","2020-09-16","19","1752","1","295","6.4","13.8"
"Hancock","2020-09-17","4","1756","0","295","4.3","11.8"
"Hancock","2020-09-18","12","1768","1","296","1.9","11.4"
"Hancock","2020-09-19","6","1774","1","297","4.3","12.6"
"Hancock","2020-09-20","5","1779","0","297","4.3","12.6"
"Hancock","2020-09-21","7","1786","1","298","6.4","6.4"
"Hancock","2020-09-22","10","1796","1","299","7.8","6.7"
"Hancock","2020-09-23","9","1805","0","299","7","6.7"
"Hancock","2020-09-24","5","1810","0","299","7","5.7"
"Hancock","2020-09-25","4","1814","0","299","5.9","3.9"
"Hancock","2020-09-26","7","1821","0","299","3.5","3.9"
"Hancock","2020-09-27","3","1824","1","300","8.2","6.3"
"Hancock","2020-09-28","8","1832","0","300","6.2","6.3"
"Hancock","2020-09-29","7","1839","2","302","8.8","8.3"
"Hancock","2020-09-30","9","1848","1","303","10.4","8.7"
"Hancock","2020-10-01","7","1855","0","303","10.4","8.7"
"Hancock","2020-10-02","21","1876","1","304","11.1","8.5"
"Hancock","2020-10-03","29","1905","1","305","11.6","7.5"
"Hancock","2020-10-04","4","1909","0","305","6.8","7.5"
"Hancock","2020-10-05","9","1918","1","306","8.4","7.3"
"Hancock","2020-10-06","17","1935","3","309","6.9","7.9"
"Hancock","2020-10-07","34","1969","1","310","5.7","8.1"
"Hancock","2020-10-08","9","1978","0","310","5.7","8.1"
"Hancock","2020-10-09","58","2036","0","310","5","8.1"
"Hancock","2020-10-10","7","2043","1","311","6.6","9.1"
"Hancock","2020-10-11","0","2043","0","311","6.6","6.7"
"Hancock","2020-10-12","11","2054","0","311","5","6.7"
"Hancock","2020-10-13","14","2068","5","316","7.6","7.2"
"Hancock","2020-10-14","5","2073","0","316","7.1","6.4"
"Hancock","2020-10-15","43","2116","1","317","7.5","6.6"
"Hancock","2020-10-16","19","2135","0","317","7.5","6.2"
"Hancock","2020-10-17","1","2136","0","317","5.4","6"
"Hancock","2020-10-18","4","2140","0","317","5.4","6"
"Hancock","2020-10-19","19","2159","0","317","5.4","5.2"
"Hancock","2020-10-20","17","2176","1","318","1.2","4.4"
"Hancock","2020-10-21","8","2184","0","318","1.2","4.2"
"Hancock","2020-10-22","8","2192","0","318","0.8","4.2"
"Hancock","2020-10-23","14","2206","1","319","1.9","4.7"
"Hancock","2020-10-24","4","2210","0","319","1.9","3.6"
"Hancock","2020-10-25","7","2217","2","321","5.9","5.7"
"Hancock","2020-10-26","9","2226","2","323","9.1","7.3"
"Hancock","2020-10-27","27","2253","3","326","9.9","5.5"
"Hancock","2020-10-28","6","2259","0","326","9.9","5.5"
"Hancock","2020-10-29","6","2265","1","327","12.2","6.5"
"Hancock","2020-10-30","13","2278","0","327","11.2","6.5"
"Hancock","2020-10-31","9","2287","0","327","11.2","6.5"
"Hancock","2020-11-01","0","2287","0","327","7.1","6.5"
"Hancock","2020-11-02","11","2298","0","327","4","6.5"
"Hancock","2020-11-03","15","2313","2","329","4.3","7.1"
"Hancock","2020-11-04","10","2323","0","329","4.3","7.1"
"Hancock","2020-11-05","15","2338","2","331","3.8","8"
"Hancock","2020-11-06","18","2356","2","333","5.4","8.3"
"Hancock","2020-11-07","8","2364","1","334","7.2","9.2"
"Hancock","2020-11-08","4","2368","0","334","7.2","7.2"
"Hancock","2020-11-09","12","2380","0","334","7.2","5.6"
"Hancock","2020-11-10","19","2399","1","335","6","5.2"
"Hancock","2020-11-11","5","2404","0","335","6","5.2"
"Hancock","2020-11-12","69","2473","9","344","6","4.9"
"Hancock","2020-11-13","94","2567","7","351","5.5","5.4"
"Hancock","2020-11-14","4","2571","1","352","7.3","7.2"
"Hancock","2020-11-15","4","2575","1","353","10.8","9"
"Hancock","2020-11-16","94","2669","26","379","14.8","11"
"Hancock","2020-11-17","17","2686","1","380","14.9","10.4"
"Hancock","2020-11-18","10","2696","2","382","17.7","11.9"
"Hancock","2020-11-19","6","2702","0","382","15.9","10.9"
"Hancock","2020-11-20","5","2707","0","382","14.8","10.1"
"Hancock","2020-11-21","4","2711","1","383","14.8","11"
"Hancock","2020-11-22","6","2717","1","384","13.6","12.2"
"Hancock","2020-11-23","13","2730","2","386","11.8","13.3"
"Hancock","2020-11-24","90","2820","31","417","15.9","15.4"
"Hancock","2020-11-25","89","2909","6","423","14","15.9"
"Hancock","2020-11-26","2","2911","0","423","14","14.9"
"Hancock","2020-11-27","9","2920","0","423","14","14.4"
"Hancock","2020-11-28","3","2923","2","425","20","17.4"
"Hancock","2020-11-29","5","2928","0","425","17.6","15.6"
"Hancock","2020-11-30","14","2942","0","425","15.4","13.6"
"Hancock","2020-12-01","10","2952","3","428","14.8","15.4"
"Hancock","2020-12-02","3","2955","0","428","13.8","13.9"
"Hancock","2020-12-03","6","2961","0","428","13.8","13.9"
"Hancock","2020-12-04","14","2975","1","429","14.8","14.4"
"Hancock","2020-12-05","6","2981","0","429","5.3","12.6"
"Hancock","2020-12-06","2","2983","0","429","5.3","11.5"
"Hancock","2020-12-07","15","2998","0","429","5.3","10.4"
"Hancock","2020-12-08","28","3026","4","433","3.1","8.9"
"Hancock","2020-12-09","6","3032","1","434","5.4","9.6"
"Hancock","2020-12-10","11","3043","2","436","8","10.9"
"Hancock","2020-12-11","6","3049","0","436","7","10.9"
"Hancock","2020-12-12","4","3053","1","437","10.6","7.9"
"Hancock","2020-12-13","6","3059","2","439","15.4","10.3"
"Hancock","2020-12-14","16","3075","3","442","18","11.7"
"Hancock","2020-12-15","10","3085","2","444","18.8","11"
"Hancock","2020-12-16","18","3103","4","448","19.6","12.5"
"Hancock","2020-12-17","68","3171","17","465","20.6","14.3"
"Hancock","2020-12-18","12","3183","5","470","26.6","16.8"
"Hancock","2020-12-19","10","3193","2","472","25.9","18.2"
"Hancock","2020-12-20","6","3199","3","475","28.2","21.8"
"Hancock","2020-12-21","54","3253","21","496","31.1","24.6"
"Hancock","2020-12-22","103","3356","12","508","29.9","24.4"
"Hancock","2020-12-23","24","3380","9","517","32.1","25.9"
"Hancock","2020-12-24","26","3406","8","525","32.9","26.8"
"Hancock","2020-12-25","4","3410","0","525","27","26.8"
"Hancock","2020-12-26","8","3418","3","528","29.5","27.7"
"Hancock","2020-12-27","8","3426","3","531","27.7","28"
"Hancock","2020-12-28","23","3449","6","537","25.9","28.5"
"Hancock","2020-12-29","52","3501","10","547","26.9","28.4"
"Hancock","2020-12-30","13","3514","4","551","26","29"
"Hancock","2020-12-31","11","3525","1","552","22.9","27.9"
"Hancock","2021-01-01","2","3527","2","554","37.2","32.1"
"Hancock","2021-01-02","9","3536","2","556","35","32.2"
"Hancock","2021-01-03","3","3539","2","558","39.2","33.4"
"Hancock","2021-01-04","18","3557","7","565","41","33.4"
"Hancock","2021-01-05","144","3701","26","591","40.8","33.9"
"Hancock","2021-01-06","17","3718","5","596","40.6","33.3"
"Hancock","2021-01-07","21","3739","8","604","44.8","33.8"
"Hancock","2021-01-08","25","3764","5","609","33.3","35.3"
"Hancock","2021-01-09","6","3770","2","611","34.9","35"
"Hancock","2021-01-10","6","3776","2","613","30.2","34.7"
"Hancock","2021-01-11","16","3792","7","620","30.9","35.9"
"Hancock","2021-01-12","27","3819","5","625","30.9","35.9"
"Hancock","2021-01-13","35","3854","9","634","30.4","35.5"
"Hancock","2021-01-14","12","3866","5","639","30.9","37.8"
"Hancock","2021-01-15","19","3885","4","643","31.1","32.2"
"Hancock","2021-01-16","8","3893","2","645","29.9","32.4"
"Hancock","2021-01-17","7","3900","1","646","27.1","28.7"
"Hancock","2021-01-18","11","3911","2","648","23.5","27.2"
"Hancock","2021-01-19","13","3924","4","652","25.2","28.1"
"Hancock","2021-01-20","30","3954","5","657","23.9","27.2"
"Hancock","2021-01-21","114","4068","0","657","18","24.4"
"Hancock","2021-01-22","13","4081","1","658","16.1","23.6"
"Hancock","2021-01-23","11","4092","2","660","15.1","22.5"
"Hancock","2021-01-24","8","4100","3","663","18.4","22.8"
"Hancock","2021-01-25","22","4122","3","666","17.8","20.6"
"Hancock","2021-01-26","9","4131","2","668","16.6","20.9"
"Hancock","2021-01-27","40","4171","3","671","15.2","19.6"
"Hancock","2021-01-28","10","4181","4","675","21","19.5"
"Hancock","2021-01-29","9","4190","1","676","21.5","18.8"
"Hancock","2021-01-30","11","4201","2","678","21.5","18.3"
"Hancock","2021-01-31","4","4205","0","678","16.1","17.3"
"Hancock","2021-02-01","8","4213","2","680","17.7","17.7"
"Hancock","2021-02-02","14","4227","2","682","16.6","16.6"
"Hancock","2021-02-03","26","4253","6","688","18.8","17"
"Hancock","2021-02-04","12","4265","0","688","13.1","17"
"Hancock","2021-02-05","7","4272","0","688","11.5","16.5"
"Hancock","2021-02-06","3","4275","0","688","8.9","15.2"
"Hancock","2021-02-07","1","4276","0","688","8.9","12.5"
"Hancock","2021-02-08","0","4276","0","688","5.3","11.5"
"Haralson","2020-02-01","0","0","0","0",".","."
"Haralson","2020-02-02","0","0","0","0",".","."
"Haralson","2020-02-03","0","0","0","0",".","."
"Haralson","2020-02-04","0","0","0","0",".","."
"Haralson","2020-02-05","0","0","0","0",".","."
"Haralson","2020-02-06","0","0","0","0",".","."
"Haralson","2020-02-07","0","0","0","0","0","."
"Haralson","2020-02-08","0","0","0","0","0","."
"Haralson","2020-02-09","0","0","0","0","0","."
"Haralson","2020-02-10","0","0","0","0","0","."
"Haralson","2020-02-11","0","0","0","0","0","."
"Haralson","2020-02-12","0","0","0","0","0","."
"Haralson","2020-02-13","0","0","0","0","0","."
"Haralson","2020-02-14","0","0","0","0","0","0"
"Haralson","2020-02-15","0","0","0","0","0","0"
"Haralson","2020-02-16","0","0","0","0","0","0"
"Haralson","2020-02-17","0","0","0","0","0","0"
"Haralson","2020-02-18","0","0","0","0","0","0"
"Haralson","2020-02-19","0","0","0","0","0","0"
"Haralson","2020-02-20","0","0","0","0","0","0"
"Haralson","2020-02-21","0","0","0","0","0","0"
"Haralson","2020-02-22","0","0","0","0","0","0"
"Haralson","2020-02-23","0","0","0","0","0","0"
"Haralson","2020-02-24","0","0","0","0","0","0"
"Haralson","2020-02-25","0","0","0","0","0","0"
"Haralson","2020-02-26","0","0","0","0","0","0"
"Haralson","2020-02-27","0","0","0","0","0","0"
"Haralson","2020-02-28","0","0","0","0","0","0"
"Haralson","2020-02-29","0","0","0","0","0","0"
"Haralson","2020-03-01","0","0","0","0","0","0"
"Haralson","2020-03-02","0","0","0","0","0","0"
"Haralson","2020-03-03","0","0","0","0","0","0"
"Haralson","2020-03-04","0","0","0","0","0","0"
"Haralson","2020-03-05","0","0","0","0","0","0"
"Haralson","2020-03-06","0","0","0","0","0","0"
"Haralson","2020-03-07","2","2","0","0","0","0"
"Haralson","2020-03-08","1","3","0","0","0","0"
"Haralson","2020-03-09","1","4","0","0","0","0"
"Haralson","2020-03-10","1","5","0","0","0","0"
"Haralson","2020-03-11","0","5","0","0","0","0"
"Haralson","2020-03-12","4","9","0","0","0","0"
"Haralson","2020-03-13","4","13","0","0","0","0"
"Haralson","2020-03-14","0","13","0","0","0","0"
"Haralson","2020-03-15","2","15","0","0","0","0"
"Haralson","2020-03-16","10","25","0","0","0","0"
"Haralson","2020-03-17","14","39","0","0","0","0"
"Haralson","2020-03-18","6","45","0","0","0","0"
"Haralson","2020-03-19","6","51","0","0","0","0"
"Haralson","2020-03-20","3","54","0","0","0","0"
"Haralson","2020-03-21","3","57","0","0","0","0"
"Haralson","2020-03-22","0","57","0","0","0","0"
"Haralson","2020-03-23","1","58","0","0","0","0"
"Haralson","2020-03-24","1","59","0","0","0","0"
"Haralson","2020-03-25","4","63","0","0","0","0"
"Haralson","2020-03-26","4","67","0","0","0","0"
"Haralson","2020-03-27","3","70","0","0","0","0"
"Haralson","2020-03-28","4","74","0","0","0","0"
"Haralson","2020-03-29","4","78","0","0","0","0"
"Haralson","2020-03-30","2","80","0","0","0","0"
"Haralson","2020-03-31","1","81","0","0","0","0"
"Haralson","2020-04-01","0","81","0","0","0","0"
"Haralson","2020-04-02","6","87","2","2","4.8","2.4"
"Haralson","2020-04-03","4","91","0","2","4.8","2.4"
"Haralson","2020-04-04","6","97","2","4","9.5","4.8"
"Haralson","2020-04-05","0","97","0","4","9.5","4.8"
"Haralson","2020-04-06","5","102","1","5","12.4","6.2"
"Haralson","2020-04-07","7","109","1","6","14.4","7.2"
"Haralson","2020-04-08","5","114","1","7","17.3","8.6"
"Haralson","2020-04-09","8","122","1","8","14.3","9.5"
"Haralson","2020-04-10","5","127","0","8","14.3","9.5"
"Haralson","2020-04-11","6","133","1","9","11.9","10.7"
"Haralson","2020-04-12","1","134","1","10","26.2","17.9"
"Haralson","2020-04-13","1","135","1","11","37.6","25"
"Haralson","2020-04-14","4","139","0","11","35.6","25"
"Haralson","2020-04-15","2","141","0","11","32.7","25"
"Haralson","2020-04-16","3","144","0","11","31","22.6"
"Haralson","2020-04-17","3","147","2","13","40.5","27.4"
"Haralson","2020-04-18","3","150","2","15","47.6","29.8"
"Haralson","2020-04-19","3","153","0","15","33.3","29.8"
"Haralson","2020-04-20","8","161","1","16","20.8","29.2"
"Haralson","2020-04-21","11","172","0","16","20.8","28.2"
"Haralson","2020-04-22","9","181","0","16","20.8","26.8"
"Haralson","2020-04-23","20","201","1","17","21.5","26.3"
"Haralson","2020-04-24","14","215","1","18","13","26.8"
"Haralson","2020-04-25","12","227","1","19","4.7","26.2"
"Haralson","2020-04-26","3","230","0","19","4.7","19"
"Haralson","2020-04-27","19","249","0","19","2.9","11.9"
"Haralson","2020-04-28","11","260","1","20","4.2","12.5"
"Haralson","2020-04-29","33","293","4","24","6","13.4"
"Haralson","2020-04-30","19","312","4","28","8.2","14.9"
"Haralson","2020-05-01","22","334","2","30","8.5","10.8"
"Haralson","2020-05-02","10","344","0","30","7.3","6"
"Haralson","2020-05-03","2","346","0","30","7.3","6"
"Haralson","2020-05-04","28","374","2","32","8.4","5.6"
"Haralson","2020-05-05","7","381","0","32","7.1","5.6"
"Haralson","2020-05-06","7","388","0","32","5.3","5.6"
"Haralson","2020-05-07","13","401","0","32","2.3","5.3"
"Haralson","2020-05-08","9","410","1","33","2.6","5.6"
"Haralson","2020-05-09","4","414","0","33","2.6","5"
"Haralson","2020-05-10","0","414","0","33","2.6","5"
"Haralson","2020-05-11","26","440","1","34","2.1","5.2"
"Haralson","2020-05-12","21","461","0","34","2.1","4.6"
"Haralson","2020-05-13","9","470","0","34","2.1","3.7"
"Haralson","2020-05-14","6","476","0","34","2.1","2.2"
"Haralson","2020-05-15","104","580","1","35","0.7","1.6"
"Haralson","2020-05-16","8","588","1","36","2.5","2.5"
"Haralson","2020-05-17","8","596","0","36","2.5","2.5"
"Haralson","2020-05-18","17","613","1","37","2.8","2.5"
"Haralson","2020-05-19","19","632","1","38","3.5","2.8"
"Haralson","2020-05-20","12","644","1","39","4.7","3.4"
"Haralson","2020-05-21","24","668","0","39","4.7","3.4"
"Haralson","2020-05-22","21","689","0","39","4.6","2.6"
"Haralson","2020-05-23","4","693","0","39","2.8","2.6"
"Haralson","2020-05-24","2","695","0","39","2.8","2.6"
"Haralson","2020-05-25","11","706","1","40","3.2","3"
"Haralson","2020-05-26","28","734","0","40","2.5","3"
"Haralson","2020-05-27","23","757","1","41","1.9","3.3"
"Haralson","2020-05-28","18","775","1","42","2.7","3.7"
"Haralson","2020-05-29","24","799","0","42","2.7","3.6"
"Haralson","2020-05-30","7","806","0","42","2.7","2.7"
"Haralson","2020-05-31","7","813","1","43","4.8","3.8"
"Haralson","2020-06-01","14","827","1","44","4.5","3.9"
"Haralson","2020-06-02","12","839","0","44","4.5","3.5"
"Haralson","2020-06-03","23","862","1","45","4.5","3.2"
"Haralson","2020-06-04","9","871","2","47","6.9","4.8"
"Haralson","2020-06-05","24","895","1","48","7.5","5.1"
"Haralson","2020-06-06","16","911","4","52","11","6.9"
"Haralson","2020-06-07","4","915","0","52","9","6.9"
"Haralson","2020-06-08","18","933","2","54","9.5","7"
"Haralson","2020-06-09","16","949","1","55","10.4","7.5"
"Haralson","2020-06-10","10","959","0","55","9.8","7.1"
"Haralson","2020-06-11","16","975","3","58","9.3","8.1"
"Haralson","2020-06-12","27","1002","0","58","8.7","8.1"
"Haralson","2020-06-13","3","1005","0","58","5.2","8.1"
"Haralson","2020-06-14","1","1006","1","59","19.4","14.2"
"Haralson","2020-06-15","19","1025","2","61","19.4","14.5"
"Haralson","2020-06-16","25","1050","1","62","19","14.7"
"Haralson","2020-06-17","22","1072","1","63","19.7","14.8"
"Haralson","2020-06-18","20","1092","3","66","19.2","14.2"
"Haralson","2020-06-19","24","1116","0","66","19.2","13.9"
"Haralson","2020-06-20","12","1128","1","67","20.3","12.8"
"Haralson","2020-06-21","7","1135","2","69","10.1","14.8"
"Haralson","2020-06-22","35","1170","2","71","9.5","14.4"
"Haralson","2020-06-23","21","1191","2","73","10.2","14.6"
"Haralson","2020-06-24","35","1226","3","76","10.8","15.3"
"Haralson","2020-06-25","32","1258","1","77","9.1","14.1"
"Haralson","2020-06-26","36","1294","4","81","10.7","14.9"
"Haralson","2020-06-27","13","1307","2","83","11.7","16"
"Haralson","2020-06-28","10","1317","2","85","10.5","10.3"
"Haralson","2020-06-29","28","1345","2","87","10.7","10.1"
"Haralson","2020-06-30","26","1371","1","88","9.9","10.1"
"Haralson","2020-07-01","46","1417","4","92","9.9","10.4"
"Haralson","2020-07-02","39","1456","4","96","10.9","10"
"Haralson","2020-07-03","15","1471","3","99","12.2","11.4"
"Haralson","2020-07-04","10","1481","2","101","12.8","12.3"
"Haralson","2020-07-05","3","1484","2","103","19.5","15"
"Haralson","2020-07-06","48","1532","11","114","21.8","16.2"
"Haralson","2020-07-07","43","1575","6","120","23.2","16.5"
"Haralson","2020-07-08","50","1625","6","126","23.7","16.8"
"Haralson","2020-07-09","48","1673","5","131","23.7","17.3"
"Haralson","2020-07-10","50","1723","9","140","23.4","17.8"
"Haralson","2020-07-11","20","1743","2","142","22","17.4"
"Haralson","2020-07-12","10","1753","0","142","12.5","16"
"Haralson","2020-07-13","48","1801","9","151","11.9","16.8"
"Haralson","2020-07-14","46","1847","9","160","12.7","17.9"
"Haralson","2020-07-15","30","1877","4","164","12.9","18.3"
"Haralson","2020-07-16","40","1917","9","173","14.6","19.2"
"Haralson","2020-07-17","62","1979","9","182","14.1","18.8"
"Haralson","2020-07-18","21","2000","5","187","16.1","19"
"Haralson","2020-07-19","11","2011","1","188","17.4","14.9"
"Haralson","2020-07-20","45","2056","12","200","18.5","15.2"
"Haralson","2020-07-21","51","2107","18","218","20.7","16.7"
"Haralson","2020-07-22","35","2142","11","229","23.3","18.1"
"Haralson","2020-07-23","36","2178","11","240","24.5","19.5"
"Haralson","2020-07-24","36","2214","7","247","25.2","19.6"
"Haralson","2020-07-25","8","2222","1","248","23.6","19.8"
"Haralson","2020-07-26","2","2224","0","248","22.3","19.8"
"Haralson","2020-07-27","35","2259","3","251","19.7","19.1"
"Haralson","2020-07-28","24","2283","4","255","17","18.9"
"Haralson","2020-07-29","24","2307","7","262","16.7","20"
"Haralson","2020-07-30","21","2328","3","265","14.4","19.4"
"Haralson","2020-07-31","26","2354","2","267","12.7","18.9"
"Haralson","2020-08-01","10","2364","4","271","16.6","20.1"
"Haralson","2020-08-02","9","2373","2","273","19.8","21"
"Haralson","2020-08-03","30","2403","6","279","21.4","20.6"
"Haralson","2020-08-04","27","2430","7","286","22.8","19.9"
"Haralson","2020-08-05","28","2458","4","290","20.6","18.7"
"Haralson","2020-08-06","26","2484","4","294","20.8","17.6"
"Haralson","2020-08-07","39","2523","16","310","25.5","19.1"
"Haralson","2020-08-08","21","2544","11","321","27.3","22"
"Haralson","2020-08-09","4","2548","2","323","31.3","25.5"
"Haralson","2020-08-10","41","2589","7","330","30.9","26.2"
"Haralson","2020-08-11","34","2623","10","340","31.4","27.1"
"Haralson","2020-08-12","29","2652","5","345","31.8","26.2"
"Haralson","2020-08-13","25","2677","3","348","31.3","26"
"Haralson","2020-08-14","27","2704","2","350","26.5","26"
"Haralson","2020-08-15","8","2712","0","350","19","23.2"
"Haralson","2020-08-16","5","2717","0","350","11.9","21.6"
"Haralson","2020-08-17","35","2752","8","358","12.7","21.8"
"Haralson","2020-08-18","46","2798","13","371","12.5","22"
"Haralson","2020-08-19","35","2833","10","381","14.2","23"
"Haralson","2020-08-20","28","2861","6","387","15.5","23.4"
"Haralson","2020-08-21","36","2897","8","395","17.6","22.1"
"Haralson","2020-08-22","14","2911","4","399","21.7","20.4"
"Haralson","2020-08-23","3","2914","0","399","21.7","16.8"
"Haralson","2020-08-24","33","2947","4","403","20.2","16.4"
"Haralson","2020-08-25","40","2987","5","408","17.9","15.2"
"Haralson","2020-08-26","37","3024","7","415","16.5","15.3"
"Haralson","2020-08-27","30","3054","4","419","15.4","15.4"
"Haralson","2020-08-28","32","3086","4","423","14","15.8"
"Haralson","2020-08-29","7","3093","1","424","12","16.8"
"Haralson","2020-08-30","3","3096","0","424","12","16.8"
"Haralson","2020-08-31","34","3130","7","431","13.2","16.7"
"Haralson","2020-09-01","34","3164","10","441","15.6","16.7"
"Haralson","2020-09-02","75","3239","6","447","14","15.3"
"Haralson","2020-09-03","37","3276","3","450","13.3","14.3"
"Haralson","2020-09-04","42","3318","3","453","12.5","13.2"
"Haralson","2020-09-05","4","3322","0","453","10.5","11.2"
"Haralson","2020-09-06","3","3325","0","453","10.5","11.2"
"Haralson","2020-09-07","12","3337","2","455","9.9","11.5"
"Haralson","2020-09-08","41","3378","6","461","7.8","11.7"
"Haralson","2020-09-09","82","3460","18","479","9.8","11.9"
"Haralson","2020-09-10","43","3503","7","486","11","12.1"
"Haralson","2020-09-11","30","3533","4","490","11.8","12.2"
"Haralson","2020-09-12","153","3686","4","494","12.2","11.3"
"Haralson","2020-09-13","12","3698","0","494","12.2","11.3"
"Haralson","2020-09-14","27","3725","2","496","10.9","10.4"
"Haralson","2020-09-15","33","3758","4","500","10.5","9.2"
"Haralson","2020-09-16","153","3911","8","508","8.1","9"
"Haralson","2020-09-17","41","3952","2","510","6.5","8.7"
"Haralson","2020-09-18","48","4000","4","514","5.8","8.8"
"Haralson","2020-09-19","75","4075","4","518","6.2","9.2"
"Haralson","2020-09-20","7","4082","1","519","8.2","10.2"
"Haralson","2020-09-21","25","4107","6","525","10.6","10.7"
"Haralson","2020-09-22","27","4134","5","530","11.5","11"
"Haralson","2020-09-23","89","4223","15","545","13.2","10.7"
"Haralson","2020-09-24","26","4249","9","554","17.4","12"
"Haralson","2020-09-25","24","4273","7","561","20.4","13.1"
"Haralson","2020-09-26","10","4283","6","567","28.2","17.2"
"Haralson","2020-09-27","5","4288","1","568","29","18.6"
"Haralson","2020-09-28","25","4313","3","571","27.3","19"
"Haralson","2020-09-29","31","4344","6","577","27.4","19.5"
"Haralson","2020-09-30","75","4419","13","590","27.5","20.3"
"Haralson","2020-10-01","110","4529","10","600","23.8","20.6"
"Haralson","2020-10-02","42","4571","7","607","22.1","21.2"
"Haralson","2020-10-03","46","4617","4","611","14.7","21.5"
"Haralson","2020-10-04","9","4626","0","611","11.9","20.4"
"Haralson","2020-10-05","29","4655","6","617","13.1","20.2"
"Haralson","2020-10-06","34","4689","11","628","15","21.2"
"Haralson","2020-10-07","149","4838","8","636","13.3","20.4"
"Haralson","2020-10-08","44","4882","4","640","13.3","18.6"
"Haralson","2020-10-09","36","4918","3","643","12.1","17.1"
"Haralson","2020-10-10","10","4928","5","648","18","16.4"
"Haralson","2020-10-11","2","4930","1","649","25.1","18.5"
"Haralson","2020-10-12","31","4961","5","654","24.5","18.8"
"Haralson","2020-10-13","40","5001","6","660","22","18.5"
"Haralson","2020-10-14","102","5103","10","670","22.6","17.9"
"Haralson","2020-10-15","46","5149","11","681","24.7","19"
"Haralson","2020-10-16","67","5216","8","689","25.3","18.7"
"Haralson","2020-10-17","35","5251","5","694","20.2","19.1"
"Haralson","2020-10-18","21","5272","1","695","13.7","19.4"
"Haralson","2020-10-19","50","5322","10","705","14.2","19.4"
"Haralson","2020-10-20","44","5366","10","715","15.3","18.7"
"Haralson","2020-10-21","84","5450","8","723","15.3","19"
"Haralson","2020-10-22","34","5484","9","732","15.7","20.2"
"Haralson","2020-10-23","53","5537","12","744","17.2","21.2"
"Haralson","2020-10-24","21","5558","8","752","20.6","20.4"
"Haralson","2020-10-25","4","5562","1","753","23.5","18.6"
"Haralson","2020-10-26","34","5596","12","765","25.7","20"
"Haralson","2020-10-27","34","5630","14","779","28.3","21.8"
"Haralson","2020-10-28","76","5706","13","792","29.4","22.4"
"Haralson","2020-10-29","18","5724","3","795","28","21.8"
"Haralson","2020-10-30","23","5747","5","800","27.9","22.5"
"Haralson","2020-10-31","14","5761","3","803","25.5","23"
"Haralson","2020-11-01","5","5766","1","804","24.8","24.1"
"Haralson","2020-11-02","38","5804","9","813","23.1","24.4"
"Haralson","2020-11-03","27","5831","4","817","19.3","23.8"
"Haralson","2020-11-04","97","5928","9","826","18.2","23.8"
"Haralson","2020-11-05","32","5960","6","832","18.5","23.3"
"Haralson","2020-11-06","37","5997","9","841","18.9","23.4"
"Haralson","2020-11-07","14","6011","5","846","20.9","23.2"
"Haralson","2020-11-08","2","6013","2","848","32.4","28.6"
"Haralson","2020-11-09","51","6064","5","853","30.4","26.7"
"Haralson","2020-11-10","53","6117","14","867","32","25.7"
"Haralson","2020-11-11","50","6167","16","883","35.3","26.8"
"Haralson","2020-11-12","46","6213","8","891","35.1","26.8"
"Haralson","2020-11-13","48","6261","13","904","35.5","27.2"
"Haralson","2020-11-14","27","6288","6","910","33.6","27.2"
"Haralson","2020-11-15","7","6295","3","913","25.4","28.9"
"Haralson","2020-11-16","54","6349","14","927","27.7","29"
"Haralson","2020-11-17","48","6397","5","932","25.4","28.7"
"Haralson","2020-11-18","126","6523","11","943","22.1","28.7"
"Haralson","2020-11-19","68","6591","10","953","21.7","28.4"
"Haralson","2020-11-20","60","6651","15","968","21.4","28.4"
"Haralson","2020-11-21","32","6683","9","977","22.3","27.9"
"Haralson","2020-11-22","8","6691","2","979","19.7","22.5"
"Haralson","2020-11-23","31","6722","3","982","17.4","22.5"
"Haralson","2020-11-24","26","6748","3","985","17.5","21.5"
"Haralson","2020-11-25","114","6862","16","1001","18.3","20.2"
"Haralson","2020-11-26","5","6867","2","1003","21.9","21.8"
"Haralson","2020-11-27","48","6915","10","1013","21.3","21.4"
"Haralson","2020-11-28","25","6940","7","1020","21.3","21.8"
"Haralson","2020-11-29","13","6953","2","1022","19.9","19.8"
"Haralson","2020-11-30","41","6994","5","1027","20.3","18.8"
"Haralson","2020-12-01","59","7053","20","1047","23.5","20.5"
"Haralson","2020-12-02","71","7124","19","1066","25.3","21.8"
"Haralson","2020-12-03","78","7202","28","1094","24.7","23.3"
"Haralson","2020-12-04","56","7258","16","1110","25.8","23.6"
"Haralson","2020-12-05","28","7286","9","1119","26.4","23.9"
"Haralson","2020-12-06","10","7296","1","1120","25.6","22.8"
"Haralson","2020-12-07","66","7362","5","1125","25","22.6"
"Haralson","2020-12-08","53","7415","16","1141","24.4","24"
"Haralson","2020-12-09","55","7470","12","1153","23.7","24.5"
"Haralson","2020-12-10","50","7520","8","1161","20.9","22.8"
"Haralson","2020-12-11","52","7572","11","1172","19.8","22.8"
"Haralson","2020-12-12","70","7642","8","1180","16.9","21.6"
"Haralson","2020-12-13","20","7662","3","1183","17.6","21.6"
"Haralson","2020-12-14","62","7724","15","1198","20","22.5"
"Haralson","2020-12-15","65","7789","19","1217","19.8","22.1"
"Haralson","2020-12-16","86","7875","28","1245","21.4","22.6"
"Haralson","2020-12-17","54","7929","9","1254","21.5","21.2"
"Haralson","2020-12-18","48","7977","10","1264","21.4","20.6"
"Haralson","2020-12-19","41","8018","13","1277","24.3","20.6"
"Haralson","2020-12-20","14","8032","4","1281","26.3","21.9"
"Haralson","2020-12-21","38","8070","10","1291","26.6","23.3"
"Haralson","2020-12-22","78","8148","19","1310","25.9","22.8"
"Haralson","2020-12-23","50","8198","15","1325","25.5","23.4"
"Haralson","2020-12-24","56","8254","16","1341","27.2","24.3"
"Haralson","2020-12-25","3","8257","0","1341","24.2","22.8"
"Haralson","2020-12-26","18","8275","4","1345","22.9","23.6"
"Haralson","2020-12-27","21","8296","3","1348","20.8","23.5"
"Haralson","2020-12-28","109","8405","22","1370","19.9","23.3"
"Haralson","2020-12-29","103","8508","24","1394","19.8","22.8"
"Haralson","2020-12-30","64","8572","18","1412","19.5","22.5"
"Haralson","2020-12-31","86","8658","23","1435","19.3","23.2"
"Haralson","2021-01-01","8","8666","1","1436","21.1","22.6"
"Haralson","2021-01-02","10","8676","2","1438","20.7","21.8"
"Haralson","2021-01-03","18","8694","4","1442","21.9","21.3"
"Haralson","2021-01-04","79","8773","28","1470","24","22"
"Haralson","2021-01-05","93","8866","21","1491","23.9","21.9"
"Haralson","2021-01-06","71","8937","9","1500","21.7","20.6"
"Haralson","2021-01-07","70","9007","14","1514","20.8","20"
"Haralson","2021-01-08","51","9058","13","1527","22.6","21.8"
"Haralson","2021-01-09","36","9094","8","1535","22.9","21.8"
"Haralson","2021-01-10","13","9107","0","1535","19.8","20.8"
"Haralson","2021-01-11","49","9156","12","1547","18.2","21.1"
"Haralson","2021-01-12","67","9223","12","1559","17.5","20.7"
"Haralson","2021-01-13","59","9282","8","1567","17.7","19.7"
"Haralson","2021-01-14","43","9325","12","1579","18.8","19.8"
"Haralson","2021-01-15","41","9366","8","1587","17.9","20.3"
"Haralson","2021-01-16","30","9396","11","1598","20","21.5"
"Haralson","2021-01-17","24","9420","5","1603","23","21.4"
"Haralson","2021-01-18","40","9460","11","1614","23.4","20.8"
"Haralson","2021-01-19","58","9518","13","1627","24.1","20.8"
"Haralson","2021-01-20","44","9562","7","1634","24.4","21"
"Haralson","2021-01-21","42","9604","6","1640","22.4","20.6"
"Haralson","2021-01-22","44","9648","6","1646","21.6","19.8"
"Haralson","2021-01-23","41","9689","14","1660","21.2","20.6"
"Haralson","2021-01-24","15","9704","2","1662","20.2","21.6"
"Haralson","2021-01-25","46","9750","7","1669","18.4","20.9"
"Haralson","2021-01-26","55","9805","11","1680","18.1","21.1"
"Haralson","2021-01-27","58","9863","8","1688","17.8","21.1"
"Haralson","2021-01-28","56","9919","8","1696","17.8","20.1"
"Haralson","2021-01-29","47","9966","9","1705","18.6","20.1"
"Haralson","2021-01-30","27","9993","6","1711","16.9","19.1"
"Haralson","2021-01-31","8","10001","1","1712","16.7","18.5"
"Haralson","2021-02-01","40","10041","9","1721","17.8","18.1"
"Haralson","2021-02-02","37","10078","7","1728","17.6","17.8"
"Haralson","2021-02-03","58","10136","13","1741","18.9","18.3"
"Haralson","2021-02-04","34","10170","5","1746","18.9","18.3"
"Haralson","2021-02-05","23","10193","4","1750","18.7","18.6"
"Haralson","2021-02-06","6","10199","2","1752","20.3","18.6"
"Haralson","2021-02-07","0","10199","0","1752","18.5","17.6"
"Haralson","2021-02-08","0","10199","0","1752","15.3","16.5"
"Harris","2020-02-01","0","0","0","0",".","."
"Harris","2020-02-02","0","0","0","0",".","."
"Harris","2020-02-03","0","0","0","0",".","."
"Harris","2020-02-04","0","0","0","0",".","."
"Harris","2020-02-05","0","0","0","0",".","."
"Harris","2020-02-06","0","0","0","0",".","."
"Harris","2020-02-07","0","0","0","0","0","."
"Harris","2020-02-08","0","0","0","0","0","."
"Harris","2020-02-09","0","0","0","0","0","."
"Harris","2020-02-10","0","0","0","0","0","."
"Harris","2020-02-11","0","0","0","0","0","."
"Harris","2020-02-12","0","0","0","0","0","."
"Harris","2020-02-13","0","0","0","0","0","."
"Harris","2020-02-14","0","0","0","0","0","0"
"Harris","2020-02-15","0","0","0","0","0","0"
"Harris","2020-02-16","0","0","0","0","0","0"
"Harris","2020-02-17","0","0","0","0","0","0"
"Harris","2020-02-18","0","0","0","0","0","0"
"Harris","2020-02-19","0","0","0","0","0","0"
"Harris","2020-02-20","0","0","0","0","0","0"
"Harris","2020-02-21","0","0","0","0","0","0"
"Harris","2020-02-22","0","0","0","0","0","0"
"Harris","2020-02-23","0","0","0","0","0","0"
"Harris","2020-02-24","0","0","0","0","0","0"
"Harris","2020-02-25","0","0","0","0","0","0"
"Harris","2020-02-26","0","0","0","0","0","0"
"Harris","2020-02-27","0","0","0","0","0","0"
"Harris","2020-02-28","0","0","0","0","0","0"
"Harris","2020-02-29","0","0","0","0","0","0"
"Harris","2020-03-01","0","0","0","0","0","0"
"Harris","2020-03-02","0","0","0","0","0","0"
"Harris","2020-03-03","0","0","0","0","0","0"
"Harris","2020-03-04","0","0","0","0","0","0"
"Harris","2020-03-05","0","0","0","0","0","0"
"Harris","2020-03-06","0","0","0","0","0","0"
"Harris","2020-03-07","0","0","0","0","0","0"
"Harris","2020-03-08","0","0","0","0","0","0"
"Harris","2020-03-09","0","0","0","0","0","0"
"Harris","2020-03-10","0","0","0","0","0","0"
"Harris","2020-03-11","0","0","0","0","0","0"
"Harris","2020-03-12","2","2","0","0","0","0"
"Harris","2020-03-13","3","5","0","0","0","0"
"Harris","2020-03-14","0","5","0","0","0","0"
"Harris","2020-03-15","0","5","0","0","0","0"
"Harris","2020-03-16","2","7","0","0","0","0"
"Harris","2020-03-17","3","10","0","0","0","0"
"Harris","2020-03-18","2","12","0","0","0","0"
"Harris","2020-03-19","5","17","0","0","0","0"
"Harris","2020-03-20","8","25","0","0","0","0"
"Harris","2020-03-21","1","26","1","1","14.3","7.1"
"Harris","2020-03-22","2","28","0","1","14.3","7.1"
"Harris","2020-03-23","6","34","0","1","14.3","7.1"
"Harris","2020-03-24","11","45","2","3","16.9","8.4"
"Harris","2020-03-25","13","58","3","6","20.2","10.1"
"Harris","2020-03-26","14","72","1","7","21.2","10.6"
"Harris","2020-03-27","4","76","0","7","21.2","10.6"
"Harris","2020-03-28","2","78","0","7","6.9","10.6"
"Harris","2020-03-29","0","78","0","7","6.9","10.6"
"Harris","2020-03-30","11","89","1","8","8.2","11.2"
"Harris","2020-03-31","8","97","1","9","7.4","12.1"
"Harris","2020-04-01","16","113","2","11","5.9","13"
"Harris","2020-04-02","3","116","1","12","9.6","15.4"
"Harris","2020-04-03","4","120","0","12","9.6","15.4"
"Harris","2020-04-04","0","120","0","12","9.6","8.3"
"Harris","2020-04-05","1","121","0","12","9.6","8.3"
"Harris","2020-04-06","11","132","3","15","12.2","10.2"
"Harris","2020-04-07","8","140","2","17","14","10.7"
"Harris","2020-04-08","15","155","1","18","13.2","9.5"
"Harris","2020-04-09","13","168","1","19","9.5","9.6"
"Harris","2020-04-10","13","181","0","19","9.5","9.6"
"Harris","2020-04-11","5","186","0","19","9.5","9.6"
"Harris","2020-04-12","3","189","0","19","9.5","9.6"
"Harris","2020-04-13","24","213","1","20","6.2","9.2"
"Harris","2020-04-14","12","225","1","21","3.8","8.9"
"Harris","2020-04-15","17","242","1","22","3.7","8.5"
"Harris","2020-04-16","16","258","0","22","2.6","6.1"
"Harris","2020-04-17","20","278","2","24","4.1","6.8"
"Harris","2020-04-18","1","279","0","24","4.1","6.8"
"Harris","2020-04-19","2","281","0","24","4.1","6.8"
"Harris","2020-04-20","25","306","3","27","5.2","5.7"
"Harris","2020-04-21","24","330","5","32","7","5.4"
"Harris","2020-04-22","10","340","0","32","6.1","4.9"
"Harris","2020-04-23","3","343","0","32","6.1","4.4"
"Harris","2020-04-24","22","365","1","33","5.3","4.7"
"Harris","2020-04-25","5","370","0","33","5.3","4.7"
"Harris","2020-04-26","10","380","1","34","6.8","5.4"
"Harris","2020-04-27","18","398","1","35","5.8","5.5"
"Harris","2020-04-28","13","411","0","35","2.9","4.9"
"Harris","2020-04-29","12","423","0","35","2.9","4.5"
"Harris","2020-04-30","14","437","1","36","3.9","5"
"Harris","2020-05-01","10","447","0","36","3.2","4.3"
"Harris","2020-05-02","6","453","0","36","3.2","4.3"
"Harris","2020-05-03","3","456","0","36","1.8","4.3"
"Harris","2020-05-04","15","471","1","37","2","3.9"
"Harris","2020-05-05","22","493","0","37","2","2.4"
"Harris","2020-05-06","18","511","0","37","2","2.4"
"Harris","2020-05-07","22","533","3","40","2.9","3.4"
"Harris","2020-05-08","7","540","1","41","4.9","4.1"
"Harris","2020-05-09","2","542","1","42","12.1","7.7"
"Harris","2020-05-10","9","551","0","42","12.1","6.9"
"Harris","2020-05-11","27","578","3","45","12.7","7.3"
"Harris","2020-05-12","23","601","0","45","12.7","7.3"
"Harris","2020-05-13","19","620","0","45","12.7","7.3"
"Harris","2020-05-14","62","682","2","47","11.2","7.1"
"Harris","2020-05-15","55","737","3","50","10","7.5"
"Harris","2020-05-16","2","739","0","50","2.8","7.5"
"Harris","2020-05-17","13","752","0","50","2.8","7.5"
"Harris","2020-05-18","21","773","4","54","4","8.3"
"Harris","2020-05-19","36","809","2","56","4.8","8.7"
"Harris","2020-05-20","34","843","1","57","5.2","8.9"
"Harris","2020-05-21","48","891","2","59","5.3","8.3"
"Harris","2020-05-22","8","899","0","59","4.5","7.3"
"Harris","2020-05-23","1","900","0","59","4.5","3.7"
"Harris","2020-05-24","5","905","0","59","4.5","3.7"
"Harris","2020-05-25","9","914","0","59","1.8","2.9"
"Harris","2020-05-26","21","935","1","60","1.7","3.2"
"Harris","2020-05-27","26","961","0","60","1.3","3.2"
"Harris","2020-05-28","34","995","0","60","0.7","3"
"Harris","2020-05-29","41","1036","8","68","3.5","4"
"Harris","2020-05-30","12","1048","0","68","3.5","4"
"Harris","2020-05-31","13","1061","0","68","3.5","4"
"Harris","2020-06-01","37","1098","5","73","5.4","3.6"
"Harris","2020-06-02","64","1162","8","81","6.5","4.1"
"Harris","2020-06-03","47","1209","4","85","7.7","4.5"
"Harris","2020-06-04","46","1255","3","88","8.7","4.7"
"Harris","2020-06-05","54","1309","6","94","7.5","5.5"
"Harris","2020-06-06","7","1316","2","96","11.5","7.5"
"Harris","2020-06-07","14","1330","0","96","11.5","7.5"
"Harris","2020-06-08","47","1377","5","101","11.1","8.3"
"Harris","2020-06-09","67","1444","10","111","11.5","9"
"Harris","2020-06-10","53","1497","3","114","11.1","9.4"
"Harris","2020-06-11","81","1578","9","123","11.7","10.2"
"Harris","2020-06-12","64","1642","4","127","11","9.2"
"Harris","2020-06-13","6","1648","1","128","9.3","10.4"
"Harris","2020-06-14","9","1657","1","129","10.9","11.2"
"Harris","2020-06-15","86","1743","13","142","11.5","11.3"
"Harris","2020-06-16","75","1818","5","147","10.4","10.9"
"Harris","2020-06-17","73","1891","7","154","10.9","11"
"Harris","2020-06-18","59","1950","6","160","10.8","11.3"
"Harris","2020-06-19","92","2042","16","176","12.4","11.7"
"Harris","2020-06-20","18","2060","1","177","10.8","10.1"
"Harris","2020-06-21","8","2068","1","178","11","11"
"Harris","2020-06-22","102","2170","21","199","11.8","11.7"
"Harris","2020-06-23","76","2246","9","208","12.5","11.4"
"Harris","2020-06-24","54","2300","5","213","12.5","11.7"
"Harris","2020-06-25","79","2379","13","226","13.4","12.1"
"Harris","2020-06-26","105","2484","24","250","14.2","13.3"
"Harris","2020-06-27","16","2500","6","256","18.7","14.8"
"Harris","2020-06-28","21","2521","7","263","21.7","16.3"
"Harris","2020-06-29","110","2631","15","278","20.7","16.2"
"Harris","2020-06-30","95","2726","12","290","20.8","16.7"
"Harris","2020-07-01","107","2833","14","304","21.4","16.9"
"Harris","2020-07-02","64","2897","10","314","21.2","17.3"
"Harris","2020-07-03","33","2930","6","320","20.6","17.4"
"Harris","2020-07-04","20","2950","2","322","16.6","17.7"
"Harris","2020-07-05","31","2981","5","327","14.2","17.9"
"Harris","2020-07-06","60","3041","10","337","14.6","17.7"
"Harris","2020-07-07","51","3092","12","349","16.2","18.5"
"Harris","2020-07-08","204","3296","30","379","16.4","18.9"
"Harris","2020-07-09","121","3417","9","388","15.2","18.2"
"Harris","2020-07-10","55","3472","6","394","14.2","17.4"
"Harris","2020-07-11","216","3688","11","405","13.5","15.1"
"Harris","2020-07-12","7","3695","1","406","13.2","13.7"
"Harris","2020-07-13","93","3788","22","428","14.2","14.4"
"Harris","2020-07-14","69","3857","11","439","13.1","14.7"
"Harris","2020-07-15","75","3932","8","447","12.6","14.5"
"Harris","2020-07-16","71","4003","5","452","12.5","13.9"
"Harris","2020-07-17","50","4053","8","460","13.2","13.7"
"Harris","2020-07-18","9","4062","4","464","18.9","16.2"
"Harris","2020-07-19","8","4070","1","465","18.6","15.9"
"Harris","2020-07-20","43","4113","10","475","18.6","16.4"
"Harris","2020-07-21","45","4158","4","479","17.5","15.3"
"Harris","2020-07-22","66","4224","6","485","17.3","14.9"
"Harris","2020-07-23","86","4310","7","492","17.5","15"
"Harris","2020-07-24","26","4336","2","494","16.3","14.8"
"Harris","2020-07-25","35","4371","9","503","13.6","16.2"
"Harris","2020-07-26","16","4387","1","504","12.7","15.7"
"Harris","2020-07-27","58","4445","10","514","11.9","15.2"
"Harris","2020-07-28","69","4514","3","517","11.2","14.4"
"Harris","2020-07-29","65","4579","8","525","11.7","14.5"
"Harris","2020-07-30","60","4639","6","531","11.9","14.7"
"Harris","2020-07-31","63","4702","4","535","11.7","14"
"Harris","2020-08-01","20","4722","3","538","10.2","11.9"
"Harris","2020-08-02","11","4733","0","538","9.3","11"
"Harris","2020-08-03","31","4764","3","541","8.2","10"
"Harris","2020-08-04","46","4810","5","546","9.2","10.2"
"Harris","2020-08-05","34","4844","5","551","9.5","10.6"
"Harris","2020-08-06","56","4900","3","554","8.9","10.4"
"Harris","2020-08-07","26","4926","0","554","7.9","9.8"
"Harris","2020-08-08","18","4944","2","556","7.4","8.8"
"Harris","2020-08-09","6","4950","2","558","12.2","10.7"
"Harris","2020-08-10","49","4999","5","563","12.2","10.2"
"Harris","2020-08-11","56","5055","6","569","12.2","10.7"
"Harris","2020-08-12","61","5116","1","570","10.3","9.9"
"Harris","2020-08-13","52","5168","6","576","11.2","10"
"Harris","2020-08-14","26","5194","2","578","12.3","10.1"
"Harris","2020-08-15","15","5209","2","580","12.6","10"
"Harris","2020-08-16","14","5223","1","581","8.9","10.5"
"Harris","2020-08-17","22","5245","1","582","8.1","10.2"
"Harris","2020-08-18","36","5281","4","586","8.1","10.2"
"Harris","2020-08-19","46","5327","2","588","8.5","9.4"
"Harris","2020-08-20","45","5372","2","590","7.5","9.4"
"Harris","2020-08-21","37","5409","2","592","7.2","9.8"
"Harris","2020-08-22","20","5429","3","595","7.4","10"
"Harris","2020-08-23","15","5444","2","597","8.3","8.6"
"Harris","2020-08-24","35","5479","2","599","8.5","8.3"
"Harris","2020-08-25","40","5519","2","601","7.6","7.9"
"Harris","2020-08-26","56","5575","4","605","8","8.3"
"Harris","2020-08-27","40","5615","2","607","8.1","7.8"
"Harris","2020-08-28","26","5641","1","608","7.9","7.5"
"Harris","2020-08-29","12","5653","3","611","9.3","8.4"
"Harris","2020-08-30","13","5666","0","611","7.4","7.8"
"Harris","2020-08-31","41","5707","1","612","6.9","7.7"
"Harris","2020-09-01","49","5756","2","614","6.8","7.2"
"Harris","2020-09-02","47","5803","6","620","7.6","7.8"
"Harris","2020-09-03","42","5845","1","621","7.2","7.7"
"Harris","2020-09-04","57","5902","5","626","7.9","7.9"
"Harris","2020-09-05","12","5914","1","627","5.5","7.4"
"Harris","2020-09-06","6","5920","1","628","7.9","7.7"
"Harris","2020-09-07","12","5932","2","630","10","8.4"
"Harris","2020-09-08","45","5977","0","630","9.4","8.1"
"Harris","2020-09-09","64","6041","2","632","8","7.8"
"Harris","2020-09-10","31","6072","3","635","9","8.1"
"Harris","2020-09-11","30","6102","1","636","8.3","8.1"
"Harris","2020-09-12","13","6115","0","636","7.1","6.3"
"Harris","2020-09-13","7","6122","1","637","6.7","7.3"
"Harris","2020-09-14","22","6144","0","637","4.3","7.1"
"Harris","2020-09-15","53","6197","3","640","5.2","7.3"
"Harris","2020-09-16","25","6222","0","640","4.7","6.4"
"Harris","2020-09-17","32","6254","0","640","3.3","6.2"
"Harris","2020-09-18","24","6278","0","640","2.8","5.6"
"Harris","2020-09-19","8","6286","2","642","6.4","6.7"
"Harris","2020-09-20","12","6298","0","642","4.4","5.6"
"Harris","2020-09-21","32","6330","3","645","5.7","5"
"Harris","2020-09-22","33","6363","0","645","4.9","5"
"Harris","2020-09-23","27","6390","2","647","6","5.3"
"Harris","2020-09-24","30","6420","1","648","6.4","4.9"
"Harris","2020-09-25","25","6445","0","648","6.4","4.6"
"Harris","2020-09-26","18","6463","0","648","2.9","4.6"
"Harris","2020-09-27","5","6468","1","649","5.7","5.1"
"Harris","2020-09-28","23","6491","3","652","6.3","6"
"Harris","2020-09-29","39","6530","0","652","6.3","5.6"
"Harris","2020-09-30","39","6569","3","655","6.3","6.1"
"Harris","2020-10-01","30","6599","3","658","7.2","6.8"
"Harris","2020-10-02","31","6630","1","659","7.7","7.1"
"Harris","2020-10-03","12","6642","0","659","7.7","5.3"
"Harris","2020-10-04","21","6663","0","659","4.9","5.3"
"Harris","2020-10-05","32","6695","1","660","3.4","4.8"
"Harris","2020-10-06","56","6751","1","661","3.7","5"
"Harris","2020-10-07","50","6801","1","662","2.9","4.6"
"Harris","2020-10-08","37","6838","4","666","3","5.1"
"Harris","2020-10-09","46","6884","2","668","3.2","5.4"
"Harris","2020-10-10","18","6902","1","669","3.9","5.8"
"Harris","2020-10-11","14","6916","0","669","3.9","4.4"
"Harris","2020-10-12","27","6943","1","670","4","3.7"
"Harris","2020-10-13","39","6982","4","674","5.2","4.5"
"Harris","2020-10-14","42","7024","1","675","5.3","4.1"
"Harris","2020-10-15","38","7062","1","676","4.1","3.6"
"Harris","2020-10-16","29","7091","2","678","4.5","3.8"
"Harris","2020-10-17","6","7097","0","678","3.7","3.8"
"Harris","2020-10-18","15","7112","0","678","3.7","3.8"
"Harris","2020-10-19","28","7140","1","679","3.7","3.9"
"Harris","2020-10-20","47","7187","1","680","2.5","3.9"
"Harris","2020-10-21","38","7225","1","681","2.6","3.9"
"Harris","2020-10-22","36","7261","2","683","3","3.5"
"Harris","2020-10-23","28","7289","1","684","2.5","3.5"
"Harris","2020-10-24","7","7296","0","684","2.5","3.1"
"Harris","2020-10-25","9","7305","0","684","2.5","3.1"
"Harris","2020-10-26","26","7331","0","684","2","2.8"
"Harris","2020-10-27","46","7377","1","685","2","2.3"
"Harris","2020-10-28","39","7416","1","686","2","2.3"
"Harris","2020-10-29","38","7454","2","688","1.9","2.5"
"Harris","2020-10-30","31","7485","2","690","2.4","2.4"
"Harris","2020-10-31","7","7492","0","690","2.4","2.4"
"Harris","2020-11-01","8","7500","0","690","2.4","2.4"
"Harris","2020-11-02","18","7518","3","693","4.7","3.4"
"Harris","2020-11-03","33","7551","2","695","5.3","3.6"
"Harris","2020-11-04","28","7579","2","697","5.9","4"
"Harris","2020-11-05","57","7636","2","699","5.7","3.8"
"Harris","2020-11-06","28","7664","3","702","6.3","4.3"
"Harris","2020-11-07","20","7684","0","702","6.3","4.3"
"Harris","2020-11-08","13","7697","1","703","7.4","4.9"
"Harris","2020-11-09","26","7723","3","706","6.7","5.7"
"Harris","2020-11-10","47","7770","1","707","6.1","5.7"
"Harris","2020-11-11","42","7812","3","710","6.1","6"
"Harris","2020-11-12","46","7858","1","711","5.9","5.8"
"Harris","2020-11-13","50","7908","5","716","5.8","6.1"
"Harris","2020-11-14","13","7921","1","717","6.9","6.6"
"Harris","2020-11-15","10","7931","2","719","8.7","8"
"Harris","2020-11-16","55","7986","2","721","7.5","7.1"
"Harris","2020-11-17","43","8029","4","725","8.6","7.3"
"Harris","2020-11-18","50","8079","3","728","8.4","7.3"
"Harris","2020-11-19","48","8127","3","731","9","7.4"
"Harris","2020-11-20","31","8158","5","736","9.9","7.8"
"Harris","2020-11-21","64","8222","2","738","9.2","8.1"
"Harris","2020-11-22","20","8242","0","738","6.3","7.5"
"Harris","2020-11-23","40","8282","4","742","7.3","7.4"
"Harris","2020-11-24","24","8306","1","743","6.5","7.5"
"Harris","2020-11-25","62","8368","3","746","6.4","7.4"
"Harris","2020-11-26","4","8372","1","747","9","9"
"Harris","2020-11-27","38","8410","2","749","7.5","8.7"
"Harris","2020-11-28","18","8428","4","753","10.2","9.7"
"Harris","2020-11-29","13","8441","3","756","13.5","9.9"
"Harris","2020-11-30","47","8488","4","760","13.3","10.3"
"Harris","2020-12-01","48","8536","9","769","15.4","11"
"Harris","2020-12-02","55","8591","5","774","16","11.2"
"Harris","2020-12-03","44","8635","4","778","13.7","11.4"
"Harris","2020-12-04","27","8662","2","780","14","10.8"
"Harris","2020-12-05","28","8690","0","780","10.8","10.5"
"Harris","2020-12-06","20","8710","3","783","9.7","11.6"
"Harris","2020-12-07","47","8757","2","785","9.1","11.2"
"Harris","2020-12-08","62","8819","10","795","8.7","12"
"Harris","2020-12-09","56","8875","5","800","8.7","12.3"
"Harris","2020-12-10","66","8941","5","805","8.5","11.1"
"Harris","2020-12-11","52","8993","6","811","9.1","11.5"
"Harris","2020-12-12","37","9030","7","818","11.8","11.3"
"Harris","2020-12-13","26","9056","6","824","12.9","11.3"
"Harris","2020-12-14","66","9122","13","837","15.1","12.1"
"Harris","2020-12-15","86","9208","18","855","15.8","12.3"
"Harris","2020-12-16","56","9264","2","857","15","11.9"
"Harris","2020-12-17","100","9364","15","872","16.1","12.3"
"Harris","2020-12-18","71","9435","7","879","15.9","12.5"
"Harris","2020-12-19","37","9472","7","886","15.9","13.8"
"Harris","2020-12-20","26","9498","4","890","14.8","13.8"
"Harris","2020-12-21","60","9558","15","905","15.5","15.3"
"Harris","2020-12-22","87","9645","16","921","15.2","15.5"
"Harris","2020-12-23","75","9720","14","935","17.3","16.2"
"Harris","2020-12-24","118","9838","12","947","16.6","16.4"
"Harris","2020-12-25","4","9842","0","947","15.2","15.5"
"Harris","2020-12-26","38","9880","11","958","16.7","16.3"
"Harris","2020-12-27","50","9930","15","973","18.7","16.8"
"Harris","2020-12-28","81","10011","21","994","18.9","17.2"
"Harris","2020-12-29","118","10129","32","1026","20.1","17.6"
"Harris","2020-12-30","82","10211","23","1049","21.5","19.4"
"Harris","2020-12-31","96","10307","17","1066","22.5","19.6"
"Harris","2021-01-01","24","10331","4","1070","24.9","20.1"
"Harris","2021-01-02","24","10355","7","1077","24.9","20.8"
"Harris","2021-01-03","37","10392","11","1088","24.9","21.8"
"Harris","2021-01-04","71","10463","21","1109","25.4","22.2"
"Harris","2021-01-05","142","10605","38","1147","25.4","22.7"
"Harris","2021-01-06","101","10706","22","1169","24.5","23"
"Harris","2021-01-07","84","10790","21","1190","25.5","24"
"Harris","2021-01-08","105","10895","24","1214","26.4","25.7"
"Harris","2021-01-09","79","10974","4","1218","23","24"
"Harris","2021-01-10","18","10992","3","1221","21.1","23"
"Harris","2021-01-11","84","11076","21","1242","20.4","22.9"
"Harris","2021-01-12","89","11165","18","1260","19.5","22.4"
"Harris","2021-01-13","52","11217","13","1273","20","22.2"
"Harris","2021-01-14","61","11278","12","1285","19.2","22.4"
"Harris","2021-01-15","74","11352","16","1301","19","22.7"
"Harris","2021-01-16","39","11391","11","1312","22.3","22.7"
"Harris","2021-01-17","31","11422","11","1323","25","23.1"
"Harris","2021-01-18","48","11470","8","1331","23.8","22.1"
"Harris","2021-01-19","81","11551","21","1352","24.7","22.1"
"Harris","2021-01-20","72","11623","12","1364","23.5","21.7"
"Harris","2021-01-21","72","11695","6","1370","21.8","20.5"
"Harris","2021-01-22","75","11770","8","1378","20.3","19.7"
"Harris","2021-01-23","40","11810","15","1393","21.6","22"
"Harris","2021-01-24","23","11833","9","1402","22.1","23.6"
"Harris","2021-01-25","66","11899","12","1414","22.3","23.1"
"Harris","2021-01-26","147","12046","26","1440","21.2","22.9"
"Harris","2021-01-27","69","12115","13","1453","21.5","22.5"
"Harris","2021-01-28","74","12189","13","1466","22.8","22.3"
"Harris","2021-01-29","101","12290","10","1476","22.7","21.5"
"Harris","2021-01-30","49","12339","7","1483","19.4","20.5"
"Harris","2021-01-31","31","12370","10","1493","18.4","20.3"
"Harris","2021-02-01","71","12441","11","1504","18","20.2"
"Harris","2021-02-02","81","12522","11","1515","17.4","19.3"
"Harris","2021-02-03","56","12578","11","1526","17.5","19.5"
"Harris","2021-02-04","54","12632","8","1534","17.1","20"
"Harris","2021-02-05","83","12715","11","1545","17.6","20.2"
"Harris","2021-02-06","13","12728","4","1549","20","19.7"
"Harris","2021-02-07","1","12729","0","1549","15.4","16.9"
"Harris","2021-02-08","0","12729","0","1549","13.2","15.6"
"Hart","2020-02-01","0","0","0","0",".","."
"Hart","2020-02-02","0","0","0","0",".","."
"Hart","2020-02-03","0","0","0","0",".","."
"Hart","2020-02-04","0","0","0","0",".","."
"Hart","2020-02-05","0","0","0","0",".","."
"Hart","2020-02-06","0","0","0","0",".","."
"Hart","2020-02-07","0","0","0","0","0","."
"Hart","2020-02-08","0","0","0","0","0","."
"Hart","2020-02-09","0","0","0","0","0","."
"Hart","2020-02-10","0","0","0","0","0","."
"Hart","2020-02-11","0","0","0","0","0","."
"Hart","2020-02-12","0","0","0","0","0","."
"Hart","2020-02-13","0","0","0","0","0","."
"Hart","2020-02-14","0","0","0","0","0","0"
"Hart","2020-02-15","0","0","0","0","0","0"
"Hart","2020-02-16","0","0","0","0","0","0"
"Hart","2020-02-17","0","0","0","0","0","0"
"Hart","2020-02-18","0","0","0","0","0","0"
"Hart","2020-02-19","0","0","0","0","0","0"
"Hart","2020-02-20","0","0","0","0","0","0"
"Hart","2020-02-21","0","0","0","0","0","0"
"Hart","2020-02-22","0","0","0","0","0","0"
"Hart","2020-02-23","0","0","0","0","0","0"
"Hart","2020-02-24","0","0","0","0","0","0"
"Hart","2020-02-25","0","0","0","0","0","0"
"Hart","2020-02-26","0","0","0","0","0","0"
"Hart","2020-02-27","0","0","0","0","0","0"
"Hart","2020-02-28","0","0","0","0","0","0"
"Hart","2020-02-29","0","0","0","0","0","0"
"Hart","2020-03-01","0","0","0","0","0","0"
"Hart","2020-03-02","0","0","0","0","0","0"
"Hart","2020-03-03","0","0","0","0","0","0"
"Hart","2020-03-04","0","0","0","0","0","0"
"Hart","2020-03-05","0","0","0","0","0","0"
"Hart","2020-03-06","0","0","0","0","0","0"
"Hart","2020-03-07","0","0","0","0","0","0"
"Hart","2020-03-08","0","0","0","0","0","0"
"Hart","2020-03-09","0","0","0","0","0","0"
"Hart","2020-03-10","0","0","0","0","0","0"
"Hart","2020-03-11","0","0","0","0","0","0"
"Hart","2020-03-12","0","0","0","0","0","0"
"Hart","2020-03-13","0","0","0","0","0","0"
"Hart","2020-03-14","0","0","0","0","0","0"
"Hart","2020-03-15","0","0","0","0","0","0"
"Hart","2020-03-16","3","3","0","0","0","0"
"Hart","2020-03-17","2","5","0","0","0","0"
"Hart","2020-03-18","2","7","0","0","0","0"
"Hart","2020-03-19","3","10","0","0","0","0"
"Hart","2020-03-20","3","13","1","1","4.8","2.4"
"Hart","2020-03-21","0","13","0","1","4.8","2.4"
"Hart","2020-03-22","0","13","0","1","4.8","2.4"
"Hart","2020-03-23","3","16","0","1","4.8","2.4"
"Hart","2020-03-24","5","21","1","2","7.6","3.8"
"Hart","2020-03-25","5","26","0","2","7.6","3.8"
"Hart","2020-03-26","11","37","0","2","7.6","3.8"
"Hart","2020-03-27","4","41","0","2","2.9","3.8"
"Hart","2020-03-28","12","53","0","2","2.9","3.8"
"Hart","2020-03-29","11","64","0","2","2.9","3.8"
"Hart","2020-03-30","5","69","0","2","2.9","3.8"
"Hart","2020-03-31","5","74","0","2","0","3.8"
"Hart","2020-04-01","9","83","0","2","0","3.8"
"Hart","2020-04-02","3","86","0","2","0","3.8"
"Hart","2020-04-03","4","90","0","2","0","1.4"
"Hart","2020-04-04","1","91","0","2","0","1.4"
"Hart","2020-04-05","0","91","0","2","0","1.4"
"Hart","2020-04-06","4","95","0","2","0","1.4"
"Hart","2020-04-07","2","97","2","4","14.3","7.1"
"Hart","2020-04-08","6","103","0","4","14.3","7.1"
"Hart","2020-04-09","2","105","0","4","14.3","7.1"
"Hart","2020-04-10","5","110","1","5","17.1","8.6"
"Hart","2020-04-11","0","110","0","5","17.1","8.6"
"Hart","2020-04-12","0","110","0","5","17.1","8.6"
"Hart","2020-04-13","4","114","0","5","17.1","8.6"
"Hart","2020-04-14","4","118","0","5","2.9","8.6"
"Hart","2020-04-15","6","124","1","6","5.2","9.8"
"Hart","2020-04-16","6","130","0","6","5.2","9.8"
"Hart","2020-04-17","5","135","0","6","2.4","9.8"
"Hart","2020-04-18","2","137","0","6","2.4","9.8"
"Hart","2020-04-19","3","140","0","6","2.4","9.8"
"Hart","2020-04-20","3","143","0","6","2.4","9.8"
"Hart","2020-04-21","7","150","1","7","4.4","3.6"
"Hart","2020-04-22","2","152","0","7","2","3.6"
"Hart","2020-04-23","4","156","1","8","5.6","5.4"
"Hart","2020-04-24","14","170","0","8","5.6","4"
"Hart","2020-04-25","0","170","0","8","5.6","4"
"Hart","2020-04-26","1","171","0","8","5.6","4"
"Hart","2020-04-27","16","187","0","8","5.6","4"
"Hart","2020-04-28","10","197","0","8","3.6","4"
"Hart","2020-04-29","10","207","2","10","6.4","4.2"
"Hart","2020-04-30","11","218","1","11","4.2","4.9"
"Hart","2020-05-01","11","229","0","11","4.2","4.9"
"Hart","2020-05-02","3","232","0","11","4.2","4.9"
"Hart","2020-05-03","2","234","0","11","4.2","4.9"
"Hart","2020-05-04","7","241","0","11","4.2","4.9"
"Hart","2020-05-05","7","248","1","12","6.2","4.9"
"Hart","2020-05-06","6","254","1","13","5.7","6.1"
"Hart","2020-05-07","5","259","1","14","7.3","5.7"
"Hart","2020-05-08","6","265","0","14","7.3","5.7"
"Hart","2020-05-09","4","269","0","14","7.3","5.7"
"Hart","2020-05-10","3","272","0","14","7.3","5.7"
"Hart","2020-05-11","8","280","0","14","7.3","5.7"
"Hart","2020-05-12","9","289","0","14","5.2","5.7"
"Hart","2020-05-13","10","299","0","14","2.9","4.3"
"Hart","2020-05-14","14","313","1","15","1","4.1"
"Hart","2020-05-15","14","327","0","15","1","4.1"
"Hart","2020-05-16","3","330","0","15","1","4.1"
"Hart","2020-05-17","27","357","4","19","3.1","5.2"
"Hart","2020-05-18","10","367","0","19","3.1","5.2"
"Hart","2020-05-19","14","381","4","23","7.2","6.2"
"Hart","2020-05-20","14","395","0","23","7.2","5"
"Hart","2020-05-21","5","400","0","23","6.2","3.6"
"Hart","2020-05-22","17","417","0","23","6.2","3.6"
"Hart","2020-05-23","1","418","0","23","6.2","3.6"
"Hart","2020-05-24","4","422","0","23","4.1","3.6"
"Hart","2020-05-25","2","424","0","23","4.1","3.6"
"Hart","2020-05-26","13","437","1","24","1.1","4.2"
"Hart","2020-05-27","13","450","1","25","2.2","4.7"
"Hart","2020-05-28","3","453","0","25","2.2","4.2"
"Hart","2020-05-29","8","461","0","25","2.2","4.2"
"Hart","2020-05-30","6","467","0","25","2.2","4.2"
"Hart","2020-05-31","5","472","0","25","2.2","3.1"
"Hart","2020-06-01","8","480","0","25","2.2","3.1"
"Hart","2020-06-02","17","497","0","25","1.1","1.1"
"Hart","2020-06-03","14","511","0","25","0","1.1"
"Hart","2020-06-04","7","518","0","25","0","1.1"
"Hart","2020-06-05","10","528","0","25","0","1.1"
"Hart","2020-06-06","3","531","0","25","0","1.1"
"Hart","2020-06-07","3","534","0","25","0","1.1"
"Hart","2020-06-08","9","543","0","25","0","1.1"
"Hart","2020-06-09","8","551","3","28","5.4","3.2"
"Hart","2020-06-10","5","556","0","28","5.4","2.7"
"Hart","2020-06-11","8","564","1","29","7.1","3.6"
"Hart","2020-06-12","8","572","3","32","12.5","6.3"
"Hart","2020-06-13","3","575","1","33","17.3","8.6"
"Hart","2020-06-14","2","577","0","33","17.3","8.6"
"Hart","2020-06-15","7","584","0","33","17.3","8.6"
"Hart","2020-06-16","11","595","2","35","14.5","9.9"
"Hart","2020-06-17","9","604","1","36","16.1","10.7"
"Hart","2020-06-18","12","616","1","37","15.5","11.3"
"Hart","2020-06-19","12","628","2","39","12.5","12.5"
"Hart","2020-06-20","7","635","3","42","13.9","15.6"
"Hart","2020-06-21","2","637","0","42","13.9","15.6"
"Hart","2020-06-22","8","645","1","43","15.7","16.5"
"Hart","2020-06-23","12","657","2","45","15.4","15"
"Hart","2020-06-24","19","676","8","53","19.9","18"
"Hart","2020-06-25","21","697","2","55","20","17.8"
"Hart","2020-06-26","22","719","4","59","20.3","16.4"
"Hart","2020-06-27","7","726","0","59","14.1","14"
"Hart","2020-06-28","12","738","1","60","15.3","14.6"
"Hart","2020-06-29","20","758","2","62","15","15.3"
"Hart","2020-06-30","14","772","4","66","16.7","16.1"
"Hart","2020-07-01","19","791","6","72","15.2","17.5"
"Hart","2020-07-02","12","803","1","73","15","17.5"
"Hart","2020-07-03","6","809","0","73","12.4","16.3"
"Hart","2020-07-04","7","816","1","74","14.4","14.3"
"Hart","2020-07-05","6","822","1","75","15.6","15.5"
"Hart","2020-07-06","17","839","6","81","19.2","17.1"
"Hart","2020-07-07","24","863","3","84","17","16.8"
"Hart","2020-07-08","16","879","2","86","14.2","14.7"
"Hart","2020-07-09","31","910","8","94","16.7","15.9"
"Hart","2020-07-10","24","934","2","96","17.9","15.2"
"Hart","2020-07-11","9","943","2","98","19","16.7"
"Hart","2020-07-12","15","958","4","102","20.5","18.1"
"Hart","2020-07-13","17","975","3","105","18","18.6"
"Hart","2020-07-14","18","993","2","107","17.8","17.4"
"Hart","2020-07-15","29","1022","6","113","18.9","16.6"
"Hart","2020-07-16","22","1044","2","115","16.5","16.6"
"Hart","2020-07-17","19","1063","4","119","18.4","18.1"
"Hart","2020-07-18","2","1065","0","119","15.2","17.1"
"Hart","2020-07-19","5","1070","3","122","19.9","20.2"
"Hart","2020-07-20","12","1082","2","124","19.8","18.9"
"Hart","2020-07-21","15","1097","4","128","22","19.9"
"Hart","2020-07-22","33","1130","4","132","20.8","19.9"
"Hart","2020-07-23","12","1142","5","137","25.5","21"
"Hart","2020-07-24","15","1157","3","140","25.3","21.8"
"Hart","2020-07-25","22","1179","10","150","31.8","23.5"
"Hart","2020-07-26","4","1183","0","150","23.2","21.6"
"Hart","2020-07-27","17","1200","2","152","22.5","21.2"
"Hart","2020-07-28","25","1225","6","158","22.1","22.1"
"Hart","2020-07-29","28","1253","12","170","26.5","23.7"
"Hart","2020-07-30","10","1263","1","171","22","23.7"
"Hart","2020-07-31","42","1305","3","174","20.2","22.7"
"Hart","2020-08-01","19","1324","6","180","18.2","25"
"Hart","2020-08-02","10","1334","1","181","19.6","21.4"
"Hart","2020-08-03","31","1365","6","187","20.7","21.6"
"Hart","2020-08-04","18","1383","5","192","21.2","21.7"
"Hart","2020-08-05","18","1401","0","192","15.1","20.8"
"Hart","2020-08-06","8","1409","1","193","15.5","18.7"
"Hart","2020-08-07","13","1422","1","194","15.6","17.9"
"Hart","2020-08-08","6","1428","0","194","11","14.6"
"Hart","2020-08-09","3","1431","0","194","9.6","14.6"
"Hart","2020-08-10","20","1451","6","200","11.1","15.9"
"Hart","2020-08-11","14","1465","2","202","9.2","15.2"
"Hart","2020-08-12","8","1473","0","202","9.2","12.2"
"Hart","2020-08-13","18","1491","2","204","9","12.2"
"Hart","2020-08-14","9","1500","1","205","9.5","12.5"
"Hart","2020-08-15","1","1501","0","205","9.5","10.3"
"Hart","2020-08-16","3","1504","0","205","9.5","9.6"
"Hart","2020-08-17","20","1524","2","207","6.6","8.9"
"Hart","2020-08-18","16","1540","2","209","6.4","7.8"
"Hart","2020-08-19","19","1559","2","211","7.9","8.6"
"Hart","2020-08-20","5","1564","2","213","12","10.5"
"Hart","2020-08-21","16","1580","3","216","13.1","11.3"
"Hart","2020-08-22","5","1585","1","217","16","12.7"
"Hart","2020-08-23","1","1586","0","217","16","12.7"
"Hart","2020-08-24","16","1602","1","218","15.4","11"
"Hart","2020-08-25","13","1615","0","218","13.6","10"
"Hart","2020-08-26","11","1626","3","221","16","12"
"Hart","2020-08-27","11","1637","4","225","15.5","13.8"
"Hart","2020-08-28","20","1657","4","229","15.7","14.4"
"Hart","2020-08-29","2","1659","1","230","20","18"
"Hart","2020-08-30","4","1663","1","231","23.6","19.8"
"Hart","2020-08-31","19","1682","0","231","22.7","19"
"Hart","2020-09-01","12","1694","4","235","27.4","20.5"
"Hart","2020-09-02","22","1716","4","239","26.1","21.1"
"Hart","2020-09-03","8","1724","0","239","20.9","18.2"
"Hart","2020-09-04","10","1734","0","239","18.1","16.9"
"Hart","2020-09-05","15","1749","2","241","12.8","16.4"
"Hart","2020-09-06","8","1757","1","242","11","17.3"
"Hart","2020-09-07","9","1766","1","243","12.6","17.6"
"Hart","2020-09-08","25","1791","0","243","7.9","17.6"
"Hart","2020-09-09","29","1820","2","245","6.3","16.2"
"Hart","2020-09-10","13","1833","1","246","7.4","14.1"
"Hart","2020-09-11","19","1852","3","249","9.6","13.8"
"Hart","2020-09-12","1","1853","1","250","22","17.4"
"Hart","2020-09-13","6","1859","1","251","22.6","16.8"
"Hart","2020-09-14","13","1872","2","253","23.2","17.9"
"Hart","2020-09-15","15","1887","1","254","24.2","16"
"Hart","2020-09-16","16","1903","2","256","25","15.6"
"Hart","2020-09-17","14","1917","2","258","25.9","16.6"
"Hart","2020-09-18","16","1933","1","259","24.5","17.1"
"Hart","2020-09-19","4","1937","0","259","10.3","16.1"
"Hart","2020-09-20","5","1942","2","261","13.6","18.1"
"Hart","2020-09-21","20","1962","1","262","12.1","17.7"
"Hart","2020-09-22","11","1973","1","263","12.4","18.3"
"Hart","2020-09-23","14","1987","2","265","12.7","18.8"
"Hart","2020-09-24","12","1999","2","267","13","19.5"
"Hart","2020-09-25","10","2009","1","268","13.6","19.1"
"Hart","2020-09-26","2","2011","0","268","13.6","11.9"
"Hart","2020-09-27","4","2015","1","269","11.4","12.5"
"Hart","2020-09-28","17","2032","1","270","11.6","11.8"
"Hart","2020-09-29","13","2045","0","270","10.3","11.4"
"Hart","2020-09-30","18","2063","0","270","8.2","10.5"
"Hart","2020-10-01","9","2072","1","271","7.4","10.2"
"Hart","2020-10-02","11","2083","0","271","6","9.8"
"Hart","2020-10-03","17","2100","1","272","6.8","10.2"
"Hart","2020-10-04","3","2103","0","272","3.3","7.4"
"Hart","2020-10-05","11","2114","0","272","2.4","7"
"Hart","2020-10-06","16","2130","1","273","3.3","6.8"
"Hart","2020-10-07","13","2143","2","275","5.5","6.9"
"Hart","2020-10-08","16","2159","0","275","3.9","5.7"
"Hart","2020-10-09","24","2183","1","276","4.5","5.3"
"Hart","2020-10-10","15","2198","3","279","6.5","6.7"
"Hart","2020-10-11","2","2200","0","279","6.5","4.9"
"Hart","2020-10-12","15","2215","1","280","7.5","5"
"Hart","2020-10-13","19","2234","2","282","8.1","5.7"
"Hart","2020-10-14","14","2248","0","282","5.9","5.7"
"Hart","2020-10-15","20","2268","0","282","5.9","4.9"
"Hart","2020-10-16","24","2292","4","286","7.7","6.1"
"Hart","2020-10-17","1","2293","0","286","4.8","5.7"
"Hart","2020-10-18","3","2296","1","287","9.6","8.1"
"Hart","2020-10-19","13","2309","0","287","8.6","8.1"
"Hart","2020-10-20","15","2324","0","287","7.1","7.6"
"Hart","2020-10-21","30","2354","4","291","9","7.5"
"Hart","2020-10-22","17","2371","1","292","9.9","7.9"
"Hart","2020-10-23","21","2392","2","294","8.9","8.3"
"Hart","2020-10-24","11","2403","3","297","12.8","8.8"
"Hart","2020-10-25","6","2409","2","299","12.8","11.2"
"Hart","2020-10-26","22","2431","3","302","14.7","11.7"
"Hart","2020-10-27","26","2457","6","308","18","12.6"
"Hart","2020-10-28","23","2480","5","313","19.2","14.1"
"Hart","2020-10-29","16","2496","1","314","19.3","14.6"
"Hart","2020-10-30","8","2504","1","315","19.7","14.3"
"Hart","2020-10-31","10","2514","0","315","15.8","14.3"
"Hart","2020-11-01","8","2522","0","315","11","11.9"
"Hart","2020-11-02","18","2540","2","317","10.7","12.7"
"Hart","2020-11-03","15","2555","2","319","9.3","13.6"
"Hart","2020-11-04","24","2579","4","323","8.6","13.9"
"Hart","2020-11-05","23","2602","3","326","9.5","14.4"
"Hart","2020-11-06","28","2630","4","330","9.8","14.7"
"Hart","2020-11-07","17","2647","9","339","17.3","16.6"
"Hart","2020-11-08","12","2659","3","342","20.9","16"
"Hart","2020-11-09","17","2676","1","343","20.2","15.4"
"Hart","2020-11-10","27","2703","2","345","19.3","14.3"
"Hart","2020-11-11","22","2725","0","345","16.9","12.7"
"Hart","2020-11-12","25","2750","6","351","18.5","14"
"Hart","2020-11-13","30","2780","4","355","18.4","14.1"
"Hart","2020-11-14","17","2797","5","360","15","16.2"
"Hart","2020-11-15","19","2816","0","360","11.4","16.2"
"Hart","2020-11-16","45","2861","6","366","12.5","16.3"
"Hart","2020-11-17","17","2878","2","368","13.1","16.2"
"Hart","2020-11-18","28","2906","2","370","14.1","15.5"
"Hart","2020-11-19","37","2943","4","374","12.3","15.4"
"Hart","2020-11-20","22","2965","4","378","12.9","15.7"
"Hart","2020-11-21","16","2981","3","381","11.4","13.2"
"Hart","2020-11-22","9","2990","2","383","14.6","13"
"Hart","2020-11-23","32","3022","2","385","13.6","13"
"Hart","2020-11-24","33","3055","4","389","13.6","13.4"
"Hart","2020-11-25","26","3081","5","394","15.4","14.8"
"Hart","2020-11-26","6","3087","1","395","16.2","14.2"
"Hart","2020-11-27","24","3111","2","397","14.8","13.9"
"Hart","2020-11-28","9","3120","3","400","16.9","14.2"
"Hart","2020-11-29","15","3135","5","405","18.5","16.5"
"Hart","2020-11-30","38","3173","10","415","21.3","17.5"
"Hart","2020-12-01","33","3206","6","421","22.2","17.9"
"Hart","2020-12-02","33","3239","4","425","21.2","18.3"
"Hart","2020-12-03","48","3287","8","433","21.2","18.7"
"Hart","2020-12-04","51","3338","7","440","22","18.4"
"Hart","2020-12-05","28","3366","11","451","22.8","19.8"
"Hart","2020-12-06","16","3382","3","454","20.7","19.6"
"Hart","2020-12-07","51","3433","11","465","20","20.7"
"Hart","2020-12-08","60","3493","7","472","19.1","20.7"
"Hart","2020-12-09","56","3549","9","481","19.7","20.4"
"Hart","2020-12-10","46","3595","12","493","21","21.1"
"Hart","2020-12-11","49","3644","10","503","22","22"
"Hart","2020-12-12","32","3676","6","509","19","20.9"
"Hart","2020-12-13","13","3689","7","516","24.1","22.4"
"Hart","2020-12-14","54","3743","12","528","24.2","22.1"
"Hart","2020-12-15","52","3795","14","542","26.3","22.7"
"Hart","2020-12-16","53","3848","11","553","27","23.3"
"Hart","2020-12-17","54","3902","10","563","25.9","23.5"
"Hart","2020-12-18","76","3978","16","579","26","24"
"Hart","2020-12-19","35","4013","14","593","29","24"
"Hart","2020-12-20","26","4039","15","608","29.6","26.8"
"Hart","2020-12-21","62","4101","17","625","30.3","27.2"
"Hart","2020-12-22","74","4175","13","638","29","27.7"
"Hart","2020-12-23","76","4251","24","662","30.5","28.8"
"Hart","2020-12-24","36","4287","12","674","32.7","29.3"
"Hart","2020-12-25","3","4290","0","674","29.7","27.8"
"Hart","2020-12-26","19","4309","6","680","28.5","28.7"
"Hart","2020-12-27","28","4337","10","690","25.3","27.5"
"Hart","2020-12-28","180","4517","30","720","23.8","27.1"
"Hart","2020-12-29","120","4637","29","749","24.7","26.9"
"Hart","2020-12-30","82","4719","34","783","26.1","28.3"
"Hart","2020-12-31","134","4853","28","811","24.4","28.5"
"Hart","2021-01-01","9","4862","1","812","25.9","27.8"
"Hart","2021-01-02","20","4882","8","820","27.1","27.8"
"Hart","2021-01-03","31","4913","14","834","28.5","26.9"
"Hart","2021-01-04","76","4989","22","856","30.2","27"
"Hart","2021-01-05","91","5080","18","874","29.6","27.2"
"Hart","2021-01-06","71","5151","10","884","25.7","25.9"
"Hart","2021-01-07","71","5222","17","901","26.1","25.3"
"Hart","2021-01-08","65","5287","17","918","28.3","27.1"
"Hart","2021-01-09","71","5358","10","928","24.6","25.9"
"Hart","2021-01-10","34","5392","13","941","23.6","26"
"Hart","2021-01-11","69","5461","15","956","22.6","26.4"
"Hart","2021-01-12","65","5526","16","972","23.3","26.4"
"Hart","2021-01-13","84","5610","15","987","23.8","24.8"
"Hart","2021-01-14","48","5658","5","992","21.9","24"
"Hart","2021-01-15","41","5699","10","1002","21.6","25"
"Hart","2021-01-16","38","5737","17","1019","26","25.3"
"Hart","2021-01-17","20","5757","2","1021","22","22.8"
"Hart","2021-01-18","47","5804","10","1031","21.9","22.2"
"Hart","2021-01-19","91","5895","9","1040","19.8","21.5"
"Hart","2021-01-20","41","5936","7","1047","19.7","21.7"
"Hart","2021-01-21","49","5985","13","1060","22","21.9"
"Hart","2021-01-22","52","6037","13","1073","22.1","21.8"
"Hart","2021-01-23","26","6063","5","1078","18.4","22.2"
"Hart","2021-01-24","50","6113","5","1083","18.4","20.2"
"Hart","2021-01-25","39","6152","8","1091","18.3","20.1"
"Hart","2021-01-26","46","6198","2","1093","17.5","18.7"
"Hart","2021-01-27","47","6245","6","1099","16.9","18.3"
"Hart","2021-01-28","42","6287","11","1110","16.9","19.4"
"Hart","2021-01-29","41","6328","7","1117","15.7","18.9"
"Hart","2021-01-30","23","6351","8","1125","18","18.2"
"Hart","2021-01-31","19","6370","6","1131","21","19.7"
"Hart","2021-02-01","56","6426","11","1142","20.9","19.6"
"Hart","2021-02-02","36","6462","5","1147","22.3","19.9"
"Hart","2021-02-03","43","6505","7","1154","22.8","19.8"
"Hart","2021-02-04","39","6544","7","1161","21.6","19.2"
"Hart","2021-02-05","20","6564","2","1163","20.6","18.2"
"Hart","2021-02-06","10","6574","1","1164","17","17.5"
"Hart","2021-02-07","5","6579","2","1166","18.3","19.6"
"Hart","2021-02-08","0","6579","0","1166","15.4","18.2"
"Heard","2020-02-01","0","0","0","0",".","."
"Heard","2020-02-02","0","0","0","0",".","."
"Heard","2020-02-03","0","0","0","0",".","."
"Heard","2020-02-04","0","0","0","0",".","."
"Heard","2020-02-05","0","0","0","0",".","."
"Heard","2020-02-06","0","0","0","0",".","."
"Heard","2020-02-07","0","0","0","0","0","."
"Heard","2020-02-08","0","0","0","0","0","."
"Heard","2020-02-09","0","0","0","0","0","."
"Heard","2020-02-10","0","0","0","0","0","."
"Heard","2020-02-11","0","0","0","0","0","."
"Heard","2020-02-12","0","0","0","0","0","."
"Heard","2020-02-13","0","0","0","0","0","."
"Heard","2020-02-14","0","0","0","0","0","0"
"Heard","2020-02-15","0","0","0","0","0","0"
"Heard","2020-02-16","0","0","0","0","0","0"
"Heard","2020-02-17","0","0","0","0","0","0"
"Heard","2020-02-18","0","0","0","0","0","0"
"Heard","2020-02-19","0","0","0","0","0","0"
"Heard","2020-02-20","0","0","0","0","0","0"
"Heard","2020-02-21","0","0","0","0","0","0"
"Heard","2020-02-22","0","0","0","0","0","0"
"Heard","2020-02-23","0","0","0","0","0","0"
"Heard","2020-02-24","0","0","0","0","0","0"
"Heard","2020-02-25","0","0","0","0","0","0"
"Heard","2020-02-26","0","0","0","0","0","0"
"Heard","2020-02-27","0","0","0","0","0","0"
"Heard","2020-02-28","0","0","0","0","0","0"
"Heard","2020-02-29","0","0","0","0","0","0"
"Heard","2020-03-01","0","0","0","0","0","0"
"Heard","2020-03-02","0","0","0","0","0","0"
"Heard","2020-03-03","0","0","0","0","0","0"
"Heard","2020-03-04","0","0","0","0","0","0"
"Heard","2020-03-05","0","0","0","0","0","0"
"Heard","2020-03-06","0","0","0","0","0","0"
"Heard","2020-03-07","0","0","0","0","0","0"
"Heard","2020-03-08","0","0","0","0","0","0"
"Heard","2020-03-09","0","0","0","0","0","0"
"Heard","2020-03-10","0","0","0","0","0","0"
"Heard","2020-03-11","0","0","0","0","0","0"
"Heard","2020-03-12","2","2","0","0","0","0"
"Heard","2020-03-13","1","3","0","0","0","0"
"Heard","2020-03-14","1","4","0","0","0","0"
"Heard","2020-03-15","5","9","3","3","8.6","4.3"
"Heard","2020-03-16","1","10","0","3","8.6","4.3"
"Heard","2020-03-17","0","10","0","3","8.6","4.3"
"Heard","2020-03-18","2","12","0","3","8.6","4.3"
"Heard","2020-03-19","2","14","0","3","8.6","4.3"
"Heard","2020-03-20","0","14","0","3","8.6","4.3"
"Heard","2020-03-21","0","14","0","3","8.6","4.3"
"Heard","2020-03-22","0","14","0","3","0","4.3"
"Heard","2020-03-23","1","15","0","3","0","4.3"
"Heard","2020-03-24","4","19","0","3","0","4.3"
"Heard","2020-03-25","4","23","0","3","0","4.3"
"Heard","2020-03-26","1","24","0","3","0","4.3"
"Heard","2020-03-27","6","30","0","3","0","4.3"
"Heard","2020-03-28","1","31","0","3","0","4.3"
"Heard","2020-03-29","2","33","0","3","0","0"
"Heard","2020-03-30","0","33","0","3","0","0"
"Heard","2020-03-31","5","38","0","3","0","0"
"Heard","2020-04-01","2","40","0","3","0","0"
"Heard","2020-04-02","3","43","0","3","0","0"
"Heard","2020-04-03","1","44","0","3","0","0"
"Heard","2020-04-04","2","46","0","3","0","0"
"Heard","2020-04-05","1","47","0","3","0","0"
"Heard","2020-04-06","1","48","0","3","0","0"
"Heard","2020-04-07","5","53","0","3","0","0"
"Heard","2020-04-08","1","54","0","3","0","0"
"Heard","2020-04-09","2","56","1","4","7.1","3.6"
"Heard","2020-04-10","0","56","0","4","7.1","3.6"
"Heard","2020-04-11","1","57","1","5","21.4","10.7"
"Heard","2020-04-12","0","57","0","5","21.4","10.7"
"Heard","2020-04-13","0","57","0","5","21.4","10.7"
"Heard","2020-04-14","1","58","1","6","35.7","17.9"
"Heard","2020-04-15","1","59","0","6","35.7","17.9"
"Heard","2020-04-16","3","62","1","7","33.3","20.2"
"Heard","2020-04-17","2","64","0","7","33.3","20.2"
"Heard","2020-04-18","6","70","0","7","19","20.2"
"Heard","2020-04-19","0","70","0","7","19","20.2"
"Heard","2020-04-20","4","74","1","8","22.6","22"
"Heard","2020-04-21","3","77","0","8","8.3","22"
"Heard","2020-04-22","3","80","1","9","13.1","24.4"
"Heard","2020-04-23","15","95","0","9","8.3","20.8"
"Heard","2020-04-24","0","95","0","9","8.3","20.8"
"Heard","2020-04-25","6","101","0","9","8.3","13.7"
"Heard","2020-04-26","1","102","0","9","8.3","13.7"
"Heard","2020-04-27","3","105","0","9","4.8","13.7"
"Heard","2020-04-28","7","112","0","9","4.8","6.5"
"Heard","2020-04-29","9","121","1","10","1.6","7.3"
"Heard","2020-04-30","8","129","3","13","6.9","7.6"
"Heard","2020-05-01","16","145","0","13","6.9","7.6"
"Heard","2020-05-02","7","152","1","14","9","8.7"
"Heard","2020-05-03","2","154","0","14","9","8.7"
"Heard","2020-05-04","7","161","0","14","9","6.9"
"Heard","2020-05-05","6","167","0","14","9","6.9"
"Heard","2020-05-06","8","175","0","14","7.4","4.5"
"Heard","2020-05-07","11","186","1","15","3.3","5.1"
"Heard","2020-05-08","8","194","1","16","5.1","6"
"Heard","2020-05-09","3","197","1","17","7.8","8.4"
"Heard","2020-05-10","1","198","0","17","7.8","8.4"
"Heard","2020-05-11","28","226","0","17","7.8","8.4"
"Heard","2020-05-12","8","234","1","18","9.6","9.3"
"Heard","2020-05-13","20","254","1","19","10.3","8.9"
"Heard","2020-05-14","16","270","4","23","12.6","8"
"Heard","2020-05-15","9","279","1","24","12.4","8.8"
"Heard","2020-05-16","14","293","1","25","8.7","8.3"
"Heard","2020-05-17","3","296","0","25","8.7","8.3"
"Heard","2020-05-18","15","311","0","25","8.7","8.3"
"Heard","2020-05-19","24","335","1","26","7.5","8.6"
"Heard","2020-05-20","11","346","1","27","8.1","9.2"
"Heard","2020-05-21","13","359","1","28","5.6","9.1"
"Heard","2020-05-22","9","368","1","29","5.6","9"
"Heard","2020-05-23","2","370","0","29","4.6","6.6"
"Heard","2020-05-24","5","375","0","29","4.6","6.6"
"Heard","2020-05-25","6","381","1","30","7","7.8"
"Heard","2020-05-26","10","391","2","32","9.2","8.4"
"Heard","2020-05-27","10","401","1","33","9.4","8.7"
"Heard","2020-05-28","12","413","1","34","9.4","7.5"
"Heard","2020-05-29","12","425","0","34","7.9","6.7"
"Heard","2020-05-30","7","432","1","35","9.9","7.2"
"Heard","2020-05-31","0","432","0","35","9.9","7.2"
"Heard","2020-06-01","5","437","1","36","10.4","8.7"
"Heard","2020-06-02","12","449","0","36","7.5","8.4"
"Heard","2020-06-03","14","463","0","36","6.1","7.7"
"Heard","2020-06-04","8","471","0","36","4.9","7.2"
"Heard","2020-06-05","13","484","2","38","7.1","7.5"
"Heard","2020-06-06","14","498","2","40","7.1","8.5"
"Heard","2020-06-07","2","500","0","40","7.1","8.5"
"Heard","2020-06-08","17","517","1","41","5.1","7.7"
"Heard","2020-06-09","14","531","1","42","6.1","6.8"
"Heard","2020-06-10","11","542","1","43","7.4","6.7"
"Heard","2020-06-11","9","551","1","44","9","6.9"
"Heard","2020-06-12","15","566","1","45","7.7","7.4"
"Heard","2020-06-13","1","567","0","45","5.7","6.4"
"Heard","2020-06-14","1","568","0","45","5.7","6.4"
"Heard","2020-06-15","11","579","0","45","4.9","5"
"Heard","2020-06-16","20","599","0","45","3.8","5"
"Heard","2020-06-17","9","608","0","45","2.5","5"
"Heard","2020-06-18","8","616","0","45","1","5"
"Heard","2020-06-19","10","626","2","47","2.9","5.3"
"Heard","2020-06-20","6","632","1","48","5.2","5.5"
"Heard","2020-06-21","1","633","0","48","5.2","5.5"
"Heard","2020-06-22","10","643","1","49","6.7","5.8"
"Heard","2020-06-23","13","656","0","49","6.7","5.3"
"Heard","2020-06-24","18","674","0","49","6.7","4.6"
"Heard","2020-06-25","25","699","2","51","7.8","4.4"
"Heard","2020-06-26","13","712","0","51","5","3.9"
"Heard","2020-06-27","9","721","1","52","4.2","4.7"
"Heard","2020-06-28","4","725","1","53","7.7","6.5"
"Heard","2020-06-29","16","741","1","54","7.2","6.9"
"Heard","2020-06-30","23","764","4","58","9.7","8.2"
"Heard","2020-07-01","45","809","3","61","10.6","8.6"
"Heard","2020-07-02","20","829","4","65","12.3","10.1"
"Heard","2020-07-03","13","842","2","67","14.5","9.7"
"Heard","2020-07-04","17","859","5","72","17.2","10.7"
"Heard","2020-07-05","4","863","0","72","13.6","10.7"
"Heard","2020-07-06","27","890","6","78","15.9","11.5"
"Heard","2020-07-07","19","909","0","78","13.4","11.5"
"Heard","2020-07-08","71","980","3","81","13","11.8"
"Heard","2020-07-09","14","994","1","82","11.2","11.8"
"Heard","2020-07-10","30","1024","3","85","10.4","12.5"
"Heard","2020-07-11","20","1044","2","87","7.7","12.4"
"Heard","2020-07-12","9","1053","3","90","12.4","13"
"Heard","2020-07-13","20","1073","4","94","12.1","14"
"Heard","2020-07-14","15","1088","0","94","12.1","12.7"
"Heard","2020-07-15","104","1192","15","109","13.6","13.3"
"Heard","2020-07-16","4","1196","1","110","16.1","13.7"
"Heard","2020-07-17","26","1222","4","114","16.9","13.7"
"Heard","2020-07-18","8","1230","1","115","17.2","12.4"
"Heard","2020-07-19","4","1234","0","115","12.5","12.4"
"Heard","2020-07-20","26","1260","3","118","11.3","11.7"
"Heard","2020-07-21","32","1292","5","123","13.5","12.8"
"Heard","2020-07-22","65","1357","3","126","12.1","12.8"
"Heard","2020-07-23","10","1367","1","127","10","13"
"Heard","2020-07-24","12","1379","1","128","8.9","12.9"
"Heard","2020-07-25","2","1381","0","128","7.2","12.2"
"Heard","2020-07-26","6","1387","1","129","9.5","11"
"Heard","2020-07-27","16","1403","7","136","14.1","12.7"
"Heard","2020-07-28","21","1424","7","143","16.7","15.1"
"Heard","2020-07-29","33","1457","2","145","16.9","14.5"
"Heard","2020-07-30","7","1464","1","146","17.5","13.7"
"Heard","2020-07-31","8","1472","1","147","18.1","13.5"
"Heard","2020-08-01","5","1477","1","148","20.9","14.1"
"Heard","2020-08-02","2","1479","1","149","25.7","17.6"
"Heard","2020-08-03","20","1499","4","153","22.3","18.2"
"Heard","2020-08-04","9","1508","3","156","22.3","19.5"
"Heard","2020-08-05","53","1561","0","156","21.4","19.2"
"Heard","2020-08-06","10","1571","1","157","20.8","19.2"
"Heard","2020-08-07","15","1586","0","157","19","18.6"
"Heard","2020-08-08","7","1593","1","158","18.2","19.6"
"Heard","2020-08-09","8","1601","0","158","11.1","18.4"
"Heard","2020-08-10","11","1612","0","158","8.2","15.3"
"Heard","2020-08-11","19","1631","1","159","4.2","13.3"
"Heard","2020-08-12","50","1681","3","162","5.1","13.3"
"Heard","2020-08-13","24","1705","1","163","4.2","12.5"
"Heard","2020-08-14","16","1721","1","164","5.1","12.1"
"Heard","2020-08-15","9","1730","1","165","4.7","11.5"
"Heard","2020-08-16","15","1745","0","165","4.7","7.9"
"Heard","2020-08-17","23","1768","2","167","5.9","7.1"
"Heard","2020-08-18","22","1790","2","169","6.5","5.3"
"Heard","2020-08-19","54","1844","4","173","6.7","5.9"
"Heard","2020-08-20","14","1858","1","174","7.1","5.7"
"Heard","2020-08-21","19","1877","2","176","7.7","6.4"
"Heard","2020-08-22","18","1895","1","177","6.9","5.8"
"Heard","2020-08-23","7","1902","1","178","9","6.8"
"Heard","2020-08-24","9","1911","3","181","12.5","9.2"
"Heard","2020-08-25","15","1926","1","182","12.1","9.3"
"Heard","2020-08-26","35","1961","1","183","11.5","9.1"
"Heard","2020-08-27","8","1969","0","183","10.5","8.8"
"Heard","2020-08-28","32","2001","0","183","9","8.3"
"Heard","2020-08-29","13","2014","2","185","10.4","8.6"
"Heard","2020-08-30","1","2015","0","185","8.3","8.6"
"Heard","2020-08-31","6","2021","1","186","5.9","9.2"
"Heard","2020-09-01","15","2036","2","188","6.9","9.5"
"Heard","2020-09-02","25","2061","2","190","7.6","9.6"
"Heard","2020-09-03","9","2070","3","193","12.4","11.4"
"Heard","2020-09-04","38","2108","1","194","12.8","10.9"
"Heard","2020-09-05","55","2163","0","194","10.6","10.5"
"Heard","2020-09-06","10","2173","0","194","10.6","9.4"
"Heard","2020-09-07","4","2177","0","194","8.2","7.1"
"Heard","2020-09-08","8","2185","0","194","6.3","6.6"
"Heard","2020-09-09","24","2209","1","195","5.7","6.7"
"Heard","2020-09-10","9","2218","0","195","1","6.7"
"Heard","2020-09-11","16","2234","3","198","3.3","8"
"Heard","2020-09-12","1","2235","0","198","3.3","6.9"
"Heard","2020-09-13","3","2238","1","199","8","9.3"
"Heard","2020-09-14","9","2247","0","199","8","8.1"
"Heard","2020-09-15","7","2254","0","199","8","7.2"
"Heard","2020-09-16","28","2282","0","199","7.4","6.6"
"Heard","2020-09-17","5","2287","0","199","7.4","4.2"
"Heard","2020-09-18","9","2296","0","199","4.8","4"
"Heard","2020-09-19","5","2301","0","199","4.8","4"
"Heard","2020-09-20","3","2304","0","199","0","4"
"Heard","2020-09-21","7","2311","0","199","0","4"
"Heard","2020-09-22","9","2320","5","204","7.9","8"
"Heard","2020-09-23","22","2342","3","207","9.9","8.7"
"Heard","2020-09-24","11","2353","2","209","12.5","10"
"Heard","2020-09-25","6","2359","0","209","12.5","8.6"
"Heard","2020-09-26","4","2363","0","209","12.5","8.6"
"Heard","2020-09-27","2","2365","0","209","12.5","6.2"
"Heard","2020-09-28","8","2373","1","210","14.3","7.1"
"Heard","2020-09-29","16","2389","6","216","11.7","9.8"
"Heard","2020-09-30","20","2409","1","217","10.5","10.2"
"Heard","2020-10-01","3","2412","1","218","12.6","12.6"
"Heard","2020-10-02","12","2424","1","219","13.8","13.1"
"Heard","2020-10-03","4","2428","0","219","13.8","13.1"
"Heard","2020-10-04","0","2428","0","219","13.8","13.1"
"Heard","2020-10-05","14","2442","0","219","12","13.1"
"Heard","2020-10-06","22","2464","1","220","7.3","9.5"
"Heard","2020-10-07","14","2478","2","222","8.6","9.5"
"Heard","2020-10-08","11","2489","1","223","5.2","8.9"
"Heard","2020-10-09","7","2496","0","223","4","8.9"
"Heard","2020-10-10","4","2500","0","223","4","8.9"
"Heard","2020-10-11","4","2504","0","223","4","8.9"
"Heard","2020-10-12","8","2512","0","223","4","8"
"Heard","2020-10-13","15","2527","1","224","4.3","5.8"
"Heard","2020-10-14","18","2545","1","225","3","5.8"
"Heard","2020-10-15","17","2562","3","228","4.3","4.7"
"Heard","2020-10-16","12","2574","1","229","5.5","4.7"
"Heard","2020-10-17","11","2585","1","230","6.8","5.4"
"Heard","2020-10-18","6","2591","0","230","6.8","5.4"
"Heard","2020-10-19","26","2617","3","233","8.4","6.2"
"Heard","2020-10-20","25","2642","7","240","11.5","7.9"
"Heard","2020-10-21","15","2657","5","245","15.4","9.2"
"Heard","2020-10-22","10","2667","4","249","18.6","11.4"
"Heard","2020-10-23","11","2678","3","252","21.3","13.4"
"Heard","2020-10-24","8","2686","0","252","20","13.4"
"Heard","2020-10-25","7","2693","1","253","22.1","14.4"
"Heard","2020-10-26","31","2724","6","259","23.2","15.8"
"Heard","2020-10-27","23","2747","3","262","21","16.2"
"Heard","2020-10-28","19","2766","4","266","19.3","17.4"
"Heard","2020-10-29","13","2779","2","268","15.8","17.2"
"Heard","2020-10-30","19","2798","2","270","13.4","17.3"
"Heard","2020-10-31","3","2801","1","271","18.1","19.1"
"Heard","2020-11-01","8","2809","0","271","16.1","19.1"
"Heard","2020-11-02","22","2831","6","277","17.2","20.2"
"Heard","2020-11-03","12","2843","0","277","15.4","18.2"
"Heard","2020-11-04","27","2870","3","280","13.9","16.6"
"Heard","2020-11-05","7","2877","2","282","15.8","15.8"
"Heard","2020-11-06","17","2894","2","284","16","14.7"
"Heard","2020-11-07","6","2900","0","284","11.2","14.7"
"Heard","2020-11-08","5","2905","0","284","11.2","13.7"
"Heard","2020-11-09","19","2924","2","286","8.9","13"
"Heard","2020-11-10","17","2941","4","290","12.2","13.8"
"Heard","2020-11-11","6","2947","3","293","17.8","15.9"
"Heard","2020-11-12","11","2958","3","296","17.6","16.7"
"Heard","2020-11-13","11","2969","3","299","19.8","17.9"
"Heard","2020-11-14","8","2977","4","303","26.9","19.1"
"Heard","2020-11-15","6","2983","0","303","26.9","19.1"
"Heard","2020-11-16","29","3012","3","306","26.9","17.9"
"Heard","2020-11-17","13","3025","2","308","25.8","19"
"Heard","2020-11-18","22","3047","3","311","20.6","19.2"
"Heard","2020-11-19","21","3068","1","312","17.3","17.5"
"Heard","2020-11-20","31","3099","3","315","14.8","17.3"
"Heard","2020-11-21","9","3108","0","315","7.7","17.3"
"Heard","2020-11-22","4","3112","0","315","7.7","17.3"
"Heard","2020-11-23","13","3125","1","316","7.3","17.1"
"Heard","2020-11-24","21","3146","5","321","8.5","17.1"
"Heard","2020-11-25","12","3158","4","325","11.3","15.9"
"Heard","2020-11-26","5","3163","0","325","10.6","14"
"Heard","2020-11-27","8","3171","1","326","11","12.9"
"Heard","2020-11-28","3","3174","1","327","15.8","11.7"
"Heard","2020-11-29","8","3182","3","330","21.2","14.4"
"Heard","2020-11-30","40","3222","13","343","24.7","16"
"Heard","2020-12-01","10","3232","1","344","22.7","15.6"
"Heard","2020-12-02","19","3251","4","348","21","16.2"
"Heard","2020-12-03","17","3268","6","354","26","18.3"
"Heard","2020-12-04","18","3286","5","359","28.2","19.6"
"Heard","2020-12-05","4","3290","0","359","23.4","19.6"
"Heard","2020-12-06","6","3296","0","359","18.1","19.6"
"Heard","2020-12-07","14","3310","1","360","14.5","19.6"
"Heard","2020-12-08","31","3341","10","370","17.6","20.2"
"Heard","2020-12-09","29","3370","11","381","20.1","20.5"
"Heard","2020-12-10","25","3395","5","386","17.9","21.9"
"Heard","2020-12-11","21","3416","1","387","14.6","21.4"
"Heard","2020-12-12","5","3421","2","389","20.3","21.9"
"Heard","2020-12-13","5","3426","1","390","23.2","20.6"
"Heard","2020-12-14","61","3487","5","395","23.3","18.9"
"Heard","2020-12-15","22","3509","6","401","22.6","20.1"
"Heard","2020-12-16","18","3527","1","402","18","19"
"Heard","2020-12-17","22","3549","2","404","16.4","17.1"
"Heard","2020-12-18","29","3578","8","412","19.7","17.1"
"Heard","2020-12-19","10","3588","1","413","15.4","17.8"
"Heard","2020-12-20","2","3590","0","413","12.5","17.8"
"Heard","2020-12-21","22","3612","8","421","16.6","19.9"
"Heard","2020-12-22","39","3651","12","433","17.1","19.8"
"Heard","2020-12-23","19","3670","5","438","20","19"
"Heard","2020-12-24","22","3692","9","447","24.6","20.5"
"Heard","2020-12-25","3","3695","3","450","34.9","27.3"
"Heard","2020-12-26","9","3704","0","450","33.5","24.4"
"Heard","2020-12-27","6","3710","2","452","38.2","25.4"
"Heard","2020-12-28","68","3778","9","461","34.9","25.7"
"Heard","2020-12-29","18","3796","8","469","36.9","27"
"Heard","2020-12-30","31","3827","6","475","35.9","28"
"Heard","2020-12-31","16","3843","4","479","33.6","29.1"
"Heard","2021-01-01","3","3846","0","479","19.3","27.1"
"Heard","2021-01-02","8","3854","0","479","19.3","26.4"
"Heard","2021-01-03","1","3855","0","479","14.6","26.4"
"Heard","2021-01-04","18","3873","5","484","16.7","25.8"
"Heard","2021-01-05","31","3904","11","495","15.4","26.1"
"Heard","2021-01-06","21","3925","8","503","18.1","27"
"Heard","2021-01-07","25","3950","3","506","16.2","24.9"
"Heard","2021-01-08","19","3969","5","511","20","19.6"
"Heard","2021-01-09","16","3985","4","515","23.5","21.4"
"Heard","2021-01-10","8","3993","2","517","27.1","20.8"
"Heard","2021-01-11","12","4005","2","519","25.5","21.1"
"Heard","2021-01-12","85","4090","8","527","21.8","18.6"
"Heard","2021-01-13","22","4112","6","533","20.2","19.1"
"Heard","2021-01-14","20","4132","4","537","21.4","18.8"
"Heard","2021-01-15","25","4157","8","545","22.2","21.1"
"Heard","2021-01-16","18","4175","7","552","24.2","23.9"
"Heard","2021-01-17","9","4184","1","553","22.2","24.6"
"Heard","2021-01-18","24","4208","5","558","22.8","24.1"
"Heard","2021-01-19","31","4239","3","561","22.8","22.3"
"Heard","2021-01-20","29","4268","7","568","22.4","21.3"
"Heard","2021-01-21","20","4288","3","571","21.7","21.5"
"Heard","2021-01-22","34","4322","2","573","17.9","20.1"
"Heard","2021-01-23","22","4344","7","580","16.9","20.6"
"Heard","2021-01-24","4","4348","2","582","22.5","22.3"
"Heard","2021-01-25","48","4396","5","587","21","21.9"
"Heard","2021-01-26","32","4428","6","593","22.3","22.6"
"Heard","2021-01-27","35","4463","4","597","20.5","21.4"
"Heard","2021-01-28","24","4487","4","601","20.7","21.2"
"Heard","2021-01-29","18","4505","1","602","20.7","19.3"
"Heard","2021-01-30","18","4523","3","605","18.5","17.7"
"Heard","2021-01-31","4","4527","2","607","18.5","20.5"
"Heard","2021-02-01","23","4550","3","610","18.9","19.9"
"Heard","2021-02-02","32","4582","5","615","18.4","20.4"
"Heard","2021-02-03","19","4601","5","620","20.6","20.5"
"Heard","2021-02-04","23","4624","2","622","19.4","20.1"
"Heard","2021-02-05","28","4652","6","628","21.7","21.2"
"Heard","2021-02-06","3","4655","1","629","24.1","21.3"
"Heard","2021-02-07","1","4656","0","629","16.9","17.7"
"Heard","2021-02-08","0","4656","0","629","15.1","17"
"Henry","2020-02-01","0","0","0","0",".","."
"Henry","2020-02-02","0","0","0","0",".","."
"Henry","2020-02-03","0","0","0","0",".","."
"Henry","2020-02-04","0","0","0","0",".","."
"Henry","2020-02-05","0","0","0","0",".","."
"Henry","2020-02-06","0","0","0","0",".","."
"Henry","2020-02-07","0","0","0","0","0","."
"Henry","2020-02-08","0","0","0","0","0","."
"Henry","2020-02-09","0","0","0","0","0","."
"Henry","2020-02-10","0","0","0","0","0","."
"Henry","2020-02-11","0","0","0","0","0","."
"Henry","2020-02-12","0","0","0","0","0","."
"Henry","2020-02-13","0","0","0","0","0","."
"Henry","2020-02-14","0","0","0","0","0","0"
"Henry","2020-02-15","0","0","0","0","0","0"
"Henry","2020-02-16","0","0","0","0","0","0"
"Henry","2020-02-17","0","0","0","0","0","0"
"Henry","2020-02-18","0","0","0","0","0","0"
"Henry","2020-02-19","0","0","0","0","0","0"
"Henry","2020-02-20","0","0","0","0","0","0"
"Henry","2020-02-21","0","0","0","0","0","0"
"Henry","2020-02-22","0","0","0","0","0","0"
"Henry","2020-02-23","0","0","0","0","0","0"
"Henry","2020-02-24","0","0","0","0","0","0"
"Henry","2020-02-25","0","0","0","0","0","0"
"Henry","2020-02-26","0","0","0","0","0","0"
"Henry","2020-02-27","0","0","0","0","0","0"
"Henry","2020-02-28","0","0","0","0","0","0"
"Henry","2020-02-29","0","0","0","0","0","0"
"Henry","2020-03-01","0","0","0","0","0","0"
"Henry","2020-03-02","0","0","0","0","0","0"
"Henry","2020-03-03","0","0","0","0","0","0"
"Henry","2020-03-04","0","0","0","0","0","0"
"Henry","2020-03-05","0","0","0","0","0","0"
"Henry","2020-03-06","0","0","0","0","0","0"
"Henry","2020-03-07","0","0","0","0","0","0"
"Henry","2020-03-08","0","0","0","0","0","0"
"Henry","2020-03-09","0","0","0","0","0","0"
"Henry","2020-03-10","0","0","0","0","0","0"
"Henry","2020-03-11","10","10","0","0","0","0"
"Henry","2020-03-12","12","22","5","5","6","3"
"Henry","2020-03-13","28","50","9","14","10.5","5.3"
"Henry","2020-03-14","2","52","0","14","10.5","5.3"
"Henry","2020-03-15","10","62","1","15","12","6"
"Henry","2020-03-16","24","86","4","19","14.4","7.2"
"Henry","2020-03-17","23","109","4","23","16.8","8.4"
"Henry","2020-03-18","33","142","10","33","21.2","10.6"
"Henry","2020-03-19","43","185","5","38","16.9","11.4"
"Henry","2020-03-20","37","222","9","47","15.8","13.2"
"Henry","2020-03-21","12","234","3","50","19.3","14.9"
"Henry","2020-03-22","17","251","10","60","26.3","19.1"
"Henry","2020-03-23","53","304","25","85","30.7","22.5"
"Henry","2020-03-24","50","354","19","104","33.6","25.2"
"Henry","2020-03-25","86","440","32","136","34.6","27.9"
"Henry","2020-03-26","75","515","17","153","36.2","26.5"
"Henry","2020-03-27","68","583","14","167","35.6","25.7"
"Henry","2020-03-28","21","604","11","178","39.5","29.4"
"Henry","2020-03-29","20","624","4","182","34","30.2"
"Henry","2020-03-30","97","721","24","206","30.8","30.7"
"Henry","2020-03-31","63","784","14","220","28.5","31.1"
"Henry","2020-04-01","66","850","12","232","25.8","30.2"
"Henry","2020-04-02","67","917","15","247","25.8","31"
"Henry","2020-04-03","56","973","6","253","24.4","30"
"Henry","2020-04-04","29","1002","6","259","19.8","29.7"
"Henry","2020-04-05","12","1014","3","262","20.6","27.3"
"Henry","2020-04-06","110","1124","24","286","20.1","25.5"
"Henry","2020-04-07","80","1204","15","301","19.6","24.1"
"Henry","2020-04-08","120","1324","17","318","19.1","22.5"
"Henry","2020-04-09","114","1438","18","336","18.1","22"
"Henry","2020-04-10","118","1556","13","349","18.2","21.3"
"Henry","2020-04-11","47","1603","3","352","16.1","18"
"Henry","2020-04-12","20","1623","3","355","14.7","17.6"
"Henry","2020-04-13","126","1749","19","374","13.7","16.9"
"Henry","2020-04-14","123","1872","15","389","12.8","16.2"
"Henry","2020-04-15","113","1985","14","403","12.6","15.8"
"Henry","2020-04-16","129","2114","20","423","12.5","15.3"
"Henry","2020-04-17","126","2240","5","428","11.5","14.8"
"Henry","2020-04-18","49","2289","8","436","12.9","14.5"
"Henry","2020-04-19","51","2340","7","443","12.7","13.7"
"Henry","2020-04-20","156","2496","20","463","12.4","13.1"
"Henry","2020-04-21","269","2765","32","495","12.4","12.6"
"Henry","2020-04-22","182","2947","8","503","11.2","11.9"
"Henry","2020-04-23","191","3138","12","515","9.9","11.2"
"Henry","2020-04-24","197","3335","25","540","11.2","11.3"
"Henry","2020-04-25","101","3436","10","550","10.2","11.6"
"Henry","2020-04-26","41","3477","2","552","9","10.9"
"Henry","2020-04-27","192","3669","17","569","8.4","10.4"
"Henry","2020-04-28","203","3872","17","586","7.9","10.1"
"Henry","2020-04-29","189","4061","9","595","8","9.6"
"Henry","2020-04-30","226","4287","16","611","8.1","9"
"Henry","2020-05-01","214","4501","18","629","7.5","9.3"
"Henry","2020-05-02","105","4606","10","639","7.4","8.8"
"Henry","2020-05-03","98","4704","4","643","7.3","8.1"
"Henry","2020-05-04","190","4894","16","659","7.2","7.8"
"Henry","2020-05-05","221","5115","16","675","7.1","7.5"
"Henry","2020-05-06","197","5312","17","692","7.6","7.8"
"Henry","2020-05-07","175","5487","11","703","7.5","7.8"
"Henry","2020-05-08","221","5708","10","713","7","7.2"
"Henry","2020-05-09","97","5805","5","718","6.3","6.9"
"Henry","2020-05-10","66","5871","4","722","6.6","7"
"Henry","2020-05-11","273","6144","9","731","5.9","6.6"
"Henry","2020-05-12","283","6427","16","747","5.7","6.4"
"Henry","2020-05-13","256","6683","6","753","4.8","6.2"
"Henry","2020-05-14","248","6931","6","759","4.2","5.9"
"Henry","2020-05-15","249","7180","11","770","4.2","5.6"
"Henry","2020-05-16","141","7321","4","774","3.9","5.1"
"Henry","2020-05-17","72","7393","3","777","3.6","5.1"
"Henry","2020-05-18","190","7583","4","781","3.4","4.7"
"Henry","2020-05-19","269","7852","15","796","3.4","4.5"
"Henry","2020-05-20","276","8128","10","806","3.6","4.2"
"Henry","2020-05-21","227","8355","11","817","3.9","4.1"
"Henry","2020-05-22","279","8634","7","824","3.7","3.9"
"Henry","2020-05-23","351","8985","5","829","3.5","3.7"
"Henry","2020-05-24","69","9054","2","831","3.3","3.4"
"Henry","2020-05-25","34","9088","3","834","4.2","3.8"
"Henry","2020-05-26","292","9380","18","852","4.3","3.9"
"Henry","2020-05-27","253","9633","18","870","4.8","4.2"
"Henry","2020-05-28","208","9841","10","880","4.8","4.4"
"Henry","2020-05-29","201","10042","13","893","5.4","4.5"
"Henry","2020-05-30","54","10096","3","896","6","4.7"
"Henry","2020-05-31","64","10160","3","899","6.2","4.8"
"Henry","2020-06-01","242","10402","21","920","6.2","5.2"
"Henry","2020-06-02","219","10621","13","933","6.2","5.3"
"Henry","2020-06-03","234","10855","6","939","5.5","5.2"
"Henry","2020-06-04","206","11061","11","950","5.6","5.2"
"Henry","2020-06-05","233","11294","13","963","5.5","5.4"
"Henry","2020-06-06","114","11408","6","969","5.4","5.7"
"Henry","2020-06-07","60","11468","4","973","5.7","6"
"Henry","2020-06-08","366","11834","17","990","5.1","5.7"
"Henry","2020-06-09","259","12093","8","998","4.7","5.5"
"Henry","2020-06-10","245","12338","16","1014","5.3","5.4"
"Henry","2020-06-11","273","12611","14","1028","5.3","5.4"
"Henry","2020-06-12","179","12790","9","1037","5.2","5.3"
"Henry","2020-06-13","60","12850","6","1043","5.9","5.7"
"Henry","2020-06-14","82","12932","6","1049","6","5.8"
"Henry","2020-06-15","297","13229","44","1093","7.4","6.3"
"Henry","2020-06-16","292","13521","30","1123","8.4","6.6"
"Henry","2020-06-17","288","13809","34","1157","9.2","7.2"
"Henry","2020-06-18","313","14122","34","1191","10","7.6"
"Henry","2020-06-19","293","14415","30","1221","10.8","8"
"Henry","2020-06-20","100","14515","14","1235","11.3","8.6"
"Henry","2020-06-21","76","14591","11","1246","12.4","9.2"
"Henry","2020-06-22","434","15025","52","1298","11.9","9.7"
"Henry","2020-06-23","442","15467","47","1345","12","10.2"
"Henry","2020-06-24","402","15869","44","1389","11.9","10.5"
"Henry","2020-06-25","256","16125","20","1409","11.4","10.7"
"Henry","2020-06-26","407","16532","39","1448","11.3","11.1"
"Henry","2020-06-27","130","16662","15","1463","11","11.2"
"Henry","2020-06-28","125","16787","16","1479","10.8","11.6"
"Henry","2020-06-29","523","17310","51","1530","10.4","11.2"
"Henry","2020-06-30","386","17696","45","1575","10.6","11.3"
"Henry","2020-07-01","341","18037","38","1613","10.6","11.2"
"Henry","2020-07-02","314","18351","53","1666","11.9","11.7"
"Henry","2020-07-03","199","18550","35","1701","13.1","12.2"
"Henry","2020-07-04","51","18601","13","1714","15","13"
"Henry","2020-07-05","110","18711","21","1735","15.9","13.3"
"Henry","2020-07-06","392","19103","76","1811","17.3","13.9"
"Henry","2020-07-07","388","19491","68","1879","18.2","14.4"
"Henry","2020-07-08","451","19942","55","1934","18.3","14.5"
"Henry","2020-07-09","433","20375","52","1986","17.6","14.8"
"Henry","2020-07-10","383","20758","50","2036","17","15"
"Henry","2020-07-11","171","20929","22","2058","15.2","15.1"
"Henry","2020-07-12","109","21038","13","2071","14.1","15"
"Henry","2020-07-13","377","21415","62","2133","13.7","15.5"
"Henry","2020-07-14","367","21782","67","2200","13.8","16"
"Henry","2020-07-15","319","22101","50","2250","14.3","16.3"
"Henry","2020-07-16","344","22445","51","2301","14.7","16.2"
"Henry","2020-07-17","313","22758","29","2330","14.2","15.6"
"Henry","2020-07-18","159","22917","24","2354","14.5","14.8"
"Henry","2020-07-19","119","23036","16","2370","14.7","14.4"
"Henry","2020-07-20","292","23328","39","2409","14.3","14"
"Henry","2020-07-21","287","23615","24","2433","12.9","13.3"
"Henry","2020-07-22","353","23968","43","2476","12.4","13.3"
"Henry","2020-07-23","360","24328","39","2515","11.8","13.3"
"Henry","2020-07-24","324","24652","52","2567","12.8","13.5"
"Henry","2020-07-25","176","24828","12","2579","11.6","13"
"Henry","2020-07-26","79","24907","6","2585","10.7","12.7"
"Henry","2020-07-27","372","25279","38","2623","10.3","12.3"
"Henry","2020-07-28","376","25655","45","2668","10.8","11.8"
"Henry","2020-07-29","317","25972","34","2702","10.6","11.5"
"Henry","2020-07-30","300","26272","31","2733","10.5","11.2"
"Henry","2020-07-31","320","26592","29","2762","9.5","11.1"
"Henry","2020-08-01","131","26723","22","2784","11","11.3"
"Henry","2020-08-02","94","26817","17","2801","12.5","11.6"
"Henry","2020-08-03","349","27166","36","2837","12.5","11.4"
"Henry","2020-08-04","315","27481","30","2867","12.1","11.5"
"Henry","2020-08-05","265","27746","25","2892","11.9","11.3"
"Henry","2020-08-06","315","28061","36","2928","12.1","11.3"
"Henry","2020-08-07","296","28357","34","2962","12.4","11"
"Henry","2020-08-08","214","28571","15","2977","11","11"
"Henry","2020-08-09","109","28680","11","2988","9.9","11.2"
"Henry","2020-08-10","352","29032","34","3022","9.8","11.1"
"Henry","2020-08-11","636","29668","72","3094","10.1","11.1"
"Henry","2020-08-12","534","30202","70","3164","10.6","11.3"
"Henry","2020-08-13","528","30730","54","3218","10.4","11.3"
"Henry","2020-08-14","672","31402","58","3276","10","11.2"
"Henry","2020-08-15","268","31670","22","3298","10.2","10.6"
"Henry","2020-08-16","186","31856","16","3314","10","9.9"
"Henry","2020-08-17","523","32379","72","3386","10.6","10.2"
"Henry","2020-08-18","540","32919","79","3465","11","10.5"
"Henry","2020-08-19","544","33463","60","3525","10.7","10.7"
"Henry","2020-08-20","440","33903","65","3590","11.4","10.9"
"Henry","2020-08-21","451","34354","51","3641","11.8","10.9"
"Henry","2020-08-22","186","34540","14","3655","11.7","10.9"
"Henry","2020-08-23","108","34648","6","3661","11.2","10.6"
"Henry","2020-08-24","459","35107","57","3718","11","10.8"
"Henry","2020-08-25","410","35517","48","3766","10.6","10.8"
"Henry","2020-08-26","397","35914","31","3797","10.2","10.4"
"Henry","2020-08-27","329","36243","29","3826","9.3","10.3"
"Henry","2020-08-28","401","36644","40","3866","9.1","10.4"
"Henry","2020-08-29","233","36877","21","3887","9.3","10.5"
"Henry","2020-08-30","81","36958","6","3893","9.6","10.4"
"Henry","2020-08-31","375","37333","41","3934","9.4","10.2"
"Henry","2020-09-01","386","37719","40","3974","9.2","9.9"
"Henry","2020-09-02","296","38015","26","4000","9.3","9.7"
"Henry","2020-09-03","318","38333","40","4040","9.9","9.6"
"Henry","2020-09-04","303","38636","38","4078","10.2","9.7"
"Henry","2020-09-05","206","38842","22","4100","10.5","9.9"
"Henry","2020-09-06","85","38927","5","4105","10.3","9.9"
"Henry","2020-09-07","84","39011","15","4120","11.2","10.3"
"Henry","2020-09-08","417","39428","49","4169","11.4","10.3"
"Henry","2020-09-09","333","39761","28","4197","11.4","10.4"
"Henry","2020-09-10","351","40112","42","4239","11.3","10.6"
"Henry","2020-09-11","330","40442","24","4263","10.5","10.4"
"Henry","2020-09-12","156","40598","14","4277","10.3","10.4"
"Henry","2020-09-13","91","40689","5","4282","10.2","10.2"
"Henry","2020-09-14","345","41034","31","4313","9","10.1"
"Henry","2020-09-15","442","41476","43","4356","8.7","10.1"
"Henry","2020-09-16","285","41761","21","4377","8.5","10"
"Henry","2020-09-17","331","42092","19","4396","7.7","9.5"
"Henry","2020-09-18","396","42488","45","4441","8.2","9.4"
"Henry","2020-09-19","113","42601","6","4447","7.7","9"
"Henry","2020-09-20","93","42694","9","4456","8.3","9.3"
"Henry","2020-09-21","390","43084","39","4495","8.5","8.7"
"Henry","2020-09-22","297","43381","16","4511","7.8","8.3"
"Henry","2020-09-23","370","43751","31","4542","8","8.3"
"Henry","2020-09-24","268","44019","14","4556","7.9","7.8"
"Henry","2020-09-25","324","44343","20","4576","7.2","7.7"
"Henry","2020-09-26","97","44440","11","4587","8","7.9"
"Henry","2020-09-27","90","44530","8","4595","7.9","8.1"
"Henry","2020-09-28","351","44881","21","4616","7.3","7.9"
"Henry","2020-09-29","427","45308","35","4651","7.7","7.8"
"Henry","2020-09-30","341","45649","23","4674","7.5","7.7"
"Henry","2020-10-01","306","45955","20","4694","7.7","7.8"
"Henry","2020-10-02","390","46345","30","4724","7.9","7.5"
"Henry","2020-10-03","229","46574","12","4736","7","7.5"
"Henry","2020-10-04","96","46670","3","4739","6.2","7.1"
"Henry","2020-10-05","435","47105","34","4773","6.5","6.9"
"Henry","2020-10-06","544","47649","33","4806","6.2","7"
"Henry","2020-10-07","431","48080","27","4833","6.1","6.8"
"Henry","2020-10-08","373","48453","32","4865","6.4","7"
"Henry","2020-10-09","412","48865","31","4896","6.4","7.1"
"Henry","2020-10-10","164","49029","18","4914","7.2","7.1"
"Henry","2020-10-11","93","49122","6","4920","7.7","6.9"
"Henry","2020-10-12","329","49451","26","4946","7.7","7.1"
"Henry","2020-10-13","513","49964","35","4981","7.8","7"
"Henry","2020-10-14","370","50334","29","5010","8","7.1"
"Henry","2020-10-15","369","50703","33","5043","8.1","7.2"
"Henry","2020-10-16","380","51083","36","5079","8.3","7.4"
"Henry","2020-10-17","158","51241","14","5093","8","7.6"
"Henry","2020-10-18","97","51338","10","5103","8.6","8.1"
"Henry","2020-10-19","451","51789","38","5141","8.7","8.2"
"Henry","2020-10-20","442","52231","31","5172","8.7","8.2"
"Henry","2020-10-21","439","52670","33","5205","8.6","8.3"
"Henry","2020-10-22","410","53080","45","5250","8.9","8.5"
"Henry","2020-10-23","496","53576","52","5302","9.1","8.7"
"Henry","2020-10-24","240","53816","39","5341","10.1","9.1"
"Henry","2020-10-25","162","53978","15","5356","10","9.3"
"Henry","2020-10-26","524","54502","52","5408","10.2","9.4"
"Henry","2020-10-27","499","55001","45","5453","10.5","9.6"
"Henry","2020-10-28","451","55452","50","5503","11","9.8"
"Henry","2020-10-29","298","55750","31","5534","10.9","9.9"
"Henry","2020-10-30","526","56276","56","5590","10.9","10"
"Henry","2020-10-31","177","56453","12","5602","9.6","9.9"
"Henry","2020-11-01","169","56622","17","5619","9.7","9.8"
"Henry","2020-11-02","588","57210","63","5682","9.8","10"
"Henry","2020-11-03","591","57801","57","5739","9.9","10.2"
"Henry","2020-11-04","497","58298","51","5790","9.8","10.4"
"Henry","2020-11-05","460","58758","28","5818","9.2","10"
"Henry","2020-11-06","493","59251","49","5867","9.1","10"
"Henry","2020-11-07","253","59504","23","5890","9.4","9.5"
"Henry","2020-11-08","143","59647","18","5908","9.8","9.7"
"Henry","2020-11-09","650","60297","70","5978","9.8","9.8"
"Henry","2020-11-10","548","60845","61","6039","10","9.9"
"Henry","2020-11-11","377","61222","41","6080","10.1","9.9"
"Henry","2020-11-12","595","61817","65","6145","10.8","10"
"Henry","2020-11-13","589","62406","55","6200","10.7","9.9"
"Henry","2020-11-14","293","62699","35","6235","11.1","10.2"
"Henry","2020-11-15","229","62928","25","6260","10.8","10.3"
"Henry","2020-11-16","687","63615","75","6335","10.9","10.3"
"Henry","2020-11-17","684","64299","73","6408","10.8","10.4"
"Henry","2020-11-18","684","64983","60","6468","10.5","10.3"
"Henry","2020-11-19","681","65664","64","6532","10.3","10.5"
"Henry","2020-11-20","741","66405","91","6623","10.7","10.7"
"Henry","2020-11-21","253","66658","26","6649","10.5","10.8"
"Henry","2020-11-22","189","66847","32","6681","11.3","11.1"
"Henry","2020-11-23","821","67668","80","6761","11.2","11"
"Henry","2020-11-24","747","68415","106","6867","11.7","11.2"
"Henry","2020-11-25","715","69130","87","6954","12.1","11.3"
"Henry","2020-11-26","105","69235","8","6962","11.9","11.1"
"Henry","2020-11-27","370","69605","64","7026","12.6","11.7"
"Henry","2020-11-28","260","69865","50","7076","13.9","12.2"
"Henry","2020-11-29","209","70074","45","7121","14.5","12.9"
"Henry","2020-11-30","849","70923","156","7277","15.8","13.5"
"Henry","2020-12-01","636","71559","88","7365","15.7","13.7"
"Henry","2020-12-02","828","72387","135","7500","16.3","14.2"
"Henry","2020-12-03","764","73151","108","7608","17.2","14.6"
"Henry","2020-12-04","862","74013","153","7761","17.3","15"
"Henry","2020-12-05","335","74348","55","7816","16.9","15.4"
"Henry","2020-12-06","221","74569","37","7853","16.2","15.4"
"Henry","2020-12-07","841","75410","140","7993","16","15.9"
"Henry","2020-12-08","839","76249","130","8123","16.2","16"
"Henry","2020-12-09","839","77088","147","8270","16.4","16.4"
"Henry","2020-12-10","823","77911","152","8422","17","17.1"
"Henry","2020-12-11","914","78825","161","8583","17","17.1"
"Henry","2020-12-12","373","79198","67","8650","17.2","17.1"
"Henry","2020-12-13","262","79460","53","8703","17.7","17"
"Henry","2020-12-14","1130","80590","178","8881","17.6","16.8"
"Henry","2020-12-15","973","81563","170","9051","17.9","17"
"Henry","2020-12-16","974","82537","177","9228","18","17.2"
"Henry","2020-12-17","1024","83561","190","9418","18","17.5"
"Henry","2020-12-18","1103","84664","212","9630","18.2","17.6"
"Henry","2020-12-19","355","85019","66","9696","18.3","17.7"
"Henry","2020-12-20","252","85271","47","9743","18.1","17.9"
"Henry","2020-12-21","1442","86713","278","10021","18.6","18.1"
"Henry","2020-12-22","1088","87801","218","10239","18.9","18.4"
"Henry","2020-12-23","1131","88932","201","10440","18.9","18.4"
"Henry","2020-12-24","460","89392","125","10565","20.1","19"
"Henry","2020-12-25","65","89457","15","10580","20.7","19.4"
"Henry","2020-12-26","513","89970","148","10728","22.1","20.2"
"Henry","2020-12-27","243","90213","67","10795","23.4","20.7"
"Henry","2020-12-28","1342","91555","258","11053","23.4","21"
"Henry","2020-12-29","1149","92704","291","11344","24.1","21.5"
"Henry","2020-12-30","1136","93840","246","11590","24.7","21.8"
"Henry","2020-12-31","584","94424","128","11718","23.9","22"
"Henry","2021-01-01","107","94531","28","11746","24.4","22.5"
"Henry","2021-01-02","531","95062","131","11877","23.8","23"
"Henry","2021-01-03","256","95318","87","11964","24.7","24.1"
"Henry","2021-01-04","1295","96613","340","12304","25.7","24.5"
"Henry","2021-01-05","1307","97920","289","12593","25.3","24.7"
"Henry","2021-01-06","1295","99215","281","12874","25.3","25"
"Henry","2021-01-07","1268","100483","294","13168","25.4","24.7"
"Henry","2021-01-08","921","101404","193","13361","24.7","24.5"
"Henry","2021-01-09","639","102043","135","13496","24.2","24"
"Henry","2021-01-10","301","102344","50","13546","21.7","23.2"
"Henry","2021-01-11","1246","103590","228","13774","20.6","23.1"
"Henry","2021-01-12","1017","104607","196","13970","20.2","22.7"
"Henry","2021-01-13","1040","105647","206","14176","19.9","22.6"
"Henry","2021-01-14","1035","106682","193","14369","19.2","22.3"
"Henry","2021-01-15","758","107440","169","14538","19.4","22.1"
"Henry","2021-01-16","514","107954","113","14651","19.6","21.9"
"Henry","2021-01-17","347","108301","53","14704","19.4","20.5"
"Henry","2021-01-18","760","109061","133","14837","19.3","19.9"
"Henry","2021-01-19","932","109993","174","15011","19.2","19.7"
"Henry","2021-01-20","966","110959","189","15200","19.1","19.5"
"Henry","2021-01-21","844","111803","136","15336","18.8","19"
"Henry","2021-01-22","822","112625","124","15460","17.7","18.6"
"Henry","2021-01-23","476","113101","87","15547","17.2","18.4"
"Henry","2021-01-24","332","113433","44","15591","16.9","18.1"
"Henry","2021-01-25","1103","114536","190","15781","16.9","18.1"
"Henry","2021-01-26","914","115450","151","15932","16.6","17.9"
"Henry","2021-01-27","835","116285","122","16054","15.9","17.5"
"Henry","2021-01-28","809","117094","120","16174","15.7","17.2"
"Henry","2021-01-29","680","117774","97","16271","15.6","16.7"
"Henry","2021-01-30","404","118178","73","16344","15.5","16.4"
"Henry","2021-01-31","314","118492","56","16400","16.2","16.6"
"Henry","2021-02-01","793","119285","108","16508","15.7","16.3"
"Henry","2021-02-02","725","120010","105","16613","15.4","16"
"Henry","2021-02-03","701","120711","87","16700","15.1","15.5"
"Henry","2021-02-04","657","121368","91","16791","14.9","15.3"
"Henry","2021-02-05","422","121790","55","16846","14.8","15.2"
"Henry","2021-02-06","141","121931","18","16864","14","14.8"
"Henry","2021-02-07","4","121935","2","16866","18.6","17.4"
"Henry","2021-02-08","0","121935","0","16866","16.6","16.2"
"Houston","2020-02-01","0","0","0","0",".","."
"Houston","2020-02-02","0","0","0","0",".","."
"Houston","2020-02-03","0","0","0","0",".","."
"Houston","2020-02-04","0","0","0","0",".","."
"Houston","2020-02-05","0","0","0","0",".","."
"Houston","2020-02-06","0","0","0","0",".","."
"Houston","2020-02-07","0","0","0","0","0","."
"Houston","2020-02-08","0","0","0","0","0","."
"Houston","2020-02-09","0","0","0","0","0","."
"Houston","2020-02-10","0","0","0","0","0","."
"Houston","2020-02-11","0","0","0","0","0","."
"Houston","2020-02-12","0","0","0","0","0","."
"Houston","2020-02-13","0","0","0","0","0","."
"Houston","2020-02-14","0","0","0","0","0","0"
"Houston","2020-02-15","0","0","0","0","0","0"
"Houston","2020-02-16","0","0","0","0","0","0"
"Houston","2020-02-17","0","0","0","0","0","0"
"Houston","2020-02-18","0","0","0","0","0","0"
"Houston","2020-02-19","0","0","0","0","0","0"
"Houston","2020-02-20","0","0","0","0","0","0"
"Houston","2020-02-21","0","0","0","0","0","0"
"Houston","2020-02-22","0","0","0","0","0","0"
"Houston","2020-02-23","0","0","0","0","0","0"
"Houston","2020-02-24","0","0","0","0","0","0"
"Houston","2020-02-25","0","0","0","0","0","0"
"Houston","2020-02-26","0","0","0","0","0","0"
"Houston","2020-02-27","0","0","0","0","0","0"
"Houston","2020-02-28","0","0","0","0","0","0"
"Houston","2020-02-29","0","0","0","0","0","0"
"Houston","2020-03-01","0","0","0","0","0","0"
"Houston","2020-03-02","0","0","0","0","0","0"
"Houston","2020-03-03","0","0","0","0","0","0"
"Houston","2020-03-04","0","0","0","0","0","0"
"Houston","2020-03-05","0","0","0","0","0","0"
"Houston","2020-03-06","5","5","0","0","0","0"
"Houston","2020-03-07","1","6","0","0","0","0"
"Houston","2020-03-08","2","8","0","0","0","0"
"Houston","2020-03-09","2","10","0","0","0","0"
"Houston","2020-03-10","0","10","0","0","0","0"
"Houston","2020-03-11","0","10","0","0","0","0"
"Houston","2020-03-12","1","11","0","0","0","0"
"Houston","2020-03-13","0","11","0","0","0","0"
"Houston","2020-03-14","1","12","0","0","0","0"
"Houston","2020-03-15","2","14","0","0","0","0"
"Houston","2020-03-16","5","19","2","2","5.7","2.9"
"Houston","2020-03-17","6","25","2","4","10.5","5.2"
"Houston","2020-03-18","11","36","2","6","13.1","6.5"
"Houston","2020-03-19","16","52","0","6","13.1","6.5"
"Houston","2020-03-20","18","70","1","7","13.9","6.9"
"Houston","2020-03-21","4","74","1","8","17.4","8.7"
"Houston","2020-03-22","5","79","0","8","17.4","8.7"
"Houston","2020-03-23","28","107","2","10","12.7","9.2"
"Houston","2020-03-24","35","142","2","12","8.8","9.6"
"Houston","2020-03-25","31","173","8","20","9.9","11.5"
"Houston","2020-03-26","20","193","5","25","13.5","13.3"
"Houston","2020-03-27","19","212","4","29","15.7","14.8"
"Houston","2020-03-28","6","218","0","29","12.1","14.8"
"Houston","2020-03-29","4","222","1","30","15.7","16.6"
"Houston","2020-03-30","46","268","5","35","16.2","14.5"
"Houston","2020-03-31","17","285","2","37","17.1","12.9"
"Houston","2020-04-01","40","325","5","42","15.2","12.5"
"Houston","2020-04-02","42","367","5","47","13.3","13.4"
"Houston","2020-04-03","52","419","6","53","11.9","13.8"
"Houston","2020-04-04","17","436","0","53","11.9","12"
"Houston","2020-04-05","4","440","2","55","15.5","15.6"
"Houston","2020-04-06","48","488","9","64","16.6","16.4"
"Houston","2020-04-07","62","550","9","73","17","17.1"
"Houston","2020-04-08","40","590","4","77","16.7","15.9"
"Houston","2020-04-09","51","641","8","85","17.2","15.3"
"Houston","2020-04-10","27","668","3","88","17.2","14.5"
"Houston","2020-04-11","23","691","1","89","17.8","14.9"
"Houston","2020-04-12","8","699","0","89","10.6","13.1"
"Houston","2020-04-13","51","750","14","103","11.9","14.3"
"Houston","2020-04-14","52","802","7","110","11.7","14.4"
"Houston","2020-04-15","49","851","8","118","12.6","14.6"
"Houston","2020-04-16","77","928","5","123","11.3","14.3"
"Houston","2020-04-17","64","992","5","128","10.8","14"
"Houston","2020-04-18","31","1023","0","128","10.2","14"
"Houston","2020-04-19","5","1028","0","128","10.2","10.4"
"Houston","2020-04-20","69","1097","6","134","7.5","9.7"
"Houston","2020-04-21","63","1160","3","137","6.3","9"
"Houston","2020-04-22","71","1231","10","147","6","9.3"
"Houston","2020-04-23","27","1258","2","149","6.1","8.7"
"Houston","2020-04-24","91","1349","12","161","6.9","8.9"
"Houston","2020-04-25","33","1382","1","162","7.3","8.8"
"Houston","2020-04-26","7","1389","0","162","7.3","8.8"
"Houston","2020-04-27","89","1478","6","168","7","7.3"
"Houston","2020-04-28","159","1637","12","180","7.4","6.9"
"Houston","2020-04-29","129","1766","15","195","7.1","6.5"
"Houston","2020-04-30","49","1815","1","196","6.3","6.2"
"Houston","2020-05-01","104","1919","5","201","5.1","6"
"Houston","2020-05-02","32","1951","2","203","5.6","6.4"
"Houston","2020-05-03","24","1975","0","203","5.6","6.4"
"Houston","2020-05-04","82","2057","5","208","5.5","6.3"
"Houston","2020-05-05","66","2123","3","211","5.1","6.2"
"Houston","2020-05-06","81","2204","6","217","4.4","5.8"
"Houston","2020-05-07","83","2287","5","222","5","5.7"
"Houston","2020-05-08","248","2535","18","240","5.4","5.2"
"Houston","2020-05-09","97","2632","3","243","4.9","5.2"
"Houston","2020-05-10","83","2715","16","259","7.7","6.6"
"Houston","2020-05-11","92","2807","3","262","7.3","6.4"
"Houston","2020-05-12","104","2911","3","265","7","6"
"Houston","2020-05-13","92","3003","3","268","6.4","5.4"
"Houston","2020-05-14","90","3093","6","274","6.5","5.8"
"Houston","2020-05-15","110","3203","9","283","6.7","6"
"Houston","2020-05-16","62","3265","2","285","6.7","5.8"
"Houston","2020-05-17","10","3275","0","285","3.9","5.8"
"Houston","2020-05-18","73","3348","5","290","4.4","5.9"
"Houston","2020-05-19","121","3469","2","292","4.3","5.6"
"Houston","2020-05-20","111","3580","3","295","4.2","5.3"
"Houston","2020-05-21","45","3625","3","298","4.2","5.4"
"Houston","2020-05-22","63","3688","2","300","3.5","5.1"
"Houston","2020-05-23","48","3736","2","302","3.6","5.1"
"Houston","2020-05-24","11","3747","0","302","3.6","3.8"
"Houston","2020-05-25","15","3762","1","303","3.6","4"
"Houston","2020-05-26","119","3881","4","307","3.8","4"
"Houston","2020-05-27","71","3952","3","310","4","4.1"
"Houston","2020-05-28","55","4007","2","312","3.6","3.9"
"Houston","2020-05-29","78","4085","3","315","3.7","3.6"
"Houston","2020-05-30","47","4132","0","315","3.1","3.4"
"Houston","2020-05-31","10","4142","0","315","3.1","3.4"
"Houston","2020-06-01","94","4236","3","318","2.6","3.1"
"Houston","2020-06-02","77","4313","5","323","3.1","3.4"
"Houston","2020-06-03","99","4412","5","328","3.2","3.6"
"Houston","2020-06-04","91","4503","2","330","3","3.3"
"Houston","2020-06-05","103","4606","2","332","2.7","3.2"
"Houston","2020-06-06","35","4641","3","335","3.9","3.5"
"Houston","2020-06-07","24","4665","0","335","3.9","3.5"
"Houston","2020-06-08","92","4757","1","336","3.6","3.1"
"Houston","2020-06-09","109","4866","3","339","3.1","3.1"
"Houston","2020-06-10","85","4951","6","345","3.4","3.3"
"Houston","2020-06-11","161","5112","22","367","5","4"
"Houston","2020-06-12","109","5221","11","378","6.2","4.4"
"Houston","2020-06-13","40","5261","1","379","5.3","4.6"
"Houston","2020-06-14","16","5277","3","382","8","6"
"Houston","2020-06-15","140","5417","6","388","8.4","6"
"Houston","2020-06-16","144","5561","7","395","8.7","5.9"
"Houston","2020-06-17","115","5676","7","402","8.6","6"
"Houston","2020-06-18","153","5829","10","412","7.6","6.3"
"Houston","2020-06-19","206","6035","11","423","6.9","6.5"
"Houston","2020-06-20","65","6100","5","428","7.7","6.5"
"Houston","2020-06-21","30","6130","0","428","5","6.5"
"Houston","2020-06-22","183","6313","21","449","6","7.2"
"Houston","2020-06-23","193","6506","19","468","6.7","7.7"
"Houston","2020-06-24","213","6719","16","484","6.9","7.8"
"Houston","2020-06-25","205","6924","38","522","8.6","8.1"
"Houston","2020-06-26","255","7179","15","537","8.7","7.8"
"Houston","2020-06-27","69","7248","9","546","9.5","8.6"
"Houston","2020-06-28","30","7278","5","551","11.9","8.4"
"Houston","2020-06-29","285","7563","29","580","11.7","8.8"
"Houston","2020-06-30","362","7925","41","621","11.9","9.3"
"Houston","2020-07-01","286","8211","26","647","12.1","9.5"
"Houston","2020-07-02","406","8617","40","687","10.9","9.7"
"Houston","2020-07-03","100","8717","18","705","12.6","10.6"
"Houston","2020-07-04","42","8759","4","709","12.1","10.8"
"Houston","2020-07-05","45","8804","4","713","11","11.4"
"Houston","2020-07-06","302","9106","38","751","11.3","11.5"
"Houston","2020-07-07","370","9476","51","802","11.7","11.8"
"Houston","2020-07-08","267","9743","32","834","12.1","12.1"
"Houston","2020-07-09","320","10063","40","874","12.5","11.7"
"Houston","2020-07-10","352","10415","39","913","11.5","12"
"Houston","2020-07-11","87","10502","13","926","12.3","12.2"
"Houston","2020-07-12","56","10558","6","932","12.5","11.7"
"Houston","2020-07-13","294","10852","26","958","12","11.7"
"Houston","2020-07-14","238","11090","26","984","11.6","11.6"
"Houston","2020-07-15","263","11353","32","1016","11.6","11.8"
"Houston","2020-07-16","273","11626","26","1042","11.2","11.8"
"Houston","2020-07-17","287","11913","37","1079","11.4","11.5"
"Houston","2020-07-18","88","12001","10","1089","10.9","11.6"
"Houston","2020-07-19","60","12061","10","1099","11.8","12.1"
"Houston","2020-07-20","301","12362","34","1133","12.1","12"
"Houston","2020-07-21","338","12700","16","1149","11.2","11.4"
"Houston","2020-07-22","254","12954","34","1183","11.4","11.5"
"Houston","2020-07-23","264","13218","21","1204","11.2","11.2"
"Houston","2020-07-24","315","13533","43","1247","11.3","11.4"
"Houston","2020-07-25","84","13617","10","1257","11.4","11.1"
"Houston","2020-07-26","56","13673","6","1263","10.5","11.1"
"Houston","2020-07-27","444","14117","31","1294","9.9","11"
"Houston","2020-07-28","352","14469","47","1341","11.1","11.2"
"Houston","2020-07-29","295","14764","29","1370","10.6","11"
"Houston","2020-07-30","302","15066","23","1393","10.6","10.9"
"Houston","2020-07-31","314","15380","23","1416","9.7","10.5"
"Houston","2020-08-01","92","15472","15","1431","10.3","10.8"
"Houston","2020-08-02","38","15510","3","1434","9.9","10.2"
"Houston","2020-08-03","396","15906","22","1456","9.7","9.8"
"Houston","2020-08-04","335","16241","27","1483","8.9","10"
"Houston","2020-08-05","246","16487","23","1506","8.9","9.7"
"Houston","2020-08-06","287","16774","27","1533","9.1","9.9"
"Houston","2020-08-07","237","17011","19","1552","9.2","9.5"
"Houston","2020-08-08","71","17082","13","1565","9.5","9.9"
"Houston","2020-08-09","51","17133","8","1573","10.6","10.3"
"Houston","2020-08-10","408","17541","36","1609","11.1","10.4"
"Houston","2020-08-11","345","17886","49","1658","12","10.5"
"Houston","2020-08-12","271","18157","30","1688","12.2","10.5"
"Houston","2020-08-13","327","18484","50","1738","13.1","11.1"
"Houston","2020-08-14","251","18735","36","1774","14","11.6"
"Houston","2020-08-15","125","18860","22","1796","13.9","11.7"
"Houston","2020-08-16","62","18922","10","1806","13.9","12.3"
"Houston","2020-08-17","301","19223","22","1828","13.7","12.4"
"Houston","2020-08-18","313","19536","32","1860","13.1","12.6"
"Houston","2020-08-19","351","19887","40","1900","13.2","12.7"
"Houston","2020-08-20","267","20154","21","1921","12.1","12.6"
"Houston","2020-08-21","343","20497","26","1947","11.2","12.6"
"Houston","2020-08-22","89","20586","5","1952","9.4","11.7"
"Houston","2020-08-23","72","20658","9","1961","8.9","11.4"
"Houston","2020-08-24","397","21055","25","1986","8.8","11.2"
"Houston","2020-08-25","254","21309","22","2008","8.6","10.8"
"Houston","2020-08-26","241","21550","18","2026","8","10.6"
"Houston","2020-08-27","234","21784","16","2042","7.9","10"
"Houston","2020-08-28","201","21985","15","2057","7.8","9.5"
"Houston","2020-08-29","93","22078","10","2067","8.6","9"
"Houston","2020-08-30","55","22133","8","2075","8.9","8.9"
"Houston","2020-08-31","338","22471","21","2096","8.8","8.8"
"Houston","2020-09-01","230","22701","13","2109","8.4","8.5"
"Houston","2020-09-02","190","22891","14","2123","8.4","8.2"
"Houston","2020-09-03","318","23209","34","2157","9","8.4"
"Houston","2020-09-04","196","23405","12","2169","8.8","8.3"
"Houston","2020-09-05","90","23495","11","2180","9","8.8"
"Houston","2020-09-06","121","23616","6","2186","7.6","8.2"
"Houston","2020-09-07","45","23661","7","2193","8.9","8.9"
"Houston","2020-09-08","267","23928","19","2212","9.1","8.8"
"Houston","2020-09-09","315","24243","19","2231","9","8.7"
"Houston","2020-09-10","221","24464","19","2250","8.7","8.8"
"Houston","2020-09-11","199","24663","20","2270","9.2","9"
"Houston","2020-09-12","60","24723","4","2274","8.4","8.7"
"Houston","2020-09-13","104","24827","7","2281","8.7","8.1"
"Houston","2020-09-14","172","24999","21","2302","8.2","8.6"
"Houston","2020-09-15","215","25214","23","2325","8.7","8.9"
"Houston","2020-09-16","184","25398","15","2340","9","9"
"Houston","2020-09-17","280","25678","17","2357","8.7","8.7"
"Houston","2020-09-18","190","25868","19","2376","8.6","8.9"
"Houston","2020-09-19","65","25933","5","2381","8.8","8.6"
"Houston","2020-09-20","92","26025","1","2382","8","8.3"
"Houston","2020-09-21","236","26261","24","2406","7.7","7.9"
"Houston","2020-09-22","158","26419","12","2418","7.3","8"
"Houston","2020-09-23","142","26561","14","2432","7.5","8.3"
"Houston","2020-09-24","218","26779","14","2446","7.5","8.1"
"Houston","2020-09-25","149","26928","7","2453","6.8","7.7"
"Houston","2020-09-26","54","26982","4","2457","6.7","7.8"
"Houston","2020-09-27","24","27006","4","2461","9","8.5"
"Houston","2020-09-28","278","27284","18","2479","8.4","8.1"
"Houston","2020-09-29","197","27481","12","2491","8.2","7.7"
"Houston","2020-09-30","147","27628","11","2502","7.9","7.7"
"Houston","2020-10-01","239","27867","5","2507","7.3","7.4"
"Houston","2020-10-02","155","28022","13","2520","7.8","7.3"
"Houston","2020-10-03","88","28110","12","2532","8.7","7.7"
"Houston","2020-10-04","97","28207","6","2538","7.2","8.1"
"Houston","2020-10-05","343","28550","9","2547","6.6","7.5"
"Houston","2020-10-06","214","28764","10","2557","6.4","7.3"
"Houston","2020-10-07","207","28971","24","2581","7","7.5"
"Houston","2020-10-08","301","29272","13","2594","7.3","7.3"
"Houston","2020-10-09","163","29435","10","2604","7","7.4"
"Houston","2020-10-10","63","29498","11","2615","7.6","8.1"
"Houston","2020-10-11","59","29557","10","2625","9.1","8.2"
"Houston","2020-10-12","282","29839","13","2638","9.4","8"
"Houston","2020-10-13","175","30014","21","2659","10.4","8.4"
"Houston","2020-10-14","195","30209","24","2683","10.5","8.8"
"Houston","2020-10-15","199","30408","20","2703","11.4","9.4"
"Houston","2020-10-16","200","30608","22","2725","12.1","9.5"
"Houston","2020-10-17","66","30674","9","2734","11.5","9.5"
"Houston","2020-10-18","43","30717","11","2745","12.7","10.9"
"Houston","2020-10-19","365","31082","23","2768","13","11.2"
"Houston","2020-10-20","112","31194","10","2778","12.5","11.5"
"Houston","2020-10-21","200","31394","19","2797","12.1","11.3"
"Houston","2020-10-22","156","31550","15","2812","12.1","11.7"
"Houston","2020-10-23","233","31783","24","2836","12","12"
"Houston","2020-10-24","86","31869","10","2846","11.7","11.6"
"Houston","2020-10-25","73","31942","13","2859","10.6","11.7"
"Houston","2020-10-26","390","32332","37","2896","11","12"
"Houston","2020-10-27","164","32496","20","2916","11.5","12"
"Houston","2020-10-28","248","32744","21","2937","11.4","11.7"
"Houston","2020-10-29","144","32888","24","2961","12.4","12.2"
"Houston","2020-10-30","253","33141","15","2976","11.7","11.9"
"Houston","2020-10-31","119","33260","14","2990","11.8","11.7"
"Houston","2020-11-01","103","33363","14","3004","11.2","10.9"
"Houston","2020-11-02","393","33756","22","3026","10.6","10.8"
"Houston","2020-11-03","181","33937","15","3041","10","10.8"
"Houston","2020-11-04","218","34155","27","3068","10.6","11"
"Houston","2020-11-05","175","34330","13","3081","9.3","10.8"
"Houston","2020-11-06","262","34592","22","3103","9.6","10.7"
"Houston","2020-11-07","95","34687","20","3123","11","11.4"
"Houston","2020-11-08","73","34760","7","3130","10.4","10.8"
"Houston","2020-11-09","247","35007","22","3152","10.9","10.7"
"Houston","2020-11-10","173","35180","15","3167","10.9","10.5"
"Houston","2020-11-11","162","35342","21","3188","11","10.8"
"Houston","2020-11-12","190","35532","22","3210","11.6","10.4"
"Houston","2020-11-13","300","35832","29","3239","11.8","10.7"
"Houston","2020-11-14","132","35964","9","3248","9.7","10.4"
"Houston","2020-11-15","77","36041","11","3259","10.4","10.4"
"Houston","2020-11-16","312","36353","37","3296","10.8","10.8"
"Houston","2020-11-17","238","36591","24","3320","11","11"
"Houston","2020-11-18","285","36876","32","3352","10.8","10.9"
"Houston","2020-11-19","201","37077","10","3362","9.8","10.7"
"Houston","2020-11-20","294","37371","28","3390","9.8","10.8"
"Houston","2020-11-21","130","37501","12","3402","10.2","10"
"Houston","2020-11-22","105","37606","8","3410","9.2","9.8"
"Houston","2020-11-23","278","37884","23","3433","8.7","9.8"
"Houston","2020-11-24","191","38075","20","3453","8.8","9.9"
"Houston","2020-11-25","278","38353","35","3488","9","9.9"
"Houston","2020-11-26","24","38377","2","3490","9.4","9.6"
"Houston","2020-11-27","181","38558","25","3515","10","9.9"
"Houston","2020-11-28","121","38679","29","3544","12.2","11.2"
"Houston","2020-11-29","96","38775","21","3565","14.2","11.7"
"Houston","2020-11-30","373","39148","41","3606","14.6","11.6"
"Houston","2020-12-01","261","39409","30","3636","14.7","11.7"
"Houston","2020-12-02","400","39809","41","3677","14.4","11.7"
"Houston","2020-12-03","200","40009","24","3701","14.9","12.2"
"Houston","2020-12-04","358","40367","55","3756","15.1","12.6"
"Houston","2020-12-05","192","40559","19","3775","13.1","12.6"
"Houston","2020-12-06","124","40683","23","3798","12.6","13.4"
"Houston","2020-12-07","354","41037","42","3840","12.8","13.7"
"Houston","2020-12-08","260","41297","40","3880","13.3","14"
"Houston","2020-12-09","374","41671","61","3941","14.2","14.3"
"Houston","2020-12-10","318","41989","48","3989","14.6","14.8"
"Houston","2020-12-11","430","42419","73","4062","14.9","15"
"Houston","2020-12-12","203","42622","25","4087","15.2","14.2"
"Houston","2020-12-13","148","42770","45","4132","16.9","14.8"
"Houston","2020-12-14","465","43235","79","4211","17.6","15.2"
"Houston","2020-12-15","340","43575","56","4267","17.8","15.6"
"Houston","2020-12-16","433","44008","86","4353","18.3","16.2"
"Houston","2020-12-17","331","44339","44","4397","18","16.3"
"Houston","2020-12-18","423","44762","68","4465","17.9","16.4"
"Houston","2020-12-19","225","44987","58","4523","19.8","17.5"
"Houston","2020-12-20","217","45204","54","4577","19.1","18"
"Houston","2020-12-21","464","45668","96","4673","19.6","18.6"
"Houston","2020-12-22","340","46008","100","4773","21.4","19.6"
"Houston","2020-12-23","513","46521","113","4886","21.7","20"
"Houston","2020-12-24","312","46833","75","4961","23.3","20.7"
"Houston","2020-12-25","28","46861","9","4970","25.6","21.7"
"Houston","2020-12-26","216","47077","65","5035","26.2","23"
"Houston","2020-12-27","155","47232","54","5089","27.6","23.3"
"Houston","2020-12-28","612","47844","156","5245","28.3","23.9"
"Houston","2020-12-29","342","48186","98","5343","28.2","24.8"
"Houston","2020-12-30","626","48812","163","5506","28.8","25.2"
"Houston","2020-12-31","360","49172","90","5596","28.9","26.1"
"Houston","2021-01-01","46","49218","21","5617","30.8","28.2"
"Houston","2021-01-02","126","49344","53","5670","32.5","29.4"
"Houston","2021-01-03","260","49604","89","5759","32.4","30"
"Houston","2021-01-04","610","50214","183","5942","33.1","30.7"
"Houston","2021-01-05","478","50692","129","6071","32.9","30.5"
"Houston","2021-01-06","568","51260","146","6217","32.8","30.8"
"Houston","2021-01-07","394","51654","75","6292","32","30.4"
"Houston","2021-01-08","549","52203","83","6375","27.6","29.2"
"Houston","2021-01-09","242","52445","43","6418","24.1","28.3"
"Houston","2021-01-10","230","52675","46","6464","22.1","27.3"
"Houston","2021-01-11","533","53208","108","6572","20.7","26.9"
"Houston","2021-01-12","371","53579","88","6660","20.2","26.5"
"Houston","2021-01-13","481","54060","111","6771","19.9","26.3"
"Houston","2021-01-14","398","54458","86","6857","20.2","26.1"
"Houston","2021-01-15","388","54846","88","6945","21.3","24.4"
"Houston","2021-01-16","194","55040","46","6991","22.2","23.1"
"Houston","2021-01-17","153","55193","42","7033","23.2","22.7"
"Houston","2021-01-18","339","55532","79","7112","23.7","22.2"
"Houston","2021-01-19","477","56009","107","7219","23.5","21.8"
"Houston","2021-01-20","381","56390","64","7283","22.6","21.2"
"Houston","2021-01-21","420","56810","78","7361","22.1","21.2"
"Houston","2021-01-22","309","57119","47","7408","21.1","21.2"
"Houston","2021-01-23","159","57278","39","7447","21.2","21.7"
"Houston","2021-01-24","180","57458","37","7484","20.2","21.7"
"Houston","2021-01-25","415","57873","72","7556","19.3","21.5"
"Houston","2021-01-26","412","58285","64","7620","18.4","20.9"
"Houston","2021-01-27","317","58602","53","7673","18.4","20.5"
"Houston","2021-01-28","345","58947","50","7723","17.8","20"
"Houston","2021-01-29","234","59181","31","7754","17.5","19.3"
"Houston","2021-01-30","125","59306","24","7778","16.7","19"
"Houston","2021-01-31","85","59391","19","7797","17","18.6"
"Houston","2021-02-01","274","59665","46","7843","16.9","18.1"
"Houston","2021-02-02","258","59923","29","7872","16.3","17.3"
"Houston","2021-02-03","198","60121","32","7904","16.2","17.3"
"Houston","2021-02-04","223","60344","21","7925","15.5","16.6"
"Houston","2021-02-05","110","60454","6","7931","14.4","15.9"
"Houston","2021-02-06","15","60469","1","7932","12.6","14.7"
"Houston","2021-02-07","1","60470","0","7932","9.4","13.2"
"Houston","2021-02-08","0","60470","0","7932","7","11.9"
"Irwin","2020-02-01","0","0","0","0",".","."
"Irwin","2020-02-02","0","0","0","0",".","."
"Irwin","2020-02-03","0","0","0","0",".","."
"Irwin","2020-02-04","0","0","0","0",".","."
"Irwin","2020-02-05","0","0","0","0",".","."
"Irwin","2020-02-06","0","0","0","0",".","."
"Irwin","2020-02-07","0","0","0","0","0","."
"Irwin","2020-02-08","0","0","0","0","0","."
"Irwin","2020-02-09","0","0","0","0","0","."
"Irwin","2020-02-10","0","0","0","0","0","."
"Irwin","2020-02-11","0","0","0","0","0","."
"Irwin","2020-02-12","0","0","0","0","0","."
"Irwin","2020-02-13","0","0","0","0","0","."
"Irwin","2020-02-14","0","0","0","0","0","0"
"Irwin","2020-02-15","0","0","0","0","0","0"
"Irwin","2020-02-16","0","0","0","0","0","0"
"Irwin","2020-02-17","0","0","0","0","0","0"
"Irwin","2020-02-18","0","0","0","0","0","0"
"Irwin","2020-02-19","0","0","0","0","0","0"
"Irwin","2020-02-20","0","0","0","0","0","0"
"Irwin","2020-02-21","0","0","0","0","0","0"
"Irwin","2020-02-22","0","0","0","0","0","0"
"Irwin","2020-02-23","0","0","0","0","0","0"
"Irwin","2020-02-24","0","0","0","0","0","0"
"Irwin","2020-02-25","0","0","0","0","0","0"
"Irwin","2020-02-26","0","0","0","0","0","0"
"Irwin","2020-02-27","0","0","0","0","0","0"
"Irwin","2020-02-28","0","0","0","0","0","0"
"Irwin","2020-02-29","0","0","0","0","0","0"
"Irwin","2020-03-01","0","0","0","0","0","0"
"Irwin","2020-03-02","0","0","0","0","0","0"
"Irwin","2020-03-03","0","0","0","0","0","0"
"Irwin","2020-03-04","0","0","0","0","0","0"
"Irwin","2020-03-05","0","0","0","0","0","0"
"Irwin","2020-03-06","0","0","0","0","0","0"
"Irwin","2020-03-07","0","0","0","0","0","0"
"Irwin","2020-03-08","0","0","0","0","0","0"
"Irwin","2020-03-09","0","0","0","0","0","0"
"Irwin","2020-03-10","0","0","0","0","0","0"
"Irwin","2020-03-11","1","1","0","0","0","0"
"Irwin","2020-03-12","1","2","0","0","0","0"
"Irwin","2020-03-13","0","2","0","0","0","0"
"Irwin","2020-03-14","0","2","0","0","0","0"
"Irwin","2020-03-15","0","2","0","0","0","0"
"Irwin","2020-03-16","1","3","0","0","0","0"
"Irwin","2020-03-17","2","5","0","0","0","0"
"Irwin","2020-03-18","0","5","0","0","0","0"
"Irwin","2020-03-19","5","10","1","1","2.9","1.4"
"Irwin","2020-03-20","0","10","0","1","2.9","1.4"
"Irwin","2020-03-21","0","10","0","1","2.9","1.4"
"Irwin","2020-03-22","2","12","0","1","2.9","1.4"
"Irwin","2020-03-23","0","12","0","1","2.9","1.4"
"Irwin","2020-03-24","4","16","1","2","6.4","3.2"
"Irwin","2020-03-25","3","19","2","4","16","8"
"Irwin","2020-03-26","3","22","0","4","13.1","8"
"Irwin","2020-03-27","1","23","1","5","27.4","15.1"
"Irwin","2020-03-28","0","23","0","5","27.4","15.1"
"Irwin","2020-03-29","0","23","0","5","27.4","15.1"
"Irwin","2020-03-30","3","26","2","7","36.9","19.9"
"Irwin","2020-03-31","3","29","0","7","33.3","19.9"
"Irwin","2020-04-01","1","30","1","8","38.1","27"
"Irwin","2020-04-02","3","33","0","8","38.1","25.6"
"Irwin","2020-04-03","1","34","0","8","23.8","25.6"
"Irwin","2020-04-04","0","34","0","8","23.8","25.6"
"Irwin","2020-04-05","2","36","0","8","23.8","25.6"
"Irwin","2020-04-06","3","39","0","8","14.3","25.6"
"Irwin","2020-04-07","8","47","1","9","16.1","24.7"
"Irwin","2020-04-08","3","50","0","9","1.8","19.9"
"Irwin","2020-04-09","4","54","0","9","1.8","19.9"
"Irwin","2020-04-10","2","56","0","9","1.8","12.8"
"Irwin","2020-04-11","2","58","0","9","1.8","12.8"
"Irwin","2020-04-12","1","59","0","9","1.8","12.8"
"Irwin","2020-04-13","2","61","0","9","1.8","8"
"Irwin","2020-04-14","1","62","0","9","0","8"
"Irwin","2020-04-15","3","65","2","11","9.5","5.7"
"Irwin","2020-04-16","6","71","2","13","14.3","8"
"Irwin","2020-04-17","5","76","2","15","20","10.9"
"Irwin","2020-04-18","2","78","0","15","20","10.9"
"Irwin","2020-04-19","2","80","0","15","20","10.9"
"Irwin","2020-04-20","2","82","0","15","20","10.9"
"Irwin","2020-04-21","0","82","0","15","20","10"
"Irwin","2020-04-22","1","83","0","15","10.5","10"
"Irwin","2020-04-23","1","84","1","16","20","17.1"
"Irwin","2020-04-24","2","86","0","16","14.3","17.1"
"Irwin","2020-04-25","1","87","0","16","14.3","17.1"
"Irwin","2020-04-26","0","87","0","16","14.3","17.1"
"Irwin","2020-04-27","4","91","1","17","17.9","18.9"
"Irwin","2020-04-28","4","95","1","18","21.4","20.7"
"Irwin","2020-04-29","2","97","1","19","28.6","19.5"
"Irwin","2020-04-30","2","99","0","19","14.3","17.1"
"Irwin","2020-05-01","3","102","2","21","23.8","19"
"Irwin","2020-05-02","1","103","0","21","23.8","19"
"Irwin","2020-05-03","0","103","0","21","23.8","19"
"Irwin","2020-05-04","4","107","0","21","20.2","19"
"Irwin","2020-05-05","11","118","1","22","18","19.7"
"Irwin","2020-05-06","16","134","0","22","10.8","19.7"
"Irwin","2020-05-07","5","139","1","23","13.7","14"
"Irwin","2020-05-08","1","140","0","23","4.2","14"
"Irwin","2020-05-09","3","143","0","23","4.2","14"
"Irwin","2020-05-10","1","144","0","23","4.2","14"
"Irwin","2020-05-11","3","147","1","24","8.9","14.6"
"Irwin","2020-05-12","8","155","0","24","7.6","12.8"
"Irwin","2020-05-13","5","160","0","24","7.6","9.2"
"Irwin","2020-05-14","4","164","0","24","4.8","9.2"
"Irwin","2020-05-15","2","166","0","24","4.8","4.5"
"Irwin","2020-05-16","2","168","0","24","4.8","4.5"
"Irwin","2020-05-17","1","169","0","24","4.8","4.5"
"Irwin","2020-05-18","5","174","1","25","2.9","5.9"
"Irwin","2020-05-19","18","192","1","26","3.7","5.6"
"Irwin","2020-05-20","7","199","1","27","5.7","6.7"
"Irwin","2020-05-21","3","202","0","27","5.7","5.2"
"Irwin","2020-05-22","3","205","1","28","10.5","7.6"
"Irwin","2020-05-23","2","207","0","28","10.5","7.6"
"Irwin","2020-05-24","0","207","0","28","10.5","7.6"
"Irwin","2020-05-25","1","208","0","28","7.6","5.2"
"Irwin","2020-05-26","13","221","0","28","6.8","5.2"
"Irwin","2020-05-27","5","226","2","30","10.5","8.1"
"Irwin","2020-05-28","1","227","1","31","24.8","15.2"
"Irwin","2020-05-29","0","227","0","31","20","15.2"
"Irwin","2020-05-30","0","227","0","31","20","15.2"
"Irwin","2020-05-31","4","231","0","31","20","15.2"
"Irwin","2020-06-01","4","235","1","32","23.6","15.6"
"Irwin","2020-06-02","15","250","1","33","24.5","15.7"
"Irwin","2020-06-03","17","267","1","34","19.6","15.1"
"Irwin","2020-06-04","7","274","1","35","7.4","16.1"
"Irwin","2020-06-05","14","288","1","36","8.4","14.2"
"Irwin","2020-06-06","1","289","0","36","8.4","14.2"
"Irwin","2020-06-07","2","291","0","36","8.4","14.2"
"Irwin","2020-06-08","7","298","0","36","4.9","14.2"
"Irwin","2020-06-09","18","316","0","36","3.9","14.2"
"Irwin","2020-06-10","13","329","3","39","6.4","13"
"Irwin","2020-06-11","5","334","3","42","12.9","10.1"
"Irwin","2020-06-12","12","346","2","44","14.2","11.3"
"Irwin","2020-06-13","0","346","0","44","14.2","11.3"
"Irwin","2020-06-14","0","346","0","44","14.2","11.3"
"Irwin","2020-06-15","9","355","0","44","14.2","9.6"
"Irwin","2020-06-16","39","394","1","45","14.6","9.3"
"Irwin","2020-06-17","25","419","1","46","11.9","9.1"
"Irwin","2020-06-18","3","422","0","46","3.3","8.1"
"Irwin","2020-06-19","7","429","0","46","0.9","7.6"
"Irwin","2020-06-20","2","431","0","46","0.9","7.6"
"Irwin","2020-06-21","1","432","0","46","0.9","7.6"
"Irwin","2020-06-22","12","444","0","46","0.9","7.6"
"Irwin","2020-06-23","30","474","4","50","2.5","8.5"
"Irwin","2020-06-24","30","504","3","53","3.3","7.6"
"Irwin","2020-06-25","2","506","0","53","3.3","3.3"
"Irwin","2020-06-26","21","527","6","59","7.4","4.2"
"Irwin","2020-06-27","6","533","0","59","7.4","4.2"
"Irwin","2020-06-28","1","534","0","59","7.4","4.2"
"Irwin","2020-06-29","94","628","9","68","8.8","4.9"
"Irwin","2020-06-30","62","690","6","74","8.3","5.4"
"Irwin","2020-07-01","26","716","3","77","8.5","5.9"
"Irwin","2020-07-02","9","725","2","79","11.7","7.5"
"Irwin","2020-07-03","4","729","1","80","11.1","9.3"
"Irwin","2020-07-04","5","734","3","83","19.7","13.6"
"Irwin","2020-07-05","3","737","1","84","24.5","15.9"
"Irwin","2020-07-06","25","762","3","87","24.8","16.8"
"Irwin","2020-07-07","91","853","19","106","26.4","17.3"
"Irwin","2020-07-08","18","871","2","108","26.4","17.4"
"Irwin","2020-07-09","13","884","4","112","27.6","19.6"
"Irwin","2020-07-10","9","893","1","113","25.6","18.4"
"Irwin","2020-07-11","3","896","0","113","17","18.4"
"Irwin","2020-07-12","2","898","1","114","19.4","21.9"
"Irwin","2020-07-13","59","957","2","116","18.2","21.5"
"Irwin","2020-07-14","32","989","1","117","15.6","21"
"Irwin","2020-07-15","27","1016","2","119","15.1","20.7"
"Irwin","2020-07-16","10","1026","0","119","10.7","19.2"
"Irwin","2020-07-17","15","1041","3","122","12","18.8"
"Irwin","2020-07-18","2","1043","1","123","19.1","18.1"
"Irwin","2020-07-19","2","1045","0","123","12","15.7"
"Irwin","2020-07-20","12","1057","3","126","15.1","16.6"
"Irwin","2020-07-21","54","1111","8","134","16.7","16.2"
"Irwin","2020-07-22","12","1123","2","136","18.1","16.6"
"Irwin","2020-07-23","17","1140","3","139","20.6","15.7"
"Irwin","2020-07-24","20","1160","6","145","22","17"
"Irwin","2020-07-25","2","1162","1","146","22","20.6"
"Irwin","2020-07-26","3","1165","0","146","22","17"
"Irwin","2020-07-27","28","1193","6","152","21.5","18.3"
"Irwin","2020-07-28","20","1213","5","157","23","19.9"
"Irwin","2020-07-29","10","1223","3","160","24.9","21.5"
"Irwin","2020-07-30","21","1244","3","163","24.4","22.5"
"Irwin","2020-07-31","17","1261","2","165","21.8","21.9"
"Irwin","2020-08-01","3","1264","0","165","14.6","18.3"
"Irwin","2020-08-02","3","1267","0","165","14.6","18.3"
"Irwin","2020-08-03","90","1357","2","167","11.9","16.7"
"Irwin","2020-08-04","22","1379","2","169","9.6","16.3"
"Irwin","2020-08-05","23","1402","2","171","6.6","15.7"
"Irwin","2020-08-06","23","1425","0","171","4.5","14.5"
"Irwin","2020-08-07","24","1449","1","172","3.5","12.6"
"Irwin","2020-08-08","6","1455","0","172","3.5","9"
"Irwin","2020-08-09","3","1458","0","172","3.5","9"
"Irwin","2020-08-10","42","1500","7","179","5.5","8.7"
"Irwin","2020-08-11","18","1518","7","186","9.8","9.7"
"Irwin","2020-08-12","78","1596","4","190","9.3","7.9"
"Irwin","2020-08-13","10","1606","1","191","10.7","7.6"
"Irwin","2020-08-14","31","1637","0","191","10.1","6.8"
"Irwin","2020-08-15","16","1653","1","192","11","7.2"
"Irwin","2020-08-16","3","1656","0","192","11","7.2"
"Irwin","2020-08-17","10","1666","1","193","10","7.8"
"Irwin","2020-08-18","14","1680","0","193","4.5","7.1"
"Irwin","2020-08-19","60","1740","0","193","3.8","6.5"
"Irwin","2020-08-20","391","2131","7","200","2.6","6.6"
"Irwin","2020-08-21","85","2216","3","203","3.1","6.6"
"Irwin","2020-08-22","3","2219","0","203","2.2","6.6"
"Irwin","2020-08-23","2","2221","0","203","2.2","6.6"
"Irwin","2020-08-24","36","2257","4","207","2.3","6.2"
"Irwin","2020-08-25","30","2287","1","208","2.8","3.7"
"Irwin","2020-08-26","26","2313","0","208","2.8","3.3"
"Irwin","2020-08-27","27","2340","2","210","3.6","3.1"
"Irwin","2020-08-28","23","2363","1","211","3.7","3.4"
"Irwin","2020-08-29","24","2387","0","211","3.7","3"
"Irwin","2020-08-30","4","2391","0","211","3.7","3"
"Irwin","2020-08-31","60","2451","2","213","2.6","2.5"
"Irwin","2020-09-01","10","2461","0","213","2.2","2.5"
"Irwin","2020-09-02","27","2488","3","216","3.7","3.3"
"Irwin","2020-09-03","21","2509","1","217","3.4","3.5"
"Irwin","2020-09-04","83","2592","4","221","3.4","3.6"
"Irwin","2020-09-05","10","2602","1","222","4.9","4.3"
"Irwin","2020-09-06","1","2603","0","222","4.9","4.3"
"Irwin","2020-09-07","2","2605","0","222","4.4","3.5"
"Irwin","2020-09-08","27","2632","2","224","5.4","3.8"
"Irwin","2020-09-09","23","2655","0","224","3.9","3.8"
"Irwin","2020-09-10","10","2665","1","225","4.6","4"
"Irwin","2020-09-11","104","2769","14","239","5.8","4.6"
"Irwin","2020-09-12","7","2776","0","239","4.4","4.6"
"Irwin","2020-09-13","4","2780","2","241","11.6","8.2"
"Irwin","2020-09-14","16","2796","2","243","13.3","8.9"
"Irwin","2020-09-15","34","2830","1","244","12.7","9.1"
"Irwin","2020-09-16","26","2856","2","246","13.8","8.8"
"Irwin","2020-09-17","38","2894","6","252","14.6","9.6"
"Irwin","2020-09-18","12","2906","3","255","16.3","11.1"
"Irwin","2020-09-19","6","2912","2","257","21","12.7"
"Irwin","2020-09-20","2","2914","0","257","13.9","12.7"
"Irwin","2020-09-21","28","2942","0","257","12.1","12.7"
"Irwin","2020-09-22","29","2971","1","258","12.2","12.4"
"Irwin","2020-09-23","37","3008","4","262","12.6","13.2"
"Irwin","2020-09-24","28","3036","1","263","10.9","12.8"
"Irwin","2020-09-25","32","3068","2","265","8.2","12.2"
"Irwin","2020-09-26","2","3070","0","265","3.4","12.2"
"Irwin","2020-09-27","0","3070","0","265","3.4","8.7"
"Irwin","2020-09-28","11","3081","3","268","7.3","9.7"
"Irwin","2020-09-29","28","3109","6","274","9.9","11"
"Irwin","2020-09-30","27","3136","2","276","9.4","11"
"Irwin","2020-10-01","30","3166","5","281","11.3","11.1"
"Irwin","2020-10-02","18","3184","0","281","10.4","9.3"
"Irwin","2020-10-03","5","3189","1","282","13.3","8.3"
"Irwin","2020-10-04","5","3194","1","283","16.1","9.8"
"Irwin","2020-10-05","15","3209","2","285","14.1","10.7"
"Irwin","2020-10-06","4","3213","0","285","11.1","10.5"
"Irwin","2020-10-07","22","3235","0","285","10","9.7"
"Irwin","2020-10-08","28","3263","3","288","9.1","10.2"
"Irwin","2020-10-09","11","3274","2","290","11.7","11.1"
"Irwin","2020-10-10","1","3275","0","290","8.9","11.1"
"Irwin","2020-10-11","4","3279","1","291","9.6","12.9"
"Irwin","2020-10-12","5","3284","0","291","7.7","10.9"
"Irwin","2020-10-13","33","3317","1","292","8.1","9.6"
"Irwin","2020-10-14","19","3336","2","294","9.6","9.8"
"Irwin","2020-10-15","25","3361","1","295","8.7","8.9"
"Irwin","2020-10-16","8","3369","0","295","6.1","8.9"
"Irwin","2020-10-17","1","3370","0","295","6.1","7.5"
"Irwin","2020-10-18","4","3374","0","295","2.5","6.1"
"Irwin","2020-10-19","11","3385","1","296","3.8","5.8"
"Irwin","2020-10-20","15","3400","0","296","3.4","5.8"
"Irwin","2020-10-21","42","3442","2","298","2.6","6.1"
"Irwin","2020-10-22","12","3454","0","298","2","5.3"
"Irwin","2020-10-23","13","3467","2","300","4.2","5.1"
"Irwin","2020-10-24","21","3488","1","301","4.9","5.5"
"Irwin","2020-10-25","1","3489","0","301","4.9","3.7"
"Irwin","2020-10-26","24","3513","2","303","4.7","4.3"
"Irwin","2020-10-27","21","3534","1","304","5.4","4.4"
"Irwin","2020-10-28","25","3559","2","306","5.9","4.2"
"Irwin","2020-10-29","6","3565","1","307","8.3","5.1"
"Irwin","2020-10-30","18","3583","1","308","6.9","5.5"
"Irwin","2020-10-31","3","3586","0","308","6.2","5.5"
"Irwin","2020-11-01","4","3590","1","309","9.8","7.3"
"Irwin","2020-11-02","36","3626","4","313","10.2","7.5"
"Irwin","2020-11-03","32","3658","2","315","10.4","7.9"
"Irwin","2020-11-04","40","3698","1","316","9.6","7.7"
"Irwin","2020-11-05","33","3731","1","317","7.6","8"
"Irwin","2020-11-06","15","3746","0","317","6.8","6.9"
"Irwin","2020-11-07","2","3748","0","317","6.8","6.5"
"Irwin","2020-11-08","2","3750","0","317","3.3","6.5"
"Irwin","2020-11-09","21","3771","4","321","4.4","7.3"
"Irwin","2020-11-10","35","3806","4","325","5.1","7.8"
"Irwin","2020-11-11","14","3820","1","326","5.8","7.7"
"Irwin","2020-11-12","30","3850","1","327","5.9","6.7"
"Irwin","2020-11-13","12","3862","2","329","8.2","7.5"
"Irwin","2020-11-14","6","3868","1","330","10.6","8.7"
"Irwin","2020-11-15","1","3869","0","330","10.6","6.9"
"Irwin","2020-11-16","32","3901","5","335","10.1","7.3"
"Irwin","2020-11-17","33","3934","3","338","9.8","7.5"
"Irwin","2020-11-18","4","3938","0","338","8.8","7.3"
"Irwin","2020-11-19","28","3966","1","339","8.8","7.3"
"Irwin","2020-11-20","42","4008","1","340","6.8","7.5"
"Irwin","2020-11-21","5","4013","2","342","10.1","10.4"
"Irwin","2020-11-22","8","4021","1","343","11.9","11.2"
"Irwin","2020-11-23","32","4053","4","347","11.4","10.8"
"Irwin","2020-11-24","14","4067","1","348","11.2","10.5"
"Irwin","2020-11-25","11","4078","1","349","12.5","10.6"
"Irwin","2020-11-26","4","4082","0","349","11.9","10.4"
"Irwin","2020-11-27","6","4088","0","349","11.6","9.2"
"Irwin","2020-11-28","3","4091","0","349","5.9","8"
"Irwin","2020-11-29","6","4097","1","350","6.5","9.2"
"Irwin","2020-11-30","28","4125","5","355","7.3","9.3"
"Irwin","2020-12-01","14","4139","1","356","7.3","9.2"
"Irwin","2020-12-02","10","4149","0","356","6","9.2"
"Irwin","2020-12-03","13","4162","5","361","11.4","11.7"
"Irwin","2020-12-04","14","4176","1","362","12.5","12"
"Irwin","2020-12-05","6","4182","3","365","19.6","12.8"
"Irwin","2020-12-06","4","4186","1","366","20.8","13.6"
"Irwin","2020-12-07","43","4229","7","373","20.6","13.9"
"Irwin","2020-12-08","23","4252","6","379","23.3","15.3"
"Irwin","2020-12-09","19","4271","3","382","25.5","15.7"
"Irwin","2020-12-10","12","4283","0","382","20","15.7"
"Irwin","2020-12-11","12","4295","4","386","23.8","18.1"
"Irwin","2020-12-12","7","4302","1","387","18.7","19.1"
"Irwin","2020-12-13","8","4310","3","390","20.5","20.6"
"Irwin","2020-12-14","49","4359","12","402","21.6","21.1"
"Irwin","2020-12-15","13","4372","2","404","20.1","21.7"
"Irwin","2020-12-16","10","4382","4","408","23.6","24.6"
"Irwin","2020-12-17","27","4409","9","417","28.3","24.2"
"Irwin","2020-12-18","8","4417","3","420","28.9","26.4"
"Irwin","2020-12-19","5","4422","3","423","35.5","27.1"
"Irwin","2020-12-20","9","4431","1","424","31.7","26.1"
"Irwin","2020-12-21","58","4489","13","437","31.4","26.5"
"Irwin","2020-12-22","16","4505","4","441","32.8","26.4"
"Irwin","2020-12-23","12","4517","2","443","29.4","26.5"
"Irwin","2020-12-24","10","4527","4","447","30.4","29.4"
"Irwin","2020-12-25","1","4528","1","448","39.3","34.1"
"Irwin","2020-12-26","5","4533","2","450","36.5","36"
"Irwin","2020-12-27","2","4535","1","451","42","36.8"
"Irwin","2020-12-28","79","4614","17","468","41.9","36.6"
"Irwin","2020-12-29","11","4625","2","470","40.9","36.8"
"Irwin","2020-12-30","45","4670","13","483","42.7","36"
"Irwin","2020-12-31","10","4680","3","486","41.2","35.8"
"Irwin","2021-01-01","4","4684","0","486","26.9","33.1"
"Irwin","2021-01-02","4","4688","0","486","21.2","28.8"
"Irwin","2021-01-03","5","4693","1","487","16.9","29.5"
"Irwin","2021-01-04","43","4736","10","497","17.2","29.5"
"Irwin","2021-01-05","15","4751","1","498","15.5","28.2"
"Irwin","2021-01-06","14","4765","0","498","11.4","27"
"Irwin","2021-01-07","25","4790","2","500","8.3","24.8"
"Irwin","2021-01-08","11","4801","2","502","10.9","18.9"
"Irwin","2021-01-09","5","4806","2","504","16.6","18.9"
"Irwin","2021-01-10","3","4809","3","507","28","22.5"
"Irwin","2021-01-11","32","4841","6","513","27.4","22.3"
"Irwin","2021-01-12","10","4851","3","516","30.7","23.1"
"Irwin","2021-01-13","28","4879","4","520","32.7","22.1"
"Irwin","2021-01-14","8","4887","0","520","31.6","19.9"
"Irwin","2021-01-15","10","4897","1","521","30.4","20.7"
"Irwin","2021-01-16","5","4902","2","523","30.4","23.5"
"Irwin","2021-01-17","2","4904","1","524","23.3","25.7"
"Irwin","2021-01-18","6","4910","0","524","20.6","24"
"Irwin","2021-01-19","6","4916","1","525","18.7","24.7"
"Irwin","2021-01-20","10","4926","1","526","18.1","25.4"
"Irwin","2021-01-21","10","4936","1","527","19.5","25.6"
"Irwin","2021-01-22","6","4942","2","529","22.9","26.6"
"Irwin","2021-01-23","2","4944","1","530","24.3","27.4"
"Irwin","2021-01-24","8","4952","4","534","24.3","23.8"
"Irwin","2021-01-25","9","4961","1","535","25.9","23.2"
"Irwin","2021-01-26","5","4966","2","537","29.2","24"
"Irwin","2021-01-27","11","4977","4","541","33","25.5"
"Irwin","2021-01-28","8","4985","1","542","33.3","26.4"
"Irwin","2021-01-29","3","4988","2","544","38.1","30.5"
"Irwin","2021-01-30","2","4990","0","544","30.9","27.6"
"Irwin","2021-01-31","1","4991","1","545","38.1","31.2"
"Irwin","2021-02-01","5","4996","0","545","36.5","31.2"
"Irwin","2021-02-02","6","5002","0","545","30.8","30"
"Irwin","2021-02-03","8","5010","0","545","25.6","29.3"
"Irwin","2021-02-04","4","5014","0","545","23.8","28.6"
"Irwin","2021-02-05","4","5018","0","545","14.3","26.2"
"Irwin","2021-02-06","2","5020","0","545","14.3","22.6"
"Irwin","2021-02-07","1","5021","0","545","0","19"
"Irwin","2021-02-08","0","5021","0","545","0","18.3"
"Jackson","2020-02-01","0","0","0","0",".","."
"Jackson","2020-02-02","0","0","0","0",".","."
"Jackson","2020-02-03","0","0","0","0",".","."
"Jackson","2020-02-04","0","0","0","0",".","."
"Jackson","2020-02-05","0","0","0","0",".","."
"Jackson","2020-02-06","0","0","0","0",".","."
"Jackson","2020-02-07","0","0","0","0","0","."
"Jackson","2020-02-08","0","0","0","0","0","."
"Jackson","2020-02-09","0","0","0","0","0","."
"Jackson","2020-02-10","0","0","0","0","0","."
"Jackson","2020-02-11","0","0","0","0","0","."
"Jackson","2020-02-12","0","0","0","0","0","."
"Jackson","2020-02-13","0","0","0","0","0","."
"Jackson","2020-02-14","0","0","0","0","0","0"
"Jackson","2020-02-15","0","0","0","0","0","0"
"Jackson","2020-02-16","0","0","0","0","0","0"
"Jackson","2020-02-17","0","0","0","0","0","0"
"Jackson","2020-02-18","0","0","0","0","0","0"
"Jackson","2020-02-19","0","0","0","0","0","0"
"Jackson","2020-02-20","0","0","0","0","0","0"
"Jackson","2020-02-21","0","0","0","0","0","0"
"Jackson","2020-02-22","0","0","0","0","0","0"
"Jackson","2020-02-23","0","0","0","0","0","0"
"Jackson","2020-02-24","0","0","0","0","0","0"
"Jackson","2020-02-25","0","0","0","0","0","0"
"Jackson","2020-02-26","0","0","0","0","0","0"
"Jackson","2020-02-27","0","0","0","0","0","0"
"Jackson","2020-02-28","0","0","0","0","0","0"
"Jackson","2020-02-29","0","0","0","0","0","0"
"Jackson","2020-03-01","0","0","0","0","0","0"
"Jackson","2020-03-02","0","0","0","0","0","0"
"Jackson","2020-03-03","0","0","0","0","0","0"
"Jackson","2020-03-04","0","0","0","0","0","0"
"Jackson","2020-03-05","0","0","0","0","0","0"
"Jackson","2020-03-06","0","0","0","0","0","0"
"Jackson","2020-03-07","0","0","0","0","0","0"
"Jackson","2020-03-08","0","0","0","0","0","0"
"Jackson","2020-03-09","0","0","0","0","0","0"
"Jackson","2020-03-10","0","0","0","0","0","0"
"Jackson","2020-03-11","1","1","0","0","0","0"
"Jackson","2020-03-12","2","3","0","0","0","0"
"Jackson","2020-03-13","3","6","0","0","0","0"
"Jackson","2020-03-14","3","9","0","0","0","0"
"Jackson","2020-03-15","1","10","0","0","0","0"
"Jackson","2020-03-16","7","17","0","0","0","0"
"Jackson","2020-03-17","15","32","0","0","0","0"
"Jackson","2020-03-18","21","53","0","0","0","0"
"Jackson","2020-03-19","21","74","1","1","0.7","0.3"
"Jackson","2020-03-20","10","84","2","3","3.5","1.8"
"Jackson","2020-03-21","13","97","0","3","3.5","1.8"
"Jackson","2020-03-22","6","103","0","3","3.5","1.8"
"Jackson","2020-03-23","23","126","1","4","4.2","2.1"
"Jackson","2020-03-24","23","149","1","5","4.8","2.4"
"Jackson","2020-03-25","18","167","1","6","5.6","2.8"
"Jackson","2020-03-26","19","186","3","9","7.1","3.9"
"Jackson","2020-03-27","5","191","2","11","10","6.8"
"Jackson","2020-03-28","4","195","2","13","17.1","10.3"
"Jackson","2020-03-29","3","198","1","14","21.9","12.7"
"Jackson","2020-03-30","12","210","0","14","21.3","12.7"
"Jackson","2020-03-31","6","216","0","14","20.7","12.7"
"Jackson","2020-04-01","14","230","0","14","19.9","12.7"
"Jackson","2020-04-02","11","241","0","14","17.6","12.4"
"Jackson","2020-04-03","11","252","2","16","14.5","12.3"
"Jackson","2020-04-04","1","253","0","16","7.4","12.3"
"Jackson","2020-04-05","2","255","0","16","2.6","12.3"
"Jackson","2020-04-06","11","266","1","17","3.9","12.6"
"Jackson","2020-04-07","5","271","1","18","6.8","13.7"
"Jackson","2020-04-08","12","283","0","18","6.8","13.3"
"Jackson","2020-04-09","11","294","0","18","6.8","12.2"
"Jackson","2020-04-10","10","304","1","19","5.6","10"
"Jackson","2020-04-11","7","311","0","19","5.6","6.5"
"Jackson","2020-04-12","1","312","0","19","5.6","4.1"
"Jackson","2020-04-13","21","333","1","20","5","4.4"
"Jackson","2020-04-14","18","351","0","20","2.1","4.4"
"Jackson","2020-04-15","15","366","1","21","3.1","4.9"
"Jackson","2020-04-16","26","392","5","26","5.8","6.3"
"Jackson","2020-04-17","23","415","0","26","4.4","5"
"Jackson","2020-04-18","16","431","2","28","6.2","5.9"
"Jackson","2020-04-19","2","433","0","28","6.2","5.9"
"Jackson","2020-04-20","33","466","3","31","6.8","5.9"
"Jackson","2020-04-21","27","493","8","39","11","6.6"
"Jackson","2020-04-22","23","516","2","41","11.3","7.2"
"Jackson","2020-04-23","19","535","2","43","10.1","7.9"
"Jackson","2020-04-24","29","564","0","43","10.1","7.2"
"Jackson","2020-04-25","20","584","0","43","8.3","7.2"
"Jackson","2020-04-26","7","591","0","43","8.3","7.2"
"Jackson","2020-04-27","13","604","1","44","8.1","7.4"
"Jackson","2020-04-28","32","636","5","49","6.1","8.5"
"Jackson","2020-04-29","36","672","2","51","5.6","8.5"
"Jackson","2020-04-30","30","702","2","53","5.1","7.6"
"Jackson","2020-05-01","33","735","3","56","6.4","8.2"
"Jackson","2020-05-02","13","748","3","59","9.7","9"
"Jackson","2020-05-03","16","764","0","59","9.7","9"
"Jackson","2020-05-04","32","796","0","59","8.6","8.3"
"Jackson","2020-05-05","30","826","1","60","6.8","6.4"
"Jackson","2020-05-06","23","849","1","61","6.6","6.1"
"Jackson","2020-05-07","24","873","2","63","6.9","6"
"Jackson","2020-05-08","27","900","0","63","5.6","6"
"Jackson","2020-05-09","4","904","0","63","2.3","6"
"Jackson","2020-05-10","11","915","0","63","2.3","6"
"Jackson","2020-05-11","36","951","0","63","2.3","5.4"
"Jackson","2020-05-12","37","988","1","64","2.2","4.5"
"Jackson","2020-05-13","30","1018","2","66","2.5","4.6"
"Jackson","2020-05-14","36","1054","0","66","1.3","4.1"
"Jackson","2020-05-15","33","1087","2","68","2.2","3.9"
"Jackson","2020-05-16","22","1109","1","69","2.9","2.6"
"Jackson","2020-05-17","14","1123","1","70","3.9","3.1"
"Jackson","2020-05-18","47","1170","2","72","4.5","3.4"
"Jackson","2020-05-19","52","1222","3","75","4.9","3.6"
"Jackson","2020-05-20","59","1281","1","76","4.2","3.4"
"Jackson","2020-05-21","101","1382","2","78","4.5","2.9"
"Jackson","2020-05-22","158","1540","7","85","4.3","3.2"
"Jackson","2020-05-23","27","1567","1","86","4.1","3.5"
"Jackson","2020-05-24","20","1587","0","86","3.1","3.5"
"Jackson","2020-05-25","19","1606","0","86","2.5","3.5"
"Jackson","2020-05-26","49","1655","8","94","4","4.5"
"Jackson","2020-05-27","41","1696","1","95","4.1","4.2"
"Jackson","2020-05-28","47","1743","0","95","3.8","4.2"
"Jackson","2020-05-29","67","1810","4","99","4.1","4.2"
"Jackson","2020-05-30","32","1842","2","101","4.4","4.3"
"Jackson","2020-05-31","28","1870","2","103","5.4","4.3"
"Jackson","2020-06-01","82","1952","6","109","6.5","4.5"
"Jackson","2020-06-02","65","2017","4","113","5","4.5"
"Jackson","2020-06-03","60","2077","2","115","5.2","4.6"
"Jackson","2020-06-04","61","2138","3","118","5.9","4.9"
"Jackson","2020-06-05","76","2214","6","124","6.1","5.1"
"Jackson","2020-06-06","31","2245","0","124","5.3","4.8"
"Jackson","2020-06-07","23","2268","1","125","4.9","5.1"
"Jackson","2020-06-08","62","2330","5","130","5","5.7"
"Jackson","2020-06-09","60","2390","6","136","5.5","5.3"
"Jackson","2020-06-10","63","2453","6","142","6.4","5.8"
"Jackson","2020-06-11","63","2516","1","143","5.9","5.9"
"Jackson","2020-06-12","101","2617","4","147","5.4","5.7"
"Jackson","2020-06-13","32","2649","5","152","7.6","6.4"
"Jackson","2020-06-14","34","2683","2","154","7.8","6.3"
"Jackson","2020-06-15","64","2747","0","154","6.7","5.8"
"Jackson","2020-06-16","56","2803","6","160","6.8","6.1"
"Jackson","2020-06-17","46","2849","3","163","6.3","6.4"
"Jackson","2020-06-18","72","2921","7","170","7.5","6.7"
"Jackson","2020-06-19","66","2987","9","179","8.9","7.1"
"Jackson","2020-06-20","26","3013","3","182","8.3","7.9"
"Jackson","2020-06-21","31","3044","1","183","7.9","7.9"
"Jackson","2020-06-22","124","3168","13","196","9.4","8"
"Jackson","2020-06-23","84","3252","7","203","9.1","7.9"
"Jackson","2020-06-24","77","3329","5","208","9.1","7.7"
"Jackson","2020-06-25","110","3439","13","221","9.4","8.4"
"Jackson","2020-06-26","128","3567","18","239","9.4","9.1"
"Jackson","2020-06-27","71","3638","10","249","9.8","9"
"Jackson","2020-06-28","23","3661","1","250","9.9","8.9"
"Jackson","2020-06-29","194","3855","20","270","9.9","9.7"
"Jackson","2020-06-30","143","3998","21","291","10.8","9.9"
"Jackson","2020-07-01","98","4096","6","297","10.8","9.9"
"Jackson","2020-07-02","97","4193","14","311","11.1","10.3"
"Jackson","2020-07-03","72","4265","7","318","10.5","10"
"Jackson","2020-07-04","58","4323","2","320","9","9.4"
"Jackson","2020-07-05","75","4398","6","326","9.5","9.7"
"Jackson","2020-07-06","117","4515","15","341","9.9","9.9"
"Jackson","2020-07-07","199","4714","19","360","9.2","10"
"Jackson","2020-07-08","167","4881","14","374","9.5","10.1"
"Jackson","2020-07-09","137","5018","18","392","9.3","10.2"
"Jackson","2020-07-10","122","5140","12","404","9.3","9.9"
"Jackson","2020-07-11","33","5173","1","405","9.3","9.1"
"Jackson","2020-07-12","27","5200","2","407","9.2","9.3"
"Jackson","2020-07-13","104","5304","15","422","9.4","9.6"
"Jackson","2020-07-14","119","5423","19","441","10.3","9.7"
"Jackson","2020-07-15","121","5544","14","455","10.8","10.1"
"Jackson","2020-07-16","108","5652","23","478","11.9","10.6"
"Jackson","2020-07-17","98","5750","10","488","12","10.6"
"Jackson","2020-07-18","57","5807","11","499","14.3","11.8"
"Jackson","2020-07-19","63","5870","9","508","15.3","12.2"
"Jackson","2020-07-20","89","5959","9","517","14.7","12"
"Jackson","2020-07-21","92","6051","13","530","14.4","12.4"
"Jackson","2020-07-22","114","6165","7","537","13.6","12.2"
"Jackson","2020-07-23","82","6247","8","545","12","12"
"Jackson","2020-07-24","97","6344","12","557","12.3","12.1"
"Jackson","2020-07-25","60","6404","10","567","11.9","13.1"
"Jackson","2020-07-26","37","6441","8","575","13","14.1"
"Jackson","2020-07-27","132","6573","11","586","12.7","13.7"
"Jackson","2020-07-28","77","6650","9","595","12.4","13.4"
"Jackson","2020-07-29","71","6721","11","606","13.7","13.7"
"Jackson","2020-07-30","96","6817","18","624","15","13.5"
"Jackson","2020-07-31","93","6910","10","634","14.8","13.5"
"Jackson","2020-08-01","61","6971","11","645","15","13.4"
"Jackson","2020-08-02","63","7034","8","653","13.7","13.3"
"Jackson","2020-08-03","81","7115","7","660","13.7","13.2"
"Jackson","2020-08-04","102","7217","14","674","14","13.2"
"Jackson","2020-08-05","80","7297","8","682","13.2","13.5"
"Jackson","2020-08-06","86","7383","6","688","11.5","13.3"
"Jackson","2020-08-07","87","7470","2","690","10.3","12.5"
"Jackson","2020-08-08","38","7508","5","695","9.6","12.3"
"Jackson","2020-08-09","38","7546","6","701","10.1","11.9"
"Jackson","2020-08-10","115","7661","8","709","9.8","11.8"
"Jackson","2020-08-11","107","7768","12","721","9.5","11.7"
"Jackson","2020-08-12","77","7845","8","729","9.5","11.4"
"Jackson","2020-08-13","104","7949","11","740","10.1","10.8"
"Jackson","2020-08-14","92","8041","8","748","11","10.7"
"Jackson","2020-08-15","47","8088","5","753","10.6","10.1"
"Jackson","2020-08-16","62","8150","3","756","9","9.6"
"Jackson","2020-08-17","133","8283","8","764","8.9","9.4"
"Jackson","2020-08-18","157","8440","4","768","7.7","8.6"
"Jackson","2020-08-19","121","8561","12","780","7.6","8.6"
"Jackson","2020-08-20","100","8661","5","785","6.8","8.4"
"Jackson","2020-08-21","99","8760","2","787","5.9","8.4"
"Jackson","2020-08-22","64","8824","8","795","6.1","8.4"
"Jackson","2020-08-23","55","8879","7","802","7.2","8.1"
"Jackson","2020-08-24","156","9035","6","808","6.9","7.9"
"Jackson","2020-08-25","131","9166","13","821","8","7.8"
"Jackson","2020-08-26","127","9293","14","835","8.1","7.9"
"Jackson","2020-08-27","97","9390","10","845","8.9","7.9"
"Jackson","2020-08-28","126","9516","12","857","10","7.9"
"Jackson","2020-08-29","53","9569","5","862","9.5","7.8"
"Jackson","2020-08-30","41","9610","6","868","9.8","8.5"
"Jackson","2020-08-31","111","9721","6","874","10","8.5"
"Jackson","2020-09-01","128","9849","5","879","9.2","8.6"
"Jackson","2020-09-02","108","9957","5","884","8.3","8.2"
"Jackson","2020-09-03","105","10062","7","891","7.7","8.3"
"Jackson","2020-09-04","106","10168","9","900","7.6","8.8"
"Jackson","2020-09-05","48","10216","1","901","6.5","8"
"Jackson","2020-09-06","30","10246","1","902","4.9","7.4"
"Jackson","2020-09-07","46","10292","6","908","6","8"
"Jackson","2020-09-08","127","10419","20","928","7.7","8.4"
"Jackson","2020-09-09","83","10502","8","936","8.4","8.3"
"Jackson","2020-09-10","109","10611","9","945","8.7","8.2"
"Jackson","2020-09-11","97","10708","12","957","9.2","8.4"
"Jackson","2020-09-12","45","10753","9","966","11.8","9.2"
"Jackson","2020-09-13","45","10798","11","977","14.8","9.9"
"Jackson","2020-09-14","103","10901","6","983","13.8","9.9"
"Jackson","2020-09-15","100","11001","12","995","13.2","10.5"
"Jackson","2020-09-16","111","11112","6","1001","12.6","10.5"
"Jackson","2020-09-17","101","11213","8","1009","12.6","10.6"
"Jackson","2020-09-18","133","11346","8","1017","11.7","10.4"
"Jackson","2020-09-19","44","11390","2","1019","9.5","10.6"
"Jackson","2020-09-20","29","11419","3","1022","7.4","11.1"
"Jackson","2020-09-21","101","11520","8","1030","7.7","10.7"
"Jackson","2020-09-22","95","11615","8","1038","7.2","10.2"
"Jackson","2020-09-23","93","11708","5","1043","7.2","9.9"
"Jackson","2020-09-24","77","11785","5","1048","7","9.8"
"Jackson","2020-09-25","91","11876","12","1060","8","9.8"
"Jackson","2020-09-26","29","11905","4","1064","9.4","9.4"
"Jackson","2020-09-27","30","11935","2","1066","8.8","8.1"
"Jackson","2020-09-28","106","12041","6","1072","8.5","8.1"
"Jackson","2020-09-29","84","12125","3","1075","7.8","7.5"
"Jackson","2020-09-30","95","12220","6","1081","8","7.6"
"Jackson","2020-10-01","91","12311","7","1088","8.1","7.6"
"Jackson","2020-10-02","110","12421","3","1091","6.6","7.3"
"Jackson","2020-10-03","60","12481","5","1096","5.9","7.6"
"Jackson","2020-10-04","37","12518","2","1098","5.7","7.3"
"Jackson","2020-10-05","96","12614","8","1106","6.1","7.3"
"Jackson","2020-10-06","100","12714","9","1115","6.8","7.3"
"Jackson","2020-10-07","108","12822","7","1122","6.9","7.4"
"Jackson","2020-10-08","88","12910","1","1123","5.9","7"
"Jackson","2020-10-09","109","13019","6","1129","6.3","6.5"
"Jackson","2020-10-10","53","13072","7","1136","7","6.4"
"Jackson","2020-10-11","43","13115","5","1141","7.9","6.8"
"Jackson","2020-10-12","114","13229","19","1160","9.1","7.6"
"Jackson","2020-10-13","103","13332","14","1174","9.7","8.3"
"Jackson","2020-10-14","87","13419","9","1183","10.3","8.6"
"Jackson","2020-10-15","130","13549","10","1193","11.2","8.6"
"Jackson","2020-10-16","86","13635","8","1201","11.8","9"
"Jackson","2020-10-17","82","13717","9","1210","11.5","9.2"
"Jackson","2020-10-18","26","13743","4","1214","12","9.9"
"Jackson","2020-10-19","131","13874","12","1226","10.9","10"
"Jackson","2020-10-20","95","13969","6","1232","9.9","9.8"
"Jackson","2020-10-21","114","14083","18","1250","10.7","10.5"
"Jackson","2020-10-22","117","14200","6","1256","10.3","10.8"
"Jackson","2020-10-23","103","14303","8","1264","10.1","10.9"
"Jackson","2020-10-24","60","14363","5","1269","9.7","10.6"
"Jackson","2020-10-25","50","14413","7","1276","9.5","10.7"
"Jackson","2020-10-26","152","14565","22","1298","10.3","10.6"
"Jackson","2020-10-27","98","14663","6","1304","10.2","10.1"
"Jackson","2020-10-28","140","14803","34","1338","11.4","11.1"
"Jackson","2020-10-29","134","14937","15","1353","12.3","11.3"
"Jackson","2020-10-30","103","15040","13","1366","13","11.5"
"Jackson","2020-10-31","78","15118","6","1372","12.9","11.3"
"Jackson","2020-11-01","62","15180","11","1383","13.4","11.5"
"Jackson","2020-11-02","118","15298","16","1399","13.3","11.8"
"Jackson","2020-11-03","127","15425","25","1424","15.3","12.7"
"Jackson","2020-11-04","119","15544","20","1444","14.2","12.8"
"Jackson","2020-11-05","150","15694","29","1473","15.3","13.8"
"Jackson","2020-11-06","111","15805","14","1487","15.3","14.2"
"Jackson","2020-11-07","76","15881","8","1495","15.8","14.3"
"Jackson","2020-11-08","64","15945","13","1508","16.1","14.8"
"Jackson","2020-11-09","163","16108","32","1540","17","15.2"
"Jackson","2020-11-10","171","16279","25","1565","16.3","15.8"
"Jackson","2020-11-11","153","16432","16","1581","15.4","14.8"
"Jackson","2020-11-12","180","16612","12","1593","13.5","14.4"
"Jackson","2020-11-13","177","16789","18","1611","13.2","14.3"
"Jackson","2020-11-14","61","16850","12","1623","14.5","15.1"
"Jackson","2020-11-15","49","16899","9","1632","14.2","15.2"
"Jackson","2020-11-16","191","17090","37","1669","14.2","15.6"
"Jackson","2020-11-17","224","17314","14","1683","13","14.6"
"Jackson","2020-11-18","180","17494","16","1699","12.8","14.1"
"Jackson","2020-11-19","213","17707","23","1722","13.4","13.5"
"Jackson","2020-11-20","169","17876","8","1730","12.6","12.9"
"Jackson","2020-11-21","106","17982","9","1739","11","12.7"
"Jackson","2020-11-22","85","18067","11","1750","10.2","12.2"
"Jackson","2020-11-23","215","18282","27","1777","9.2","11.7"
"Jackson","2020-11-24","172","18454","23","1800","10.3","11.6"
"Jackson","2020-11-25","121","18575","19","1819","11.2","12"
"Jackson","2020-11-26","19","18594","1","1820","10.4","11.9"
"Jackson","2020-11-27","161","18755","39","1859","13.2","12.9"
"Jackson","2020-11-28","117","18872","25","1884","15.1","13"
"Jackson","2020-11-29","88","18960","26","1910","17.4","13.8"
"Jackson","2020-11-30","320","19280","59","1969","18.3","13.8"
"Jackson","2020-12-01","340","19620","54","2023","18.6","14.4"
"Jackson","2020-12-02","344","19964","49","2072","18.4","14.8"
"Jackson","2020-12-03","319","20283","40","2112","19.5","15"
"Jackson","2020-12-04","305","20588","46","2158","18.2","15.7"
"Jackson","2020-12-05","125","20713","26","2184","18.1","16.6"
"Jackson","2020-12-06","114","20827","22","2206","16.6","17"
"Jackson","2020-12-07","310","21137","69","2275","17.2","17.7"
"Jackson","2020-12-08","256","21393","53","2328","17.8","18.2"
"Jackson","2020-12-09","263","21656","49","2377","18.5","18.4"
"Jackson","2020-12-10","271","21927","59","2436","19.8","19.6"
"Jackson","2020-12-11","222","22149","47","2483","20.7","19.4"
"Jackson","2020-12-12","153","22302","48","2531","22.2","20.1"
"Jackson","2020-12-13","131","22433","38","2569","23.6","20.1"
"Jackson","2020-12-14","328","22761","89","2658","24.3","20.7"
"Jackson","2020-12-15","281","23042","63","2721","24.5","21.2"
"Jackson","2020-12-16","266","23308","65","2786","25.3","21.9"
"Jackson","2020-12-17","313","23621","76","2862","25.7","22.7"
"Jackson","2020-12-18","260","23881","61","2923","26","23.3"
"Jackson","2020-12-19","148","24029","46","2969","26","24.1"
"Jackson","2020-12-20","173","24202","59","3028","26.7","25.1"
"Jackson","2020-12-21","314","24516","74","3102","26.2","25.2"
"Jackson","2020-12-22","354","24870","80","3182","26.2","25.4"
"Jackson","2020-12-23","278","25148","72","3254","26.4","25.9"
"Jackson","2020-12-24","167","25315","45","3299","26.8","26.2"
"Jackson","2020-12-25","34","25349","12","3311","28.5","27.3"
"Jackson","2020-12-26","199","25548","78","3389","29.7","27.8"
"Jackson","2020-12-27","134","25682","38","3427","28.8","27.8"
"Jackson","2020-12-28","287","25969","89","3516","29.9","28"
"Jackson","2020-12-29","325","26294","93","3609","30.8","28.5"
"Jackson","2020-12-30","315","26609","97","3706","31.5","28.9"
"Jackson","2020-12-31","225","26834","80","3786","32.7","29.7"
"Jackson","2021-01-01","97","26931","35","3821","32.8","30.7"
"Jackson","2021-01-02","98","27029","34","3855","32.2","30.9"
"Jackson","2021-01-03","116","27145","39","3894","32.9","30.9"
"Jackson","2021-01-04","339","27484","103","3997","32.8","31.4"
"Jackson","2021-01-05","377","27861","114","4111","33.1","31.9"
"Jackson","2021-01-06","421","28282","113","4224","32.5","32"
"Jackson","2021-01-07","360","28642","90","4314","31","31.8"
"Jackson","2021-01-08","321","28963","81","4395","29.4","31.1"
"Jackson","2021-01-09","143","29106","38","4433","28.3","30.2"
"Jackson","2021-01-10","118","29224","30","4463","27.1","30"
"Jackson","2021-01-11","304","29528","88","4551","26.9","29.9"
"Jackson","2021-01-12","276","29804","59","4610","25.6","29.3"
"Jackson","2021-01-13","318","30122","66","4676","24.8","28.6"
"Jackson","2021-01-14","283","30405","61","4737","24.3","27.6"
"Jackson","2021-01-15","238","30643","52","4789","23.8","26.6"
"Jackson","2021-01-16","140","30783","24","4813","22.4","25.4"
"Jackson","2021-01-17","143","30926","41","4854","22.9","25"
"Jackson","2021-01-18","208","31134","53","4907","22.4","24.6"
"Jackson","2021-01-19","253","31387","47","4954","22","23.8"
"Jackson","2021-01-20","281","31668","54","5008","21.8","23.3"
"Jackson","2021-01-21","265","31933","41","5049","20.9","22.6"
"Jackson","2021-01-22","195","32128","26","5075","19.7","21.7"
"Jackson","2021-01-23","134","32262","32","5107","20.7","21.5"
"Jackson","2021-01-24","128","32390","19","5126","18.7","20.8"
"Jackson","2021-01-25","253","32643","43","5169","17.5","19.9"
"Jackson","2021-01-26","246","32889","49","5218","17.7","19.8"
"Jackson","2021-01-27","223","33112","35","5253","17.2","19.5"
"Jackson","2021-01-28","204","33316","30","5283","17.1","19"
"Jackson","2021-01-29","183","33499","28","5311","17.3","18.5"
"Jackson","2021-01-30","98","33597","28","5339","18","19.3"
"Jackson","2021-01-31","95","33692","15","5354","18.1","18.4"
"Jackson","2021-02-01","211","33903","31","5385","17.8","17.6"
"Jackson","2021-02-02","194","34097","17","5402","16.2","16.9"
"Jackson","2021-02-03","212","34309","27","5429","15.8","16.5"
"Jackson","2021-02-04","217","34526","28","5457","15.5","16.3"
"Jackson","2021-02-05","122","34648","18","5475","15.5","16.4"
"Jackson","2021-02-06","22","34670","4","5479","14","16"
"Jackson","2021-02-07","3","34673","1","5480","16.5","17.3"
"Jackson","2021-02-08","0","34673","0","5480","14.4","16.1"
"Jasper","2020-02-01","0","0","0","0",".","."
"Jasper","2020-02-02","0","0","0","0",".","."
"Jasper","2020-02-03","0","0","0","0",".","."
"Jasper","2020-02-04","0","0","0","0",".","."
"Jasper","2020-02-05","0","0","0","0",".","."
"Jasper","2020-02-06","0","0","0","0",".","."
"Jasper","2020-02-07","0","0","0","0","0","."
"Jasper","2020-02-08","0","0","0","0","0","."
"Jasper","2020-02-09","0","0","0","0","0","."
"Jasper","2020-02-10","0","0","0","0","0","."
"Jasper","2020-02-11","0","0","0","0","0","."
"Jasper","2020-02-12","0","0","0","0","0","."
"Jasper","2020-02-13","0","0","0","0","0","."
"Jasper","2020-02-14","0","0","0","0","0","0"
"Jasper","2020-02-15","0","0","0","0","0","0"
"Jasper","2020-02-16","0","0","0","0","0","0"
"Jasper","2020-02-17","0","0","0","0","0","0"
"Jasper","2020-02-18","0","0","0","0","0","0"
"Jasper","2020-02-19","0","0","0","0","0","0"
"Jasper","2020-02-20","0","0","0","0","0","0"
"Jasper","2020-02-21","0","0","0","0","0","0"
"Jasper","2020-02-22","0","0","0","0","0","0"
"Jasper","2020-02-23","0","0","0","0","0","0"
"Jasper","2020-02-24","0","0","0","0","0","0"
"Jasper","2020-02-25","0","0","0","0","0","0"
"Jasper","2020-02-26","0","0","0","0","0","0"
"Jasper","2020-02-27","0","0","0","0","0","0"
"Jasper","2020-02-28","0","0","0","0","0","0"
"Jasper","2020-02-29","0","0","0","0","0","0"
"Jasper","2020-03-01","0","0","0","0","0","0"
"Jasper","2020-03-02","0","0","0","0","0","0"
"Jasper","2020-03-03","0","0","0","0","0","0"
"Jasper","2020-03-04","0","0","0","0","0","0"
"Jasper","2020-03-05","0","0","0","0","0","0"
"Jasper","2020-03-06","0","0","0","0","0","0"
"Jasper","2020-03-07","0","0","0","0","0","0"
"Jasper","2020-03-08","0","0","0","0","0","0"
"Jasper","2020-03-09","2","2","1","1","7.1","3.6"
"Jasper","2020-03-10","1","3","0","1","7.1","3.6"
"Jasper","2020-03-11","0","3","0","1","7.1","3.6"
"Jasper","2020-03-12","0","3","0","1","7.1","3.6"
"Jasper","2020-03-13","0","3","0","1","7.1","3.6"
"Jasper","2020-03-14","0","3","0","1","7.1","3.6"
"Jasper","2020-03-15","0","3","0","1","7.1","3.6"
"Jasper","2020-03-16","3","6","1","2","4.8","6"
"Jasper","2020-03-17","1","7","0","2","4.8","6"
"Jasper","2020-03-18","4","11","0","2","4.8","6"
"Jasper","2020-03-19","2","13","0","2","4.8","6"
"Jasper","2020-03-20","3","16","0","2","4.8","6"
"Jasper","2020-03-21","0","16","0","2","4.8","6"
"Jasper","2020-03-22","2","18","1","3","11.9","9.5"
"Jasper","2020-03-23","1","19","0","3","7.1","6"
"Jasper","2020-03-24","8","27","2","5","10.7","7.7"
"Jasper","2020-03-25","4","31","2","7","17.9","11.3"
"Jasper","2020-03-26","3","34","0","7","17.9","11.3"
"Jasper","2020-03-27","3","37","0","7","17.9","11.3"
"Jasper","2020-03-28","2","39","0","7","17.9","11.3"
"Jasper","2020-03-29","0","39","0","7","10.7","11.3"
"Jasper","2020-03-30","1","40","0","7","10.7","8.9"
"Jasper","2020-03-31","0","40","0","7","7.1","8.9"
"Jasper","2020-04-01","2","42","0","7","0","8.9"
"Jasper","2020-04-02","0","42","0","7","0","8.9"
"Jasper","2020-04-03","6","48","0","7","0","8.9"
"Jasper","2020-04-04","2","50","0","7","0","8.9"
"Jasper","2020-04-05","1","51","0","7","0","5.4"
"Jasper","2020-04-06","5","56","0","7","0","5.4"
"Jasper","2020-04-07","4","60","0","7","0","3.6"
"Jasper","2020-04-08","7","67","2","9","4.1","2"
"Jasper","2020-04-09","4","71","1","10","7.7","3.8"
"Jasper","2020-04-10","8","79","0","10","7.7","3.8"
"Jasper","2020-04-11","1","80","0","10","7.7","3.8"
"Jasper","2020-04-12","0","80","0","10","7.7","3.8"
"Jasper","2020-04-13","11","91","3","13","11.5","5.8"
"Jasper","2020-04-14","7","98","1","14","13.6","6.8"
"Jasper","2020-04-15","8","106","1","15","11.3","7.7"
"Jasper","2020-04-16","9","115","3","18","12.5","10.1"
"Jasper","2020-04-17","7","122","1","19","14.5","11.1"
"Jasper","2020-04-18","8","130","0","19","14.5","11.1"
"Jasper","2020-04-19","1","131","0","19","14.5","11.1"
"Jasper","2020-04-20","11","142","1","20","11.9","11.7"
"Jasper","2020-04-21","10","152","0","20","9.9","11.7"
"Jasper","2020-04-22","10","162","0","20","8.1","9.7"
"Jasper","2020-04-23","15","177","1","21","4.3","8.4"
"Jasper","2020-04-24","12","189","0","21","2.3","8.4"
"Jasper","2020-04-25","6","195","0","21","2.3","8.4"
"Jasper","2020-04-26","3","198","1","22","7","10.8"
"Jasper","2020-04-27","28","226","4","26","7.8","9.8"
"Jasper","2020-04-28","15","241","0","26","7.8","8.8"
"Jasper","2020-04-29","10","251","0","26","7.8","7.9"
"Jasper","2020-04-30","15","266","0","26","6.8","5.5"
"Jasper","2020-05-01","14","280","2","28","8.8","5.5"
"Jasper","2020-05-02","8","288","0","28","8.8","5.5"
"Jasper","2020-05-03","4","292","0","28","4.1","5.5"
"Jasper","2020-05-04","8","300","1","29","3.8","5.8"
"Jasper","2020-05-05","10","310","0","29","3.8","5.8"
"Jasper","2020-05-06","18","328","0","29","3.8","5.8"
"Jasper","2020-05-07","24","352","1","30","4.4","5.6"
"Jasper","2020-05-08","23","375","1","31","3","5.9"
"Jasper","2020-05-09","2","377","0","31","3","5.9"
"Jasper","2020-05-10","2","379","0","31","3","3.5"
"Jasper","2020-05-11","52","431","1","32","1.5","2.7"
"Jasper","2020-05-12","32","463","0","32","1.5","2.7"
"Jasper","2020-05-13","45","508","5","37","3.1","3.5"
"Jasper","2020-05-14","39","547","0","37","2.5","3.5"
"Jasper","2020-05-15","52","599","6","43","3.5","3.3"
"Jasper","2020-05-16","9","608","0","43","3.5","3.3"
"Jasper","2020-05-17","5","613","0","43","3.5","3.3"
"Jasper","2020-05-18","58","671","1","44","3.5","2.5"
"Jasper","2020-05-19","29","700","1","45","4","2.7"
"Jasper","2020-05-20","16","716","0","45","2.4","2.7"
"Jasper","2020-05-21","13","729","0","45","2.4","2.4"
"Jasper","2020-05-22","19","748","0","45","0.7","2.1"
"Jasper","2020-05-23","2","750","0","45","0.7","2.1"
"Jasper","2020-05-24","5","755","0","45","0.7","2.1"
"Jasper","2020-05-25","6","761","0","45","0.5","2"
"Jasper","2020-05-26","31","792","3","48","1.4","2.7"
"Jasper","2020-05-27","48","840","3","51","2.3","2.3"
"Jasper","2020-05-28","40","880","3","54","3.3","2.9"
"Jasper","2020-05-29","33","913","6","60","5.9","3.3"
"Jasper","2020-05-30","3","916","0","60","5.9","3.3"
"Jasper","2020-05-31","4","920","0","60","5.9","3.3"
"Jasper","2020-06-01","50","970","2","62","6.5","3.5"
"Jasper","2020-06-02","63","1033","3","65","5.8","3.6"
"Jasper","2020-06-03","18","1051","0","65","4.9","3.6"
"Jasper","2020-06-04","22","1073","3","68","5.8","4.6"
"Jasper","2020-06-05","38","1111","1","69","3.6","4.8"
"Jasper","2020-06-06","14","1125","0","69","3.6","4.8"
"Jasper","2020-06-07","6","1131","0","69","3.6","4.8"
"Jasper","2020-06-08","11","1142","0","69","3","4.8"
"Jasper","2020-06-09","44","1186","5","74","3.9","4.9"
"Jasper","2020-06-10","18","1204","2","76","5.5","5.2"
"Jasper","2020-06-11","16","1220","1","77","4.5","5.1"
"Jasper","2020-06-12","33","1253","0","77","4.1","3.8"
"Jasper","2020-06-13","3","1256","0","77","4.1","3.8"
"Jasper","2020-06-14","3","1259","0","77","4.1","3.8"
"Jasper","2020-06-15","24","1283","1","78","4.7","3.9"
"Jasper","2020-06-16","38","1321","1","79","3.5","3.7"
"Jasper","2020-06-17","10","1331","2","81","4.7","5.1"
"Jasper","2020-06-18","14","1345","0","81","3.8","4.2"
"Jasper","2020-06-19","39","1384","6","87","6","5.1"
"Jasper","2020-06-20","2","1386","0","87","6","5.1"
"Jasper","2020-06-21","5","1391","0","87","6","5.1"
"Jasper","2020-06-22","23","1414","1","88","6.1","5.4"
"Jasper","2020-06-23","22","1436","3","91","7.6","5.5"
"Jasper","2020-06-24","13","1449","2","93","7","5.8"
"Jasper","2020-06-25","12","1461","0","93","7","5.4"
"Jasper","2020-06-26","51","1512","3","96","5.6","5.8"
"Jasper","2020-06-27","6","1518","0","96","5.6","5.8"
"Jasper","2020-06-28","4","1522","0","96","5.6","5.8"
"Jasper","2020-06-29","53","1575","3","99","5.8","5.9"
"Jasper","2020-06-30","56","1631","4","103","4.9","6.2"
"Jasper","2020-07-01","24","1655","6","109","6.2","6.6"
"Jasper","2020-07-02","20","1675","4","113","9.1","8"
"Jasper","2020-07-03","7","1682","0","113","8.3","6.9"
"Jasper","2020-07-04","2","1684","1","114","15.4","10.5"
"Jasper","2020-07-05","4","1688","0","114","15.4","10.5"
"Jasper","2020-07-06","35","1723","4","118","16.2","11"
"Jasper","2020-07-07","54","1777","6","124","16.8","10.8"
"Jasper","2020-07-08","14","1791","2","126","15.3","10.8"
"Jasper","2020-07-09","11","1802","0","126","12.4","10.8"
"Jasper","2020-07-10","62","1864","3","129","13.1","10.7"
"Jasper","2020-07-11","8","1872","1","130","7.7","11.6"
"Jasper","2020-07-12","3","1875","0","130","7.7","11.6"
"Jasper","2020-07-13","8","1883","3","133","11.5","13.8"
"Jasper","2020-07-14","39","1922","7","140","12.4","14.6"
"Jasper","2020-07-15","14","1936","0","140","10.4","12.8"
"Jasper","2020-07-16","7","1943","0","140","10.4","11.4"
"Jasper","2020-07-17","43","1986","3","143","10.7","11.9"
"Jasper","2020-07-18","9","1995","0","143","8.9","8.3"
"Jasper","2020-07-19","2","1997","1","144","16.1","11.9"
"Jasper","2020-07-20","15","2012","2","146","12.6","12"
"Jasper","2020-07-21","40","2052","3","149","11.1","11.8"
"Jasper","2020-07-22","9","2061","2","151","14.3","12.3"
"Jasper","2020-07-23","16","2077","3","154","17","13.7"
"Jasper","2020-07-24","47","2124","6","160","17.8","14.2"
"Jasper","2020-07-25","10","2134","4","164","23.5","16.2"
"Jasper","2020-07-26","3","2137","0","164","16.4","16.2"
"Jasper","2020-07-27","15","2152","0","164","14.5","13.5"
"Jasper","2020-07-28","31","2183","5","169","15.7","13.4"
"Jasper","2020-07-29","17","2200","0","169","12.5","13.4"
"Jasper","2020-07-30","12","2212","2","171","12.2","14.6"
"Jasper","2020-07-31","35","2247","2","173","11.2","14.5"
"Jasper","2020-08-01","8","2255","0","173","5.5","14.5"
"Jasper","2020-08-02","4","2259","1","174","9.1","12.7"
"Jasper","2020-08-03","13","2272","1","175","10.2","12.3"
"Jasper","2020-08-04","51","2323","4","179","9","12.3"
"Jasper","2020-08-05","13","2336","1","180","10.1","11.3"
"Jasper","2020-08-06","9","2345","1","181","9.3","10.8"
"Jasper","2020-08-07","37","2382","6","187","10.8","11"
"Jasper","2020-08-08","3","2385","0","187","10.8","8.1"
"Jasper","2020-08-09","5","2390","1","188","10.1","9.6"
"Jasper","2020-08-10","16","2406","3","191","11.7","10.9"
"Jasper","2020-08-11","50","2456","5","196","12","10.5"
"Jasper","2020-08-12","11","2467","0","196","10.9","10.5"
"Jasper","2020-08-13","11","2478","1","197","10.6","9.9"
"Jasper","2020-08-14","32","2510","5","202","10.5","10.6"
"Jasper","2020-08-15","9","2519","2","204","13.7","12.2"
"Jasper","2020-08-16","7","2526","0","204","10.8","10.4"
"Jasper","2020-08-17","18","2544","1","205","8.9","10.3"
"Jasper","2020-08-18","35","2579","1","206","7.9","9.9"
"Jasper","2020-08-19","15","2594","2","208","9.8","10.3"
"Jasper","2020-08-20","13","2607","0","208","8.5","9.5"
"Jasper","2020-08-21","20","2627","2","210","7.7","9.1"
"Jasper","2020-08-22","11","2638","4","214","9.7","11.7"
"Jasper","2020-08-23","5","2643","0","214","9.7","10.3"
"Jasper","2020-08-24","6","2649","1","215","11.3","10.1"
"Jasper","2020-08-25","24","2673","2","217","12.1","10"
"Jasper","2020-08-26","11","2684","2","219","12.8","11.3"
"Jasper","2020-08-27","11","2695","1","220","14.1","11.3"
"Jasper","2020-08-28","21","2716","1","221","13.3","10.5"
"Jasper","2020-08-29","5","2721","0","221","8.1","8.9"
"Jasper","2020-08-30","2","2723","0","221","8.1","8.9"
"Jasper","2020-08-31","12","2735","1","222","7","9.1"
"Jasper","2020-09-01","17","2752","1","223","6.6","9.4"
"Jasper","2020-09-02","14","2766","0","223","4","8.4"
"Jasper","2020-09-03","11","2777","0","223","2.7","8.4"
"Jasper","2020-09-04","11","2788","1","224","3.3","8.3"
"Jasper","2020-09-05","2","2790","0","224","3.3","5.7"
"Jasper","2020-09-06","8","2798","0","224","3.3","5.7"
"Jasper","2020-09-07","4","2802","0","224","2.1","4.5"
"Jasper","2020-09-08","24","2826","2","226","2.5","4.5"
"Jasper","2020-09-09","10","2836","0","226","2.5","3.2"
"Jasper","2020-09-10","15","2851","0","226","2.5","2.6"
"Jasper","2020-09-11","30","2881","1","227","1.7","2.5"
"Jasper","2020-09-12","5","2886","1","228","4.5","3.9"
"Jasper","2020-09-13","4","2890","1","229","8.1","5.7"
"Jasper","2020-09-14","8","2898","1","230","9.9","6"
"Jasper","2020-09-15","27","2925","1","231","9.2","5.9"
"Jasper","2020-09-16","16","2941","0","231","9.2","5.9"
"Jasper","2020-09-17","13","2954","1","232","10.3","6.4"
"Jasper","2020-09-18","18","2972","0","232","9.8","5.8"
"Jasper","2020-09-19","6","2978","0","232","7","5.8"
"Jasper","2020-09-20","4","2982","1","233","7","7.5"
"Jasper","2020-09-21","15","2997","0","233","5.2","7.5"
"Jasper","2020-09-22","19","3016","0","233","4.7","6.9"
"Jasper","2020-09-23","13","3029","4","237","9.1","9.1"
"Jasper","2020-09-24","10","3039","1","238","9.4","9.9"
"Jasper","2020-09-25","16","3055","0","238","9.4","9.6"
"Jasper","2020-09-26","4","3059","0","238","9.4","8.2"
"Jasper","2020-09-27","3","3062","0","238","5.8","6.4"
"Jasper","2020-09-28","15","3077","0","238","5.8","5.5"
"Jasper","2020-09-29","18","3095","0","238","5.8","5.2"
"Jasper","2020-09-30","12","3107","0","238","1.4","5.2"
"Jasper","2020-10-01","15","3122","2","240","1.9","5.7"
"Jasper","2020-10-02","14","3136","2","242","3.9","6.7"
"Jasper","2020-10-03","8","3144","2","244","7.5","8.5"
"Jasper","2020-10-04","3","3147","0","244","7.5","6.7"
"Jasper","2020-10-05","11","3158","1","245","8.8","7.3"
"Jasper","2020-10-06","20","3178","1","246","9.5","7.7"
"Jasper","2020-10-07","13","3191","1","247","10.6","6"
"Jasper","2020-10-08","12","3203","2","249","11.1","6.5"
"Jasper","2020-10-09","18","3221","3","252","11.4","7.7"
"Jasper","2020-10-10","2","3223","0","252","7.9","7.7"
"Jasper","2020-10-11","8","3231","1","253","9.7","8.6"
"Jasper","2020-10-12","9","3240","2","255","11.5","10.2"
"Jasper","2020-10-13","25","3265","1","256","11.4","10.5"
"Jasper","2020-10-14","4","3269","0","256","10.3","10.5"
"Jasper","2020-10-15","13","3282","0","256","7.9","9.5"
"Jasper","2020-10-16","6","3288","0","256","5.5","8.5"
"Jasper","2020-10-17","5","3293","0","256","5.5","6.7"
"Jasper","2020-10-18","6","3299","1","257","6.1","7.9"
"Jasper","2020-10-19","18","3317","0","257","3","7.2"
"Jasper","2020-10-20","22","3339","0","257","2.4","6.9"
"Jasper","2020-10-21","15","3354","1","258","3.3","6.8"
"Jasper","2020-10-22","11","3365","0","258","3.3","5.6"
"Jasper","2020-10-23","11","3376","2","260","5.9","5.7"
"Jasper","2020-10-24","1","3377","0","260","5.9","5.7"
"Jasper","2020-10-25","5","3382","0","260","3.5","4.8"
"Jasper","2020-10-26","11","3393","0","260","3.5","3.3"
"Jasper","2020-10-27","41","3434","2","262","4.2","3.3"
"Jasper","2020-10-28","39","3473","0","262","3.3","3.3"
"Jasper","2020-10-29","33","3506","0","262","3.3","3.3"
"Jasper","2020-10-30","19","3525","0","262","0.7","3.3"
"Jasper","2020-10-31","6","3531","0","262","0.7","3.3"
"Jasper","2020-11-01","6","3537","1","263","3.1","3.3"
"Jasper","2020-11-02","36","3573","0","263","3.1","3.3"
"Jasper","2020-11-03","16","3589","1","264","3.3","3.8"
"Jasper","2020-11-04","16","3605","0","264","3.3","3.3"
"Jasper","2020-11-05","12","3617","3","267","6.8","5.1"
"Jasper","2020-11-06","17","3634","2","269","8.5","4.6"
"Jasper","2020-11-07","7","3641","1","270","10.6","5.6"
"Jasper","2020-11-08","2","3643","0","270","8.2","5.6"
"Jasper","2020-11-09","10","3653","1","271","9.6","6.3"
"Jasper","2020-11-10","36","3689","8","279","11.9","7.6"
"Jasper","2020-11-11","12","3701","1","280","13.1","8.2"
"Jasper","2020-11-12","9","3710","0","280","9.5","8.2"
"Jasper","2020-11-13","17","3727","3","283","10.4","9.4"
"Jasper","2020-11-14","7","3734","1","284","10.4","10.5"
"Jasper","2020-11-15","1","3735","0","284","10.4","9.3"
"Jasper","2020-11-16","29","3764","2","286","9.9","9.8"
"Jasper","2020-11-17","29","3793","1","287","7.2","9.6"
"Jasper","2020-11-18","9","3802","0","287","6","9.6"
"Jasper","2020-11-19","13","3815","0","287","6","7.8"
"Jasper","2020-11-20","13","3828","1","288","4.6","7.5"
"Jasper","2020-11-21","9","3837","0","288","2.6","6.5"
"Jasper","2020-11-22","4","3841","1","289","6.1","8.3"
"Jasper","2020-11-23","22","3863","5","294","8.4","9.2"
"Jasper","2020-11-24","30","3893","0","294","7.9","7.6"
"Jasper","2020-11-25","16","3909","5","299","12.4","9.2"
"Jasper","2020-11-26","5","3914","0","299","12.4","9.2"
"Jasper","2020-11-27","15","3929","1","300","12.2","8.4"
"Jasper","2020-11-28","7","3936","2","302","16.3","9.4"
"Jasper","2020-11-29","4","3940","0","302","12.7","9.4"
"Jasper","2020-11-30","26","3966","5","307","12.2","10.3"
"Jasper","2020-12-01","32","3998","6","313","14.9","11.4"
"Jasper","2020-12-02","23","4021","4","317","12.9","12.7"
"Jasper","2020-12-03","15","4036","0","317","12.9","12.7"
"Jasper","2020-12-04","17","4053","1","318","12.8","12.5"
"Jasper","2020-12-05","10","4063","1","319","10.2","13.2"
"Jasper","2020-12-06","10","4073","2","321","13","12.9"
"Jasper","2020-12-07","15","4088","0","321","10.3","11.3"
"Jasper","2020-12-08","31","4119","6","327","10.4","12.6"
"Jasper","2020-12-09","26","4145","6","333","11.2","12.1"
"Jasper","2020-12-10","25","4170","5","338","14","13.5"
"Jasper","2020-12-11","33","4203","5","343","15.4","14.1"
"Jasper","2020-12-12","13","4216","3","346","17.2","13.7"
"Jasper","2020-12-13","8","4224","2","348","18","15.5"
"Jasper","2020-12-14","20","4244","5","353","21.5","15.9"
"Jasper","2020-12-15","30","4274","8","361","22.6","16.5"
"Jasper","2020-12-16","22","4296","2","363","20.6","15.9"
"Jasper","2020-12-17","28","4324","6","369","20.8","17.4"
"Jasper","2020-12-18","57","4381","8","377","20.6","18"
"Jasper","2020-12-19","13","4394","1","378","18.4","17.8"
"Jasper","2020-12-20","6","4400","3","381","22","20"
"Jasper","2020-12-21","20","4420","6","387","22.7","22.1"
"Jasper","2020-12-22","21","4441","4","391","21.6","22.1"
"Jasper","2020-12-23","13","4454","2","393","22.5","21.5"
"Jasper","2020-12-24","17","4471","3","396","22","21.4"
"Jasper","2020-12-25","1","4472","0","396","20","20.3"
"Jasper","2020-12-26","11","4483","1","397","20.2","19.3"
"Jasper","2020-12-27","10","4493","1","398","14.5","18.2"
"Jasper","2020-12-28","24","4517","9","407","15.5","19.1"
"Jasper","2020-12-29","28","4545","10","417","17.9","19.8"
"Jasper","2020-12-30","49","4594","15","432","20.1","21.3"
"Jasper","2020-12-31","36","4630","4","436","19.1","20.6"
"Jasper","2021-01-01","6","4636","3","439","26.3","23.1"
"Jasper","2021-01-02","17","4653","4","443","28.4","24.3"
"Jasper","2021-01-03","6","4659","1","444","29.3","21.9"
"Jasper","2021-01-04","23","4682","6","450","27.7","21.6"
"Jasper","2021-01-05","65","4747","25","475","28.1","23"
"Jasper","2021-01-06","31","4778","8","483","27.4","23.7"
"Jasper","2021-01-07","37","4815","11","494","30","24.6"
"Jasper","2021-01-08","69","4884","16","510","26.2","26.2"
"Jasper","2021-01-09","14","4898","4","514","26.9","27.6"
"Jasper","2021-01-10","6","4904","2","516","29.3","29.3"
"Jasper","2021-01-11","25","4929","5","521","28.4","28.1"
"Jasper","2021-01-12","30","4959","9","530","27.2","27.6"
"Jasper","2021-01-13","41","5000","8","538","26.3","26.9"
"Jasper","2021-01-14","44","5044","4","542","23.4","26.7"
"Jasper","2021-01-15","38","5082","9","551","23.5","24.8"
"Jasper","2021-01-16","12","5094","3","554","22.9","24.9"
"Jasper","2021-01-17","18","5112","3","557","20.6","24.9"
"Jasper","2021-01-18","17","5129","2","559","19.4","23.9"
"Jasper","2021-01-19","31","5160","4","563","16.9","22.1"
"Jasper","2021-01-20","30","5190","4","567","16.1","21.2"
"Jasper","2021-01-21","34","5224","4","571","16.4","19.9"
"Jasper","2021-01-22","53","5277","9","580","15.5","19.5"
"Jasper","2021-01-23","11","5288","3","583","15.8","19.4"
"Jasper","2021-01-24","7","5295","2","585","17.5","19"
"Jasper","2021-01-25","24","5319","1","586","16.4","17.9"
"Jasper","2021-01-26","30","5349","4","590","16.5","16.7"
"Jasper","2021-01-27","38","5387","3","593","15.7","15.9"
"Jasper","2021-01-28","34","5421","2","595","14.9","15.7"
"Jasper","2021-01-29","28","5449","2","597","13.5","14.5"
"Jasper","2021-01-30","14","5463","1","598","10.6","13.2"
"Jasper","2021-01-31","9","5472","2","600","9.7","13.6"
"Jasper","2021-02-01","18","5490","0","600","9.1","12.8"
"Jasper","2021-02-02","13","5503","1","601","8.3","12.4"
"Jasper","2021-02-03","21","5524","4","605","9.9","12.8"
"Jasper","2021-02-04","22","5546","2","607","10.3","12.6"
"Jasper","2021-02-05","31","5577","3","610","10.7","12.1"
"Jasper","2021-02-06","3","5580","2","612","19.2","14.9"
"Jasper","2021-02-07","0","5580","0","612","16","12.9"
"Jasper","2021-02-08","0","5580","0","612","16","12.6"
"Jeff Davis","2020-02-01","0","0","0","0",".","."
"Jeff Davis","2020-02-02","0","0","0","0",".","."
"Jeff Davis","2020-02-03","0","0","0","0",".","."
"Jeff Davis","2020-02-04","0","0","0","0",".","."
"Jeff Davis","2020-02-05","0","0","0","0",".","."
"Jeff Davis","2020-02-06","0","0","0","0",".","."
"Jeff Davis","2020-02-07","0","0","0","0","0","."
"Jeff Davis","2020-02-08","0","0","0","0","0","."
"Jeff Davis","2020-02-09","0","0","0","0","0","."
"Jeff Davis","2020-02-10","0","0","0","0","0","."
"Jeff Davis","2020-02-11","0","0","0","0","0","."
"Jeff Davis","2020-02-12","0","0","0","0","0","."
"Jeff Davis","2020-02-13","0","0","0","0","0","."
"Jeff Davis","2020-02-14","0","0","0","0","0","0"
"Jeff Davis","2020-02-15","0","0","0","0","0","0"
"Jeff Davis","2020-02-16","0","0","0","0","0","0"
"Jeff Davis","2020-02-17","0","0","0","0","0","0"
"Jeff Davis","2020-02-18","0","0","0","0","0","0"
"Jeff Davis","2020-02-19","0","0","0","0","0","0"
"Jeff Davis","2020-02-20","0","0","0","0","0","0"
"Jeff Davis","2020-02-21","0","0","0","0","0","0"
"Jeff Davis","2020-02-22","0","0","0","0","0","0"
"Jeff Davis","2020-02-23","0","0","0","0","0","0"
"Jeff Davis","2020-02-24","0","0","0","0","0","0"
"Jeff Davis","2020-02-25","0","0","0","0","0","0"
"Jeff Davis","2020-02-26","0","0","0","0","0","0"
"Jeff Davis","2020-02-27","0","0","0","0","0","0"
"Jeff Davis","2020-02-28","0","0","0","0","0","0"
"Jeff Davis","2020-02-29","0","0","0","0","0","0"
"Jeff Davis","2020-03-01","0","0","0","0","0","0"
"Jeff Davis","2020-03-02","0","0","0","0","0","0"
"Jeff Davis","2020-03-03","0","0","0","0","0","0"
"Jeff Davis","2020-03-04","0","0","0","0","0","0"
"Jeff Davis","2020-03-05","0","0","0","0","0","0"
"Jeff Davis","2020-03-06","0","0","0","0","0","0"
"Jeff Davis","2020-03-07","0","0","0","0","0","0"
"Jeff Davis","2020-03-08","0","0","0","0","0","0"
"Jeff Davis","2020-03-09","0","0","0","0","0","0"
"Jeff Davis","2020-03-10","0","0","0","0","0","0"
"Jeff Davis","2020-03-11","0","0","0","0","0","0"
"Jeff Davis","2020-03-12","0","0","0","0","0","0"
"Jeff Davis","2020-03-13","4","4","0","0","0","0"
"Jeff Davis","2020-03-14","0","4","0","0","0","0"
"Jeff Davis","2020-03-15","0","4","0","0","0","0"
"Jeff Davis","2020-03-16","3","7","0","0","0","0"
"Jeff Davis","2020-03-17","1","8","0","0","0","0"
"Jeff Davis","2020-03-18","1","9","0","0","0","0"
"Jeff Davis","2020-03-19","3","12","0","0","0","0"
"Jeff Davis","2020-03-20","2","14","0","0","0","0"
"Jeff Davis","2020-03-21","2","16","0","0","0","0"
"Jeff Davis","2020-03-22","2","18","0","0","0","0"
"Jeff Davis","2020-03-23","5","23","0","0","0","0"
"Jeff Davis","2020-03-24","8","31","0","0","0","0"
"Jeff Davis","2020-03-25","7","38","0","0","0","0"
"Jeff Davis","2020-03-26","3","41","0","0","0","0"
"Jeff Davis","2020-03-27","3","44","0","0","0","0"
"Jeff Davis","2020-03-28","3","47","0","0","0","0"
"Jeff Davis","2020-03-29","2","49","0","0","0","0"
"Jeff Davis","2020-03-30","2","51","0","0","0","0"
"Jeff Davis","2020-03-31","6","57","0","0","0","0"
"Jeff Davis","2020-04-01","5","62","1","1","2.9","1.4"
"Jeff Davis","2020-04-02","3","65","0","1","2.9","1.4"
"Jeff Davis","2020-04-03","5","70","0","1","2.9","1.4"
"Jeff Davis","2020-04-04","1","71","0","1","2.9","1.4"
"Jeff Davis","2020-04-05","5","76","0","1","2.9","1.4"
"Jeff Davis","2020-04-06","4","80","0","1","2.9","1.4"
"Jeff Davis","2020-04-07","8","88","0","1","2.9","1.4"
"Jeff Davis","2020-04-08","2","90","0","1","0","1.4"
"Jeff Davis","2020-04-09","3","93","0","1","0","1.4"
"Jeff Davis","2020-04-10","2","95","1","2","7.1","5"
"Jeff Davis","2020-04-11","0","95","0","2","7.1","5"
"Jeff Davis","2020-04-12","0","95","0","2","7.1","5"
"Jeff Davis","2020-04-13","5","100","2","4","12.9","7.9"
"Jeff Davis","2020-04-14","0","100","0","4","12.9","7.9"
"Jeff Davis","2020-04-15","1","101","0","4","12.9","6.4"
"Jeff Davis","2020-04-16","1","102","1","5","27.1","13.6"
"Jeff Davis","2020-04-17","0","102","0","5","20","13.6"
"Jeff Davis","2020-04-18","1","103","1","6","34.3","20.7"
"Jeff Davis","2020-04-19","0","103","0","6","34.3","20.7"
"Jeff Davis","2020-04-20","4","107","0","6","28.6","20.7"
"Jeff Davis","2020-04-21","4","111","0","6","28.6","20.7"
"Jeff Davis","2020-04-22","4","115","1","7","32.1","22.5"
"Jeff Davis","2020-04-23","0","115","0","7","17.9","22.5"
"Jeff Davis","2020-04-24","2","117","0","7","17.9","18.9"
"Jeff Davis","2020-04-25","0","117","0","7","3.6","18.9"
"Jeff Davis","2020-04-26","3","120","0","7","3.6","18.9"
"Jeff Davis","2020-04-27","9","129","2","9","6.7","17.7"
"Jeff Davis","2020-04-28","2","131","0","9","6.7","17.7"
"Jeff Davis","2020-04-29","2","133","0","9","3.2","17.7"
"Jeff Davis","2020-04-30","11","144","1","10","4.5","11.2"
"Jeff Davis","2020-05-01","3","147","0","10","4.5","11.2"
"Jeff Davis","2020-05-02","2","149","1","11","11.6","7.6"
"Jeff Davis","2020-05-03","0","149","0","11","11.6","7.6"
"Jeff Davis","2020-05-04","8","157","0","11","8.4","7.6"
"Jeff Davis","2020-05-05","4","161","0","11","8.4","7.6"
"Jeff Davis","2020-05-06","3","164","0","11","8.4","5.8"
"Jeff Davis","2020-05-07","6","170","1","12","9.5","7"
"Jeff Davis","2020-05-08","3","173","0","12","9.5","7"
"Jeff Davis","2020-05-09","2","175","0","12","2.4","7"
"Jeff Davis","2020-05-10","0","175","0","12","2.4","7"
"Jeff Davis","2020-05-11","2","177","0","12","2.4","5.4"
"Jeff Davis","2020-05-12","1","178","0","12","2.4","5.4"
"Jeff Davis","2020-05-13","1","179","0","12","2.4","5.4"
"Jeff Davis","2020-05-14","5","184","1","13","2.9","6.2"
"Jeff Davis","2020-05-15","2","186","0","13","2.9","6.2"
"Jeff Davis","2020-05-16","0","186","0","13","2.9","2.6"
"Jeff Davis","2020-05-17","0","186","0","13","2.9","2.6"
"Jeff Davis","2020-05-18","4","190","0","13","2.9","2.6"
"Jeff Davis","2020-05-19","2","192","0","13","2.9","2.6"
"Jeff Davis","2020-05-20","2","194","1","14","10","6.2"
"Jeff Davis","2020-05-21","5","199","1","15","10","6.4"
"Jeff Davis","2020-05-22","7","206","0","15","10","6.4"
"Jeff Davis","2020-05-23","2","208","0","15","10","6.4"
"Jeff Davis","2020-05-24","2","210","0","15","10","6.4"
"Jeff Davis","2020-05-25","3","213","0","15","10","6.4"
"Jeff Davis","2020-05-26","4","217","0","15","10","6.4"
"Jeff Davis","2020-05-27","7","224","0","15","2.9","6.4"
"Jeff Davis","2020-05-28","4","228","0","15","0","5"
"Jeff Davis","2020-05-29","3","231","0","15","0","5"
"Jeff Davis","2020-05-30","0","231","0","15","0","5"
"Jeff Davis","2020-05-31","0","231","0","15","0","5"
"Jeff Davis","2020-06-01","13","244","1","16","1.1","5.5"
"Jeff Davis","2020-06-02","9","253","0","16","1.1","5.5"
"Jeff Davis","2020-06-03","5","258","0","16","1.1","2"
"Jeff Davis","2020-06-04","2","260","0","16","1.1","0.5"
"Jeff Davis","2020-06-05","1","261","0","16","1.1","0.5"
"Jeff Davis","2020-06-06","0","261","0","16","1.1","0.5"
"Jeff Davis","2020-06-07","0","261","0","16","1.1","0.5"
"Jeff Davis","2020-06-08","7","268","0","16","0","0.5"
"Jeff Davis","2020-06-09","2","270","0","16","0","0.5"
"Jeff Davis","2020-06-10","5","275","1","17","2.9","2"
"Jeff Davis","2020-06-11","3","278","0","17","2.9","2"
"Jeff Davis","2020-06-12","3","281","0","17","2.9","2"
"Jeff Davis","2020-06-13","3","284","0","17","2.9","2"
"Jeff Davis","2020-06-14","3","287","1","18","7.6","4.4"
"Jeff Davis","2020-06-15","4","291","0","18","7.6","3.8"
"Jeff Davis","2020-06-16","2","293","0","18","7.6","3.8"
"Jeff Davis","2020-06-17","3","296","0","18","4.8","3.8"
"Jeff Davis","2020-06-18","4","300","0","18","4.8","3.8"
"Jeff Davis","2020-06-19","3","303","1","19","9.5","6.2"
"Jeff Davis","2020-06-20","5","308","1","20","12.4","7.6"
"Jeff Davis","2020-06-21","0","308","0","20","7.6","7.6"
"Jeff Davis","2020-06-22","8","316","3","23","13","10.3"
"Jeff Davis","2020-06-23","9","325","4","27","19.3","13.5"
"Jeff Davis","2020-06-24","1","326","0","27","19.3","12"
"Jeff Davis","2020-06-25","6","332","1","28","21.7","13.2"
"Jeff Davis","2020-06-26","40","372","1","29","17.3","13.4"
"Jeff Davis","2020-06-27","8","380","3","32","19.8","16.1"
"Jeff Davis","2020-06-28","2","382","1","33","26.9","17.3"
"Jeff Davis","2020-06-29","27","409","0","33","21.6","17.3"
"Jeff Davis","2020-06-30","15","424","2","35","17.1","18.2"
"Jeff Davis","2020-07-01","11","435","4","39","22.3","20.8"
"Jeff Davis","2020-07-02","9","444","1","40","21.5","21.6"
"Jeff Davis","2020-07-03","8","452","3","43","26.5","21.9"
"Jeff Davis","2020-07-04","2","454","1","44","28.3","24.1"
"Jeff Davis","2020-07-05","5","459","3","47","29.8","28.4"
"Jeff Davis","2020-07-06","16","475","7","54","36","28.8"
"Jeff Davis","2020-07-07","8","483","1","55","35.9","26.5"
"Jeff Davis","2020-07-08","6","489","0","55","30.7","26.5"
"Jeff Davis","2020-07-09","14","503","3","58","32.2","26.9"
"Jeff Davis","2020-07-10","6","509","0","58","26.8","26.7"
"Jeff Davis","2020-07-11","8","517","2","60","23.2","25.8"
"Jeff Davis","2020-07-12","2","519","0","60","14.7","22.2"
"Jeff Davis","2020-07-13","17","536","4","64","11.8","23.9"
"Jeff Davis","2020-07-14","7","543","0","64","10","22.9"
"Jeff Davis","2020-07-15","8","551","1","65","11.8","21.2"
"Jeff Davis","2020-07-16","20","571","4","69","11.6","21.9"
"Jeff Davis","2020-07-17","4","575","0","69","11.6","19.2"
"Jeff Davis","2020-07-18","0","575","0","69","8","15.6"
"Jeff Davis","2020-07-19","0","575","0","69","8","11.3"
"Jeff Davis","2020-07-20","5","580","1","70","7.5","9.6"
"Jeff Davis","2020-07-21","6","586","2","72","12.3","11.1"
"Jeff Davis","2020-07-22","4","590","1","73","14","12.9"
"Jeff Davis","2020-07-23","3","593","1","74","16","13.8"
"Jeff Davis","2020-07-24","8","601","2","76","19.5","15.5"
"Jeff Davis","2020-07-25","2","603","0","76","19.5","13.8"
"Jeff Davis","2020-07-26","5","608","2","78","25.2","16.6"
"Jeff Davis","2020-07-27","7","615","3","81","28.5","18"
"Jeff Davis","2020-07-28","6","621","0","81","23.7","18"
"Jeff Davis","2020-07-29","14","635","4","85","24.3","19.1"
"Jeff Davis","2020-07-30","3","638","0","85","19.5","17.7"
"Jeff Davis","2020-07-31","2","640","1","86","23.1","21.3"
"Jeff Davis","2020-08-01","5","645","2","88","28.8","24.1"
"Jeff Davis","2020-08-02","4","649","0","88","23.1","24.1"
"Jeff Davis","2020-08-03","6","655","1","89","19.3","23.9"
"Jeff Davis","2020-08-04","3","658","1","90","24.1","23.9"
"Jeff Davis","2020-08-05","9","667","2","92","23.2","23.7"
"Jeff Davis","2020-08-06","9","676","3","95","27.9","23.7"
"Jeff Davis","2020-08-07","6","682","0","95","20.8","21.9"
"Jeff Davis","2020-08-08","1","683","0","95","15.1","21.9"
"Jeff Davis","2020-08-09","1","684","0","95","15.1","19.1"
"Jeff Davis","2020-08-10","8","692","1","96","14.5","16.9"
"Jeff Davis","2020-08-11","6","698","0","96","9.7","16.9"
"Jeff Davis","2020-08-12","6","704","0","96","6.5","14.9"
"Jeff Davis","2020-08-13","5","709","0","96","1.8","14.9"
"Jeff Davis","2020-08-14","10","719","3","99","6.1","13.4"
"Jeff Davis","2020-08-15","1","720","0","99","6.1","10.6"
"Jeff Davis","2020-08-16","1","721","0","99","6.1","10.6"
"Jeff Davis","2020-08-17","29","750","4","103","6.3","10.4"
"Jeff Davis","2020-08-18","13","763","2","105","8.5","9.1"
"Jeff Davis","2020-08-19","4","767","1","106","12","9.3"
"Jeff Davis","2020-08-20","19","786","2","108","13.5","7.7"
"Jeff Davis","2020-08-21","2","788","1","109","16.4","11.2"
"Jeff Davis","2020-08-22","4","792","3","112","27.1","16.6"
"Jeff Davis","2020-08-23","1","793","0","112","27.1","16.6"
"Jeff Davis","2020-08-24","13","806","3","115","28.4","17.3"
"Jeff Davis","2020-08-25","16","822","4","119","29.8","19.1"
"Jeff Davis","2020-08-26","10","832","3","122","30.5","21.3"
"Jeff Davis","2020-08-27","8","840","1","123","30.8","22.2"
"Jeff Davis","2020-08-28","7","847","0","123","23.7","20"
"Jeff Davis","2020-08-29","6","853","2","125","17.7","22.4"
"Jeff Davis","2020-08-30","2","855","0","125","17.7","22.4"
"Jeff Davis","2020-08-31","2","857","0","125","14.4","21.4"
"Jeff Davis","2020-09-01","17","874","0","125","10.8","20.3"
"Jeff Davis","2020-09-02","11","885","3","128","10.4","20.5"
"Jeff Davis","2020-09-03","20","905","4","132","11.5","21.2"
"Jeff Davis","2020-09-04","13","918","2","134","13.7","18.7"
"Jeff Davis","2020-09-05","3","921","2","136","18.5","18.1"
"Jeff Davis","2020-09-06","7","928","2","138","22.6","20.1"
"Jeff Davis","2020-09-07","29","957","0","138","22.6","18.5"
"Jeff Davis","2020-09-08","10","967","1","139","24","17.4"
"Jeff Davis","2020-09-09","9","976","2","141","23.3","16.9"
"Jeff Davis","2020-09-10","12","988","1","142","21.6","16.6"
"Jeff Davis","2020-09-11","7","995","0","142","19.4","16.6"
"Jeff Davis","2020-09-12","5","1000","0","142","9.9","14.2"
"Jeff Davis","2020-09-13","1","1001","0","142","5.8","14.2"
"Jeff Davis","2020-09-14","29","1030","0","142","5.8","14.2"
"Jeff Davis","2020-09-15","44","1074","5","147","6","15"
"Jeff Davis","2020-09-16","2","1076","1","148","10","16.6"
"Jeff Davis","2020-09-17","22","1098","3","151","10.7","16.2"
"Jeff Davis","2020-09-18","2","1100","0","151","10.7","15.1"
"Jeff Davis","2020-09-19","0","1100","0","151","10.7","10.3"
"Jeff Davis","2020-09-20","5","1105","1","152","13.6","9.7"
"Jeff Davis","2020-09-21","6","1111","1","153","16","10.9"
"Jeff Davis","2020-09-22","24","1135","0","153","14.3","10.2"
"Jeff Davis","2020-09-23","8","1143","0","153","7.2","8.6"
"Jeff Davis","2020-09-24","49","1192","0","153","5.2","8"
"Jeff Davis","2020-09-25","3","1195","0","153","5.2","8"
"Jeff Davis","2020-09-26","2","1197","0","153","5.2","8"
"Jeff Davis","2020-09-27","0","1197","0","153","2.4","8"
"Jeff Davis","2020-09-28","9","1206","0","153","0","8"
"Jeff Davis","2020-09-29","50","1256","3","156","0.9","7.6"
"Jeff Davis","2020-09-30","8","1264","1","157","2.6","4.9"
"Jeff Davis","2020-10-01","7","1271","0","157","2.6","3.9"
"Jeff Davis","2020-10-02","9","1280","2","159","5.8","5.5"
"Jeff Davis","2020-10-03","3","1283","0","159","5.8","5.5"
"Jeff Davis","2020-10-04","3","1286","0","159","5.8","4.1"
"Jeff Davis","2020-10-05","3","1289","0","159","5.8","2.9"
"Jeff Davis","2020-10-06","25","1314","3","162","6.7","3.8"
"Jeff Davis","2020-10-07","15","1329","1","163","5.8","4.2"
"Jeff Davis","2020-10-08","13","1342","1","164","6.9","4.8"
"Jeff Davis","2020-10-09","5","1347","1","165","6.6","6.2"
"Jeff Davis","2020-10-10","1","1348","0","165","6.6","6.2"
"Jeff Davis","2020-10-11","0","1348","0","165","6.6","6.2"
"Jeff Davis","2020-10-12","6","1354","0","165","6.6","6.2"
"Jeff Davis","2020-10-13","15","1369","1","166","5.9","6.3"
"Jeff Davis","2020-10-14","4","1373","0","166","4.9","5.4"
"Jeff Davis","2020-10-15","23","1396","1","167","4.4","5.7"
"Jeff Davis","2020-10-16","12","1408","0","167","1.6","4.1"
"Jeff Davis","2020-10-17","1","1409","0","167","1.6","4.1"
"Jeff Davis","2020-10-18","1","1410","0","167","1.6","4.1"
"Jeff Davis","2020-10-19","18","1428","1","168","2.4","4.5"
"Jeff Davis","2020-10-20","18","1446","0","168","1.4","3.6"
"Jeff Davis","2020-10-21","11","1457","3","171","5.3","5.1"
"Jeff Davis","2020-10-22","10","1467","0","171","4.7","4.6"
"Jeff Davis","2020-10-23","42","1509","1","172","5","3.3"
"Jeff Davis","2020-10-24","4","1513","0","172","5","3.3"
"Jeff Davis","2020-10-25","1","1514","0","172","5","3.3"
"Jeff Davis","2020-10-26","10","1524","1","173","5.7","4"
"Jeff Davis","2020-10-27","15","1539","4","177","9.5","5.4"
"Jeff Davis","2020-10-28","9","1548","1","178","7.2","6.2"
"Jeff Davis","2020-10-29","6","1554","0","178","7.2","5.9"
"Jeff Davis","2020-10-30","6","1560","1","179","9.2","7.1"
"Jeff Davis","2020-10-31","2","1562","0","179","9.2","7.1"
"Jeff Davis","2020-11-01","0","1562","0","179","9.2","7.1"
"Jeff Davis","2020-11-02","4","1566","0","179","7.8","6.7"
"Jeff Davis","2020-11-03","7","1573","2","181","8","8.8"
"Jeff Davis","2020-11-04","5","1578","0","181","6.5","6.8"
"Jeff Davis","2020-11-05","8","1586","1","182","8.2","7.7"
"Jeff Davis","2020-11-06","9","1595","3","185","10.6","9.9"
"Jeff Davis","2020-11-07","1","1596","0","185","10.6","9.9"
"Jeff Davis","2020-11-08","3","1599","0","185","10.6","9.9"
"Jeff Davis","2020-11-09","5","1604","0","185","10.6","9.2"
"Jeff Davis","2020-11-10","5","1609","0","185","6.5","7.3"
"Jeff Davis","2020-11-11","6","1615","1","186","8.9","7.7"
"Jeff Davis","2020-11-12","13","1628","0","186","7.1","7.7"
"Jeff Davis","2020-11-13","7","1635","0","186","2.4","6.5"
"Jeff Davis","2020-11-14","3","1638","0","186","2.4","6.5"
"Jeff Davis","2020-11-15","2","1640","1","187","9.5","10.1"
"Jeff Davis","2020-11-16","13","1653","1","188","10.6","10.6"
"Jeff Davis","2020-11-17","14","1667","1","189","11.6","9.1"
"Jeff Davis","2020-11-18","5","1672","0","189","9.3","9.1"
"Jeff Davis","2020-11-19","5","1677","2","191","15","11.1"
"Jeff Davis","2020-11-20","4","1681","1","192","18.5","10.5"
"Jeff Davis","2020-11-21","4","1685","1","193","22.1","12.3"
"Jeff Davis","2020-11-22","2","1687","0","193","15","12.3"
"Jeff Davis","2020-11-23","18","1705","2","195","15.5","13"
"Jeff Davis","2020-11-24","17","1722","2","197","16.1","13.9"
"Jeff Davis","2020-11-25","15","1737","0","197","16.1","12.7"
"Jeff Davis","2020-11-26","3","1740","0","197","10.4","12.7"
"Jeff Davis","2020-11-27","11","1751","2","199","9.4","14"
"Jeff Davis","2020-11-28","10","1761","1","200","7.3","14.7"
"Jeff Davis","2020-11-29","5","1766","0","200","7.3","11.1"
"Jeff Davis","2020-11-30","32","1798","7","207","8.8","12.1"
"Jeff Davis","2020-12-01","15","1813","0","207","7.2","11.6"
"Jeff Davis","2020-12-02","6","1819","0","207","7.2","11.6"
"Jeff Davis","2020-12-03","13","1832","0","207","7.2","8.8"
"Jeff Davis","2020-12-04","13","1845","0","207","4.6","7"
"Jeff Davis","2020-12-05","4","1849","0","207","3.1","5.2"
"Jeff Davis","2020-12-06","4","1853","1","208","6.7","7"
"Jeff Davis","2020-12-07","10","1863","4","212","9.3","9.1"
"Jeff Davis","2020-12-08","27","1890","3","215","10.9","9"
"Jeff Davis","2020-12-09","9","1899","4","219","17.2","12.2"
"Jeff Davis","2020-12-10","24","1923","5","224","20.2","13.7"
"Jeff Davis","2020-12-11","15","1938","2","226","22.1","13.3"
"Jeff Davis","2020-12-12","13","1951","5","231","27.6","15.4"
"Jeff Davis","2020-12-13","1","1952","1","232","38.3","22.5"
"Jeff Davis","2020-12-14","16","1968","1","233","33.5","21.4"
"Jeff Davis","2020-12-15","44","2012","8","241","34.5","22.7"
"Jeff Davis","2020-12-16","19","2031","2","243","29.7","23.4"
"Jeff Davis","2020-12-17","40","2071","6","249","28.8","24.5"
"Jeff Davis","2020-12-18","16","2087","5","254","31.4","26.7"
"Jeff Davis","2020-12-19","9","2096","2","256","29.1","28.3"
"Jeff Davis","2020-12-20","8","2104","2","258","18.3","28.3"
"Jeff Davis","2020-12-21","16","2120","5","263","21.9","27.7"
"Jeff Davis","2020-12-22","33","2153","8","271","22.8","28.6"
"Jeff Davis","2020-12-23","13","2166","1","272","22.4","26"
"Jeff Davis","2020-12-24","13","2179","4","276","24.6","26.7"
"Jeff Davis","2020-12-25","0","2179","0","276","20.2","25.8"
"Jeff Davis","2020-12-26","12","2191","7","283","25.3","27.2"
"Jeff Davis","2020-12-27","6","2197","3","286","28.9","23.6"
"Jeff Davis","2020-12-28","23","2220","6","292","28.2","25"
"Jeff Davis","2020-12-29","43","2263","10","302","28","25.4"
"Jeff Davis","2020-12-30","31","2294","8","310","30.6","26.5"
"Jeff Davis","2020-12-31","38","2332","10","320","30","27.3"
"Jeff Davis","2021-01-01","1","2333","0","320","30","25.1"
"Jeff Davis","2021-01-02","21","2354","5","325","25","25.2"
"Jeff Davis","2021-01-03","8","2362","5","330","26.8","27.9"
"Jeff Davis","2021-01-04","38","2400","13","343","28","28.1"
"Jeff Davis","2021-01-05","79","2479","19","362","28.1","28.1"
"Jeff Davis","2021-01-06","19","2498","6","368","28.9","29.8"
"Jeff Davis","2021-01-07","38","2536","8","376","28.2","29.1"
"Jeff Davis","2021-01-08","15","2551","4","380","32","31"
"Jeff Davis","2021-01-09","12","2563","3","383","32.2","28.6"
"Jeff Davis","2021-01-10","10","2573","2","385","26.1","26.5"
"Jeff Davis","2021-01-11","18","2591","3","388","23.6","25.8"
"Jeff Davis","2021-01-12","51","2642","10","398","22.9","25.5"
"Jeff Davis","2021-01-13","17","2659","2","400","20.1","24.5"
"Jeff Davis","2021-01-14","32","2691","6","406","19.8","24"
"Jeff Davis","2021-01-15","27","2718","4","410","18.1","25"
"Jeff Davis","2021-01-16","11","2729","3","413","18.4","25.3"
"Jeff Davis","2021-01-17","13","2742","6","419","22.1","24.1"
"Jeff Davis","2021-01-18","17","2759","2","421","21.4","22.5"
"Jeff Davis","2021-01-19","19","2778","5","426","22.4","22.7"
"Jeff Davis","2021-01-20","15","2793","4","430","24.5","22.3"
"Jeff Davis","2021-01-21","23","2816","3","433","23.7","21.7"
"Jeff Davis","2021-01-22","18","2834","6","439","26.4","22.2"
"Jeff Davis","2021-01-23","12","2846","4","443","27.2","22.8"
"Jeff Davis","2021-01-24","10","2856","3","446","24.9","23.5"
"Jeff Davis","2021-01-25","21","2877","6","452","27.3","24.4"
"Jeff Davis","2021-01-26","21","2898","7","459","28.3","25.4"
"Jeff Davis","2021-01-27","27","2925","4","463","26.6","25.6"
"Jeff Davis","2021-01-28","44","2969","3","466","25.7","24.7"
"Jeff Davis","2021-01-29","16","2985","5","471","25.4","25.9"
"Jeff Davis","2021-01-30","12","2997","2","473","23.1","25.1"
"Jeff Davis","2021-01-31","10","3007","2","475","21.6","23.3"
"Jeff Davis","2021-02-01","16","3023","3","478","20.2","23.8"
"Jeff Davis","2021-02-02","20","3043","0","478","15.5","21.9"
"Jeff Davis","2021-02-03","14","3057","0","478","13.4","20"
"Jeff Davis","2021-02-04","20","3077","0","478","12.4","19.1"
"Jeff Davis","2021-02-05","6","3083","0","478","7.9","16.7"
"Jeff Davis","2021-02-06","2","3085","0","478","5.5","14.3"
"Jeff Davis","2021-02-07","0","3085","0","478","2.7","12.2"
"Jeff Davis","2021-02-08","0","3085","0","478","0","10.1"
"Jefferson","2020-02-01","0","0","0","0",".","."
"Jefferson","2020-02-02","0","0","0","0",".","."
"Jefferson","2020-02-03","0","0","0","0",".","."
"Jefferson","2020-02-04","0","0","0","0",".","."
"Jefferson","2020-02-05","0","0","0","0",".","."
"Jefferson","2020-02-06","0","0","0","0",".","."
"Jefferson","2020-02-07","0","0","0","0","0","."
"Jefferson","2020-02-08","0","0","0","0","0","."
"Jefferson","2020-02-09","0","0","0","0","0","."
"Jefferson","2020-02-10","0","0","0","0","0","."
"Jefferson","2020-02-11","0","0","0","0","0","."
"Jefferson","2020-02-12","0","0","0","0","0","."
"Jefferson","2020-02-13","0","0","0","0","0","."
"Jefferson","2020-02-14","0","0","0","0","0","0"
"Jefferson","2020-02-15","0","0","0","0","0","0"
"Jefferson","2020-02-16","0","0","0","0","0","0"
"Jefferson","2020-02-17","0","0","0","0","0","0"
"Jefferson","2020-02-18","0","0","0","0","0","0"
"Jefferson","2020-02-19","0","0","0","0","0","0"
"Jefferson","2020-02-20","0","0","0","0","0","0"
"Jefferson","2020-02-21","0","0","0","0","0","0"
"Jefferson","2020-02-22","0","0","0","0","0","0"
"Jefferson","2020-02-23","0","0","0","0","0","0"
"Jefferson","2020-02-24","0","0","0","0","0","0"
"Jefferson","2020-02-25","0","0","0","0","0","0"
"Jefferson","2020-02-26","0","0","0","0","0","0"
"Jefferson","2020-02-27","0","0","0","0","0","0"
"Jefferson","2020-02-28","0","0","0","0","0","0"
"Jefferson","2020-02-29","0","0","0","0","0","0"
"Jefferson","2020-03-01","0","0","0","0","0","0"
"Jefferson","2020-03-02","0","0","0","0","0","0"
"Jefferson","2020-03-03","0","0","0","0","0","0"
"Jefferson","2020-03-04","0","0","0","0","0","0"
"Jefferson","2020-03-05","0","0","0","0","0","0"
"Jefferson","2020-03-06","0","0","0","0","0","0"
"Jefferson","2020-03-07","0","0","0","0","0","0"
"Jefferson","2020-03-08","0","0","0","0","0","0"
"Jefferson","2020-03-09","0","0","0","0","0","0"
"Jefferson","2020-03-10","0","0","0","0","0","0"
"Jefferson","2020-03-11","0","0","0","0","0","0"
"Jefferson","2020-03-12","0","0","0","0","0","0"
"Jefferson","2020-03-13","0","0","0","0","0","0"
"Jefferson","2020-03-14","0","0","0","0","0","0"
"Jefferson","2020-03-15","0","0","0","0","0","0"
"Jefferson","2020-03-16","1","1","0","0","0","0"
"Jefferson","2020-03-17","3","4","0","0","0","0"
"Jefferson","2020-03-18","1","5","0","0","0","0"
"Jefferson","2020-03-19","2","7","1","1","7.1","3.6"
"Jefferson","2020-03-20","1","8","0","1","7.1","3.6"
"Jefferson","2020-03-21","1","9","0","1","7.1","3.6"
"Jefferson","2020-03-22","2","11","0","1","7.1","3.6"
"Jefferson","2020-03-23","1","12","0","1","7.1","3.6"
"Jefferson","2020-03-24","2","14","0","1","7.1","3.6"
"Jefferson","2020-03-25","0","14","0","1","7.1","3.6"
"Jefferson","2020-03-26","1","15","0","1","0","3.6"
"Jefferson","2020-03-27","2","17","0","1","0","3.6"
"Jefferson","2020-03-28","0","17","0","1","0","3.6"
"Jefferson","2020-03-29","0","17","0","1","0","3.6"
"Jefferson","2020-03-30","2","19","0","1","0","3.6"
"Jefferson","2020-03-31","1","20","0","1","0","3.6"
"Jefferson","2020-04-01","3","23","0","1","0","3.6"
"Jefferson","2020-04-02","2","25","0","1","0","0"
"Jefferson","2020-04-03","1","26","0","1","0","0"
"Jefferson","2020-04-04","2","28","1","2","7.1","3.6"
"Jefferson","2020-04-05","0","28","0","2","7.1","3.6"
"Jefferson","2020-04-06","4","32","1","3","10.7","5.4"
"Jefferson","2020-04-07","3","35","0","3","10.7","5.4"
"Jefferson","2020-04-08","6","41","1","4","13.1","6.5"
"Jefferson","2020-04-09","4","45","0","4","13.1","6.5"
"Jefferson","2020-04-10","1","46","0","4","13.1","6.5"
"Jefferson","2020-04-11","5","51","0","4","6","6.5"
"Jefferson","2020-04-12","2","53","0","4","6","6.5"
"Jefferson","2020-04-13","4","57","1","5","6","8.3"
"Jefferson","2020-04-14","5","62","0","5","6","8.3"
"Jefferson","2020-04-15","6","68","1","6","6","9.5"
"Jefferson","2020-04-16","2","70","0","6","6","9.5"
"Jefferson","2020-04-17","2","72","0","6","6","9.5"
"Jefferson","2020-04-18","1","73","0","6","6","6"
"Jefferson","2020-04-19","1","74","0","6","6","6"
"Jefferson","2020-04-20","7","81","1","7","4.4","5.2"
"Jefferson","2020-04-21","15","96","1","8","5.4","5.7"
"Jefferson","2020-04-22","5","101","0","8","3","4.5"
"Jefferson","2020-04-23","9","110","0","8","3","4.5"
"Jefferson","2020-04-24","4","114","0","8","3","4.5"
"Jefferson","2020-04-25","11","125","0","8","3","4.5"
"Jefferson","2020-04-26","1","126","0","8","3","4.5"
"Jefferson","2020-04-27","4","130","0","8","1","2.7"
"Jefferson","2020-04-28","7","137","0","8","0","2.7"
"Jefferson","2020-04-29","4","141","0","8","0","1.5"
"Jefferson","2020-04-30","13","154","0","8","0","1.5"
"Jefferson","2020-05-01","6","160","0","8","0","1.5"
"Jefferson","2020-05-02","1","161","0","8","0","1.5"
"Jefferson","2020-05-03","2","163","0","8","0","1.5"
"Jefferson","2020-05-04","14","177","0","8","0","0.5"
"Jefferson","2020-05-05","6","183","0","8","0","0"
"Jefferson","2020-05-06","17","200","2","10","1.7","0.8"
"Jefferson","2020-05-07","3","203","0","10","1.7","0.8"
"Jefferson","2020-05-08","4","207","0","10","1.7","0.8"
"Jefferson","2020-05-09","4","211","0","10","1.7","0.8"
"Jefferson","2020-05-10","2","213","0","10","1.7","0.8"
"Jefferson","2020-05-11","8","221","0","10","1.7","0.8"
"Jefferson","2020-05-12","8","229","0","10","1.7","0.8"
"Jefferson","2020-05-13","9","238","1","11","1.6","1.6"
"Jefferson","2020-05-14","18","256","4","15","4.8","3.2"
"Jefferson","2020-05-15","7","263","0","15","4.8","3.2"
"Jefferson","2020-05-16","13","276","2","17","7","4.3"
"Jefferson","2020-05-17","0","276","0","17","7","4.3"
"Jefferson","2020-05-18","12","288","0","17","7","4.3"
"Jefferson","2020-05-19","15","303","2","19","8.9","5.3"
"Jefferson","2020-05-20","9","312","0","19","7.3","4.4"
"Jefferson","2020-05-21","4","316","0","19","4.1","4.4"
"Jefferson","2020-05-22","39","355","0","19","4.1","4.4"
"Jefferson","2020-05-23","5","360","2","21","7.6","7.3"
"Jefferson","2020-05-24","2","362","0","21","7.6","7.3"
"Jefferson","2020-05-25","1","363","0","21","7.6","7.3"
"Jefferson","2020-05-26","82","445","0","21","5.7","7.3"
"Jefferson","2020-05-27","11","456","2","23","8.3","7.8"
"Jefferson","2020-05-28","9","465","1","24","9.9","7"
"Jefferson","2020-05-29","8","473","1","25","11.7","7.9"
"Jefferson","2020-05-30","1","474","0","25","6","6.8"
"Jefferson","2020-05-31","2","476","0","25","6","6.8"
"Jefferson","2020-06-01","13","489","1","26","7.1","7.3"
"Jefferson","2020-06-02","13","502","0","26","7.1","6.4"
"Jefferson","2020-06-03","6","508","0","26","4.5","6.4"
"Jefferson","2020-06-04","15","523","1","27","3.8","6.9"
"Jefferson","2020-06-05","3","526","0","27","2.1","6.9"
"Jefferson","2020-06-06","3","529","0","27","2.1","4"
"Jefferson","2020-06-07","2","531","0","27","2.1","4"
"Jefferson","2020-06-08","6","537","1","28","3.3","5.2"
"Jefferson","2020-06-09","5","542","1","29","6.2","6.6"
"Jefferson","2020-06-10","11","553","1","30","7.5","6"
"Jefferson","2020-06-11","6","559","0","30","6.5","5.2"
"Jefferson","2020-06-12","10","569","1","31","8","5"
"Jefferson","2020-06-13","8","577","2","33","11.5","6.8"
"Jefferson","2020-06-14","7","584","1","34","13.6","7.8"
"Jefferson","2020-06-15","17","601","2","36","12.9","8.1"
"Jefferson","2020-06-16","16","617","6","42","15.4","10.8"
"Jefferson","2020-06-17","20","637","3","45","16.2","11.9"
"Jefferson","2020-06-18","5","642","0","45","16.2","11.4"
"Jefferson","2020-06-19","7","649","1","46","16.8","12.4"
"Jefferson","2020-06-20","6","655","0","46","13.3","12.4"
"Jefferson","2020-06-21","3","658","0","46","11.2","12.4"
"Jefferson","2020-06-22","23","681","5","51","12.6","12.8"
"Jefferson","2020-06-23","21","702","3","54","9.3","12.4"
"Jefferson","2020-06-24","21","723","6","60","11.3","13.7"
"Jefferson","2020-06-25","19","742","3","63","13.5","14.9"
"Jefferson","2020-06-26","19","761","2","65","13","14.9"
"Jefferson","2020-06-27","13","774","4","69","17.4","15.3"
"Jefferson","2020-06-28","7","781","1","70","19.4","15.3"
"Jefferson","2020-06-29","39","820","7","77","18.9","15.8"
"Jefferson","2020-06-30","30","850","7","84","20.2","14.8"
"Jefferson","2020-07-01","146","996","22","106","18.2","14.8"
"Jefferson","2020-07-02","19","1015","7","113","21.3","17.4"
"Jefferson","2020-07-03","15","1030","5","118","24.5","18.7"
"Jefferson","2020-07-04","13","1043","1","119","21.2","19.3"
"Jefferson","2020-07-05","13","1056","2","121","21.4","20.4"
"Jefferson","2020-07-06","33","1089","6","127","21.4","20.1"
"Jefferson","2020-07-07","47","1136","11","138","21.4","20.8"
"Jefferson","2020-07-08","41","1177","3","141","20.3","19.3"
"Jefferson","2020-07-09","42","1219","11","152","18.8","20"
"Jefferson","2020-07-10","41","1260","10","162","17.5","21"
"Jefferson","2020-07-11","22","1282","6","168","20.3","20.8"
"Jefferson","2020-07-12","25","1307","13","181","25.5","23.5"
"Jefferson","2020-07-13","50","1357","14","195","26.9","24.2"
"Jefferson","2020-07-14","42","1399","11","206","27.3","24.4"
"Jefferson","2020-07-15","42","1441","10","216","29.7","25"
"Jefferson","2020-07-16","35","1476","8","224","29.2","24"
"Jefferson","2020-07-17","46","1522","3","227","26.7","22.1"
"Jefferson","2020-07-18","17","1539","3","230","25.3","22.8"
"Jefferson","2020-07-19","13","1552","4","234","22.3","23.9"
"Jefferson","2020-07-20","24","1576","6","240","21.8","24.4"
"Jefferson","2020-07-21","38","1614","5","245","20","23.7"
"Jefferson","2020-07-22","21","1635","7","252","21.3","25.5"
"Jefferson","2020-07-23","33","1668","12","264","23.3","26.2"
"Jefferson","2020-07-24","24","1692","2","266","23.5","25.1"
"Jefferson","2020-07-25","17","1709","4","270","24.4","24.8"
"Jefferson","2020-07-26","7","1716","0","270","20","21.1"
"Jefferson","2020-07-27","32","1748","10","280","20.9","21.3"
"Jefferson","2020-07-28","27","1775","9","289","23.7","21.9"
"Jefferson","2020-07-29","26","1801","7","296","22.8","22.1"
"Jefferson","2020-07-30","27","1828","8","304","21.9","22.6"
"Jefferson","2020-07-31","28","1856","12","316","26.8","25.2"
"Jefferson","2020-08-01","10","1866","5","321","30.6","27.5"
"Jefferson","2020-08-02","12","1878","2","323","33","26.5"
"Jefferson","2020-08-03","19","1897","6","329","33","26.9"
"Jefferson","2020-08-04","20","1917","6","335","32.5","28.1"
"Jefferson","2020-08-05","102","2019","7","342","29.7","26.2"
"Jefferson","2020-08-06","27","2046","4","346","27.5","24.7"
"Jefferson","2020-08-07","51","2097","12","358","24.8","25.8"
"Jefferson","2020-08-08","10","2107","0","358","17.6","24.1"
"Jefferson","2020-08-09","40","2147","3","361","16.3","24.6"
"Jefferson","2020-08-10","24","2171","9","370","17.2","25.1"
"Jefferson","2020-08-11","28","2199","5","375","15.4","24"
"Jefferson","2020-08-12","31","2230","3","378","15.8","22.7"
"Jefferson","2020-08-13","114","2344","14","392","15.5","21.5"
"Jefferson","2020-08-14","38","2382","11","403","16.3","20.5"
"Jefferson","2020-08-15","8","2390","2","405","19.8","18.7"
"Jefferson","2020-08-16","14","2404","5","410","23.9","20.1"
"Jefferson","2020-08-17","27","2431","4","414","20.6","18.9"
"Jefferson","2020-08-18","16","2447","2","416","19.8","17.6"
"Jefferson","2020-08-19","29","2476","5","421","20.9","18.4"
"Jefferson","2020-08-20","73","2549","10","431","21.1","18.3"
"Jefferson","2020-08-21","67","2616","2","433","17.4","16.8"
"Jefferson","2020-08-22","12","2628","0","433","13.9","16.8"
"Jefferson","2020-08-23","4","2632","0","433","8.7","16.3"
"Jefferson","2020-08-24","16","2648","5","438","11.1","15.9"
"Jefferson","2020-08-25","15","2663","4","442","13.1","16.5"
"Jefferson","2020-08-26","18","2681","9","451","17.8","19.4"
"Jefferson","2020-08-27","61","2742","9","460","18","19.5"
"Jefferson","2020-08-28","39","2781","4","464","19","18.2"
"Jefferson","2020-08-29","21","2802","4","468","21.7","17.8"
"Jefferson","2020-08-30","22","2824","4","472","24.3","16.5"
"Jefferson","2020-08-31","25","2849","7","479","23.8","17.5"
"Jefferson","2020-09-01","30","2879","12","491","25.7","19.4"
"Jefferson","2020-09-02","96","2975","8","499","19.8","18.8"
"Jefferson","2020-09-03","41","3016","4","503","19.1","18.5"
"Jefferson","2020-09-04","30","3046","3","506","19","19"
"Jefferson","2020-09-05","16","3062","2","508","18.1","19.9"
"Jefferson","2020-09-06","8","3070","3","511","20.9","22.6"
"Jefferson","2020-09-07","12","3082","4","515","21.6","22.7"
"Jefferson","2020-09-08","27","3109","6","521","19.1","22.4"
"Jefferson","2020-09-09","18","3127","4","525","21.1","20.4"
"Jefferson","2020-09-10","24","3151","5","530","22.7","20.9"
"Jefferson","2020-09-11","16","3167","0","530","21.2","20.1"
"Jefferson","2020-09-12","14","3181","3","533","22.5","20.3"
"Jefferson","2020-09-13","7","3188","0","533","17.1","19"
"Jefferson","2020-09-14","30","3218","6","539","15.2","18.4"
"Jefferson","2020-09-15","28","3246","3","542","13.6","16.3"
"Jefferson","2020-09-16","18","3264","1","543","11.2","16.1"
"Jefferson","2020-09-17","16","3280","4","547","11.8","17.2"
"Jefferson","2020-09-18","18","3298","8","555","18.2","19.7"
"Jefferson","2020-09-19","53","3351","2","557","15.6","19.1"
"Jefferson","2020-09-20","11","3362","0","557","15.6","16.4"
"Jefferson","2020-09-21","21","3383","3","560","14.8","15"
"Jefferson","2020-09-22","18","3401","4","564","16.5","15"
"Jefferson","2020-09-23","14","3415","3","567","18.7","15"
"Jefferson","2020-09-24","48","3463","5","572","16.7","14.2"
"Jefferson","2020-09-25","20","3483","3","575","12.4","15.3"
"Jefferson","2020-09-26","13","3496","2","577","14.1","14.9"
"Jefferson","2020-09-27","2","3498","0","577","14.1","14.9"
"Jefferson","2020-09-28","22","3520","5","582","15.3","15.1"
"Jefferson","2020-09-29","29","3549","6","588","15.1","15.8"
"Jefferson","2020-09-30","22","3571","1","589","12.7","15.7"
"Jefferson","2020-10-01","107","3678","2","591","11.5","14.1"
"Jefferson","2020-10-02","55","3733","2","593","9.8","11.1"
"Jefferson","2020-10-03","17","3750","1","594","8.5","11.3"
"Jefferson","2020-10-04","4","3754","0","594","8.5","11.3"
"Jefferson","2020-10-05","21","3775","2","596","6.6","11"
"Jefferson","2020-10-06","42","3817","1","597","4","9.5"
"Jefferson","2020-10-07","63","3880","1","598","3.6","8.1"
"Jefferson","2020-10-08","40","3920","1","599","3.6","7.6"
"Jefferson","2020-10-09","62","3982","1","600","3.4","6.6"
"Jefferson","2020-10-10","22","4004","0","600","2.5","5.5"
"Jefferson","2020-10-11","6","4010","0","600","2.5","5.5"
"Jefferson","2020-10-12","30","4040","3","603","2.6","4.6"
"Jefferson","2020-10-13","44","4084","1","604","2.6","3.3"
"Jefferson","2020-10-14","19","4103","1","605","3.1","3.3"
"Jefferson","2020-10-15","53","4156","1","606","3","3.3"
"Jefferson","2020-10-16","41","4197","4","610","4.2","3.8"
"Jefferson","2020-10-17","5","4202","1","611","7","4.8"
"Jefferson","2020-10-18","5","4207","0","611","7","4.8"
"Jefferson","2020-10-19","28","4235","2","613","6.6","4.6"
"Jefferson","2020-10-20","24","4259","1","614","6.9","4.7"
"Jefferson","2020-10-21","18","4277","3","617","8.5","5.8"
"Jefferson","2020-10-22","33","4310","2","619","9.1","6.1"
"Jefferson","2020-10-23","20","4330","2","621","9.1","6.7"
"Jefferson","2020-10-24","13","4343","0","621","6.3","6.7"
"Jefferson","2020-10-25","7","4350","1","622","8.3","7.7"
"Jefferson","2020-10-26","36","4386","1","623","7.7","7.2"
"Jefferson","2020-10-27","25","4411","1","624","7.7","7.3"
"Jefferson","2020-10-28","16","4427","1","625","6.2","7.4"
"Jefferson","2020-10-29","18","4445","0","625","5.3","7.2"
"Jefferson","2020-10-30","18","4463","1","626","4.7","6.9"
"Jefferson","2020-10-31","9","4472","0","626","4.7","5.5"
"Jefferson","2020-11-01","3","4475","1","627","7.4","7.9"
"Jefferson","2020-11-02","22","4497","2","629","8.3","8"
"Jefferson","2020-11-03","20","4517","2","631","9.2","8.4"
"Jefferson","2020-11-04","12","4529","3","634","11.9","9"
"Jefferson","2020-11-05","66","4595","10","644","14","9.7"
"Jefferson","2020-11-06","27","4622","4","648","15.3","10"
"Jefferson","2020-11-07","19","4641","3","651","17.6","11.1"
"Jefferson","2020-11-08","98","4739","2","653","13.1","10.3"
"Jefferson","2020-11-09","56","4795","4","657","12.8","10.6"
"Jefferson","2020-11-10","34","4829","7","664","14.4","11.8"
"Jefferson","2020-11-11","47","4876","4","668","12","11.9"
"Jefferson","2020-11-12","45","4921","4","672","11.1","12.6"
"Jefferson","2020-11-13","22","4943","5","677","12.2","13.8"
"Jefferson","2020-11-14","14","4957","3","680","13","15.3"
"Jefferson","2020-11-15","8","4965","1","681","14.5","13.8"
"Jefferson","2020-11-16","32","4997","7","688","16.6","14.7"
"Jefferson","2020-11-17","39","5036","6","694","15.9","15.1"
"Jefferson","2020-11-18","34","5070","4","698","16.4","14.2"
"Jefferson","2020-11-19","49","5119","4","702","16.3","13.7"
"Jefferson","2020-11-20","30","5149","4","706","14.9","13.6"
"Jefferson","2020-11-21","10","5159","2","708","14.7","13.9"
"Jefferson","2020-11-22","8","5167","0","708","12.9","13.7"
"Jefferson","2020-11-23","25","5192","1","709","10.4","13.5"
"Jefferson","2020-11-24","43","5235","7","716","10.5","13.2"
"Jefferson","2020-11-25","11","5246","0","716","8.8","12.6"
"Jefferson","2020-11-26","6","5252","2","718","12.4","14.3"
"Jefferson","2020-11-27","44","5296","3","721","11.5","13.2"
"Jefferson","2020-11-28","7","5303","0","721","8.6","11.7"
"Jefferson","2020-11-29","7","5310","0","721","8.6","10.8"
"Jefferson","2020-11-30","45","5355","12","733","11.9","11.1"
"Jefferson","2020-12-01","56","5411","5","738","10.8","10.7"
"Jefferson","2020-12-02","30","5441","9","747","15.1","12"
"Jefferson","2020-12-03","66","5507","5","752","11.4","11.9"
"Jefferson","2020-12-04","54","5561","1","753","10.7","11.1"
"Jefferson","2020-12-05","15","5576","3","756","13.6","11.1"
"Jefferson","2020-12-06","8","5584","1","757","15.4","12"
"Jefferson","2020-12-07","35","5619","5","762","13.6","12.7"
"Jefferson","2020-12-08","60","5679","5","767","13.5","12.2"
"Jefferson","2020-12-09","36","5715","4","771","10.8","13"
"Jefferson","2020-12-10","39","5754","5","776","11.6","11.5"
"Jefferson","2020-12-11","60","5814","6","782","12.7","11.7"
"Jefferson","2020-12-12","17","5831","2","784","11.5","12.6"
"Jefferson","2020-12-13","9","5840","3","787","14.5","14.9"
"Jefferson","2020-12-14","44","5884","16","803","17.7","15.6"
"Jefferson","2020-12-15","69","5953","8","811","18.1","15.8"
"Jefferson","2020-12-16","36","5989","5","816","18.5","14.7"
"Jefferson","2020-12-17","42","6031","6","822","18.7","15.2"
"Jefferson","2020-12-18","45","6076","4","826","18.6","15.7"
"Jefferson","2020-12-19","15","6091","4","830","20.7","16.1"
"Jefferson","2020-12-20","10","6101","3","833","20.2","17.4"
"Jefferson","2020-12-21","48","6149","8","841","17.4","17.6"
"Jefferson","2020-12-22","63","6212","12","853","18.5","18.3"
"Jefferson","2020-12-23","31","6243","7","860","19.7","19.1"
"Jefferson","2020-12-24","28","6271","6","866","20.8","19.8"
"Jefferson","2020-12-25","8","6279","1","867","21.3","19.9"
"Jefferson","2020-12-26","12","6291","4","871","22.2","21.5"
"Jefferson","2020-12-27","12","6303","1","872","19.1","19.7"
"Jefferson","2020-12-28","51","6354","12","884","20.1","18.8"
"Jefferson","2020-12-29","51","6405","12","896","20.7","19.6"
"Jefferson","2020-12-30","29","6434","8","904","21.5","20.6"
"Jefferson","2020-12-31","46","6480","11","915","21.8","21.3"
"Jefferson","2021-01-01","4","6484","0","915","20","20.7"
"Jefferson","2021-01-02","20","6504","8","923","21","21.6"
"Jefferson","2021-01-03","11","6515","5","928","26.3","22.7"
"Jefferson","2021-01-04","24","6539","6","934","26.5","23.3"
"Jefferson","2021-01-05","58","6597","11","945","25.8","23.3"
"Jefferson","2021-01-06","55","6652","16","961","26.1","23.8"
"Jefferson","2021-01-07","41","6693","18","979","28.9","25.4"
"Jefferson","2021-01-08","81","6774","16","995","31.7","25.9"
"Jefferson","2021-01-09","22","6796","8","1003","31.2","26.1"
"Jefferson","2021-01-10","10","6806","4","1007","30.4","28.4"
"Jefferson","2021-01-11","54","6860","21","1028","32.4","29.5"
"Jefferson","2021-01-12","183","7043","12","1040","30.7","28.2"
"Jefferson","2021-01-13","42","7085","11","1051","30.2","28.1"
"Jefferson","2021-01-14","45","7130","18","1069","29.7","29.3"
"Jefferson","2021-01-15","176","7306","19","1088","28.4","30.1"
"Jefferson","2021-01-16","29","7335","13","1101","29.6","30.4"
"Jefferson","2021-01-17","13","7348","1","1102","25","27.7"
"Jefferson","2021-01-18","33","7381","13","1115","25.1","28.7"
"Jefferson","2021-01-19","89","7470","13","1128","26.2","28.4"
"Jefferson","2021-01-20","43","7513","6","1134","24.5","27.4"
"Jefferson","2021-01-21","39","7552","3","1137","19.9","24.8"
"Jefferson","2021-01-22","72","7624","9","1146","20.1","24.2"
"Jefferson","2021-01-23","19","7643","4","1150","16.7","23.2"
"Jefferson","2021-01-24","8","7651","0","1150","15.6","20.3"
"Jefferson","2021-01-25","29","7680","9","1159","14.4","19.7"
"Jefferson","2021-01-26","97","7777","10","1169","13.8","20"
"Jefferson","2021-01-27","106","7883","5","1174","12.5","18.5"
"Jefferson","2021-01-28","71","7954","2","1176","11.8","15.8"
"Jefferson","2021-01-29","141","8095","4","1180","10.4","15.2"
"Jefferson","2021-01-30","22","8117","4","1184","10","13.3"
"Jefferson","2021-01-31","10","8127","2","1186","12.8","14.2"
"Jefferson","2021-02-01","28","8155","8","1194","12.5","13.4"
"Jefferson","2021-02-02","165","8320","13","1207","12.1","13"
"Jefferson","2021-02-03","26","8346","8","1215","15.9","14.2"
"Jefferson","2021-02-04","21","8367","7","1222","20.2","16"
"Jefferson","2021-02-05","48","8415","4","1226","21","15.7"
"Jefferson","2021-02-06","9","8424","1","1227","20","15"
"Jefferson","2021-02-07","0","8424","0","1227","17.1","15"
"Jefferson","2021-02-08","0","8424","0","1227","13.1","12.8"
"Jenkins","2020-02-01","0","0","0","0",".","."
"Jenkins","2020-02-02","0","0","0","0",".","."
"Jenkins","2020-02-03","0","0","0","0",".","."
"Jenkins","2020-02-04","0","0","0","0",".","."
"Jenkins","2020-02-05","0","0","0","0",".","."
"Jenkins","2020-02-06","0","0","0","0",".","."
"Jenkins","2020-02-07","0","0","0","0","0","."
"Jenkins","2020-02-08","0","0","0","0","0","."
"Jenkins","2020-02-09","0","0","0","0","0","."
"Jenkins","2020-02-10","0","0","0","0","0","."
"Jenkins","2020-02-11","0","0","0","0","0","."
"Jenkins","2020-02-12","0","0","0","0","0","."
"Jenkins","2020-02-13","0","0","0","0","0","."
"Jenkins","2020-02-14","0","0","0","0","0","0"
"Jenkins","2020-02-15","0","0","0","0","0","0"
"Jenkins","2020-02-16","0","0","0","0","0","0"
"Jenkins","2020-02-17","0","0","0","0","0","0"
"Jenkins","2020-02-18","0","0","0","0","0","0"
"Jenkins","2020-02-19","0","0","0","0","0","0"
"Jenkins","2020-02-20","0","0","0","0","0","0"
"Jenkins","2020-02-21","0","0","0","0","0","0"
"Jenkins","2020-02-22","0","0","0","0","0","0"
"Jenkins","2020-02-23","0","0","0","0","0","0"
"Jenkins","2020-02-24","0","0","0","0","0","0"
"Jenkins","2020-02-25","0","0","0","0","0","0"
"Jenkins","2020-02-26","0","0","0","0","0","0"
"Jenkins","2020-02-27","0","0","0","0","0","0"
"Jenkins","2020-02-28","0","0","0","0","0","0"
"Jenkins","2020-02-29","0","0","0","0","0","0"
"Jenkins","2020-03-01","0","0","0","0","0","0"
"Jenkins","2020-03-02","0","0","0","0","0","0"
"Jenkins","2020-03-03","0","0","0","0","0","0"
"Jenkins","2020-03-04","0","0","0","0","0","0"
"Jenkins","2020-03-05","0","0","0","0","0","0"
"Jenkins","2020-03-06","0","0","0","0","0","0"
"Jenkins","2020-03-07","0","0","0","0","0","0"
"Jenkins","2020-03-08","0","0","0","0","0","0"
"Jenkins","2020-03-09","0","0","0","0","0","0"
"Jenkins","2020-03-10","0","0","0","0","0","0"
"Jenkins","2020-03-11","2","2","0","0","0","0"
"Jenkins","2020-03-12","0","2","0","0","0","0"
"Jenkins","2020-03-13","3","5","0","0","0","0"
"Jenkins","2020-03-14","0","5","0","0","0","0"
"Jenkins","2020-03-15","0","5","0","0","0","0"
"Jenkins","2020-03-16","0","5","0","0","0","0"
"Jenkins","2020-03-17","2","7","1","1","7.1","3.6"
"Jenkins","2020-03-18","4","11","0","1","7.1","3.6"
"Jenkins","2020-03-19","2","13","0","1","7.1","3.6"
"Jenkins","2020-03-20","1","14","0","1","7.1","3.6"
"Jenkins","2020-03-21","1","15","0","1","7.1","3.6"
"Jenkins","2020-03-22","0","15","0","1","7.1","3.6"
"Jenkins","2020-03-23","0","15","0","1","7.1","3.6"
"Jenkins","2020-03-24","0","15","0","1","0","3.6"
"Jenkins","2020-03-25","0","15","0","1","0","3.6"
"Jenkins","2020-03-26","2","17","0","1","0","3.6"
"Jenkins","2020-03-27","3","20","0","1","0","3.6"
"Jenkins","2020-03-28","0","20","0","1","0","3.6"
"Jenkins","2020-03-29","0","20","0","1","0","3.6"
"Jenkins","2020-03-30","1","21","0","1","0","3.6"
"Jenkins","2020-03-31","3","24","1","2","4.8","2.4"
"Jenkins","2020-04-01","0","24","0","2","4.8","2.4"
"Jenkins","2020-04-02","5","29","1","3","7.6","3.8"
"Jenkins","2020-04-03","3","32","0","3","7.6","3.8"
"Jenkins","2020-04-04","1","33","1","4","21.9","11"
"Jenkins","2020-04-05","1","34","0","4","21.9","11"
"Jenkins","2020-04-06","11","45","2","6","24.5","12.3"
"Jenkins","2020-04-07","6","51","0","6","19.7","12.3"
"Jenkins","2020-04-08","6","57","1","7","22.1","13.4"
"Jenkins","2020-04-09","6","63","1","8","21.6","14.6"
"Jenkins","2020-04-10","2","65","0","8","21.6","14.6"
"Jenkins","2020-04-11","1","66","0","8","7.4","14.6"
"Jenkins","2020-04-12","1","67","0","8","7.4","14.6"
"Jenkins","2020-04-13","13","80","2","10","7","15.7"
"Jenkins","2020-04-14","2","82","0","10","7","13.3"
"Jenkins","2020-04-15","3","85","1","11","9.3","15.7"
"Jenkins","2020-04-16","3","88","0","11","7","14.3"
"Jenkins","2020-04-17","2","90","0","11","7","14.3"
"Jenkins","2020-04-18","0","90","0","11","7","7.2"
"Jenkins","2020-04-19","0","90","0","11","7","7.2"
"Jenkins","2020-04-20","6","96","1","12","7.1","7.1"
"Jenkins","2020-04-21","15","111","3","15","10","8.5"
"Jenkins","2020-04-22","6","117","0","15","5.2","7.3"
"Jenkins","2020-04-23","3","120","0","15","5.2","6.1"
"Jenkins","2020-04-24","7","127","0","15","5.2","6.1"
"Jenkins","2020-04-25","0","127","0","15","5.2","6.1"
"Jenkins","2020-04-26","1","128","0","15","5.2","6.1"
"Jenkins","2020-04-27","2","130","0","15","2.9","5"
"Jenkins","2020-04-28","7","137","0","15","0","5"
"Jenkins","2020-04-29","6","143","2","17","4.8","5"
"Jenkins","2020-04-30","2","145","0","17","4.8","5"
"Jenkins","2020-05-01","3","148","0","17","4.8","5"
"Jenkins","2020-05-02","0","148","0","17","4.8","5"
"Jenkins","2020-05-03","1","149","0","17","4.8","5"
"Jenkins","2020-05-04","5","154","0","17","4.8","3.8"
"Jenkins","2020-05-05","5","159","0","17","4.8","2.4"
"Jenkins","2020-05-06","4","163","0","17","0","2.4"
"Jenkins","2020-05-07","2","165","0","17","0","2.4"
"Jenkins","2020-05-08","6","171","1","18","2.4","3.6"
"Jenkins","2020-05-09","0","171","0","18","2.4","3.6"
"Jenkins","2020-05-10","1","172","1","19","16.7","10.7"
"Jenkins","2020-05-11","3","175","0","19","16.7","10.7"
"Jenkins","2020-05-12","5","180","0","19","16.7","10.7"
"Jenkins","2020-05-13","3","183","0","19","16.7","8.3"
"Jenkins","2020-05-14","2","185","0","19","16.7","8.3"
"Jenkins","2020-05-15","0","185","0","19","14.3","8.3"
"Jenkins","2020-05-16","3","188","0","19","14.3","8.3"
"Jenkins","2020-05-17","1","189","0","19","0","8.3"
"Jenkins","2020-05-18","2","191","1","20","7.1","11.9"
"Jenkins","2020-05-19","5","196","0","20","7.1","11.9"
"Jenkins","2020-05-20","3","199","0","20","7.1","11.9"
"Jenkins","2020-05-21","2","201","1","21","14.3","15.5"
"Jenkins","2020-05-22","4","205","0","21","14.3","14.3"
"Jenkins","2020-05-23","0","205","0","21","14.3","14.3"
"Jenkins","2020-05-24","0","205","0","21","14.3","7.1"
"Jenkins","2020-05-25","2","207","0","21","7.1","7.1"
"Jenkins","2020-05-26","2","209","0","21","7.1","7.1"
"Jenkins","2020-05-27","4","213","0","21","7.1","7.1"
"Jenkins","2020-05-28","1","214","0","21","0","7.1"
"Jenkins","2020-05-29","6","220","1","22","2.4","8.3"
"Jenkins","2020-05-30","0","220","0","22","2.4","8.3"
"Jenkins","2020-05-31","2","222","0","22","2.4","8.3"
"Jenkins","2020-06-01","5","227","2","24","8.1","7.6"
"Jenkins","2020-06-02","6","233","2","26","12.9","10"
"Jenkins","2020-06-03","2","235","2","28","27.1","17.1"
"Jenkins","2020-06-04","6","241","2","30","31.9","16"
"Jenkins","2020-06-05","6","247","1","31","31.9","17.1"
"Jenkins","2020-06-06","0","247","0","31","31.9","17.1"
"Jenkins","2020-06-07","0","247","0","31","31.9","17.1"
"Jenkins","2020-06-08","5","252","0","31","26.2","17.1"
"Jenkins","2020-06-09","11","263","3","34","25.3","19.1"
"Jenkins","2020-06-10","5","268","0","34","11","19.1"
"Jenkins","2020-06-11","4","272","0","34","6.3","19.1"
"Jenkins","2020-06-12","3","275","1","35","8.7","20.3"
"Jenkins","2020-06-13","4","279","1","36","12.2","22.1"
"Jenkins","2020-06-14","2","281","0","36","12.2","22.1"
"Jenkins","2020-06-15","8","289","1","37","14","20.1"
"Jenkins","2020-06-16","12","301","0","37","10.1","17.7"
"Jenkins","2020-06-17","3","304","3","40","24.4","17.7"
"Jenkins","2020-06-18","2","306","1","41","31.5","18.9"
"Jenkins","2020-06-19","7","313","2","43","30.9","19.8"
"Jenkins","2020-06-20","2","315","0","43","27.3","19.8"
"Jenkins","2020-06-21","1","316","1","44","41.6","26.9"
"Jenkins","2020-06-22","14","330","3","47","42.9","28.4"
"Jenkins","2020-06-23","16","346","5","52","47.3","28.7"
"Jenkins","2020-06-24","12","358","3","55","36.6","30.5"
"Jenkins","2020-06-25","10","368","1","56","30.9","31.2"
"Jenkins","2020-06-26","11","379","0","56","26.8","28.8"
"Jenkins","2020-06-27","2","381","1","57","34","30.6"
"Jenkins","2020-06-28","3","384","0","57","19.7","30.6"
"Jenkins","2020-06-29","18","402","2","59","18.2","30.5"
"Jenkins","2020-06-30","18","420","2","61","15.3","31.3"
"Jenkins","2020-07-01","17","437","0","61","11.7","24.2"
"Jenkins","2020-07-02","9","446","1","62","11.9","21.4"
"Jenkins","2020-07-03","0","446","0","62","11.9","19.4"
"Jenkins","2020-07-04","1","447","0","62","4.8","19.4"
"Jenkins","2020-07-05","3","450","0","62","4.8","12.2"
"Jenkins","2020-07-06","12","462","3","65","6.7","12.5"
"Jenkins","2020-07-07","15","477","2","67","7.1","11.2"
"Jenkins","2020-07-08","7","484","3","70","13.2","12.5"
"Jenkins","2020-07-09","99","583","7","77","12.6","12.3"
"Jenkins","2020-07-10","14","597","1","78","13.6","12.8"
"Jenkins","2020-07-11","4","601","1","79","17.2","11"
"Jenkins","2020-07-12","1","602","0","79","17.2","11"
"Jenkins","2020-07-13","54","656","3","82","14.4","10.6"
"Jenkins","2020-07-14","7","663","2","84","16.6","11.8"
"Jenkins","2020-07-15","11","674","3","87","14.4","13.8"
"Jenkins","2020-07-16","8","682","2","89","16.9","14.8"
"Jenkins","2020-07-17","7","689","0","89","15.9","14.8"
"Jenkins","2020-07-18","2","691","0","89","12.3","14.8"
"Jenkins","2020-07-19","0","691","0","89","12.3","14.8"
"Jenkins","2020-07-20","93","784","3","92","12","13.2"
"Jenkins","2020-07-21","9","793","3","95","12.7","14.6"
"Jenkins","2020-07-22","5","798","0","95","8.8","11.6"
"Jenkins","2020-07-23","5","803","1","96","8.1","12.5"
"Jenkins","2020-07-24","5","808","0","96","8.1","12"
"Jenkins","2020-07-25","1","809","0","96","8.1","10.2"
"Jenkins","2020-07-26","1","810","1","97","22.4","17.4"
"Jenkins","2020-07-27","69","879","6","103","23.1","17.6"
"Jenkins","2020-07-28","10","889","0","103","18.4","15.5"
"Jenkins","2020-07-29","5","894","2","105","24.1","16.4"
"Jenkins","2020-07-30","7","901","0","105","21.2","14.7"
"Jenkins","2020-07-31","7","908","1","106","23.3","15.7"
"Jenkins","2020-08-01","5","913","1","107","26.1","17.1"
"Jenkins","2020-08-02","2","915","0","107","11.9","17.1"
"Jenkins","2020-08-03","55","970","8","115","12.7","17.9"
"Jenkins","2020-08-04","6","976","0","115","12.7","15.5"
"Jenkins","2020-08-05","9","985","1","116","8.6","16.3"
"Jenkins","2020-08-06","6","991","2","118","13.3","17.3"
"Jenkins","2020-08-07","9","1000","0","118","11.3","17.3"
"Jenkins","2020-08-08","57","1057","6","124","9.9","18"
"Jenkins","2020-08-09","7","1064","4","128","18.1","15"
"Jenkins","2020-08-10","46","1110","7","135","18.2","15.4"
"Jenkins","2020-08-11","7","1117","0","135","18.2","15.4"
"Jenkins","2020-08-12","23","1140","3","138","18.5","13.5"
"Jenkins","2020-08-13","25","1165","1","139","14.3","13.8"
"Jenkins","2020-08-14","8","1173","0","139","14.3","12.8"
"Jenkins","2020-08-15","7","1180","2","141","16.9","13.4"
"Jenkins","2020-08-16","9","1189","0","141","8.7","13.4"
"Jenkins","2020-08-17","10","1199","4","145","12.2","15.2"
"Jenkins","2020-08-18","3","1202","1","146","17","17.6"
"Jenkins","2020-08-19","29","1231","0","146","15.1","16.8"
"Jenkins","2020-08-20","4","1235","0","146","14.6","14.4"
"Jenkins","2020-08-21","39","1274","0","146","14.6","14.4"
"Jenkins","2020-08-22","4","1278","2","148","17.6","17.2"
"Jenkins","2020-08-23","1","1279","0","148","17.6","13.2"
"Jenkins","2020-08-24","33","1312","4","152","13.6","12.9"
"Jenkins","2020-08-25","11","1323","5","157","15.4","16.2"
"Jenkins","2020-08-26","11","1334","3","160","19.3","17.2"
"Jenkins","2020-08-27","10","1344","5","165","26.4","20.5"
"Jenkins","2020-08-28","7","1351","0","165","26.4","20.5"
"Jenkins","2020-08-29","3","1354","1","166","24","20.8"
"Jenkins","2020-08-30","4","1358","3","169","34.7","26.2"
"Jenkins","2020-08-31","69","1427","17","186","36.5","25.1"
"Jenkins","2020-09-01","9","1436","2","188","33.2","24.3"
"Jenkins","2020-09-02","19","1455","3","191","31.6","25.4"
"Jenkins","2020-09-03","22","1477","3","194","26.4","26.4"
"Jenkins","2020-09-04","11","1488","3","197","30.3","28.3"
"Jenkins","2020-09-05","8","1496","1","198","27.3","25.7"
"Jenkins","2020-09-06","1","1497","0","198","16.6","25.7"
"Jenkins","2020-09-07","3","1500","2","200","22.6","29.6"
"Jenkins","2020-09-08","23","1523","10","210","25.6","29.4"
"Jenkins","2020-09-09","7","1530","3","213","29.5","30.5"
"Jenkins","2020-09-10","5","1535","1","214","30.4","28.4"
"Jenkins","2020-09-11","15","1550","1","215","27.5","28.9"
"Jenkins","2020-09-12","6","1556","0","215","25.7","26.5"
"Jenkins","2020-09-13","3","1559","1","216","30.4","23.5"
"Jenkins","2020-09-14","53","1612","9","225","23.3","23"
"Jenkins","2020-09-15","8","1620","3","228","22.5","24"
"Jenkins","2020-09-16","6","1626","2","230","21.1","25.3"
"Jenkins","2020-09-17","8","1634","0","230","18.3","24.3"
"Jenkins","2020-09-18","8","1642","0","230","17.3","22.4"
"Jenkins","2020-09-19","5","1647","3","233","25.9","25.8"
"Jenkins","2020-09-20","7","1654","2","235","25.2","27.8"
"Jenkins","2020-09-21","35","1689","2","237","23.6","23.5"
"Jenkins","2020-09-22","18","1707","4","241","21.4","21.9"
"Jenkins","2020-09-23","7","1714","2","243","20.7","20.9"
"Jenkins","2020-09-24","9","1723","1","244","22.3","20.3"
"Jenkins","2020-09-25","7","1730","3","247","28.4","22.9"
"Jenkins","2020-09-26","4","1734","0","247","19.9","22.9"
"Jenkins","2020-09-27","3","1737","2","249","25.3","25.3"
"Jenkins","2020-09-28","26","1763","6","255","27.8","25.7"
"Jenkins","2020-09-29","11","1774","2","257","27.2","24.3"
"Jenkins","2020-09-30","7","1781","0","257","23.1","21.9"
"Jenkins","2020-10-01","6","1787","0","257","21.5","21.9"
"Jenkins","2020-10-02","5","1792","0","257","15.4","21.9"
"Jenkins","2020-10-03","3","1795","0","257","15.4","17.6"
"Jenkins","2020-10-04","6","1801","0","257","5.9","15.6"
"Jenkins","2020-10-05","24","1825","4","261","5","16.4"
"Jenkins","2020-10-06","6","1831","1","262","4.8","16"
"Jenkins","2020-10-07","4","1835","1","263","8.3","15.7"
"Jenkins","2020-10-08","9","1844","2","265","11.5","16.5"
"Jenkins","2020-10-09","3","1847","0","265","11.5","13.5"
"Jenkins","2020-10-10","3","1850","0","265","11.5","13.5"
"Jenkins","2020-10-11","0","1850","0","265","11.5","8.7"
"Jenkins","2020-10-12","6","1856","0","265","9.1","7.1"
"Jenkins","2020-10-13","5","1861","1","266","9.6","7.2"
"Jenkins","2020-10-14","2","1863","0","266","6","7.2"
"Jenkins","2020-10-15","5","1868","0","266","2.9","7.2"
"Jenkins","2020-10-16","3","1871","0","266","2.9","7.2"
"Jenkins","2020-10-17","3","1874","0","266","2.9","7.2"
"Jenkins","2020-10-18","2","1876","0","266","2.9","7.2"
"Jenkins","2020-10-19","17","1893","1","267","3.7","6.4"
"Jenkins","2020-10-20","5","1898","0","267","0.8","5.2"
"Jenkins","2020-10-21","3","1901","0","267","0.8","3.4"
"Jenkins","2020-10-22","2","1903","0","267","0.8","1.8"
"Jenkins","2020-10-23","7","1910","4","271","9","5.9"
"Jenkins","2020-10-24","3","1913","0","271","9","5.9"
"Jenkins","2020-10-25","1","1914","0","271","9","5.9"
"Jenkins","2020-10-26","32","1946","4","275","9.9","6.8"
"Jenkins","2020-10-27","5","1951","0","275","9.9","5.4"
"Jenkins","2020-10-28","7","1958","2","277","14","7.4"
"Jenkins","2020-10-29","4","1962","2","279","21.2","11"
"Jenkins","2020-10-30","5","1967","1","280","15.9","12.4"
"Jenkins","2020-10-31","1","1968","0","280","15.9","12.4"
"Jenkins","2020-11-01","3","1971","0","280","15.9","12.4"
"Jenkins","2020-11-02","14","1985","0","280","14.1","12"
"Jenkins","2020-11-03","5","1990","1","281","16.9","13.4"
"Jenkins","2020-11-04","7","1997","1","282","14.9","14.5"
"Jenkins","2020-11-05","7","2004","1","283","9.8","15.5"
"Jenkins","2020-11-06","5","2009","2","285","12.7","14.3"
"Jenkins","2020-11-07","9","2018","1","286","14.2","15.1"
"Jenkins","2020-11-08","4","2022","1","287","17.8","16.8"
"Jenkins","2020-11-09","13","2035","0","287","17.8","15.9"
"Jenkins","2020-11-10","7","2042","1","288","17","17"
"Jenkins","2020-11-11","3","2045","1","289","19.7","17.3"
"Jenkins","2020-11-12","11","2056","2","291","20.3","15"
"Jenkins","2020-11-13","8","2064","0","291","14.6","13.6"
"Jenkins","2020-11-14","3","2067","0","291","13","13.6"
"Jenkins","2020-11-15","3","2070","0","291","9.4","13.6"
"Jenkins","2020-11-16","52","2122","1","292","9.7","13.7"
"Jenkins","2020-11-17","8","2130","0","292","7.6","12.3"
"Jenkins","2020-11-18","6","2136","2","294","7.6","13.7"
"Jenkins","2020-11-19","13","2149","1","295","6.1","13.2"
"Jenkins","2020-11-20","6","2155","0","295","6.1","10.3"
"Jenkins","2020-11-21","1","2156","0","295","6.1","9.6"
"Jenkins","2020-11-22","2","2158","0","295","6.1","7.8"
"Jenkins","2020-11-23","6","2164","1","296","8.2","9"
"Jenkins","2020-11-24","7","2171","1","297","10.3","9"
"Jenkins","2020-11-25","8","2179","0","297","5.5","6.6"
"Jenkins","2020-11-26","1","2180","0","297","4.4","5.3"
"Jenkins","2020-11-27","0","2180","0","297","4.4","5.3"
"Jenkins","2020-11-28","2","2182","0","297","4.4","5.3"
"Jenkins","2020-11-29","4","2186","1","298","8","7.1"
"Jenkins","2020-11-30","31","2217","1","299","6.1","7.2"
"Jenkins","2020-12-01","6","2223","0","299","4","7.2"
"Jenkins","2020-12-02","6","2229","1","300","6.4","6"
"Jenkins","2020-12-03","8","2237","0","300","6.4","5.4"
"Jenkins","2020-12-04","6","2243","1","301","8.8","6.6"
"Jenkins","2020-12-05","0","2243","0","301","8.8","6.6"
"Jenkins","2020-12-06","2","2245","0","301","5.2","6.6"
"Jenkins","2020-12-07","15","2260","1","302","5.7","5.9"
"Jenkins","2020-12-08","8","2268","1","303","7.5","5.8"
"Jenkins","2020-12-09","7","2275","2","305","9.2","7.8"
"Jenkins","2020-12-10","12","2287","1","306","10.4","8.4"
"Jenkins","2020-12-11","3","2290","0","306","8","8.4"
"Jenkins","2020-12-12","2","2292","0","306","8","8.4"
"Jenkins","2020-12-13","0","2292","0","306","8","6.6"
"Jenkins","2020-12-14","10","2302","1","307","8.5","7.1"
"Jenkins","2020-12-15","9","2311","4","311","13","10.3"
"Jenkins","2020-12-16","11","2322","1","312","10.3","9.7"
"Jenkins","2020-12-17","4","2326","0","312","9.1","9.7"
"Jenkins","2020-12-18","7","2333","0","312","9.1","8.5"
"Jenkins","2020-12-19","4","2337","0","312","9.1","8.5"
"Jenkins","2020-12-20","1","2338","0","312","9.1","8.5"
"Jenkins","2020-12-21","12","2350","0","312","7.6","8.1"
"Jenkins","2020-12-22","9","2359","4","316","7.6","10.3"
"Jenkins","2020-12-23","6","2365","3","319","13.5","11.9"
"Jenkins","2020-12-24","8","2373","2","321","17.1","13.1"
"Jenkins","2020-12-25","3","2376","0","321","17.1","13.1"
"Jenkins","2020-12-26","6","2382","3","324","24.2","16.6"
"Jenkins","2020-12-27","2","2384","0","324","24.2","16.6"
"Jenkins","2020-12-28","15","2399","4","328","28","17.8"
"Jenkins","2020-12-29","15","2414","5","333","26.4","17"
"Jenkins","2020-12-30","24","2438","10","343","25.2","19.4"
"Jenkins","2020-12-31","8","2446","1","344","23.5","20.3"
"Jenkins","2021-01-01","1","2447","1","345","37.7","27.4"
"Jenkins","2021-01-02","3","2450","3","348","44.9","34.5"
"Jenkins","2021-01-03","0","2450","0","348","44.9","34.5"
"Jenkins","2021-01-04","16","2466","4","352","44.6","36.3"
"Jenkins","2021-01-05","30","2496","10","362","44.6","35.5"
"Jenkins","2021-01-06","20","2516","8","370","44.4","34.8"
"Jenkins","2021-01-07","21","2537","7","377","47.4","35.4"
"Jenkins","2021-01-08","17","2554","5","382","37.3","37.5"
"Jenkins","2021-01-09","7","2561","2","384","27.1","36"
"Jenkins","2021-01-10","5","2566","0","384","27.1","36"
"Jenkins","2021-01-11","19","2585","7","391","28.8","36.7"
"Jenkins","2021-01-12","27","2612","7","398","27.7","36.2"
"Jenkins","2021-01-13","24","2636","9","407","27.4","35.9"
"Jenkins","2021-01-14","21","2657","5","412","26","36.7"
"Jenkins","2021-01-15","24","2681","9","421","27.2","32.2"
"Jenkins","2021-01-16","2","2683","0","421","23.1","25.1"
"Jenkins","2021-01-17","8","2691","1","422","24.9","26"
"Jenkins","2021-01-18","18","2709","0","422","19.6","24.2"
"Jenkins","2021-01-19","18","2727","1","423","16.7","22.2"
"Jenkins","2021-01-20","21","2748","9","432","17.5","22.4"
"Jenkins","2021-01-21","16","2764","0","432","14.1","20"
"Jenkins","2021-01-22","16","2780","5","437","13.2","20.2"
"Jenkins","2021-01-23","5","2785","0","437","13.2","18.1"
"Jenkins","2021-01-24","2","2787","1","438","18.5","21.7"
"Jenkins","2021-01-25","19","2806","8","446","24.5","22.1"
"Jenkins","2021-01-26","22","2828","6","452","27.6","22.2"
"Jenkins","2021-01-27","15","2843","1","453","22.5","20"
"Jenkins","2021-01-28","22","2865","6","459","26.4","20.2"
"Jenkins","2021-01-29","11","2876","2","461","24.5","18.8"
"Jenkins","2021-01-30","7","2883","0","461","24.5","18.8"
"Jenkins","2021-01-31","0","2883","0","461","17.4","17.9"
"Jenkins","2021-02-01","19","2902","4","465","14.3","19.4"
"Jenkins","2021-02-02","9","2911","0","465","10.5","19"
"Jenkins","2021-02-03","9","2920","2","467","12.7","17.6"
"Jenkins","2021-02-04","11","2931","0","467","8.8","17.6"
"Jenkins","2021-02-05","5","2936","1","468","9","16.8"
"Jenkins","2021-02-06","2","2938","2","470","23.3","23.9"
"Jenkins","2021-02-07","0","2938","0","470","23.3","20.3"
"Jenkins","2021-02-08","0","2938","0","470","20.3","17.3"
"Johnson","2020-02-01","0","0","0","0",".","."
"Johnson","2020-02-02","0","0","0","0",".","."
"Johnson","2020-02-03","0","0","0","0",".","."
"Johnson","2020-02-04","0","0","0","0",".","."
"Johnson","2020-02-05","0","0","0","0",".","."
"Johnson","2020-02-06","0","0","0","0",".","."
"Johnson","2020-02-07","0","0","0","0","0","."
"Johnson","2020-02-08","0","0","0","0","0","."
"Johnson","2020-02-09","0","0","0","0","0","."
"Johnson","2020-02-10","0","0","0","0","0","."
"Johnson","2020-02-11","0","0","0","0","0","."
"Johnson","2020-02-12","0","0","0","0","0","."
"Johnson","2020-02-13","0","0","0","0","0","."
"Johnson","2020-02-14","0","0","0","0","0","0"
"Johnson","2020-02-15","0","0","0","0","0","0"
"Johnson","2020-02-16","0","0","0","0","0","0"
"Johnson","2020-02-17","0","0","0","0","0","0"
"Johnson","2020-02-18","0","0","0","0","0","0"
"Johnson","2020-02-19","0","0","0","0","0","0"
"Johnson","2020-02-20","0","0","0","0","0","0"
"Johnson","2020-02-21","0","0","0","0","0","0"
"Johnson","2020-02-22","0","0","0","0","0","0"
"Johnson","2020-02-23","0","0","0","0","0","0"
"Johnson","2020-02-24","0","0","0","0","0","0"
"Johnson","2020-02-25","0","0","0","0","0","0"
"Johnson","2020-02-26","0","0","0","0","0","0"
"Johnson","2020-02-27","0","0","0","0","0","0"
"Johnson","2020-02-28","0","0","0","0","0","0"
"Johnson","2020-02-29","0","0","0","0","0","0"
"Johnson","2020-03-01","0","0","0","0","0","0"
"Johnson","2020-03-02","0","0","0","0","0","0"
"Johnson","2020-03-03","0","0","0","0","0","0"
"Johnson","2020-03-04","0","0","0","0","0","0"
"Johnson","2020-03-05","0","0","0","0","0","0"
"Johnson","2020-03-06","0","0","0","0","0","0"
"Johnson","2020-03-07","0","0","0","0","0","0"
"Johnson","2020-03-08","0","0","0","0","0","0"
"Johnson","2020-03-09","0","0","0","0","0","0"
"Johnson","2020-03-10","0","0","0","0","0","0"
"Johnson","2020-03-11","0","0","0","0","0","0"
"Johnson","2020-03-12","0","0","0","0","0","0"
"Johnson","2020-03-13","0","0","0","0","0","0"
"Johnson","2020-03-14","0","0","0","0","0","0"
"Johnson","2020-03-15","0","0","0","0","0","0"
"Johnson","2020-03-16","0","0","0","0","0","0"
"Johnson","2020-03-17","1","1","0","0","0","0"
"Johnson","2020-03-18","1","2","0","0","0","0"
"Johnson","2020-03-19","1","3","0","0","0","0"
"Johnson","2020-03-20","1","4","0","0","0","0"
"Johnson","2020-03-21","0","4","0","0","0","0"
"Johnson","2020-03-22","0","4","0","0","0","0"
"Johnson","2020-03-23","1","5","0","0","0","0"
"Johnson","2020-03-24","3","8","1","1","4.8","2.4"
"Johnson","2020-03-25","3","11","0","1","4.8","2.4"
"Johnson","2020-03-26","1","12","0","1","4.8","2.4"
"Johnson","2020-03-27","1","13","0","1","4.8","2.4"
"Johnson","2020-03-28","0","13","0","1","4.8","2.4"
"Johnson","2020-03-29","0","13","0","1","4.8","2.4"
"Johnson","2020-03-30","4","17","3","4","15.5","7.7"
"Johnson","2020-03-31","0","17","0","4","10.7","7.7"
"Johnson","2020-04-01","1","18","0","4","10.7","7.7"
"Johnson","2020-04-02","0","18","0","4","10.7","7.7"
"Johnson","2020-04-03","3","21","0","4","10.7","7.7"
"Johnson","2020-04-04","0","21","0","4","10.7","7.7"
"Johnson","2020-04-05","0","21","0","4","10.7","7.7"
"Johnson","2020-04-06","2","23","1","5","7.1","11.3"
"Johnson","2020-04-07","1","24","0","5","7.1","8.9"
"Johnson","2020-04-08","8","32","7","12","19.6","15.2"
"Johnson","2020-04-09","2","34","0","12","19.6","15.2"
"Johnson","2020-04-10","1","35","0","12","19.6","15.2"
"Johnson","2020-04-11","0","35","0","12","19.6","15.2"
"Johnson","2020-04-12","4","39","3","15","30.4","20.5"
"Johnson","2020-04-13","11","50","6","21","31","19.1"
"Johnson","2020-04-14","1","51","0","21","31","19.1"
"Johnson","2020-04-15","3","54","3","24","32.8","26.2"
"Johnson","2020-04-16","7","61","7","31","47.1","33.4"
"Johnson","2020-04-17","1","62","0","31","47.1","33.4"
"Johnson","2020-04-18","1","63","1","32","61.4","40.5"
"Johnson","2020-04-19","1","64","0","32","50.6","40.5"
"Johnson","2020-04-20","2","66","1","33","50","40.5"
"Johnson","2020-04-21","5","71","2","35","55.7","43.4"
"Johnson","2020-04-22","4","75","0","35","41.4","37.1"
"Johnson","2020-04-23","2","77","0","35","27.1","37.1"
"Johnson","2020-04-24","9","86","0","35","27.1","37.1"
"Johnson","2020-04-25","2","88","0","35","12.9","37.1"
"Johnson","2020-04-26","1","89","0","35","12.9","31.8"
"Johnson","2020-04-27","15","104","9","44","14.3","32.1"
"Johnson","2020-04-28","12","116","5","49","14.5","35.1"
"Johnson","2020-04-29","11","127","4","53","19.7","30.6"
"Johnson","2020-04-30","12","139","2","55","22.1","24.6"
"Johnson","2020-05-01","2","141","1","56","29.2","28.2"
"Johnson","2020-05-02","2","143","1","57","36.4","24.6"
"Johnson","2020-05-03","31","174","0","57","36.4","24.6"
"Johnson","2020-05-04","14","188","0","57","27.8","21"
"Johnson","2020-05-05","7","195","1","58","23.9","19.2"
"Johnson","2020-05-06","8","203","1","59","20.5","20.1"
"Johnson","2020-05-07","3","206","2","61","27.6","24.9"
"Johnson","2020-05-08","4","210","0","61","20.5","24.9"
"Johnson","2020-05-09","2","212","0","61","13.4","24.9"
"Johnson","2020-05-10","1","213","0","61","13.4","24.9"
"Johnson","2020-05-11","9","222","3","64","18.1","23"
"Johnson","2020-05-12","3","225","0","64","16.1","20"
"Johnson","2020-05-13","6","231","2","66","19","19.8"
"Johnson","2020-05-14","8","239","2","68","13.1","20.4"
"Johnson","2020-05-15","1","240","0","68","13.1","16.8"
"Johnson","2020-05-16","24","264","8","76","17.9","15.6"
"Johnson","2020-05-17","8","272","8","84","32.1","22.7"
"Johnson","2020-05-18","4","276","0","84","27.4","22.7"
"Johnson","2020-05-19","9","285","0","84","27.4","21.7"
"Johnson","2020-05-20","6","291","0","84","22.6","20.8"
"Johnson","2020-05-21","3","294","0","84","19","16.1"
"Johnson","2020-05-22","3","297","0","84","19","16.1"
"Johnson","2020-05-23","2","299","0","84","14.3","16.1"
"Johnson","2020-05-24","3","302","0","84","0","16.1"
"Johnson","2020-05-25","4","306","1","85","3.6","15.5"
"Johnson","2020-05-26","3","309","0","85","3.6","15.5"
"Johnson","2020-05-27","7","316","0","85","3.6","13.1"
"Johnson","2020-05-28","11","327","0","85","3.6","11.3"
"Johnson","2020-05-29","1","328","0","85","3.6","11.3"
"Johnson","2020-05-30","3","331","1","86","8.3","11.3"
"Johnson","2020-05-31","0","331","0","86","8.3","4.2"
"Johnson","2020-06-01","8","339","0","86","4.8","4.2"
"Johnson","2020-06-02","5","344","0","86","4.8","4.2"
"Johnson","2020-06-03","15","359","0","86","4.8","4.2"
"Johnson","2020-06-04","28","387","0","86","4.8","4.2"
"Johnson","2020-06-05","5","392","1","87","7.6","5.6"
"Johnson","2020-06-06","0","392","0","87","2.9","5.6"
"Johnson","2020-06-07","2","394","0","87","2.9","5.6"
"Johnson","2020-06-08","2","396","0","87","2.9","3.8"
"Johnson","2020-06-09","0","396","0","87","2.9","3.8"
"Johnson","2020-06-10","10","406","0","87","2.9","3.8"
"Johnson","2020-06-11","27","433","0","87","2.9","3.8"
"Johnson","2020-06-12","12","445","1","88","1.2","4.4"
"Johnson","2020-06-13","1","446","0","88","1.2","2"
"Johnson","2020-06-14","2","448","1","89","8.3","5.6"
"Johnson","2020-06-15","2","450","0","89","8.3","5.6"
"Johnson","2020-06-16","4","454","0","89","8.3","5.6"
"Johnson","2020-06-17","4","458","0","89","8.3","5.6"
"Johnson","2020-06-18","1","459","0","89","8.3","5.6"
"Johnson","2020-06-19","2","461","0","89","7.1","4.2"
"Johnson","2020-06-20","1","462","0","89","7.1","4.2"
"Johnson","2020-06-21","0","462","0","89","0","4.2"
"Johnson","2020-06-22","3","465","0","89","0","4.2"
"Johnson","2020-06-23","0","465","0","89","0","4.2"
"Johnson","2020-06-24","9","474","0","89","0","4.2"
"Johnson","2020-06-25","4","478","1","90","3.6","6"
"Johnson","2020-06-26","5","483","0","90","3.6","5.4"
"Johnson","2020-06-27","3","486","1","91","8.3","7.7"
"Johnson","2020-06-28","0","486","0","91","8.3","4.2"
"Johnson","2020-06-29","2","488","0","91","8.3","4.2"
"Johnson","2020-06-30","5","493","1","92","11.2","5.6"
"Johnson","2020-07-01","3","496","1","93","16","8"
"Johnson","2020-07-02","6","502","1","94","14.8","9.2"
"Johnson","2020-07-03","2","504","1","95","21.9","12.7"
"Johnson","2020-07-04","0","504","0","95","17.1","12.7"
"Johnson","2020-07-05","6","510","2","97","21.9","15.1"
"Johnson","2020-07-06","9","519","1","98","23.5","15.9"
"Johnson","2020-07-07","12","531","4","102","25.4","18.3"
"Johnson","2020-07-08","5","536","0","102","20.6","18.3"
"Johnson","2020-07-09","6","542","1","103","20.6","17.7"
"Johnson","2020-07-10","5","547","2","105","19.2","20.6"
"Johnson","2020-07-11","3","550","2","107","28.7","22.9"
"Johnson","2020-07-12","1","551","0","107","24","22.9"
"Johnson","2020-07-13","6","557","0","107","22.4","22.9"
"Johnson","2020-07-14","9","566","1","108","19.2","22.3"
"Johnson","2020-07-15","7","573","0","108","19.2","19.9"
"Johnson","2020-07-16","4","577","1","109","20.4","20.5"
"Johnson","2020-07-17","2","579","0","109","14.7","16.9"
"Johnson","2020-07-18","1","580","1","110","19.4","24.1"
"Johnson","2020-07-19","2","582","0","110","19.4","21.7"
"Johnson","2020-07-20","1","583","0","110","19.4","20.9"
"Johnson","2020-07-21","7","590","2","112","21.9","20.6"
"Johnson","2020-07-22","4","594","0","112","21.9","20.6"
"Johnson","2020-07-23","3","597","0","112","18.4","19.4"
"Johnson","2020-07-24","6","603","3","115","25.5","20.1"
"Johnson","2020-07-25","6","609","2","117","16","17.7"
"Johnson","2020-07-26","1","610","1","118","30.3","24.9"
"Johnson","2020-07-27","4","614","1","119","33.8","26.6"
"Johnson","2020-07-28","2","616","1","120","36.9","29.4"
"Johnson","2020-07-29","3","619","0","120","36.9","29.4"
"Johnson","2020-07-30","3","622","1","121","41.7","30"
"Johnson","2020-07-31","6","628","2","123","39.3","32.4"
"Johnson","2020-08-01","4","632","4","127","48.8","32.4"
"Johnson","2020-08-02","3","635","1","128","39.3","34.8"
"Johnson","2020-08-03","3","638","0","128","35.7","34.8"
"Johnson","2020-08-04","5","643","0","128","28.6","32.7"
"Johnson","2020-08-05","9","652","3","131","33.3","35.1"
"Johnson","2020-08-06","4","656","1","132","32.1","36.9"
"Johnson","2020-08-07","6","662","1","133","29.8","34.5"
"Johnson","2020-08-08","6","668","2","135","20.2","34.5"
"Johnson","2020-08-09","1","669","0","135","15.5","27.4"
"Johnson","2020-08-10","5","674","0","135","15.5","25.6"
"Johnson","2020-08-11","9","683","2","137","18.7","23.6"
"Johnson","2020-08-12","4","687","0","137","13.9","23.6"
"Johnson","2020-08-13","3","690","0","137","10.3","21.2"
"Johnson","2020-08-14","12","702","1","138","9.1","19.4"
"Johnson","2020-08-15","8","710","2","140","7.9","14.1"
"Johnson","2020-08-16","2","712","1","141","15.1","15.3"
"Johnson","2020-08-17","4","716","0","141","15.1","15.3"
"Johnson","2020-08-18","3","719","3","144","26.2","22.4"
"Johnson","2020-08-19","6","725","1","145","28.6","21.2"
"Johnson","2020-08-20","5","730","1","146","31.4","20.9"
"Johnson","2020-08-21","10","740","2","148","33.1","21.1"
"Johnson","2020-08-22","7","747","2","150","33.6","20.8"
"Johnson","2020-08-23","3","750","2","152","36","25.5"
"Johnson","2020-08-24","10","760","0","152","36","25.5"
"Johnson","2020-08-25","9","769","2","154","24.9","25.5"
"Johnson","2020-08-26","9","778","0","154","22.5","25.5"
"Johnson","2020-08-27","6","784","2","156","24.4","27.9"
"Johnson","2020-08-28","35","819","19","175","29.3","31.2"
"Johnson","2020-08-29","5","824","2","177","30.9","32.3"
"Johnson","2020-08-30","2","826","1","178","28.5","32.3"
"Johnson","2020-08-31","6","832","1","179","30.9","33.5"
"Johnson","2020-09-01","5","837","4","183","39.2","32"
"Johnson","2020-09-02","6","843","1","184","41.6","32"
"Johnson","2020-09-03","4","847","1","185","40.4","32.4"
"Johnson","2020-09-04","23","870","11","196","39.5","34.4"
"Johnson","2020-09-05","7","877","2","198","37.8","34.4"
"Johnson","2020-09-06","2","879","0","198","30.7","29.6"
"Johnson","2020-09-07","3","882","2","200","37.8","34.4"
"Johnson","2020-09-08","18","900","3","203","28.8","34"
"Johnson","2020-09-09","3","903","0","203","26.4","34"
"Johnson","2020-09-10","6","909","0","203","22.8","31.6"
"Johnson","2020-09-11","11","920","6","209","23.8","31.6"
"Johnson","2020-09-12","3","923","1","210","24.5","31.1"
"Johnson","2020-09-13","0","923","0","210","24.5","27.6"
"Johnson","2020-09-14","6","929","0","210","14.9","26.4"
"Johnson","2020-09-15","9","938","0","210","12.6","20.7"
"Johnson","2020-09-16","3","941","1","211","17.3","21.9"
"Johnson","2020-09-17","14","955","2","213","19.4","21.1"
"Johnson","2020-09-18","3","958","1","214","16.3","20.1"
"Johnson","2020-09-19","3","961","0","214","11.6","18"
"Johnson","2020-09-20","0","961","0","214","11.6","18"
"Johnson","2020-09-21","10","971","1","215","13","14"
"Johnson","2020-09-22","15","986","2","217","14.9","13.7"
"Johnson","2020-09-23","1","987","0","217","10.1","13.7"
"Johnson","2020-09-24","10","997","5","222","15.2","17.3"
"Johnson","2020-09-25","4","1001","1","223","14","15.2"
"Johnson","2020-09-26","2","1003","0","223","14","12.8"
"Johnson","2020-09-27","1","1004","0","223","14","12.8"
"Johnson","2020-09-28","13","1017","2","225","14.8","13.9"
"Johnson","2020-09-29","6","1023","1","226","15.3","15.1"
"Johnson","2020-09-30","4","1027","0","226","15.3","12.7"
"Johnson","2020-10-01","4","1031","0","226","8.2","11.7"
"Johnson","2020-10-02","11","1042","0","226","4.6","9.3"
"Johnson","2020-10-03","8","1050","0","226","4.6","9.3"
"Johnson","2020-10-04","4","1054","1","227","8.2","11.1"
"Johnson","2020-10-05","6","1060","0","227","6","10.4"
"Johnson","2020-10-06","24","1084","1","228","4.2","9.7"
"Johnson","2020-10-07","4","1088","0","228","4.2","9.7"
"Johnson","2020-10-08","10","1098","2","230","7","7.6"
"Johnson","2020-10-09","8","1106","0","230","7","5.8"
"Johnson","2020-10-10","2","1108","0","230","7","5.8"
"Johnson","2020-10-11","0","1108","0","230","3.5","5.8"
"Johnson","2020-10-12","6","1114","0","230","3.5","4.7"
"Johnson","2020-10-13","5","1119","2","232","8.6","6.4"
"Johnson","2020-10-14","2","1121","0","232","8.6","6.4"
"Johnson","2020-10-15","5","1126","1","233","8.6","7.8"
"Johnson","2020-10-16","1","1127","0","233","8.6","7.8"
"Johnson","2020-10-17","4","1131","1","234","12.1","9.6"
"Johnson","2020-10-18","2","1133","1","235","19.3","11.4"
"Johnson","2020-10-19","7","1140","0","235","19.3","11.4"
"Johnson","2020-10-20","19","1159","0","235","13.6","11.1"
"Johnson","2020-10-21","3","1162","0","235","13.6","11.1"
"Johnson","2020-10-22","13","1175","1","236","11.8","10.2"
"Johnson","2020-10-23","1","1176","1","237","26.1","17.3"
"Johnson","2020-10-24","0","1176","0","237","22.5","17.3"
"Johnson","2020-10-25","3","1179","1","238","20.1","19.7"
"Johnson","2020-10-26","12","1191","0","238","20.1","19.7"
"Johnson","2020-10-27","7","1198","0","238","20.1","16.9"
"Johnson","2020-10-28","9","1207","0","238","20.1","16.9"
"Johnson","2020-10-29","4","1211","0","238","19","15.4"
"Johnson","2020-10-30","3","1214","0","238","4.8","15.4"
"Johnson","2020-10-31","2","1216","0","238","4.8","13.6"
"Johnson","2020-11-01","0","1216","0","238","0","10.1"
"Johnson","2020-11-02","9","1225","1","239","1.6","10.9"
"Johnson","2020-11-03","6","1231","1","240","4","12.1"
"Johnson","2020-11-04","7","1238","2","242","8","14.1"
"Johnson","2020-11-05","200","1438","0","242","8","13.5"
"Johnson","2020-11-06","17","1455","2","244","9.7","7.2"
"Johnson","2020-11-07","4","1459","1","245","13.3","9"
"Johnson","2020-11-08","2","1461","0","245","13.3","6.7"
"Johnson","2020-11-09","4","1465","0","245","11.7","6.7"
"Johnson","2020-11-10","75","1540","0","245","9.3","6.7"
"Johnson","2020-11-11","3","1543","0","245","5.3","6.7"
"Johnson","2020-11-12","6","1549","0","245","5.3","6.7"
"Johnson","2020-11-13","3","1552","1","246","8.3","9"
"Johnson","2020-11-14","2","1554","0","246","4.8","9"
"Johnson","2020-11-15","2","1556","1","247","11.9","12.6"
"Johnson","2020-11-16","30","1586","0","247","11.9","11.8"
"Johnson","2020-11-17","6","1592","1","248","14.3","11.8"
"Johnson","2020-11-18","7","1599","1","249","16.3","10.8"
"Johnson","2020-11-19","4","1603","0","249","16.3","10.8"
"Johnson","2020-11-20","7","1610","2","251","15.6","12"
"Johnson","2020-11-21","2","1612","0","251","15.6","10.2"
"Johnson","2020-11-22","2","1614","0","251","8.5","10.2"
"Johnson","2020-11-23","6","1620","0","251","8.5","10.2"
"Johnson","2020-11-24","15","1635","1","252","7.1","10.7"
"Johnson","2020-11-25","3","1638","0","252","5","10.7"
"Johnson","2020-11-26","2","1640","1","253","12.2","14.3"
"Johnson","2020-11-27","5","1645","0","253","8.1","11.9"
"Johnson","2020-11-28","3","1648","0","253","8.1","11.9"
"Johnson","2020-11-29","1","1649","0","253","8.1","8.3"
"Johnson","2020-11-30","4","1653","0","253","8.1","8.3"
"Johnson","2020-12-01","11","1664","1","254","8.4","7.8"
"Johnson","2020-12-02","9","1673","1","255","10","7.5"
"Johnson","2020-12-03","8","1681","1","256","4.7","8.4"
"Johnson","2020-12-04","10","1691","2","258","7.5","7.8"
"Johnson","2020-12-05","6","1697","0","258","7.5","7.8"
"Johnson","2020-12-06","3","1700","0","258","7.5","7.8"
"Johnson","2020-12-07","11","1711","2","260","10.1","9.1"
"Johnson","2020-12-08","5","1716","0","260","8.8","8.6"
"Johnson","2020-12-09","5","1721","1","261","10.1","10.1"
"Johnson","2020-12-10","2","1723","0","261","8.3","6.5"
"Johnson","2020-12-11","9","1732","2","263","8.6","8.1"
"Johnson","2020-12-12","2","1734","2","265","22.9","15.2"
"Johnson","2020-12-13","3","1737","0","265","22.9","15.2"
"Johnson","2020-12-14","71","1808","2","267","20.7","15.4"
"Johnson","2020-12-15","32","1840","10","277","25.2","17"
"Johnson","2020-12-16","7","1847","0","277","22.3","16.2"
"Johnson","2020-12-17","11","1858","2","279","24.9","16.6"
"Johnson","2020-12-18","5","1863","2","281","27.5","18"
"Johnson","2020-12-19","4","1867","0","281","13.2","18"
"Johnson","2020-12-20","2","1869","2","283","27.5","25.2"
"Johnson","2020-12-21","65","1934","4","287","27.9","24.3"
"Johnson","2020-12-22","45","1979","8","295","26","25.6"
"Johnson","2020-12-23","6","1985","2","297","30.8","26.6"
"Johnson","2020-12-24","8","1993","1","298","30","27.4"
"Johnson","2020-12-25","2","1995","1","299","31.4","29.4"
"Johnson","2020-12-26","9","2004","3","302","36.2","24.7"
"Johnson","2020-12-27","0","2004","0","302","21.9","24.7"
"Johnson","2020-12-28","8","2012","2","304","24.6","26.3"
"Johnson","2020-12-29","29","2041","9","313","26.5","26.2"
"Johnson","2020-12-30","12","2053","4","317","26.5","28.6"
"Johnson","2020-12-31","13","2066","2","319","26.9","28.4"
"Johnson","2021-01-01","1","2067","0","319","19.7","25.6"
"Johnson","2021-01-02","3","2070","1","320","19.7","27.9"
"Johnson","2021-01-03","5","2075","3","323","28.3","25.1"
"Johnson","2021-01-04","192","2267","51","374","28.5","26.5"
"Johnson","2021-01-05","32","2299","7","381","27.2","26.8"
"Johnson","2021-01-06","74","2373","2","383","22.8","24.6"
"Johnson","2021-01-07","77","2450","0","383","20.6","23.8"
"Johnson","2021-01-08","10","2460","0","383","20.6","20.2"
"Johnson","2021-01-09","9","2469","3","386","20.6","20.2"
"Johnson","2021-01-10","2","2471","0","386","12.1","20.2"
"Johnson","2021-01-11","98","2569","13","399","10.2","19.3"
"Johnson","2021-01-12","39","2608","7","406","9.6","18.4"
"Johnson","2021-01-13","15","2623","3","409","12.1","17.5"
"Johnson","2021-01-14","178","2801","2","411","12.2","16.4"
"Johnson","2021-01-15","7","2808","0","411","12.2","16.4"
"Johnson","2021-01-16","5","2813","0","411","7.5","14.1"
"Johnson","2021-01-17","0","2813","0","411","7.5","9.8"
"Johnson","2021-01-18","5","2818","0","411","5.6","7.9"
"Johnson","2021-01-19","23","2841","10","421","9.2","9.4"
"Johnson","2021-01-20","8","2849","3","424","11.7","11.9"
"Johnson","2021-01-21","15","2864","2","426","13.5","12.9"
"Johnson","2021-01-22","9","2873","0","426","13.5","12.9"
"Johnson","2021-01-23","4","2877","1","427","17","12.3"
"Johnson","2021-01-24","3","2880","0","427","17","12.3"
"Johnson","2021-01-25","7","2887","2","429","21.1","13.4"
"Johnson","2021-01-26","39","2926","4","433","16.4","12.8"
"Johnson","2021-01-27","11","2937","3","436","14.9","13.3"
"Johnson","2021-01-28","137","3074","4","440","13.4","13.5"
"Johnson","2021-01-29","12","3086","1","441","14.6","14"
"Johnson","2021-01-30","5","3091","0","441","11.1","14"
"Johnson","2021-01-31","4","3095","3","444","21.8","19.4"
"Johnson","2021-02-01","92","3187","13","457","19.7","20.4"
"Johnson","2021-02-02","100","3287","0","457","18.2","17.3"
"Johnson","2021-02-03","14","3301","0","457","14.3","14.6"
"Johnson","2021-02-04","2","3303","0","457","13.9","13.7"
"Johnson","2021-02-05","1","3304","0","457","12.7","13.7"
"Johnson","2021-02-06","0","3304","0","457","12.7","11.9"
"Johnson","2021-02-07","0","3304","0","457","2","11.9"
"Johnson","2021-02-08","0","3304","0","457","0","9.9"
"Jones","2020-02-01","0","0","0","0",".","."
"Jones","2020-02-02","0","0","0","0",".","."
"Jones","2020-02-03","0","0","0","0",".","."
"Jones","2020-02-04","0","0","0","0",".","."
"Jones","2020-02-05","0","0","0","0",".","."
"Jones","2020-02-06","0","0","0","0",".","."
"Jones","2020-02-07","0","0","0","0","0","."
"Jones","2020-02-08","0","0","0","0","0","."
"Jones","2020-02-09","0","0","0","0","0","."
"Jones","2020-02-10","0","0","0","0","0","."
"Jones","2020-02-11","0","0","0","0","0","."
"Jones","2020-02-12","0","0","0","0","0","."
"Jones","2020-02-13","0","0","0","0","0","."
"Jones","2020-02-14","0","0","0","0","0","0"
"Jones","2020-02-15","0","0","0","0","0","0"
"Jones","2020-02-16","0","0","0","0","0","0"
"Jones","2020-02-17","0","0","0","0","0","0"
"Jones","2020-02-18","0","0","0","0","0","0"
"Jones","2020-02-19","0","0","0","0","0","0"
"Jones","2020-02-20","0","0","0","0","0","0"
"Jones","2020-02-21","0","0","0","0","0","0"
"Jones","2020-02-22","0","0","0","0","0","0"
"Jones","2020-02-23","0","0","0","0","0","0"
"Jones","2020-02-24","0","0","0","0","0","0"
"Jones","2020-02-25","0","0","0","0","0","0"
"Jones","2020-02-26","0","0","0","0","0","0"
"Jones","2020-02-27","0","0","0","0","0","0"
"Jones","2020-02-28","0","0","0","0","0","0"
"Jones","2020-02-29","0","0","0","0","0","0"
"Jones","2020-03-01","0","0","0","0","0","0"
"Jones","2020-03-02","0","0","0","0","0","0"
"Jones","2020-03-03","0","0","0","0","0","0"
"Jones","2020-03-04","0","0","0","0","0","0"
"Jones","2020-03-05","0","0","0","0","0","0"
"Jones","2020-03-06","0","0","0","0","0","0"
"Jones","2020-03-07","0","0","0","0","0","0"
"Jones","2020-03-08","0","0","0","0","0","0"
"Jones","2020-03-09","0","0","0","0","0","0"
"Jones","2020-03-10","0","0","0","0","0","0"
"Jones","2020-03-11","0","0","0","0","0","0"
"Jones","2020-03-12","0","0","0","0","0","0"
"Jones","2020-03-13","1","1","0","0","0","0"
"Jones","2020-03-14","0","1","0","0","0","0"
"Jones","2020-03-15","0","1","0","0","0","0"
"Jones","2020-03-16","3","4","0","0","0","0"
"Jones","2020-03-17","5","9","0","0","0","0"
"Jones","2020-03-18","5","14","0","0","0","0"
"Jones","2020-03-19","1","15","0","0","0","0"
"Jones","2020-03-20","1","16","0","0","0","0"
"Jones","2020-03-21","2","18","0","0","0","0"
"Jones","2020-03-22","5","23","0","0","0","0"
"Jones","2020-03-23","7","30","2","2","4.1","2"
"Jones","2020-03-24","6","36","0","2","4.1","2"
"Jones","2020-03-25","19","55","3","5","6.3","3.2"
"Jones","2020-03-26","9","64","0","5","6.3","3.2"
"Jones","2020-03-27","10","74","1","6","7.8","3.9"
"Jones","2020-03-28","1","75","0","6","7.8","3.9"
"Jones","2020-03-29","3","78","0","6","7.8","3.9"
"Jones","2020-03-30","4","82","0","6","3.7","3.9"
"Jones","2020-03-31","10","92","3","9","8","6"
"Jones","2020-04-01","10","102","0","9","5.7","6"
"Jones","2020-04-02","11","113","1","10","7","6.7"
"Jones","2020-04-03","9","122","3","13","10.3","9.1"
"Jones","2020-04-04","5","127","2","15","16.1","11.9"
"Jones","2020-04-05","5","132","0","15","16.1","11.9"
"Jones","2020-04-06","6","138","2","17","20.8","12.3"
"Jones","2020-04-07","5","143","2","19","22.3","15.1"
"Jones","2020-04-08","6","149","0","19","22.3","14"
"Jones","2020-04-09","9","158","4","23","27.3","17.2"
"Jones","2020-04-10","6","164","1","24","24.9","17.6"
"Jones","2020-04-11","1","165","1","25","33.5","24.8"
"Jones","2020-04-12","3","168","0","25","33.5","24.8"
"Jones","2020-04-13","23","191","0","25","28.7","24.8"
"Jones","2020-04-14","13","204","0","25","23","22.6"
"Jones","2020-04-15","27","231","6","31","26.2","24.2"
"Jones","2020-04-16","27","258","1","32","20.4","23.8"
"Jones","2020-04-17","13","271","1","33","19.1","22"
"Jones","2020-04-18","3","274","0","33","4.8","19.1"
"Jones","2020-04-19","5","279","0","33","4.8","19.1"
"Jones","2020-04-20","20","299","4","37","7.7","18.2"
"Jones","2020-04-21","28","327","4","41","9.7","16.4"
"Jones","2020-04-22","18","345","1","42","7.3","16.8"
"Jones","2020-04-23","5","350","2","44","12.5","16.4"
"Jones","2020-04-24","35","385","5","49","13.4","16.3"
"Jones","2020-04-25","3","388","0","49","13.4","9.1"
"Jones","2020-04-26","6","394","0","49","13.4","9.1"
"Jones","2020-04-27","17","411","8","57","17.3","12.5"
"Jones","2020-04-28","14","425","0","57","15.3","12.5"
"Jones","2020-04-29","11","436","0","57","14.5","10.9"
"Jones","2020-04-30","12","448","0","57","8.8","10.6"
"Jones","2020-05-01","19","467","1","58","7.5","10.5"
"Jones","2020-05-02","11","478","1","59","8.8","11.1"
"Jones","2020-05-03","5","483","0","59","8.8","11.1"
"Jones","2020-05-04","8","491","1","60","3.8","10.6"
"Jones","2020-05-05","15","506","1","61","4.8","10"
"Jones","2020-05-06","18","524","2","63","6.4","10.4"
"Jones","2020-05-07","14","538","0","63","6.4","7.6"
"Jones","2020-05-08","18","556","0","63","5.6","6.5"
"Jones","2020-05-09","3","559","0","63","4.3","6.5"
"Jones","2020-05-10","7","566","1","64","6.4","7.6"
"Jones","2020-05-11","20","586","1","65","5.3","4.6"
"Jones","2020-05-12","11","597","0","65","4.3","4.6"
"Jones","2020-05-13","45","642","0","65","2.8","4.6"
"Jones","2020-05-14","40","682","4","69","4.2","5.3"
"Jones","2020-05-15","34","716","1","70","4.6","5.1"
"Jones","2020-05-16","0","716","0","70","4.6","4.5"
"Jones","2020-05-17","4","720","0","70","2.6","4.5"
"Jones","2020-05-18","34","754","3","73","3.1","4.2"
"Jones","2020-05-19","25","779","2","75","4.3","4.3"
"Jones","2020-05-20","14","793","0","75","4.3","3.5"
"Jones","2020-05-21","16","809","2","77","4.6","4.4"
"Jones","2020-05-22","24","833","0","77","4.2","4.4"
"Jones","2020-05-23","7","840","0","77","4.2","4.4"
"Jones","2020-05-24","6","846","0","77","4.2","3.4"
"Jones","2020-05-25","6","852","1","78","5.3","4.2"
"Jones","2020-05-26","19","871","0","78","4.2","4.2"
"Jones","2020-05-27","72","943","2","80","4.6","4.4"
"Jones","2020-05-28","47","990","2","82","3.4","4"
"Jones","2020-05-29","81","1071","6","88","4.4","4.3"
"Jones","2020-05-30","3","1074","0","88","4.4","4.3"
"Jones","2020-05-31","9","1083","1","89","6","5.1"
"Jones","2020-06-01","51","1134","7","96","5.6","5.5"
"Jones","2020-06-02","18","1152","4","100","8.8","6.5"
"Jones","2020-06-03","92","1244","5","105","9.2","6.9"
"Jones","2020-06-04","31","1275","1","106","9","6.2"
"Jones","2020-06-05","31","1306","0","106","8","6.2"
"Jones","2020-06-06","9","1315","3","109","12.7","8.6"
"Jones","2020-06-07","3","1318","0","109","11.1","8.6"
"Jones","2020-06-08","27","1345","1","110","9.7","7.7"
"Jones","2020-06-09","20","1365","2","112","8","8.4"
"Jones","2020-06-10","17","1382","0","112","7.2","8.2"
"Jones","2020-06-11","19","1401","2","114","8.2","8.6"
"Jones","2020-06-12","33","1434","0","114","8.2","8.1"
"Jones","2020-06-13","9","1443","2","116","6.6","9.7"
"Jones","2020-06-14","2","1445","1","117","13.8","12.5"
"Jones","2020-06-15","26","1471","0","117","13.2","11.5"
"Jones","2020-06-16","16","1487","1","118","12.7","10.3"
"Jones","2020-06-17","38","1525","3","121","13.8","10.5"
"Jones","2020-06-18","20","1545","1","122","13.1","10.6"
"Jones","2020-06-19","25","1570","0","122","13.1","10.6"
"Jones","2020-06-20","3","1573","1","123","14.6","10.6"
"Jones","2020-06-21","5","1578","1","124","10.4","12.1"
"Jones","2020-06-22","45","1623","9","133","13.2","13.2"
"Jones","2020-06-23","30","1653","2","135","13.3","13"
"Jones","2020-06-24","69","1722","17","152","15.7","14.8"
"Jones","2020-06-25","46","1768","3","155","15.9","14.5"
"Jones","2020-06-26","56","1824","14","169","19.5","16.3"
"Jones","2020-06-27","13","1837","6","175","21.3","18"
"Jones","2020-06-28","9","1846","3","178","23.2","16.8"
"Jones","2020-06-29","83","1929","21","199","23.9","18.6"
"Jones","2020-06-30","42","1971","4","203","24.4","18.8"
"Jones","2020-07-01","134","2105","15","218","22.4","19"
"Jones","2020-07-02","79","2184","9","227","23.1","19.5"
"Jones","2020-07-03","22","2206","3","230","21.5","20.5"
"Jones","2020-07-04","9","2215","2","232","18.1","19.7"
"Jones","2020-07-05","24","2239","9","241","18.7","20.9"
"Jones","2020-07-06","106","2345","12","253","16.7","20.3"
"Jones","2020-07-07","66","2411","18","271","19.2","21.8"
"Jones","2020-07-08","95","2506","13","284","19.6","21"
"Jones","2020-07-09","90","2596","25","309","21.9","22.5"
"Jones","2020-07-10","104","2700","11","320","21.5","21.5"
"Jones","2020-07-11","21","2721","5","325","21.7","19.9"
"Jones","2020-07-12","24","2745","9","334","21.7","20.2"
"Jones","2020-07-13","136","2881","36","370","23.9","20.3"
"Jones","2020-07-14","50","2931","7","377","22","20.6"
"Jones","2020-07-15","102","3033","10","387","21.4","20.5"
"Jones","2020-07-16","82","3115","28","415","22.3","22.1"
"Jones","2020-07-17","95","3210","21","436","24","22.7"
"Jones","2020-07-18","25","3235","7","443","24.6","23.1"
"Jones","2020-07-19","29","3264","5","448","21.7","21.7"
"Jones","2020-07-20","92","3356","10","458","19.5","21.7"
"Jones","2020-07-21","41","3397","11","469","21.3","21.6"
"Jones","2020-07-22","84","3481","11","480","21.8","21.6"
"Jones","2020-07-23","43","3524","6","486","18.9","20.6"
"Jones","2020-07-24","81","3605","11","497","17.7","20.8"
"Jones","2020-07-25","39","3644","7","504","16.2","20.4"
"Jones","2020-07-26","19","3663","11","515","22","21.9"
"Jones","2020-07-27","69","3732","14","529","23.4","21.4"
"Jones","2020-07-28","64","3796","12","541","22.2","21.8"
"Jones","2020-07-29","105","3901","17","558","22.7","22.2"
"Jones","2020-07-30","77","3978","17","575","23.8","21.3"
"Jones","2020-07-31","94","4072","20","595","24.9","21.3"
"Jones","2020-08-01","29","4101","5","600","24.8","20.5"
"Jones","2020-08-02","21","4122","5","605","19.9","21"
"Jones","2020-08-03","88","4210","7","612","18.2","20.8"
"Jones","2020-08-04","48","4258","12","624","19.1","20.6"
"Jones","2020-08-05","44","4302","6","630","18.7","20.7"
"Jones","2020-08-06","55","4357","11","641","18.4","21.1"
"Jones","2020-08-07","129","4486","16","657","17.1","21"
"Jones","2020-08-08","12","4498","5","662","20.6","22.7"
"Jones","2020-08-09","26","4524","2","664","18.3","19.1"
"Jones","2020-08-10","78","4602","14","678","19.8","19"
"Jones","2020-08-11","38","4640","5","683","18.1","18.6"
"Jones","2020-08-12","67","4707","8","691","17.8","18.3"
"Jones","2020-08-13","50","4757","6","697","16.7","17.6"
"Jones","2020-08-14","60","4817","8","705","16.8","17"
"Jones","2020-08-15","19","4836","5","710","14.6","17.6"
"Jones","2020-08-16","21","4857","3","713","15.6","17"
"Jones","2020-08-17","36","4893","2","715","13.8","16.8"
"Jones","2020-08-18","41","4934","4","719","13.3","15.7"
"Jones","2020-08-19","50","4984","3","722","12.5","15.1"
"Jones","2020-08-20","42","5026","8","730","13.5","15.1"
"Jones","2020-08-21","78","5104","14","744","14.1","15.5"
"Jones","2020-08-22","15","5119","4","748","14.2","14.4"
"Jones","2020-08-23","23","5142","3","751","14","14.8"
"Jones","2020-08-24","66","5208","5","756","14.3","14"
"Jones","2020-08-25","33","5241","7","763","15.9","14.6"
"Jones","2020-08-26","71","5312","11","774","17.3","14.9"
"Jones","2020-08-27","52","5364","6","780","16.2","14.8"
"Jones","2020-08-28","67","5431","5","785","14.7","14.4"
"Jones","2020-08-29","18","5449","2","787","12.5","13.3"
"Jones","2020-08-30","17","5466","2","789","12.3","13.2"
"Jones","2020-08-31","59","5525","7","796","12.9","13.6"
"Jones","2020-09-01","40","5565","6","802","12","14"
"Jones","2020-09-02","55","5620","5","807","11.1","14.2"
"Jones","2020-09-03","34","5654","5","812","11.6","13.9"
"Jones","2020-09-04","47","5701","6","818","12.3","13.5"
"Jones","2020-09-05","17","5718","6","824","15.8","14.1"
"Jones","2020-09-06","14","5732","2","826","16.1","14.2"
"Jones","2020-09-07","14","5746","3","829","17.5","15.2"
"Jones","2020-09-08","44","5790","2","831","16","14"
"Jones","2020-09-09","67","5857","6","837","16","13.6"
"Jones","2020-09-10","29","5886","6","843","16.9","14.2"
"Jones","2020-09-11","65","5951","0","843","15","13.7"
"Jones","2020-09-12","7","5958","0","843","10","12.9"
"Jones","2020-09-13","20","5978","0","843","7.9","12"
"Jones","2020-09-14","42","6020","2","845","5.6","11.5"
"Jones","2020-09-15","36","6056","2","847","5.7","10.9"
"Jones","2020-09-16","112","6168","9","856","5.6","10.8"
"Jones","2020-09-17","71","6239","2","858","3","9.9"
"Jones","2020-09-18","67","6306","2","860","3.5","9.2"
"Jones","2020-09-19","24","6330","3","863","5.2","7.6"
"Jones","2020-09-20","13","6343","0","863","5.2","6.6"
"Jones","2020-09-21","48","6391","6","869","6.3","6"
"Jones","2020-09-22","36","6427","5","874","7.5","6.6"
"Jones","2020-09-23","37","6464","3","877","7.5","6.6"
"Jones","2020-09-24","37","6501","4","881","8.7","5.9"
"Jones","2020-09-25","49","6550","4","885","9.4","6.4"
"Jones","2020-09-26","18","6568","1","886","8.4","6.8"
"Jones","2020-09-27","14","6582","6","892","14.6","9.9"
"Jones","2020-09-28","50","6632","7","899","14.8","10.6"
"Jones","2020-09-29","26","6658","0","899","12.8","10.2"
"Jones","2020-09-30","31","6689","5","904","13.9","10.7"
"Jones","2020-10-01","104","6793","3","907","12.8","10.7"
"Jones","2020-10-02","79","6872","6","913","12.7","11.1"
"Jones","2020-10-03","16","6888","3","916","14.6","11.5"
"Jones","2020-10-04","10","6898","0","916","8.5","11.5"
"Jones","2020-10-05","36","6934","2","918","7.3","11"
"Jones","2020-10-06","54","6988","1","919","7.5","10.2"
"Jones","2020-10-07","78","7066","4","923","6","9.9"
"Jones","2020-10-08","72","7138","1","924","5.8","9.3"
"Jones","2020-10-09","135","7273","7","931","5.4","9.1"
"Jones","2020-10-10","13","7286","3","934","6","10.3"
"Jones","2020-10-11","13","7299","3","937","9.3","8.9"
"Jones","2020-10-12","51","7350","6","943","10.2","8.7"
"Jones","2020-10-13","31","7381","2","945","10.9","9.2"
"Jones","2020-10-14","33","7414","3","948","11.4","8.7"
"Jones","2020-10-15","142","7556","4","952","11.6","8.7"
"Jones","2020-10-16","41","7597","1","953","11.2","8.3"
"Jones","2020-10-17","11","7608","0","953","7.9","7"
"Jones","2020-10-18","6","7614","2","955","9.4","9.4"
"Jones","2020-10-19","66","7680","4","959","8.6","9.4"
"Jones","2020-10-20","36","7716","2","961","8.5","9.7"
"Jones","2020-10-21","46","7762","5","966","8.7","10.1"
"Jones","2020-10-22","57","7819","1","967","8.6","10.1"
"Jones","2020-10-23","79","7898","1","968","8.4","9.8"
"Jones","2020-10-24","22","7920","1","969","9.1","8.5"
"Jones","2020-10-25","15","7935","0","969","4.3","6.9"
"Jones","2020-10-26","49","7984","4","973","4.6","6.6"
"Jones","2020-10-27","27","8011","4","977","5.9","7.2"
"Jones","2020-10-28","46","8057","7","984","6.5","7.6"
"Jones","2020-10-29","36","8093","2","986","7.1","7.8"
"Jones","2020-10-30","96","8189","3","989","7.3","7.9"
"Jones","2020-10-31","18","8207","1","990","7.5","8.3"
"Jones","2020-11-01","13","8220","1","991","8.6","6.4"
"Jones","2020-11-02","63","8283","5","996","8.6","6.6"
"Jones","2020-11-03","43","8326","4","1000","7.8","6.8"
"Jones","2020-11-04","71","8397","6","1006","6.8","6.7"
"Jones","2020-11-05","74","8471","4","1010","6.8","6.9"
"Jones","2020-11-06","72","8543","2","1012","6.7","7"
"Jones","2020-11-07","22","8565","5","1017","9.2","8.3"
"Jones","2020-11-08","8","8573","0","1017","8.1","8.3"
"Jones","2020-11-09","54","8627","6","1023","8.5","8.5"
"Jones","2020-11-10","50","8677","4","1027","8.4","8.1"
"Jones","2020-11-11","49","8726","6","1033","8.9","7.8"
"Jones","2020-11-12","44","8770","3","1036","9.1","7.9"
"Jones","2020-11-13","65","8835","3","1039","9.4","8"
"Jones","2020-11-14","19","8854","3","1042","8.4","8.8"
"Jones","2020-11-15","15","8869","1","1043","9.3","8.7"
"Jones","2020-11-16","67","8936","5","1048","8.8","8.7"
"Jones","2020-11-17","39","8975","8","1056","10.6","9.5"
"Jones","2020-11-18","43","9018","7","1063","11.2","10"
"Jones","2020-11-19","65","9083","7","1070","11.7","10.4"
"Jones","2020-11-20","67","9150","4","1074","11.9","10.6"
"Jones","2020-11-21","14","9164","1","1075","10.7","9.5"
"Jones","2020-11-22","10","9174","0","1075","9.7","9.5"
"Jones","2020-11-23","71","9245","5","1080","9.7","9.2"
"Jones","2020-11-24","50","9295","1","1081","7","8.8"
"Jones","2020-11-25","46","9341","9","1090","7.5","9.3"
"Jones","2020-11-26","24","9365","0","1090","6","8.8"
"Jones","2020-11-27","31","9396","1","1091","5.6","8.7"
"Jones","2020-11-28","11","9407","0","1091","4.5","7.6"
"Jones","2020-11-29","17","9424","3","1094","7.1","8.4"
"Jones","2020-11-30","68","9492","12","1106","8.6","9.1"
"Jones","2020-12-01","58","9550","8","1114","10.3","8.6"
"Jones","2020-12-02","40","9590","7","1121","10","8.7"
"Jones","2020-12-03","52","9642","6","1127","11.6","8.8"
"Jones","2020-12-04","54","9696","6","1133","12.7","9.2"
"Jones","2020-12-05","11","9707","1","1134","14","9.3"
"Jones","2020-12-06","22","9729","3","1137","13.5","10.3"
"Jones","2020-12-07","65","9794","7","1144","12.5","10.5"
"Jones","2020-12-08","69","9863","11","1155","12.8","11.5"
"Jones","2020-12-09","56","9919","8","1163","12.3","11.2"
"Jones","2020-12-10","83","10002","10","1173","12.4","12"
"Jones","2020-12-11","55","10057","7","1180","12.6","12.7"
"Jones","2020-12-12","31","10088","6","1186","14.1","14.1"
"Jones","2020-12-13","25","10113","8","1194","16.7","15.1"
"Jones","2020-12-14","67","10180","11","1205","17.5","15"
"Jones","2020-12-15","93","10273","17","1222","17.9","15.3"
"Jones","2020-12-16","72","10345","9","1231","17.6","15"
"Jones","2020-12-17","82","10427","9","1240","17.5","14.9"
"Jones","2020-12-18","41","10468","9","1249","18.8","15.7"
"Jones","2020-12-19","53","10521","13","1262","19.5","16.8"
"Jones","2020-12-20","50","10571","12","1274","18.4","17.6"
"Jones","2020-12-21","65","10636","10","1284","18.2","17.9"
"Jones","2020-12-22","95","10731","22","1306","18.9","18.4"
"Jones","2020-12-23","91","10822","17","1323","19.8","18.7"
"Jones","2020-12-24","53","10875","20","1343","23.6","20.5"
"Jones","2020-12-25","7","10882","2","1345","24.6","21.7"
"Jones","2020-12-26","87","10969","15","1360","23.5","21.5"
"Jones","2020-12-27","50","11019","16","1376","24.7","21.5"
"Jones","2020-12-28","117","11136","34","1410","26.6","22.4"
"Jones","2020-12-29","165","11301","59","1469","28.4","23.7"
"Jones","2020-12-30","96","11397","30","1499","30.2","25"
"Jones","2020-12-31","73","11470","14","1513","27.6","25.6"
"Jones","2021-01-01","23","11493","7","1520","27.8","26.2"
"Jones","2021-01-02","40","11533","8","1528","28.2","25.9"
"Jones","2021-01-03","37","11570","8","1536","26.8","25.7"
"Jones","2021-01-04","106","11676","21","1557","25.4","26"
"Jones","2021-01-05","246","11922","66","1623","24.2","26.3"
"Jones","2021-01-06","95","12017","7","1630","20.7","25.5"
"Jones","2021-01-07","57","12074","11","1641","20.8","24.2"
"Jones","2021-01-08","71","12145","16","1657","19.6","23.7"
"Jones","2021-01-09","49","12194","17","1674","21.7","25"
"Jones","2021-01-10","33","12227","8","1682","22.1","24.4"
"Jones","2021-01-11","83","12310","22","1704","23.1","24.3"
"Jones","2021-01-12","77","12387","17","1721","22.4","23.3"
"Jones","2021-01-13","76","12463","13","1734","23.8","22.3"
"Jones","2021-01-14","58","12521","10","1744","23.5","22.1"
"Jones","2021-01-15","82","12603","9","1753","21.8","20.7"
"Jones","2021-01-16","29","12632","6","1759","19.8","20.8"
"Jones","2021-01-17","36","12668","6","1765","18.8","20.4"
"Jones","2021-01-18","64","12732","9","1774","17","20"
"Jones","2021-01-19","59","12791","13","1787","17","19.7"
"Jones","2021-01-20","75","12866","11","1798","16.6","20.2"
"Jones","2021-01-21","59","12925","13","1811","17.3","20.4"
"Jones","2021-01-22","69","12994","15","1826","18.8","20.3"
"Jones","2021-01-23","38","13032","11","1837","20","19.9"
"Jones","2021-01-24","32","13064","1","1838","18.1","18.4"
"Jones","2021-01-25","75","13139","8","1846","17.6","17.3"
"Jones","2021-01-26","83","13222","17","1863","17.4","17.2"
"Jones","2021-01-27","101","13323","17","1880","17.7","17.2"
"Jones","2021-01-28","57","13380","9","1889","16.8","17.1"
"Jones","2021-01-29","51","13431","10","1899","16.5","17.7"
"Jones","2021-01-30","28","13459","5","1904","14.9","17.5"
"Jones","2021-01-31","10","13469","1","1905","15.9","17"
"Jones","2021-02-01","48","13517","11","1916","17.6","17.6"
"Jones","2021-02-02","51","13568","8","1924","17","17.2"
"Jones","2021-02-03","77","13645","8","1932","16","16.9"
"Jones","2021-02-04","45","13690","4","1936","15","15.9"
"Jones","2021-02-05","56","13746","7","1943","14","15.3"
"Jones","2021-02-06","10","13756","2","1945","14.3","14.6"
"Jones","2021-02-07","2","13758","0","1945","12.9","14.4"
"Jones","2021-02-08","0","13758","0","1945","9.6","13.6"
"Lamar","2020-02-01","0","0","0","0",".","."
"Lamar","2020-02-02","0","0","0","0",".","."
"Lamar","2020-02-03","0","0","0","0",".","."
"Lamar","2020-02-04","0","0","0","0",".","."
"Lamar","2020-02-05","0","0","0","0",".","."
"Lamar","2020-02-06","0","0","0","0",".","."
"Lamar","2020-02-07","0","0","0","0","0","."
"Lamar","2020-02-08","0","0","0","0","0","."
"Lamar","2020-02-09","0","0","0","0","0","."
"Lamar","2020-02-10","0","0","0","0","0","."
"Lamar","2020-02-11","0","0","0","0","0","."
"Lamar","2020-02-12","0","0","0","0","0","."
"Lamar","2020-02-13","0","0","0","0","0","."
"Lamar","2020-02-14","0","0","0","0","0","0"
"Lamar","2020-02-15","0","0","0","0","0","0"
"Lamar","2020-02-16","0","0","0","0","0","0"
"Lamar","2020-02-17","0","0","0","0","0","0"
"Lamar","2020-02-18","0","0","0","0","0","0"
"Lamar","2020-02-19","0","0","0","0","0","0"
"Lamar","2020-02-20","0","0","0","0","0","0"
"Lamar","2020-02-21","0","0","0","0","0","0"
"Lamar","2020-02-22","0","0","0","0","0","0"
"Lamar","2020-02-23","0","0","0","0","0","0"
"Lamar","2020-02-24","0","0","0","0","0","0"
"Lamar","2020-02-25","0","0","0","0","0","0"
"Lamar","2020-02-26","0","0","0","0","0","0"
"Lamar","2020-02-27","0","0","0","0","0","0"
"Lamar","2020-02-28","0","0","0","0","0","0"
"Lamar","2020-02-29","0","0","0","0","0","0"
"Lamar","2020-03-01","0","0","0","0","0","0"
"Lamar","2020-03-02","0","0","0","0","0","0"
"Lamar","2020-03-03","0","0","0","0","0","0"
"Lamar","2020-03-04","0","0","0","0","0","0"
"Lamar","2020-03-05","0","0","0","0","0","0"
"Lamar","2020-03-06","0","0","0","0","0","0"
"Lamar","2020-03-07","0","0","0","0","0","0"
"Lamar","2020-03-08","0","0","0","0","0","0"
"Lamar","2020-03-09","0","0","0","0","0","0"
"Lamar","2020-03-10","2","2","0","0","0","0"
"Lamar","2020-03-11","2","4","0","0","0","0"
"Lamar","2020-03-12","0","4","0","0","0","0"
"Lamar","2020-03-13","2","6","0","0","0","0"
"Lamar","2020-03-14","0","6","0","0","0","0"
"Lamar","2020-03-15","0","6","0","0","0","0"
"Lamar","2020-03-16","1","7","0","0","0","0"
"Lamar","2020-03-17","3","10","0","0","0","0"
"Lamar","2020-03-18","1","11","0","0","0","0"
"Lamar","2020-03-19","1","12","0","0","0","0"
"Lamar","2020-03-20","4","16","2","2","7.1","3.6"
"Lamar","2020-03-21","3","19","0","2","7.1","3.6"
"Lamar","2020-03-22","5","24","1","3","10","5"
"Lamar","2020-03-23","10","34","1","4","11.4","5.7"
"Lamar","2020-03-24","12","46","2","6","13.8","6.9"
"Lamar","2020-03-25","5","51","0","6","13.8","6.9"
"Lamar","2020-03-26","9","60","1","7","15.4","7.7"
"Lamar","2020-03-27","9","69","5","12","16.2","11.7"
"Lamar","2020-03-28","4","73","0","12","16.2","11.7"
"Lamar","2020-03-29","4","77","0","12","13.3","11.7"
"Lamar","2020-03-30","4","81","0","12","11.9","11.7"
"Lamar","2020-03-31","6","87","2","14","14.3","14"
"Lamar","2020-04-01","13","100","2","16","16.5","15.1"
"Lamar","2020-04-02","6","106","0","16","14.9","15.1"
"Lamar","2020-04-03","6","112","1","17","9.3","12.8"
"Lamar","2020-04-04","0","112","0","17","9.3","12.8"
"Lamar","2020-04-05","1","113","1","18","23.6","18.5"
"Lamar","2020-04-06","7","120","1","19","25.7","18.8"
"Lamar","2020-04-07","9","129","0","19","20.9","17.6"
"Lamar","2020-04-08","13","142","0","19","18.7","17.6"
"Lamar","2020-04-09","14","156","2","21","20.7","17.8"
"Lamar","2020-04-10","8","164","1","22","20.2","14.7"
"Lamar","2020-04-11","4","168","0","22","20.2","14.7"
"Lamar","2020-04-12","1","169","0","22","5.9","14.7"
"Lamar","2020-04-13","10","179","1","23","5.3","15.5"
"Lamar","2020-04-14","8","187","0","23","5.3","13.1"
"Lamar","2020-04-15","21","208","2","25","6.6","12.7"
"Lamar","2020-04-16","7","215","0","25","4.6","12.7"
"Lamar","2020-04-17","7","222","2","27","6.9","13.5"
"Lamar","2020-04-18","3","225","0","27","6.9","13.5"
"Lamar","2020-04-19","2","227","0","27","6.9","6.4"
"Lamar","2020-04-20","17","244","2","29","7.1","6.2"
"Lamar","2020-04-21","21","265","1","30","7.8","6.5"
"Lamar","2020-04-22","38","303","3","33","7.6","7.1"
"Lamar","2020-04-23","17","320","1","34","8.4","6.5"
"Lamar","2020-04-24","14","334","3","37","7.4","7.1"
"Lamar","2020-04-25","4","338","0","37","7.4","7.1"
"Lamar","2020-04-26","3","341","0","37","7.4","7.1"
"Lamar","2020-04-27","18","359","4","41","8.9","8"
"Lamar","2020-04-28","16","375","1","42","9.1","8.4"
"Lamar","2020-04-29","12","387","0","42","8","7.8"
"Lamar","2020-04-30","12","399","0","42","7.1","7.8"
"Lamar","2020-05-01","4","403","0","42","4.1","5.7"
"Lamar","2020-05-02","7","410","0","42","4.1","5.7"
"Lamar","2020-05-03","5","415","0","42","4.1","5.7"
"Lamar","2020-05-04","13","428","1","43","2","5.4"
"Lamar","2020-05-05","7","435","0","43","1.1","5.1"
"Lamar","2020-05-06","5","440","1","44","4","6"
"Lamar","2020-05-07","9","449","2","46","7.1","7.1"
"Lamar","2020-05-08","10","459","0","46","7.1","5.6"
"Lamar","2020-05-09","4","463","0","46","7.1","5.6"
"Lamar","2020-05-10","0","463","0","46","7.1","5.6"
"Lamar","2020-05-11","10","473","0","46","6","4"
"Lamar","2020-05-12","8","481","1","47","7.8","4.5"
"Lamar","2020-05-13","13","494","1","48","6.1","5"
"Lamar","2020-05-14","9","503","2","50","6.1","6.6"
"Lamar","2020-05-15","23","526","6","56","9.8","8.5"
"Lamar","2020-05-16","7","533","0","56","9.8","8.5"
"Lamar","2020-05-17","4","537","1","57","13.4","10.2"
"Lamar","2020-05-18","20","557","1","58","14.1","10.1"
"Lamar","2020-05-19","21","578","2","60","13.6","10.7"
"Lamar","2020-05-20","43","621","10","70","15.9","11"
"Lamar","2020-05-21","13","634","2","72","14.9","10.5"
"Lamar","2020-05-22","9","643","0","72","11.2","10.5"
"Lamar","2020-05-23","10","653","2","74","14","11.9"
"Lamar","2020-05-24","6","659","0","74","10.5","11.9"
"Lamar","2020-05-25","3","662","0","74","9.7","11.9"
"Lamar","2020-05-26","18","680","1","75","9.2","11.4"
"Lamar","2020-05-27","110","790","2","77","6.1","11"
"Lamar","2020-05-28","8","798","0","77","3.9","9.4"
"Lamar","2020-05-29","10","808","1","78","5.3","8.3"
"Lamar","2020-05-30","7","815","1","79","4.5","9.3"
"Lamar","2020-05-31","0","815","0","79","4.5","7.5"
"Lamar","2020-06-01","17","832","0","79","4.5","7.1"
"Lamar","2020-06-02","13","845","1","80","4.8","7"
"Lamar","2020-06-03","16","861","0","80","4.6","5.3"
"Lamar","2020-06-04","17","878","2","82","6.2","5.1"
"Lamar","2020-06-05","16","894","0","82","4.8","5.1"
"Lamar","2020-06-06","5","899","0","82","2.8","3.7"
"Lamar","2020-06-07","5","904","1","83","5.6","5.1"
"Lamar","2020-06-08","12","916","1","84","6.8","5.7"
"Lamar","2020-06-09","17","933","0","84","5.7","5.3"
"Lamar","2020-06-10","20","953","6","90","10","7.3"
"Lamar","2020-06-11","20","973","2","92","9.8","8"
"Lamar","2020-06-12","13","986","0","92","9.8","7.3"
"Lamar","2020-06-13","7","993","0","92","9.8","6.3"
"Lamar","2020-06-14","3","996","0","92","6.9","6.3"
"Lamar","2020-06-15","22","1018","3","95","7.7","7.2"
"Lamar","2020-06-16","25","1043","2","97","8.8","7.3"
"Lamar","2020-06-17","23","1066","1","98","5.1","7.6"
"Lamar","2020-06-18","15","1081","3","101","6.6","8.2"
"Lamar","2020-06-19","21","1102","3","104","8.6","9.2"
"Lamar","2020-06-20","19","1121","3","107","10.9","10.3"
"Lamar","2020-06-21","2","1123","0","107","10.9","8.9"
"Lamar","2020-06-22","38","1161","1","108","9.3","8.5"
"Lamar","2020-06-23","31","1192","0","108","8.2","8.5"
"Lamar","2020-06-24","28","1220","3","111","9.1","7.1"
"Lamar","2020-06-25","27","1247","3","114","7.8","7.2"
"Lamar","2020-06-26","21","1268","8","122","11.2","9.9"
"Lamar","2020-06-27","19","1287","2","124","10.4","10.7"
"Lamar","2020-06-28","8","1295","2","126","14","12.4"
"Lamar","2020-06-29","19","1314","1","127","14.4","11.8"
"Lamar","2020-06-30","34","1348","2","129","15.2","11.7"
"Lamar","2020-07-01","35","1383","2","131","14.5","11.8"
"Lamar","2020-07-02","127","1510","9","140","13.9","10.9"
"Lamar","2020-07-03","15","1525","1","141","9.4","10.3"
"Lamar","2020-07-04","10","1535","1","142","9.4","9.9"
"Lamar","2020-07-05","6","1541","0","142","5.8","9.9"
"Lamar","2020-07-06","90","1631","1","143","5.2","9.8"
"Lamar","2020-07-07","34","1665","2","145","5.2","10.2"
"Lamar","2020-07-08","22","1687","2","147","5.7","10.1"
"Lamar","2020-07-09","157","1844","4","151","5","9.5"
"Lamar","2020-07-10","44","1888","1","152","4.4","6.9"
"Lamar","2020-07-11","18","1906","3","155","5.4","7.4"
"Lamar","2020-07-12","8","1914","1","156","7.2","6.5"
"Lamar","2020-07-13","35","1949","5","161","9","7.1"
"Lamar","2020-07-14","30","1979","6","167","11.1","8.1"
"Lamar","2020-07-15","23","2002","2","169","11","8.3"
"Lamar","2020-07-16","131","2133","6","175","11.3","8.2"
"Lamar","2020-07-17","44","2177","0","175","11","7.7"
"Lamar","2020-07-18","26","2203","1","176","9.1","7.2"
"Lamar","2020-07-19","6","2209","1","177","9.7","8.4"
"Lamar","2020-07-20","44","2253","6","183","9.6","9.3"
"Lamar","2020-07-21","24","2277","2","185","8","9.5"
"Lamar","2020-07-22","29","2306","3","188","8.2","9.6"
"Lamar","2020-07-23","184","2490","17","205","8.9","10.1"
"Lamar","2020-07-24","32","2522","3","208","10.2","10.6"
"Lamar","2020-07-25","33","2555","5","213","11.8","10.5"
"Lamar","2020-07-26","9","2564","2","215","12.6","11.2"
"Lamar","2020-07-27","39","2603","2","217","11.4","10.5"
"Lamar","2020-07-28","39","2642","2","219","10.9","9.5"
"Lamar","2020-07-29","16","2658","0","219","9.5","8.8"
"Lamar","2020-07-30","150","2808","19","238","10","9.4"
"Lamar","2020-07-31","31","2839","9","247","12.8","11.5"
"Lamar","2020-08-01","20","2859","1","248","11.3","11.6"
"Lamar","2020-08-02","9","2868","2","250","11.3","12"
"Lamar","2020-08-03","34","2902","5","255","12.7","12"
"Lamar","2020-08-04","26","2928","5","260","14.7","12.8"
"Lamar","2020-08-05","40","2968","4","264","16.1","12.8"
"Lamar","2020-08-06","101","3069","5","269","15","12.5"
"Lamar","2020-08-07","19","3088","2","271","12.4","12.6"
"Lamar","2020-08-08","18","3106","2","273","13.2","12.3"
"Lamar","2020-08-09","9","3115","3","276","14.8","13.1"
"Lamar","2020-08-10","21","3136","1","277","13.4","13"
"Lamar","2020-08-11","21","3157","3","280","12.7","13.7"
"Lamar","2020-08-12","29","3186","5","285","13.7","14.9"
"Lamar","2020-08-13","76","3262","1","286","13.2","14.1"
"Lamar","2020-08-14","41","3303","3","289","12.8","12.6"
"Lamar","2020-08-15","34","3337","4","293","12.9","13.1"
"Lamar","2020-08-16","9","3346","1","294","9.7","12.3"
"Lamar","2020-08-17","44","3390","3","297","10","11.7"
"Lamar","2020-08-18","48","3438","1","298","8.2","10.5"
"Lamar","2020-08-19","35","3473","6","304","8.2","11"
"Lamar","2020-08-20","99","3572","4","308","8.6","10.9"
"Lamar","2020-08-21","43","3615","2","310","8.2","10.5"
"Lamar","2020-08-22","57","3672","1","311","6.8","9.8"
"Lamar","2020-08-23","9","3681","1","312","6.8","8.2"
"Lamar","2020-08-24","36","3717","4","316","7.4","8.7"
"Lamar","2020-08-25","45","3762","1","317","7.4","7.8"
"Lamar","2020-08-26","40","3802","1","318","5.3","6.8"
"Lamar","2020-08-27","87","3889","0","318","4.8","6.7"
"Lamar","2020-08-28","34","3923","3","321","5.4","6.8"
"Lamar","2020-08-29","13","3936","0","321","5.1","6"
"Lamar","2020-08-30","6","3942","0","321","3.5","5.2"
"Lamar","2020-08-31","29","3971","2","323","2.9","5.2"
"Lamar","2020-09-01","24","3995","2","325","3.8","5.6"
"Lamar","2020-09-02","33","4028","2","327","4.3","4.8"
"Lamar","2020-09-03","44","4072","0","327","4.3","4.5"
"Lamar","2020-09-04","29","4101","1","328","3.5","4.4"
"Lamar","2020-09-05","37","4138","2","330","4.3","4.7"
"Lamar","2020-09-06","6","4144","1","331","6.7","5.1"
"Lamar","2020-09-07","7","4151","1","332","7.7","5.3"
"Lamar","2020-09-08","25","4176","2","334","7.7","5.7"
"Lamar","2020-09-09","35","4211","0","334","6.8","5.6"
"Lamar","2020-09-10","43","4254","0","334","6.8","5.6"
"Lamar","2020-09-11","25","4279","3","337","8.1","5.8"
"Lamar","2020-09-12","5","4284","1","338","10.1","7.2"
"Lamar","2020-09-13","3","4287","1","339","12.5","9.6"
"Lamar","2020-09-14","52","4339","4","343","11.6","9.7"
"Lamar","2020-09-15","24","4363","0","343","10.4","9.1"
"Lamar","2020-09-16","14","4377","0","343","10.4","8.6"
"Lamar","2020-09-17","22","4399","1","344","11.1","9"
"Lamar","2020-09-18","18","4417","3","347","11.7","9.9"
"Lamar","2020-09-19","17","4434","0","347","8.9","9.5"
"Lamar","2020-09-20","5","4439","0","347","4.1","8.3"
"Lamar","2020-09-21","36","4475","1","348","3.4","7.5"
"Lamar","2020-09-22","34","4509","4","352","5.1","7.8"
"Lamar","2020-09-23","25","4534","2","354","6.3","8.3"
"Lamar","2020-09-24","65","4599","1","355","5.8","8.5"
"Lamar","2020-09-25","28","4627","3","358","5","8.4"
"Lamar","2020-09-26","18","4645","1","359","5.8","7.3"
"Lamar","2020-09-27","7","4652","2","361","9.8","7"
"Lamar","2020-09-28","27","4679","2","363","10.5","7"
"Lamar","2020-09-29","34","4713","1","364","9.2","7.2"
"Lamar","2020-09-30","28","4741","1","365","8.6","7.4"
"Lamar","2020-10-01","72","4813","4","369","9.2","7.5"
"Lamar","2020-10-02","39","4852","0","369","7.7","6.3"
"Lamar","2020-10-03","14","4866","0","369","6.9","6.3"
"Lamar","2020-10-04","9","4875","1","370","4.4","7.1"
"Lamar","2020-10-05","45","4920","2","372","3.9","7.2"
"Lamar","2020-10-06","53","4973","3","375","4.3","6.8"
"Lamar","2020-10-07","37","5010","1","376","4.2","6.4"
"Lamar","2020-10-08","54","5064","0","376","3.4","6.3"
"Lamar","2020-10-09","26","5090","0","376","3.4","5.5"
"Lamar","2020-10-10","13","5103","0","376","3.4","5.1"
"Lamar","2020-10-11","7","5110","0","376","1.8","3.1"
"Lamar","2020-10-12","32","5142","1","377","1.6","2.8"
"Lamar","2020-10-13","35","5177","3","380","2.1","3.2"
"Lamar","2020-10-14","31","5208","1","381","2.1","3.2"
"Lamar","2020-10-15","45","5253","2","383","2.8","3.1"
"Lamar","2020-10-16","33","5286","2","385","3.6","3.5"
"Lamar","2020-10-17","17","5303","0","385","3.6","3.5"
"Lamar","2020-10-18","7","5310","0","385","3.6","2.7"
"Lamar","2020-10-19","40","5350","1","386","3.5","2.6"
"Lamar","2020-10-20","43","5393","2","388","3","2.5"
"Lamar","2020-10-21","18","5411","1","389","3.3","2.7"
"Lamar","2020-10-22","32","5443","3","392","4","3.4"
"Lamar","2020-10-23","72","5515","8","400","4.7","4.2"
"Lamar","2020-10-24","20","5535","1","401","5.5","4.5"
"Lamar","2020-10-25","11","5546","1","402","6.8","5.2"
"Lamar","2020-10-26","26","5572","3","405","8","5.8"
"Lamar","2020-10-27","25","5597","1","406","8","5.5"
"Lamar","2020-10-28","23","5620","1","407","7.8","5.5"
"Lamar","2020-10-29","27","5647","2","409","7.5","5.8"
"Lamar","2020-10-30","28","5675","3","412","7.4","6.1"
"Lamar","2020-10-31","27","5702","8","420","11","8.2"
"Lamar","2020-11-01","11","5713","1","421","11","8.9"
"Lamar","2020-11-02","32","5745","4","425","11.1","9.6"
"Lamar","2020-11-03","19","5764","1","426","11.3","9.6"
"Lamar","2020-11-04","37","5801","1","427","11","9.4"
"Lamar","2020-11-05","87","5888","7","434","11.1","9.3"
"Lamar","2020-11-06","36","5924","1","435","10","8.7"
"Lamar","2020-11-07","41","5965","7","442","8.2","9.6"
"Lamar","2020-11-08","6","5971","0","442","6.9","8.9"
"Lamar","2020-11-09","41","6012","7","449","7.6","9.3"
"Lamar","2020-11-10","33","6045","2","451","7.7","9.5"
"Lamar","2020-11-11","48","6093","5","456","8.8","9.9"
"Lamar","2020-11-12","52","6145","3","459","8.5","9.8"
"Lamar","2020-11-13","46","6191","4","463","9.3","9.6"
"Lamar","2020-11-14","23","6214","3","466","8.7","8.5"
"Lamar","2020-11-15","17","6231","4","470","12.1","9.5"
"Lamar","2020-11-16","37","6268","4","474","11.2","9.4"
"Lamar","2020-11-17","31","6299","3","477","11.7","9.7"
"Lamar","2020-11-18","47","6346","7","484","12.3","10.6"
"Lamar","2020-11-19","76","6422","5","489","12.5","10.5"
"Lamar","2020-11-20","55","6477","10","499","13.8","11.6"
"Lamar","2020-11-21","41","6518","9","508","15.1","11.9"
"Lamar","2020-11-22","7","6525","2","510","15.8","13.9"
"Lamar","2020-11-23","29","6554","6","516","17.2","14.2"
"Lamar","2020-11-24","35","6589","7","523","18.7","15.2"
"Lamar","2020-11-25","39","6628","4","527","18","15.2"
"Lamar","2020-11-26","7","6635","0","527","17.1","14.8"
"Lamar","2020-11-27","36","6671","4","531","16.1","14.9"
"Lamar","2020-11-28","58","6729","7","538","14.7","14.9"
"Lamar","2020-11-29","9","6738","1","539","12.2","14"
"Lamar","2020-11-30","41","6779","4","543","10.6","13.9"
"Lamar","2020-12-01","52","6831","14","557","11.6","15.1"
"Lamar","2020-12-02","32","6863","5","562","12.4","15.2"
"Lamar","2020-12-03","105","6968","9","571","13.6","15.3"
"Lamar","2020-12-04","46","7014","6","577","13.9","15"
"Lamar","2020-12-05","14","7028","1","578","13.2","13.9"
"Lamar","2020-12-06","9","7037","4","582","17.9","15.1"
"Lamar","2020-12-07","39","7076","8","590","19.5","15"
"Lamar","2020-12-08","44","7120","12","602","19.5","15.6"
"Lamar","2020-12-09","66","7186","5","607","18.4","15.4"
"Lamar","2020-12-10","151","7337","17","624","18.8","16.2"
"Lamar","2020-12-11","43","7380","4","628","18.2","16"
"Lamar","2020-12-12","75","7455","5","633","18.1","15.7"
"Lamar","2020-12-13","27","7482","6","639","15","16.5"
"Lamar","2020-12-14","76","7558","12","651","14.3","16.9"
"Lamar","2020-12-15","93","7651","12","663","12.2","15.9"
"Lamar","2020-12-16","48","7699","15","678","15.6","17"
"Lamar","2020-12-17","142","7841","26","704","16.6","17.7"
"Lamar","2020-12-18","33","7874","4","708","17","17.6"
"Lamar","2020-12-19","24","7898","6","714","19.7","18.9"
"Lamar","2020-12-20","13","7911","2","716","18.7","16.8"
"Lamar","2020-12-21","33","7944","9","725","20.3","17.3"
"Lamar","2020-12-22","63","8007","12","737","21.2","16.7"
"Lamar","2020-12-23","50","8057","9","746","19.3","17.5"
"Lamar","2020-12-24","31","8088","14","760","23.1","19.9"
"Lamar","2020-12-25","2","8090","2","762","35.7","26.4"
"Lamar","2020-12-26","25","8115","7","769","36.1","27.9"
"Lamar","2020-12-27","17","8132","6","775","39","28.8"
"Lamar","2020-12-28","94","8226","19","794","38","29.1"
"Lamar","2020-12-29","80","8306","19","813","38.6","29.9"
"Lamar","2020-12-30","59","8365","22","835","41.4","30.3"
"Lamar","2020-12-31","213","8578","49","884","38.2","30.7"
"Lamar","2021-01-01","5","8583","2","886","29.6","32.7"
"Lamar","2021-01-02","14","8597","6","892","31.8","33.9"
"Lamar","2021-01-03","28","8625","7","899","30.3","34.6"
"Lamar","2021-01-04","62","8687","18","917","31.6","34.8"
"Lamar","2021-01-05","70","8757","23","940","32.9","35.7"
"Lamar","2021-01-06","68","8825","12","952","30.1","35.7"
"Lamar","2021-01-07","170","8995","23","975","28.7","33.5"
"Lamar","2021-01-08","51","9046","9","984","25.5","27.6"
"Lamar","2021-01-09","34","9080","12","996","24.4","28.1"
"Lamar","2021-01-10","13","9093","0","996","20.9","25.6"
"Lamar","2021-01-11","71","9164","16","1012","19.9","25.7"
"Lamar","2021-01-12","52","9216","15","1027","19.4","26.1"
"Lamar","2021-01-13","57","9273","14","1041","20.3","25.2"
"Lamar","2021-01-14","171","9444","25","1066","20.5","24.6"
"Lamar","2021-01-15","55","9499","11","1077","20.8","23.2"
"Lamar","2021-01-16","25","9524","4","1081","18.1","21.3"
"Lamar","2021-01-17","23","9547","5","1086","21.2","21"
"Lamar","2021-01-18","53","9600","9","1095","20.4","20.2"
"Lamar","2021-01-19","45","9645","11","1106","19.8","19.6"
"Lamar","2021-01-20","52","9697","15","1121","20.4","20.4"
"Lamar","2021-01-21","147","9844","23","1144","20.5","20.5"
"Lamar","2021-01-22","48","9892","15","1159","22.1","21.5"
"Lamar","2021-01-23","36","9928","4","1163","21.4","19.8"
"Lamar","2021-01-24","18","9946","4","1167","21.5","21.3"
"Lamar","2021-01-25","51","9997","11","1178","22.2","21.3"
"Lamar","2021-01-26","46","10043","9","1187","21.5","20.6"
"Lamar","2021-01-27","49","10092","12","1199","20.8","20.6"
"Lamar","2021-01-28","109","10201","11","1210","20","20.3"
"Lamar","2021-01-29","40","10241","4","1214","17","19.6"
"Lamar","2021-01-30","26","10267","0","1214","15.4","18.4"
"Lamar","2021-01-31","14","10281","5","1219","17.3","19.4"
"Lamar","2021-02-01","42","10323","4","1223","15.6","18.9"
"Lamar","2021-02-02","53","10376","8","1231","15","18.2"
"Lamar","2021-02-03","35","10411","4","1235","13.1","17"
"Lamar","2021-02-04","82","10493","5","1240","12.6","16.3"
"Lamar","2021-02-05","32","10525","4","1244","12.9","15"
"Lamar","2021-02-06","14","10539","0","1244","12.9","14.2"
"Lamar","2021-02-07","4","10543","0","1244","7.8","12.6"
"Lamar","2021-02-08","0","10543","0","1244","6.4","11"
"Lanier","2020-02-01","0","0","0","0",".","."
"Lanier","2020-02-02","0","0","0","0",".","."
"Lanier","2020-02-03","0","0","0","0",".","."
"Lanier","2020-02-04","0","0","0","0",".","."
"Lanier","2020-02-05","0","0","0","0",".","."
"Lanier","2020-02-06","0","0","0","0",".","."
"Lanier","2020-02-07","0","0","0","0","0","."
"Lanier","2020-02-08","0","0","0","0","0","."
"Lanier","2020-02-09","0","0","0","0","0","."
"Lanier","2020-02-10","0","0","0","0","0","."
"Lanier","2020-02-11","0","0","0","0","0","."
"Lanier","2020-02-12","0","0","0","0","0","."
"Lanier","2020-02-13","0","0","0","0","0","."
"Lanier","2020-02-14","0","0","0","0","0","0"
"Lanier","2020-02-15","0","0","0","0","0","0"
"Lanier","2020-02-16","0","0","0","0","0","0"
"Lanier","2020-02-17","0","0","0","0","0","0"
"Lanier","2020-02-18","0","0","0","0","0","0"
"Lanier","2020-02-19","0","0","0","0","0","0"
"Lanier","2020-02-20","0","0","0","0","0","0"
"Lanier","2020-02-21","0","0","0","0","0","0"
"Lanier","2020-02-22","0","0","0","0","0","0"
"Lanier","2020-02-23","0","0","0","0","0","0"
"Lanier","2020-02-24","0","0","0","0","0","0"
"Lanier","2020-02-25","0","0","0","0","0","0"
"Lanier","2020-02-26","0","0","0","0","0","0"
"Lanier","2020-02-27","0","0","0","0","0","0"
"Lanier","2020-02-28","0","0","0","0","0","0"
"Lanier","2020-02-29","0","0","0","0","0","0"
"Lanier","2020-03-01","0","0","0","0","0","0"
"Lanier","2020-03-02","0","0","0","0","0","0"
"Lanier","2020-03-03","0","0","0","0","0","0"
"Lanier","2020-03-04","0","0","0","0","0","0"
"Lanier","2020-03-05","0","0","0","0","0","0"
"Lanier","2020-03-06","0","0","0","0","0","0"
"Lanier","2020-03-07","0","0","0","0","0","0"
"Lanier","2020-03-08","0","0","0","0","0","0"
"Lanier","2020-03-09","0","0","0","0","0","0"
"Lanier","2020-03-10","0","0","0","0","0","0"
"Lanier","2020-03-11","0","0","0","0","0","0"
"Lanier","2020-03-12","0","0","0","0","0","0"
"Lanier","2020-03-13","0","0","0","0","0","0"
"Lanier","2020-03-14","0","0","0","0","0","0"
"Lanier","2020-03-15","0","0","0","0","0","0"
"Lanier","2020-03-16","0","0","0","0","0","0"
"Lanier","2020-03-17","0","0","0","0","0","0"
"Lanier","2020-03-18","1","1","0","0","0","0"
"Lanier","2020-03-19","2","3","0","0","0","0"
"Lanier","2020-03-20","0","3","0","0","0","0"
"Lanier","2020-03-21","0","3","0","0","0","0"
"Lanier","2020-03-22","0","3","0","0","0","0"
"Lanier","2020-03-23","1","4","0","0","0","0"
"Lanier","2020-03-24","1","5","0","0","0","0"
"Lanier","2020-03-25","0","5","0","0","0","0"
"Lanier","2020-03-26","0","5","0","0","0","0"
"Lanier","2020-03-27","3","8","0","0","0","0"
"Lanier","2020-03-28","0","8","0","0","0","0"
"Lanier","2020-03-29","1","9","0","0","0","0"
"Lanier","2020-03-30","1","10","0","0","0","0"
"Lanier","2020-03-31","1","11","1","1","14.3","7.1"
"Lanier","2020-04-01","3","14","0","1","14.3","7.1"
"Lanier","2020-04-02","1","15","0","1","14.3","7.1"
"Lanier","2020-04-03","3","18","1","2","19","9.5"
"Lanier","2020-04-04","4","22","3","5","29.8","14.9"
"Lanier","2020-04-05","0","22","0","5","29.8","14.9"
"Lanier","2020-04-06","3","25","0","5","29.8","14.9"
"Lanier","2020-04-07","4","29","0","5","15.5","14.9"
"Lanier","2020-04-08","2","31","0","5","15.5","14.9"
"Lanier","2020-04-09","1","32","0","5","15.5","14.9"
"Lanier","2020-04-10","0","32","0","5","10.7","14.9"
"Lanier","2020-04-11","0","32","0","5","0","14.9"
"Lanier","2020-04-12","0","32","0","5","0","14.9"
"Lanier","2020-04-13","2","34","0","5","0","14.9"
"Lanier","2020-04-14","4","38","0","5","0","7.7"
"Lanier","2020-04-15","4","42","0","5","0","7.7"
"Lanier","2020-04-16","5","47","0","5","0","7.7"
"Lanier","2020-04-17","2","49","0","5","0","5.4"
"Lanier","2020-04-18","15","64","4","9","3.8","1.9"
"Lanier","2020-04-19","1","65","0","9","3.8","1.9"
"Lanier","2020-04-20","3","68","0","9","3.8","1.9"
"Lanier","2020-04-21","3","71","0","9","3.8","1.9"
"Lanier","2020-04-22","3","74","1","10","8.6","4.3"
"Lanier","2020-04-23","3","77","0","10","8.6","4.3"
"Lanier","2020-04-24","2","79","0","10","8.6","4.3"
"Lanier","2020-04-25","0","79","0","10","4.8","4.3"
"Lanier","2020-04-26","2","81","0","10","4.8","4.3"
"Lanier","2020-04-27","7","88","1","11","6.8","5.3"
"Lanier","2020-04-28","3","91","0","11","6.8","5.3"
"Lanier","2020-04-29","3","94","0","11","2","5.3"
"Lanier","2020-04-30","4","98","0","11","2","5.3"
"Lanier","2020-05-01","10","108","1","12","3.5","6"
"Lanier","2020-05-02","0","108","0","12","3.5","4.1"
"Lanier","2020-05-03","0","108","0","12","3.5","4.1"
"Lanier","2020-05-04","7","115","0","12","1.4","4.1"
"Lanier","2020-05-05","8","123","0","12","1.4","4.1"
"Lanier","2020-05-06","1","124","0","12","1.4","1.7"
"Lanier","2020-05-07","2","126","0","12","1.4","1.7"
"Lanier","2020-05-08","3","129","1","13","4.8","4.1"
"Lanier","2020-05-09","1","130","0","13","4.8","4.1"
"Lanier","2020-05-10","0","130","0","13","4.8","4.1"
"Lanier","2020-05-11","22","152","0","13","4.8","3.1"
"Lanier","2020-05-12","17","169","0","13","4.8","3.1"
"Lanier","2020-05-13","3","172","0","13","4.8","3.1"
"Lanier","2020-05-14","7","179","0","13","4.8","3.1"
"Lanier","2020-05-15","5","184","0","13","0","2.4"
"Lanier","2020-05-16","0","184","0","13","0","2.4"
"Lanier","2020-05-17","0","184","0","13","0","2.4"
"Lanier","2020-05-18","14","198","1","14","1","2.9"
"Lanier","2020-05-19","20","218","1","15","1.7","3.2"
"Lanier","2020-05-20","7","225","0","15","1.7","3.2"
"Lanier","2020-05-21","1","226","0","15","1.7","3.2"
"Lanier","2020-05-22","2","228","0","15","1.7","0.9"
"Lanier","2020-05-23","0","228","0","15","1.7","0.9"
"Lanier","2020-05-24","1","229","1","16","16","8"
"Lanier","2020-05-25","1","230","0","16","15","8"
"Lanier","2020-05-26","29","259","5","21","16.7","9.2"
"Lanier","2020-05-27","3","262","1","22","21.5","11.6"
"Lanier","2020-05-28","8","270","0","22","21.5","11.6"
"Lanier","2020-05-29","6","276","1","23","23.9","12.8"
"Lanier","2020-05-30","0","276","0","23","23.9","12.8"
"Lanier","2020-05-31","2","278","2","25","23.9","20"
"Lanier","2020-06-01","10","288","0","25","23.9","19.4"
"Lanier","2020-06-02","10","298","2","27","24.3","20.5"
"Lanier","2020-06-03","5","303","2","29","25.2","23.4"
"Lanier","2020-06-04","6","309","0","29","25.2","23.4"
"Lanier","2020-06-05","10","319","0","29","22.9","23.4"
"Lanier","2020-06-06","2","321","0","29","22.9","23.4"
"Lanier","2020-06-07","6","327","5","34","20.5","22.2"
"Lanier","2020-06-08","51","378","1","35","20.8","22.3"
"Lanier","2020-06-09","33","411","0","35","17.9","21.1"
"Lanier","2020-06-10","9","420","3","38","16.9","21.1"
"Lanier","2020-06-11","14","434","6","44","23.1","24.2"
"Lanier","2020-06-12","9","443","1","45","24.7","23.8"
"Lanier","2020-06-13","0","443","0","45","24.7","23.8"
"Lanier","2020-06-14","0","443","0","45","12.8","16.6"
"Lanier","2020-06-15","38","481","5","50","14.4","17.6"
"Lanier","2020-06-16","38","519","2","52","15.1","16.5"
"Lanier","2020-06-17","15","534","1","53","11.3","14.1"
"Lanier","2020-06-18","13","547","2","55","7.4","15.2"
"Lanier","2020-06-19","19","566","1","56","6.5","15.6"
"Lanier","2020-06-20","1","567","1","57","20.8","22.7"
"Lanier","2020-06-21","2","569","1","58","28","20.4"
"Lanier","2020-06-22","58","627","5","63","27.3","20.8"
"Lanier","2020-06-23","49","676","5","68","28","21.6"
"Lanier","2020-06-24","13","689","2","70","29.3","20.3"
"Lanier","2020-06-25","34","723","9","79","30.8","19.1"
"Lanier","2020-06-26","41","764","5","84","31.8","19.2"
"Lanier","2020-06-27","1","765","0","84","17.6","19.2"
"Lanier","2020-06-28","1","766","1","85","24.7","26.3"
"Lanier","2020-06-29","74","840","10","95","25.4","26.4"
"Lanier","2020-06-30","91","931","10","105","25.5","26.8"
"Lanier","2020-07-01","13","944","0","105","23.3","26.3"
"Lanier","2020-07-02","21","965","4","109","22.2","26.5"
"Lanier","2020-07-03","4","969","1","110","24.1","28"
"Lanier","2020-07-04","1","970","0","110","24.1","20.8"
"Lanier","2020-07-05","3","973","2","112","19.3","22"
"Lanier","2020-07-06","55","1028","3","115","18.2","21.8"
"Lanier","2020-07-07","45","1073","8","123","19.1","22.3"
"Lanier","2020-07-08","8","1081","0","123","19.1","21.2"
"Lanier","2020-07-09","9","1090","2","125","19.6","20.9"
"Lanier","2020-07-10","3","1093","0","125","16","20"
"Lanier","2020-07-11","0","1093","0","125","16","20"
"Lanier","2020-07-12","3","1096","0","125","6.5","12.9"
"Lanier","2020-07-13","49","1145","5","130","7.2","12.7"
"Lanier","2020-07-14","50","1195","4","134","5.8","12.5"
"Lanier","2020-07-15","14","1209","1","135","6.8","13"
"Lanier","2020-07-16","16","1225","8","143","10.8","15.2"
"Lanier","2020-07-17","29","1254","4","147","12.7","14.4"
"Lanier","2020-07-18","5","1259","0","147","12.7","14.4"
"Lanier","2020-07-19","4","1263","0","147","12.7","9.6"
"Lanier","2020-07-20","79","1342","5","152","12.2","9.7"
"Lanier","2020-07-21","55","1397","6","158","12.6","9.2"
"Lanier","2020-07-22","25","1422","2","160","12.7","9.8"
"Lanier","2020-07-23","14","1436","0","160","5.6","8.2"
"Lanier","2020-07-24","17","1453","8","168","10.3","11.5"
"Lanier","2020-07-25","4","1457","1","169","13.9","13.3"
"Lanier","2020-07-26","0","1457","0","169","13.9","13.3"
"Lanier","2020-07-27","74","1531","8","177","14.5","13.4"
"Lanier","2020-07-28","36","1567","0","177","13","12.8"
"Lanier","2020-07-29","7","1574","2","179","15.9","14.3"
"Lanier","2020-07-30","13","1587","4","183","20.3","12.9"
"Lanier","2020-07-31","23","1610","2","185","14.8","12.6"
"Lanier","2020-08-01","4","1614","0","185","11.3","12.6"
"Lanier","2020-08-02","2","1616","0","185","11.3","12.6"
"Lanier","2020-08-03","58","1674","3","188","10.5","12.5"
"Lanier","2020-08-04","26","1700","5","193","13.2","13.1"
"Lanier","2020-08-05","11","1711","2","195","11.7","13.8"
"Lanier","2020-08-06","6","1717","0","195","7.3","13.8"
"Lanier","2020-08-07","9","1726","1","196","7.7","11.3"
"Lanier","2020-08-08","2","1728","0","196","7.7","9.5"
"Lanier","2020-08-09","5","1733","2","198","13.4","12.3"
"Lanier","2020-08-10","35","1768","7","205","15.5","13"
"Lanier","2020-08-11","38","1806","4","209","14.3","13.7"
"Lanier","2020-08-12","4","1810","1","210","15.2","13.5"
"Lanier","2020-08-13","13","1823","2","212","17.4","12.4"
"Lanier","2020-08-14","13","1836","3","215","19.1","13.4"
"Lanier","2020-08-15","2","1838","0","215","19.1","13.4"
"Lanier","2020-08-16","1","1839","0","215","13.4","13.4"
"Lanier","2020-08-17","28","1867","7","222","14.1","14.8"
"Lanier","2020-08-18","31","1898","2","224","13.6","13.9"
"Lanier","2020-08-19","10","1908","4","228","15.7","15.5"
"Lanier","2020-08-20","17","1925","0","228","13.5","15.5"
"Lanier","2020-08-21","20","1945","2","230","11.6","15.4"
"Lanier","2020-08-22","1","1946","0","230","11.6","15.4"
"Lanier","2020-08-23","2","1948","0","230","11.6","12.5"
"Lanier","2020-08-24","28","1976","0","230","8.1","11.1"
"Lanier","2020-08-25","17","1993","1","231","8","10.8"
"Lanier","2020-08-26","12","2005","0","231","2.3","9"
"Lanier","2020-08-27","12","2017","0","231","2.3","7.9"
"Lanier","2020-08-28","27","2044","16","247","9.3","10.5"
"Lanier","2020-08-29","3","2047","0","247","9.3","10.5"
"Lanier","2020-08-30","8","2055","4","251","16.4","14"
"Lanier","2020-08-31","30","2085","2","253","17.4","12.7"
"Lanier","2020-09-01","25","2110","4","257","18.8","13.4"
"Lanier","2020-09-02","18","2128","1","258","19.6","11"
"Lanier","2020-09-03","6","2134","2","260","24.4","13.3"
"Lanier","2020-09-04","20","2154","0","260","15.9","12.6"
"Lanier","2020-09-05","6","2160","2","262","20.7","15"
"Lanier","2020-09-06","2","2162","0","262","13.6","15"
"Lanier","2020-09-07","3","2165","0","262","12.6","15"
"Lanier","2020-09-08","65","2230","5","267","11.4","15.1"
"Lanier","2020-09-09","27","2257","4","271","12.7","16.2"
"Lanier","2020-09-10","6","2263","4","275","17.5","21"
"Lanier","2020-09-11","6","2269","0","275","17.5","16.7"
"Lanier","2020-09-12","1","2270","0","275","12.7","16.7"
"Lanier","2020-09-13","1","2271","0","275","12.7","13.1"
"Lanier","2020-09-14","35","2306","5","280","14.8","13.7"
"Lanier","2020-09-15","14","2320","0","280","13.7","12.5"
"Lanier","2020-09-16","9","2329","1","281","13.2","12.9"
"Lanier","2020-09-17","14","2343","0","281","3.6","10.6"
"Lanier","2020-09-18","9","2352","0","281","3.6","10.6"
"Lanier","2020-09-19","2","2354","0","281","3.6","8.2"
"Lanier","2020-09-20","4","2358","0","281","3.6","8.2"
"Lanier","2020-09-21","22","2380","1","282","2.2","8.5"
"Lanier","2020-09-22","17","2397","0","282","2.2","8"
"Lanier","2020-09-23","8","2405","3","285","6","9.6"
"Lanier","2020-09-24","4","2409","0","285","6","4.8"
"Lanier","2020-09-25","2","2411","0","285","6","4.8"
"Lanier","2020-09-26","1","2412","0","285","6","4.8"
"Lanier","2020-09-27","2","2414","0","285","6","4.8"
"Lanier","2020-09-28","10","2424","1","286","6.8","4.5"
"Lanier","2020-09-29","7","2431","0","286","6.8","4.5"
"Lanier","2020-09-30","4","2435","0","286","1.4","3.7"
"Lanier","2020-10-01","5","2440","0","286","1.4","3.7"
"Lanier","2020-10-02","11","2451","1","287","2.7","4.4"
"Lanier","2020-10-03","1","2452","0","287","2.7","4.4"
"Lanier","2020-10-04","0","2452","0","287","2.7","4.4"
"Lanier","2020-10-05","19","2471","0","287","1.3","4"
"Lanier","2020-10-06","6","2477","0","287","1.3","4"
"Lanier","2020-10-07","21","2498","0","287","1.3","1.4"
"Lanier","2020-10-08","15","2513","6","293","7","4.2"
"Lanier","2020-10-09","10","2523","2","295","8.6","5.6"
"Lanier","2020-10-10","2","2525","0","295","8.6","5.6"
"Lanier","2020-10-11","0","2525","0","295","8.6","5.6"
"Lanier","2020-10-12","11","2536","0","295","8.6","4.9"
"Lanier","2020-10-13","14","2550","0","295","8.6","4.9"
"Lanier","2020-10-14","9","2559","0","295","8.6","4.9"
"Lanier","2020-10-15","6","2565","0","295","2.9","4.9"
"Lanier","2020-10-16","12","2577","0","295","0","4.3"
"Lanier","2020-10-17","4","2581","0","295","0","4.3"
"Lanier","2020-10-18","2","2583","0","295","0","4.3"
"Lanier","2020-10-19","22","2605","0","295","0","4.3"
"Lanier","2020-10-20","20","2625","2","297","1.4","5"
"Lanier","2020-10-21","6","2631","0","297","1.4","5"
"Lanier","2020-10-22","6","2637","0","297","1.4","2.1"
"Lanier","2020-10-23","5","2642","0","297","1.4","0.7"
"Lanier","2020-10-24","2","2644","1","298","8.6","4.3"
"Lanier","2020-10-25","6","2650","2","300","13.3","6.7"
"Lanier","2020-10-26","18","2668","1","301","14.1","7.1"
"Lanier","2020-10-27","15","2683","0","301","12.7","7.1"
"Lanier","2020-10-28","6","2689","0","301","12.7","7.1"
"Lanier","2020-10-29","7","2696","0","301","12.7","7.1"
"Lanier","2020-10-30","9","2705","0","301","12.7","7.1"
"Lanier","2020-10-31","7","2712","0","301","5.6","7.1"
"Lanier","2020-11-01","2","2714","0","301","0.8","7.1"
"Lanier","2020-11-02","8","2722","1","302","1.8","8"
"Lanier","2020-11-03","16","2738","0","302","1.8","7.2"
"Lanier","2020-11-04","6","2744","0","302","1.8","7.2"
"Lanier","2020-11-05","7","2751","2","304","5.9","9.3"
"Lanier","2020-11-06","11","2762","2","306","8.5","10.6"
"Lanier","2020-11-07","0","2762","0","306","8.5","7"
"Lanier","2020-11-08","1","2763","0","306","8.5","4.6"
"Lanier","2020-11-09","11","2774","2","308","9.3","5.5"
"Lanier","2020-11-10","15","2789","0","308","9.3","5.5"
"Lanier","2020-11-11","11","2800","0","308","9.3","5.5"
"Lanier","2020-11-12","7","2807","0","308","5.2","5.5"
"Lanier","2020-11-13","5","2812","0","308","2.6","5.5"
"Lanier","2020-11-14","3","2815","1","309","7.4","7.9"
"Lanier","2020-11-15","1","2816","1","310","21.6","15.1"
"Lanier","2020-11-16","16","2832","0","310","19","14.2"
"Lanier","2020-11-17","9","2841","0","310","19","14.2"
"Lanier","2020-11-18","9","2850","1","311","20.6","15"
"Lanier","2020-11-19","9","2859","1","312","22.2","13.7"
"Lanier","2020-11-20","3","2862","0","312","22.2","12.4"
"Lanier","2020-11-21","1","2863","0","312","17.5","12.4"
"Lanier","2020-11-22","5","2868","1","313","6","13.8"
"Lanier","2020-11-23","8","2876","2","315","9.6","14.3"
"Lanier","2020-11-24","26","2902","1","316","10.2","14.6"
"Lanier","2020-11-25","11","2913","1","317","9.9","15.2"
"Lanier","2020-11-26","0","2913","0","317","8.3","15.2"
"Lanier","2020-11-27","4","2917","0","317","8.3","15.2"
"Lanier","2020-11-28","2","2919","0","317","8.3","12.9"
"Lanier","2020-11-29","1","2920","0","317","5.4","5.7"
"Lanier","2020-11-30","19","2939","5","322","5.6","7.6"
"Lanier","2020-12-01","10","2949","1","323","6.5","8.3"
"Lanier","2020-12-02","5","2954","0","323","5.2","7.5"
"Lanier","2020-12-03","3","2957","1","324","9.9","9.1"
"Lanier","2020-12-04","8","2965","0","324","9.9","9.1"
"Lanier","2020-12-05","4","2969","0","324","9.9","9.1"
"Lanier","2020-12-06","0","2969","0","324","9.9","7.7"
"Lanier","2020-12-07","34","3003","5","329","8.3","6.9"
"Lanier","2020-12-08","10","3013","2","331","9.7","8.1"
"Lanier","2020-12-09","10","3023","0","331","9.7","7.5"
"Lanier","2020-12-10","8","3031","1","332","6.7","8.3"
"Lanier","2020-12-11","16","3047","4","336","10.3","10.1"
"Lanier","2020-12-12","3","3050","1","337","15.1","12.5"
"Lanier","2020-12-13","4","3054","0","337","15.1","12.5"
"Lanier","2020-12-14","24","3078","3","340","14.8","11.5"
"Lanier","2020-12-15","9","3087","1","341","13.5","11.6"
"Lanier","2020-12-16","14","3101","2","343","15.5","12.6"
"Lanier","2020-12-17","11","3112","1","344","15","10.9"
"Lanier","2020-12-18","8","3120","0","344","11.5","10.9"
"Lanier","2020-12-19","9","3129","2","346","9.9","12.5"
"Lanier","2020-12-20","4","3133","1","347","13.5","14.3"
"Lanier","2020-12-21","39","3172","3","350","12.8","13.8"
"Lanier","2020-12-22","10","3182","2","352","14","13.8"
"Lanier","2020-12-23","11","3193","3","355","15.9","15.7"
"Lanier","2020-12-24","4","3197","0","355","14.6","14.8"
"Lanier","2020-12-25","1","3198","0","355","14.6","13"
"Lanier","2020-12-26","10","3208","4","359","17.1","13.5"
"Lanier","2020-12-27","5","3213","2","361","19.3","16.4"
"Lanier","2020-12-28","34","3247","10","371","22.4","17.6"
"Lanier","2020-12-29","14","3261","3","374","22.6","18.3"
"Lanier","2020-12-30","11","3272","4","378","23.9","19.9"
"Lanier","2020-12-31","4","3276","0","378","23.9","19.2"
"Lanier","2021-01-01","0","3276","0","378","23.9","19.2"
"Lanier","2021-01-02","2","3278","0","378","18.2","17.7"
"Lanier","2021-01-03","3","3281","2","380","22","20.6"
"Lanier","2021-01-04","18","3299","6","386","22.5","22.5"
"Lanier","2021-01-05","9","3308","1","387","21.1","21.8"
"Lanier","2021-01-06","14","3322","3","390","18.9","21.4"
"Lanier","2021-01-07","7","3329","0","390","18.9","21.4"
"Lanier","2021-01-08","12","3341","2","392","21.3","22.6"
"Lanier","2021-01-09","3","3344","2","394","30.8","24.5"
"Lanier","2021-01-10","1","3345","0","394","21.3","21.6"
"Lanier","2021-01-11","27","3372","5","399","19.2","20.9"
"Lanier","2021-01-12","12","3384","1","400","18.8","19.9"
"Lanier","2021-01-13","10","3394","1","401","17.2","18.1"
"Lanier","2021-01-14","11","3405","1","402","18.5","18.7"
"Lanier","2021-01-15","9","3414","1","403","17.7","19.5"
"Lanier","2021-01-16","3","3417","0","403","8.2","19.5"
"Lanier","2021-01-17","3","3420","2","405","17.7","19.5"
"Lanier","2021-01-18","12","3432","4","409","19.8","19.5"
"Lanier","2021-01-19","10","3442","3","412","22.9","20.8"
"Lanier","2021-01-20","13","3455","1","413","22.6","19.9"
"Lanier","2021-01-21","25","3480","3","416","23","20.7"
"Lanier","2021-01-22","11","3491","0","416","21.4","19.5"
"Lanier","2021-01-23","4","3495","1","417","25","16.6"
"Lanier","2021-01-24","4","3499","1","418","19","18.3"
"Lanier","2021-01-25","22","3521","1","419","14.9","17.3"
"Lanier","2021-01-26","6","3527","1","420","13","17.9"
"Lanier","2021-01-27","9","3536","2","422","15.1","18.8"
"Lanier","2021-01-28","6","3542","0","422","13.3","18.2"
"Lanier","2021-01-29","3","3545","0","422","13.3","17.4"
"Lanier","2021-01-30","4","3549","1","423","13.3","19.2"
"Lanier","2021-01-31","1","3550","0","423","9.8","14.4"
"Lanier","2021-02-01","18","3568","2","425","10.7","12.8"
"Lanier","2021-02-02","4","3572","1","426","11.9","12.4"
"Lanier","2021-02-03","6","3578","1","427","11.1","13.1"
"Lanier","2021-02-04","9","3587","1","428","12.7","13"
"Lanier","2021-02-05","4","3591","0","428","12.7","13"
"Lanier","2021-02-06","1","3592","0","428","9.1","11.2"
"Lanier","2021-02-07","2","3594","1","429","16.3","13"
"Lanier","2021-02-08","0","3594","0","429","14.7","12.7"
"Laurens","2020-02-01","0","0","0","0",".","."
"Laurens","2020-02-02","0","0","0","0",".","."
"Laurens","2020-02-03","0","0","0","0",".","."
"Laurens","2020-02-04","0","0","0","0",".","."
"Laurens","2020-02-05","0","0","0","0",".","."
"Laurens","2020-02-06","0","0","0","0",".","."
"Laurens","2020-02-07","0","0","0","0","0","."
"Laurens","2020-02-08","0","0","0","0","0","."
"Laurens","2020-02-09","0","0","0","0","0","."
"Laurens","2020-02-10","0","0","0","0","0","."
"Laurens","2020-02-11","0","0","0","0","0","."
"Laurens","2020-02-12","0","0","0","0","0","."
"Laurens","2020-02-13","0","0","0","0","0","."
"Laurens","2020-02-14","0","0","0","0","0","0"
"Laurens","2020-02-15","0","0","0","0","0","0"
"Laurens","2020-02-16","0","0","0","0","0","0"
"Laurens","2020-02-17","0","0","0","0","0","0"
"Laurens","2020-02-18","0","0","0","0","0","0"
"Laurens","2020-02-19","0","0","0","0","0","0"
"Laurens","2020-02-20","0","0","0","0","0","0"
"Laurens","2020-02-21","0","0","0","0","0","0"
"Laurens","2020-02-22","0","0","0","0","0","0"
"Laurens","2020-02-23","0","0","0","0","0","0"
"Laurens","2020-02-24","0","0","0","0","0","0"
"Laurens","2020-02-25","0","0","0","0","0","0"
"Laurens","2020-02-26","0","0","0","0","0","0"
"Laurens","2020-02-27","0","0","0","0","0","0"
"Laurens","2020-02-28","0","0","0","0","0","0"
"Laurens","2020-02-29","0","0","0","0","0","0"
"Laurens","2020-03-01","0","0","0","0","0","0"
"Laurens","2020-03-02","0","0","0","0","0","0"
"Laurens","2020-03-03","0","0","0","0","0","0"
"Laurens","2020-03-04","0","0","0","0","0","0"
"Laurens","2020-03-05","0","0","0","0","0","0"
"Laurens","2020-03-06","1","1","0","0","0","0"
"Laurens","2020-03-07","0","1","0","0","0","0"
"Laurens","2020-03-08","0","1","0","0","0","0"
"Laurens","2020-03-09","1","2","0","0","0","0"
"Laurens","2020-03-10","0","2","0","0","0","0"
"Laurens","2020-03-11","0","2","0","0","0","0"
"Laurens","2020-03-12","2","4","0","0","0","0"
"Laurens","2020-03-13","1","5","0","0","0","0"
"Laurens","2020-03-14","0","5","0","0","0","0"
"Laurens","2020-03-15","2","7","1","1","7.1","3.6"
"Laurens","2020-03-16","2","9","0","1","7.1","3.6"
"Laurens","2020-03-17","7","16","1","2","9.2","4.6"
"Laurens","2020-03-18","2","18","1","3","16.3","8.2"
"Laurens","2020-03-19","13","31","1","4","17.4","8.7"
"Laurens","2020-03-20","38","69","6","10","19.7","9.8"
"Laurens","2020-03-21","0","69","0","10","19.7","9.8"
"Laurens","2020-03-22","2","71","0","10","12.5","9.8"
"Laurens","2020-03-23","39","110","1","11","12.9","10"
"Laurens","2020-03-24","79","189","6","17","11.9","10.6"
"Laurens","2020-03-25","47","236","3","20","5.7","11"
"Laurens","2020-03-26","24","260","3","23","6.4","11.9"
"Laurens","2020-03-27","18","278","1","24","4.9","12.3"
"Laurens","2020-03-28","13","291","2","26","7.1","13.4"
"Laurens","2020-03-29","0","291","0","26","7.1","9.8"
"Laurens","2020-03-30","43","334","8","34","9.4","11.2"
"Laurens","2020-03-31","24","358","2","36","9.5","10.7"
"Laurens","2020-04-01","24","382","2","38","9.8","7.8"
"Laurens","2020-04-02","22","404","3","41","10","8.2"
"Laurens","2020-04-03","21","425","3","44","11.2","8.1"
"Laurens","2020-04-04","8","433","2","46","12.6","9.9"
"Laurens","2020-04-05","5","438","0","46","12.6","9.9"
"Laurens","2020-04-06","20","458","2","48","11.4","10.4"
"Laurens","2020-04-07","31","489","7","55","13.4","11.5"
"Laurens","2020-04-08","23","512","3","58","14.1","11.9"
"Laurens","2020-04-09","24","536","2","60","13.3","11.6"
"Laurens","2020-04-10","25","561","3","63","13","12.1"
"Laurens","2020-04-11","9","570","2","65","12.6","12.6"
"Laurens","2020-04-12","6","576","1","66","15","13.8"
"Laurens","2020-04-13","38","614","8","74","16.6","14"
"Laurens","2020-04-14","24","638","0","74","13.3","13.4"
"Laurens","2020-04-15","44","682","6","80","13.4","13.7"
"Laurens","2020-04-16","59","741","4","84","13.2","13.3"
"Laurens","2020-04-17","32","773","1","85","11.9","12.5"
"Laurens","2020-04-18","22","795","4","89","11.3","12"
"Laurens","2020-04-19","1","796","0","89","9","12"
"Laurens","2020-04-20","31","827","3","92","7.3","11.9"
"Laurens","2020-04-21","28","855","0","92","7.3","10.3"
"Laurens","2020-04-22","30","885","0","92","5.4","9.4"
"Laurens","2020-04-23","23","908","2","94","5.7","9.4"
"Laurens","2020-04-24","71","979","3","97","5.8","8.9"
"Laurens","2020-04-25","47","1026","2","99","3.8","7.6"
"Laurens","2020-04-26","2","1028","0","99","3.8","6.4"
"Laurens","2020-04-27","31","1059","1","100","2.9","5.1"
"Laurens","2020-04-28","34","1093","1","101","3.3","5.3"
"Laurens","2020-04-29","39","1132","5","106","5.2","5.3"
"Laurens","2020-04-30","40","1172","3","109","5","5.3"
"Laurens","2020-05-01","57","1229","3","112","5.1","5.5"
"Laurens","2020-05-02","28","1257","0","112","4.5","4.2"
"Laurens","2020-05-03","154","1411","4","116","4.9","4.4"
"Laurens","2020-05-04","105","1516","2","118","4.7","3.8"
"Laurens","2020-05-05","60","1576","1","119","4.5","3.9"
"Laurens","2020-05-06","173","1749","3","122","3","4.1"
"Laurens","2020-05-07","52","1801","5","127","3.3","4.1"
"Laurens","2020-05-08","79","1880","12","139","4.7","4.9"
"Laurens","2020-05-09","87","1967","1","140","4.8","4.7"
"Laurens","2020-05-10","1","1968","0","140","4.5","4.7"
"Laurens","2020-05-11","97","2065","7","147","5.2","5"
"Laurens","2020-05-12","46","2111","0","147","5","4.8"
"Laurens","2020-05-13","88","2199","3","150","5.2","4.1"
"Laurens","2020-05-14","83","2282","3","153","4.4","3.8"
"Laurens","2020-05-15","82","2364","0","153","2.2","3.4"
"Laurens","2020-05-16","39","2403","1","154","2.4","3.6"
"Laurens","2020-05-17","24","2427","2","156","3.6","4"
"Laurens","2020-05-18","99","2526","4","160","3.1","4.2"
"Laurens","2020-05-19","86","2612","2","162","3.5","4.2"
"Laurens","2020-05-20","71","2683","1","163","3.2","4.2"
"Laurens","2020-05-21","41","2724","1","164","3","3.7"
"Laurens","2020-05-22","21","2745","0","164","3","2.6"
"Laurens","2020-05-23","13","2758","0","164","2.6","2.5"
"Laurens","2020-05-24","11","2769","0","164","1.5","2.5"
"Laurens","2020-05-25","13","2782","1","165","2","2.6"
"Laurens","2020-05-26","76","2858","0","165","1.6","2.6"
"Laurens","2020-05-27","29","2887","1","166","1.9","2.6"
"Laurens","2020-05-28","37","2924","1","167","2","2.5"
"Laurens","2020-05-29","86","3010","2","169","2.3","2.7"
"Laurens","2020-05-30","16","3026","0","169","2.3","2.5"
"Laurens","2020-05-31","4","3030","0","169","2.3","1.9"
"Laurens","2020-06-01","43","3073","1","170","1.5","1.8"
"Laurens","2020-06-02","50","3123","3","173","2.4","2"
"Laurens","2020-06-03","24","3147","2","175","3.1","2.5"
"Laurens","2020-06-04","36","3183","4","179","4.3","3.1"
"Laurens","2020-06-05","26","3209","2","181","5.1","3.7"
"Laurens","2020-06-06","9","3218","1","182","6.7","4.5"
"Laurens","2020-06-07","3","3221","0","182","6.7","4.5"
"Laurens","2020-06-08","24","3245","2","184","7.5","4.5"
"Laurens","2020-06-09","37","3282","2","186","7.4","4.9"
"Laurens","2020-06-10","16","3298","2","188","8","5.6"
"Laurens","2020-06-11","42","3340","6","194","8.5","6.4"
"Laurens","2020-06-12","29","3369","4","198","9.3","7.2"
"Laurens","2020-06-13","35","3404","2","200","8.6","7.6"
"Laurens","2020-06-14","5","3409","1","201","11.4","9"
"Laurens","2020-06-15","96","3505","8","209","11.4","9.5"
"Laurens","2020-06-16","85","3590","2","211","11","9.2"
"Laurens","2020-06-17","52","3642","4","215","10.3","9.2"
"Laurens","2020-06-18","138","3780","5","220","8.8","8.6"
"Laurens","2020-06-19","47","3827","2","222","7.4","8.4"
"Laurens","2020-06-20","64","3891","3","225","7.3","7.9"
"Laurens","2020-06-21","1","3892","0","225","4.4","7.9"
"Laurens","2020-06-22","110","4002","14","239","5","8.2"
"Laurens","2020-06-23","109","4111","6","245","5.5","8.2"
"Laurens","2020-06-24","254","4365","11","256","5","7.7"
"Laurens","2020-06-25","201","4566","16","272","5.6","7.2"
"Laurens","2020-06-26","188","4754","16","288","6.2","6.8"
"Laurens","2020-06-27","211","4965","18","306","6.8","7"
"Laurens","2020-06-28","15","4980","6","312","12.5","8.5"
"Laurens","2020-06-29","333","5313","20","332","11.5","8.3"
"Laurens","2020-06-30","277","5590","24","356","12","8.7"
"Laurens","2020-07-01","245","5835","25","381","12.8","8.9"
"Laurens","2020-07-02","278","6113","33","414","13.4","9.5"
"Laurens","2020-07-03","226","6339","16","430","13.2","9.7"
"Laurens","2020-07-04","95","6434","12","442","13.8","10.3"
"Laurens","2020-07-05","17","6451","8","450","14.8","13.6"
"Laurens","2020-07-06","295","6746","62","512","16.9","14.2"
"Laurens","2020-07-07","387","7133","24","536","16.6","14.3"
"Laurens","2020-07-08","322","7455","45","581","17.1","15"
"Laurens","2020-07-09","205","7660","28","609","17.4","15.4"
"Laurens","2020-07-10","320","7980","37","646","18","15.6"
"Laurens","2020-07-11","168","8148","16","662","17.6","15.7"
"Laurens","2020-07-12","3","8151","2","664","20.4","17.6"
"Laurens","2020-07-13","277","8428","22","686","18.5","17.7"
"Laurens","2020-07-14","264","8692","34","720","19.5","18"
"Laurens","2020-07-15","286","8978","26","746","18.8","17.9"
"Laurens","2020-07-16","314","9292","21","767","17.8","17.6"
"Laurens","2020-07-17","311","9603","33","800","17.6","17.8"
"Laurens","2020-07-18","105","9708","14","814","18.2","17.9"
"Laurens","2020-07-19","12","9720","1","815","9.8","15.1"
"Laurens","2020-07-20","232","9952","31","846","10.6","14.6"
"Laurens","2020-07-21","227","10179","23","869","10.2","14.8"
"Laurens","2020-07-22","186","10365","23","892","10.7","14.7"
"Laurens","2020-07-23","232","10597","22","914","11.1","14.4"
"Laurens","2020-07-24","201","10798","20","934","11","14.3"
"Laurens","2020-07-25","122","10920","7","941","9.9","14"
"Laurens","2020-07-26","6","10926","1","942","11.1","10.5"
"Laurens","2020-07-27","379","11305","48","990","11","10.8"
"Laurens","2020-07-28","213","11518","43","1033","12.4","11.3"
"Laurens","2020-07-29","218","11736","25","1058","12.3","11.5"
"Laurens","2020-07-30","167","11903","28","1086","13.3","12.2"
"Laurens","2020-07-31","359","12262","49","1135","13.9","12.4"
"Laurens","2020-08-01","22","12284","3","1138","15","12.5"
"Laurens","2020-08-02","11","12295","2","1140","15.2","13.2"
"Laurens","2020-08-03","244","12539","29","1169","15.1","13.1"
"Laurens","2020-08-04","214","12753","57","1226","16","14.2"
"Laurens","2020-08-05","312","13065","54","1280","16.9","14.6"
"Laurens","2020-08-06","205","13270","34","1314","16.8","15.1"
"Laurens","2020-08-07","463","13733","119","1433","18.6","16.2"
"Laurens","2020-08-08","104","13837","14","1447","18.5","16.8"
"Laurens","2020-08-09","4","13841","2","1449","23.1","19.2"
"Laurens","2020-08-10","256","14097","33","1482","23.2","19.2"
"Laurens","2020-08-11","213","14310","17","1499","20.6","18.3"
"Laurens","2020-08-12","285","14595","26","1525","19.4","18.1"
"Laurens","2020-08-13","161","14756","21","1546","18.9","17.9"
"Laurens","2020-08-14","273","15029","27","1573","16.6","17.6"
"Laurens","2020-08-15","100","15129","11","1584","16.3","17.4"
"Laurens","2020-08-16","10","15139","2","1586","12","17.5"
"Laurens","2020-08-17","27","15166","6","1592","13.3","18.3"
"Laurens","2020-08-18","175","15341","20","1612","13.8","17.2"
"Laurens","2020-08-19","169","15510","20","1632","14.2","16.8"
"Laurens","2020-08-20","141","15651","29","1661","15.3","17.1"
"Laurens","2020-08-21","229","15880","13","1674","14.7","15.7"
"Laurens","2020-08-22","111","15991","18","1692","15.4","15.8"
"Laurens","2020-08-23","20","16011","7","1699","17.6","14.8"
"Laurens","2020-08-24","241","16252","33","1732","16.3","14.8"
"Laurens","2020-08-25","172","16424","25","1757","16.8","15.3"
"Laurens","2020-08-26","183","16607","25","1782","17","15.6"
"Laurens","2020-08-27","176","16783","22","1804","15.9","15.6"
"Laurens","2020-08-28","297","17080","25","1829","16.3","15.5"
"Laurens","2020-08-29","129","17209","18","1847","16","15.7"
"Laurens","2020-08-30","29","17238","2","1849","12","14.8"
"Laurens","2020-08-31","189","17427","21","1870","11.6","14"
"Laurens","2020-09-01","185","17612","18","1888","10.9","13.8"
"Laurens","2020-09-02","156","17768","21","1909","10.9","14"
"Laurens","2020-09-03","221","17989","27","1936","10.8","13.4"
"Laurens","2020-09-04","268","18257","85","2021","14.2","15.2"
"Laurens","2020-09-05","79","18336","16","2037","15.1","15.5"
"Laurens","2020-09-06","13","18349","3","2040","17.4","14.7"
"Laurens","2020-09-07","65","18414","18","2058","19.7","15.7"
"Laurens","2020-09-08","340","18754","17","2075","19.1","15"
"Laurens","2020-09-09","150","18904","10","2085","18.1","14.5"
"Laurens","2020-09-10","371","19275","21","2106","17.2","14"
"Laurens","2020-09-11","246","19521","33","2139","14.5","14.3"
"Laurens","2020-09-12","74","19595","4","2143","12.4","13.7"
"Laurens","2020-09-13","8","19603","1","2144","10.9","14.1"
"Laurens","2020-09-14","283","19886","20","2164","8","13.8"
"Laurens","2020-09-15","245","20131","14","2178","8.1","13.6"
"Laurens","2020-09-16","282","20413","22","2200","8.2","13.2"
"Laurens","2020-09-17","292","20705","17","2217","8.2","12.7"
"Laurens","2020-09-18","248","20953","16","2233","7.3","10.9"
"Laurens","2020-09-19","98","21051","7","2240","7.5","10"
"Laurens","2020-09-20","16","21067","3","2243","8.4","9.6"
"Laurens","2020-09-21","275","21342","20","2263","8.4","8.2"
"Laurens","2020-09-22","352","21694","14","2277","8.2","8.1"
"Laurens","2020-09-23","215","21909","20","2297","8.4","8.3"
"Laurens","2020-09-24","485","22394","15","2312","8","8.1"
"Laurens","2020-09-25","112","22506","7","2319","8","7.6"
"Laurens","2020-09-26","99","22605","3","2322","7.4","7.4"
"Laurens","2020-09-27","10","22615","1","2323","6.1","7.3"
"Laurens","2020-09-28","183","22798","18","2341","6.5","7.5"
"Laurens","2020-09-29","426","23224","20","2361","6.6","7.4"
"Laurens","2020-09-30","187","23411","22","2383","7","7.7"
"Laurens","2020-10-01","436","23847","31","2414","7.5","7.8"
"Laurens","2020-10-02","183","24030","22","2436","8.4","8.2"
"Laurens","2020-10-03","102","24132","11","2447","9.5","8.4"
"Laurens","2020-10-04","22","24154","4","2451","10.6","8.4"
"Laurens","2020-10-05","278","24432","28","2479","10.7","8.6"
"Laurens","2020-10-06","321","24753","32","2511","11.4","9"
"Laurens","2020-10-07","398","25151","30","2541","10.8","8.9"
"Laurens","2020-10-08","197","25348","18","2559","11.1","9.3"
"Laurens","2020-10-09","248","25596","27","2586","10.9","9.6"
"Laurens","2020-10-10","101","25697","13","2599","11.2","10.3"
"Laurens","2020-10-11","16","25713","4","2603","12.2","11.4"
"Laurens","2020-10-12","168","25881","24","2627","12.8","11.7"
"Laurens","2020-10-13","335","26216","22","2649","12.3","11.9"
"Laurens","2020-10-14","265","26481","19","2668","12.3","11.5"
"Laurens","2020-10-15","224","26705","12","2680","11.7","11.4"
"Laurens","2020-10-16","171","26876","17","2697","11.6","11.3"
"Laurens","2020-10-17","66","26942","9","2706","11.7","11.5"
"Laurens","2020-10-18","10","26952","3","2709","12.4","12.3"
"Laurens","2020-10-19","291","27243","35","2744","12.1","12.5"
"Laurens","2020-10-20","261","27504","16","2760","12","12.2"
"Laurens","2020-10-21","284","27788","18","2778","11.9","12.1"
"Laurens","2020-10-22","110","27898","11","2789","12.6","12.2"
"Laurens","2020-10-23","152","28050","20","2809","13","12.3"
"Laurens","2020-10-24","73","28123","11","2820","13.2","12.5"
"Laurens","2020-10-25","15","28138","3","2823","11.8","12.1"
"Laurens","2020-10-26","221","28359","28","2851","11.9","12"
"Laurens","2020-10-27","201","28560","10","2861","11.7","11.9"
"Laurens","2020-10-28","223","28783","21","2882","12.2","12.1"
"Laurens","2020-10-29","282","29065","32","2914","12.4","12.5"
"Laurens","2020-10-30","124","29189","11","2925","11.8","12.4"
"Laurens","2020-10-31","73","29262","12","2937","12","12.6"
"Laurens","2020-11-01","15","29277","5","2942","13.9","12.8"
"Laurens","2020-11-02","192","29469","26","2968","14","12.9"
"Laurens","2020-11-03","342","29811","23","2991","14.2","13"
"Laurens","2020-11-04","131","29942","6","2997","13.5","12.9"
"Laurens","2020-11-05","235","30177","19","3016","13.1","12.7"
"Laurens","2020-11-06","85","30262","0","3016","11.8","11.8"
"Laurens","2020-11-07","57","30319","8","3024","11.5","11.7"
"Laurens","2020-11-08","10","30329","2","3026","9.6","11.7"
"Laurens","2020-11-09","200","30529","8","3034","8.2","11.1"
"Laurens","2020-11-10","343","30872","21","3055","8.1","11.2"
"Laurens","2020-11-11","114","30986","7","3062","8.3","10.9"
"Laurens","2020-11-12","286","31272","19","3081","8.1","10.6"
"Laurens","2020-11-13","110","31382","6","3087","8.9","10.4"
"Laurens","2020-11-14","40","31422","3","3090","8","9.7"
"Laurens","2020-11-15","15","31437","2","3092","7","8.3"
"Laurens","2020-11-16","205","31642","9","3101","7.1","7.6"
"Laurens","2020-11-17","221","31863","3","3104","6.4","7.3"
"Laurens","2020-11-18","159","32022","17","3121","7.1","7.7"
"Laurens","2020-11-19","101","32123","6","3127","7","7.5"
"Laurens","2020-11-20","141","32264","10","3137","7.2","8.1"
"Laurens","2020-11-21","21","32285","4","3141","8.8","8.4"
"Laurens","2020-11-22","16","32301","6","3147","12.3","9.7"
"Laurens","2020-11-23","469","32770","16","3163","12.1","9.6"
"Laurens","2020-11-24","42","32812","3","3166","13","9.7"
"Laurens","2020-11-25","92","32904","8","3174","12.7","9.9"
"Laurens","2020-11-26","7","32911","3","3177","18","12.5"
"Laurens","2020-11-27","76","32987","12","3189","19.2","13.2"
"Laurens","2020-11-28","22","33009","6","3195","20.4","14.6"
"Laurens","2020-11-29","14","33023","2","3197","17.1","14.7"
"Laurens","2020-11-30","198","33221","18","3215","17.9","15"
"Laurens","2020-12-01","244","33465","11","3226","17.5","15.2"
"Laurens","2020-12-02","307","33772","47","3273","18.4","15.6"
"Laurens","2020-12-03","192","33964","7","3280","12.8","15.4"
"Laurens","2020-12-04","163","34127","17","3297","12.1","15.6"
"Laurens","2020-12-05","29","34156","10","3307","13.1","16.7"
"Laurens","2020-12-06","19","34175","2","3309","12.6","14.8"
"Laurens","2020-12-07","325","34500","13","3322","11.8","14.9"
"Laurens","2020-12-08","262","34762","16","3338","12.1","14.8"
"Laurens","2020-12-09","164","34926","12","3350","10.9","14.7"
"Laurens","2020-12-10","326","35252","28","3378","11.6","12.2"
"Laurens","2020-12-11","235","35487","32","3410","12.1","12.1"
"Laurens","2020-12-12","27","35514","4","3414","9.3","11.2"
"Laurens","2020-12-13","34","35548","10","3424","12","12.3"
"Laurens","2020-12-14","474","36022","54","3478","13","12.4"
"Laurens","2020-12-15","461","36483","45","3523","13.6","12.8"
"Laurens","2020-12-16","293","36776","39","3562","14.4","12.7"
"Laurens","2020-12-17","334","37110","31","3593","14.5","13.1"
"Laurens","2020-12-18","316","37426","43","3636","14.5","13.3"
"Laurens","2020-12-19","34","37460","8","3644","15.8","12.5"
"Laurens","2020-12-20","115","37575","8","3652","12.5","12.3"
"Laurens","2020-12-21","683","38258","51","3703","12","12.5"
"Laurens","2020-12-22","350","38608","42","3745","12.3","12.9"
"Laurens","2020-12-23","251","38859","27","3772","11.9","13.2"
"Laurens","2020-12-24","31","38890","7","3779","13.8","14.2"
"Laurens","2020-12-25","10","38900","4","3783","17.6","16.1"
"Laurens","2020-12-26","38","38938","10","3793","18","16.9"
"Laurens","2020-12-27","23","38961","11","3804","23.8","18.2"
"Laurens","2020-12-28","625","39586","73","3877","24.5","18.2"
"Laurens","2020-12-29","536","40122","52","3929","24.1","18.2"
"Laurens","2020-12-30","394","40516","62","3991","24.8","18.4"
"Laurens","2020-12-31","281","40797","67","4058","25","19.4"
"Laurens","2021-01-01","7","40804","1","4059","21.3","19.5"
"Laurens","2021-01-02","45","40849","10","4069","20.8","19.4"
"Laurens","2021-01-03","19","40868","10","4079","21.4","22.6"
"Laurens","2021-01-04","168","41036","18","4097","21.3","22.9"
"Laurens","2021-01-05","693","41729","117","4214","22.3","23.2"
"Laurens","2021-01-06","253","41982","19","4233","21.2","23"
"Laurens","2021-01-07","383","42365","59","4292","20","22.5"
"Laurens","2021-01-08","70","42435","15","4307","21","21.2"
"Laurens","2021-01-09","54","42489","12","4319","21","20.9"
"Laurens","2021-01-10","26","42515","9","4328","18.4","19.9"
"Laurens","2021-01-11","167","42682","38","4366","20.1","20.7"
"Laurens","2021-01-12","440","43122","57","4423","19.6","20.9"
"Laurens","2021-01-13","67","43189","14","4437","21.5","21.3"
"Laurens","2021-01-14","111","43300","16","4453","21.3","20.6"
"Laurens","2021-01-15","68","43368","9","4462","20.2","20.6"
"Laurens","2021-01-16","45","43413","12","4474","20.8","20.9"
"Laurens","2021-01-17","27","43440","5","4479","18.5","18.4"
"Laurens","2021-01-18","143","43583","26","4505","17.8","19"
"Laurens","2021-01-19","366","43949","51","4556","18","18.8"
"Laurens","2021-01-20","47","43996","11","4567","18.3","19.9"
"Laurens","2021-01-21","103","44099","11","4578","17.8","19.6"
"Laurens","2021-01-22","53","44152","10","4588","18.6","19.4"
"Laurens","2021-01-23","34","44186","8","4596","18.2","19.5"
"Laurens","2021-01-24","38","44224","10","4606","19.3","18.9"
"Laurens","2021-01-25","178","44402","29","4635","19","18.4"
"Laurens","2021-01-26","348","44750","39","4674","18.6","18.3"
"Laurens","2021-01-27","68","44818","11","4685","17.6","18"
"Laurens","2021-01-28","97","44915","16","4701","18.4","18.1"
"Laurens","2021-01-29","45","44960","7","4708","17.9","18.3"
"Laurens","2021-01-30","51","45011","13","4721","18.2","18.2"
"Laurens","2021-01-31","36","45047","10","4731","18.4","18.9"
"Laurens","2021-02-01","176","45223","15","4746","17.3","18.2"
"Laurens","2021-02-02","106","45329","9","4755","16.9","17.8"
"Laurens","2021-02-03","191","45520","24","4779","16.4","17"
"Laurens","2021-02-04","84","45604","6","4785","15.1","16.7"
"Laurens","2021-02-05","49","45653","10","4795","15.8","16.9"
"Laurens","2021-02-06","21","45674","1","4796","12.8","15.5"
"Laurens","2021-02-07","3","45677","0","4796","8.8","13.6"
"Laurens","2021-02-08","0","45677","0","4796","7.6","12.5"
"Lee","2020-02-01","0","0","0","0",".","."
"Lee","2020-02-02","0","0","0","0",".","."
"Lee","2020-02-03","0","0","0","0",".","."
"Lee","2020-02-04","0","0","0","0",".","."
"Lee","2020-02-05","0","0","0","0",".","."
"Lee","2020-02-06","0","0","0","0",".","."
"Lee","2020-02-07","0","0","0","0","0","."
"Lee","2020-02-08","0","0","0","0","0","."
"Lee","2020-02-09","0","0","0","0","0","."
"Lee","2020-02-10","0","0","0","0","0","."
"Lee","2020-02-11","0","0","0","0","0","."
"Lee","2020-02-12","0","0","0","0","0","."
"Lee","2020-02-13","0","0","0","0","0","."
"Lee","2020-02-14","0","0","0","0","0","0"
"Lee","2020-02-15","0","0","0","0","0","0"
"Lee","2020-02-16","0","0","0","0","0","0"
"Lee","2020-02-17","0","0","0","0","0","0"
"Lee","2020-02-18","0","0","0","0","0","0"
"Lee","2020-02-19","0","0","0","0","0","0"
"Lee","2020-02-20","0","0","0","0","0","0"
"Lee","2020-02-21","0","0","0","0","0","0"
"Lee","2020-02-22","0","0","0","0","0","0"
"Lee","2020-02-23","0","0","0","0","0","0"
"Lee","2020-02-24","0","0","0","0","0","0"
"Lee","2020-02-25","0","0","0","0","0","0"
"Lee","2020-02-26","0","0","0","0","0","0"
"Lee","2020-02-27","0","0","0","0","0","0"
"Lee","2020-02-28","0","0","0","0","0","0"
"Lee","2020-02-29","0","0","0","0","0","0"
"Lee","2020-03-01","0","0","0","0","0","0"
"Lee","2020-03-02","0","0","0","0","0","0"
"Lee","2020-03-03","0","0","0","0","0","0"
"Lee","2020-03-04","0","0","0","0","0","0"
"Lee","2020-03-05","0","0","0","0","0","0"
"Lee","2020-03-06","0","0","0","0","0","0"
"Lee","2020-03-07","0","0","0","0","0","0"
"Lee","2020-03-08","1","1","1","1","14.3","7.1"
"Lee","2020-03-09","0","1","0","1","14.3","7.1"
"Lee","2020-03-10","0","1","0","1","14.3","7.1"
"Lee","2020-03-11","7","8","2","3","18.4","9.2"
"Lee","2020-03-12","4","12","1","4","21.9","11"
"Lee","2020-03-13","3","15","2","6","31.5","15.7"
"Lee","2020-03-14","2","17","1","7","38.6","19.3"
"Lee","2020-03-15","12","29","6","13","31.5","22.9"
"Lee","2020-03-16","21","50","9","22","37.6","25.9"
"Lee","2020-03-17","40","90","15","37","42.9","28.6"
"Lee","2020-03-18","18","108","3","40","41.2","29.8"
"Lee","2020-03-19","24","132","4","44","40.1","31"
"Lee","2020-03-20","42","174","12","56","34.6","33"
"Lee","2020-03-21","24","198","8","64","32.2","35.4"
"Lee","2020-03-22","17","215","7","71","31","31.2"
"Lee","2020-03-23","98","313","16","87","27.2","32.4"
"Lee","2020-03-24","103","416","25","112","25.3","34.1"
"Lee","2020-03-25","52","468","15","127","27","34.1"
"Lee","2020-03-26","59","527","15","142","28.3","34.2"
"Lee","2020-03-27","71","598","14","156","27","30.8"
"Lee","2020-03-28","37","635","11","167","26.5","29.4"
"Lee","2020-03-29","22","657","8","175","25.8","28.4"
"Lee","2020-03-30","62","719","16","191","27.2","27.2"
"Lee","2020-03-31","28","747","8","199","27.8","26.5"
"Lee","2020-04-01","65","812","24","223","28.9","28"
"Lee","2020-04-02","52","864","13","236","28.9","28.6"
"Lee","2020-04-03","33","897","10","246","30.4","28.7"
"Lee","2020-04-04","13","910","5","251","31.6","29.1"
"Lee","2020-04-05","18","928","8","259","32.8","29.3"
"Lee","2020-04-06","43","971","5","264","30.8","29"
"Lee","2020-04-07","32","1003","4","268","28.5","28.1"
"Lee","2020-04-08","27","1030","5","273","25.8","27.4"
"Lee","2020-04-09","21","1051","3","276","24.3","26.6"
"Lee","2020-04-10","31","1082","7","283","23.2","26.8"
"Lee","2020-04-11","10","1092","3","286","22","26.8"
"Lee","2020-04-12","2","1094","0","286","15.6","24.2"
"Lee","2020-04-13","37","1131","5","291","15.9","23.3"
"Lee","2020-04-14","41","1172","5","296","15.9","22.2"
"Lee","2020-04-15","40","1212","4","300","14.7","20.2"
"Lee","2020-04-16","42","1254","9","309","15.7","20"
"Lee","2020-04-17","36","1290","4","313","14","18.6"
"Lee","2020-04-18","12","1302","1","314","10.9","16.5"
"Lee","2020-04-19","11","1313","1","315","12.2","13.9"
"Lee","2020-04-20","22","1335","4","319","12.9","14.4"
"Lee","2020-04-21","25","1360","3","322","12.9","14.4"
"Lee","2020-04-22","26","1386","1","323","12","13.3"
"Lee","2020-04-23","42","1428","12","335","13","14.3"
"Lee","2020-04-24","66","1494","7","342","12.9","13.5"
"Lee","2020-04-25","17","1511","2","344","13.4","12.2"
"Lee","2020-04-26","12","1523","1","345","13.3","12.8"
"Lee","2020-04-27","27","1550","5","350","13.4","13.1"
"Lee","2020-04-28","36","1586","1","351","12.1","12.5"
"Lee","2020-04-29","46","1632","1","352","11.8","11.9"
"Lee","2020-04-30","63","1695","6","358","9.1","11.1"
"Lee","2020-05-01","60","1755","4","362","8.5","10.7"
"Lee","2020-05-02","39","1794","0","362","6.9","10.1"
"Lee","2020-05-03","26","1820","1","363","6.2","9.8"
"Lee","2020-05-04","62","1882","5","368","4.7","9"
"Lee","2020-05-05","56","1938","2","370","4.8","8.4"
"Lee","2020-05-06","63","2001","1","371","4.8","8.3"
"Lee","2020-05-07","47","2048","4","375","4.6","6.9"
"Lee","2020-05-08","36","2084","4","379","5.2","6.9"
"Lee","2020-05-09","14","2098","0","379","5.2","6"
"Lee","2020-05-10","5","2103","3","382","13.3","9.7"
"Lee","2020-05-11","32","2135","1","383","12.6","8.6"
"Lee","2020-05-12","32","2167","1","384","12.5","8.7"
"Lee","2020-05-13","40","2207","1","385","12.6","8.7"
"Lee","2020-05-14","56","2263","0","385","11.4","8"
"Lee","2020-05-15","46","2309","1","386","10.1","7.7"
"Lee","2020-05-16","8","2317","2","388","13.7","9.5"
"Lee","2020-05-17","16","2333","0","388","5.1","9.2"
"Lee","2020-05-18","79","2412","6","394","5.8","9.2"
"Lee","2020-05-19","69","2481","4","398","6.2","9.3"
"Lee","2020-05-20","49","2530","2","400","6.4","9.5"
"Lee","2020-05-21","101","2631","4","404","6.9","9.2"
"Lee","2020-05-22","61","2692","0","404","6.6","8.4"
"Lee","2020-05-23","21","2713","1","405","3.7","8.7"
"Lee","2020-05-24","12","2725","0","405","3.7","4.4"
"Lee","2020-05-25","49","2774","3","408","3.5","4.7"
"Lee","2020-05-26","70","2844","1","409","2.9","4.5"
"Lee","2020-05-27","48","2892","0","409","2.3","4.4"
"Lee","2020-05-28","75","2967","0","409","1.8","4.4"
"Lee","2020-05-29","44","3011","2","411","2.4","4.5"
"Lee","2020-05-30","16","3027","2","413","3.5","3.6"
"Lee","2020-05-31","17","3044","1","414","4.4","4"
"Lee","2020-06-01","38","3082","0","414","3.5","3.5"
"Lee","2020-06-02","44","3126","1","415","3.6","3.3"
"Lee","2020-06-03","86","3212","3","418","4.1","3.2"
"Lee","2020-06-04","53","3265","0","418","4.1","2.9"
"Lee","2020-06-05","55","3320","3","421","4.2","3.3"
"Lee","2020-06-06","11","3331","1","422","3.7","3.6"
"Lee","2020-06-07","15","3346","1","423","3.9","4.1"
"Lee","2020-06-08","41","3387","2","425","4.6","4"
"Lee","2020-06-09","32","3419","1","426","4.7","4.1"
"Lee","2020-06-10","64","3483","1","427","4.4","4.2"
"Lee","2020-06-11","30","3513","1","428","4.9","4.5"
"Lee","2020-06-12","37","3550","2","430","4.9","4.5"
"Lee","2020-06-13","9","3559","1","431","5.2","4.4"
"Lee","2020-06-14","6","3565","0","431","4.2","4"
"Lee","2020-06-15","42","3607","2","433","4.2","4.4"
"Lee","2020-06-16","42","3649","4","437","5.1","4.9"
"Lee","2020-06-17","58","3707","0","437","4.9","4.6"
"Lee","2020-06-18","28","3735","1","438","4.9","4.9"
"Lee","2020-06-19","22","3757","0","438","4.1","4.5"
"Lee","2020-06-20","7","3764","2","440","6.6","5.9"
"Lee","2020-06-21","9","3773","0","440","6.6","5.4"
"Lee","2020-06-22","54","3827","3","443","6.7","5.5"
"Lee","2020-06-23","53","3880","1","444","5.7","5.4"
"Lee","2020-06-24","38","3918","1","445","6","5.5"
"Lee","2020-06-25","29","3947","0","445","5.5","5.2"
"Lee","2020-06-26","58","4005","2","447","6","5.1"
"Lee","2020-06-27","13","4018","0","447","1.9","4.3"
"Lee","2020-06-28","11","4029","1","448","3.2","4.9"
"Lee","2020-06-29","44","4073","4","452","3.7","5.2"
"Lee","2020-06-30","39","4112","0","452","3.5","4.6"
"Lee","2020-07-01","124","4236","10","462","4.2","5.1"
"Lee","2020-07-02","51","4287","7","469","6.2","5.9"
"Lee","2020-07-03","23","4310","0","469","5.7","5.9"
"Lee","2020-07-04","15","4325","0","469","5.7","3.8"
"Lee","2020-07-05","19","4344","1","470","5.2","4.2"
"Lee","2020-07-06","58","4402","2","472","4.4","4"
"Lee","2020-07-07","45","4447","5","477","5.9","4.7"
"Lee","2020-07-08","125","4572","8","485","5.7","5"
"Lee","2020-07-09","49","4621","1","486","4","5.1"
"Lee","2020-07-10","60","4681","3","489","4.8","5.2"
"Lee","2020-07-11","14","4695","2","491","6.8","6.3"
"Lee","2020-07-12","12","4707","1","492","7.2","6.2"
"Lee","2020-07-13","54","4761","3","495","7.5","5.9"
"Lee","2020-07-14","48","4809","2","497","6.5","6.2"
"Lee","2020-07-15","188","4997","5","502","6","5.9"
"Lee","2020-07-16","35","5032","4","506","7.3","5.7"
"Lee","2020-07-17","52","5084","7","513","8.6","6.7"
"Lee","2020-07-18","17","5101","3","516","9","7.9"
"Lee","2020-07-19","17","5118","4","520","11.2","9.2"
"Lee","2020-07-20","53","5171","6","526","12","9.8"
"Lee","2020-07-21","49","5220","6","532","13.2","9.9"
"Lee","2020-07-22","67","5287","5","537","13.9","9.9"
"Lee","2020-07-23","71","5358","5","542","13.2","10.3"
"Lee","2020-07-24","40","5398","5","547","13.1","10.8"
"Lee","2020-07-25","12","5410","1","548","11.8","10.4"
"Lee","2020-07-26","9","5419","1","549","10","10.6"
"Lee","2020-07-27","77","5496","6","555","9.5","10.8"
"Lee","2020-07-28","54","5550","6","561","9.3","11.3"
"Lee","2020-07-29","169","5719","6","567","8.8","11.3"
"Lee","2020-07-30","45","5764","4","571","9","11.1"
"Lee","2020-07-31","47","5811","3","574","8.2","10.6"
"Lee","2020-08-01","13","5824","0","574","7","9.4"
"Lee","2020-08-02","56","5880","5","579","6.7","8.3"
"Lee","2020-08-03","66","5946","6","585","6.9","8.2"
"Lee","2020-08-04","51","5997","4","589","6.4","7.9"
"Lee","2020-08-05","113","6110","8","597","6.9","7.8"
"Lee","2020-08-06","57","6167","2","599","6.1","7.6"
"Lee","2020-08-07","57","6224","7","606","7","7.6"
"Lee","2020-08-08","25","6249","2","608","8.1","7.5"
"Lee","2020-08-09","17","6266","0","608","6.8","6.7"
"Lee","2020-08-10","68","6334","5","613","6.6","6.7"
"Lee","2020-08-11","54","6388","5","618","6.8","6.6"
"Lee","2020-08-12","82","6470","5","623","6.6","6.8"
"Lee","2020-08-13","39","6509","5","628","8","7"
"Lee","2020-08-14","38","6547","2","630","7","7"
"Lee","2020-08-15","40","6587","6","636","8","8"
"Lee","2020-08-16","17","6604","4","640","11.3","9.1"
"Lee","2020-08-17","47","6651","2","642","10.9","8.7"
"Lee","2020-08-18","52","6703","3","645","10.4","8.6"
"Lee","2020-08-19","87","6790","4","649","10.2","8.4"
"Lee","2020-08-20","34","6824","5","654","10.4","9.2"
"Lee","2020-08-21","45","6869","3","657","10.6","8.8"
"Lee","2020-08-22","13","6882","2","659","10.7","9.3"
"Lee","2020-08-23","48","6930","3","662","8.2","9.8"
"Lee","2020-08-24","59","6989","4","666","8.6","9.7"
"Lee","2020-08-25","60","7049","1","667","8","9.2"
"Lee","2020-08-26","80","7129","6","673","8.4","9.3"
"Lee","2020-08-27","53","7182","3","676","7.1","8.8"
"Lee","2020-08-28","31","7213","1","677","6.6","8.6"
"Lee","2020-08-29","68","7281","6","683","5.7","8.2"
"Lee","2020-08-30","20","7301","2","685","6.2","7.2"
"Lee","2020-08-31","50","7351","2","687","5.8","7.2"
"Lee","2020-09-01","121","7472","10","697","6.8","7.4"
"Lee","2020-09-02","59","7531","2","699","6.2","7.3"
"Lee","2020-09-03","46","7577","3","702","6.3","6.7"
"Lee","2020-09-04","46","7623","2","704","6.5","6.6"
"Lee","2020-09-05","12","7635","1","705","6.4","6.1"
"Lee","2020-09-06","8","7643","0","705","5","5.6"
"Lee","2020-09-07","8","7651","1","706","6.2","6"
"Lee","2020-09-08","90","7741","6","712","6","6.4"
"Lee","2020-09-09","96","7837","10","722","7","6.6"
"Lee","2020-09-10","70","7907","5","727","7.1","6.7"
"Lee","2020-09-11","54","7961","3","730","7.2","6.9"
"Lee","2020-09-12","16","7977","3","733","8.7","7.6"
"Lee","2020-09-13","9","7986","0","733","8.7","6.8"
"Lee","2020-09-14","54","8040","2","735","7.5","6.8"
"Lee","2020-09-15","59","8099","3","738","7.2","6.6"
"Lee","2020-09-16","86","8185","4","742","6.4","6.7"
"Lee","2020-09-17","46","8231","4","746","6.6","6.8"
"Lee","2020-09-18","50","8281","2","748","6.4","6.8"
"Lee","2020-09-19","10","8291","1","749","5.2","6.9"
"Lee","2020-09-20","18","8309","2","751","6.7","7.7"
"Lee","2020-09-21","60","8369","5","756","7.4","7.4"
"Lee","2020-09-22","85","8454","3","759","7.2","7.2"
"Lee","2020-09-23","51","8505","3","762","7.4","6.9"
"Lee","2020-09-24","46","8551","0","762","6.1","6.4"
"Lee","2020-09-25","53","8604","1","763","5.8","6.1"
"Lee","2020-09-26","29","8633","0","763","4.4","4.8"
"Lee","2020-09-27","16","8649","0","763","2.8","4.8"
"Lee","2020-09-28","60","8709","5","768","2.8","5.1"
"Lee","2020-09-29","60","8769","1","769","2.5","4.9"
"Lee","2020-09-30","39","8808","2","771","2.4","4.9"
"Lee","2020-10-01","44","8852","3","774","3.4","4.8"
"Lee","2020-10-02","49","8901","1","775","3.4","4.6"
"Lee","2020-10-03","7","8908","1","776","5.5","4.9"
"Lee","2020-10-04","10","8918","1","777","6.9","4.9"
"Lee","2020-10-05","69","8987","5","782","6.7","4.8"
"Lee","2020-10-06","69","9056","4","786","7.3","4.9"
"Lee","2020-10-07","70","9126","2","788","7","4.7"
"Lee","2020-10-08","48","9174","1","789","6.3","4.9"
"Lee","2020-10-09","41","9215","1","790","6.4","4.9"
"Lee","2020-10-10","11","9226","2","792","6.9","6.2"
"Lee","2020-10-11","13","9239","2","794","7.7","7.3"
"Lee","2020-10-12","60","9299","0","794","6.7","6.7"
"Lee","2020-10-13","44","9343","4","798","7.1","7.2"
"Lee","2020-10-14","53","9396","0","798","6.7","6.9"
"Lee","2020-10-15","39","9435","1","799","6.8","6.6"
"Lee","2020-10-16","31","9466","2","801","7.4","6.9"
"Lee","2020-10-17","7","9473","0","801","4.8","5.9"
"Lee","2020-10-18","13","9486","3","804","5.9","6.8"
"Lee","2020-10-19","49","9535","0","804","5.9","6.3"
"Lee","2020-10-20","56","9591","1","805","4.8","6"
"Lee","2020-10-21","47","9638","0","805","4.8","5.8"
"Lee","2020-10-22","53","9691","3","808","5.3","6"
"Lee","2020-10-23","36","9727","1","809","4.8","6.1"
"Lee","2020-10-24","12","9739","0","809","4.8","4.8"
"Lee","2020-10-25","9","9748","1","810","3","4.5"
"Lee","2020-10-26","58","9806","2","812","3.5","4.7"
"Lee","2020-10-27","42","9848","2","814","4","4.4"
"Lee","2020-10-28","37","9885","1","815","4.4","4.6"
"Lee","2020-10-29","46","9931","2","817","4.2","4.7"
"Lee","2020-10-30","40","9971","1","818","4.1","4.4"
"Lee","2020-10-31","20","9991","0","818","4.1","4.4"
"Lee","2020-11-01","8","9999","1","819","4.3","3.7"
"Lee","2020-11-02","34","10033","1","820","4.3","3.9"
"Lee","2020-11-03","68","10101","1","821","3.8","3.9"
"Lee","2020-11-04","45","10146","2","823","4","4.2"
"Lee","2020-11-05","41","10187","2","825","4.1","4.1"
"Lee","2020-11-06","42","10229","0","825","3.7","3.9"
"Lee","2020-11-07","9","10238","0","825","3.7","3.9"
"Lee","2020-11-08","12","10250","1","826","3.2","3.7"
"Lee","2020-11-09","52","10302","2","828","3.3","3.8"
"Lee","2020-11-10","53","10355","0","828","3.1","3.4"
"Lee","2020-11-11","62","10417","2","830","2.9","3.5"
"Lee","2020-11-12","42","10459","2","832","2.9","3.5"
"Lee","2020-11-13","46","10505","2","834","3.5","3.6"
"Lee","2020-11-14","21","10526","2","836","4.9","4.3"
"Lee","2020-11-15","17","10543","2","838","5.4","4.3"
"Lee","2020-11-16","65","10608","6","844","6.1","4.7"
"Lee","2020-11-17","47","10655","5","849","7.6","5.4"
"Lee","2020-11-18","69","10724","4","853","8","5.5"
"Lee","2020-11-19","43","10767","4","857","8.7","5.8"
"Lee","2020-11-20","74","10841","7","864","9.4","6.4"
"Lee","2020-11-21","16","10857","3","867","10.7","7.8"
"Lee","2020-11-22","20","10877","3","870","11.2","8.3"
"Lee","2020-11-23","87","10964","4","874","10.5","8.3"
"Lee","2020-11-24","60","11024","2","876","9.5","8.6"
"Lee","2020-11-25","73","11097","6","882","9.8","8.9"
"Lee","2020-11-26","17","11114","0","882","8.5","8.6"
"Lee","2020-11-27","23","11137","3","885","9","9.2"
"Lee","2020-11-28","20","11157","6","891","10.6","10.7"
"Lee","2020-11-29","14","11171","1","892","9.5","10.3"
"Lee","2020-11-30","88","11259","7","899","10","10.2"
"Lee","2020-12-01","69","11328","4","903","10.3","9.9"
"Lee","2020-12-02","54","11382","2","905","9.7","9.7"
"Lee","2020-12-03","72","11454","3","908","10.3","9.4"
"Lee","2020-12-04","65","11519","10","918","10.6","9.8"
"Lee","2020-12-05","24","11543","7","925","10.5","10.5"
"Lee","2020-12-06","23","11566","5","930","12.6","11"
"Lee","2020-12-07","88","11654","7","937","12.6","11.3"
"Lee","2020-12-08","69","11723","11","948","14","12.2"
"Lee","2020-12-09","69","11792","6","954","14.7","12.2"
"Lee","2020-12-10","73","11865","6","960","15.3","12.8"
"Lee","2020-12-11","90","11955","7","967","14.2","12.4"
"Lee","2020-12-12","26","11981","6","973","13.3","11.9"
"Lee","2020-12-13","27","12008","9","982","15","13.8"
"Lee","2020-12-14","65","12073","17","999","17.6","15.1"
"Lee","2020-12-15","60","12133","9","1008","17.5","15.7"
"Lee","2020-12-16","61","12194","6","1014","17.6","16.2"
"Lee","2020-12-17","67","12261","7","1021","17.9","16.6"
"Lee","2020-12-18","64","12325","4","1025","17.7","16"
"Lee","2020-12-19","58","12383","8","1033","16.4","14.9"
"Lee","2020-12-20","26","12409","7","1040","15.5","15.2"
"Lee","2020-12-21","65","12474","10","1050","13.9","15.8"
"Lee","2020-12-22","82","12556","18","1068","14.9","16.2"
"Lee","2020-12-23","53","12609","7","1075","15.4","16.5"
"Lee","2020-12-24","44","12653","7","1082","16.2","17.1"
"Lee","2020-12-25","13","12666","4","1086","19.7","18.7"
"Lee","2020-12-26","36","12702","15","1101","23.7","20"
"Lee","2020-12-27","23","12725","4","1105","22.3","18.9"
"Lee","2020-12-28","122","12847","32","1137","23.9","18.9"
"Lee","2020-12-29","85","12932","15","1152","23.3","19.1"
"Lee","2020-12-30","86","13018","16","1168","24","19.7"
"Lee","2020-12-31","100","13118","16","1184","24","20.1"
"Lee","2021-01-01","7","13125","0","1184","19.6","19.7"
"Lee","2021-01-02","22","13147","9","1193","19.5","21.6"
"Lee","2021-01-03","32","13179","8","1201","20.6","21.5"
"Lee","2021-01-04","80","13259","17","1218","19.9","21.9"
"Lee","2021-01-05","104","13363","15","1233","19.5","21.4"
"Lee","2021-01-06","90","13453","12","1245","18.7","21.4"
"Lee","2021-01-07","98","13551","16","1261","18.7","21.4"
"Lee","2021-01-08","87","13638","10","1271","20.4","20"
"Lee","2021-01-09","34","13672","8","1279","17.9","18.7"
"Lee","2021-01-10","33","13705","8","1287","17.8","19.2"
"Lee","2021-01-11","83","13788","23","1310","18.7","19.3"
"Lee","2021-01-12","88","13876","11","1321","18.4","19"
"Lee","2021-01-13","71","13947","10","1331","18.6","18.6"
"Lee","2021-01-14","66","14013","9","1340","18.2","18.5"
"Lee","2021-01-15","65","14078","12","1352","19.2","19.8"
"Lee","2021-01-16","27","14105","7","1359","19.5","18.7"
"Lee","2021-01-17","25","14130","5","1364","18.9","18.4"
"Lee","2021-01-18","49","14179","12","1376","18.4","18.6"
"Lee","2021-01-19","60","14239","10","1386","19","18.7"
"Lee","2021-01-20","58","14297","10","1396","19.5","19"
"Lee","2021-01-21","46","14343","7","1403","19.7","18.9"
"Lee","2021-01-22","82","14425","14","1417","19.5","19.3"
"Lee","2021-01-23","31","14456","7","1424","19","19.3"
"Lee","2021-01-24","13","14469","2","1426","18.4","18.6"
"Lee","2021-01-25","64","14533","15","1441","18.2","18.3"
"Lee","2021-01-26","72","14605","8","1449","17.4","18.2"
"Lee","2021-01-27","64","14669","10","1459","17.2","18.3"
"Lee","2021-01-28","56","14725","7","1466","16.8","18.3"
"Lee","2021-01-29","70","14795","11","1477","16.6","18.1"
"Lee","2021-01-30","28","14823","6","1483","16.5","17.7"
"Lee","2021-01-31","29","14852","5","1488","16.7","17.6"
"Lee","2021-02-01","51","14903","10","1498","16.2","17.2"
"Lee","2021-02-02","48","14951","8","1506","17","17.2"
"Lee","2021-02-03","52","15003","8","1514","16.9","17.1"
"Lee","2021-02-04","51","15054","1","1515","15.4","16.1"
"Lee","2021-02-05","49","15103","2","1517","13.8","15.2"
"Lee","2021-02-06","11","15114","0","1517","10.7","13.6"
"Lee","2021-02-07","7","15121","1","1518","10.3","13.5"
"Lee","2021-02-08","0","15121","0","1518","7.5","11.8"
"Liberty","2020-02-01","0","0","0","0",".","."
"Liberty","2020-02-02","0","0","0","0",".","."
"Liberty","2020-02-03","0","0","0","0",".","."
"Liberty","2020-02-04","0","0","0","0",".","."
"Liberty","2020-02-05","0","0","0","0",".","."
"Liberty","2020-02-06","0","0","0","0",".","."
"Liberty","2020-02-07","0","0","0","0","0","."
"Liberty","2020-02-08","0","0","0","0","0","."
"Liberty","2020-02-09","0","0","0","0","0","."
"Liberty","2020-02-10","0","0","0","0","0","."
"Liberty","2020-02-11","0","0","0","0","0","."
"Liberty","2020-02-12","0","0","0","0","0","."
"Liberty","2020-02-13","0","0","0","0","0","."
"Liberty","2020-02-14","0","0","0","0","0","0"
"Liberty","2020-02-15","0","0","0","0","0","0"
"Liberty","2020-02-16","0","0","0","0","0","0"
"Liberty","2020-02-17","0","0","0","0","0","0"
"Liberty","2020-02-18","0","0","0","0","0","0"
"Liberty","2020-02-19","0","0","0","0","0","0"
"Liberty","2020-02-20","0","0","0","0","0","0"
"Liberty","2020-02-21","0","0","0","0","0","0"
"Liberty","2020-02-22","0","0","0","0","0","0"
"Liberty","2020-02-23","0","0","0","0","0","0"
"Liberty","2020-02-24","0","0","0","0","0","0"
"Liberty","2020-02-25","0","0","0","0","0","0"
"Liberty","2020-02-26","0","0","0","0","0","0"
"Liberty","2020-02-27","0","0","0","0","0","0"
"Liberty","2020-02-28","0","0","0","0","0","0"
"Liberty","2020-02-29","0","0","0","0","0","0"
"Liberty","2020-03-01","0","0","0","0","0","0"
"Liberty","2020-03-02","0","0","0","0","0","0"
"Liberty","2020-03-03","0","0","0","0","0","0"
"Liberty","2020-03-04","0","0","0","0","0","0"
"Liberty","2020-03-05","0","0","0","0","0","0"
"Liberty","2020-03-06","0","0","0","0","0","0"
"Liberty","2020-03-07","0","0","0","0","0","0"
"Liberty","2020-03-08","0","0","0","0","0","0"
"Liberty","2020-03-09","0","0","0","0","0","0"
"Liberty","2020-03-10","0","0","0","0","0","0"
"Liberty","2020-03-11","0","0","0","0","0","0"
"Liberty","2020-03-12","0","0","0","0","0","0"
"Liberty","2020-03-13","1","1","0","0","0","0"
"Liberty","2020-03-14","1","2","0","0","0","0"
"Liberty","2020-03-15","10","12","0","0","0","0"
"Liberty","2020-03-16","8","20","0","0","0","0"
"Liberty","2020-03-17","17","37","0","0","0","0"
"Liberty","2020-03-18","5","42","0","0","0","0"
"Liberty","2020-03-19","8","50","0","0","0","0"
"Liberty","2020-03-20","9","59","1","1","1.6","0.8"
"Liberty","2020-03-21","10","69","0","1","1.6","0.8"
"Liberty","2020-03-22","9","78","0","1","1.6","0.8"
"Liberty","2020-03-23","8","86","4","5","8.7","4.4"
"Liberty","2020-03-24","16","102","2","7","10.5","5.3"
"Liberty","2020-03-25","20","122","3","10","12.7","6.3"
"Liberty","2020-03-26","19","141","1","11","13.4","6.7"
"Liberty","2020-03-27","16","157","0","11","11.8","6.7"
"Liberty","2020-03-28","4","161","0","11","11.8","6.7"
"Liberty","2020-03-29","5","166","1","12","14.7","8.1"
"Liberty","2020-03-30","11","177","1","13","8.8","8.8"
"Liberty","2020-03-31","18","195","0","13","7.1","8.8"
"Liberty","2020-04-01","15","210","0","13","4.9","8.8"
"Liberty","2020-04-02","14","224","1","14","5.2","9.3"
"Liberty","2020-04-03","21","245","2","16","6.5","9.2"
"Liberty","2020-04-04","18","263","0","16","6.5","9.2"
"Liberty","2020-04-05","2","265","0","16","3.7","9.2"
"Liberty","2020-04-06","27","292","1","17","2.9","5.9"
"Liberty","2020-04-07","51","343","4","21","4","5.5"
"Liberty","2020-04-08","46","389","2","23","4.7","4.8"
"Liberty","2020-04-09","40","429","2","25","4.3","4.8"
"Liberty","2020-04-10","33","462","3","28","4.3","5.4"
"Liberty","2020-04-11","6","468","0","28","4.3","5.4"
"Liberty","2020-04-12","3","471","0","28","4.3","4"
"Liberty","2020-04-13","18","489","3","31","6.1","4.5"
"Liberty","2020-04-14","28","517","2","33","6","5"
"Liberty","2020-04-15","33","550","3","36","6.7","5.7"
"Liberty","2020-04-16","31","581","1","37","6.5","5.4"
"Liberty","2020-04-17","26","607","1","38","5.7","5"
"Liberty","2020-04-18","13","620","0","38","5.7","5"
"Liberty","2020-04-19","5","625","0","38","5.7","5"
"Liberty","2020-04-20","20","645","0","38","3.3","4.7"
"Liberty","2020-04-21","37","682","0","38","2.3","4.2"
"Liberty","2020-04-22","26","708","0","38","1","3.9"
"Liberty","2020-04-23","17","725","0","38","0.5","3.5"
"Liberty","2020-04-24","31","756","0","38","0","2.9"
"Liberty","2020-04-25","12","768","0","38","0","2.9"
"Liberty","2020-04-26","6","774","1","39","2.4","4"
"Liberty","2020-04-27","16","790","1","40","3.3","3.3"
"Liberty","2020-04-28","26","816","1","41","3.8","3.1"
"Liberty","2020-04-29","29","845","0","41","3.8","2.4"
"Liberty","2020-04-30","36","881","1","42","4.2","2.4"
"Liberty","2020-05-01","118","999","1","43","4.3","2.2"
"Liberty","2020-05-02","5","1004","0","43","4.3","2.2"
"Liberty","2020-05-03","4","1008","0","43","2","2.2"
"Liberty","2020-05-04","130","1138","1","44","1.2","2.2"
"Liberty","2020-05-05","85","1223","0","44","0.6","2.2"
"Liberty","2020-05-06","163","1386","1","45","0.7","2.3"
"Liberty","2020-05-07","214","1600","2","47","0.5","2.3"
"Liberty","2020-05-08","70","1670","0","47","0.3","2.3"
"Liberty","2020-05-09","5","1675","0","47","0.3","2.3"
"Liberty","2020-05-10","0","1675","0","47","0.3","1.1"
"Liberty","2020-05-11","29","1704","0","47","0.2","0.7"
"Liberty","2020-05-12","120","1824","1","48","0.3","0.5"
"Liberty","2020-05-13","228","2052","11","59","0.9","0.8"
"Liberty","2020-05-14","140","2192","1","60","0.9","0.7"
"Liberty","2020-05-15","100","2292","0","60","0.9","0.6"
"Liberty","2020-05-16","17","2309","0","60","0.9","0.6"
"Liberty","2020-05-17","4","2313","0","60","0.9","0.6"
"Liberty","2020-05-18","20","2333","0","60","0.9","0.6"
"Liberty","2020-05-19","35","2368","0","60","0.8","0.6"
"Liberty","2020-05-20","33","2401","1","61","0.5","0.7"
"Liberty","2020-05-21","242","2643","1","62","0.5","0.7"
"Liberty","2020-05-22","61","2704","3","65","1.2","1.1"
"Liberty","2020-05-23","10","2714","0","65","1.2","1.1"
"Liberty","2020-05-24","1","2715","0","65","1.2","1.1"
"Liberty","2020-05-25","6","2721","0","65","1.2","1.1"
"Liberty","2020-05-26","41","2762","2","67","1.9","1.3"
"Liberty","2020-05-27","212","2974","0","67","1.5","1"
"Liberty","2020-05-28","79","3053","0","67","1.4","0.9"
"Liberty","2020-05-29","60","3113","1","68","0.9","1.1"
"Liberty","2020-05-30","11","3124","0","68","0.9","1.1"
"Liberty","2020-05-31","7","3131","0","68","0.9","1.1"
"Liberty","2020-06-01","53","3184","1","69","1.2","1.2"
"Liberty","2020-06-02","31","3215","0","69","0.5","1.2"
"Liberty","2020-06-03","34","3249","0","69","0.5","1"
"Liberty","2020-06-04","22","3271","0","69","0.5","1"
"Liberty","2020-06-05","12","3283","0","69","0.3","0.6"
"Liberty","2020-06-06","5","3288","0","69","0.3","0.6"
"Liberty","2020-06-07","4","3292","0","69","0.3","0.6"
"Liberty","2020-06-08","92","3384","1","70","0.2","0.7"
"Liberty","2020-06-09","42","3426","1","71","0.5","0.5"
"Liberty","2020-06-10","36","3462","0","71","0.5","0.5"
"Liberty","2020-06-11","65","3527","2","73","0.9","0.7"
"Liberty","2020-06-12","39","3566","0","73","0.9","0.6"
"Liberty","2020-06-13","5","3571","0","73","0.9","0.6"
"Liberty","2020-06-14","4","3575","0","73","0.9","0.6"
"Liberty","2020-06-15","46","3621","1","74","1.1","0.6"
"Liberty","2020-06-16","47","3668","2","76","1.4","0.9"
"Liberty","2020-06-17","47","3715","2","78","2","1.2"
"Liberty","2020-06-18","70","3785","1","79","1.7","1.3"
"Liberty","2020-06-19","43","3828","0","79","1.7","1.3"
"Liberty","2020-06-20","22","3850","0","79","1.7","1.3"
"Liberty","2020-06-21","19","3869","1","80","2.5","1.7"
"Liberty","2020-06-22","77","3946","2","82","2.5","1.8"
"Liberty","2020-06-23","67","4013","2","84","2.4","1.9"
"Liberty","2020-06-24","41","4054","1","85","2.1","2"
"Liberty","2020-06-25","65","4119","2","87","2.3","2"
"Liberty","2020-06-26","142","4261","5","92","2.8","2.3"
"Liberty","2020-06-27","36","4297","0","92","2.8","2.3"
"Liberty","2020-06-28","18","4315","1","93","2.9","2.7"
"Liberty","2020-06-29","157","4472","12","105","3.6","3.1"
"Liberty","2020-06-30","123","4595","11","116","4.5","3.4"
"Liberty","2020-07-01","389","4984","44","160","5.7","3.9"
"Liberty","2020-07-02","53","5037","10","170","8","5.2"
"Liberty","2020-07-03","26","5063","3","173","9.1","6"
"Liberty","2020-07-04","7","5070","3","176","15.2","9"
"Liberty","2020-07-05","15","5085","1","177","15.4","9.1"
"Liberty","2020-07-06","165","5250","50","227","18.6","11.1"
"Liberty","2020-07-07","217","5467","33","260","19.5","12"
"Liberty","2020-07-08","112","5579","11","271","19.3","12.5"
"Liberty","2020-07-09","221","5800","25","296","18.2","13.1"
"Liberty","2020-07-10","231","6031","37","333","18.9","14"
"Liberty","2020-07-11","77","6108","6","339","13.9","14.6"
"Liberty","2020-07-12","10","6118","3","342","17.2","16.3"
"Liberty","2020-07-13","220","6338","36","378","15.2","16.9"
"Liberty","2020-07-14","178","6516","32","410","15.6","17.6"
"Liberty","2020-07-15","245","6761","27","437","15.8","17.6"
"Liberty","2020-07-16","173","6934","20","457","15.8","17"
"Liberty","2020-07-17","192","7126","29","486","15.7","17.3"
"Liberty","2020-07-18","25","7151","4","490","16.9","15.4"
"Liberty","2020-07-19","38","7189","3","493","13.7","15.5"
"Liberty","2020-07-20","61","7250","8","501","13.2","14.2"
"Liberty","2020-07-21","145","7395","10","511","11.7","13.6"
"Liberty","2020-07-22","245","7640","29","540","11.8","13.8"
"Liberty","2020-07-23","161","7801","29","569","12.7","14.3"
"Liberty","2020-07-24","126","7927","13","582","12","13.8"
"Liberty","2020-07-25","44","7971","13","595","13.9","15.4"
"Liberty","2020-07-26","24","7995","11","606","19.4","16.5"
"Liberty","2020-07-27","83","8078","19","625","20.8","17"
"Liberty","2020-07-28","73","8151","9","634","21.5","16.6"
"Liberty","2020-07-29","117","8268","15","649","21.7","16.7"
"Liberty","2020-07-30","85","8353","21","670","22.6","17.7"
"Liberty","2020-07-31","120","8473","12","682","22.6","17.3"
"Liberty","2020-08-01","34","8507","5","687","20.5","17.2"
"Liberty","2020-08-02","13","8520","1","688","15","17.2"
"Liberty","2020-08-03","83","8603","15","703","14.3","17.5"
"Liberty","2020-08-04","70","8673","20","723","16.7","19.1"
"Liberty","2020-08-05","107","8780","13","736","16.6","19.1"
"Liberty","2020-08-06","82","8862","34","770","19","20.8"
"Liberty","2020-08-07","108","8970","15","785","19.5","21"
"Liberty","2020-08-08","33","9003","8","793","20.9","20.7"
"Liberty","2020-08-09","23","9026","3","796","21.6","18.3"
"Liberty","2020-08-10","59","9085","10","806","21.5","17.9"
"Liberty","2020-08-11","61","9146","12","818","20.2","18.4"
"Liberty","2020-08-12","146","9292","11","829","19.5","18"
"Liberty","2020-08-13","58","9350","6","835","15.1","17"
"Liberty","2020-08-14","127","9477","10","845","14.2","16.9"
"Liberty","2020-08-15","29","9506","3","848","12.3","16.6"
"Liberty","2020-08-16","21","9527","2","850","11.7","16.7"
"Liberty","2020-08-17","42","9569","5","855","11","16.3"
"Liberty","2020-08-18","55","9624","7","862","10","15.1"
"Liberty","2020-08-19","156","9780","11","873","10","14.8"
"Liberty","2020-08-20","121","9901","9","882","9.6","12.3"
"Liberty","2020-08-21","146","10047","18","900","10.2","12.2"
"Liberty","2020-08-22","28","10075","4","904","10.8","11.5"
"Liberty","2020-08-23","15","10090","2","906","11.3","11.5"
"Liberty","2020-08-24","51","10141","7","913","11.6","11.3"
"Liberty","2020-08-25","31","10172","2","915","10.7","10.3"
"Liberty","2020-08-26","130","10302","10","925","10.8","10.4"
"Liberty","2020-08-27","77","10379","2","927","10.1","9.8"
"Liberty","2020-08-28","115","10494","11","938","9.7","9.9"
"Liberty","2020-08-29","14","10508","3","941","10.7","10.7"
"Liberty","2020-08-30","20","10528","1","942","9.5","10.4"
"Liberty","2020-08-31","34","10562","2","944","8.4","10"
"Liberty","2020-09-01","62","10624","11","955","10","10.3"
"Liberty","2020-09-02","131","10755","9","964","9.9","10.3"
"Liberty","2020-09-03","49","10804","1","965","9.8","9.9"
"Liberty","2020-09-04","75","10879","4","969","9.2","9.4"
"Liberty","2020-09-05","57","10936","2","971","6.6","8.7"
"Liberty","2020-09-06","15","10951","0","971","5.9","7.7"
"Liberty","2020-09-07","13","10964","4","975","9.5","8.9"
"Liberty","2020-09-08","74","11038","5","980","7.9","8.9"
"Liberty","2020-09-09","102","11140","6","986","7.8","8.8"
"Liberty","2020-09-10","41","11181","5","991","9.2","9.5"
"Liberty","2020-09-11","107","11288","11","1002","9.9","9.5"
"Liberty","2020-09-12","31","11319","6","1008","12.2","9.4"
"Liberty","2020-09-13","18","11337","2","1010","13.8","9.8"
"Liberty","2020-09-14","57","11394","6","1016","10.9","10.2"
"Liberty","2020-09-15","81","11475","4","1020","10.6","9.3"
"Liberty","2020-09-16","97","11572","8","1028","11","9.4"
"Liberty","2020-09-17","72","11644","5","1033","10.2","9.7"
"Liberty","2020-09-18","91","11735","5","1038","9.5","9.7"
"Liberty","2020-09-19","38","11773","3","1041","7.9","10"
"Liberty","2020-09-20","22","11795","1","1042","6.9","10.4"
"Liberty","2020-09-21","45","11840","2","1044","6.1","8.5"
"Liberty","2020-09-22","41","11881","5","1049","7.1","8.9"
"Liberty","2020-09-23","105","11986","5","1054","6.6","8.8"
"Liberty","2020-09-24","52","12038","7","1061","7.5","8.9"
"Liberty","2020-09-25","93","12131","4","1065","7.4","8.4"
"Liberty","2020-09-26","25","12156","0","1065","6.2","7.1"
"Liberty","2020-09-27","10","12166","0","1065","5.6","6.3"
"Liberty","2020-09-28","50","12216","2","1067","5.5","5.8"
"Liberty","2020-09-29","27","12243","0","1067","3.8","5.4"
"Liberty","2020-09-30","90","12333","6","1073","4.1","5.3"
"Liberty","2020-10-01","34","12367","0","1073","2.1","4.8"
"Liberty","2020-10-02","98","12465","4","1077","2.1","4.7"
"Liberty","2020-10-03","25","12490","1","1078","2.7","4.5"
"Liberty","2020-10-04","19","12509","3","1081","4.9","5.3"
"Liberty","2020-10-05","54","12563","1","1082","4.6","5.1"
"Liberty","2020-10-06","37","12600","1","1083","5","4.4"
"Liberty","2020-10-07","171","12771","5","1088","4.5","4.3"
"Liberty","2020-10-08","41","12812","6","1094","6.6","4.4"
"Liberty","2020-10-09","107","12919","2","1096","6.3","4.2"
"Liberty","2020-10-10","16","12935","1","1097","6.6","4.6"
"Liberty","2020-10-11","17","12952","0","1097","4.3","4.6"
"Liberty","2020-10-12","36","12988","3","1100","5.2","4.9"
"Liberty","2020-10-13","37","13025","0","1100","4.9","4.9"
"Liberty","2020-10-14","108","13133","5","1105","5.1","4.8"
"Liberty","2020-10-15","40","13173","4","1109","4.4","5.5"
"Liberty","2020-10-16","38","13211","4","1113","5.7","6"
"Liberty","2020-10-17","22","13233","0","1113","4.8","5.7"
"Liberty","2020-10-18","20","13253","1","1114","5.5","4.9"
"Liberty","2020-10-19","55","13308","5","1119","5.6","5.4"
"Liberty","2020-10-20","34","13342","0","1119","5.6","5.2"
"Liberty","2020-10-21","144","13486","13","1132","6.2","5.7"
"Liberty","2020-10-22","42","13528","2","1134","5.5","5"
"Liberty","2020-10-23","52","13580","4","1138","5.1","5.4"
"Liberty","2020-10-24","19","13599","0","1138","5.1","4.9"
"Liberty","2020-10-25","31","13630","4","1142","6.2","5.9"
"Liberty","2020-10-26","64","13694","2","1144","5.4","5.5"
"Liberty","2020-10-27","34","13728","0","1144","5.4","5.5"
"Liberty","2020-10-28","136","13864","5","1149","4.6","5.4"
"Liberty","2020-10-29","40","13904","3","1152","5","5.2"
"Liberty","2020-10-30","48","13952","11","1163","7.2","6.1"
"Liberty","2020-10-31","7","13959","0","1163","7.2","6.1"
"Liberty","2020-11-01","13","13972","1","1164","6.4","6.3"
"Liberty","2020-11-02","64","14036","2","1166","6.4","5.9"
"Liberty","2020-11-03","46","14082","2","1168","7","6.2"
"Liberty","2020-11-04","145","14227","5","1173","7","5.8"
"Liberty","2020-11-05","24","14251","0","1173","5.9","5.5"
"Liberty","2020-11-06","51","14302","6","1179","4.3","5.7"
"Liberty","2020-11-07","32","14334","2","1181","5.2","6.2"
"Liberty","2020-11-08","22","14356","0","1181","4.1","5.3"
"Liberty","2020-11-09","47","14403","7","1188","5.8","6.1"
"Liberty","2020-11-10","53","14456","6","1194","6.8","6.9"
"Liberty","2020-11-11","112","14568","12","1206","7.8","7.4"
"Liberty","2020-11-12","40","14608","6","1212","10","8"
"Liberty","2020-11-13","47","14655","2","1214","8.9","6.6"
"Liberty","2020-11-14","19","14674","4","1218","11","8.1"
"Liberty","2020-11-15","23","14697","1","1219","11.7","7.9"
"Liberty","2020-11-16","61","14758","7","1226","11.2","8.5"
"Liberty","2020-11-17","80","14838","8","1234","11","8.9"
"Liberty","2020-11-18","158","14996","5","1239","9.9","8.9"
"Liberty","2020-11-19","64","15060","5","1244","8.9","9.4"
"Liberty","2020-11-20","54","15114","4","1248","9.3","9.1"
"Liberty","2020-11-21","58","15172","5","1253","7.5","9.3"
"Liberty","2020-11-22","24","15196","2","1255","8.1","9.9"
"Liberty","2020-11-23","73","15269","8","1263","8","9.6"
"Liberty","2020-11-24","62","15331","5","1268","7.8","9.4"
"Liberty","2020-11-25","139","15470","10","1278","8.3","9.1"
"Liberty","2020-11-26","5","15475","0","1278","7.2","8"
"Liberty","2020-11-27","35","15510","5","1283","8.2","8.8"
"Liberty","2020-11-28","29","15539","2","1285","8","7.8"
"Liberty","2020-11-29","29","15568","0","1285","6.8","7.4"
"Liberty","2020-11-30","64","15632","13","1298","8.1","8.1"
"Liberty","2020-12-01","43","15675","7","1305","9.3","8.5"
"Liberty","2020-12-02","185","15860","13","1318","9.3","8.8"
"Liberty","2020-12-03","56","15916","3","1321","10","8.6"
"Liberty","2020-12-04","51","15967","9","1330","10.5","9.4"
"Liberty","2020-12-05","26","15993","2","1332","10.6","9.3"
"Liberty","2020-12-06","13","16006","4","1336","15","10.9"
"Liberty","2020-12-07","58","16064","6","1342","13.6","10.8"
"Liberty","2020-12-08","68","16132","4","1346","12.1","10.7"
"Liberty","2020-12-09","243","16375","14","1360","11.9","10.6"
"Liberty","2020-12-10","62","16437","10","1370","13.5","11.7"
"Liberty","2020-12-11","88","16525","6","1376","11.9","11.2"
"Liberty","2020-12-12","41","16566","7","1383","13.3","11.9"
"Liberty","2020-12-13","36","16602","5","1388","10.8","12.9"
"Liberty","2020-12-14","81","16683","6","1394","10.4","12"
"Liberty","2020-12-15","69","16752","7","1401","11","11.6"
"Liberty","2020-12-16","207","16959","19","1420","11.5","11.7"
"Liberty","2020-12-17","85","17044","12","1432","11.2","12.3"
"Liberty","2020-12-18","80","17124","10","1442","12","12"
"Liberty","2020-12-19","45","17169","6","1448","11.5","12.4"
"Liberty","2020-12-20","40","17209","6","1454","11.7","11.3"
"Liberty","2020-12-21","62","17271","8","1462","12.5","11.4"
"Liberty","2020-12-22","71","17342","11","1473","13.2","12.1"
"Liberty","2020-12-23","160","17502","13","1486","13.1","12.3"
"Liberty","2020-12-24","47","17549","8","1494","13.5","12.4"
"Liberty","2020-12-25","7","17556","0","1494","11.7","11.9"
"Liberty","2020-12-26","35","17591","9","1503","13.5","12.5"
"Liberty","2020-12-27","24","17615","2","1505","12.5","12.1"
"Liberty","2020-12-28","86","17701","10","1515","12.3","12.4"
"Liberty","2020-12-29","72","17773","15","1530","13.1","13.2"
"Liberty","2020-12-30","185","17958","25","1555","13.9","13.5"
"Liberty","2020-12-31","56","18014","7","1562","13.2","13.3"
"Liberty","2021-01-01","5","18019","0","1562","13.2","12.5"
"Liberty","2021-01-02","26","18045","4","1566","11.7","12.6"
"Liberty","2021-01-03","32","18077","1","1567","11","11.8"
"Liberty","2021-01-04","74","18151","19","1586","13","12.7"
"Liberty","2021-01-05","112","18263","34","1620","14.4","13.7"
"Liberty","2021-01-06","209","18472","22","1642","13.9","13.9"
"Liberty","2021-01-07","83","18555","22","1664","15.9","14.6"
"Liberty","2021-01-08","72","18627","11","1675","18.1","15.7"
"Liberty","2021-01-09","44","18671","3","1678","16.9","14.3"
"Liberty","2021-01-10","33","18704","7","1685","19.5","15.2"
"Liberty","2021-01-11","89","18793","19","1704","18.9","15.9"
"Liberty","2021-01-12","131","18924","17","1721","16.4","15.4"
"Liberty","2021-01-13","177","19101","23","1744","16.7","15.3"
"Liberty","2021-01-14","76","19177","19","1763","16.5","16.2"
"Liberty","2021-01-15","94","19271","18","1781","17.1","17.6"
"Liberty","2021-01-16","38","19309","8","1789","19.1","18"
"Liberty","2021-01-17","43","19352","17","1806","21.7","20.6"
"Liberty","2021-01-18","98","19450","18","1824","21.3","20.1"
"Liberty","2021-01-19","91","19541","15","1839","21.8","19.1"
"Liberty","2021-01-20","184","19725","26","1865","22","19.3"
"Liberty","2021-01-21","82","19807","13","1878","20.7","18.6"
"Liberty","2021-01-22","92","19899","17","1895","20.6","18.8"
"Liberty","2021-01-23","48","19947","15","1910","22","20.6"
"Liberty","2021-01-24","46","19993","7","1917","18.5","20.1"
"Liberty","2021-01-25","100","20093","13","1930","17.8","19.5"
"Liberty","2021-01-26","91","20184","17","1947","18.1","19.9"
"Liberty","2021-01-27","188","20372","13","1960","17.1","19.5"
"Liberty","2021-01-28","69","20441","12","1972","17.3","19"
"Liberty","2021-01-29","82","20523","14","1986","17.1","18.8"
"Liberty","2021-01-30","43","20566","9","1995","15.6","18.8"
"Liberty","2021-01-31","27","20593","3","1998","15","16.8"
"Liberty","2021-02-01","92","20685","9","2007","14.6","16.2"
"Liberty","2021-02-02","163","20848","8","2015","12.6","15.3"
"Liberty","2021-02-03","90","20938","13","2028","13.7","15.4"
"Liberty","2021-02-04","85","21023","8","2036","12.5","14.9"
"Liberty","2021-02-05","83","21106","12","2048","12.1","14.6"
"Liberty","2021-02-06","18","21124","3","2051","11.5","13.6"
"Liberty","2021-02-07","0","21124","0","2051","10","12.5"
"Liberty","2021-02-08","0","21124","0","2051","8.6","11.6"
"Lincoln","2020-02-01","0","0","0","0",".","."
"Lincoln","2020-02-02","0","0","0","0",".","."
"Lincoln","2020-02-03","0","0","0","0",".","."
"Lincoln","2020-02-04","0","0","0","0",".","."
"Lincoln","2020-02-05","0","0","0","0",".","."
"Lincoln","2020-02-06","0","0","0","0",".","."
"Lincoln","2020-02-07","0","0","0","0","0","."
"Lincoln","2020-02-08","0","0","0","0","0","."
"Lincoln","2020-02-09","0","0","0","0","0","."
"Lincoln","2020-02-10","0","0","0","0","0","."
"Lincoln","2020-02-11","0","0","0","0","0","."
"Lincoln","2020-02-12","0","0","0","0","0","."
"Lincoln","2020-02-13","0","0","0","0","0","."
"Lincoln","2020-02-14","0","0","0","0","0","0"
"Lincoln","2020-02-15","0","0","0","0","0","0"
"Lincoln","2020-02-16","0","0","0","0","0","0"
"Lincoln","2020-02-17","0","0","0","0","0","0"
"Lincoln","2020-02-18","0","0","0","0","0","0"
"Lincoln","2020-02-19","0","0","0","0","0","0"
"Lincoln","2020-02-20","0","0","0","0","0","0"
"Lincoln","2020-02-21","0","0","0","0","0","0"
"Lincoln","2020-02-22","0","0","0","0","0","0"
"Lincoln","2020-02-23","0","0","0","0","0","0"
"Lincoln","2020-02-24","0","0","0","0","0","0"
"Lincoln","2020-02-25","0","0","0","0","0","0"
"Lincoln","2020-02-26","0","0","0","0","0","0"
"Lincoln","2020-02-27","0","0","0","0","0","0"
"Lincoln","2020-02-28","0","0","0","0","0","0"
"Lincoln","2020-02-29","0","0","0","0","0","0"
"Lincoln","2020-03-01","0","0","0","0","0","0"
"Lincoln","2020-03-02","0","0","0","0","0","0"
"Lincoln","2020-03-03","0","0","0","0","0","0"
"Lincoln","2020-03-04","0","0","0","0","0","0"
"Lincoln","2020-03-05","0","0","0","0","0","0"
"Lincoln","2020-03-06","0","0","0","0","0","0"
"Lincoln","2020-03-07","0","0","0","0","0","0"
"Lincoln","2020-03-08","0","0","0","0","0","0"
"Lincoln","2020-03-09","0","0","0","0","0","0"
"Lincoln","2020-03-10","0","0","0","0","0","0"
"Lincoln","2020-03-11","0","0","0","0","0","0"
"Lincoln","2020-03-12","0","0","0","0","0","0"
"Lincoln","2020-03-13","0","0","0","0","0","0"
"Lincoln","2020-03-14","0","0","0","0","0","0"
"Lincoln","2020-03-15","0","0","0","0","0","0"
"Lincoln","2020-03-16","0","0","0","0","0","0"
"Lincoln","2020-03-17","0","0","0","0","0","0"
"Lincoln","2020-03-18","0","0","0","0","0","0"
"Lincoln","2020-03-19","0","0","0","0","0","0"
"Lincoln","2020-03-20","0","0","0","0","0","0"
"Lincoln","2020-03-21","2","2","2","2","14.3","7.1"
"Lincoln","2020-03-22","0","2","0","2","14.3","7.1"
"Lincoln","2020-03-23","1","3","0","2","14.3","7.1"
"Lincoln","2020-03-24","0","3","0","2","14.3","7.1"
"Lincoln","2020-03-25","0","3","0","2","14.3","7.1"
"Lincoln","2020-03-26","1","4","0","2","14.3","7.1"
"Lincoln","2020-03-27","1","5","0","2","14.3","7.1"
"Lincoln","2020-03-28","1","6","0","2","0","7.1"
"Lincoln","2020-03-29","0","6","0","2","0","7.1"
"Lincoln","2020-03-30","2","8","1","3","7.1","10.7"
"Lincoln","2020-03-31","0","8","0","3","7.1","10.7"
"Lincoln","2020-04-01","2","10","0","3","7.1","10.7"
"Lincoln","2020-04-02","3","13","0","3","7.1","10.7"
"Lincoln","2020-04-03","5","18","0","3","7.1","10.7"
"Lincoln","2020-04-04","2","20","1","4","14.3","7.1"
"Lincoln","2020-04-05","1","21","0","4","14.3","7.1"
"Lincoln","2020-04-06","0","21","0","4","7.1","7.1"
"Lincoln","2020-04-07","2","23","1","5","14.3","10.7"
"Lincoln","2020-04-08","8","31","2","7","17.9","12.5"
"Lincoln","2020-04-09","3","34","0","7","17.9","12.5"
"Lincoln","2020-04-10","4","38","0","7","17.9","12.5"
"Lincoln","2020-04-11","1","39","0","7","10.7","12.5"
"Lincoln","2020-04-12","0","39","0","7","10.7","12.5"
"Lincoln","2020-04-13","2","41","0","7","10.7","8.9"
"Lincoln","2020-04-14","1","42","0","7","3.6","8.9"
"Lincoln","2020-04-15","5","47","0","7","0","8.9"
"Lincoln","2020-04-16","4","51","0","7","0","8.9"
"Lincoln","2020-04-17","0","51","0","7","0","8.9"
"Lincoln","2020-04-18","1","52","0","7","0","5.4"
"Lincoln","2020-04-19","1","53","1","8","14.3","12.5"
"Lincoln","2020-04-20","6","59","1","9","16.7","13.7"
"Lincoln","2020-04-21","1","60","0","9","16.7","10.1"
"Lincoln","2020-04-22","10","70","2","11","19.5","9.8"
"Lincoln","2020-04-23","5","75","0","11","19.5","9.8"
"Lincoln","2020-04-24","4","79","0","11","19.5","9.8"
"Lincoln","2020-04-25","8","87","0","11","19.5","9.8"
"Lincoln","2020-04-26","3","90","2","13","14.8","14.5"
"Lincoln","2020-04-27","0","90","0","13","12.4","14.5"
"Lincoln","2020-04-28","3","93","0","13","12.4","14.5"
"Lincoln","2020-04-29","2","95","0","13","9.5","14.5"
"Lincoln","2020-04-30","4","99","0","13","9.5","14.5"
"Lincoln","2020-05-01","4","103","0","13","9.5","14.5"
"Lincoln","2020-05-02","4","107","0","13","9.5","14.5"
"Lincoln","2020-05-03","3","110","0","13","0","7.4"
"Lincoln","2020-05-04","3","113","0","13","0","6.2"
"Lincoln","2020-05-05","7","120","0","13","0","6.2"
"Lincoln","2020-05-06","4","124","0","13","0","4.8"
"Lincoln","2020-05-07","1","125","0","13","0","4.8"
"Lincoln","2020-05-08","3","128","0","13","0","4.8"
"Lincoln","2020-05-09","0","128","0","13","0","4.8"
"Lincoln","2020-05-10","0","128","0","13","0","0"
"Lincoln","2020-05-11","1","129","0","13","0","0"
"Lincoln","2020-05-12","1","130","0","13","0","0"
"Lincoln","2020-05-13","3","133","0","13","0","0"
"Lincoln","2020-05-14","2","135","0","13","0","0"
"Lincoln","2020-05-15","2","137","0","13","0","0"
"Lincoln","2020-05-16","2","139","0","13","0","0"
"Lincoln","2020-05-17","2","141","0","13","0","0"
"Lincoln","2020-05-18","12","153","4","17","4.8","2.4"
"Lincoln","2020-05-19","5","158","2","19","10.5","5.2"
"Lincoln","2020-05-20","4","162","0","19","10.5","5.2"
"Lincoln","2020-05-21","24","186","0","19","10.5","5.2"
"Lincoln","2020-05-22","21","207","0","19","10.5","5.2"
"Lincoln","2020-05-23","1","208","0","19","10.5","5.2"
"Lincoln","2020-05-24","2","210","0","19","10.5","5.2"
"Lincoln","2020-05-25","0","210","0","19","5.7","5.2"
"Lincoln","2020-05-26","2","212","0","19","0","5.2"
"Lincoln","2020-05-27","4","216","0","19","0","5.2"
"Lincoln","2020-05-28","3","219","0","19","0","5.2"
"Lincoln","2020-05-29","2","221","0","19","0","5.2"
"Lincoln","2020-05-30","0","221","0","19","0","5.2"
"Lincoln","2020-05-31","2","223","0","19","0","5.2"
"Lincoln","2020-06-01","13","236","0","19","0","2.9"
"Lincoln","2020-06-02","6","242","0","19","0","0"
"Lincoln","2020-06-03","4","246","1","20","3.6","1.8"
"Lincoln","2020-06-04","1","247","0","20","3.6","1.8"
"Lincoln","2020-06-05","4","251","0","20","3.6","1.8"
"Lincoln","2020-06-06","0","251","0","20","3.6","1.8"
"Lincoln","2020-06-07","0","251","0","20","3.6","1.8"
"Lincoln","2020-06-08","2","253","0","20","3.6","1.8"
"Lincoln","2020-06-09","5","258","1","21","6.4","3.2"
"Lincoln","2020-06-10","2","260","0","21","2.9","3.2"
"Lincoln","2020-06-11","4","264","0","21","2.9","3.2"
"Lincoln","2020-06-12","4","268","0","21","2.9","3.2"
"Lincoln","2020-06-13","6","274","0","21","2.9","3.2"
"Lincoln","2020-06-14","1","275","1","22","17.1","10.4"
"Lincoln","2020-06-15","5","280","1","23","20","11.8"
"Lincoln","2020-06-16","6","286","2","25","21.9","14.2"
"Lincoln","2020-06-17","6","292","1","26","24.3","13.6"
"Lincoln","2020-06-18","6","298","4","30","33.8","18.3"
"Lincoln","2020-06-19","3","301","0","30","33.8","18.3"
"Lincoln","2020-06-20","7","308","2","32","37.9","20.4"
"Lincoln","2020-06-21","1","309","0","32","23.6","20.4"
"Lincoln","2020-06-22","14","323","3","35","23.8","21.9"
"Lincoln","2020-06-23","10","333","1","36","20.5","21.2"
"Lincoln","2020-06-24","15","348","1","37","19","21.7"
"Lincoln","2020-06-25","17","365","1","38","10.4","22.1"
"Lincoln","2020-06-26","11","376","3","41","14.3","24"
"Lincoln","2020-06-27","5","381","0","41","10.2","24"
"Lincoln","2020-06-28","1","382","0","41","10.2","16.9"
"Lincoln","2020-06-29","6","388","1","42","9.5","16.7"
"Lincoln","2020-06-30","14","402","3","45","11.1","15.8"
"Lincoln","2020-07-01","22","424","7","52","14.7","16.9"
"Lincoln","2020-07-02","13","437","2","54","16.1","13.2"
"Lincoln","2020-07-03","5","442","1","55","15","14.7"
"Lincoln","2020-07-04","4","446","1","56","18.6","14.4"
"Lincoln","2020-07-05","9","455","1","57","20.2","15.2"
"Lincoln","2020-07-06","11","466","1","58","19.1","14.3"
"Lincoln","2020-07-07","14","480","2","60","18.1","14.6"
"Lincoln","2020-07-08","20","500","1","61","14.3","14.5"
"Lincoln","2020-07-09","3","503","2","63","21.6","18.8"
"Lincoln","2020-07-10","9","512","0","63","18.7","16.9"
"Lincoln","2020-07-11","13","525","1","64","16.3","17.4"
"Lincoln","2020-07-12","5","530","1","65","17.5","18.9"
"Lincoln","2020-07-13","18","548","6","71","21","20.1"
"Lincoln","2020-07-14","14","562","0","71","19","18.5"
"Lincoln","2020-07-15","15","577","6","77","24","19.1"
"Lincoln","2020-07-16","9","586","0","77","14.4","18"
"Lincoln","2020-07-17","11","597","0","77","14.4","16.6"
"Lincoln","2020-07-18","14","611","4","81","17.4","16.8"
"Lincoln","2020-07-19","1","612","0","81","14.6","16"
"Lincoln","2020-07-20","7","619","1","82","11.8","16.4"
"Lincoln","2020-07-21","6","625","0","82","11.8","15.4"
"Lincoln","2020-07-22","4","629","2","84","13.3","18.6"
"Lincoln","2020-07-23","9","638","1","85","14.9","14.6"
"Lincoln","2020-07-24","18","656","0","85","14.9","14.6"
"Lincoln","2020-07-25","8","664","1","86","12.6","15"
"Lincoln","2020-07-26","13","677","2","88","14.8","14.7"
"Lincoln","2020-07-27","22","699","1","89","13.4","12.6"
"Lincoln","2020-07-28","11","710","2","91","16","13.9"
"Lincoln","2020-07-29","9","719","2","93","12","12.6"
"Lincoln","2020-07-30","6","725","2","95","15.2","15"
"Lincoln","2020-07-31","10","735","1","96","16.6","15.7"
"Lincoln","2020-08-01","7","742","3","99","20.9","16.7"
"Lincoln","2020-08-02","5","747","1","100","21.6","18.2"
"Lincoln","2020-08-03","11","758","0","100","20.9","17.2"
"Lincoln","2020-08-04","9","767","0","100","18.3","17.2"
"Lincoln","2020-08-05","13","780","2","102","17.4","14.7"
"Lincoln","2020-08-06","13","793","5","107","18.1","16.6"
"Lincoln","2020-08-07","17","810","3","110","19.2","17.9"
"Lincoln","2020-08-08","3","813","1","111","17.8","19.4"
"Lincoln","2020-08-09","11","824","1","112","16.3","18.9"
"Lincoln","2020-08-10","27","851","2","114","17.3","19.1"
"Lincoln","2020-08-11","10","861","2","116","20.2","19.3"
"Lincoln","2020-08-12","4","865","2","118","25.1","21.3"
"Lincoln","2020-08-13","5","870","1","119","22.5","20.3"
"Lincoln","2020-08-14","13","883","1","120","21.1","20.1"
"Lincoln","2020-08-15","30","913","0","120","16.3","17.1"
"Lincoln","2020-08-16","4","917","1","121","18.6","17.4"
"Lincoln","2020-08-17","4","921","0","121","17.5","17.4"
"Lincoln","2020-08-18","7","928","2","123","18.8","19.5"
"Lincoln","2020-08-19","7","935","1","124","13.6","19.4"
"Lincoln","2020-08-20","6","941","1","125","13.2","17.8"
"Lincoln","2020-08-21","6","947","0","125","12.1","16.6"
"Lincoln","2020-08-22","7","954","2","127","16.2","16.2"
"Lincoln","2020-08-23","6","960","0","127","12.6","15.6"
"Lincoln","2020-08-24","33","993","3","130","13.9","15.7"
"Lincoln","2020-08-25","10","1003","0","130","9.8","14.3"
"Lincoln","2020-08-26","5","1008","0","130","7.8","10.7"
"Lincoln","2020-08-27","4","1012","1","131","9","11.1"
"Lincoln","2020-08-28","11","1023","3","134","12.8","12.5"
"Lincoln","2020-08-29","2","1025","0","134","8.8","12.5"
"Lincoln","2020-08-30","2","1027","0","134","8.8","10.7"
"Lincoln","2020-08-31","22","1049","2","136","8.8","11.3"
"Lincoln","2020-09-01","10","1059","0","136","8.8","9.3"
"Lincoln","2020-09-02","10","1069","0","136","8.8","8.3"
"Lincoln","2020-09-03","9","1078","0","136","5.2","7.1"
"Lincoln","2020-09-04","9","1087","0","136","1.3","7.1"
"Lincoln","2020-09-05","12","1099","0","136","1.3","5"
"Lincoln","2020-09-06","4","1103","0","136","1.3","5"
"Lincoln","2020-09-07","1","1104","0","136","0","4.4"
"Lincoln","2020-09-08","8","1112","1","137","1.8","5.3"
"Lincoln","2020-09-09","6","1118","2","139","6.5","7.7"
"Lincoln","2020-09-10","9","1127","0","139","6.5","5.9"
"Lincoln","2020-09-11","8","1135","1","140","8.3","4.8"
"Lincoln","2020-09-12","10","1145","1","141","9.8","5.5"
"Lincoln","2020-09-13","3","1148","0","141","9.8","5.5"
"Lincoln","2020-09-14","32","1180","0","141","9.8","4.9"
"Lincoln","2020-09-15","13","1193","0","141","8","4.9"
"Lincoln","2020-09-16","8","1201","1","142","5","5.8"
"Lincoln","2020-09-17","13","1214","1","143","6.1","6.3"
"Lincoln","2020-09-18","11","1225","2","145","6.9","7.6"
"Lincoln","2020-09-19","7","1232","1","146","7.5","8.6"
"Lincoln","2020-09-20","0","1232","0","146","7.5","8.6"
"Lincoln","2020-09-21","21","1253","0","146","7.5","8.6"
"Lincoln","2020-09-22","5","1258","0","146","7.5","7.7"
"Lincoln","2020-09-23","3","1261","1","147","10.5","7.7"
"Lincoln","2020-09-24","3","1264","0","147","9.4","7.7"
"Lincoln","2020-09-25","4","1268","0","147","6.8","6.9"
"Lincoln","2020-09-26","4","1272","0","147","4.8","6.1"
"Lincoln","2020-09-27","2","1274","0","147","4.8","6.1"
"Lincoln","2020-09-28","9","1283","0","147","4.8","6.1"
"Lincoln","2020-09-29","9","1292","1","148","6.3","6.9"
"Lincoln","2020-09-30","6","1298","0","148","1.6","6"
"Lincoln","2020-10-01","3","1301","0","148","1.6","5.5"
"Lincoln","2020-10-02","10","1311","1","149","3","4.9"
"Lincoln","2020-10-03","7","1318","0","149","3","3.9"
"Lincoln","2020-10-04","2","1320","0","149","3","3.9"
"Lincoln","2020-10-05","12","1332","1","150","4.2","4.5"
"Lincoln","2020-10-06","11","1343","0","150","2.6","4.5"
"Lincoln","2020-10-07","14","1357","1","151","3.6","2.6"
"Lincoln","2020-10-08","11","1368","2","153","6.2","3.9"
"Lincoln","2020-10-09","6","1374","0","153","4.8","3.9"
"Lincoln","2020-10-10","8","1382","0","153","4.8","3.9"
"Lincoln","2020-10-11","5","1387","0","153","4.8","3.9"
"Lincoln","2020-10-12","6","1393","1","154","6","5.1"
"Lincoln","2020-10-13","7","1400","0","154","6","4.3"
"Lincoln","2020-10-14","9","1409","0","154","5","4.3"
"Lincoln","2020-10-15","5","1414","1","155","5.2","5.7"
"Lincoln","2020-10-16","17","1431","2","157","6.9","5.9"
"Lincoln","2020-10-17","15","1446","0","157","6.9","5.9"
"Lincoln","2020-10-18","6","1452","2","159","11.7","8.2"
"Lincoln","2020-10-19","23","1475","3","162","11.2","8.6"
"Lincoln","2020-10-20","10","1485","1","163","12.6","9.3"
"Lincoln","2020-10-21","4","1489","0","163","12.6","8.8"
"Lincoln","2020-10-22","6","1495","1","164","12.1","8.7"
"Lincoln","2020-10-23","8","1503","0","164","10.4","8.7"
"Lincoln","2020-10-24","15","1518","0","164","10.4","8.7"
"Lincoln","2020-10-25","5","1523","0","164","5.7","8.7"
"Lincoln","2020-10-26","28","1551","1","165","4.3","7.7"
"Lincoln","2020-10-27","9","1560","0","165","2.9","7.7"
"Lincoln","2020-10-28","8","1568","5","170","11.8","12.2"
"Lincoln","2020-10-29","12","1580","1","171","10.6","11.4"
"Lincoln","2020-10-30","13","1593","1","172","11.7","11.1"
"Lincoln","2020-10-31","4","1597","0","172","11.7","11.1"
"Lincoln","2020-11-01","6","1603","0","172","11.7","8.7"
"Lincoln","2020-11-02","29","1632","4","176","13.2","8.8"
"Lincoln","2020-11-03","13","1645","2","178","15.4","9.1"
"Lincoln","2020-11-04","9","1654","1","179","8","9.9"
"Lincoln","2020-11-05","12","1666","2","181","9.2","9.9"
"Lincoln","2020-11-06","7","1673","2","183","12.2","12"
"Lincoln","2020-11-07","21","1694","1","184","12.9","12.3"
"Lincoln","2020-11-08","3","1697","0","184","12.9","12.3"
"Lincoln","2020-11-09","14","1711","2","186","13","13.1"
"Lincoln","2020-11-10","17","1728","3","189","13.3","14.3"
"Lincoln","2020-11-11","16","1744","1","190","12.6","10.3"
"Lincoln","2020-11-12","15","1759","0","190","10.2","9.7"
"Lincoln","2020-11-13","18","1777","1","191","6.9","9.6"
"Lincoln","2020-11-14","44","1821","4","195","7.5","10.2"
"Lincoln","2020-11-15","21","1842","1","196","8.2","10.6"
"Lincoln","2020-11-16","27","1869","1","197","6.7","9.8"
"Lincoln","2020-11-17","11","1880","0","197","4.2","8.7"
"Lincoln","2020-11-18","23","1903","3","200","5.2","8.9"
"Lincoln","2020-11-19","16","1919","3","203","7.8","9"
"Lincoln","2020-11-20","19","1938","4","207","10.1","8.5"
"Lincoln","2020-11-21","11","1949","1","208","10.1","8.8"
"Lincoln","2020-11-22","7","1956","0","208","9.4","8.8"
"Lincoln","2020-11-23","31","1987","3","211","10.2","8.5"
"Lincoln","2020-11-24","11","1998","0","211","10.2","7.2"
"Lincoln","2020-11-25","6","2004","1","212","10.7","8"
"Lincoln","2020-11-26","16","2020","0","212","8.1","8"
"Lincoln","2020-11-27","5","2025","0","212","5.1","7.6"
"Lincoln","2020-11-28","3","2028","0","212","3.8","6.9"
"Lincoln","2020-11-29","4","2032","0","212","3.8","6.6"
"Lincoln","2020-11-30","21","2053","2","214","3.7","7"
"Lincoln","2020-12-01","14","2067","1","215","4.8","7.5"
"Lincoln","2020-12-02","18","2085","3","218","4.8","7.8"
"Lincoln","2020-12-03","13","2098","0","218","4.8","6.4"
"Lincoln","2020-12-04","12","2110","1","219","6","5.5"
"Lincoln","2020-12-05","17","2127","2","221","7.6","5.7"
"Lincoln","2020-12-06","4","2131","1","222","11.2","7.5"
"Lincoln","2020-12-07","20","2151","0","222","9.8","6.8"
"Lincoln","2020-12-08","11","2162","2","224","11.4","8.1"
"Lincoln","2020-12-09","35","2197","2","226","9.9","7.3"
"Lincoln","2020-12-10","14","2211","1","227","10.9","7.8"
"Lincoln","2020-12-11","9","2220","0","227","9.7","7.8"
"Lincoln","2020-12-12","8","2228","2","229","11.6","9.6"
"Lincoln","2020-12-13","4","2232","0","229","8","9.6"
"Lincoln","2020-12-14","13","2245","1","230","9.1","9.5"
"Lincoln","2020-12-15","14","2259","2","232","8.5","10"
"Lincoln","2020-12-16","11","2270","4","236","12.9","11.4"
"Lincoln","2020-12-17","7","2277","2","238","16","13.4"
"Lincoln","2020-12-18","7","2284","1","239","18","13.9"
"Lincoln","2020-12-19","9","2293","1","240","16","13.8"
"Lincoln","2020-12-20","8","2301","0","240","16","12"
"Lincoln","2020-12-21","7","2308","1","241","17","13"
"Lincoln","2020-12-22","8","2316","2","243","18.5","13.5"
"Lincoln","2020-12-23","15","2331","2","245","15.2","14.1"
"Lincoln","2020-12-24","5","2336","1","246","14","15"
"Lincoln","2020-12-25","1","2337","0","246","12","15"
"Lincoln","2020-12-26","4","2341","1","247","13.9","15"
"Lincoln","2020-12-27","8","2349","4","251","21.1","18.6"
"Lincoln","2020-12-28","16","2365","0","251","19","18"
"Lincoln","2020-12-29","9","2374","1","252","17.1","17.8"
"Lincoln","2020-12-30","18","2392","5","257","19.1","17.2"
"Lincoln","2020-12-31","17","2409","2","259","18","16"
"Lincoln","2021-01-01","1","2410","0","259","18","15"
"Lincoln","2021-01-02","7","2417","2","261","18.5","16.2"
"Lincoln","2021-01-03","1","2418","1","262","25.6","23.3"
"Lincoln","2021-01-04","7","2425","1","263","27.6","23.3"
"Lincoln","2021-01-05","25","2450","7","270","30.1","23.6"
"Lincoln","2021-01-06","17","2467","5","275","30.3","24.7"
"Lincoln","2021-01-07","19","2486","2","277","30.1","24"
"Lincoln","2021-01-08","14","2500","3","280","33.2","25.6"
"Lincoln","2021-01-09","8","2508","4","284","36.2","27.3"
"Lincoln","2021-01-10","9","2517","3","287","26.7","26.2"
"Lincoln","2021-01-11","32","2549","7","294","27.8","27.7"
"Lincoln","2021-01-12","14","2563","4","298","27.9","29"
"Lincoln","2021-01-13","13","2576","3","301","27","28.6"
"Lincoln","2021-01-14","25","2601","5","306","28.3","29.2"
"Lincoln","2021-01-15","22","2623","7","313","29.8","31.5"
"Lincoln","2021-01-16","8","2631","1","314","24.5","30.3"
"Lincoln","2021-01-17","10","2641","7","321","29.7","28.2"
"Lincoln","2021-01-18","27","2668","6","327","29.7","28.8"
"Lincoln","2021-01-19","20","2688","7","334","30.7","29.3"
"Lincoln","2021-01-20","15","2703","4","338","31.2","29.1"
"Lincoln","2021-01-21","17","2720","4","342","31.7","30"
"Lincoln","2021-01-22","7","2727","0","342","27.1","28.5"
"Lincoln","2021-01-23","2","2729","0","342","25.3","24.9"
"Lincoln","2021-01-24","5","2734","0","342","15.3","22.5"
"Lincoln","2021-01-25","10","2744","3","345","16.5","23.1"
"Lincoln","2021-01-26","14","2758","2","347","13.5","22.1"
"Lincoln","2021-01-27","18","2776","3","350","12.1","21.6"
"Lincoln","2021-01-28","20","2796","5","355","12.3","22"
"Lincoln","2021-01-29","20","2816","6","361","16.6","21.8"
"Lincoln","2021-01-30","6","2822","1","362","18.9","22.1"
"Lincoln","2021-01-31","7","2829","1","363","21","18.2"
"Lincoln","2021-02-01","14","2843","0","363","16.7","16.6"
"Lincoln","2021-02-02","17","2860","1","364","15.5","14.5"
"Lincoln","2021-02-03","10","2870","0","364","13.1","12.6"
"Lincoln","2021-02-04","13","2883","3","367","12.8","12.6"
"Lincoln","2021-02-05","8","2891","1","368","10.3","13.5"
"Lincoln","2021-02-06","1","2892","0","368","8","13.5"
"Lincoln","2021-02-07","0","2892","0","368","5.9","13.5"
"Lincoln","2021-02-08","0","2892","0","368","5.9","11.3"
"Long","2020-02-01","0","0","0","0",".","."
"Long","2020-02-02","0","0","0","0",".","."
"Long","2020-02-03","0","0","0","0",".","."
"Long","2020-02-04","0","0","0","0",".","."
"Long","2020-02-05","0","0","0","0",".","."
"Long","2020-02-06","0","0","0","0",".","."
"Long","2020-02-07","0","0","0","0","0","."
"Long","2020-02-08","0","0","0","0","0","."
"Long","2020-02-09","0","0","0","0","0","."
"Long","2020-02-10","0","0","0","0","0","."
"Long","2020-02-11","0","0","0","0","0","."
"Long","2020-02-12","0","0","0","0","0","."
"Long","2020-02-13","0","0","0","0","0","."
"Long","2020-02-14","0","0","0","0","0","0"
"Long","2020-02-15","0","0","0","0","0","0"
"Long","2020-02-16","0","0","0","0","0","0"
"Long","2020-02-17","0","0","0","0","0","0"
"Long","2020-02-18","0","0","0","0","0","0"
"Long","2020-02-19","0","0","0","0","0","0"
"Long","2020-02-20","0","0","0","0","0","0"
"Long","2020-02-21","0","0","0","0","0","0"
"Long","2020-02-22","0","0","0","0","0","0"
"Long","2020-02-23","0","0","0","0","0","0"
"Long","2020-02-24","0","0","0","0","0","0"
"Long","2020-02-25","0","0","0","0","0","0"
"Long","2020-02-26","0","0","0","0","0","0"
"Long","2020-02-27","0","0","0","0","0","0"
"Long","2020-02-28","0","0","0","0","0","0"
"Long","2020-02-29","0","0","0","0","0","0"
"Long","2020-03-01","0","0","0","0","0","0"
"Long","2020-03-02","0","0","0","0","0","0"
"Long","2020-03-03","0","0","0","0","0","0"
"Long","2020-03-04","0","0","0","0","0","0"
"Long","2020-03-05","0","0","0","0","0","0"
"Long","2020-03-06","0","0","0","0","0","0"
"Long","2020-03-07","0","0","0","0","0","0"
"Long","2020-03-08","0","0","0","0","0","0"
"Long","2020-03-09","0","0","0","0","0","0"
"Long","2020-03-10","0","0","0","0","0","0"
"Long","2020-03-11","0","0","0","0","0","0"
"Long","2020-03-12","4","4","0","0","0","0"
"Long","2020-03-13","1","5","0","0","0","0"
"Long","2020-03-14","0","5","0","0","0","0"
"Long","2020-03-15","0","5","0","0","0","0"
"Long","2020-03-16","1","6","0","0","0","0"
"Long","2020-03-17","1","7","1","1","14.3","7.1"
"Long","2020-03-18","4","11","0","1","14.3","7.1"
"Long","2020-03-19","1","12","0","1","14.3","7.1"
"Long","2020-03-20","0","12","0","1","14.3","7.1"
"Long","2020-03-21","3","15","0","1","14.3","7.1"
"Long","2020-03-22","0","15","0","1","14.3","7.1"
"Long","2020-03-23","1","16","0","1","14.3","7.1"
"Long","2020-03-24","3","19","0","1","0","7.1"
"Long","2020-03-25","12","31","0","1","0","7.1"
"Long","2020-03-26","1","32","0","1","0","7.1"
"Long","2020-03-27","6","38","0","1","0","7.1"
"Long","2020-03-28","0","38","0","1","0","7.1"
"Long","2020-03-29","2","40","0","1","0","7.1"
"Long","2020-03-30","3","43","0","1","0","7.1"
"Long","2020-03-31","0","43","0","1","0","0"
"Long","2020-04-01","2","45","0","1","0","0"
"Long","2020-04-02","2","47","0","1","0","0"
"Long","2020-04-03","6","53","0","1","0","0"
"Long","2020-04-04","7","60","0","1","0","0"
"Long","2020-04-05","0","60","0","1","0","0"
"Long","2020-04-06","9","69","0","1","0","0"
"Long","2020-04-07","6","75","0","1","0","0"
"Long","2020-04-08","9","84","0","1","0","0"
"Long","2020-04-09","2","86","0","1","0","0"
"Long","2020-04-10","2","88","0","1","0","0"
"Long","2020-04-11","0","88","0","1","0","0"
"Long","2020-04-12","2","90","0","1","0","0"
"Long","2020-04-13","4","94","0","1","0","0"
"Long","2020-04-14","5","99","0","1","0","0"
"Long","2020-04-15","0","99","0","1","0","0"
"Long","2020-04-16","5","104","0","1","0","0"
"Long","2020-04-17","4","108","0","1","0","0"
"Long","2020-04-18","1","109","0","1","0","0"
"Long","2020-04-19","2","111","0","1","0","0"
"Long","2020-04-20","3","114","0","1","0","0"
"Long","2020-04-21","10","124","0","1","0","0"
"Long","2020-04-22","5","129","0","1","0","0"
"Long","2020-04-23","6","135","1","2","2.4","1.2"
"Long","2020-04-24","9","144","1","3","4","2"
"Long","2020-04-25","1","145","0","3","4","2"
"Long","2020-04-26","1","146","0","3","4","2"
"Long","2020-04-27","3","149","0","3","4","2"
"Long","2020-04-28","4","153","0","3","4","2"
"Long","2020-04-29","4","157","0","3","4","2"
"Long","2020-04-30","3","160","0","3","1.6","2"
"Long","2020-05-01","21","181","0","3","0","2"
"Long","2020-05-02","2","183","0","3","0","2"
"Long","2020-05-03","2","185","0","3","0","2"
"Long","2020-05-04","19","204","0","3","0","2"
"Long","2020-05-05","12","216","0","3","0","2"
"Long","2020-05-06","7","223","0","3","0","2"
"Long","2020-05-07","118","341","1","4","0.1","0.9"
"Long","2020-05-08","1","342","0","4","0.1","0.1"
"Long","2020-05-09","0","342","0","4","0.1","0.1"
"Long","2020-05-10","1","343","0","4","0.1","0.1"
"Long","2020-05-11","15","358","0","4","0.1","0.1"
"Long","2020-05-12","5","363","0","4","0.1","0.1"
"Long","2020-05-13","5","368","1","5","3","1.5"
"Long","2020-05-14","70","438","6","11","4.1","2.1"
"Long","2020-05-15","3","441","0","11","4.1","2.1"
"Long","2020-05-16","0","441","0","11","4.1","2.1"
"Long","2020-05-17","0","441","0","11","4.1","2.1"
"Long","2020-05-18","6","447","2","13","8.8","4.5"
"Long","2020-05-19","10","457","0","13","8.8","4.5"
"Long","2020-05-20","3","460","0","13","6","4.5"
"Long","2020-05-21","43","503","0","13","4.8","4.4"
"Long","2020-05-22","7","510","0","13","4.8","4.4"
"Long","2020-05-23","1","511","0","13","4.8","4.4"
"Long","2020-05-24","0","511","0","13","4.8","4.4"
"Long","2020-05-25","1","512","0","13","0","4.4"
"Long","2020-05-26","3","515","0","13","0","4.4"
"Long","2020-05-27","3","518","0","13","0","3"
"Long","2020-05-28","110","628","4","17","0.5","2.6"
"Long","2020-05-29","3","631","0","17","0.5","2.6"
"Long","2020-05-30","0","631","0","17","0.5","2.6"
"Long","2020-05-31","0","631","0","17","0.5","2.6"
"Long","2020-06-01","3","634","0","17","0.5","0.3"
"Long","2020-06-02","5","639","0","17","0.5","0.3"
"Long","2020-06-03","7","646","0","17","0.5","0.3"
"Long","2020-06-04","11","657","1","18","1.3","0.9"
"Long","2020-06-05","6","663","0","18","1.3","0.9"
"Long","2020-06-06","1","664","0","18","1.3","0.9"
"Long","2020-06-07","1","665","0","18","1.3","0.9"
"Long","2020-06-08","17","682","2","20","3","1.7"
"Long","2020-06-09","12","694","0","20","3","1.7"
"Long","2020-06-10","8","702","0","20","3","1.7"
"Long","2020-06-11","11","713","0","20","1.7","1.5"
"Long","2020-06-12","9","722","0","20","1.7","1.5"
"Long","2020-06-13","0","722","0","20","1.7","1.5"
"Long","2020-06-14","2","724","0","20","1.7","1.5"
"Long","2020-06-15","12","736","0","20","0","1.5"
"Long","2020-06-16","16","752","2","22","1.8","2.4"
"Long","2020-06-17","6","758","0","22","1.8","2.4"
"Long","2020-06-18","12","770","1","23","3","2.3"
"Long","2020-06-19","13","783","2","25","5.2","3.4"
"Long","2020-06-20","1","784","0","25","5.2","3.4"
"Long","2020-06-21","2","786","2","27","19.5","10.6"
"Long","2020-06-22","17","803","0","27","19.5","9.7"
"Long","2020-06-23","13","816","2","29","19.9","10.8"
"Long","2020-06-24","16","832","2","31","21.7","11.7"
"Long","2020-06-25","21","853","0","31","20.5","11.7"
"Long","2020-06-26","24","877","3","34","20.1","12.6"
"Long","2020-06-27","3","880","0","34","20.1","12.6"
"Long","2020-06-28","2","882","0","34","5.8","12.6"
"Long","2020-06-29","24","906","3","37","7.6","13.5"
"Long","2020-06-30","16","922","0","37","5.4","12.6"
"Long","2020-07-01","32","954","3","40","4.9","13.3"
"Long","2020-07-02","168","1122","15","55","6.2","13.3"
"Long","2020-07-03","8","1130","0","55","4.4","12.2"
"Long","2020-07-04","3","1133","0","55","4.4","12.2"
"Long","2020-07-05","3","1136","0","55","4.4","5.1"
"Long","2020-07-06","115","1251","6","61","3.4","5.5"
"Long","2020-07-07","59","1310","9","70","5.5","5.4"
"Long","2020-07-08","18","1328","2","72","5.8","5.3"
"Long","2020-07-09","35","1363","2","74","5.3","5.8"
"Long","2020-07-10","17","1380","2","76","7","5.7"
"Long","2020-07-11","5","1385","2","78","12.7","8.6"
"Long","2020-07-12","8","1393","1","79","14.5","9.5"
"Long","2020-07-13","29","1422","5","84","16.2","9.8"
"Long","2020-07-14","57","1479","3","87","14.8","10.2"
"Long","2020-07-15","34","1513","3","90","14.5","10.1"
"Long","2020-07-16","45","1558","2","92","14.3","9.8"
"Long","2020-07-17","19","1577","1","93","13.4","10.2"
"Long","2020-07-18","4","1581","0","93","7.6","10.2"
"Long","2020-07-19","8","1589","2","95","9.4","12"
"Long","2020-07-20","93","1682","1","96","7.1","11.7"
"Long","2020-07-21","116","1798","8","104","7.4","11.1"
"Long","2020-07-22","21","1819","3","107","8.1","11.3"
"Long","2020-07-23","54","1873","3","110","8.3","11.3"
"Long","2020-07-24","11","1884","3","113","11.4","12.4"
"Long","2020-07-25","3","1887","0","113","11.4","9.5"
"Long","2020-07-26","8","1895","1","114","9.7","9.5"
"Long","2020-07-27","16","1911","4","118","13.1","10.1"
"Long","2020-07-28","57","1968","3","121","12.8","10.1"
"Long","2020-07-29","10","1978","2","123","13.7","10.9"
"Long","2020-07-30","43","2021","0","123","12.9","10.6"
"Long","2020-07-31","13","2034","1","124","10.1","10.8"
"Long","2020-08-01","7","2041","0","124","10.1","10.8"
"Long","2020-08-02","8","2049","3","127","13.6","11.6"
"Long","2020-08-03","17","2066","1","128","10.9","12"
"Long","2020-08-04","30","2096","2","130","11.1","12"
"Long","2020-08-05","10","2106","1","131","9.7","11.7"
"Long","2020-08-06","80","2186","3","134","10.2","11.5"
"Long","2020-08-07","7","2193","1","135","11.2","10.6"
"Long","2020-08-08","10","2203","5","140","18.3","14.2"
"Long","2020-08-09","3","2206","2","142","22.5","18.1"
"Long","2020-08-10","16","2222","4","146","25.2","18.1"
"Long","2020-08-11","55","2277","4","150","25.3","18.2"
"Long","2020-08-12","17","2294","6","156","28.9","19.3"
"Long","2020-08-13","69","2363","6","162","29.6","19.9"
"Long","2020-08-14","22","2385","2","164","28.9","20"
"Long","2020-08-15","8","2393","4","168","28.9","23.6"
"Long","2020-08-16","1","2394","0","168","19.3","20.9"
"Long","2020-08-17","89","2483","2","170","16.1","20.6"
"Long","2020-08-18","53","2536","6","176","16.7","21"
"Long","2020-08-19","7","2543","4","180","19.8","24.3"
"Long","2020-08-20","47","2590","8","188","21","25.3"
"Long","2020-08-21","9","2599","0","188","19.7","24.3"
"Long","2020-08-22","6","2605","0","188","12.5","20.7"
"Long","2020-08-23","5","2610","0","188","12.5","15.9"
"Long","2020-08-24","12","2622","2","190","14.6","15.3"
"Long","2020-08-25","38","2660","5","195","14.9","15.8"
"Long","2020-08-26","9","2669","2","197","9.9","14.8"
"Long","2020-08-27","126","2795","2","199","7.7","14.3"
"Long","2020-08-28","17","2812","2","201","9.3","14.5"
"Long","2020-08-29","1","2813","0","201","9.3","10.9"
"Long","2020-08-30","6","2819","2","203","14.1","13.3"
"Long","2020-08-31","9","2828","1","204","13.3","14"
"Long","2020-09-01","45","2873","6","210","13.3","14.1"
"Long","2020-09-02","9","2882","0","210","10.2","10"
"Long","2020-09-03","115","2997","6","216","10.7","9.2"
"Long","2020-09-04","13","3010","1","217","10.1","9.7"
"Long","2020-09-05","7","3017","2","219","14.2","11.8"
"Long","2020-09-06","0","3017","0","219","9.4","11.8"
"Long","2020-09-07","5","3022","3","222","16.4","14.9"
"Long","2020-09-08","31","3053","6","228","17.3","15.3"
"Long","2020-09-09","12","3065","2","230","19.6","14.9"
"Long","2020-09-10","131","3196","4","234","19.3","15"
"Long","2020-09-11","11","3207","0","234","18.2","14.2"
"Long","2020-09-12","8","3215","1","235","15.9","15.1"
"Long","2020-09-13","7","3222","3","238","22.1","15.7"
"Long","2020-09-14","17","3239","4","242","16.9","16.6"
"Long","2020-09-15","39","3278","2","244","14.8","16"
"Long","2020-09-16","11","3289","2","246","15","17.3"
"Long","2020-09-17","34","3323","1","247","15","17.2"
"Long","2020-09-18","13","3336","0","247","15","16.6"
"Long","2020-09-19","6","3342","1","248","15.6","15.8"
"Long","2020-09-20","1","3343","0","248","9.5","15.8"
"Long","2020-09-21","14","3357","1","249","7.2","12"
"Long","2020-09-22","51","3408","11","260","9.5","12.2"
"Long","2020-09-23","12","3420","0","260","6.9","11"
"Long","2020-09-24","45","3465","3","263","7.4","11.2"
"Long","2020-09-25","10","3475","0","263","7.4","11.2"
"Long","2020-09-26","2","3477","1","264","12.2","13.9"
"Long","2020-09-27","1","3478","0","264","12.2","10.8"
"Long","2020-09-28","22","3500","0","264","11.2","9.2"
"Long","2020-09-29","48","3548","1","265","8.4","8.9"
"Long","2020-09-30","7","3555","0","265","8.4","7.6"
"Long","2020-10-01","41","3596","2","267","8.1","7.8"
"Long","2020-10-02","9","3605","0","267","8.1","7.8"
"Long","2020-10-03","4","3609","0","267","1","6.6"
"Long","2020-10-04","6","3615","0","267","1","6.6"
"Long","2020-10-05","15","3630","1","268","1.9","6.6"
"Long","2020-10-06","58","3688","3","271","2.4","5.4"
"Long","2020-10-07","9","3697","0","271","2.4","5.4"
"Long","2020-10-08","24","3721","0","271","1.7","4.9"
"Long","2020-10-09","8","3729","0","271","1.7","4.9"
"Long","2020-10-10","5","3734","1","272","4.5","2.8"
"Long","2020-10-11","5","3739","0","272","4.5","2.8"
"Long","2020-10-12","12","3751","0","272","3.6","2.8"
"Long","2020-10-13","25","3776","1","273","3.4","2.9"
"Long","2020-10-14","5","3781","0","273","3.4","2.9"
"Long","2020-10-15","9","3790","0","273","3.4","2.6"
"Long","2020-10-16","13","3803","3","276","6.7","4.2"
"Long","2020-10-17","4","3807","3","279","14.6","9.6"
"Long","2020-10-18","3","3810","0","279","14.6","9.6"
"Long","2020-10-19","15","3825","2","281","16.5","10"
"Long","2020-10-20","32","3857","0","281","15.9","9.7"
"Long","2020-10-21","6","3863","0","281","15.9","9.7"
"Long","2020-10-22","17","3880","1","282","16.8","10.1"
"Long","2020-10-23","13","3893","1","283","14.6","10.6"
"Long","2020-10-24","3","3896","0","283","3.8","9.2"
"Long","2020-10-25","5","3901","0","283","3.8","9.2"
"Long","2020-10-26","3","3904","0","283","1.9","9.2"
"Long","2020-10-27","41","3945","4","287","3.3","9.6"
"Long","2020-10-28","11","3956","2","289","5.9","10.9"
"Long","2020-10-29","5","3961","0","289","5.1","10.9"
"Long","2020-10-30","9","3970","0","289","4","9.3"
"Long","2020-10-31","7","3977","1","290","6","4.9"
"Long","2020-11-01","2","3979","1","291","13.2","8.5"
"Long","2020-11-02","8","3987","0","291","13.2","7.6"
"Long","2020-11-03","18","4005","0","291","11.8","7.6"
"Long","2020-11-04","10","4015","0","291","9.2","7.6"
"Long","2020-11-05","5","4020","1","292","12","8.6"
"Long","2020-11-06","20","4040","0","292","12","8"
"Long","2020-11-07","3","4043","0","292","10","8"
"Long","2020-11-08","2","4045","0","292","2.9","8"
"Long","2020-11-09","15","4060","0","292","2.9","8"
"Long","2020-11-10","31","4091","2","294","3.8","7.8"
"Long","2020-11-11","8","4099","0","294","3.8","6.5"
"Long","2020-11-12","13","4112","4","298","5.3","8.7"
"Long","2020-11-13","11","4123","0","298","5.3","8.7"
"Long","2020-11-14","9","4132","1","299","6.9","8.5"
"Long","2020-11-15","6","4138","3","302","14","8.5"
"Long","2020-11-16","13","4151","1","303","15.1","9"
"Long","2020-11-17","39","4190","2","305","15","9.4"
"Long","2020-11-18","10","4200","0","305","15","9.4"
"Long","2020-11-19","15","4215","0","305","10.6","7.9"
"Long","2020-11-20","12","4227","0","305","10.6","7.9"
"Long","2020-11-21","11","4238","4","309","14.2","10.5"
"Long","2020-11-22","6","4244","0","309","7","10.5"
"Long","2020-11-23","9","4253","0","309","5.9","10.5"
"Long","2020-11-24","42","4295","1","310","5.5","10.2"
"Long","2020-11-25","13","4308","0","310","5.5","10.2"
"Long","2020-11-26","1","4309","0","310","5.5","8"
"Long","2020-11-27","6","4315","0","310","5.5","8"
"Long","2020-11-28","6","4321","2","312","5.1","9.6"
"Long","2020-11-29","17","4338","1","313","5.9","6.5"
"Long","2020-11-30","19","4357","2","315","7.4","6.7"
"Long","2020-12-01","39","4396","5","320","8.9","7.2"
"Long","2020-12-02","11","4407","1","321","10.2","7.9"
"Long","2020-12-03","12","4419","2","323","12.6","9.1"
"Long","2020-12-04","10","4429","0","323","12.6","9.1"
"Long","2020-12-05","8","4437","4","327","15","10.1"
"Long","2020-12-06","1","4438","1","328","28.4","17.2"
"Long","2020-12-07","12","4450","1","329","28.1","17.8"
"Long","2020-12-08","68","4518","5","334","27.3","18.1"
"Long","2020-12-09","20","4538","0","334","26.1","18.1"
"Long","2020-12-10","20","4558","1","335","24.4","18.5"
"Long","2020-12-11","7","4565","2","337","28.5","20.5"
"Long","2020-12-12","7","4572","1","338","23.4","19.2"
"Long","2020-12-13","15","4587","7","345","15.7","22.1"
"Long","2020-12-14","25","4612","6","351","18","23.1"
"Long","2020-12-15","80","4692","11","362","18.9","23.1"
"Long","2020-12-16","27","4719","6","368","22.1","24.1"
"Long","2020-12-17","19","4738","2","370","22.9","23.6"
"Long","2020-12-18","21","4759","8","378","24.2","26.3"
"Long","2020-12-19","12","4771","3","381","25.8","24.6"
"Long","2020-12-20","6","4777","2","383","23.8","19.8"
"Long","2020-12-21","16","4793","3","386","23.1","20.5"
"Long","2020-12-22","97","4890","12","398","22.9","20.9"
"Long","2020-12-23","20","4910","2","400","21.2","21.6"
"Long","2020-12-24","12","4922","2","402","22","22.4"
"Long","2020-12-25","2","4924","1","403","23.7","24"
"Long","2020-12-26","7","4931","0","403","20.2","23"
"Long","2020-12-27","4","4935","1","404","19","21.4"
"Long","2020-12-28","21","4956","2","406","17.7","20.4"
"Long","2020-12-29","102","5058","18","424","18.4","20.7"
"Long","2020-12-30","14","5072","2","426","19","20.1"
"Long","2020-12-31","15","5087","3","429","19.5","20.8"
"Long","2021-01-01","0","5087","0","429","12.4","18"
"Long","2021-01-02","15","5102","2","431","14.3","17.2"
"Long","2021-01-03","7","5109","1","432","12.7","15.8"
"Long","2021-01-04","18","5127","2","434","13","15.3"
"Long","2021-01-05","117","5244","13","447","12","15.2"
"Long","2021-01-06","19","5263","5","452","13.7","16.4"
"Long","2021-01-07","17","5280","6","458","15.9","17.7"
"Long","2021-01-08","20","5300","1","459","16.6","14.5"
"Long","2021-01-09","6","5306","1","460","17.1","15.7"
"Long","2021-01-10","6","5312","1","461","17.5","15.1"
"Long","2021-01-11","14","5326","3","464","18.9","15.9"
"Long","2021-01-12","104","5430","10","474","18.7","15.4"
"Long","2021-01-13","22","5452","7","481","19.5","16.6"
"Long","2021-01-14","26","5478","3","484","16.1","16"
"Long","2021-01-15","27","5505","3","487","17","16.8"
"Long","2021-01-16","9","5514","4","491","20.9","19"
"Long","2021-01-17","6","5520","0","491","18.6","18"
"Long","2021-01-18","22","5542","2","493","16.8","17.9"
"Long","2021-01-19","69","5611","9","502","17.3","18"
"Long","2021-01-20","17","5628","3","505","15.3","17.4"
"Long","2021-01-21","33","5661","9","514","17.5","16.8"
"Long","2021-01-22","23","5684","3","517","17.8","17.4"
"Long","2021-01-23","19","5703","5","522","15.2","18.1"
"Long","2021-01-24","8","5711","2","524","18.8","18.7"
"Long","2021-01-25","25","5736","3","527","19.2","18"
"Long","2021-01-26","88","5824","7","534","18.5","17.9"
"Long","2021-01-27","18","5842","3","537","18.3","16.8"
"Long","2021-01-28","17","5859","1","538","15.3","16.4"
"Long","2021-01-29","29","5888","4","542","15.4","16.6"
"Long","2021-01-30","15","5903","3","545","14.5","14.8"
"Long","2021-01-31","6","5909","0","545","10.9","14.8"
"Long","2021-02-01","19","5928","4","549","12.2","15.7"
"Long","2021-02-02","14","5942","1","550","12.1","15.3"
"Long","2021-02-03","22","5964","3","553","11.6","15"
"Long","2021-02-04","21","5985","3","556","12.8","14.1"
"Long","2021-02-05","14","5999","1","557","11.9","13.6"
"Long","2021-02-06","1","6000","0","557","9","11.8"
"Long","2021-02-07","0","6000","0","557","9","10"
"Long","2021-02-08","0","6000","0","557","6","9.1"
"Lowndes","2020-02-01","0","0","0","0",".","."
"Lowndes","2020-02-02","0","0","0","0",".","."
"Lowndes","2020-02-03","0","0","0","0",".","."
"Lowndes","2020-02-04","0","0","0","0",".","."
"Lowndes","2020-02-05","0","0","0","0",".","."
"Lowndes","2020-02-06","0","0","0","0",".","."
"Lowndes","2020-02-07","0","0","0","0","0","."
"Lowndes","2020-02-08","0","0","0","0","0","."
"Lowndes","2020-02-09","0","0","0","0","0","."
"Lowndes","2020-02-10","0","0","0","0","0","."
"Lowndes","2020-02-11","0","0","0","0","0","."
"Lowndes","2020-02-12","0","0","0","0","0","."
"Lowndes","2020-02-13","0","0","0","0","0","."
"Lowndes","2020-02-14","0","0","0","0","0","0"
"Lowndes","2020-02-15","0","0","0","0","0","0"
"Lowndes","2020-02-16","0","0","0","0","0","0"
"Lowndes","2020-02-17","0","0","0","0","0","0"
"Lowndes","2020-02-18","0","0","0","0","0","0"
"Lowndes","2020-02-19","0","0","0","0","0","0"
"Lowndes","2020-02-20","0","0","0","0","0","0"
"Lowndes","2020-02-21","0","0","0","0","0","0"
"Lowndes","2020-02-22","0","0","0","0","0","0"
"Lowndes","2020-02-23","0","0","0","0","0","0"
"Lowndes","2020-02-24","0","0","0","0","0","0"
"Lowndes","2020-02-25","0","0","0","0","0","0"
"Lowndes","2020-02-26","0","0","0","0","0","0"
"Lowndes","2020-02-27","0","0","0","0","0","0"
"Lowndes","2020-02-28","0","0","0","0","0","0"
"Lowndes","2020-02-29","0","0","0","0","0","0"
"Lowndes","2020-03-01","0","0","0","0","0","0"
"Lowndes","2020-03-02","0","0","0","0","0","0"
"Lowndes","2020-03-03","0","0","0","0","0","0"
"Lowndes","2020-03-04","0","0","0","0","0","0"
"Lowndes","2020-03-05","0","0","0","0","0","0"
"Lowndes","2020-03-06","0","0","0","0","0","0"
"Lowndes","2020-03-07","0","0","0","0","0","0"
"Lowndes","2020-03-08","0","0","0","0","0","0"
"Lowndes","2020-03-09","1","1","1","1","14.3","7.1"
"Lowndes","2020-03-10","0","1","0","1","14.3","7.1"
"Lowndes","2020-03-11","0","1","0","1","14.3","7.1"
"Lowndes","2020-03-12","3","4","0","1","14.3","7.1"
"Lowndes","2020-03-13","3","7","1","2","19","9.5"
"Lowndes","2020-03-14","1","8","0","2","19","9.5"
"Lowndes","2020-03-15","0","8","0","2","19","9.5"
"Lowndes","2020-03-16","2","10","0","2","4.8","9.5"
"Lowndes","2020-03-17","14","24","4","6","8.8","11.6"
"Lowndes","2020-03-18","23","47","2","8","10.1","12.2"
"Lowndes","2020-03-19","15","62","1","9","11","12.7"
"Lowndes","2020-03-20","24","86","3","12","8.1","13.6"
"Lowndes","2020-03-21","7","93","2","14","12.1","15.6"
"Lowndes","2020-03-22","1","94","0","14","12.1","15.6"
"Lowndes","2020-03-23","11","105","0","14","12.1","8.5"
"Lowndes","2020-03-24","23","128","3","17","9.9","9.4"
"Lowndes","2020-03-25","23","151","1","18","9.3","9.7"
"Lowndes","2020-03-26","32","183","1","19","8.8","9.9"
"Lowndes","2020-03-27","21","204","4","23","9.7","8.9"
"Lowndes","2020-03-28","4","208","0","23","5.7","8.9"
"Lowndes","2020-03-29","3","211","0","23","5.7","8.9"
"Lowndes","2020-03-30","52","263","19","42","10.9","11.5"
"Lowndes","2020-03-31","40","303","1","43","9.4","9.6"
"Lowndes","2020-04-01","44","347","8","51","11.3","10.3"
"Lowndes","2020-04-02","36","383","5","56","12.9","10.8"
"Lowndes","2020-04-03","37","420","5","61","12.1","10.9"
"Lowndes","2020-04-04","7","427","1","62","14.1","9.9"
"Lowndes","2020-04-05","7","434","0","62","14.1","9.9"
"Lowndes","2020-04-06","30","464","3","65","10.3","10.6"
"Lowndes","2020-04-07","37","501","5","70","11.9","10.6"
"Lowndes","2020-04-08","38","539","6","76","11.6","11.5"
"Lowndes","2020-04-09","49","588","12","88","13.1","13"
"Lowndes","2020-04-10","33","621","5","93","13.3","12.7"
"Lowndes","2020-04-11","10","631","0","93","11.3","12.7"
"Lowndes","2020-04-12","15","646","6","99","17","15.6"
"Lowndes","2020-04-13","27","673","1","100","16.1","13.2"
"Lowndes","2020-04-14","38","711","7","107","16.8","14.4"
"Lowndes","2020-04-15","50","761","6","113","16.3","13.9"
"Lowndes","2020-04-16","43","804","3","116","13.8","13.4"
"Lowndes","2020-04-17","67","871","11","127","13.9","13.6"
"Lowndes","2020-04-18","36","907","1","128","14.3","12.8"
"Lowndes","2020-04-19","58","965","4","132","9.6","13.3"
"Lowndes","2020-04-20","207","1172","17","149","10.2","13.2"
"Lowndes","2020-04-21","274","1446","18","167","8.6","12.7"
"Lowndes","2020-04-22","136","1582","7","174","7.6","11.9"
"Lowndes","2020-04-23","53","1635","5","179","7.9","10.8"
"Lowndes","2020-04-24","180","1815","4","183","5.9","9.9"
"Lowndes","2020-04-25","19","1834","1","184","6.2","10.3"
"Lowndes","2020-04-26","5","1839","1","185","8.1","8.9"
"Lowndes","2020-04-27","165","2004","4","189","7.3","8.8"
"Lowndes","2020-04-28","106","2110","6","195","7.2","7.9"
"Lowndes","2020-04-29","107","2217","5","200","7.1","7.3"
"Lowndes","2020-04-30","84","2301","5","205","6.6","7.3"
"Lowndes","2020-05-01","96","2397","8","213","7.5","6.7"
"Lowndes","2020-05-02","12","2409","0","213","6.7","6.5"
"Lowndes","2020-05-03","13","2422","2","215","6.1","7.1"
"Lowndes","2020-05-04","107","2529","5","220","6.4","6.8"
"Lowndes","2020-05-05","113","2642","8","228","6.6","6.9"
"Lowndes","2020-05-06","89","2731","8","236","7.2","7.1"
"Lowndes","2020-05-07","88","2819","7","243","7.5","7"
"Lowndes","2020-05-08","77","2896","5","248","7.2","7.3"
"Lowndes","2020-05-09","21","2917","2","250","8.6","7.7"
"Lowndes","2020-05-10","6","2923","0","250","6.4","6.2"
"Lowndes","2020-05-11","270","3193","12","262","6.4","6.4"
"Lowndes","2020-05-12","426","3619","12","274","5.7","6.2"
"Lowndes","2020-05-13","105","3724","2","276","4.7","6"
"Lowndes","2020-05-14","126","3850","15","291","5.3","6.4"
"Lowndes","2020-05-15","104","3954","8","299","5.5","6.3"
"Lowndes","2020-05-16","21","3975","1","300","4.8","6.7"
"Lowndes","2020-05-17","16","3991","2","302","6.6","6.5"
"Lowndes","2020-05-18","176","4167","34","336","8.7","7.5"
"Lowndes","2020-05-19","103","4270","0","336","8.3","7"
"Lowndes","2020-05-20","107","4377","4","340","8.6","6.6"
"Lowndes","2020-05-21","160","4537","5","345","7.3","6.3"
"Lowndes","2020-05-22","136","4673","15","360","7.8","6.6"
"Lowndes","2020-05-23","34","4707","6","366","9.6","7.2"
"Lowndes","2020-05-24","6","4713","1","367","10.2","8.4"
"Lowndes","2020-05-25","23","4736","3","370","9.3","9"
"Lowndes","2020-05-26","131","4867","19","389","11.4","9.8"
"Lowndes","2020-05-27","146","5013","17","406","12.5","10.5"
"Lowndes","2020-05-28","166","5179","9","415","12.9","10.1"
"Lowndes","2020-05-29","162","5341","20","435","13","10.4"
"Lowndes","2020-05-30","63","5404","9","444","12.6","11.1"
"Lowndes","2020-05-31","11","5415","1","445","11.5","10.8"
"Lowndes","2020-06-01","228","5643","29","474","11.4","10.4"
"Lowndes","2020-06-02","205","5848","26","500","11.2","11.3"
"Lowndes","2020-06-03","366","6214","38","538","11","11.8"
"Lowndes","2020-06-04","313","6527","48","586","12.4","12.6"
"Lowndes","2020-06-05","295","6822","28","614","12","12.5"
"Lowndes","2020-06-06","71","6893","8","622","11.6","12.1"
"Lowndes","2020-06-07","27","6920","8","630","14.5","13"
"Lowndes","2020-06-08","317","7237","47","677","14.8","13.1"
"Lowndes","2020-06-09","254","7491","31","708","14.7","13"
"Lowndes","2020-06-10","242","7733","46","754","16","13.5"
"Lowndes","2020-06-11","423","8156","50","804","15.5","13.9"
"Lowndes","2020-06-12","411","8567","51","855","15.9","13.9"
"Lowndes","2020-06-13","71","8638","20","875","18.3","14.9"
"Lowndes","2020-06-14","41","8679","12","887","18.2","16.4"
"Lowndes","2020-06-15","520","9199","76","963","18.2","16.5"
"Lowndes","2020-06-16","500","9699","31","994","17.4","16"
"Lowndes","2020-06-17","392","10091","46","1040","16.3","16.1"
"Lowndes","2020-06-18","426","10517","34","1074","15.8","15.6"
"Lowndes","2020-06-19","394","10911","59","1133","16.1","16"
"Lowndes","2020-06-20","90","11001","17","1150","14.8","16.6"
"Lowndes","2020-06-21","53","11054","14","1164","14.4","16.3"
"Lowndes","2020-06-22","520","11574","63","1227","14","16.1"
"Lowndes","2020-06-23","406","11980","77","1304","15.9","16.6"
"Lowndes","2020-06-24","377","12357","48","1352","16","16.2"
"Lowndes","2020-06-25","402","12759","46","1398","16.5","16.1"
"Lowndes","2020-06-26","510","13269","56","1454","15.9","16"
"Lowndes","2020-06-27","70","13339","12","1466","15.7","15.2"
"Lowndes","2020-06-28","52","13391","13","1479","15.5","14.9"
"Lowndes","2020-06-29","746","14137","163","1642","16.9","15.5"
"Lowndes","2020-06-30","833","14970","201","1843","17.6","16.7"
"Lowndes","2020-07-01","503","15473","75","1918","17.9","17"
"Lowndes","2020-07-02","509","15982","95","2013","19","17.7"
"Lowndes","2020-07-03","181","16163","27","2040","19.5","17.7"
"Lowndes","2020-07-04","105","16268","12","2052","18.7","17.2"
"Lowndes","2020-07-05","25","16293","5","2057","18","16.7"
"Lowndes","2020-07-06","485","16778","144","2201","19.1","18"
"Lowndes","2020-07-07","436","17214","98","2299","18.9","18.2"
"Lowndes","2020-07-08","368","17582","71","2370","19.5","18.7"
"Lowndes","2020-07-09","383","17965","71","2441","19.5","19.2"
"Lowndes","2020-07-10","416","18381","91","2532","20.5","20"
"Lowndes","2020-07-11","94","18475","17","2549","21.4","20.1"
"Lowndes","2020-07-12","33","18508","7","2556","21.6","19.8"
"Lowndes","2020-07-13","333","18841","116","2672","22.3","20.7"
"Lowndes","2020-07-14","475","19316","81","2753","21.6","20.2"
"Lowndes","2020-07-15","458","19774","81","2834","21.3","20.4"
"Lowndes","2020-07-16","388","20162","66","2900","21.1","20.3"
"Lowndes","2020-07-17","413","20575","66","2966","20.3","20.4"
"Lowndes","2020-07-18","108","20683","9","2975","18.9","20.1"
"Lowndes","2020-07-19","38","20721","0","2975","15.8","18.7"
"Lowndes","2020-07-20","551","21272","102","3077","13.5","17.9"
"Lowndes","2020-07-21","554","21826","101","3178","13.7","17.6"
"Lowndes","2020-07-22","614","22440","90","3268","13.2","17.3"
"Lowndes","2020-07-23","740","23180","127","3395","13.3","17.2"
"Lowndes","2020-07-24","529","23709","65","3460","12.7","16.5"
"Lowndes","2020-07-25","144","23853","14","3474","12.9","15.9"
"Lowndes","2020-07-26","51","23904","12","3486","16.3","16.1"
"Lowndes","2020-07-27","718","24622","169","3655","17","15.3"
"Lowndes","2020-07-28","394","25016","55","3710","16.4","15"
"Lowndes","2020-07-29","393","25409","77","3787","17.1","15.2"
"Lowndes","2020-07-30","576","25985","75","3862","16.5","14.9"
"Lowndes","2020-07-31","389","26374","58","3920","16.9","14.8"
"Lowndes","2020-08-01","325","26699","87","4007","19.3","16.1"
"Lowndes","2020-08-02","119","26818","21","4028","18.5","17.4"
"Lowndes","2020-08-03","514","27332","73","4101","17.2","17.1"
"Lowndes","2020-08-04","384","27716","56","4157","17.2","16.8"
"Lowndes","2020-08-05","316","28032","40","4197","16.3","16.7"
"Lowndes","2020-08-06","460","28492","78","4275","16.8","16.7"
"Lowndes","2020-08-07","376","28868","63","4338","17.1","17"
"Lowndes","2020-08-08","98","28966","11","4349","14.9","17.1"
"Lowndes","2020-08-09","128","29094","16","4365","14.1","16.3"
"Lowndes","2020-08-10","526","29620","84","4449","14.4","15.8"
"Lowndes","2020-08-11","443","30063","30","4479","13.3","15.3"
"Lowndes","2020-08-12","354","30417","51","4530","13.5","14.9"
"Lowndes","2020-08-13","319","30736","53","4583","13.5","15.1"
"Lowndes","2020-08-14","286","31022","38","4621","13","15"
"Lowndes","2020-08-15","97","31119","6","4627","12.2","13.6"
"Lowndes","2020-08-16","85","31204","4","4631","11.1","12.6"
"Lowndes","2020-08-17","217","31421","23","4654","10.4","12.4"
"Lowndes","2020-08-18","222","31643","14","4668","10.3","11.8"
"Lowndes","2020-08-19","234","31877","36","4704","10.4","12"
"Lowndes","2020-08-20","346","32223","19","4723","8.9","11.2"
"Lowndes","2020-08-21","309","32532","42","4765","8.9","10.9"
"Lowndes","2020-08-22","87","32619","11","4776","9.8","11"
"Lowndes","2020-08-23","84","32703","2","4778","9.5","10.3"
"Lowndes","2020-08-24","238","32941","24","4802","9.4","9.9"
"Lowndes","2020-08-25","190","33131","19","4821","9.9","10.1"
"Lowndes","2020-08-26","460","33591","15","4836","8.2","9.3"
"Lowndes","2020-08-27","295","33886","28","4864","8.8","8.8"
"Lowndes","2020-08-28","223","34109","19","4883","8.1","8.5"
"Lowndes","2020-08-29","78","34187","8","4891","7.7","8.8"
"Lowndes","2020-08-30","66","34253","5","4896","8.5","9"
"Lowndes","2020-08-31","250","34503","26","4922","8.5","9"
"Lowndes","2020-09-01","237","34740","19","4941","8.2","9.1"
"Lowndes","2020-09-02","502","35242","26","4967","8.5","8.3"
"Lowndes","2020-09-03","238","35480","21","4988","8.4","8.6"
"Lowndes","2020-09-04","284","35764","14","5002","7.9","8"
"Lowndes","2020-09-05","131","35895","9","5011","7.4","7.6"
"Lowndes","2020-09-06","43","35938","6","5017","8.3","8.4"
"Lowndes","2020-09-07","42","35980","9","5026","9.9","9.2"
"Lowndes","2020-09-08","286","36266","32","5058","10.3","9.3"
"Lowndes","2020-09-09","359","36625","34","5092","11","9.7"
"Lowndes","2020-09-10","234","36859","20","5112","10.9","9.7"
"Lowndes","2020-09-11","319","37178","24","5136","11.3","9.6"
"Lowndes","2020-09-12","66","37244","10","5146","12.5","9.9"
"Lowndes","2020-09-13","24","37268","6","5152","14","11.2"
"Lowndes","2020-09-14","276","37544","27","5179","12.4","11.1"
"Lowndes","2020-09-15","247","37791","24","5203","12.2","11.3"
"Lowndes","2020-09-16","260","38051","9","5212","11.3","11.1"
"Lowndes","2020-09-17","202","38253","13","5225","11","11"
"Lowndes","2020-09-18","257","38510","21","5246","11.1","11.2"
"Lowndes","2020-09-19","224","38734","8","5254","9.4","11"
"Lowndes","2020-09-20","84","38818","0","5254","5.9","10"
"Lowndes","2020-09-21","255","39073","24","5278","5.8","9.1"
"Lowndes","2020-09-22","297","39370","4","5282","4.6","8.4"
"Lowndes","2020-09-23","220","39590","17","5299","5.2","8.3"
"Lowndes","2020-09-24","213","39803","16","5315","5.4","8.2"
"Lowndes","2020-09-25","178","39981","17","5332","5.6","8.3"
"Lowndes","2020-09-26","70","40051","7","5339","6.5","8"
"Lowndes","2020-09-27","40","40091","0","5339","6.5","6.2"
"Lowndes","2020-09-28","221","40312","20","5359","6.5","6.1"
"Lowndes","2020-09-29","193","40505","15","5374","7.4","6"
"Lowndes","2020-09-30","209","40714","23","5397","7.8","6.5"
"Lowndes","2020-10-01","269","40983","24","5421","8","6.7"
"Lowndes","2020-10-02","409","41392","21","5442","7.4","6.5"
"Lowndes","2020-10-03","90","41482","9","5451","7.4","7"
"Lowndes","2020-10-04","42","41524","7","5458","9.8","8.1"
"Lowndes","2020-10-05","310","41834","42","5500","10.4","8.4"
"Lowndes","2020-10-06","296","42130","29","5529","10.7","9"
"Lowndes","2020-10-07","456","42586","33","5562","10.2","9"
"Lowndes","2020-10-08","396","42982","38","5600","10.3","9.2"
"Lowndes","2020-10-09","409","43391","19","5619","10.2","8.8"
"Lowndes","2020-10-10","75","43466","12","5631","11.1","9.2"
"Lowndes","2020-10-11","46","43512","9","5640","11.5","10.6"
"Lowndes","2020-10-12","228","43740","29","5669","11.4","10.9"
"Lowndes","2020-10-13","312","44052","56","5725","12.5","11.6"
"Lowndes","2020-10-14","401","44453","42","5767","13","11.6"
"Lowndes","2020-10-15","381","44834","34","5801","12.9","11.6"
"Lowndes","2020-10-16","408","45242","44","5845","13.8","12"
"Lowndes","2020-10-17","137","45379","7","5852","12.2","11.6"
"Lowndes","2020-10-18","52","45431","8","5860","11.6","11.6"
"Lowndes","2020-10-19","398","45829","57","5917","11.8","11.6"
"Lowndes","2020-10-20","273","46102","28","5945","10.8","11.6"
"Lowndes","2020-10-21","220","46322","24","5969","10.8","11.9"
"Lowndes","2020-10-22","186","46508","28","5997","11.7","12.3"
"Lowndes","2020-10-23","346","46854","42","6039","11.9","12.8"
"Lowndes","2020-10-24","81","46935","7","6046","12.4","12.3"
"Lowndes","2020-10-25","41","46976","3","6049","11.2","11.4"
"Lowndes","2020-10-26","239","47215","22","6071","10.5","11.2"
"Lowndes","2020-10-27","257","47472","27","6098","10.5","10.6"
"Lowndes","2020-10-28","222","47694","23","6121","10.5","10.6"
"Lowndes","2020-10-29","190","47884","19","6140","9.7","10.7"
"Lowndes","2020-10-30","231","48115","15","6155","8.9","10.4"
"Lowndes","2020-10-31","183","48298","8","6163","8.3","10.4"
"Lowndes","2020-11-01","87","48385","4","6167","7.9","9.6"
"Lowndes","2020-11-02","167","48552","21","6188","8.4","9.5"
"Lowndes","2020-11-03","206","48758","9","6197","7.5","9"
"Lowndes","2020-11-04","245","49003","18","6215","7.1","8.8"
"Lowndes","2020-11-05","285","49288","13","6228","6.3","8"
"Lowndes","2020-11-06","372","49660","21","6249","6.2","7.6"
"Lowndes","2020-11-07","113","49773","12","6261","7.1","7.7"
"Lowndes","2020-11-08","51","49824","3","6264","7.3","7.6"
"Lowndes","2020-11-09","170","49994","26","6290","7.7","8"
"Lowndes","2020-11-10","150","50144","16","6306","8.6","8.1"
"Lowndes","2020-11-11","257","50401","15","6321","8.4","7.7"
"Lowndes","2020-11-12","370","50771","22","6343","8.6","7.4"
"Lowndes","2020-11-13","244","51015","39","6382","10","8.1"
"Lowndes","2020-11-14","74","51089","11","6393","10.6","8.9"
"Lowndes","2020-11-15","55","51144","9","6402","12.1","9.7"
"Lowndes","2020-11-16","250","51394","34","6436","11.9","9.8"
"Lowndes","2020-11-17","291","51685","22","6458","11.5","10"
"Lowndes","2020-11-18","408","52093","27","6485","11.6","10"
"Lowndes","2020-11-19","299","52392","31","6516","12.2","10.4"
"Lowndes","2020-11-20","257","52649","33","6549","11.7","10.9"
"Lowndes","2020-11-21","64","52713","9","6558","11.6","11.1"
"Lowndes","2020-11-22","91","52804","9","6567","10.7","11.4"
"Lowndes","2020-11-23","394","53198","40","6607","10.2","11.1"
"Lowndes","2020-11-24","310","53508","23","6630","10.2","10.8"
"Lowndes","2020-11-25","395","53903","39","6669","10.7","11.1"
"Lowndes","2020-11-26","86","53989","3","6672","9.7","10.9"
"Lowndes","2020-11-27","116","54105","31","6703","11.7","11.7"
"Lowndes","2020-11-28","57","54162","10","6713","12.2","11.9"
"Lowndes","2020-11-29","45","54207","8","6721","13.3","12"
"Lowndes","2020-11-30","278","54485","57","6778","14.8","12.5"
"Lowndes","2020-12-01","257","54742","46","6824","16.3","13.2"
"Lowndes","2020-12-02","294","55036","35","6859","16.5","13.6"
"Lowndes","2020-12-03","278","55314","27","6886","17.4","13.6"
"Lowndes","2020-12-04","392","55706","48","6934","15.4","13.5"
"Lowndes","2020-12-05","193","55899","5","6939","13.2","12.7"
"Lowndes","2020-12-06","59","55958","11","6950","13.4","13.3"
"Lowndes","2020-12-07","202","56160","21","6971","11.9","13.3"
"Lowndes","2020-12-08","338","56498","30","7001","10.6","13.4"
"Lowndes","2020-12-09","291","56789","20","7021","9.9","13.2"
"Lowndes","2020-12-10","244","57033","27","7048","10.1","13.8"
"Lowndes","2020-12-11","509","57542","31","7079","9.2","12.3"
"Lowndes","2020-12-12","73","57615","17","7096","12.2","12.7"
"Lowndes","2020-12-13","59","57674","14","7110","12.9","13.1"
"Lowndes","2020-12-14","238","57912","41","7151","13.9","12.9"
"Lowndes","2020-12-15","230","58142","35","7186","14.8","12.7"
"Lowndes","2020-12-16","297","58439","37","7223","15.6","12.7"
"Lowndes","2020-12-17","309","58748","26","7249","15.2","12.7"
"Lowndes","2020-12-18","282","59030","46","7295","16.7","12.9"
"Lowndes","2020-12-19","103","59133","12","7307","15","13.6"
"Lowndes","2020-12-20","67","59200","14","7321","14.6","13.7"
"Lowndes","2020-12-21","223","59423","33","7354","14.2","14.1"
"Lowndes","2020-12-22","286","59709","41","7395","14.1","14.5"
"Lowndes","2020-12-23","370","60079","39","7434","13.8","14.7"
"Lowndes","2020-12-24","92","60171","26","7460","16.7","15.9"
"Lowndes","2020-12-25","30","60201","6","7466","17.2","16.9"
"Lowndes","2020-12-26","117","60318","28","7494","19","17"
"Lowndes","2020-12-27","90","60408","32","7526","21.1","17.8"
"Lowndes","2020-12-28","132","60540","28","7554","22","18.1"
"Lowndes","2020-12-29","209","60749","40","7594","22.7","18.4"
"Lowndes","2020-12-30","564","61313","54","7648","22.5","18.2"
"Lowndes","2020-12-31","224","61537","12","7660","19.3","18"
"Lowndes","2021-01-01","30","61567","5","7665","18.8","18"
"Lowndes","2021-01-02","52","61619","14","7679","19.2","19.1"
"Lowndes","2021-01-03","71","61690","13","7692","16.7","18.9"
"Lowndes","2021-01-04","119","61809","30","7722","17.3","19.6"
"Lowndes","2021-01-05","285","62094","47","7769","16.9","19.8"
"Lowndes","2021-01-06","330","62424","40","7809","17.3","19.9"
"Lowndes","2021-01-07","436","62860","50","7859","18.2","18.7"
"Lowndes","2021-01-08","148","63008","33","7892","19","18.9"
"Lowndes","2021-01-09","84","63092","21","7913","18.7","19"
"Lowndes","2021-01-10","73","63165","18","7931","19.6","18.2"
"Lowndes","2021-01-11","189","63354","22","7953","17.7","17.5"
"Lowndes","2021-01-12","385","63739","42","7995","16.9","16.9"
"Lowndes","2021-01-13","231","63970","27","8022","16.8","17.1"
"Lowndes","2021-01-14","409","64379","18","8040","15.8","17"
"Lowndes","2021-01-15","168","64547","23","8063","14.6","16.8"
"Lowndes","2021-01-16","86","64633","18","8081","14","16.3"
"Lowndes","2021-01-17","76","64709","19","8100","14","16.8"
"Lowndes","2021-01-18","132","64841","23","8123","14.9","16.3"
"Lowndes","2021-01-19","266","65107","31","8154","15","15.9"
"Lowndes","2021-01-20","192","65299","23","8177","15","15.9"
"Lowndes","2021-01-21","420","65719","19","8196","15","15.4"
"Lowndes","2021-01-22","201","65920","11","8207","13.9","14.2"
"Lowndes","2021-01-23","171","66091","5","8212","11.3","12.6"
"Lowndes","2021-01-24","75","66166","13","8225","10.2","12.1"
"Lowndes","2021-01-25","167","66333","24","8249","9.8","12.3"
"Lowndes","2021-01-26","197","66530","13","8262","9","12"
"Lowndes","2021-01-27","151","66681","15","8277","8.7","11.9"
"Lowndes","2021-01-28","336","67017","14","8291","8.7","11.9"
"Lowndes","2021-01-29","251","67268","15","8306","8.8","11.3"
"Lowndes","2021-01-30","64","67332","9","8315","10.3","10.8"
"Lowndes","2021-01-31","61","67393","11","8326","10.4","10.3"
"Lowndes","2021-02-01","151","67544","15","8341","9.8","9.8"
"Lowndes","2021-02-02","231","67775","24","8365","10.4","9.7"
"Lowndes","2021-02-03","124","67899","8","8373","9.9","9.3"
"Lowndes","2021-02-04","223","68122","8","8381","9.8","9.2"
"Lowndes","2021-02-05","272","68394","11","8392","9.5","9.1"
"Lowndes","2021-02-06","32","68426","5","8397","9.7","10"
"Lowndes","2021-02-07","37","68463","7","8404","9.9","10.1"
"Lowndes","2021-02-08","0","68463","0","8404","8.4","9.1"
"Lumpkin","2020-02-01","0","0","0","0",".","."
"Lumpkin","2020-02-02","0","0","0","0",".","."
"Lumpkin","2020-02-03","0","0","0","0",".","."
"Lumpkin","2020-02-04","0","0","0","0",".","."
"Lumpkin","2020-02-05","0","0","0","0",".","."
"Lumpkin","2020-02-06","0","0","0","0",".","."
"Lumpkin","2020-02-07","0","0","0","0","0","."
"Lumpkin","2020-02-08","0","0","0","0","0","."
"Lumpkin","2020-02-09","0","0","0","0","0","."
"Lumpkin","2020-02-10","0","0","0","0","0","."
"Lumpkin","2020-02-11","0","0","0","0","0","."
"Lumpkin","2020-02-12","0","0","0","0","0","."
"Lumpkin","2020-02-13","0","0","0","0","0","."
"Lumpkin","2020-02-14","0","0","0","0","0","0"
"Lumpkin","2020-02-15","0","0","0","0","0","0"
"Lumpkin","2020-02-16","0","0","0","0","0","0"
"Lumpkin","2020-02-17","0","0","0","0","0","0"
"Lumpkin","2020-02-18","0","0","0","0","0","0"
"Lumpkin","2020-02-19","0","0","0","0","0","0"
"Lumpkin","2020-02-20","0","0","0","0","0","0"
"Lumpkin","2020-02-21","0","0","0","0","0","0"
"Lumpkin","2020-02-22","0","0","0","0","0","0"
"Lumpkin","2020-02-23","0","0","0","0","0","0"
"Lumpkin","2020-02-24","0","0","0","0","0","0"
"Lumpkin","2020-02-25","0","0","0","0","0","0"
"Lumpkin","2020-02-26","0","0","0","0","0","0"
"Lumpkin","2020-02-27","0","0","0","0","0","0"
"Lumpkin","2020-02-28","0","0","0","0","0","0"
"Lumpkin","2020-02-29","0","0","0","0","0","0"
"Lumpkin","2020-03-01","0","0","0","0","0","0"
"Lumpkin","2020-03-02","0","0","0","0","0","0"
"Lumpkin","2020-03-03","0","0","0","0","0","0"
"Lumpkin","2020-03-04","0","0","0","0","0","0"
"Lumpkin","2020-03-05","0","0","0","0","0","0"
"Lumpkin","2020-03-06","0","0","0","0","0","0"
"Lumpkin","2020-03-07","0","0","0","0","0","0"
"Lumpkin","2020-03-08","0","0","0","0","0","0"
"Lumpkin","2020-03-09","0","0","0","0","0","0"
"Lumpkin","2020-03-10","0","0","0","0","0","0"
"Lumpkin","2020-03-11","0","0","0","0","0","0"
"Lumpkin","2020-03-12","2","2","0","0","0","0"
"Lumpkin","2020-03-13","1","3","0","0","0","0"
"Lumpkin","2020-03-14","2","5","0","0","0","0"
"Lumpkin","2020-03-15","0","5","0","0","0","0"
"Lumpkin","2020-03-16","2","7","0","0","0","0"
"Lumpkin","2020-03-17","5","12","0","0","0","0"
"Lumpkin","2020-03-18","10","22","1","1","1.4","0.7"
"Lumpkin","2020-03-19","8","30","1","2","3.2","1.6"
"Lumpkin","2020-03-20","15","45","0","2","3.2","1.6"
"Lumpkin","2020-03-21","5","50","0","2","3.2","1.6"
"Lumpkin","2020-03-22","8","58","0","2","3.2","1.6"
"Lumpkin","2020-03-23","15","73","0","2","3.2","1.6"
"Lumpkin","2020-03-24","5","78","0","2","3.2","1.6"
"Lumpkin","2020-03-25","8","86","0","2","1.8","1.6"
"Lumpkin","2020-03-26","2","88","0","2","0","1.6"
"Lumpkin","2020-03-27","2","90","0","2","0","1.6"
"Lumpkin","2020-03-28","0","90","0","2","0","1.6"
"Lumpkin","2020-03-29","1","91","0","2","0","1.6"
"Lumpkin","2020-03-30","2","93","0","2","0","1.6"
"Lumpkin","2020-03-31","3","96","0","2","0","1.6"
"Lumpkin","2020-04-01","4","100","0","2","0","0.9"
"Lumpkin","2020-04-02","4","104","0","2","0","0"
"Lumpkin","2020-04-03","2","106","0","2","0","0"
"Lumpkin","2020-04-04","0","106","0","2","0","0"
"Lumpkin","2020-04-05","0","106","0","2","0","0"
"Lumpkin","2020-04-06","5","111","0","2","0","0"
"Lumpkin","2020-04-07","2","113","0","2","0","0"
"Lumpkin","2020-04-08","2","115","0","2","0","0"
"Lumpkin","2020-04-09","0","115","0","2","0","0"
"Lumpkin","2020-04-10","3","118","0","2","0","0"
"Lumpkin","2020-04-11","5","123","0","2","0","0"
"Lumpkin","2020-04-12","0","123","0","2","0","0"
"Lumpkin","2020-04-13","3","126","0","2","0","0"
"Lumpkin","2020-04-14","6","132","0","2","0","0"
"Lumpkin","2020-04-15","3","135","0","2","0","0"
"Lumpkin","2020-04-16","4","139","0","2","0","0"
"Lumpkin","2020-04-17","4","143","1","3","3.6","1.8"
"Lumpkin","2020-04-18","2","145","0","3","3.6","1.8"
"Lumpkin","2020-04-19","1","146","0","3","3.6","1.8"
"Lumpkin","2020-04-20","8","154","0","3","3.6","1.8"
"Lumpkin","2020-04-21","4","158","1","4","7.1","3.6"
"Lumpkin","2020-04-22","8","166","0","4","7.1","3.6"
"Lumpkin","2020-04-23","7","173","0","4","7.1","3.6"
"Lumpkin","2020-04-24","10","183","0","4","3.6","3.6"
"Lumpkin","2020-04-25","12","195","2","6","6","4.8"
"Lumpkin","2020-04-26","4","199","0","6","6","4.8"
"Lumpkin","2020-04-27","4","203","0","6","6","4.8"
"Lumpkin","2020-04-28","12","215","0","6","2.4","4.8"
"Lumpkin","2020-04-29","16","231","0","6","2.4","4.8"
"Lumpkin","2020-04-30","9","240","1","7","4","5.6"
"Lumpkin","2020-05-01","14","254","1","8","5","4.3"
"Lumpkin","2020-05-02","9","263","1","9","4.2","5.1"
"Lumpkin","2020-05-03","6","269","0","9","4.2","5.1"
"Lumpkin","2020-05-04","23","292","1","10","4.8","5.4"
"Lumpkin","2020-05-05","21","313","0","10","4.8","3.6"
"Lumpkin","2020-05-06","16","329","0","10","4.8","3.6"
"Lumpkin","2020-05-07","12","341","0","10","3.2","3.6"
"Lumpkin","2020-05-08","53","394","2","12","2.7","3.9"
"Lumpkin","2020-05-09","11","405","1","13","2.5","3.3"
"Lumpkin","2020-05-10","0","405","0","13","2.5","3.3"
"Lumpkin","2020-05-11","19","424","2","15","3.3","4.1"
"Lumpkin","2020-05-12","20","444","0","15","3.3","4.1"
"Lumpkin","2020-05-13","16","460","0","15","3.3","4.1"
"Lumpkin","2020-05-14","14","474","0","15","3.3","3.3"
"Lumpkin","2020-05-15","46","520","0","15","2.8","2.8"
"Lumpkin","2020-05-16","3","523","0","15","1.5","2"
"Lumpkin","2020-05-17","6","529","1","16","3.9","3.2"
"Lumpkin","2020-05-18","19","548","2","18","3.9","3.6"
"Lumpkin","2020-05-19","18","566","1","19","4.7","4"
"Lumpkin","2020-05-20","18","584","0","19","4.7","4"
"Lumpkin","2020-05-21","40","624","1","20","5","4.2"
"Lumpkin","2020-05-22","14","638","0","20","5","3.9"
"Lumpkin","2020-05-23","4","642","0","20","5","3.3"
"Lumpkin","2020-05-24","1","643","0","20","2.7","3.3"
"Lumpkin","2020-05-25","1","644","0","20","1.2","2.5"
"Lumpkin","2020-05-26","17","661","1","21","1.2","2.9"
"Lumpkin","2020-05-27","27","688","0","21","1.2","2.9"
"Lumpkin","2020-05-28","27","715","0","21","0.8","2.9"
"Lumpkin","2020-05-29","17","732","0","21","0.8","2.9"
"Lumpkin","2020-05-30","9","741","0","21","0.8","2.9"
"Lumpkin","2020-05-31","9","750","0","21","0.8","1.7"
"Lumpkin","2020-06-01","22","772","0","21","0.8","1"
"Lumpkin","2020-06-02","11","783","0","21","0","0.6"
"Lumpkin","2020-06-03","23","806","0","21","0","0.6"
"Lumpkin","2020-06-04","15","821","0","21","0","0.4"
"Lumpkin","2020-06-05","10","831","0","21","0","0.4"
"Lumpkin","2020-06-06","11","842","0","21","0","0.4"
"Lumpkin","2020-06-07","2","844","0","21","0","0.4"
"Lumpkin","2020-06-08","9","853","0","21","0","0.4"
"Lumpkin","2020-06-09","15","868","1","22","1","0.5"
"Lumpkin","2020-06-10","14","882","0","22","1","0.5"
"Lumpkin","2020-06-11","17","899","0","22","1","0.5"
"Lumpkin","2020-06-12","19","918","0","22","1","0.5"
"Lumpkin","2020-06-13","7","925","0","22","1","0.5"
"Lumpkin","2020-06-14","4","929","0","22","1","0.5"
"Lumpkin","2020-06-15","11","940","0","22","1","0.5"
"Lumpkin","2020-06-16","19","959","0","22","0","0.5"
"Lumpkin","2020-06-17","19","978","0","22","0","0.5"
"Lumpkin","2020-06-18","18","996","0","22","0","0.5"
"Lumpkin","2020-06-19","12","1008","1","23","1.2","1.1"
"Lumpkin","2020-06-20","10","1018","0","23","1.2","1.1"
"Lumpkin","2020-06-21","4","1022","0","23","1.2","1.1"
"Lumpkin","2020-06-22","11","1033","0","23","1.2","1.1"
"Lumpkin","2020-06-23","14","1047","0","23","1.2","0.6"
"Lumpkin","2020-06-24","31","1078","1","24","1.7","0.8"
"Lumpkin","2020-06-25","54","1132","2","26","2.2","1.1"
"Lumpkin","2020-06-26","38","1170","1","27","1.4","1.3"
"Lumpkin","2020-06-27","38","1208","1","28","1.7","1.5"
"Lumpkin","2020-06-28","2","1210","0","28","1.7","1.5"
"Lumpkin","2020-06-29","38","1248","2","30","2.5","1.8"
"Lumpkin","2020-06-30","55","1303","4","34","3.5","2.4"
"Lumpkin","2020-07-01","42","1345","5","39","4.8","3.2"
"Lumpkin","2020-07-02","51","1396","1","40","4.5","3.4"
"Lumpkin","2020-07-03","13","1409","1","41","5.2","3.3"
"Lumpkin","2020-07-04","56","1465","1","42","5.1","3.4"
"Lumpkin","2020-07-05","29","1494","1","43","5.6","3.7"
"Lumpkin","2020-07-06","45","1539","7","50","7.1","4.8"
"Lumpkin","2020-07-07","58","1597","10","60","8.5","6"
"Lumpkin","2020-07-08","44","1641","2","62","7.5","6.1"
"Lumpkin","2020-07-09","56","1697","4","66","8.2","6.4"
"Lumpkin","2020-07-10","47","1744","8","74","9.5","7.4"
"Lumpkin","2020-07-11","5","1749","0","74","9.3","7.2"
"Lumpkin","2020-07-12","11","1760","0","74","8.8","7.2"
"Lumpkin","2020-07-13","31","1791","6","80","9.3","8.2"
"Lumpkin","2020-07-14","32","1823","2","82","7.8","8.1"
"Lumpkin","2020-07-15","34","1857","1","83","7.5","7.5"
"Lumpkin","2020-07-16","24","1881","0","83","6.5","7.4"
"Lumpkin","2020-07-17","28","1909","1","84","4.6","7.1"
"Lumpkin","2020-07-18","10","1919","1","85","6","7.6"
"Lumpkin","2020-07-19","13","1932","1","86","7.1","8"
"Lumpkin","2020-07-20","45","1977","5","91","5.9","7.6"
"Lumpkin","2020-07-21","30","2007","0","91","5","6.4"
"Lumpkin","2020-07-22","24","2031","4","95","7","7.3"
"Lumpkin","2020-07-23","33","2064","0","95","7","6.8"
"Lumpkin","2020-07-24","25","2089","0","95","6.5","5.5"
"Lumpkin","2020-07-25","13","2102","5","100","10.6","8.3"
"Lumpkin","2020-07-26","8","2110","0","100","9.5","8.3"
"Lumpkin","2020-07-27","23","2133","2","102","9.1","7.5"
"Lumpkin","2020-07-28","14","2147","1","103","10.1","7.6"
"Lumpkin","2020-07-29","33","2180","1","104","8.2","7.6"
"Lumpkin","2020-07-30","20","2200","2","106","9.6","8.3"
"Lumpkin","2020-07-31","29","2229","0","106","9.6","8.1"
"Lumpkin","2020-08-01","8","2237","0","106","4.1","7.3"
"Lumpkin","2020-08-02","6","2243","0","106","4.1","6.8"
"Lumpkin","2020-08-03","25","2268","1","107","3.5","6.3"
"Lumpkin","2020-08-04","23","2291","2","109","3.7","6.9"
"Lumpkin","2020-08-05","31","2322","7","116","6.5","7.3"
"Lumpkin","2020-08-06","31","2353","1","117","5.5","7.6"
"Lumpkin","2020-08-07","21","2374","3","120","7.5","8.6"
"Lumpkin","2020-08-08","10","2384","5","125","14.7","9.4"
"Lumpkin","2020-08-09","12","2396","0","125","14.7","9.4"
"Lumpkin","2020-08-10","22","2418","1","126","14.8","9.1"
"Lumpkin","2020-08-11","17","2435","2","128","15.2","9.4"
"Lumpkin","2020-08-12","28","2463","2","130","13","9.7"
"Lumpkin","2020-08-13","19","2482","3","133","14.8","10.1"
"Lumpkin","2020-08-14","27","2509","3","136","14.3","10.9"
"Lumpkin","2020-08-15","14","2523","2","138","9.2","12"
"Lumpkin","2020-08-16","10","2533","1","139","10.7","12.7"
"Lumpkin","2020-08-17","20","2553","1","140","10.7","12.7"
"Lumpkin","2020-08-18","20","2573","2","142","10.5","12.8"
"Lumpkin","2020-08-19","24","2597","1","143","10.1","11.5"
"Lumpkin","2020-08-20","18","2615","0","143","7.8","11.3"
"Lumpkin","2020-08-21","26","2641","2","145","7.3","10.8"
"Lumpkin","2020-08-22","11","2652","1","146","6.6","7.9"
"Lumpkin","2020-08-23","5","2657","0","146","5.1","7.9"
"Lumpkin","2020-08-24","23","2680","3","149","6.3","8.5"
"Lumpkin","2020-08-25","22","2702","1","150","5.5","8"
"Lumpkin","2020-08-26","20","2722","2","152","6.3","8.2"
"Lumpkin","2020-08-27","22","2744","3","155","8.3","8"
"Lumpkin","2020-08-28","30","2774","3","158","8.6","8"
"Lumpkin","2020-08-29","12","2786","1","159","8.5","7.5"
"Lumpkin","2020-08-30","5","2791","0","159","8.5","6.8"
"Lumpkin","2020-08-31","28","2819","1","160","7.2","6.7"
"Lumpkin","2020-09-01","33","2852","1","161","6.9","6.2"
"Lumpkin","2020-09-02","25","2877","1","162","6.1","6.2"
"Lumpkin","2020-09-03","23","2900","2","164","5.4","6.8"
"Lumpkin","2020-09-04","25","2925","2","166","5.1","6.9"
"Lumpkin","2020-09-05","8","2933","1","167","5.7","7.1"
"Lumpkin","2020-09-06","3","2936","0","167","5.7","7.1"
"Lumpkin","2020-09-07","5","2941","0","167","5.2","6.2"
"Lumpkin","2020-09-08","31","2972","3","170","6.1","6.5"
"Lumpkin","2020-09-09","32","3004","2","172","6.4","6.3"
"Lumpkin","2020-09-10","25","3029","0","172","5.2","5.3"
"Lumpkin","2020-09-11","39","3068","1","173","4.4","4.8"
"Lumpkin","2020-09-12","8","3076","3","176","8","6.8"
"Lumpkin","2020-09-13","3","3079","0","176","8","6.8"
"Lumpkin","2020-09-14","30","3109","5","181","10.4","7.8"
"Lumpkin","2020-09-15","33","3142","2","183","9.9","8"
"Lumpkin","2020-09-16","41","3183","3","186","10","8.2"
"Lumpkin","2020-09-17","23","3206","1","187","10.6","7.9"
"Lumpkin","2020-09-18","26","3232","2","189","11.4","7.9"
"Lumpkin","2020-09-19","8","3240","2","191","9.6","8.8"
"Lumpkin","2020-09-20","4","3244","0","191","9.6","8.8"
"Lumpkin","2020-09-21","26","3270","1","192","7.8","9.1"
"Lumpkin","2020-09-22","18","3288","1","193","7.7","8.8"
"Lumpkin","2020-09-23","20","3308","0","193","6.6","8.3"
"Lumpkin","2020-09-24","21","3329","0","193","6","8.3"
"Lumpkin","2020-09-25","23","3352","1","194","5.5","8.5"
"Lumpkin","2020-09-26","4","3356","0","194","2","5.8"
"Lumpkin","2020-09-27","2","3358","0","194","2","5.8"
"Lumpkin","2020-09-28","31","3389","0","194","1.4","4.6"
"Lumpkin","2020-09-29","36","3425","0","194","0.6","4.2"
"Lumpkin","2020-09-30","24","3449","2","196","1.8","4.2"
"Lumpkin","2020-10-01","34","3483","3","199","3.1","4.5"
"Lumpkin","2020-10-02","23","3506","1","200","3.1","4.3"
"Lumpkin","2020-10-03","6","3512","0","200","3.1","2.5"
"Lumpkin","2020-10-04","7","3519","0","200","3.1","2.5"
"Lumpkin","2020-10-05","35","3554","1","201","3.5","2.4"
"Lumpkin","2020-10-06","36","3590","1","202","3.9","2.2"
"Lumpkin","2020-10-07","36","3626","2","204","3.5","2.6"
"Lumpkin","2020-10-08","27","3653","3","207","3.8","3.4"
"Lumpkin","2020-10-09","72","3725","1","208","3.4","3.2"
"Lumpkin","2020-10-10","9","3734","0","208","3.4","3.2"
"Lumpkin","2020-10-11","8","3742","0","208","3.4","3.2"
"Lumpkin","2020-10-12","38","3780","5","213","4.9","4.2"
"Lumpkin","2020-10-13","34","3814","1","214","4.9","4.4"
"Lumpkin","2020-10-14","45","3859","3","217","5","4.3"
"Lumpkin","2020-10-15","38","3897","5","222","5.3","4.6"
"Lumpkin","2020-10-16","35","3932","2","224","5.9","4.7"
"Lumpkin","2020-10-17","5","3937","0","224","5.9","4.7"
"Lumpkin","2020-10-18","1","3938","0","224","5.9","4.7"
"Lumpkin","2020-10-19","37","3975","3","227","5.2","5"
"Lumpkin","2020-10-20","37","4012","1","228","5.2","5"
"Lumpkin","2020-10-21","45","4057","1","229","4.6","4.8"
"Lumpkin","2020-10-22","28","4085","4","233","4.7","5"
"Lumpkin","2020-10-23","36","4121","1","234","4.3","5.1"
"Lumpkin","2020-10-24","5","4126","0","234","4.3","5.1"
"Lumpkin","2020-10-25","8","4134","2","236","7.9","6.9"
"Lumpkin","2020-10-26","22","4156","0","236","6.7","6"
"Lumpkin","2020-10-27","28","4184","1","237","6.8","6"
"Lumpkin","2020-10-28","41","4225","1","238","6.9","5.7"
"Lumpkin","2020-10-29","26","4251","1","239","5.4","5"
"Lumpkin","2020-10-30","32","4283","3","242","6.3","5.3"
"Lumpkin","2020-10-31","9","4292","3","245","11.1","7.7"
"Lumpkin","2020-11-01","8","4300","2","247","11.1","9.5"
"Lumpkin","2020-11-02","31","4331","3","250","12.5","9.6"
"Lumpkin","2020-11-03","25","4356","0","250","12","9.4"
"Lumpkin","2020-11-04","43","4399","2","252","12.3","9.6"
"Lumpkin","2020-11-05","32","4431","5","257","14","9.7"
"Lumpkin","2020-11-06","39","4470","3","260","13.7","10"
"Lumpkin","2020-11-07","15","4485","1","261","9.9","10.5"
"Lumpkin","2020-11-08","6","4491","1","262","8.7","9.9"
"Lumpkin","2020-11-09","29","4520","6","268","10.3","11.4"
"Lumpkin","2020-11-10","49","4569","3","271","11.2","11.6"
"Lumpkin","2020-11-11","45","4614","5","276","12.1","12.2"
"Lumpkin","2020-11-12","30","4644","1","277","10.3","12.1"
"Lumpkin","2020-11-13","35","4679","2","279","10","11.9"
"Lumpkin","2020-11-14","13","4692","2","281","11.3","10.6"
"Lumpkin","2020-11-15","11","4703","1","282","10.2","9.5"
"Lumpkin","2020-11-16","34","4737","5","287","9.4","9.8"
"Lumpkin","2020-11-17","48","4785","2","289","9.1","10.1"
"Lumpkin","2020-11-18","51","4836","6","295","9.2","10.6"
"Lumpkin","2020-11-19","56","4892","7","302","10.5","10.4"
"Lumpkin","2020-11-20","51","4943","5","307","11.1","10.6"
"Lumpkin","2020-11-21","11","4954","2","309","11.5","11.4"
"Lumpkin","2020-11-22","5","4959","0","309","10.2","10.2"
"Lumpkin","2020-11-23","36","4995","11","320","12.4","10.9"
"Lumpkin","2020-11-24","27","5022","6","326","15","12"
"Lumpkin","2020-11-25","49","5071","5","331","14.8","12"
"Lumpkin","2020-11-26","3","5074","0","331","13","11.7"
"Lumpkin","2020-11-27","34","5108","2","333","12.4","11.7"
"Lumpkin","2020-11-28","8","5116","2","335","13.4","12.4"
"Lumpkin","2020-11-29","14","5130","2","337","15.4","12.8"
"Lumpkin","2020-11-30","52","5182","14","351","14.9","13.7"
"Lumpkin","2020-12-01","47","5229","4","355","13","14"
"Lumpkin","2020-12-02","34","5263","12","367","16.6","15.7"
"Lumpkin","2020-12-03","54","5317","8","375","18.7","15.8"
"Lumpkin","2020-12-04","42","5359","8","383","20.6","16.5"
"Lumpkin","2020-12-05","11","5370","2","385","19.6","16.5"
"Lumpkin","2020-12-06","12","5382","3","388","21.1","18.3"
"Lumpkin","2020-12-07","38","5420","8","396","20.3","17.6"
"Lumpkin","2020-12-08","62","5482","10","406","21.4","17.2"
"Lumpkin","2020-12-09","46","5528","10","416","19.4","18"
"Lumpkin","2020-12-10","43","5571","4","420","18.6","18.7"
"Lumpkin","2020-12-11","59","5630","8","428","17.9","19.2"
"Lumpkin","2020-12-12","22","5652","4","432","17.9","18.7"
"Lumpkin","2020-12-13","9","5661","0","432","14.3","17.7"
"Lumpkin","2020-12-14","68","5729","16","448","14.6","17.5"
"Lumpkin","2020-12-15","101","5830","6","454","13.2","17.3"
"Lumpkin","2020-12-16","60","5890","6","460","11.5","15.5"
"Lumpkin","2020-12-17","50","5940","10","470","13","15.8"
"Lumpkin","2020-12-18","44","5984","8","478","13.7","15.8"
"Lumpkin","2020-12-19","18","6002","3","481","13.5","15.7"
"Lumpkin","2020-12-20","18","6020","8","489","19.8","17.1"
"Lumpkin","2020-12-21","41","6061","12","501","20.6","17.6"
"Lumpkin","2020-12-22","44","6105","9","510","22.7","17.9"
"Lumpkin","2020-12-23","65","6170","12","522","23.9","17.7"
"Lumpkin","2020-12-24","33","6203","9","531","25","19"
"Lumpkin","2020-12-25","8","6211","3","534","27.7","20.7"
"Lumpkin","2020-12-26","19","6230","5","539","29.1","21.3"
"Lumpkin","2020-12-27","16","6246","2","541","24.5","22.2"
"Lumpkin","2020-12-28","70","6316","19","560","24.2","22.4"
"Lumpkin","2020-12-29","62","6378","20","580","25.9","24.3"
"Lumpkin","2020-12-30","46","6424","13","593","27.3","25.6"
"Lumpkin","2020-12-31","35","6459","5","598","25.5","25.2"
"Lumpkin","2021-01-01","10","6469","5","603","27.3","27.5"
"Lumpkin","2021-01-02","14","6483","6","609","29.6","29.4"
"Lumpkin","2021-01-03","18","6501","4","613","31","27.8"
"Lumpkin","2021-01-04","74","6575","15","628","30","27.1"
"Lumpkin","2021-01-05","59","6634","13","641","28.6","27.2"
"Lumpkin","2021-01-06","64","6698","17","658","28.3","27.8"
"Lumpkin","2021-01-07","79","6777","18","676","29.5","27.5"
"Lumpkin","2021-01-08","46","6823","5","681","23.9","25.6"
"Lumpkin","2021-01-09","24","6847","6","687","21.4","25.5"
"Lumpkin","2021-01-10","17","6864","4","691","21.6","26.3"
"Lumpkin","2021-01-11","48","6912","4","695","19.9","24.9"
"Lumpkin","2021-01-12","66","6978","9","704","18.7","23.6"
"Lumpkin","2021-01-13","63","7041","8","712","16.7","22.5"
"Lumpkin","2021-01-14","90","7131","8","720","14.7","22.1"
"Lumpkin","2021-01-15","51","7182","7","727","15.1","19.5"
"Lumpkin","2021-01-16","23","7205","2","729","12.8","17.1"
"Lumpkin","2021-01-17","12","7217","1","730","10.6","16.1"
"Lumpkin","2021-01-18","43","7260","6","736","11.4","15.6"
"Lumpkin","2021-01-19","77","7337","16","752","12.4","15.6"
"Lumpkin","2021-01-20","60","7397","13","765","13.7","15.2"
"Lumpkin","2021-01-21","67","7464","7","772","13.9","14.3"
"Lumpkin","2021-01-22","67","7531","10","782","14.1","14.6"
"Lumpkin","2021-01-23","17","7548","4","786","16.2","14.5"
"Lumpkin","2021-01-24","10","7558","1","787","16.5","13.5"
"Lumpkin","2021-01-25","31","7589","4","791","16.3","13.9"
"Lumpkin","2021-01-26","51","7640","7","798","15.3","13.9"
"Lumpkin","2021-01-27","52","7692","10","808","15","14.3"
"Lumpkin","2021-01-28","55","7747","4","812","14.5","14.2"
"Lumpkin","2021-01-29","31","7778","4","816","14.2","14.2"
"Lumpkin","2021-01-30","19","7797","2","818","12.4","14.3"
"Lumpkin","2021-01-31","17","7814","4","822","14.3","15.4"
"Lumpkin","2021-02-01","33","7847","4","826","14.2","15.3"
"Lumpkin","2021-02-02","62","7909","5","831","13.4","14.3"
"Lumpkin","2021-02-03","31","7940","1","832","11.1","13"
"Lumpkin","2021-02-04","60","8000","8","840","12","13.2"
"Lumpkin","2021-02-05","52","8052","6","846","11.8","13"
"Lumpkin","2021-02-06","7","8059","1","847","12.3","12.3"
"Lumpkin","2021-02-07","0","8059","0","847","8.9","11.6"
"Lumpkin","2021-02-08","0","8059","0","847","7.2","10.7"
"Macon","2020-02-01","0","0","0","0",".","."
"Macon","2020-02-02","0","0","0","0",".","."
"Macon","2020-02-03","0","0","0","0",".","."
"Macon","2020-02-04","0","0","0","0",".","."
"Macon","2020-02-05","0","0","0","0",".","."
"Macon","2020-02-06","0","0","0","0",".","."
"Macon","2020-02-07","0","0","0","0","0","."
"Macon","2020-02-08","0","0","0","0","0","."
"Macon","2020-02-09","0","0","0","0","0","."
"Macon","2020-02-10","0","0","0","0","0","."
"Macon","2020-02-11","0","0","0","0","0","."
"Macon","2020-02-12","0","0","0","0","0","."
"Macon","2020-02-13","0","0","0","0","0","."
"Macon","2020-02-14","0","0","0","0","0","0"
"Macon","2020-02-15","0","0","0","0","0","0"
"Macon","2020-02-16","0","0","0","0","0","0"
"Macon","2020-02-17","0","0","0","0","0","0"
"Macon","2020-02-18","0","0","0","0","0","0"
"Macon","2020-02-19","0","0","0","0","0","0"
"Macon","2020-02-20","0","0","0","0","0","0"
"Macon","2020-02-21","0","0","0","0","0","0"
"Macon","2020-02-22","0","0","0","0","0","0"
"Macon","2020-02-23","0","0","0","0","0","0"
"Macon","2020-02-24","0","0","0","0","0","0"
"Macon","2020-02-25","0","0","0","0","0","0"
"Macon","2020-02-26","0","0","0","0","0","0"
"Macon","2020-02-27","0","0","0","0","0","0"
"Macon","2020-02-28","0","0","0","0","0","0"
"Macon","2020-02-29","0","0","0","0","0","0"
"Macon","2020-03-01","0","0","0","0","0","0"
"Macon","2020-03-02","0","0","0","0","0","0"
"Macon","2020-03-03","0","0","0","0","0","0"
"Macon","2020-03-04","0","0","0","0","0","0"
"Macon","2020-03-05","0","0","0","0","0","0"
"Macon","2020-03-06","0","0","0","0","0","0"
"Macon","2020-03-07","0","0","0","0","0","0"
"Macon","2020-03-08","0","0","0","0","0","0"
"Macon","2020-03-09","0","0","0","0","0","0"
"Macon","2020-03-10","0","0","0","0","0","0"
"Macon","2020-03-11","0","0","0","0","0","0"
"Macon","2020-03-12","0","0","0","0","0","0"
"Macon","2020-03-13","0","0","0","0","0","0"
"Macon","2020-03-14","0","0","0","0","0","0"
"Macon","2020-03-15","1","1","0","0","0","0"
"Macon","2020-03-16","1","2","0","0","0","0"
"Macon","2020-03-17","0","2","0","0","0","0"
"Macon","2020-03-18","0","2","0","0","0","0"
"Macon","2020-03-19","5","7","0","0","0","0"
"Macon","2020-03-20","1","8","1","1","14.3","7.1"
"Macon","2020-03-21","0","8","0","1","14.3","7.1"
"Macon","2020-03-22","0","8","0","1","14.3","7.1"
"Macon","2020-03-23","3","11","0","1","14.3","7.1"
"Macon","2020-03-24","5","16","0","1","14.3","7.1"
"Macon","2020-03-25","3","19","1","2","19","9.5"
"Macon","2020-03-26","1","20","1","3","33.3","16.7"
"Macon","2020-03-27","5","25","0","3","19","16.7"
"Macon","2020-03-28","1","26","0","3","19","16.7"
"Macon","2020-03-29","0","26","0","3","19","16.7"
"Macon","2020-03-30","0","26","0","3","19","16.7"
"Macon","2020-03-31","5","31","4","7","30.5","22.4"
"Macon","2020-04-01","1","32","0","7","25.7","22.4"
"Macon","2020-04-02","4","36","1","8","15","24.2"
"Macon","2020-04-03","9","45","4","12","21.3","20.2"
"Macon","2020-04-04","0","45","0","12","21.3","20.2"
"Macon","2020-04-05","0","45","0","12","21.3","20.2"
"Macon","2020-04-06","9","54","6","18","30.9","25"
"Macon","2020-04-07","5","59","3","21","28","29.2"
"Macon","2020-04-08","7","66","3","24","34.1","29.9"
"Macon","2020-04-09","6","72","3","27","37.7","26.4"
"Macon","2020-04-10","8","80","2","29","34.9","28.1"
"Macon","2020-04-11","1","81","1","30","49.2","35.3"
"Macon","2020-04-12","0","81","0","30","49.2","35.3"
"Macon","2020-04-13","10","91","3","33","44","37.4"
"Macon","2020-04-14","20","111","7","40","40.4","34.2"
"Macon","2020-04-15","14","125","3","43","37.3","35.7"
"Macon","2020-04-16","12","137","2","45","32.6","35.1"
"Macon","2020-04-17","9","146","4","49","35.4","35.1"
"Macon","2020-04-18","3","149","1","50","25.8","37.5"
"Macon","2020-04-19","2","151","1","51","33","41.1"
"Macon","2020-04-20","29","180","5","56","31.2","37.6"
"Macon","2020-04-21","13","193","2","58","28.4","34.4"
"Macon","2020-04-22","25","218","2","60","26.4","31.9"
"Macon","2020-04-23","12","230","3","63","27.6","30.1"
"Macon","2020-04-24","12","242","0","63","21.3","28.3"
"Macon","2020-04-25","1","243","0","63","16.5","21.2"
"Macon","2020-04-26","2","245","0","63","9.4","21.2"
"Macon","2020-04-27","25","270","6","69","10.3","20.7"
"Macon","2020-04-28","16","286","0","69","8.1","18.2"
"Macon","2020-04-29","15","301","3","72","9.9","18.1"
"Macon","2020-04-30","2","303","0","72","6.3","17"
"Macon","2020-05-01","6","309","1","73","8.7","15"
"Macon","2020-05-02","0","309","0","73","8.7","12.6"
"Macon","2020-05-03","7","316","1","74","10.7","10"
"Macon","2020-05-04","16","332","2","76","9.1","9.7"
"Macon","2020-05-05","18","350","3","79","11.4","9.8"
"Macon","2020-05-06","11","361","0","79","8.6","9.2"
"Macon","2020-05-07","16","377","1","80","9.5","7.9"
"Macon","2020-05-08","2","379","1","81","14.2","11.5"
"Macon","2020-05-09","0","379","0","81","14.2","11.5"
"Macon","2020-05-10","4","383","0","81","12.2","11.5"
"Macon","2020-05-11","6","389","0","81","10.4","9.7"
"Macon","2020-05-12","12","401","0","81","8","9.7"
"Macon","2020-05-13","17","418","2","83","9.7","9.2"
"Macon","2020-05-14","3","421","0","83","8.8","9.2"
"Macon","2020-05-15","4","425","1","84","5.3","9.7"
"Macon","2020-05-16","2","427","0","84","5.3","9.7"
"Macon","2020-05-17","2","429","0","84","5.3","8.7"
"Macon","2020-05-18","11","440","2","86","7.8","9.1"
"Macon","2020-05-19","9","449","2","88","11","9.5"
"Macon","2020-05-20","15","464","1","89","10.3","10"
"Macon","2020-05-21","2","466","1","90","17.4","13.1"
"Macon","2020-05-22","8","474","1","91","15.7","10.5"
"Macon","2020-05-23","2","476","0","91","15.7","10.5"
"Macon","2020-05-24","3","479","0","91","15.7","10.5"
"Macon","2020-05-25","3","482","1","92","17.8","12.8"
"Macon","2020-05-26","20","502","1","93","15.4","13.2"
"Macon","2020-05-27","29","531","0","93","14.4","12.4"
"Macon","2020-05-28","10","541","0","93","7.3","12.4"
"Macon","2020-05-29","7","548","0","93","5.5","10.6"
"Macon","2020-05-30","6","554","2","95","10.2","12.9"
"Macon","2020-05-31","6","560","0","95","10.2","12.9"
"Macon","2020-06-01","11","571","0","95","5.5","11.6"
"Macon","2020-06-02","32","603","1","96","5.2","10.3"
"Macon","2020-06-03","25","628","2","98","6.4","10.4"
"Macon","2020-06-04","12","640","0","98","6.4","6.8"
"Macon","2020-06-05","7","647","0","98","6.4","5.9"
"Macon","2020-06-06","11","658","1","99","2.9","6.6"
"Macon","2020-06-07","3","661","0","99","2.9","6.6"
"Macon","2020-06-08","28","689","2","101","3.9","4.7"
"Macon","2020-06-09","24","713","1","102","4.1","4.6"
"Macon","2020-06-10","19","732","0","102","2.9","4.6"
"Macon","2020-06-11","6","738","0","102","2.9","4.6"
"Macon","2020-06-12","9","747","0","102","2.9","4.6"
"Macon","2020-06-13","0","747","0","102","1.6","2.3"
"Macon","2020-06-14","4","751","0","102","1.6","2.3"
"Macon","2020-06-15","4","755","0","102","0.6","2.3"
"Macon","2020-06-16","22","777","0","102","0","2"
"Macon","2020-06-17","5","782","0","102","0","1.5"
"Macon","2020-06-18","17","799","0","102","0","1.5"
"Macon","2020-06-19","15","814","0","102","0","1.5"
"Macon","2020-06-20","3","817","0","102","0","0.8"
"Macon","2020-06-21","7","824","0","102","0","0.8"
"Macon","2020-06-22","7","831","0","102","0","0.3"
"Macon","2020-06-23","32","863","2","104","0.9","0.4"
"Macon","2020-06-24","9","872","1","105","2.5","1.2"
"Macon","2020-06-25","14","886","2","107","4.5","2.3"
"Macon","2020-06-26","10","896","0","107","4.5","2.3"
"Macon","2020-06-27","10","906","0","107","4.5","2.3"
"Macon","2020-06-28","2","908","0","107","4.5","2.3"
"Macon","2020-06-29","15","923","1","108","5.5","2.7"
"Macon","2020-06-30","15","938","2","110","6.5","3.7"
"Macon","2020-07-01","20","958","3","113","7","4.8"
"Macon","2020-07-02","34","992","7","120","7.9","6.2"
"Macon","2020-07-03","15","1007","4","124","11.8","8.1"
"Macon","2020-07-04","4","1011","0","124","11.8","8.1"
"Macon","2020-07-05","1","1012","0","124","11.8","8.1"
"Macon","2020-07-06","16","1028","5","129","15.3","10.4"
"Macon","2020-07-07","45","1073","3","132","14.3","10.4"
"Macon","2020-07-08","11","1084","0","132","12.2","9.6"
"Macon","2020-07-09","32","1116","0","132","9.2","8.6"
"Macon","2020-07-10","33","1149","2","134","6.3","9"
"Macon","2020-07-11","5","1154","1","135","9.1","10.4"
"Macon","2020-07-12","9","1163","0","135","9.1","10.4"
"Macon","2020-07-13","12","1175","0","135","4.7","10"
"Macon","2020-07-14","28","1203","0","135","3.7","9"
"Macon","2020-07-15","14","1217","1","136","4.7","8.5"
"Macon","2020-07-16","35","1252","2","138","5.6","7.4"
"Macon","2020-07-17","26","1278","5","143","7.4","6.9"
"Macon","2020-07-18","8","1286","0","143","4.6","6.9"
"Macon","2020-07-19","4","1290","1","144","8.2","8.6"
"Macon","2020-07-20","8","1298","0","144","8.2","6.4"
"Macon","2020-07-21","30","1328","2","146","9.1","6.4"
"Macon","2020-07-22","6","1334","1","147","10.5","7.6"
"Macon","2020-07-23","38","1372","4","151","11.2","8.4"
"Macon","2020-07-24","19","1391","0","151","8.4","7.9"
"Macon","2020-07-25","11","1402","2","153","11","7.8"
"Macon","2020-07-26","3","1405","0","153","7.4","7.8"
"Macon","2020-07-27","9","1414","0","153","7.4","7.8"
"Macon","2020-07-28","32","1446","1","154","6.9","8"
"Macon","2020-07-29","5","1451","1","155","7.4","8.9"
"Macon","2020-07-30","34","1485","2","157","6.7","8.9"
"Macon","2020-07-31","5","1490","1","158","9.6","9"
"Macon","2020-08-01","4","1494","0","158","7","9"
"Macon","2020-08-02","1","1495","1","159","21.3","14.4"
"Macon","2020-08-03","6","1501","1","160","23.7","15.6"
"Macon","2020-08-04","29","1530","0","160","23.2","15.1"
"Macon","2020-08-05","10","1540","2","162","23.2","15.3"
"Macon","2020-08-06","32","1572","0","162","22.4","14.6"
"Macon","2020-08-07","12","1584","1","163","20.7","15.2"
"Macon","2020-08-08","1","1585","1","164","35","21"
"Macon","2020-08-09","6","1591","0","164","20.7","21"
"Macon","2020-08-10","12","1603","1","165","19.5","21.6"
"Macon","2020-08-11","35","1638","4","169","21.2","22.2"
"Macon","2020-08-12","4","1642","0","169","18.3","20.8"
"Macon","2020-08-13","27","1669","4","173","20.4","21.4"
"Macon","2020-08-14","12","1681","2","175","21.6","21.2"
"Macon","2020-08-15","7","1688","1","176","9.4","22.2"
"Macon","2020-08-16","3","1691","0","176","9.4","15"
"Macon","2020-08-17","7","1698","0","176","8.2","13.8"
"Macon","2020-08-18","36","1734","3","179","7.7","14.4"
"Macon","2020-08-19","12","1746","3","182","11.3","14.8"
"Macon","2020-08-20","26","1772","3","185","10.8","15.6"
"Macon","2020-08-21","12","1784","1","186","9.6","15.6"
"Macon","2020-08-22","4","1788","0","186","7.6","8.5"
"Macon","2020-08-23","6","1794","0","186","7.6","8.5"
"Macon","2020-08-24","5","1799","0","186","7.6","7.9"
"Macon","2020-08-25","25","1824","1","187","7","7.4"
"Macon","2020-08-26","6","1830","0","187","3.4","7.4"
"Macon","2020-08-27","36","1866","1","188","2.2","6.5"
"Macon","2020-08-28","17","1883","2","190","2.6","6.1"
"Macon","2020-08-29","4","1887","0","190","2.6","5.1"
"Macon","2020-08-30","3","1890","1","191","7.4","7.5"
"Macon","2020-08-31","21","1911","2","193","8.8","8.2"
"Macon","2020-09-01","20","1931","1","194","8.9","7.9"
"Macon","2020-09-02","7","1938","1","195","11","7.2"
"Macon","2020-09-03","34","1972","1","196","11","6.6"
"Macon","2020-09-04","4","1976","0","196","9.3","6"
"Macon","2020-09-05","6","1982","0","196","9.3","6"
"Macon","2020-09-06","7","1989","1","197","6.6","7"
"Macon","2020-09-07","4","1993","2","199","12.4","10.6"
"Macon","2020-09-08","20","2013","4","203","14.5","11.7"
"Macon","2020-09-09","12","2025","2","205","14.8","12.9"
"Macon","2020-09-10","31","2056","1","206","14.9","12.9"
"Macon","2020-09-11","11","2067","1","207","16.2","12.7"
"Macon","2020-09-12","7","2074","0","207","16.2","12.7"
"Macon","2020-09-13","1","2075","0","207","14.1","10.4"
"Macon","2020-09-14","12","2087","1","208","8.2","10.3"
"Macon","2020-09-15","23","2110","0","208","5.3","9.9"
"Macon","2020-09-16","14","2124","2","210","5","9.9"
"Macon","2020-09-17","12","2136","1","211","5.7","10.3"
"Macon","2020-09-18","6","2142","0","211","4.4","10.3"
"Macon","2020-09-19","6","2148","0","211","4.4","10.3"
"Macon","2020-09-20","4","2152","0","211","4.4","9.3"
"Macon","2020-09-21","12","2164","1","212","4.4","6.3"
"Macon","2020-09-22","26","2190","2","214","5.5","5.4"
"Macon","2020-09-23","4","2194","0","214","3.5","4.2"
"Macon","2020-09-24","32","2226","2","216","3.2","4.5"
"Macon","2020-09-25","7","2233","0","216","3.2","3.8"
"Macon","2020-09-26","9","2242","1","217","4.8","4.6"
"Macon","2020-09-27","3","2245","0","217","4.8","4.6"
"Macon","2020-09-28","6","2251","0","217","3.6","4"
"Macon","2020-09-29","16","2267","0","217","2.5","4"
"Macon","2020-09-30","6","2273","1","218","4.9","4.2"
"Macon","2020-10-01","23","2296","0","218","4","3.6"
"Macon","2020-10-02","11","2307","1","219","5.3","4.2"
"Macon","2020-10-03","3","2310","1","220","8.4","6.6"
"Macon","2020-10-04","2","2312","0","220","8.4","6.6"
"Macon","2020-10-05","6","2318","0","220","8.4","6"
"Macon","2020-10-06","7","2325","1","221","10.5","6.5"
"Macon","2020-10-07","18","2343","1","222","8.9","6.9"
"Macon","2020-10-08","18","2361","0","222","8.9","6.4"
"Macon","2020-10-09","10","2371","0","222","7.6","6.4"
"Macon","2020-10-10","5","2376","0","222","2.8","5.6"
"Macon","2020-10-11","3","2379","0","222","2.8","5.6"
"Macon","2020-10-12","10","2389","0","222","2.8","5.6"
"Macon","2020-10-13","15","2404","0","222","0.8","5.6"
"Macon","2020-10-14","6","2410","0","222","0","4.4"
"Macon","2020-10-15","26","2436","3","225","1.6","5.3"
"Macon","2020-10-16","7","2443","2","227","5.7","6.7"
"Macon","2020-10-17","2","2445","0","227","5.7","4.3"
"Macon","2020-10-18","0","2445","0","227","5.7","4.3"
"Macon","2020-10-19","8","2453","1","228","7.5","5.2"
"Macon","2020-10-20","16","2469","2","230","9.3","5"
"Macon","2020-10-21","11","2480","1","231","10.6","5.3"
"Macon","2020-10-22","18","2498","1","232","9.7","5.7"
"Macon","2020-10-23","4","2502","0","232","5.7","5.7"
"Macon","2020-10-24","3","2505","0","232","5.7","5.7"
"Macon","2020-10-25","5","2510","1","233","8.5","7.1"
"Macon","2020-10-26","12","2522","0","233","6.7","7.1"
"Macon","2020-10-27","26","2548","2","235","6","7.7"
"Macon","2020-10-28","6","2554","1","236","7.1","8.9"
"Macon","2020-10-29","30","2584","4","240","8.2","9"
"Macon","2020-10-30","8","2592","0","240","8.2","7"
"Macon","2020-10-31","4","2596","1","241","11.8","8.7"
"Macon","2020-11-01","4","2600","1","242","12.5","10.5"
"Macon","2020-11-02","6","2606","2","244","17.3","12"
"Macon","2020-11-03","21","2627","2","246","17.6","11.8"
"Macon","2020-11-04","7","2634","0","246","15.2","11.2"
"Macon","2020-11-05","14","2648","0","246","13.3","10.8"
"Macon","2020-11-06","6","2654","0","246","13.3","10.8"
"Macon","2020-11-07","2","2656","0","246","9.7","10.8"
"Macon","2020-11-08","1","2657","0","246","6.1","9.3"
"Macon","2020-11-09","11","2668","2","248","4","10.6"
"Macon","2020-11-10","22","2690","0","248","2.6","10.1"
"Macon","2020-11-11","8","2698","0","248","2.6","8.9"
"Macon","2020-11-12","54","2752","4","252","3.7","8.5"
"Macon","2020-11-13","13","2765","1","253","4.8","9"
"Macon","2020-11-14","4","2769","0","253","4.8","7.2"
"Macon","2020-11-15","5","2774","1","254","7.6","6.9"
"Macon","2020-11-16","7","2781","0","254","5","4.5"
"Macon","2020-11-17","6","2787","0","254","5","3.8"
"Macon","2020-11-18","7","2794","2","256","9.1","5.8"
"Macon","2020-11-19","33","2827","4","260","9.8","6.7"
"Macon","2020-11-20","6","2833","0","260","8.7","6.7"
"Macon","2020-11-21","2","2835","0","260","8.7","6.7"
"Macon","2020-11-22","3","2838","0","260","5.8","6.7"
"Macon","2020-11-23","10","2848","3","263","10.1","7.6"
"Macon","2020-11-24","27","2875","5","268","12.7","8.9"
"Macon","2020-11-25","4","2879","1","269","12.2","10.7"
"Macon","2020-11-26","8","2887","0","269","10.5","10.1"
"Macon","2020-11-27","7","2894","1","270","12.5","10.6"
"Macon","2020-11-28","5","2899","1","271","15.4","12"
"Macon","2020-11-29","6","2905","0","271","15.4","10.6"
"Macon","2020-11-30","11","2916","0","271","11.1","10.6"
"Macon","2020-12-01","11","2927","3","274","12.4","12.6"
"Macon","2020-12-02","7","2934","2","276","12.9","12.6"
"Macon","2020-12-03","24","2958","5","281","15.9","13.2"
"Macon","2020-12-04","5","2963","0","281","13.8","13.2"
"Macon","2020-12-05","11","2974","4","285","16.1","15.8"
"Macon","2020-12-06","6","2980","1","286","18.5","17"
"Macon","2020-12-07","8","2988","1","287","20.3","15.7"
"Macon","2020-12-08","16","3004","6","293","21.8","17.1"
"Macon","2020-12-09","15","3019","2","295","19.6","16.2"
"Macon","2020-12-10","38","3057","1","296","17","16.4"
"Macon","2020-12-11","11","3068","0","296","17","15.4"
"Macon","2020-12-12","5","3073","1","297","14.7","15.4"
"Macon","2020-12-13","4","3077","1","298","15.9","17.2"
"Macon","2020-12-14","13","3090","2","300","16.3","18.3"
"Macon","2020-12-15","10","3100","0","300","10.9","16.3"
"Macon","2020-12-16","8","3108","2","302","12.6","16.1"
"Macon","2020-12-17","45","3153","3","305","13.2","15.1"
"Macon","2020-12-18","14","3167","1","306","14.2","15.6"
"Macon","2020-12-19","8","3175","3","309","16.7","15.7"
"Macon","2020-12-20","7","3182","2","311","17.2","16.5"
"Macon","2020-12-21","12","3194","2","313","17.4","16.8"
"Macon","2020-12-22","11","3205","4","317","22.6","16.7"
"Macon","2020-12-23","8","3213","2","319","22.6","17.6"
"Macon","2020-12-24","10","3223","1","320","23","18.1"
"Macon","2020-12-25","2","3225","0","320","22","18.1"
"Macon","2020-12-26","10","3235","7","327","26.7","21.7"
"Macon","2020-12-27","7","3242","3","330","28.7","22.9"
"Macon","2020-12-28","29","3271","7","337","29.8","23.6"
"Macon","2020-12-29","19","3290","10","347","32.1","27.3"
"Macon","2020-12-30","31","3321","9","356","32.7","27.6"
"Macon","2020-12-31","20","3341","6","362","35.5","29.3"
"Macon","2021-01-01","2","3343","1","363","42.7","32.3"
"Macon","2021-01-02","6","3349","3","366","39.8","33.2"
"Macon","2021-01-03","14","3363","5","371","38.8","33.7"
"Macon","2021-01-04","32","3395","11","382","40.3","35"
"Macon","2021-01-05","33","3428","8","390","36.2","34.1"
"Macon","2021-01-06","25","3453","4","394","34.3","33.5"
"Macon","2021-01-07","53","3506","6","400","31.7","33.6"
"Macon","2021-01-08","76","3582","2","402","24.9","33.8"
"Macon","2021-01-09","20","3602","4","406","20.6","30.2"
"Macon","2021-01-10","8","3610","2","408","19.1","28.9"
"Macon","2021-01-11","22","3632","5","413","17.4","28.8"
"Macon","2021-01-12","21","3653","5","418","17.4","26.8"
"Macon","2021-01-13","25","3678","5","423","17.9","26.1"
"Macon","2021-01-14","40","3718","2","425","17","24.3"
"Macon","2021-01-15","19","3737","4","429","19.7","22.3"
"Macon","2021-01-16","12","3749","2","431","19.2","19.9"
"Macon","2021-01-17","11","3760","4","435","20.8","19.9"
"Macon","2021-01-18","19","3779","5","440","21.3","19.4"
"Macon","2021-01-19","19","3798","4","444","20.9","19.1"
"Macon","2021-01-20","26","3824","7","451","21.9","19.9"
"Macon","2021-01-21","38","3862","7","458","23.8","20.4"
"Macon","2021-01-22","9","3871","5","463","28.8","24.2"
"Macon","2021-01-23","7","3878","3","466","32.5","25.8"
"Macon","2021-01-24","7","3885","4","470","35.5","28.1"
"Macon","2021-01-25","109","3994","3","473","32.1","26.7"
"Macon","2021-01-26","17","4011","3","476","31.6","26.3"
"Macon","2021-01-27","25","4036","6","482","31.2","26.6"
"Macon","2021-01-28","22","4058","4","486","31.2","27.5"
"Macon","2021-01-29","10","4068","2","488","26.1","27.4"
"Macon","2021-01-30","10","4078","3","491","24.2","28.4"
"Macon","2021-01-31","2","4080","0","491","16.1","25.8"
"Macon","2021-02-01","15","4095","3","494","18.5","25.3"
"Macon","2021-02-02","16","4111","4","498","19.6","25.6"
"Macon","2021-02-03","13","4124","2","500","18.4","24.8"
"Macon","2021-02-04","26","4150","6","506","19.1","25.1"
"Macon","2021-02-05","3","4153","0","506","16.2","21.1"
"Macon","2021-02-06","2","4155","0","506","11.9","18.1"
"Macon","2021-02-07","3","4158","1","507","16.7","16.4"
"Macon","2021-02-08","0","4158","0","507","13.8","16.2"
"Madison","2020-02-01","0","0","0","0",".","."
"Madison","2020-02-02","0","0","0","0",".","."
"Madison","2020-02-03","0","0","0","0",".","."
"Madison","2020-02-04","0","0","0","0",".","."
"Madison","2020-02-05","0","0","0","0",".","."
"Madison","2020-02-06","0","0","0","0",".","."
"Madison","2020-02-07","0","0","0","0","0","."
"Madison","2020-02-08","0","0","0","0","0","."
"Madison","2020-02-09","0","0","0","0","0","."
"Madison","2020-02-10","0","0","0","0","0","."
"Madison","2020-02-11","0","0","0","0","0","."
"Madison","2020-02-12","0","0","0","0","0","."
"Madison","2020-02-13","0","0","0","0","0","."
"Madison","2020-02-14","0","0","0","0","0","0"
"Madison","2020-02-15","0","0","0","0","0","0"
"Madison","2020-02-16","0","0","0","0","0","0"
"Madison","2020-02-17","0","0","0","0","0","0"
"Madison","2020-02-18","0","0","0","0","0","0"
"Madison","2020-02-19","0","0","0","0","0","0"
"Madison","2020-02-20","0","0","0","0","0","0"
"Madison","2020-02-21","0","0","0","0","0","0"
"Madison","2020-02-22","0","0","0","0","0","0"
"Madison","2020-02-23","0","0","0","0","0","0"
"Madison","2020-02-24","0","0","0","0","0","0"
"Madison","2020-02-25","0","0","0","0","0","0"
"Madison","2020-02-26","0","0","0","0","0","0"
"Madison","2020-02-27","0","0","0","0","0","0"
"Madison","2020-02-28","0","0","0","0","0","0"
"Madison","2020-02-29","0","0","0","0","0","0"
"Madison","2020-03-01","0","0","0","0","0","0"
"Madison","2020-03-02","0","0","0","0","0","0"
"Madison","2020-03-03","0","0","0","0","0","0"
"Madison","2020-03-04","0","0","0","0","0","0"
"Madison","2020-03-05","0","0","0","0","0","0"
"Madison","2020-03-06","0","0","0","0","0","0"
"Madison","2020-03-07","0","0","0","0","0","0"
"Madison","2020-03-08","0","0","0","0","0","0"
"Madison","2020-03-09","0","0","0","0","0","0"
"Madison","2020-03-10","0","0","0","0","0","0"
"Madison","2020-03-11","0","0","0","0","0","0"
"Madison","2020-03-12","0","0","0","0","0","0"
"Madison","2020-03-13","0","0","0","0","0","0"
"Madison","2020-03-14","1","1","0","0","0","0"
"Madison","2020-03-15","1","2","0","0","0","0"
"Madison","2020-03-16","1","3","0","0","0","0"
"Madison","2020-03-17","3","6","0","0","0","0"
"Madison","2020-03-18","11","17","1","1","1.3","0.6"
"Madison","2020-03-19","3","20","0","1","1.3","0.6"
"Madison","2020-03-20","3","23","0","1","1.3","0.6"
"Madison","2020-03-21","2","25","0","1","1.3","0.6"
"Madison","2020-03-22","2","27","1","2","8.4","4.2"
"Madison","2020-03-23","5","32","1","3","11.3","5.6"
"Madison","2020-03-24","20","52","1","4","12","6"
"Madison","2020-03-25","8","60","2","6","14.3","7.8"
"Madison","2020-03-26","13","73","2","8","16.5","8.9"
"Madison","2020-03-27","11","84","2","10","19.1","10.2"
"Madison","2020-03-28","3","87","0","10","19.1","10.2"
"Madison","2020-03-29","2","89","0","10","11.9","10.2"
"Madison","2020-03-30","12","101","1","11","10.3","10.8"
"Madison","2020-03-31","7","108","0","11","9.6","10.8"
"Madison","2020-04-01","10","118","0","11","6","10.1"
"Madison","2020-04-02","4","122","1","12","7.4","11.9"
"Madison","2020-04-03","4","126","0","12","4.8","11.9"
"Madison","2020-04-04","3","129","0","12","4.8","11.9"
"Madison","2020-04-05","0","129","0","12","4.8","8.3"
"Madison","2020-04-06","6","135","1","13","6","8.1"
"Madison","2020-04-07","0","135","0","13","6","7.8"
"Madison","2020-04-08","8","143","2","15","9.5","7.8"
"Madison","2020-04-09","2","145","0","15","6","6.7"
"Madison","2020-04-10","7","152","0","15","6","5.4"
"Madison","2020-04-11","1","153","0","15","6","5.4"
"Madison","2020-04-12","0","153","0","15","6","5.4"
"Madison","2020-04-13","13","166","0","15","3.6","4.8"
"Madison","2020-04-14","7","173","0","15","3.6","4.8"
"Madison","2020-04-15","8","181","1","16","1.8","5.7"
"Madison","2020-04-16","7","188","0","16","1.8","3.9"
"Madison","2020-04-17","5","193","0","16","1.8","3.9"
"Madison","2020-04-18","2","195","0","16","1.8","3.9"
"Madison","2020-04-19","4","199","1","17","5.4","5.7"
"Madison","2020-04-20","13","212","2","19","7.6","5.6"
"Madison","2020-04-21","5","217","0","19","7.6","5.6"
"Madison","2020-04-22","8","225","1","20","7.6","4.7"
"Madison","2020-04-23","8","233","0","20","7.6","4.7"
"Madison","2020-04-24","15","248","1","21","8.5","5.1"
"Madison","2020-04-25","6","254","0","21","8.5","5.1"
"Madison","2020-04-26","2","256","0","21","4.9","5.1"
"Madison","2020-04-27","4","260","0","21","2.7","5.1"
"Madison","2020-04-28","11","271","0","21","2.7","5.1"
"Madison","2020-04-29","15","286","0","21","1","4.3"
"Madison","2020-04-30","15","301","0","21","1","4.3"
"Madison","2020-05-01","15","316","1","22","1","4.7"
"Madison","2020-05-02","7","323","0","22","1","4.7"
"Madison","2020-05-03","11","334","0","22","1","2.9"
"Madison","2020-05-04","12","346","1","23","2.1","2.4"
"Madison","2020-05-05","14","360","1","24","3.2","3"
"Madison","2020-05-06","14","374","0","24","3.2","2.1"
"Madison","2020-05-07","10","384","1","25","4.6","2.8"
"Madison","2020-05-08","8","392","0","25","3.6","2.3"
"Madison","2020-05-09","4","396","1","26","7.2","4.1"
"Madison","2020-05-10","2","398","0","26","7.2","4.1"
"Madison","2020-05-11","11","409","0","26","6","4.1"
"Madison","2020-05-12","11","420","1","27","6.3","4.7"
"Madison","2020-05-13","11","431","0","27","6.3","4.7"
"Madison","2020-05-14","18","449","1","28","5.7","5.1"
"Madison","2020-05-15","27","476","0","28","5.7","4.7"
"Madison","2020-05-16","9","485","0","28","2.1","4.7"
"Madison","2020-05-17","8","493","1","29","3.9","5.5"
"Madison","2020-05-18","22","515","0","29","3.9","4.9"
"Madison","2020-05-19","13","528","0","29","2.6","4.4"
"Madison","2020-05-20","16","544","1","30","3.5","4.9"
"Madison","2020-05-21","18","562","1","31","3.5","4.6"
"Madison","2020-05-22","23","585","2","33","4.7","5.2"
"Madison","2020-05-23","8","593","2","35","8.3","5.2"
"Madison","2020-05-24","7","600","0","35","6.5","5.2"
"Madison","2020-05-25","12","612","3","38","10.1","7"
"Madison","2020-05-26","30","642","1","39","10.5","6.6"
"Madison","2020-05-27","20","662","2","41","11.1","7.3"
"Madison","2020-05-28","15","677","0","41","10.3","6.9"
"Madison","2020-05-29","22","699","0","41","9","6.9"
"Madison","2020-05-30","11","710","0","41","5.5","6.9"
"Madison","2020-05-31","13","723","3","44","8.8","7.6"
"Madison","2020-06-01","37","760","2","46","6","8"
"Madison","2020-06-02","37","797","0","46","5.5","8"
"Madison","2020-06-03","26","823","0","46","4.1","7.6"
"Madison","2020-06-04","23","846","0","46","4.1","7.2"
"Madison","2020-06-05","29","875","0","46","4.1","6.6"
"Madison","2020-06-06","11","886","0","46","4.1","4.8"
"Madison","2020-06-07","16","902","0","46","0.8","4.8"
"Madison","2020-06-08","19","921","0","46","0","3"
"Madison","2020-06-09","18","939","2","48","1.6","3.5"
"Madison","2020-06-10","30","969","0","48","1.6","2.8"
"Madison","2020-06-11","16","985","1","49","2.5","3.3"
"Madison","2020-06-12","27","1012","2","51","3.5","3.8"
"Madison","2020-06-13","17","1029","0","51","3.5","3.8"
"Madison","2020-06-14","9","1038","0","51","3.5","2.2"
"Madison","2020-06-15","19","1057","1","52","4.3","2.1"
"Madison","2020-06-16","26","1083","0","52","2.7","2.1"
"Madison","2020-06-17","32","1115","0","52","2.7","2.1"
"Madison","2020-06-18","26","1141","2","54","2.9","2.7"
"Madison","2020-06-19","20","1161","1","55","2.6","3.1"
"Madison","2020-06-20","9","1170","1","56","4.2","3.8"
"Madison","2020-06-21","11","1181","0","56","4.2","3.8"
"Madison","2020-06-22","34","1215","1","57","3.8","4.1"
"Madison","2020-06-23","27","1242","1","58","4.3","3.5"
"Madison","2020-06-24","29","1271","4","62","6.3","4.5"
"Madison","2020-06-25","40","1311","1","63","5.6","4.2"
"Madison","2020-06-26","47","1358","10","73","7.9","5.2"
"Madison","2020-06-27","5","1363","1","74","9.2","6.7"
"Madison","2020-06-28","18","1381","5","79","13.1","8.6"
"Madison","2020-06-29","42","1423","1","80","13.1","8.4"
"Madison","2020-06-30","47","1470","5","85","14.1","9.2"
"Madison","2020-07-01","33","1503","8","93","15.5","10.9"
"Madison","2020-07-02","33","1536","6","99","17.8","11.7"
"Madison","2020-07-03","23","1559","2","101","16","11.9"
"Madison","2020-07-04","7","1566","2","103","17.2","13.2"
"Madison","2020-07-05","18","1584","3","106","15.6","14.4"
"Madison","2020-07-06","60","1644","8","114","17.2","15.1"
"Madison","2020-07-07","56","1700","11","125","18.5","16.3"
"Madison","2020-07-08","38","1738","5","130","16.9","16.2"
"Madison","2020-07-09","53","1791","9","139","16.7","17.3"
"Madison","2020-07-10","55","1846","5","144","16.8","16.4"
"Madison","2020-07-11","13","1859","5","149","18.2","17.7"
"Madison","2020-07-12","17","1876","4","153","19.2","17.4"
"Madison","2020-07-13","50","1926","7","160","19.3","18.2"
"Madison","2020-07-14","51","1977","10","170","19.3","18.9"
"Madison","2020-07-15","57","2034","9","179","19.6","18.3"
"Madison","2020-07-16","39","2073","7","186","19.8","18.2"
"Madison","2020-07-17","27","2100","4","190","20.6","18.7"
"Madison","2020-07-18","8","2108","4","194","22.2","20.2"
"Madison","2020-07-19","27","2135","5","199","21.5","20.3"
"Madison","2020-07-20","49","2184","10","209","22.4","20.9"
"Madison","2020-07-21","39","2223","8","217","22.6","20.9"
"Madison","2020-07-22","65","2288","10","227","22.5","21.1"
"Madison","2020-07-23","34","2322","6","233","22.5","21.1"
"Madison","2020-07-24","27","2349","6","239","23.5","22.1"
"Madison","2020-07-25","26","2375","6","245","19.7","21"
"Madison","2020-07-26","9","2384","2","247","20.2","20.9"
"Madison","2020-07-27","50","2434","13","260","21","21.7"
"Madison","2020-07-28","56","2490","12","272","21.1","21.9"
"Madison","2020-07-29","35","2525","9","281","22.6","22.6"
"Madison","2020-07-30","42","2567","5","286","21.8","22.1"
"Madison","2020-07-31","41","2608","6","292","20.7","22.1"
"Madison","2020-08-01","16","2624","3","295","20.1","19.9"
"Madison","2020-08-02","13","2637","1","296","18","19.1"
"Madison","2020-08-03","46","2683","4","300","15.5","18.3"
"Madison","2020-08-04","55","2738","8","308","14.6","17.9"
"Madison","2020-08-05","36","2774","8","316","14.1","18.3"
"Madison","2020-08-06","25","2799","2","318","13.5","17.7"
"Madison","2020-08-07","41","2840","5","323","13.2","16.9"
"Madison","2020-08-08","19","2859","2","325","12","16"
"Madison","2020-08-09","17","2876","2","327","12.6","15.3"
"Madison","2020-08-10","46","2922","7","334","13.5","14.5"
"Madison","2020-08-11","31","2953","2","336","12.3","13.5"
"Madison","2020-08-12","26","2979","3","339","10.8","12.4"
"Madison","2020-08-13","31","3010","3","342","11.1","12.3"
"Madison","2020-08-14","31","3041","7","349","12.5","12.8"
"Madison","2020-08-15","13","3054","0","349","11","11.5"
"Madison","2020-08-16","17","3071","3","352","11.9","12.2"
"Madison","2020-08-17","41","3112","6","358","11.8","12.6"
"Madison","2020-08-18","39","3151","4","362","12.3","12.3"
"Madison","2020-08-19","49","3200","6","368","12.4","11.6"
"Madison","2020-08-20","36","3236","8","376","14.2","12.6"
"Madison","2020-08-21","36","3272","1","377","11.4","12"
"Madison","2020-08-22","16","3288","2","379","13.2","12.1"
"Madison","2020-08-23","16","3304","0","379","10.7","11.3"
"Madison","2020-08-24","55","3359","4","383","9.6","10.7"
"Madison","2020-08-25","46","3405","5","388","9.7","11"
"Madison","2020-08-26","44","3449","6","394","9.9","11.2"
"Madison","2020-08-27","48","3497","4","398","7.9","11.1"
"Madison","2020-08-28","56","3553","1","399","7.8","9.6"
"Madison","2020-08-29","25","3578","2","401","7.1","10.2"
"Madison","2020-08-30","13","3591","0","401","7.1","8.9"
"Madison","2020-08-31","54","3645","5","406","7.4","8.5"
"Madison","2020-09-01","79","3724","6","412","6.9","8.3"
"Madison","2020-09-02","67","3791","7","419","6.5","8.2"
"Madison","2020-09-03","57","3848","7","426","7.1","7.5"
"Madison","2020-09-04","61","3909","9","435","8.9","8.3"
"Madison","2020-09-05","22","3931","1","436","8.4","7.8"
"Madison","2020-09-06","15","3946","3","439","11.3","9.2"
"Madison","2020-09-07","24","3970","2","441","11.1","9.3"
"Madison","2020-09-08","63","4033","10","451","12.3","9.6"
"Madison","2020-09-09","64","4097","7","458","12.4","9.4"
"Madison","2020-09-10","44","4141","4","462","11.9","9.5"
"Madison","2020-09-11","53","4194","3","465","10.6","9.8"
"Madison","2020-09-12","22","4216","4","469","12.6","10.5"
"Madison","2020-09-13","15","4231","3","472","12.6","11.9"
"Madison","2020-09-14","48","4279","4","476","12.6","11.9"
"Madison","2020-09-15","61","4340","7","483","12","12.1"
"Madison","2020-09-16","49","4389","5","488","11.8","12.1"
"Madison","2020-09-17","111","4500","11","499","12","11.9"
"Madison","2020-09-18","41","4541","3","502","12.2","11.4"
"Madison","2020-09-19","26","4567","2","504","10.7","11.6"
"Madison","2020-09-20","11","4578","0","504","7.8","10.2"
"Madison","2020-09-21","37","4615","1","505","7","9.8"
"Madison","2020-09-22","56","4671","3","508","6.2","9.1"
"Madison","2020-09-23","34","4705","2","510","5.6","8.7"
"Madison","2020-09-24","43","4748","2","512","4.8","8.4"
"Madison","2020-09-25","39","4787","4","516","5.2","8.7"
"Madison","2020-09-26","38","4825","3","519","5.2","8"
"Madison","2020-09-27","13","4838","2","521","7.4","7.6"
"Madison","2020-09-28","51","4889","2","523","7.6","7.3"
"Madison","2020-09-29","71","4960","0","523","6.9","6.5"
"Madison","2020-09-30","66","5026","2","525","6.4","6"
"Madison","2020-10-01","104","5130","1","526","5.9","5.4"
"Madison","2020-10-02","39","5169","2","528","5.2","5.2"
"Madison","2020-10-03","26","5195","2","530","5.2","5.2"
"Madison","2020-10-04","22","5217","1","531","3.6","5.5"
"Madison","2020-10-05","35","5252","1","532","3.5","5.5"
"Madison","2020-10-06","48","5300","2","534","4.1","5.5"
"Madison","2020-10-07","55","5355","4","538","4.7","5.6"
"Madison","2020-10-08","33","5388","0","538","4.5","5.2"
"Madison","2020-10-09","33","5421","0","538","3.8","4.5"
"Madison","2020-10-10","18","5439","1","539","3.5","4.3"
"Madison","2020-10-11","12","5451","1","540","4","3.8"
"Madison","2020-10-12","32","5483","4","544","5.4","4.4"
"Madison","2020-10-13","37","5520","6","550","7.1","5.6"
"Madison","2020-10-14","39","5559","2","552","6.8","5.7"
"Madison","2020-10-15","23","5582","0","552","6.8","5.7"
"Madison","2020-10-16","29","5611","2","554","7.8","5.8"
"Madison","2020-10-17","13","5624","1","555","8.1","5.8"
"Madison","2020-10-18","16","5640","3","558","9.6","6.8"
"Madison","2020-10-19","41","5681","4","562","9.2","7.3"
"Madison","2020-10-20","36","5717","3","565","8.1","7.6"
"Madison","2020-10-21","38","5755","4","569","8.9","7.8"
"Madison","2020-10-22","31","5786","8","577","12.5","9.7"
"Madison","2020-10-23","42","5828","2","579","12.2","10"
"Madison","2020-10-24","17","5845","4","583","14.5","11.3"
"Madison","2020-10-25","12","5857","1","584","13","11.3"
"Madison","2020-10-26","34","5891","7","591","14.6","11.9"
"Madison","2020-10-27","41","5932","3","594","14.4","11.2"
"Madison","2020-10-28","52","5984","9","603","15.4","12.1"
"Madison","2020-10-29","35","6019","5","608","13.7","13.1"
"Madison","2020-10-30","35","6054","7","615","15.9","14.1"
"Madison","2020-10-31","18","6072","5","620","16.5","15.5"
"Madison","2020-11-01","16","6088","4","624","18.9","16"
"Madison","2020-11-02","43","6131","7","631","18.3","16.4"
"Madison","2020-11-03","46","6177","5","636","18.8","16.6"
"Madison","2020-11-04","38","6215","5","641","18.2","16.8"
"Madison","2020-11-05","44","6259","7","648","18.4","16.1"
"Madison","2020-11-06","49","6308","4","652","16.7","16.3"
"Madison","2020-11-07","20","6328","7","659","17.8","17.1"
"Madison","2020-11-08","17","6345","3","662","16.7","17.8"
"Madison","2020-11-09","65","6410","5","667","15.5","16.9"
"Madison","2020-11-10","52","6462","8","675","16.1","17.5"
"Madison","2020-11-11","49","6511","11","686","17.5","17.8"
"Madison","2020-11-12","54","6565","6","692","16.8","17.6"
"Madison","2020-11-13","36","6601","7","699","18.4","17.6"
"Madison","2020-11-14","33","6634","6","705","16","16.9"
"Madison","2020-11-15","25","6659","4","709","15.8","16.2"
"Madison","2020-11-16","77","6736","10","719","16.5","16"
"Madison","2020-11-17","69","6805","6","725","15.6","15.8"
"Madison","2020-11-18","79","6884","11","736","14.3","15.9"
"Madison","2020-11-19","74","6958","3","739","13.3","15.1"
"Madison","2020-11-20","55","7013","9","748","12.9","15.6"
"Madison","2020-11-21","27","7040","6","754","13.5","14.7"
"Madison","2020-11-22","36","7076","7","761","14","14.9"
"Madison","2020-11-23","68","7144","12","773","14.6","15.6"
"Madison","2020-11-24","71","7215","10","783","15.4","15.5"
"Madison","2020-11-25","38","7253","4","787","14.9","14.6"
"Madison","2020-11-26","9","7262","2","789","17.5","15.4"
"Madison","2020-11-27","48","7310","10","799","18.1","15.5"
"Madison","2020-11-28","38","7348","11","810","19.1","16.3"
"Madison","2020-11-29","41","7389","10","820","19.8","16.9"
"Madison","2020-11-30","88","7477","26","846","21.5","18.1"
"Madison","2020-12-01","99","7576","17","863","21.9","18.7"
"Madison","2020-12-02","65","7641","14","877","23.5","19.2"
"Madison","2020-12-03","76","7717","21","898","24.3","20.9"
"Madison","2020-12-04","81","7798","17","915","24.3","21.2"
"Madison","2020-12-05","50","7848","17","932","25","22.1"
"Madison","2020-12-06","49","7897","6","938","23.3","21.6"
"Madison","2020-12-07","130","8027","19","957","21.2","21.3"
"Madison","2020-12-08","80","8107","10","967","20.5","21.2"
"Madison","2020-12-09","92","8199","15","982","19.8","21.6"
"Madison","2020-12-10","106","8305","30","1012","19.9","22.1"
"Madison","2020-12-11","93","8398","24","1036","20.5","22.4"
"Madison","2020-12-12","41","8439","11","1047","19.5","22.3"
"Madison","2020-12-13","33","8472","11","1058","22.5","22.9"
"Madison","2020-12-14","111","8583","26","1084","23.8","22.5"
"Madison","2020-12-15","116","8699","17","1101","24.1","22.3"
"Madison","2020-12-16","150","8849","23","1124","24","21.9"
"Madison","2020-12-17","88","8937","12","1136","21.9","20.9"
"Madison","2020-12-18","94","9031","25","1161","22","21.3"
"Madison","2020-12-19","57","9088","18","1179","22.7","21.1"
"Madison","2020-12-20","48","9136","16","1195","22.7","22.6"
"Madison","2020-12-21","106","9242","31","1226","23.5","23.6"
"Madison","2020-12-22","101","9343","16","1242","23.7","23.9"
"Madison","2020-12-23","91","9434","26","1268","25.5","24.7"
"Madison","2020-12-24","45","9479","16","1284","28.7","25.3"
"Madison","2020-12-25","12","9491","1","1285","26.1","24"
"Madison","2020-12-26","50","9541","14","1299","25.6","24.1"
"Madison","2020-12-27","58","9599","20","1319","25.7","24.2"
"Madison","2020-12-28","112","9711","31","1350","25.5","24.5"
"Madison","2020-12-29","92","9803","29","1379","27.7","25.7"
"Madison","2020-12-30","109","9912","38","1417","28.6","27.1"
"Madison","2020-12-31","90","10002","30","1447","28.3","28.5"
"Madison","2021-01-01","34","10036","18","1465","34.7","30.4"
"Madison","2021-01-02","35","10071","19","1484","38.4","32"
"Madison","2021-01-03","53","10124","12","1496","36.8","31.2"
"Madison","2021-01-04","111","10235","33","1529","37","31.3"
"Madison","2021-01-05","158","10393","38","1567","36","31.9"
"Madison","2021-01-06","139","10532","40","1607","35.1","31.9"
"Madison","2021-01-07","137","10669","42","1649","34.7","31.5"
"Madison","2021-01-08","135","10804","40","1689","31.4","33"
"Madison","2021-01-09","57","10861","13","1702","26.9","32.7"
"Madison","2021-01-10","58","10919","22","1724","29.1","32.9"
"Madison","2021-01-11","127","11046","36","1760","28.9","33"
"Madison","2021-01-12","109","11155","23","1783","28.5","32.2"
"Madison","2021-01-13","108","11263","36","1819","29.1","32.1"
"Madison","2021-01-14","111","11374","31","1850","28.7","31.7"
"Madison","2021-01-15","104","11478","26","1876","28.1","29.7"
"Madison","2021-01-16","53","11531","14","1890","28.6","27.7"
"Madison","2021-01-17","42","11573","11","1901","26.9","28"
"Madison","2021-01-18","78","11651","22","1923","26.9","27.9"
"Madison","2021-01-19","76","11727","21","1944","27.8","28.1"
"Madison","2021-01-20","100","11827","20","1964","25.9","27.5"
"Madison","2021-01-21","122","11949","30","1994","25.4","27.1"
"Madison","2021-01-22","84","12033","16","2010","24.6","26.3"
"Madison","2021-01-23","51","12084","14","2024","24.7","26.7"
"Madison","2021-01-24","43","12127","11","2035","24.6","25.8"
"Madison","2021-01-25","116","12243","23","2058","23.4","25.2"
"Madison","2021-01-26","111","12354","28","2086","23.1","25.5"
"Madison","2021-01-27","93","12447","14","2100","22.4","24.2"
"Madison","2021-01-28","97","12544","23","2123","22.3","23.9"
"Madison","2021-01-29","81","12625","18","2141","22.7","23.7"
"Madison","2021-01-30","45","12670","13","2154","22.9","23.8"
"Madison","2021-01-31","58","12728","15","2169","23","23.8"
"Madison","2021-02-01","94","12822","19","2188","23","23.2"
"Madison","2021-02-02","103","12925","19","2207","22.1","22.6"
"Madison","2021-02-03","100","13025","20","2227","22.8","22.6"
"Madison","2021-02-04","81","13106","7","2234","20.6","21.4"
"Madison","2021-02-05","57","13163","9","2243","19.7","21.2"
"Madison","2021-02-06","11","13174","1","2244","16.9","19.9"
"Madison","2021-02-07","2","13176","0","2244","13.2","18.1"
"Madison","2021-02-08","0","13176","0","2244","10.3","16.7"
"Marion","2020-02-01","0","0","0","0",".","."
"Marion","2020-02-02","0","0","0","0",".","."
"Marion","2020-02-03","0","0","0","0",".","."
"Marion","2020-02-04","0","0","0","0",".","."
"Marion","2020-02-05","0","0","0","0",".","."
"Marion","2020-02-06","0","0","0","0",".","."
"Marion","2020-02-07","0","0","0","0","0","."
"Marion","2020-02-08","0","0","0","0","0","."
"Marion","2020-02-09","0","0","0","0","0","."
"Marion","2020-02-10","0","0","0","0","0","."
"Marion","2020-02-11","0","0","0","0","0","."
"Marion","2020-02-12","0","0","0","0","0","."
"Marion","2020-02-13","0","0","0","0","0","."
"Marion","2020-02-14","0","0","0","0","0","0"
"Marion","2020-02-15","0","0","0","0","0","0"
"Marion","2020-02-16","0","0","0","0","0","0"
"Marion","2020-02-17","0","0","0","0","0","0"
"Marion","2020-02-18","0","0","0","0","0","0"
"Marion","2020-02-19","0","0","0","0","0","0"
"Marion","2020-02-20","0","0","0","0","0","0"
"Marion","2020-02-21","0","0","0","0","0","0"
"Marion","2020-02-22","0","0","0","0","0","0"
"Marion","2020-02-23","0","0","0","0","0","0"
"Marion","2020-02-24","0","0","0","0","0","0"
"Marion","2020-02-25","0","0","0","0","0","0"
"Marion","2020-02-26","0","0","0","0","0","0"
"Marion","2020-02-27","0","0","0","0","0","0"
"Marion","2020-02-28","0","0","0","0","0","0"
"Marion","2020-02-29","0","0","0","0","0","0"
"Marion","2020-03-01","0","0","0","0","0","0"
"Marion","2020-03-02","0","0","0","0","0","0"
"Marion","2020-03-03","0","0","0","0","0","0"
"Marion","2020-03-04","0","0","0","0","0","0"
"Marion","2020-03-05","0","0","0","0","0","0"
"Marion","2020-03-06","0","0","0","0","0","0"
"Marion","2020-03-07","0","0","0","0","0","0"
"Marion","2020-03-08","0","0","0","0","0","0"
"Marion","2020-03-09","0","0","0","0","0","0"
"Marion","2020-03-10","0","0","0","0","0","0"
"Marion","2020-03-11","0","0","0","0","0","0"
"Marion","2020-03-12","0","0","0","0","0","0"
"Marion","2020-03-13","0","0","0","0","0","0"
"Marion","2020-03-14","0","0","0","0","0","0"
"Marion","2020-03-15","0","0","0","0","0","0"
"Marion","2020-03-16","0","0","0","0","0","0"
"Marion","2020-03-17","0","0","0","0","0","0"
"Marion","2020-03-18","1","1","0","0","0","0"
"Marion","2020-03-19","3","4","0","0","0","0"
"Marion","2020-03-20","0","4","0","0","0","0"
"Marion","2020-03-21","0","4","0","0","0","0"
"Marion","2020-03-22","2","6","0","0","0","0"
"Marion","2020-03-23","2","8","0","0","0","0"
"Marion","2020-03-24","3","11","0","0","0","0"
"Marion","2020-03-25","9","20","0","0","0","0"
"Marion","2020-03-26","4","24","0","0","0","0"
"Marion","2020-03-27","5","29","2","2","5.7","2.9"
"Marion","2020-03-28","0","29","0","2","5.7","2.9"
"Marion","2020-03-29","1","30","0","2","5.7","2.9"
"Marion","2020-03-30","2","32","0","2","5.7","2.9"
"Marion","2020-03-31","0","32","0","2","5.7","2.9"
"Marion","2020-04-01","2","34","1","3","12.9","6.4"
"Marion","2020-04-02","1","35","0","3","12.9","6.4"
"Marion","2020-04-03","1","36","0","3","7.1","6.4"
"Marion","2020-04-04","2","38","1","4","14.3","10"
"Marion","2020-04-05","0","38","0","4","14.3","10"
"Marion","2020-04-06","7","45","2","6","18.4","12"
"Marion","2020-04-07","5","50","2","8","24.1","14.9"
"Marion","2020-04-08","1","51","0","8","16.9","14.9"
"Marion","2020-04-09","4","55","0","8","16.9","14.9"
"Marion","2020-04-10","6","61","4","12","26.5","16.8"
"Marion","2020-04-11","1","62","1","13","33.6","23.9"
"Marion","2020-04-12","0","62","0","13","33.6","23.9"
"Marion","2020-04-13","6","68","3","16","36.7","27.5"
"Marion","2020-04-14","2","70","0","16","31","27.5"
"Marion","2020-04-15","9","79","3","19","35.7","26.3"
"Marion","2020-04-16","8","87","2","21","39.3","28.1"
"Marion","2020-04-17","8","95","3","24","35.1","30.8"
"Marion","2020-04-18","0","95","0","24","20.8","27.2"
"Marion","2020-04-19","1","96","0","24","20.8","27.2"
"Marion","2020-04-20","6","102","3","27","20.8","28.8"
"Marion","2020-04-21","5","107","0","27","20.8","25.9"
"Marion","2020-04-22","5","112","2","29","21.8","28.8"
"Marion","2020-04-23","1","113","0","29","18.2","28.8"
"Marion","2020-04-24","11","124","2","31","15.5","25.3"
"Marion","2020-04-25","2","126","1","32","22.6","21.7"
"Marion","2020-04-26","4","130","0","32","22.6","21.7"
"Marion","2020-04-27","8","138","2","34","19","19.9"
"Marion","2020-04-28","3","141","0","34","19","19.9"
"Marion","2020-04-29","1","142","0","34","13.3","17.5"
"Marion","2020-04-30","1","143","0","34","13.3","15.8"
"Marion","2020-05-01","9","152","0","34","10.7","13.1"
"Marion","2020-05-02","1","153","0","34","3.6","13.1"
"Marion","2020-05-03","3","156","1","35","8.3","15.5"
"Marion","2020-05-04","5","161","1","36","7.6","13.3"
"Marion","2020-05-05","3","164","0","36","7.6","13.3"
"Marion","2020-05-06","10","174","2","38","10.5","11.9"
"Marion","2020-05-07","1","175","0","38","10.5","11.9"
"Marion","2020-05-08","10","185","0","38","10.5","10.6"
"Marion","2020-05-09","2","187","0","38","10.5","7"
"Marion","2020-05-10","0","187","0","38","5.7","7"
"Marion","2020-05-11","8","195","1","39","4.6","6.1"
"Marion","2020-05-12","2","197","0","39","4.6","6.1"
"Marion","2020-05-13","11","208","2","41","4.4","7.4"
"Marion","2020-05-14","10","218","4","45","10.1","10.3"
"Marion","2020-05-15","8","226","2","47","13.7","12.1"
"Marion","2020-05-16","1","227","0","47","13.7","12.1"
"Marion","2020-05-17","10","237","1","48","15.1","10.4"
"Marion","2020-05-18","27","264","3","51","14.9","9.8"
"Marion","2020-05-19","6","270","1","52","17.3","11"
"Marion","2020-05-20","4","274","0","52","14.7","9.5"
"Marion","2020-05-21","7","281","0","52","9","9.5"
"Marion","2020-05-22","1","282","0","52","5.4","9.5"
"Marion","2020-05-23","0","282","0","52","5.4","9.5"
"Marion","2020-05-24","1","283","0","52","4","9.5"
"Marion","2020-05-25","2","285","0","52","2.4","8.6"
"Marion","2020-05-26","16","301","3","55","2.7","10"
"Marion","2020-05-27","10","311","0","55","2.7","8.7"
"Marion","2020-05-28","3","314","0","55","2.7","5.8"
"Marion","2020-05-29","8","322","2","57","6.3","5.8"
"Marion","2020-05-30","1","323","0","57","6.3","5.8"
"Marion","2020-05-31","1","324","0","57","6.3","5.1"
"Marion","2020-06-01","5","329","0","57","6.3","4.3"
"Marion","2020-06-02","10","339","0","57","3.6","3.1"
"Marion","2020-06-03","6","345","0","57","3.6","3.1"
"Marion","2020-06-04","10","355","1","58","5","3.8"
"Marion","2020-06-05","14","369","1","59","2.4","4.3"
"Marion","2020-06-06","10","379","0","59","2.4","4.3"
"Marion","2020-06-07","0","379","0","59","2.4","4.3"
"Marion","2020-06-08","11","390","0","59","2.4","4.3"
"Marion","2020-06-09","4","394","0","59","2.4","3"
"Marion","2020-06-10","18","412","3","62","4.8","4.2"
"Marion","2020-06-11","10","422","1","63","4.8","4.9"
"Marion","2020-06-12","8","430","0","63","3.8","3.1"
"Marion","2020-06-13","0","430","0","63","3.8","3.1"
"Marion","2020-06-14","4","434","1","64","7.4","4.9"
"Marion","2020-06-15","23","457","2","66","8.6","5.5"
"Marion","2020-06-16","7","464","2","68","12.7","7.6"
"Marion","2020-06-17","49","513","3","71","11.2","8"
"Marion","2020-06-18","13","526","1","72","10.9","7.8"
"Marion","2020-06-19","15","541","2","74","12.8","8.3"
"Marion","2020-06-20","3","544","2","76","22.3","13.1"
"Marion","2020-06-21","2","546","0","76","18.7","13.1"
"Marion","2020-06-22","29","575","0","76","17.5","13.1"
"Marion","2020-06-23","10","585","0","76","13.4","13.1"
"Marion","2020-06-24","28","613","1","77","13","12.1"
"Marion","2020-06-25","14","627","0","77","11.9","11.4"
"Marion","2020-06-26","8","635","0","77","10","11.4"
"Marion","2020-06-27","4","639","0","77","0.5","11.4"
"Marion","2020-06-28","3","642","0","77","0.5","9.6"
"Marion","2020-06-29","7","649","0","77","0.5","9"
"Marion","2020-06-30","11","660","2","79","3.1","8.3"
"Marion","2020-07-01","19","679","7","86","7.9","10.4"
"Marion","2020-07-02","8","687","1","87","9.6","10.8"
"Marion","2020-07-03","4","691","0","87","9.6","9.8"
"Marion","2020-07-04","1","692","1","88","23.9","12.2"
"Marion","2020-07-05","4","696","1","89","27.5","14"
"Marion","2020-07-06","35","731","6","95","30","15.2"
"Marion","2020-07-07","7","738","2","97","31.4","17.3"
"Marion","2020-07-08","42","780","2","99","26.9","17.4"
"Marion","2020-07-09","8","788","0","99","25.1","17.4"
"Marion","2020-07-10","11","799","1","100","26.4","18"
"Marion","2020-07-11","4","803","1","101","15.7","19.8"
"Marion","2020-07-12","5","808","0","101","12.1","19.8"
"Marion","2020-07-13","43","851","3","104","10.6","20.3"
"Marion","2020-07-14","3","854","2","106","16.1","23.8"
"Marion","2020-07-15","39","893","3","109","16.5","21.7"
"Marion","2020-07-16","11","904","3","112","20.4","22.7"
"Marion","2020-07-17","7","911","0","112","19.1","22.7"
"Marion","2020-07-18","5","916","1","113","18.4","17"
"Marion","2020-07-19","3","919","0","113","18.4","15.2"
"Marion","2020-07-20","36","955","4","117","19","14.8"
"Marion","2020-07-21","5","960","0","117","9.4","12.8"
"Marion","2020-07-22","28","988","3","120","9.9","13.2"
"Marion","2020-07-23","18","1006","4","124","9.1","14.8"
"Marion","2020-07-24","6","1012","1","125","11.5","15.3"
"Marion","2020-07-25","7","1019","0","125","8.7","13.5"
"Marion","2020-07-26","2","1021","0","125","8.7","13.5"
"Marion","2020-07-27","46","1067","10","135","10.2","14.6"
"Marion","2020-07-28","12","1079","2","137","12.6","11"
"Marion","2020-07-29","55","1134","5","142","12.3","11.1"
"Marion","2020-07-30","10","1144","2","144","12","10.6"
"Marion","2020-07-31","9","1153","0","144","9.6","10.6"
"Marion","2020-08-01","1","1154","1","145","23.9","16.3"
"Marion","2020-08-02","3","1157","1","146","28.7","18.7"
"Marion","2020-08-03","39","1196","1","147","26","18.1"
"Marion","2020-08-04","38","1234","1","148","23.9","18.3"
"Marion","2020-08-05","37","1271","3","151","23.8","18.1"
"Marion","2020-08-06","7","1278","0","151","20.9","16.5"
"Marion","2020-08-07","4","1282","0","151","20.9","15.3"
"Marion","2020-08-08","7","1289","0","151","6.7","15.3"
"Marion","2020-08-09","4","1293","0","151","1.9","15.3"
"Marion","2020-08-10","33","1326","0","151","1.5","13.7"
"Marion","2020-08-11","5","1331","1","152","4","14"
"Marion","2020-08-12","26","1357","0","152","2.9","13.3"
"Marion","2020-08-13","8","1365","0","152","2.9","11.9"
"Marion","2020-08-14","14","1379","1","153","3.9","12.4"
"Marion","2020-08-15","1","1380","0","153","3.9","5.3"
"Marion","2020-08-16","6","1386","0","153","3.9","2.9"
"Marion","2020-08-17","6","1392","1","154","6.3","3.9"
"Marion","2020-08-18","10","1402","0","154","3.4","3.7"
"Marion","2020-08-19","8","1410","1","155","5.2","4"
"Marion","2020-08-20","13","1423","0","155","5.2","4"
"Marion","2020-08-21","7","1430","0","155","4.2","4"
"Marion","2020-08-22","6","1436","1","156","6.5","5.2"
"Marion","2020-08-23","2","1438","1","157","13.7","8.8"
"Marion","2020-08-24","15","1453","2","159","13.2","9.7"
"Marion","2020-08-25","7","1460","0","159","13.2","8.3"
"Marion","2020-08-26","16","1476","2","161","13.2","9.2"
"Marion","2020-08-27","7","1483","1","162","15.3","10.2"
"Marion","2020-08-28","8","1491","1","163","17","10.6"
"Marion","2020-08-29","1","1492","0","163","14.7","10.6"
"Marion","2020-08-30","2","1494","0","163","7.5","10.6"
"Marion","2020-08-31","18","1512","3","166","8","10.6"
"Marion","2020-09-01","4","1516","0","166","8","10.6"
"Marion","2020-09-02","6","1522","0","166","6.2","9.7"
"Marion","2020-09-03","38","1560","0","166","4.2","9.7"
"Marion","2020-09-04","15","1575","0","166","2.4","9.7"
"Marion","2020-09-05","17","1592","0","166","2.4","8.5"
"Marion","2020-09-06","2","1594","0","166","2.4","4.9"
"Marion","2020-09-07","3","1597","0","166","0","4"
"Marion","2020-09-08","1","1598","0","166","0","4"
"Marion","2020-09-09","15","1613","1","167","1","3.6"
"Marion","2020-09-10","11","1624","0","167","1","2.6"
"Marion","2020-09-11","10","1634","2","169","3.8","3.1"
"Marion","2020-09-12","11","1645","1","170","5.1","3.7"
"Marion","2020-09-13","2","1647","0","170","5.1","3.7"
"Marion","2020-09-14","14","1661","1","171","6.1","3.1"
"Marion","2020-09-15","4","1665","1","172","9.7","4.9"
"Marion","2020-09-16","44","1709","2","174","9.4","5.2"
"Marion","2020-09-17","19","1728","2","176","10.9","5.9"
"Marion","2020-09-18","14","1742","1","177","9.1","6.4"
"Marion","2020-09-19","8","1750","0","177","7.8","6.4"
"Marion","2020-09-20","1","1751","0","177","7.8","6.4"
"Marion","2020-09-21","5","1756","0","177","6.7","6.4"
"Marion","2020-09-22","5","1761","0","177","3.2","6.4"
"Marion","2020-09-23","11","1772","1","178","3.8","6.6"
"Marion","2020-09-24","10","1782","0","178","2.3","6.6"
"Marion","2020-09-25","7","1789","0","178","1.3","5.2"
"Marion","2020-09-26","3","1792","0","178","1.3","4.5"
"Marion","2020-09-27","4","1796","0","178","1.3","4.5"
"Marion","2020-09-28","15","1811","2","180","3.2","5"
"Marion","2020-09-29","4","1815","0","180","3.2","3.2"
"Marion","2020-09-30","10","1825","0","180","1.9","2.9"
"Marion","2020-10-01","4","1829","0","180","1.9","2.1"
"Marion","2020-10-02","4","1833","0","180","1.9","1.6"
"Marion","2020-10-03","4","1837","0","180","1.9","1.6"
"Marion","2020-10-04","4","1841","0","180","1.9","1.6"
"Marion","2020-10-05","9","1850","0","180","0","1.6"
"Marion","2020-10-06","8","1858","0","180","0","1.6"
"Marion","2020-10-07","22","1880","0","180","0","1"
"Marion","2020-10-08","2","1882","0","180","0","1"
"Marion","2020-10-09","10","1892","0","180","0","1"
"Marion","2020-10-10","5","1897","0","180","0","1"
"Marion","2020-10-11","5","1902","1","181","2.9","2.4"
"Marion","2020-10-12","7","1909","0","181","2.9","1.4"
"Marion","2020-10-13","4","1913","0","181","2.9","1.4"
"Marion","2020-10-14","10","1923","0","181","2.9","1.4"
"Marion","2020-10-15","9","1932","0","181","2.9","1.4"
"Marion","2020-10-16","8","1940","0","181","2.9","1.4"
"Marion","2020-10-17","6","1946","0","181","2.9","1.4"
"Marion","2020-10-18","2","1948","0","181","0","1.4"
"Marion","2020-10-19","7","1955","1","182","2","2.4"
"Marion","2020-10-20","9","1964","0","182","2","2.4"
"Marion","2020-10-21","14","1978","0","182","2","2.4"
"Marion","2020-10-22","4","1982","1","183","5.6","4.2"
"Marion","2020-10-23","5","1987","1","184","8.5","5.7"
"Marion","2020-10-24","3","1990","0","184","8.5","5.7"
"Marion","2020-10-25","3","1993","1","185","13.2","6.6"
"Marion","2020-10-26","10","2003","1","186","12.6","7.3"
"Marion","2020-10-27","3","2006","1","187","17.4","9.7"
"Marion","2020-10-28","9","2015","1","188","19","10.5"
"Marion","2020-10-29","4","2019","0","188","15.4","10.5"
"Marion","2020-10-30","7","2026","0","188","12.5","10.5"
"Marion","2020-10-31","3","2029","0","188","12.5","10.5"
"Marion","2020-11-01","3","2032","0","188","7.8","10.5"
"Marion","2020-11-02","8","2040","2","190","9.9","11.3"
"Marion","2020-11-03","3","2043","0","190","5.2","11.3"
"Marion","2020-11-04","17","2060","2","192","5.3","12.1"
"Marion","2020-11-05","11","2071","1","193","6.6","11"
"Marion","2020-11-06","8","2079","0","193","6.6","9.5"
"Marion","2020-11-07","6","2085","0","193","6.6","9.5"
"Marion","2020-11-08","1","2086","0","193","6.6","7.2"
"Marion","2020-11-09","18","2104","2","195","4.6","7.2"
"Marion","2020-11-10","7","2111","0","195","4.6","4.9"
"Marion","2020-11-11","8","2119","0","195","2.9","4.1"
"Marion","2020-11-12","15","2134","0","195","1.6","4.1"
"Marion","2020-11-13","12","2146","0","195","1.6","4.1"
"Marion","2020-11-14","2","2148","0","195","1.6","4.1"
"Marion","2020-11-15","6","2154","0","195","1.6","4.1"
"Marion","2020-11-16","18","2172","2","197","1.6","3.1"
"Marion","2020-11-17","8","2180","0","197","1.6","3.1"
"Marion","2020-11-18","36","2216","2","199","2.4","2.6"
"Marion","2020-11-19","12","2228","0","199","2.4","2"
"Marion","2020-11-20","16","2244","1","200","3.3","2.4"
"Marion","2020-11-21","10","2254","2","202","6.1","3.9"
"Marion","2020-11-22","4","2258","1","203","9.7","5.6"
"Marion","2020-11-23","26","2284","1","204","8.7","5.1"
"Marion","2020-11-24","3","2287","1","205","13.4","7.5"
"Marion","2020-11-25","18","2305","0","205","12.6","7.5"
"Marion","2020-11-26","0","2305","0","205","12.6","7.5"
"Marion","2020-11-27","6","2311","1","206","14.1","8.7"
"Marion","2020-11-28","7","2318","0","206","11.3","8.7"
"Marion","2020-11-29","4","2322","0","206","7.7","8.7"
"Marion","2020-11-30","19","2341","0","206","7.1","7.9"
"Marion","2020-12-01","5","2346","0","206","2.4","7.9"
"Marion","2020-12-02","6","2352","0","206","2.4","7.5"
"Marion","2020-12-03","4","2356","1","207","6","9.3"
"Marion","2020-12-04","7","2363","0","207","3.6","8.8"
"Marion","2020-12-05","3","2366","0","207","3.6","7.4"
"Marion","2020-12-06","5","2371","0","207","3.6","5.6"
"Marion","2020-12-07","25","2396","1","208","4.1","5.6"
"Marion","2020-12-08","3","2399","0","208","4.1","3.3"
"Marion","2020-12-09","6","2405","1","209","6.5","4.5"
"Marion","2020-12-10","11","2416","0","209","3","4.5"
"Marion","2020-12-11","11","2427","0","209","3","3.3"
"Marion","2020-12-12","1","2428","0","209","3","3.3"
"Marion","2020-12-13","3","2431","2","211","12.5","8"
"Marion","2020-12-14","40","2471","9","220","15.1","9.6"
"Marion","2020-12-15","12","2483","3","223","18.7","11.4"
"Marion","2020-12-16","12","2495","2","225","18.7","12.6"
"Marion","2020-12-17","6","2501","0","225","18.7","10.8"
"Marion","2020-12-18","10","2511","1","226","20.1","11.5"
"Marion","2020-12-19","5","2516","2","228","25.8","14.4"
"Marion","2020-12-20","2","2518","0","228","16.3","14.4"
"Marion","2020-12-21","33","2551","3","231","14.4","14.8"
"Marion","2020-12-22","8","2559","1","232","12.6","15.6"
"Marion","2020-12-23","11","2570","2","234","12.8","15.8"
"Marion","2020-12-24","3","2573","0","234","12.8","15.8"
"Marion","2020-12-25","1","2574","0","234","11.4","15.8"
"Marion","2020-12-26","3","2577","0","234","5.7","15.8"
"Marion","2020-12-27","7","2584","1","235","7.7","12"
"Marion","2020-12-28","10","2594","3","238","10.7","12.6"
"Marion","2020-12-29","15","2609","9","247","17.5","15.1"
"Marion","2020-12-30","7","2616","1","248","16.9","14.9"
"Marion","2020-12-31","10","2626","1","249","18.4","15.6"
"Marion","2021-01-01","0","2626","0","249","18.4","14.9"
"Marion","2021-01-02","3","2629","1","250","23.1","14.4"
"Marion","2021-01-03","2","2631","0","250","21.1","14.4"
"Marion","2021-01-04","108","2739","21","271","19.6","15.1"
"Marion","2021-01-05","10","2749","0","271","11","14.3"
"Marion","2021-01-06","11","2760","1","272","10.3","13.6"
"Marion","2021-01-07","19","2779","8","280","14.9","16.6"
"Marion","2021-01-08","12","2791","4","284","19.6","19"
"Marion","2021-01-09","6","2797","1","285","17.2","20.2"
"Marion","2021-01-10","3","2800","1","286","22","21.5"
"Marion","2021-01-11","54","2854","6","292","20.8","20.2"
"Marion","2021-01-12","15","2869","4","296","24.6","17.8"
"Marion","2021-01-13","14","2883","5","301","28.4","19.3"
"Marion","2021-01-14","18","2901","3","304","24.8","19.8"
"Marion","2021-01-15","12","2913","1","305","21.2","20.4"
"Marion","2021-01-16","4","2917","0","305","18.8","18"
"Marion","2021-01-17","2","2919","0","305","14.1","18"
"Marion","2021-01-18","18","2937","5","310","16.5","18.6"
"Marion","2021-01-19","7","2944","2","312","16.7","20.7"
"Marion","2021-01-20","11","2955","0","312","11.6","20"
"Marion","2021-01-21","6","2961","0","312","9.2","17"
"Marion","2021-01-22","15","2976","4","316","11.9","16.5"
"Marion","2021-01-23","6","2982","1","317","14.2","16.5"
"Marion","2021-01-24","5","2987","0","317","14.2","14.2"
"Marion","2021-01-25","52","3039","6","323","11.9","14.2"
"Marion","2021-01-26","26","3065","8","331","12.2","14.5"
"Marion","2021-01-27","28","3093","8","339","16.3","14"
"Marion","2021-01-28","15","3108","0","339","16.3","12.8"
"Marion","2021-01-29","13","3121","2","341","14.7","13.3"
"Marion","2021-01-30","3","3124","0","341","12.3","13.3"
"Marion","2021-01-31","1","3125","0","341","12.3","13.3"
"Marion","2021-02-01","14","3139","3","344","13.7","12.8"
"Marion","2021-02-02","9","3148","1","345","10.9","11.6"
"Marion","2021-02-03","25","3173","7","352","10.8","13.6"
"Marion","2021-02-04","16","3189","0","352","10.8","13.6"
"Marion","2021-02-05","13","3202","0","352","8.6","11.7"
"Marion","2021-02-06","0","3202","0","352","8.6","10.5"
"Marion","2021-02-07","3","3205","0","352","8.6","10.5"
"Marion","2021-02-08","0","3205","0","352","5.6","9.7"
"McDuffie","2020-02-01","0","0","0","0",".","."
"McDuffie","2020-02-02","0","0","0","0",".","."
"McDuffie","2020-02-03","0","0","0","0",".","."
"McDuffie","2020-02-04","0","0","0","0",".","."
"McDuffie","2020-02-05","0","0","0","0",".","."
"McDuffie","2020-02-06","0","0","0","0",".","."
"McDuffie","2020-02-07","0","0","0","0","0","."
"McDuffie","2020-02-08","0","0","0","0","0","."
"McDuffie","2020-02-09","0","0","0","0","0","."
"McDuffie","2020-02-10","0","0","0","0","0","."
"McDuffie","2020-02-11","0","0","0","0","0","."
"McDuffie","2020-02-12","0","0","0","0","0","."
"McDuffie","2020-02-13","0","0","0","0","0","."
"McDuffie","2020-02-14","0","0","0","0","0","0"
"McDuffie","2020-02-15","0","0","0","0","0","0"
"McDuffie","2020-02-16","0","0","0","0","0","0"
"McDuffie","2020-02-17","0","0","0","0","0","0"
"McDuffie","2020-02-18","0","0","0","0","0","0"
"McDuffie","2020-02-19","0","0","0","0","0","0"
"McDuffie","2020-02-20","0","0","0","0","0","0"
"McDuffie","2020-02-21","0","0","0","0","0","0"
"McDuffie","2020-02-22","0","0","0","0","0","0"
"McDuffie","2020-02-23","0","0","0","0","0","0"
"McDuffie","2020-02-24","0","0","0","0","0","0"
"McDuffie","2020-02-25","0","0","0","0","0","0"
"McDuffie","2020-02-26","0","0","0","0","0","0"
"McDuffie","2020-02-27","0","0","0","0","0","0"
"McDuffie","2020-02-28","0","0","0","0","0","0"
"McDuffie","2020-02-29","0","0","0","0","0","0"
"McDuffie","2020-03-01","0","0","0","0","0","0"
"McDuffie","2020-03-02","0","0","0","0","0","0"
"McDuffie","2020-03-03","0","0","0","0","0","0"
"McDuffie","2020-03-04","0","0","0","0","0","0"
"McDuffie","2020-03-05","0","0","0","0","0","0"
"McDuffie","2020-03-06","0","0","0","0","0","0"
"McDuffie","2020-03-07","0","0","0","0","0","0"
"McDuffie","2020-03-08","0","0","0","0","0","0"
"McDuffie","2020-03-09","0","0","0","0","0","0"
"McDuffie","2020-03-10","0","0","0","0","0","0"
"McDuffie","2020-03-11","0","0","0","0","0","0"
"McDuffie","2020-03-12","1","1","0","0","0","0"
"McDuffie","2020-03-13","0","1","0","0","0","0"
"McDuffie","2020-03-14","0","1","0","0","0","0"
"McDuffie","2020-03-15","0","1","0","0","0","0"
"McDuffie","2020-03-16","0","1","0","0","0","0"
"McDuffie","2020-03-17","1","2","0","0","0","0"
"McDuffie","2020-03-18","0","2","0","0","0","0"
"McDuffie","2020-03-19","2","4","2","2","14.3","7.1"
"McDuffie","2020-03-20","0","4","0","2","14.3","7.1"
"McDuffie","2020-03-21","1","5","0","2","14.3","7.1"
"McDuffie","2020-03-22","0","5","0","2","14.3","7.1"
"McDuffie","2020-03-23","2","7","1","3","21.4","10.7"
"McDuffie","2020-03-24","0","7","0","3","21.4","10.7"
"McDuffie","2020-03-25","1","8","0","3","21.4","10.7"
"McDuffie","2020-03-26","1","9","0","3","7.1","10.7"
"McDuffie","2020-03-27","3","12","1","4","11.9","13.1"
"McDuffie","2020-03-28","3","15","0","4","11.9","13.1"
"McDuffie","2020-03-29","0","15","0","4","11.9","13.1"
"McDuffie","2020-03-30","0","15","0","4","4.8","13.1"
"McDuffie","2020-03-31","1","16","1","5","19","20.2"
"McDuffie","2020-04-01","2","18","0","5","19","20.2"
"McDuffie","2020-04-02","6","24","0","5","19","13.1"
"McDuffie","2020-04-03","6","30","0","5","14.3","13.1"
"McDuffie","2020-04-04","2","32","1","6","21.4","16.7"
"McDuffie","2020-04-05","1","33","0","6","21.4","16.7"
"McDuffie","2020-04-06","2","35","0","6","21.4","13.1"
"McDuffie","2020-04-07","10","45","2","8","10","14.5"
"McDuffie","2020-04-08","13","58","4","12","14.4","16.7"
"McDuffie","2020-04-09","8","66","0","12","14.4","16.7"
"McDuffie","2020-04-10","7","73","4","16","22.6","18.4"
"McDuffie","2020-04-11","12","85","4","20","20.2","20.8"
"McDuffie","2020-04-12","2","87","2","22","34.5","27.9"
"McDuffie","2020-04-13","8","95","2","24","38","29.7"
"McDuffie","2020-04-14","3","98","1","25","39.9","25"
"McDuffie","2020-04-15","9","107","2","27","38.7","26.6"
"McDuffie","2020-04-16","5","112","1","28","41.6","28"
"McDuffie","2020-04-17","9","121","0","28","33.4","28"
"McDuffie","2020-04-18","0","121","0","28","28.7","24.4"
"McDuffie","2020-04-19","2","123","2","30","28.7","31.6"
"McDuffie","2020-04-20","6","129","0","30","25.1","31.6"
"McDuffie","2020-04-21","9","138","0","30","20.3","30.1"
"McDuffie","2020-04-22","14","152","2","32","19.2","29"
"McDuffie","2020-04-23","4","156","0","32","16.3","29"
"McDuffie","2020-04-24","9","165","0","32","16.3","24.9"
"McDuffie","2020-04-25","10","175","1","33","17.8","23.2"
"McDuffie","2020-04-26","5","180","1","34","6.3","17.5"
"McDuffie","2020-04-27","4","184","0","34","6.3","15.7"
"McDuffie","2020-04-28","10","194","2","36","9.2","14.8"
"McDuffie","2020-04-29","6","200","0","36","7.1","13.2"
"McDuffie","2020-04-30","5","205","0","36","7.1","11.7"
"McDuffie","2020-05-01","8","213","2","38","10.7","13.5"
"McDuffie","2020-05-02","6","219","3","41","16.4","17.1"
"McDuffie","2020-05-03","8","227","1","42","15.4","10.8"
"McDuffie","2020-05-04","13","240","1","43","16.5","11.4"
"McDuffie","2020-05-05","12","252","0","43","13.6","11.4"
"McDuffie","2020-05-06","11","263","2","45","16.2","11.7"
"McDuffie","2020-05-07","10","273","1","46","17.6","12.4"
"McDuffie","2020-05-08","7","280","0","46","14.1","12.4"
"McDuffie","2020-05-09","4","284","0","46","6.9","11.7"
"McDuffie","2020-05-10","0","284","0","46","5.1","10.2"
"McDuffie","2020-05-11","14","298","1","47","5","10.8"
"McDuffie","2020-05-12","17","315","1","48","5.9","9.7"
"McDuffie","2020-05-13","11","326","1","49","4.6","10.4"
"McDuffie","2020-05-14","13","339","3","52","6.5","12"
"McDuffie","2020-05-15","7","346","1","53","8.5","11.3"
"McDuffie","2020-05-16","6","352","0","53","8.5","7.7"
"McDuffie","2020-05-17","5","357","0","53","8.5","6.8"
"McDuffie","2020-05-18","19","376","4","57","10.5","7.8"
"McDuffie","2020-05-19","23","399","3","60","11.5","8.7"
"McDuffie","2020-05-20","10","409","0","60","10.2","7.4"
"McDuffie","2020-05-21","19","428","0","60","6.9","6.7"
"McDuffie","2020-05-22","6","434","0","60","4.9","6.7"
"McDuffie","2020-05-23","4","438","0","60","4.9","6.7"
"McDuffie","2020-05-24","8","446","0","60","4.9","6.7"
"McDuffie","2020-05-25","1","447","0","60","1.9","6.2"
"McDuffie","2020-05-26","7","454","0","60","0","5.8"
"McDuffie","2020-05-27","6","460","0","60","0","5.1"
"McDuffie","2020-05-28","9","469","1","61","1.6","4.2"
"McDuffie","2020-05-29","3","472","0","61","1.6","3.2"
"McDuffie","2020-05-30","1","473","0","61","1.6","3.2"
"McDuffie","2020-05-31","9","482","2","63","4.8","4.8"
"McDuffie","2020-06-01","18","500","0","63","4.8","3.3"
"McDuffie","2020-06-02","19","519","0","63","4.8","2.4"
"McDuffie","2020-06-03","9","528","0","63","4.8","2.4"
"McDuffie","2020-06-04","3","531","0","63","3.2","2.4"
"McDuffie","2020-06-05","6","537","0","63","3.2","2.4"
"McDuffie","2020-06-06","1","538","1","64","17.5","9.5"
"McDuffie","2020-06-07","2","540","0","64","14.3","9.5"
"McDuffie","2020-06-08","3","543","0","64","14.3","9.5"
"McDuffie","2020-06-09","5","548","0","64","14.3","9.5"
"McDuffie","2020-06-10","20","568","0","64","14.3","9.5"
"McDuffie","2020-06-11","16","584","1","65","15.2","9.2"
"McDuffie","2020-06-12","13","597","0","65","15.2","9.2"
"McDuffie","2020-06-13","5","602","0","65","0.9","9.2"
"McDuffie","2020-06-14","10","612","1","66","2.3","8.3"
"McDuffie","2020-06-15","15","627","1","67","3.3","8.8"
"McDuffie","2020-06-16","14","641","0","67","3.3","8.8"
"McDuffie","2020-06-17","7","648","1","68","5.3","9.8"
"McDuffie","2020-06-18","9","657","1","69","6","10.6"
"McDuffie","2020-06-19","4","661","2","71","13.2","14.2"
"McDuffie","2020-06-20","9","670","0","71","13.2","7"
"McDuffie","2020-06-21","2","672","0","71","11.7","7"
"McDuffie","2020-06-22","16","688","3","74","13.4","8.4"
"McDuffie","2020-06-23","18","706","2","76","15","9.2"
"McDuffie","2020-06-24","14","720","2","78","15","10.2"
"McDuffie","2020-06-25","21","741","1","79","14.1","10.1"
"McDuffie","2020-06-26","12","753","1","80","8.2","10.7"
"McDuffie","2020-06-27","17","770","3","83","10.7","11.9"
"McDuffie","2020-06-28","7","777","1","84","12.7","12.2"
"McDuffie","2020-06-29","49","826","10","94","13","13.2"
"McDuffie","2020-06-30","26","852","5","99","14.1","14.6"
"McDuffie","2020-07-01","28","880","6","105","15.2","15.1"
"McDuffie","2020-07-02","22","902","3","108","16.4","15.3"
"McDuffie","2020-07-03","16","918","2","110","17","12.6"
"McDuffie","2020-07-04","7","925","0","110","14.5","12.6"
"McDuffie","2020-07-05","25","950","6","116","15.9","14.3"
"McDuffie","2020-07-06","32","982","6","122","15.6","14.3"
"McDuffie","2020-07-07","25","1007","4","126","15.2","14.7"
"McDuffie","2020-07-08","24","1031","2","128","13.3","14.2"
"McDuffie","2020-07-09","31","1062","3","131","12.8","14.6"
"McDuffie","2020-07-10","28","1090","5","136","13.5","15.3"
"McDuffie","2020-07-11","10","1100","0","136","13.5","14"
"McDuffie","2020-07-12","29","1129","4","140","12.1","14"
"McDuffie","2020-07-13","62","1191","10","150","11.7","13.7"
"McDuffie","2020-07-14","34","1225","5","155","11.5","13.3"
"McDuffie","2020-07-15","38","1263","6","161","12.6","12.9"
"McDuffie","2020-07-16","36","1299","3","164","12.4","12.6"
"McDuffie","2020-07-17","21","1320","4","168","12.5","13"
"McDuffie","2020-07-18","29","1349","1","169","13","13.3"
"McDuffie","2020-07-19","20","1369","2","171","12.5","12.3"
"McDuffie","2020-07-20","45","1414","14","185","14.6","13.2"
"McDuffie","2020-07-21","21","1435","1","186","13.2","12.4"
"McDuffie","2020-07-22","28","1463","11","197","16.6","14.6"
"McDuffie","2020-07-23","35","1498","6","203","17.8","15.1"
"McDuffie","2020-07-24","26","1524","6","209","18.4","15.5"
"McDuffie","2020-07-25","21","1545","4","213","20.6","16.8"
"McDuffie","2020-07-26","23","1568","2","215","20.4","16.5"
"McDuffie","2020-07-27","28","1596","6","221","19.1","16.8"
"McDuffie","2020-07-28","39","1635","5","226","20.2","16.7"
"McDuffie","2020-07-29","23","1658","5","231","17.7","17.1"
"McDuffie","2020-07-30","18","1676","3","234","17.6","17.7"
"McDuffie","2020-07-31","28","1704","9","243","18.9","18.7"
"McDuffie","2020-08-01","17","1721","2","245","17.9","19.3"
"McDuffie","2020-08-02","12","1733","1","246","17.8","19.1"
"McDuffie","2020-08-03","20","1753","3","249","16.9","18"
"McDuffie","2020-08-04","35","1788","5","254","17.1","18.7"
"McDuffie","2020-08-05","34","1822","7","261","17","17.3"
"McDuffie","2020-08-06","23","1845","7","268","18.9","18.3"
"McDuffie","2020-08-07","20","1865","4","272","17.2","18.1"
"McDuffie","2020-08-08","24","1889","1","273","16.1","17"
"McDuffie","2020-08-09","26","1915","8","281","19.3","18.6"
"McDuffie","2020-08-10","23","1938","2","283","18.4","17.7"
"McDuffie","2020-08-11","34","1972","7","290","19.3","18.2"
"McDuffie","2020-08-12","23","1995","2","292","17.6","17.3"
"McDuffie","2020-08-13","24","2019","7","299","17.4","18.2"
"McDuffie","2020-08-14","27","2046","8","307","18.8","18"
"McDuffie","2020-08-15","18","2064","3","310","20.6","18.4"
"McDuffie","2020-08-16","10","2074","1","311","17.6","18.5"
"McDuffie","2020-08-17","32","2106","5","316","18.6","18.5"
"McDuffie","2020-08-18","12","2118","2","318","18.1","18.7"
"McDuffie","2020-08-19","20","2138","7","325","21.8","19.7"
"McDuffie","2020-08-20","25","2163","4","329","19.9","18.7"
"McDuffie","2020-08-21","26","2189","1","330","16.3","17.5"
"McDuffie","2020-08-22","9","2198","1","331","15.5","18"
"McDuffie","2020-08-23","13","2211","3","334","17.3","17.5"
"McDuffie","2020-08-24","38","2249","8","342","18.1","18.4"
"McDuffie","2020-08-25","23","2272","5","347","18.8","18.4"
"McDuffie","2020-08-26","21","2293","3","350","15.9","18.8"
"McDuffie","2020-08-27","16","2309","2","352","15.4","17.7"
"McDuffie","2020-08-28","38","2347","10","362","18.6","17.4"
"McDuffie","2020-08-29","13","2360","3","365","20.3","17.9"
"McDuffie","2020-08-30","19","2379","2","367","18.5","17.9"
"McDuffie","2020-08-31","13","2392","2","369","17.7","17.9"
"McDuffie","2020-09-01","24","2416","2","371","15.8","17.3"
"McDuffie","2020-09-02","33","2449","0","371","13.7","14.8"
"McDuffie","2020-09-03","22","2471","6","377","15.8","15.6"
"McDuffie","2020-09-04","23","2494","5","382","15.2","16.9"
"McDuffie","2020-09-05","14","2508","2","384","13.9","17.1"
"McDuffie","2020-09-06","8","2516","0","384","12.4","15.5"
"McDuffie","2020-09-07","14","2530","1","385","11.3","14.5"
"McDuffie","2020-09-08","21","2551","9","394","16.2","16"
"McDuffie","2020-09-09","26","2577","3","397","17.8","15.8"
"McDuffie","2020-09-10","30","2607","2","399","14.9","15.4"
"McDuffie","2020-09-11","17","2624","4","403","15.1","15.2"
"McDuffie","2020-09-12","28","2652","4","407","15.1","14.5"
"McDuffie","2020-09-13","12","2664","1","408","16.3","14.4"
"McDuffie","2020-09-14","27","2691","2","410","16.4","13.8"
"McDuffie","2020-09-15","30","2721","2","412","11.2","13.7"
"McDuffie","2020-09-16","15","2736","1","413","10.5","14.2"
"McDuffie","2020-09-17","17","2753","0","413","9.6","12.2"
"McDuffie","2020-09-18","42","2795","2","415","6.9","11"
"McDuffie","2020-09-19","21","2816","1","416","5.5","10.3"
"McDuffie","2020-09-20","15","2831","0","416","4.3","10.3"
"McDuffie","2020-09-21","30","2861","1","417","3.7","10.1"
"McDuffie","2020-09-22","28","2889","1","418","3.3","7.3"
"McDuffie","2020-09-23","25","2914","0","418","2.3","6.4"
"McDuffie","2020-09-24","19","2933","5","423","6.1","7.8"
"McDuffie","2020-09-25","19","2952","2","425","6.9","6.9"
"McDuffie","2020-09-26","19","2971","2","427","7.8","6.6"
"McDuffie","2020-09-27","6","2977","0","427","7.8","6"
"McDuffie","2020-09-28","26","3003","2","429","8.4","6.1"
"McDuffie","2020-09-29","10","3013","3","432","12.2","7.7"
"McDuffie","2020-09-30","30","3043","1","433","12.6","7.5"
"McDuffie","2020-10-01","29","3072","4","437","10.8","8.5"
"McDuffie","2020-10-02","31","3103","0","437","9.3","8.1"
"McDuffie","2020-10-03","13","3116","3","440","11.1","9.4"
"McDuffie","2020-10-04","15","3131","1","441","12.1","9.9"
"McDuffie","2020-10-05","38","3169","6","447","13.2","10.8"
"McDuffie","2020-10-06","39","3208","0","447","9","10.6"
"McDuffie","2020-10-07","29","3237","3","450","10","11.3"
"McDuffie","2020-10-08","20","3257","0","450","8","9.4"
"McDuffie","2020-10-09","42","3299","4","454","9.3","9.3"
"McDuffie","2020-10-10","17","3316","1","455","6.9","9"
"McDuffie","2020-10-11","15","3331","1","456","6.9","9.5"
"McDuffie","2020-10-12","33","3364","0","456","4.6","8.9"
"McDuffie","2020-10-13","20","3384","5","461","8.2","8.6"
"McDuffie","2020-10-14","21","3405","0","461","6.7","8.3"
"McDuffie","2020-10-15","18","3423","5","466","10.7","9.3"
"McDuffie","2020-10-16","44","3467","1","467","9.7","9.5"
"McDuffie","2020-10-17","21","3488","1","468","9.5","8.2"
"McDuffie","2020-10-18","13","3501","1","469","9.6","8.3"
"McDuffie","2020-10-19","29","3530","2","471","10.6","7.6"
"McDuffie","2020-10-20","27","3557","1","472","7.6","7.9"
"McDuffie","2020-10-21","42","3599","4","476","8.9","7.8"
"McDuffie","2020-10-22","26","3625","1","477","5.5","8.1"
"McDuffie","2020-10-23","37","3662","4","481","6.7","8.2"
"McDuffie","2020-10-24","17","3679","3","484","8.6","9"
"McDuffie","2020-10-25","6","3685","0","484","7.5","8.6"
"McDuffie","2020-10-26","43","3728","9","493","9.5","10.1"
"McDuffie","2020-10-27","23","3751","1","494","9.6","8.6"
"McDuffie","2020-10-28","38","3789","6","500","10.5","9.7"
"McDuffie","2020-10-29","23","3812","4","504","12.4","9"
"McDuffie","2020-10-30","50","3862","9","513","13.4","10.1"
"McDuffie","2020-10-31","12","3874","2","515","13.3","10.9"
"McDuffie","2020-11-01","12","3886","0","515","13.3","10.4"
"McDuffie","2020-11-02","60","3946","8","523","12.2","10.9"
"McDuffie","2020-11-03","31","3977","1","524","12.1","10.8"
"McDuffie","2020-11-04","18","3995","1","525","10.6","10.5"
"McDuffie","2020-11-05","36","4031","7","532","10.9","11.7"
"McDuffie","2020-11-06","57","4088","6","538","9.8","11.6"
"McDuffie","2020-11-07","19","4107","2","540","8.9","11.1"
"McDuffie","2020-11-08","10","4117","3","543","13.2","13.3"
"McDuffie","2020-11-09","38","4155","4","547","12.8","12.5"
"McDuffie","2020-11-10","35","4190","2","549","13.2","12.6"
"McDuffie","2020-11-11","30","4220","3","552","13.8","12.2"
"McDuffie","2020-11-12","37","4257","0","552","11","11"
"McDuffie","2020-11-13","49","4306","2","554","10.1","10"
"McDuffie","2020-11-14","15","4321","3","557","11.5","10.2"
"McDuffie","2020-11-15","14","4335","1","558","8.2","10.7"
"McDuffie","2020-11-16","37","4372","6","564","9","10.9"
"McDuffie","2020-11-17","41","4413","6","570","10.3","11.7"
"McDuffie","2020-11-18","47","4460","5","575","10.4","12.1"
"McDuffie","2020-11-19","28","4488","1","576","10.9","11"
"McDuffie","2020-11-20","64","4552","3","579","11","10.6"
"McDuffie","2020-11-21","32","4584","1","580","8.6","10"
"McDuffie","2020-11-22","19","4603","0","580","7.6","7.9"
"McDuffie","2020-11-23","21","4624","0","580","5.2","7.1"
"McDuffie","2020-11-24","35","4659","1","581","3.6","6.9"
"McDuffie","2020-11-25","27","4686","3","584","3.6","7"
"McDuffie","2020-11-26","5","4691","0","584","3.1","7"
"McDuffie","2020-11-27","19","4710","3","587","4.7","7.8"
"McDuffie","2020-11-28","29","4739","3","590","5.7","7.2"
"McDuffie","2020-11-29","9","4748","1","591","7.3","7.4"
"McDuffie","2020-11-30","32","4780","4","595","9.1","7.2"
"McDuffie","2020-12-01","50","4830","10","605","11.6","7.6"
"McDuffie","2020-12-02","38","4868","6","611","12.2","7.9"
"McDuffie","2020-12-03","47","4915","3","614","13.1","8.1"
"McDuffie","2020-12-04","52","4967","14","628","14.7","9.7"
"McDuffie","2020-12-05","25","4992","4","632","15.5","10.6"
"McDuffie","2020-12-06","16","5008","5","637","18.4","12.9"
"McDuffie","2020-12-07","53","5061","7","644","18.5","13.8"
"McDuffie","2020-12-08","46","5107","5","649","17.2","14.4"
"McDuffie","2020-12-09","36","5143","4","653","16.5","14.4"
"McDuffie","2020-12-10","34","5177","8","661","19","16.1"
"McDuffie","2020-12-11","44","5221","9","670","18.1","16.4"
"McDuffie","2020-12-12","27","5248","0","670","15.8","15.7"
"McDuffie","2020-12-13","12","5260","3","673","14.9","16.6"
"McDuffie","2020-12-14","37","5297","5","678","14.9","16.7"
"McDuffie","2020-12-15","44","5341","9","687","16.3","16.7"
"McDuffie","2020-12-16","34","5375","8","695","18.1","17.3"
"McDuffie","2020-12-17","37","5412","4","699","16.3","17.6"
"McDuffie","2020-12-18","34","5446","2","701","14.2","16.1"
"McDuffie","2020-12-19","21","5467","3","704","16.2","16"
"McDuffie","2020-12-20","22","5489","7","711","17.2","16"
"McDuffie","2020-12-21","47","5536","12","723","18.9","16.9"
"McDuffie","2020-12-22","36","5572","3","726","17.2","16.7"
"McDuffie","2020-12-23","35","5607","6","732","16.3","17.2"
"McDuffie","2020-12-24","19","5626","5","737","18.5","17.4"
"McDuffie","2020-12-25","5","5631","0","737","17.6","15.9"
"McDuffie","2020-12-26","23","5654","9","746","21.2","18.7"
"McDuffie","2020-12-27","18","5672","7","753","22.2","19.7"
"McDuffie","2020-12-28","49","5721","11","764","21.8","20.3"
"McDuffie","2020-12-29","47","5768","11","775","23.9","20.5"
"McDuffie","2020-12-30","49","5817","11","786","24.7","20.5"
"McDuffie","2020-12-31","32","5849","6","792","23.6","21"
"McDuffie","2021-01-01","4","5853","1","793","27.2","22.4"
"McDuffie","2021-01-02","28","5881","8","801","25.6","23.4"
"McDuffie","2021-01-03","11","5892","3","804","24","23.1"
"McDuffie","2021-01-04","31","5923","12","816","26.3","24"
"McDuffie","2021-01-05","77","6000","28","844","28.2","26"
"McDuffie","2021-01-06","60","6060","16","860","28.8","26.7"
"McDuffie","2021-01-07","72","6132","26","886","31.2","27.4"
"McDuffie","2021-01-08","51","6183","15","901","31.9","29.5"
"McDuffie","2021-01-09","41","6224","14","915","32.7","29.2"
"McDuffie","2021-01-10","33","6257","9","924","32.7","28.3"
"McDuffie","2021-01-11","60","6317","16","940","30.9","28.6"
"McDuffie","2021-01-12","71","6388","19","959","29.6","28.9"
"McDuffie","2021-01-13","65","6453","18","977","29.7","29.2"
"McDuffie","2021-01-14","49","6502","13","990","28.4","29.8"
"McDuffie","2021-01-15","61","6563","12","1002","27","29.4"
"McDuffie","2021-01-16","44","6607","10","1012","25.3","29"
"McDuffie","2021-01-17","25","6632","6","1018","24.9","28.8"
"McDuffie","2021-01-18","56","6688","15","1033","24.9","27.9"
"McDuffie","2021-01-19","62","6750","15","1048","24.5","27"
"McDuffie","2021-01-20","49","6799","14","1062","24.6","27.2"
"McDuffie","2021-01-21","48","6847","10","1072","23.8","26.1"
"McDuffie","2021-01-22","54","6901","18","1090","25.8","26.4"
"McDuffie","2021-01-23","30","6931","6","1096","25.4","25.4"
"McDuffie","2021-01-24","34","6965","13","1109","27.4","26.1"
"McDuffie","2021-01-25","98","7063","24","1133","27.1","26"
"McDuffie","2021-01-26","61","7124","14","1147","26.9","25.7"
"McDuffie","2021-01-27","56","7180","9","1156","25.1","24.9"
"McDuffie","2021-01-28","45","7225","9","1165","25","24.4"
"McDuffie","2021-01-29","63","7288","7","1172","21.8","23.8"
"McDuffie","2021-01-30","18","7306","5","1177","22.9","24.2"
"McDuffie","2021-01-31","19","7325","4","1181","20.5","24"
"McDuffie","2021-02-01","55","7380","13","1194","20.4","23.7"
"McDuffie","2021-02-02","35","7415","5","1199","19.1","23"
"McDuffie","2021-02-03","43","7458","8","1207","19.5","22.3"
"McDuffie","2021-02-04","43","7501","9","1216","19.6","22.3"
"McDuffie","2021-02-05","38","7539","6","1222","20.3","21.1"
"McDuffie","2021-02-06","3","7542","0","1222","16.3","19.6"
"McDuffie","2021-02-07","0","7542","0","1222","13.3","16.9"
"McDuffie","2021-02-08","0","7542","0","1222","9.9","15.2"
"McIntosh","2020-02-01","0","0","0","0",".","."
"McIntosh","2020-02-02","0","0","0","0",".","."
"McIntosh","2020-02-03","0","0","0","0",".","."
"McIntosh","2020-02-04","0","0","0","0",".","."
"McIntosh","2020-02-05","0","0","0","0",".","."
"McIntosh","2020-02-06","0","0","0","0",".","."
"McIntosh","2020-02-07","0","0","0","0","0","."
"McIntosh","2020-02-08","0","0","0","0","0","."
"McIntosh","2020-02-09","0","0","0","0","0","."
"McIntosh","2020-02-10","0","0","0","0","0","."
"McIntosh","2020-02-11","0","0","0","0","0","."
"McIntosh","2020-02-12","0","0","0","0","0","."
"McIntosh","2020-02-13","0","0","0","0","0","."
"McIntosh","2020-02-14","0","0","0","0","0","0"
"McIntosh","2020-02-15","0","0","0","0","0","0"
"McIntosh","2020-02-16","0","0","0","0","0","0"
"McIntosh","2020-02-17","0","0","0","0","0","0"
"McIntosh","2020-02-18","0","0","0","0","0","0"
"McIntosh","2020-02-19","0","0","0","0","0","0"
"McIntosh","2020-02-20","0","0","0","0","0","0"
"McIntosh","2020-02-21","0","0","0","0","0","0"
"McIntosh","2020-02-22","0","0","0","0","0","0"
"McIntosh","2020-02-23","0","0","0","0","0","0"
"McIntosh","2020-02-24","0","0","0","0","0","0"
"McIntosh","2020-02-25","0","0","0","0","0","0"
"McIntosh","2020-02-26","0","0","0","0","0","0"
"McIntosh","2020-02-27","0","0","0","0","0","0"
"McIntosh","2020-02-28","0","0","0","0","0","0"
"McIntosh","2020-02-29","0","0","0","0","0","0"
"McIntosh","2020-03-01","0","0","0","0","0","0"
"McIntosh","2020-03-02","0","0","0","0","0","0"
"McIntosh","2020-03-03","0","0","0","0","0","0"
"McIntosh","2020-03-04","0","0","0","0","0","0"
"McIntosh","2020-03-05","0","0","0","0","0","0"
"McIntosh","2020-03-06","0","0","0","0","0","0"
"McIntosh","2020-03-07","0","0","0","0","0","0"
"McIntosh","2020-03-08","0","0","0","0","0","0"
"McIntosh","2020-03-09","0","0","0","0","0","0"
"McIntosh","2020-03-10","0","0","0","0","0","0"
"McIntosh","2020-03-11","0","0","0","0","0","0"
"McIntosh","2020-03-12","0","0","0","0","0","0"
"McIntosh","2020-03-13","0","0","0","0","0","0"
"McIntosh","2020-03-14","0","0","0","0","0","0"
"McIntosh","2020-03-15","0","0","0","0","0","0"
"McIntosh","2020-03-16","2","2","0","0","0","0"
"McIntosh","2020-03-17","1","3","0","0","0","0"
"McIntosh","2020-03-18","0","3","0","0","0","0"
"McIntosh","2020-03-19","5","8","0","0","0","0"
"McIntosh","2020-03-20","4","12","0","0","0","0"
"McIntosh","2020-03-21","3","15","0","0","0","0"
"McIntosh","2020-03-22","0","15","0","0","0","0"
"McIntosh","2020-03-23","4","19","1","1","3.6","1.8"
"McIntosh","2020-03-24","4","23","0","1","3.6","1.8"
"McIntosh","2020-03-25","5","28","0","1","3.6","1.8"
"McIntosh","2020-03-26","2","30","0","1","3.6","1.8"
"McIntosh","2020-03-27","5","35","0","1","3.6","1.8"
"McIntosh","2020-03-28","0","35","0","1","3.6","1.8"
"McIntosh","2020-03-29","0","35","0","1","3.6","1.8"
"McIntosh","2020-03-30","5","40","0","1","0","1.8"
"McIntosh","2020-03-31","9","49","2","3","3.2","3.4"
"McIntosh","2020-04-01","7","56","0","3","3.2","3.4"
"McIntosh","2020-04-02","1","57","0","3","3.2","3.4"
"McIntosh","2020-04-03","4","61","1","4","6.7","5.2"
"McIntosh","2020-04-04","2","63","0","4","6.7","5.2"
"McIntosh","2020-04-05","0","63","0","4","6.7","5.2"
"McIntosh","2020-04-06","1","64","0","4","6.7","3.4"
"McIntosh","2020-04-07","1","65","0","4","3.6","3.4"
"McIntosh","2020-04-08","0","65","0","4","3.6","3.4"
"McIntosh","2020-04-09","0","65","0","4","3.6","3.4"
"McIntosh","2020-04-10","5","70","0","4","0","3.4"
"McIntosh","2020-04-11","0","70","0","4","0","3.4"
"McIntosh","2020-04-12","1","71","0","4","0","3.4"
"McIntosh","2020-04-13","0","71","0","4","0","3.4"
"McIntosh","2020-04-14","6","77","0","4","0","1.8"
"McIntosh","2020-04-15","4","81","2","6","7.1","5.4"
"McIntosh","2020-04-16","2","83","0","6","7.1","5.4"
"McIntosh","2020-04-17","3","86","0","6","7.1","3.6"
"McIntosh","2020-04-18","2","88","0","6","7.1","3.6"
"McIntosh","2020-04-19","1","89","0","6","7.1","3.6"
"McIntosh","2020-04-20","4","93","0","6","7.1","3.6"
"McIntosh","2020-04-21","5","98","0","6","7.1","3.6"
"McIntosh","2020-04-22","0","98","0","6","0","3.6"
"McIntosh","2020-04-23","10","108","0","6","0","3.6"
"McIntosh","2020-04-24","1","109","0","6","0","3.6"
"McIntosh","2020-04-25","0","109","0","6","0","3.6"
"McIntosh","2020-04-26","1","110","0","6","0","3.6"
"McIntosh","2020-04-27","2","112","0","6","0","3.6"
"McIntosh","2020-04-28","4","116","0","6","0","3.6"
"McIntosh","2020-04-29","2","118","0","6","0","0"
"McIntosh","2020-04-30","5","123","0","6","0","0"
"McIntosh","2020-05-01","3","126","0","6","0","0"
"McIntosh","2020-05-02","0","126","0","6","0","0"
"McIntosh","2020-05-03","0","126","0","6","0","0"
"McIntosh","2020-05-04","8","134","0","6","0","0"
"McIntosh","2020-05-05","47","181","1","7","0.3","0.2"
"McIntosh","2020-05-06","1","182","1","8","14.6","7.3"
"McIntosh","2020-05-07","5","187","0","8","14.6","7.3"
"McIntosh","2020-05-08","4","191","0","8","14.6","7.3"
"McIntosh","2020-05-09","5","196","0","8","14.6","7.3"
"McIntosh","2020-05-10","3","199","0","8","14.6","7.3"
"McIntosh","2020-05-11","23","222","0","8","14.6","7.3"
"McIntosh","2020-05-12","150","372","2","10","14.5","7.4"
"McIntosh","2020-05-13","2","374","0","10","0.2","7.4"
"McIntosh","2020-05-14","13","387","0","10","0.2","7.4"
"McIntosh","2020-05-15","5","392","0","10","0.2","7.4"
"McIntosh","2020-05-16","5","397","0","10","0.2","7.4"
"McIntosh","2020-05-17","1","398","0","10","0.2","7.4"
"McIntosh","2020-05-18","5","403","0","10","0.2","7.4"
"McIntosh","2020-05-19","41","444","0","10","0","7.2"
"McIntosh","2020-05-20","2","446","0","10","0","0.1"
"McIntosh","2020-05-21","2","448","0","10","0","0.1"
"McIntosh","2020-05-22","4","452","1","11","3.6","1.9"
"McIntosh","2020-05-23","1","453","0","11","3.6","1.9"
"McIntosh","2020-05-24","1","454","0","11","3.6","1.9"
"McIntosh","2020-05-25","5","459","0","11","3.6","1.9"
"McIntosh","2020-05-26","55","514","5","16","4.9","2.4"
"McIntosh","2020-05-27","4","518","0","16","4.9","2.4"
"McIntosh","2020-05-28","6","524","0","16","4.9","2.4"
"McIntosh","2020-05-29","6","530","0","16","1.3","2.4"
"McIntosh","2020-05-30","1","531","0","16","1.3","2.4"
"McIntosh","2020-05-31","1","532","0","16","1.3","2.4"
"McIntosh","2020-06-01","8","540","0","16","1.3","2.4"
"McIntosh","2020-06-02","4","544","0","16","0","2.4"
"McIntosh","2020-06-03","3","547","0","16","0","2.4"
"McIntosh","2020-06-04","9","556","0","16","0","2.4"
"McIntosh","2020-06-05","4","560","0","16","0","0.6"
"McIntosh","2020-06-06","2","562","0","16","0","0.6"
"McIntosh","2020-06-07","2","564","0","16","0","0.6"
"McIntosh","2020-06-08","16","580","1","17","0.9","1.1"
"McIntosh","2020-06-09","2","582","0","17","0.9","0.4"
"McIntosh","2020-06-10","11","593","0","17","0.9","0.4"
"McIntosh","2020-06-11","9","602","0","17","0.9","0.4"
"McIntosh","2020-06-12","7","609","0","17","0.9","0.4"
"McIntosh","2020-06-13","5","614","1","18","3.8","1.9"
"McIntosh","2020-06-14","5","619","0","18","3.8","1.9"
"McIntosh","2020-06-15","13","632","0","18","2.9","1.9"
"McIntosh","2020-06-16","2","634","0","18","2.9","1.9"
"McIntosh","2020-06-17","4","638","0","18","2.9","1.9"
"McIntosh","2020-06-18","3","641","0","18","2.9","1.9"
"McIntosh","2020-06-19","3","644","0","18","2.9","1.9"
"McIntosh","2020-06-20","0","644","0","18","0","1.9"
"McIntosh","2020-06-21","0","644","0","18","0","1.9"
"McIntosh","2020-06-22","13","657","2","20","2.2","2.5"
"McIntosh","2020-06-23","28","685","1","21","2.7","2.8"
"McIntosh","2020-06-24","19","704","2","23","4.2","3.5"
"McIntosh","2020-06-25","11","715","3","26","8.1","5.5"
"McIntosh","2020-06-26","8","723","2","28","11.7","7.3"
"McIntosh","2020-06-27","7","730","0","28","11.7","5.8"
"McIntosh","2020-06-28","2","732","1","29","18.8","9.4"
"McIntosh","2020-06-29","13","745","3","32","19.9","11.1"
"McIntosh","2020-06-30","27","772","1","33","19.9","11.3"
"McIntosh","2020-07-01","10","782","0","33","18.4","11.3"
"McIntosh","2020-07-02","8","790","2","35","18.1","13.1"
"McIntosh","2020-07-03","5","795","0","35","14.5","13.1"
"McIntosh","2020-07-04","3","798","0","35","14.5","13.1"
"McIntosh","2020-07-05","1","799","0","35","7.4","13.1"
"McIntosh","2020-07-06","6","805","1","36","6.5","13.2"
"McIntosh","2020-07-07","96","901","6","42","6.8","13.4"
"McIntosh","2020-07-08","19","920","1","43","7.6","13"
"McIntosh","2020-07-09","19","939","3","46","6.3","12.2"
"McIntosh","2020-07-10","17","956","0","46","6.3","10.4"
"McIntosh","2020-07-11","4","960","1","47","9.9","12.2"
"McIntosh","2020-07-12","4","964","2","49","17","12.2"
"McIntosh","2020-07-13","16","980","5","54","19.1","12.8"
"McIntosh","2020-07-14","84","1064","5","59","19","12.9"
"McIntosh","2020-07-15","17","1081","5","64","22.5","15"
"McIntosh","2020-07-16","69","1150","1","65","20.4","13.4"
"McIntosh","2020-07-17","13","1163","4","69","24.8","15.6"
"McIntosh","2020-07-18","10","1173","1","70","22.7","16.3"
"McIntosh","2020-07-19","11","1184","0","70","15.5","16.3"
"McIntosh","2020-07-20","20","1204","3","73","13.2","16.2"
"McIntosh","2020-07-21","70","1274","4","77","13.2","16.1"
"McIntosh","2020-07-22","22","1296","4","81","11.6","17"
"McIntosh","2020-07-23","71","1367","4","85","12.2","16.3"
"McIntosh","2020-07-24","22","1389","4","89","10.4","17.6"
"McIntosh","2020-07-25","8","1397","3","92","14.3","18.5"
"McIntosh","2020-07-26","1","1398","0","92","14.3","14.9"
"McIntosh","2020-07-27","28","1426","3","95","13.7","13.5"
"McIntosh","2020-07-28","77","1503","7","102","14.2","13.7"
"McIntosh","2020-07-29","21","1524","2","104","12.9","12.3"
"McIntosh","2020-07-30","58","1582","3","107","12.9","12.5"
"McIntosh","2020-07-31","18","1600","6","113","15","12.7"
"McIntosh","2020-08-01","12","1612","2","115","12.1","13.2"
"McIntosh","2020-08-02","10","1622","4","119","17.8","16.1"
"McIntosh","2020-08-03","23","1645","2","121","17.5","15.6"
"McIntosh","2020-08-04","85","1730","7","128","17.4","15.8"
"McIntosh","2020-08-05","17","1747","1","129","16.9","14.9"
"McIntosh","2020-08-06","72","1819","4","133","16.9","14.9"
"McIntosh","2020-08-07","23","1842","5","138","15.3","15.2"
"McIntosh","2020-08-08","11","1853","1","139","14.2","13.1"
"McIntosh","2020-08-09","11","1864","0","139","8.5","13.1"
"McIntosh","2020-08-10","22","1886","3","142","9.2","13.3"
"McIntosh","2020-08-11","79","1965","7","149","9.3","13.3"
"McIntosh","2020-08-12","25","1990","1","150","9","12.9"
"McIntosh","2020-08-13","55","2045","5","155","9.5","13.2"
"McIntosh","2020-08-14","14","2059","3","158","9.4","12.3"
"McIntosh","2020-08-15","9","2068","2","160","11.3","12.7"
"McIntosh","2020-08-16","6","2074","2","162","16.1","12.3"
"McIntosh","2020-08-17","19","2093","4","166","17.1","13.2"
"McIntosh","2020-08-18","69","2162","7","173","17.3","13.3"
"McIntosh","2020-08-19","27","2189","1","174","17.3","13.1"
"McIntosh","2020-08-20","50","2239","2","176","16.6","13"
"McIntosh","2020-08-21","15","2254","2","178","15.4","12.4"
"McIntosh","2020-08-22","7","2261","1","179","14.3","12.8"
"McIntosh","2020-08-23","10","2271","2","181","12.4","14.2"
"McIntosh","2020-08-24","18","2289","1","182","10.1","13.6"
"McIntosh","2020-08-25","43","2332","3","185","9.7","13.5"
"McIntosh","2020-08-26","26","2358","3","188","10.8","14"
"McIntosh","2020-08-27","30","2388","3","191","11.7","14.1"
"McIntosh","2020-08-28","20","2408","4","195","12.6","14"
"McIntosh","2020-08-29","15","2423","2","197","12.5","13.4"
"McIntosh","2020-08-30","6","2429","2","199","14.4","13.4"
"McIntosh","2020-08-31","9","2438","1","200","15.2","12.7"
"McIntosh","2020-09-01","53","2491","5","205","15.5","12.6"
"McIntosh","2020-09-02","24","2515","1","206","14.5","12.6"
"McIntosh","2020-09-03","37","2552","1","207","13.4","12.6"
"McIntosh","2020-09-04","12","2564","0","207","10.6","11.6"
"McIntosh","2020-09-05","7","2571","0","207","8.7","10.6"
"McIntosh","2020-09-06","6","2577","1","208","6.3","10.3"
"McIntosh","2020-09-07","13","2590","0","208","4.7","9.9"
"McIntosh","2020-09-08","44","2634","2","210","4","9.8"
"McIntosh","2020-09-09","20","2654","0","210","3.4","8.9"
"McIntosh","2020-09-10","36","2690","1","211","3.4","8.4"
"McIntosh","2020-09-11","16","2706","0","211","3.4","7"
"McIntosh","2020-09-12","10","2716","0","211","3.4","6.1"
"McIntosh","2020-09-13","9","2725","1","212","2.6","4.5"
"McIntosh","2020-09-14","26","2751","3","215","4.3","4.5"
"McIntosh","2020-09-15","26","2777","2","217","4.7","4.4"
"McIntosh","2020-09-16","14","2791","0","217","4.7","4.1"
"McIntosh","2020-09-17","41","2832","2","219","5","4.2"
"McIntosh","2020-09-18","11","2843","0","219","5","4.2"
"McIntosh","2020-09-19","11","2854","1","220","6.3","4.9"
"McIntosh","2020-09-20","3","2857","0","220","4.7","3.7"
"McIntosh","2020-09-21","10","2867","2","222","6","5.1"
"McIntosh","2020-09-22","33","2900","1","223","5.3","5"
"McIntosh","2020-09-23","12","2912","0","223","5.3","5"
"McIntosh","2020-09-24","36","2948","4","227","6.2","5.6"
"McIntosh","2020-09-25","6","2954","0","227","6.2","5.6"
"McIntosh","2020-09-26","10","2964","0","227","4.9","5.6"
"McIntosh","2020-09-27","4","2968","1","228","8.4","6.6"
"McIntosh","2020-09-28","11","2979","1","229","6.9","6.4"
"McIntosh","2020-09-29","17","2996","0","229","6.5","5.9"
"McIntosh","2020-09-30","2","2998","0","229","6.5","5.9"
"McIntosh","2020-10-01","28","3026","2","231","5.9","6"
"McIntosh","2020-10-02","6","3032","0","231","5.9","6"
"McIntosh","2020-10-03","12","3044","0","231","5.9","5.4"
"McIntosh","2020-10-04","5","3049","0","231","2.3","5.4"
"McIntosh","2020-10-05","16","3065","0","231","1","4"
"McIntosh","2020-10-06","26","3091","0","231","1","3.7"
"McIntosh","2020-10-07","14","3105","0","231","1","3.7"
"McIntosh","2020-10-08","30","3135","1","232","0.5","3.2"
"McIntosh","2020-10-09","17","3152","0","232","0.5","3.2"
"McIntosh","2020-10-10","18","3170","1","233","1.3","3.6"
"McIntosh","2020-10-11","3","3173","0","233","1.3","1.8"
"McIntosh","2020-10-12","14","3187","1","234","2.3","1.7"
"McIntosh","2020-10-13","28","3215","0","234","2.3","1.7"
"McIntosh","2020-10-14","11","3226","0","234","2.3","1.7"
"McIntosh","2020-10-15","22","3248","0","234","1.8","1.1"
"McIntosh","2020-10-16","14","3262","0","234","1.8","1.1"
"McIntosh","2020-10-17","9","3271","2","236","4.2","2.7"
"McIntosh","2020-10-18","4","3275","0","236","4.2","2.7"
"McIntosh","2020-10-19","11","3286","1","237","4.5","3.4"
"McIntosh","2020-10-20","35","3321","1","238","4.9","3.6"
"McIntosh","2020-10-21","18","3339","1","239","5.7","4"
"McIntosh","2020-10-22","11","3350","0","239","5.7","3.7"
"McIntosh","2020-10-23","16","3366","0","239","5.7","3.7"
"McIntosh","2020-10-24","9","3375","0","239","2.5","3.3"
"McIntosh","2020-10-25","11","3386","1","240","3.8","4"
"McIntosh","2020-10-26","18","3404","2","242","4.1","4.3"
"McIntosh","2020-10-27","34","3438","2","244","4.5","4.7"
"McIntosh","2020-10-28","9","3447","0","244","3.7","4.7"
"McIntosh","2020-10-29","14","3461","0","244","3.7","4.7"
"McIntosh","2020-10-30","8","3469","0","244","3.7","4.7"
"McIntosh","2020-10-31","9","3478","1","245","5.3","3.9"
"McIntosh","2020-11-01","1","3479","0","245","4","3.9"
"McIntosh","2020-11-02","10","3489","0","245","2.4","3.3"
"McIntosh","2020-11-03","31","3520","3","248","3","3.7"
"McIntosh","2020-11-04","19","3539","0","248","3","3.3"
"McIntosh","2020-11-05","20","3559","1","249","3.7","3.7"
"McIntosh","2020-11-06","12","3571","1","250","4.9","4.3"
"McIntosh","2020-11-07","11","3582","2","252","5.9","5.6"
"McIntosh","2020-11-08","7","3589","3","255","12","8"
"McIntosh","2020-11-09","20","3609","1","256","12.7","7.6"
"McIntosh","2020-11-10","9","3618","0","256","11.3","7.2"
"McIntosh","2020-11-11","15","3633","1","257","12.3","7.6"
"McIntosh","2020-11-12","18","3651","0","257","11.6","7.6"
"McIntosh","2020-11-13","12","3663","4","261","15.1","10"
"McIntosh","2020-11-14","5","3668","0","261","12.6","9.2"
"McIntosh","2020-11-15","3","3671","0","261","6.4","9.2"
"McIntosh","2020-11-16","12","3683","1","262","6.9","9.8"
"McIntosh","2020-11-17","48","3731","6","268","8.7","10"
"McIntosh","2020-11-18","25","3756","4","272","10","11.2"
"McIntosh","2020-11-19","22","3778","0","272","10","10.8"
"McIntosh","2020-11-20","15","3793","2","274","7.2","11.2"
"McIntosh","2020-11-21","2","3795","0","274","7.2","9.9"
"McIntosh","2020-11-22","4","3799","0","274","7.2","6.8"
"McIntosh","2020-11-23","15","3814","2","276","7.9","7.4"
"McIntosh","2020-11-24","17","3831","4","280","9.5","9.1"
"McIntosh","2020-11-25","14","3845","0","280","7.2","8.6"
"McIntosh","2020-11-26","8","3853","1","281","9","9.5"
"McIntosh","2020-11-27","13","3866","1","282","8.2","7.7"
"McIntosh","2020-11-28","9","3875","0","282","8.2","7.7"
"McIntosh","2020-11-29","3","3878","1","283","12.9","10"
"McIntosh","2020-11-30","11","3889","0","283","11","9.4"
"McIntosh","2020-12-01","45","3934","3","286","8.6","9"
"McIntosh","2020-12-02","25","3959","5","291","11.5","9.3"
"McIntosh","2020-12-03","13","3972","1","292","10.8","9.9"
"McIntosh","2020-12-04","13","3985","0","292","9.7","8.9"
"McIntosh","2020-12-05","4","3989","0","292","9.7","8.9"
"McIntosh","2020-12-06","9","3998","3","295","9.7","11.3"
"McIntosh","2020-12-07","22","4020","1","296","10.3","10.7"
"McIntosh","2020-12-08","56","4076","7","303","11.2","9.9"
"McIntosh","2020-12-09","17","4093","0","303","8.3","9.9"
"McIntosh","2020-12-10","6","4099","1","304","9.6","10.2"
"McIntosh","2020-12-11","14","4113","2","306","11.6","10.6"
"McIntosh","2020-12-12","13","4126","4","310","16","12.8"
"McIntosh","2020-12-13","3","4129","1","311","16","12.8"
"McIntosh","2020-12-14","16","4145","0","311","15.4","12.8"
"McIntosh","2020-12-15","43","4188","1","312","13.9","12.5"
"McIntosh","2020-12-16","10","4198","0","312","13.9","11.1"
"McIntosh","2020-12-17","22","4220","2","314","12.8","11.2"
"McIntosh","2020-12-18","14","4234","1","315","11.8","11.7"
"McIntosh","2020-12-19","22","4256","5","320","10.7","13.3"
"McIntosh","2020-12-20","6","4262","2","322","10.7","13.3"
"McIntosh","2020-12-21","27","4289","3","325","12.2","13.8"
"McIntosh","2020-12-22","69","4358","7","332","13.4","13.6"
"McIntosh","2020-12-23","26","4384","1","333","13.9","13.9"
"McIntosh","2020-12-24","10","4394","1","334","14","13.4"
"McIntosh","2020-12-25","2","4396","0","334","13","12.4"
"McIntosh","2020-12-26","11","4407","1","335","11.1","10.9"
"McIntosh","2020-12-27","7","4414","2","337","10.4","10.5"
"McIntosh","2020-12-28","23","4437","4","341","11.3","11.8"
"McIntosh","2020-12-29","88","4525","8","349","11.1","12.3"
"McIntosh","2020-12-30","31","4556","4","353","12.4","13.2"
"McIntosh","2020-12-31","12","4568","0","353","11","12.5"
"McIntosh","2021-01-01","4","4572","1","354","14.6","13.8"
"McIntosh","2021-01-02","13","4585","1","355","14.4","12.7"
"McIntosh","2021-01-03","4","4589","2","357","17.4","13.9"
"McIntosh","2021-01-04","18","4607","1","358","15.7","13.5"
"McIntosh","2021-01-05","115","4722","9","367","15.6","13.4"
"McIntosh","2021-01-06","20","4742","1","368","14.4","13.4"
"McIntosh","2021-01-07","26","4768","3","371","16.1","13.5"
"McIntosh","2021-01-08","26","4794","4","375","14.7","14.6"
"McIntosh","2021-01-09","10","4804","1","376","15","14.7"
"McIntosh","2021-01-10","3","4807","0","376","7.9","12.7"
"McIntosh","2021-01-11","23","4830","3","379","9","12.4"
"McIntosh","2021-01-12","66","4896","10","389","10","12.8"
"McIntosh","2021-01-13","15","4911","0","389","9.3","11.9"
"McIntosh","2021-01-14","19","4930","1","390","8.4","12.2"
"McIntosh","2021-01-15","18","4948","0","390","6.2","10.5"
"McIntosh","2021-01-16","18","4966","2","392","6.4","10.7"
"McIntosh","2021-01-17","5","4971","0","392","6.4","7.1"
"McIntosh","2021-01-18","26","4997","1","393","5.1","7"
"McIntosh","2021-01-19","46","5043","4","397","4.1","7.1"
"McIntosh","2021-01-20","17","5060","2","399","5.8","7.6"
"McIntosh","2021-01-21","33","5093","1","400","5.5","6.9"
"McIntosh","2021-01-22","22","5115","3","403","7.4","6.8"
"McIntosh","2021-01-23","15","5130","0","403","5.9","6.1"
"McIntosh","2021-01-24","6","5136","3","406","13","9.7"
"McIntosh","2021-01-25","20","5156","0","406","12.4","8.7"
"McIntosh","2021-01-26","74","5230","8","414","12.7","8.4"
"McIntosh","2021-01-27","13","5243","2","416","13.3","9.5"
"McIntosh","2021-01-28","23","5266","1","417","13.5","9.5"
"McIntosh","2021-01-29","23","5289","2","419","12.7","10.1"
"McIntosh","2021-01-30","17","5306","4","423","16.1","11"
"McIntosh","2021-01-31","13","5319","4","427","13.4","13.2"
"McIntosh","2021-02-01","25","5344","1","428","13.9","13.2"
"McIntosh","2021-02-02","29","5373","3","431","13.9","13.3"
"McIntosh","2021-02-03","17","5390","1","432","12.5","12.9"
"McIntosh","2021-02-04","32","5422","1","433","12.3","12.9"
"McIntosh","2021-02-05","18","5440","0","433","11.1","11.9"
"McIntosh","2021-02-06","2","5442","0","433","7.7","11.9"
"McIntosh","2021-02-07","0","5442","0","433","3.3","8.3"
"McIntosh","2021-02-08","0","5442","0","433","2.8","8.3"
"Meriwether","2020-02-01","0","0","0","0",".","."
"Meriwether","2020-02-02","0","0","0","0",".","."
"Meriwether","2020-02-03","0","0","0","0",".","."
"Meriwether","2020-02-04","0","0","0","0",".","."
"Meriwether","2020-02-05","0","0","0","0",".","."
"Meriwether","2020-02-06","0","0","0","0",".","."
"Meriwether","2020-02-07","0","0","0","0","0","."
"Meriwether","2020-02-08","0","0","0","0","0","."
"Meriwether","2020-02-09","0","0","0","0","0","."
"Meriwether","2020-02-10","0","0","0","0","0","."
"Meriwether","2020-02-11","0","0","0","0","0","."
"Meriwether","2020-02-12","0","0","0","0","0","."
"Meriwether","2020-02-13","0","0","0","0","0","."
"Meriwether","2020-02-14","0","0","0","0","0","0"
"Meriwether","2020-02-15","0","0","0","0","0","0"
"Meriwether","2020-02-16","0","0","0","0","0","0"
"Meriwether","2020-02-17","0","0","0","0","0","0"
"Meriwether","2020-02-18","0","0","0","0","0","0"
"Meriwether","2020-02-19","0","0","0","0","0","0"
"Meriwether","2020-02-20","0","0","0","0","0","0"
"Meriwether","2020-02-21","0","0","0","0","0","0"
"Meriwether","2020-02-22","0","0","0","0","0","0"
"Meriwether","2020-02-23","0","0","0","0","0","0"
"Meriwether","2020-02-24","0","0","0","0","0","0"
"Meriwether","2020-02-25","0","0","0","0","0","0"
"Meriwether","2020-02-26","0","0","0","0","0","0"
"Meriwether","2020-02-27","0","0","0","0","0","0"
"Meriwether","2020-02-28","0","0","0","0","0","0"
"Meriwether","2020-02-29","0","0","0","0","0","0"
"Meriwether","2020-03-01","0","0","0","0","0","0"
"Meriwether","2020-03-02","0","0","0","0","0","0"
"Meriwether","2020-03-03","0","0","0","0","0","0"
"Meriwether","2020-03-04","0","0","0","0","0","0"
"Meriwether","2020-03-05","0","0","0","0","0","0"
"Meriwether","2020-03-06","0","0","0","0","0","0"
"Meriwether","2020-03-07","0","0","0","0","0","0"
"Meriwether","2020-03-08","0","0","0","0","0","0"
"Meriwether","2020-03-09","0","0","0","0","0","0"
"Meriwether","2020-03-10","0","0","0","0","0","0"
"Meriwether","2020-03-11","0","0","0","0","0","0"
"Meriwether","2020-03-12","0","0","0","0","0","0"
"Meriwether","2020-03-13","0","0","0","0","0","0"
"Meriwether","2020-03-14","2","2","1","1","7.1","3.6"
"Meriwether","2020-03-15","0","2","0","1","7.1","3.6"
"Meriwether","2020-03-16","2","4","0","1","7.1","3.6"
"Meriwether","2020-03-17","2","6","0","1","7.1","3.6"
"Meriwether","2020-03-18","0","6","0","1","7.1","3.6"
"Meriwether","2020-03-19","5","11","3","4","15.7","7.9"
"Meriwether","2020-03-20","4","15","1","5","19.3","9.6"
"Meriwether","2020-03-21","2","17","0","5","12.1","9.6"
"Meriwether","2020-03-22","3","20","1","6","16.9","12"
"Meriwether","2020-03-23","3","23","0","6","16.9","12"
"Meriwether","2020-03-24","5","28","1","7","19.8","13.5"
"Meriwether","2020-03-25","6","34","0","7","19.8","13.5"
"Meriwether","2020-03-26","4","38","2","9","18.3","17"
"Meriwether","2020-03-27","11","49","1","10","16.1","17.7"
"Meriwether","2020-03-28","5","54","1","11","18.9","15.5"
"Meriwether","2020-03-29","1","55","0","11","14.2","15.5"
"Meriwether","2020-03-30","13","68","4","15","18.6","17.7"
"Meriwether","2020-03-31","8","76","1","16","17.5","18.6"
"Meriwether","2020-04-01","4","80","0","16","17.5","18.6"
"Meriwether","2020-04-02","4","84","2","18","17.5","17.9"
"Meriwether","2020-04-03","4","88","0","18","16.2","16.1"
"Meriwether","2020-04-04","2","90","0","18","13.3","16.1"
"Meriwether","2020-04-05","0","90","0","18","13.3","13.7"
"Meriwether","2020-04-06","3","93","0","18","8.9","13.7"
"Meriwether","2020-04-07","7","100","1","19","9.2","13.3"
"Meriwether","2020-04-08","6","106","0","19","9.2","13.3"
"Meriwether","2020-04-09","5","111","1","20","4.9","11.2"
"Meriwether","2020-04-10","8","119","1","21","6.7","11.4"
"Meriwether","2020-04-11","2","121","0","21","6.7","10"
"Meriwether","2020-04-12","3","124","0","21","6.7","10"
"Meriwether","2020-04-13","10","134","3","24","11","9.9"
"Meriwether","2020-04-14","13","147","1","25","10","9.6"
"Meriwether","2020-04-15","14","161","2","27","12.1","10.6"
"Meriwether","2020-04-16","8","169","3","30","14.6","9.7"
"Meriwether","2020-04-17","11","180","0","30","12.8","9.7"
"Meriwether","2020-04-18","5","185","0","30","12.8","9.7"
"Meriwether","2020-04-19","2","187","0","30","12.8","9.7"
"Meriwether","2020-04-20","20","207","2","32","9.9","10.4"
"Meriwether","2020-04-21","15","222","3","35","11.7","10.9"
"Meriwether","2020-04-22","14","236","1","36","10.7","11.4"
"Meriwether","2020-04-23","12","248","1","37","6.5","10.5"
"Meriwether","2020-04-24","17","265","0","37","6.5","9.6"
"Meriwether","2020-04-25","5","270","0","37","6.5","9.6"
"Meriwether","2020-04-26","4","274","0","37","6.5","9.6"
"Meriwether","2020-04-27","9","283","0","37","5.1","7.5"
"Meriwether","2020-04-28","10","293","0","37","2.2","6.9"
"Meriwether","2020-04-29","12","305","0","37","1.2","5.9"
"Meriwether","2020-04-30","17","322","1","38","0.8","3.7"
"Meriwether","2020-05-01","11","333","1","39","2.1","4.3"
"Meriwether","2020-05-02","4","337","0","39","2.1","4.3"
"Meriwether","2020-05-03","5","342","0","39","2.1","4.3"
"Meriwether","2020-05-04","9","351","0","39","2.1","3.6"
"Meriwether","2020-05-05","10","361","2","41","5","3.6"
"Meriwether","2020-05-06","10","371","1","42","6.4","3.8"
"Meriwether","2020-05-07","14","385","1","43","6.6","3.7"
"Meriwether","2020-05-08","7","392","0","43","5.3","3.7"
"Meriwether","2020-05-09","6","398","1","44","7.7","4.9"
"Meriwether","2020-05-10","7","405","0","44","7.7","4.9"
"Meriwether","2020-05-11","18","423","2","46","9.3","5.7"
"Meriwether","2020-05-12","17","440","0","46","6.4","5.7"
"Meriwether","2020-05-13","12","452","0","46","5","5.7"
"Meriwether","2020-05-14","128","580","0","46","4","5.3"
"Meriwether","2020-05-15","179","759","3","49","4.2","4.8"
"Meriwether","2020-05-16","6","765","0","49","1.8","4.8"
"Meriwether","2020-05-17","5","770","0","49","1.8","4.8"
"Meriwether","2020-05-18","21","791","0","49","0.2","4.8"
"Meriwether","2020-05-19","27","818","1","50","0.8","3.6"
"Meriwether","2020-05-20","32","850","2","52","1.7","3.3"
"Meriwether","2020-05-21","12","862","0","52","1.7","2.8"
"Meriwether","2020-05-22","13","875","0","52","1.4","2.8"
"Meriwether","2020-05-23","6","881","1","53","3.8","2.8"
"Meriwether","2020-05-24","8","889","1","54","5.6","3.7"
"Meriwether","2020-05-25","7","896","1","55","7.6","3.9"
"Meriwether","2020-05-26","18","914","2","57","8.7","4.7"
"Meriwether","2020-05-27","25","939","3","60","9.5","5.6"
"Meriwether","2020-05-28","17","956","0","60","9.5","5.6"
"Meriwether","2020-05-29","8","964","1","61","11.3","6.4"
"Meriwether","2020-05-30","7","971","1","62","11","7.4"
"Meriwether","2020-05-31","10","981","0","62","9.2","7.4"
"Meriwether","2020-06-01","19","1000","3","65","9.4","8.5"
"Meriwether","2020-06-02","20","1020","2","67","9.2","9"
"Meriwether","2020-06-03","18","1038","1","68","8.3","8.9"
"Meriwether","2020-06-04","24","1062","2","70","9.5","9.5"
"Meriwether","2020-06-05","14","1076","2","72","9.7","10.5"
"Meriwether","2020-06-06","15","1091","1","73","8.7","9.8"
"Meriwether","2020-06-07","1","1092","0","73","8.7","8.9"
"Meriwether","2020-06-08","28","1120","0","73","6.4","7.9"
"Meriwether","2020-06-09","14","1134","2","75","7","8.1"
"Meriwether","2020-06-10","30","1164","2","77","7.2","7.7"
"Meriwether","2020-06-11","30","1194","1","78","6.5","8"
"Meriwether","2020-06-12","19","1213","3","81","6.7","8.2"
"Meriwether","2020-06-13","10","1223","2","83","8.6","8.6"
"Meriwether","2020-06-14","6","1229","0","83","8.6","8.6"
"Meriwether","2020-06-15","24","1253","6","89","12.2","9.3"
"Meriwether","2020-06-16","30","1283","5","94","12.5","9.8"
"Meriwether","2020-06-17","39","1322","4","98","13","10.1"
"Meriwether","2020-06-18","30","1352","4","102","14.4","10.4"
"Meriwether","2020-06-19","22","1374","2","104","13.5","10.1"
"Meriwether","2020-06-20","12","1386","0","104","10.6","9.6"
"Meriwether","2020-06-21","8","1394","1","105","12.4","10.5"
"Meriwether","2020-06-22","38","1432","4","109","10.3","11.2"
"Meriwether","2020-06-23","22","1454","4","113","10.6","11.5"
"Meriwether","2020-06-24","46","1500","4","117","10.3","11.7"
"Meriwether","2020-06-25","31","1531","4","121","10.3","12.4"
"Meriwether","2020-06-26","25","1556","3","124","10.7","12.1"
"Meriwether","2020-06-27","11","1567","2","126","13.3","12"
"Meriwether","2020-06-28","9","1576","1","127","13.1","12.7"
"Meriwether","2020-06-29","34","1610","4","131","13.3","11.8"
"Meriwether","2020-06-30","46","1656","8","139","13.1","11.9"
"Meriwether","2020-07-01","47","1703","12","151","15.6","12.9"
"Meriwether","2020-07-02","31","1734","8","159","17.4","13.8"
"Meriwether","2020-07-03","16","1750","1","160","16.6","13.6"
"Meriwether","2020-07-04","14","1764","1","161","15","14.1"
"Meriwether","2020-07-05","14","1778","1","162","14.4","13.8"
"Meriwether","2020-07-06","26","1804","3","165","14.4","13.8"
"Meriwether","2020-07-07","32","1836","2","167","12.8","13"
"Meriwether","2020-07-08","43","1879","5","172","10.8","13.2"
"Meriwether","2020-07-09","34","1913","5","177","9.2","13.3"
"Meriwether","2020-07-10","38","1951","10","187","12.1","14.3"
"Meriwether","2020-07-11","17","1968","8","195","17.8","16.4"
"Meriwether","2020-07-12","17","1985","3","198","19.3","16.9"
"Meriwether","2020-07-13","36","2021","14","212","23.2","18.8"
"Meriwether","2020-07-14","28","2049","5","217","24.9","18.8"
"Meriwether","2020-07-15","32","2081","4","221","25","17.9"
"Meriwether","2020-07-16","26","2107","1","222","23.4","16.3"
"Meriwether","2020-07-17","20","2127","3","225","21.8","17"
"Meriwether","2020-07-18","16","2143","5","230","19.6","18.7"
"Meriwether","2020-07-19","11","2154","2","232","19.6","19.5"
"Meriwether","2020-07-20","39","2193","5","237","15.9","19.6"
"Meriwether","2020-07-21","19","2212","4","241","16.4","20.6"
"Meriwether","2020-07-22","17","2229","2","243","16.3","20.6"
"Meriwether","2020-07-23","29","2258","6","249","18.7","21.1"
"Meriwether","2020-07-24","26","2284","2","251","17.6","19.7"
"Meriwether","2020-07-25","18","2302","2","253","14.8","17.2"
"Meriwether","2020-07-26","19","2321","0","253","12.2","15.9"
"Meriwether","2020-07-27","143","2464","5","258","10.8","13.4"
"Meriwether","2020-07-28","23","2487","0","258","7.8","12.1"
"Meriwether","2020-07-29","36","2523","2","260","6.9","11.6"
"Meriwether","2020-07-30","22","2545","0","260","4","11.3"
"Meriwether","2020-07-31","35","2580","0","260","2.9","10.3"
"Meriwether","2020-08-01","13","2593","0","260","1.3","8"
"Meriwether","2020-08-02","7","2600","1","261","3.3","7.7"
"Meriwether","2020-08-03","32","2632","5","266","5.1","7.9"
"Meriwether","2020-08-04","27","2659","3","269","6.7","7.2"
"Meriwether","2020-08-05","31","2690","5","274","8.2","7.5"
"Meriwether","2020-08-06","19","2709","3","277","10.4","7.2"
"Meriwether","2020-08-07","18","2727","2","279","12","7.4"
"Meriwether","2020-08-08","9","2736","1","280","13.6","7.4"
"Meriwether","2020-08-09","9","2745","1","281","13.1","8.2"
"Meriwether","2020-08-10","103","2848","5","286","11.6","8.3"
"Meriwether","2020-08-11","29","2877","3","289","11.5","9.1"
"Meriwether","2020-08-12","26","2903","5","294","11.9","10.1"
"Meriwether","2020-08-13","28","2931","5","299","12.2","11.3"
"Meriwether","2020-08-14","41","2972","9","308","13.8","12.9"
"Meriwether","2020-08-15","12","2984","1","309","13.4","13.5"
"Meriwether","2020-08-16","16","3000","1","310","12.7","12.9"
"Meriwether","2020-08-17","52","3052","3","313","12.8","12.2"
"Meriwether","2020-08-18","34","3086","5","318","13.4","12.5"
"Meriwether","2020-08-19","28","3114","1","319","11.2","11.6"
"Meriwether","2020-08-20","34","3148","7","326","11.6","11.9"
"Meriwether","2020-08-21","32","3180","8","334","12","12.9"
"Meriwether","2020-08-22","12","3192","2","336","13.2","13.3"
"Meriwether","2020-08-23","15","3207","1","337","13.3","13"
"Meriwether","2020-08-24","95","3302","4","341","13.1","12.9"
"Meriwether","2020-08-25","57","3359","3","344","11.7","12.6"
"Meriwether","2020-08-26","29","3388","4","348","13.2","12.2"
"Meriwether","2020-08-27","24","3412","2","350","11.4","11.5"
"Meriwether","2020-08-28","25","3437","3","353","9.6","10.8"
"Meriwether","2020-08-29","10","3447","1","354","8.6","10.9"
"Meriwether","2020-08-30","10","3457","4","358","13.4","13.3"
"Meriwether","2020-08-31","33","3490","5","363","14.9","14"
"Meriwether","2020-09-01","32","3522","4","367","16","13.8"
"Meriwether","2020-09-02","18","3540","1","368","14.8","14"
"Meriwether","2020-09-03","15","3555","2","370","15.5","13.5"
"Meriwether","2020-09-04","20","3575","1","371","14.5","12"
"Meriwether","2020-09-05","12","3587","2","373","15.5","12"
"Meriwether","2020-09-06","15","3602","0","373","9.7","11.6"
"Meriwether","2020-09-07","11","3613","0","373","7.6","11.3"
"Meriwether","2020-09-08","34","3647","3","376","7.1","11.5"
"Meriwether","2020-09-09","20","3667","3","379","8.4","11.6"
"Meriwether","2020-09-10","23","3690","4","383","9","12.2"
"Meriwether","2020-09-11","31","3721","2","385","9.2","11.8"
"Meriwether","2020-09-12","5","3726","0","385","6.8","11.1"
"Meriwether","2020-09-13","6","3732","2","387","11.6","10.7"
"Meriwether","2020-09-14","21","3753","1","388","12.3","9.9"
"Meriwether","2020-09-15","36","3789","0","388","11","9"
"Meriwether","2020-09-16","25","3814","2","390","10","9.2"
"Meriwether","2020-09-17","19","3833","3","393","9.8","9.4"
"Meriwether","2020-09-18","37","3870","1","394","9.2","9.2"
"Meriwether","2020-09-19","10","3880","1","395","10.7","8.7"
"Meriwether","2020-09-20","7","3887","0","395","5.9","8.7"
"Meriwether","2020-09-21","24","3911","1","396","5.8","9"
"Meriwether","2020-09-22","21","3932","0","396","5.8","8.4"
"Meriwether","2020-09-23","15","3947","2","398","6.6","8.3"
"Meriwether","2020-09-24","19","3966","1","399","5.1","7.4"
"Meriwether","2020-09-25","27","3993","0","399","4.7","7"
"Meriwether","2020-09-26","23","4016","0","399","3.3","7"
"Meriwether","2020-09-27","6","4022","0","399","3.3","4.6"
"Meriwether","2020-09-28","21","4043","1","400","3.3","4.6"
"Meriwether","2020-09-29","24","4067","0","400","3.3","4.6"
"Meriwether","2020-09-30","29","4096","1","401","1.9","4.2"
"Meriwether","2020-10-01","25","4121","1","402","1.7","3.4"
"Meriwether","2020-10-02","41","4162","0","402","1.7","3.2"
"Meriwether","2020-10-03","7","4169","0","402","1.7","2.5"
"Meriwether","2020-10-04","8","4177","0","402","1.7","2.5"
"Meriwether","2020-10-05","26","4203","0","402","1.1","2.2"
"Meriwether","2020-10-06","46","4249","0","402","1.1","2.2"
"Meriwether","2020-10-07","31","4280","1","403","1","1.5"
"Meriwether","2020-10-08","37","4317","0","403","0.5","1.1"
"Meriwether","2020-10-09","22","4339","1","404","1.1","1.4"
"Meriwether","2020-10-10","17","4356","1","405","2","1.8"
"Meriwether","2020-10-11","11","4367","0","405","2","1.8"
"Meriwether","2020-10-12","32","4399","1","406","2.4","1.7"
"Meriwether","2020-10-13","43","4442","1","407","2.7","1.9"
"Meriwether","2020-10-14","21","4463","1","408","2.9","2"
"Meriwether","2020-10-15","48","4511","0","408","2.9","1.7"
"Meriwether","2020-10-16","30","4541","1","409","2.8","1.9"
"Meriwether","2020-10-17","14","4555","2","411","4","3"
"Meriwether","2020-10-18","7","4562","0","411","4","3"
"Meriwether","2020-10-19","33","4595","4","415","5.3","3.8"
"Meriwether","2020-10-20","16","4611","3","418","7.6","5.2"
"Meriwether","2020-10-21","87","4698","2","420","7.3","5.1"
"Meriwether","2020-10-22","66","4764","3","423","7.9","5.4"
"Meriwether","2020-10-23","42","4806","2","425","8.1","5.4"
"Meriwether","2020-10-24","17","4823","2","427","7.7","5.9"
"Meriwether","2020-10-25","9","4832","1","428","9.3","6.7"
"Meriwether","2020-10-26","25","4857","3","431","9.3","7.3"
"Meriwether","2020-10-27","39","4896","0","431","6.6","7.1"
"Meriwether","2020-10-28","58","4954","3","434","7.1","7.2"
"Meriwether","2020-10-29","66","5020","1","435","6.6","7.3"
"Meriwether","2020-10-30","39","5059","1","436","6.3","7.2"
"Meriwether","2020-10-31","38","5097","0","436","4.6","6.2"
"Meriwether","2020-11-01","4","5101","0","436","3","6.2"
"Meriwether","2020-11-02","26","5127","2","438","2.4","5.9"
"Meriwether","2020-11-03","33","5160","1","439","2.9","4.7"
"Meriwether","2020-11-04","24","5184","2","441","3.3","5.2"
"Meriwether","2020-11-05","27","5211","3","444","4.7","5.6"
"Meriwether","2020-11-06","63","5274","3","447","5","5.6"
"Meriwether","2020-11-07","21","5295","3","450","7","5.8"
"Meriwether","2020-11-08","6","5301","0","450","7","5"
"Meriwether","2020-11-09","23","5324","1","451","6.6","4.5"
"Meriwether","2020-11-10","27","5351","0","451","6.1","4.5"
"Meriwether","2020-11-11","43","5394","0","451","4.9","4.1"
"Meriwether","2020-11-12","33","5427","2","453","4.2","4.4"
"Meriwether","2020-11-13","52","5479","2","455","4.1","4.5"
"Meriwether","2020-11-14","24","5503","2","457","3.2","5.1"
"Meriwether","2020-11-15","15","5518","0","457","3.2","5.1"
"Meriwether","2020-11-16","33","5551","0","457","2.6","4.6"
"Meriwether","2020-11-17","23","5574","0","457","2.6","4.4"
"Meriwether","2020-11-18","25","5599","2","459","3.7","4.3"
"Meriwether","2020-11-19","37","5636","1","460","3.3","3.7"
"Meriwether","2020-11-20","23","5659","1","461","3.3","3.7"
"Meriwether","2020-11-21","35","5694","0","461","2.2","2.7"
"Meriwether","2020-11-22","9","5703","1","462","3.7","3.5"
"Meriwether","2020-11-23","44","5747","3","465","4.7","3.7"
"Meriwether","2020-11-24","51","5798","1","466","5","3.8"
"Meriwether","2020-11-25","29","5827","2","468","4.8","4.3"
"Meriwether","2020-11-26","4","5831","1","469","8","5.6"
"Meriwether","2020-11-27","20","5851","0","469","7.4","5.4"
"Meriwether","2020-11-28","11","5862","0","469","7.4","4.8"
"Meriwether","2020-11-29","8","5870","2","471","9.4","6.6"
"Meriwether","2020-11-30","27","5897","5","476","11.1","7.9"
"Meriwether","2020-12-01","22","5919","2","478","12.1","8.5"
"Meriwether","2020-12-02","37","5956","4","482","12.6","8.7"
"Meriwether","2020-12-03","28","5984","6","488","12.1","10.1"
"Meriwether","2020-12-04","28","6012","2","490","13.1","10.3"
"Meriwether","2020-12-05","13","6025","0","490","13.1","10.3"
"Meriwether","2020-12-06","5","6030","1","491","12.4","10.9"
"Meriwether","2020-12-07","44","6074","4","495","11.1","11.1"
"Meriwether","2020-12-08","49","6123","7","502","11.8","11.9"
"Meriwether","2020-12-09","79","6202","7","509","11.5","12.1"
"Meriwether","2020-12-10","45","6247","5","514","10.1","11.1"
"Meriwether","2020-12-11","32","6279","5","519","11.3","12.2"
"Meriwether","2020-12-12","114","6393","1","520","11.4","12.3"
"Meriwether","2020-12-13","19","6412","1","521","9.3","10.9"
"Meriwether","2020-12-14","52","6464","15","536","12.1","11.6"
"Meriwether","2020-12-15","69","6533","9","545","11.9","11.9"
"Meriwether","2020-12-16","49","6582","12","557","14.2","12.9"
"Meriwether","2020-12-17","60","6642","9","566","14.7","12.4"
"Meriwether","2020-12-18","39","6681","2","568","13.2","12.3"
"Meriwether","2020-12-19","17","6698","4","572","16.5","13.9"
"Meriwether","2020-12-20","47","6745","5","577","17.2","13.3"
"Meriwether","2020-12-21","40","6785","7","584","15.6","13.9"
"Meriwether","2020-12-22","86","6871","20","604","17.1","14.5"
"Meriwether","2020-12-23","49","6920","7","611","15.6","14.9"
"Meriwether","2020-12-24","31","6951","7","618","16.7","15.7"
"Meriwether","2020-12-25","7","6958","3","621","22.1","17.7"
"Meriwether","2020-12-26","32","6990","8","629","22.3","19.4"
"Meriwether","2020-12-27","19","7009","5","634","24.5","20.9"
"Meriwether","2020-12-28","65","7074","13","647","24.9","20.3"
"Meriwether","2020-12-29","62","7136","28","675","28","22.6"
"Meriwether","2020-12-30","81","7217","15","690","28.6","22.1"
"Meriwether","2020-12-31","80","7297","20","710","29","22.8"
"Meriwether","2021-01-01","9","7306","2","712","26","24.1"
"Meriwether","2021-01-02","23","7329","6","718","26.2","24.2"
"Meriwether","2021-01-03","19","7348","5","723","26.2","25.4"
"Meriwether","2021-01-04","58","7406","10","733","25.8","25.3"
"Meriwether","2021-01-05","160","7566","28","761","21.8","24.9"
"Meriwether","2021-01-06","125","7691","32","793","22.9","25.7"
"Meriwether","2021-01-07","64","7755","14","807","22.4","25.7"
"Meriwether","2021-01-08","86","7841","11","818","21.1","23.5"
"Meriwether","2021-01-09","49","7890","9","827","20","23.1"
"Meriwether","2021-01-10","21","7911","4","831","18.9","22.6"
"Meriwether","2021-01-11","59","7970","14","845","19.8","22.8"
"Meriwether","2021-01-12","80","8050","14","859","19.8","20.8"
"Meriwether","2021-01-13","59","8109","8","867","18.1","20.5"
"Meriwether","2021-01-14","113","8222","12","879","16.5","19.5"
"Meriwether","2021-01-15","61","8283","17","896","18.7","19.9"
"Meriwether","2021-01-16","32","8315","10","906","20.5","20.2"
"Meriwether","2021-01-17","28","8343","13","919","24.4","21.7"
"Meriwether","2021-01-18","41","8384","5","924","22.8","21.3"
"Meriwether","2021-01-19","80","8464","17","941","23.3","21.6"
"Meriwether","2021-01-20","81","8545","14","955","23.8","21"
"Meriwether","2021-01-21","126","8671","23","978","24.9","20.7"
"Meriwether","2021-01-22","105","8776","17","995","23.3","21"
"Meriwether","2021-01-23","71","8847","15","1010","21.8","21.2"
"Meriwether","2021-01-24","23","8870","7","1017","19.5","22"
"Meriwether","2021-01-25","48","8918","4","1021","19","20.9"
"Meriwether","2021-01-26","126","9044","16","1037","17.8","20.5"
"Meriwether","2021-01-27","130","9174","39","1076","19.6","21.7"
"Meriwether","2021-01-28","111","9285","13","1089","18.6","21.8"
"Meriwether","2021-01-29","65","9350","11","1100","18.7","21"
"Meriwether","2021-01-30","41","9391","8","1108","18.5","20.2"
"Meriwether","2021-01-31","23","9414","1","1109","14.8","17.2"
"Meriwether","2021-02-01","61","9475","5","1114","14.8","16.9"
"Meriwether","2021-02-02","89","9564","10","1124","14.6","16.2"
"Meriwether","2021-02-03","100","9664","14","1138","12.3","15.9"
"Meriwether","2021-02-04","86","9750","19","1157","13.8","16.2"
"Meriwether","2021-02-05","62","9812","16","1173","15","16.9"
"Meriwether","2021-02-06","22","9834","2","1175","13.5","16"
"Meriwether","2021-02-07","3","9837","0","1175","12.9","13.9"
"Meriwether","2021-02-08","0","9837","0","1175","11.7","13.3"
"Miller","2020-02-01","0","0","0","0",".","."
"Miller","2020-02-02","0","0","0","0",".","."
"Miller","2020-02-03","0","0","0","0",".","."
"Miller","2020-02-04","0","0","0","0",".","."
"Miller","2020-02-05","0","0","0","0",".","."
"Miller","2020-02-06","0","0","0","0",".","."
"Miller","2020-02-07","0","0","0","0","0","."
"Miller","2020-02-08","0","0","0","0","0","."
"Miller","2020-02-09","0","0","0","0","0","."
"Miller","2020-02-10","0","0","0","0","0","."
"Miller","2020-02-11","0","0","0","0","0","."
"Miller","2020-02-12","0","0","0","0","0","."
"Miller","2020-02-13","0","0","0","0","0","."
"Miller","2020-02-14","0","0","0","0","0","0"
"Miller","2020-02-15","0","0","0","0","0","0"
"Miller","2020-02-16","0","0","0","0","0","0"
"Miller","2020-02-17","0","0","0","0","0","0"
"Miller","2020-02-18","0","0","0","0","0","0"
"Miller","2020-02-19","0","0","0","0","0","0"
"Miller","2020-02-20","0","0","0","0","0","0"
"Miller","2020-02-21","0","0","0","0","0","0"
"Miller","2020-02-22","0","0","0","0","0","0"
"Miller","2020-02-23","0","0","0","0","0","0"
"Miller","2020-02-24","0","0","0","0","0","0"
"Miller","2020-02-25","0","0","0","0","0","0"
"Miller","2020-02-26","0","0","0","0","0","0"
"Miller","2020-02-27","0","0","0","0","0","0"
"Miller","2020-02-28","0","0","0","0","0","0"
"Miller","2020-02-29","0","0","0","0","0","0"
"Miller","2020-03-01","0","0","0","0","0","0"
"Miller","2020-03-02","0","0","0","0","0","0"
"Miller","2020-03-03","0","0","0","0","0","0"
"Miller","2020-03-04","0","0","0","0","0","0"
"Miller","2020-03-05","0","0","0","0","0","0"
"Miller","2020-03-06","0","0","0","0","0","0"
"Miller","2020-03-07","0","0","0","0","0","0"
"Miller","2020-03-08","0","0","0","0","0","0"
"Miller","2020-03-09","0","0","0","0","0","0"
"Miller","2020-03-10","0","0","0","0","0","0"
"Miller","2020-03-11","1","1","1","1","14.3","7.1"
"Miller","2020-03-12","2","3","0","1","14.3","7.1"
"Miller","2020-03-13","0","3","0","1","14.3","7.1"
"Miller","2020-03-14","1","4","0","1","14.3","7.1"
"Miller","2020-03-15","0","4","0","1","14.3","7.1"
"Miller","2020-03-16","2","6","0","1","14.3","7.1"
"Miller","2020-03-17","2","8","0","1","14.3","7.1"
"Miller","2020-03-18","3","11","0","1","0","7.1"
"Miller","2020-03-19","0","11","0","1","0","7.1"
"Miller","2020-03-20","1","12","0","1","0","7.1"
"Miller","2020-03-21","1","13","0","1","0","7.1"
"Miller","2020-03-22","0","13","0","1","0","7.1"
"Miller","2020-03-23","2","15","0","1","0","7.1"
"Miller","2020-03-24","1","16","0","1","0","7.1"
"Miller","2020-03-25","0","16","0","1","0","0"
"Miller","2020-03-26","1","17","0","1","0","0"
"Miller","2020-03-27","1","18","0","1","0","0"
"Miller","2020-03-28","0","18","0","1","0","0"
"Miller","2020-03-29","0","18","0","1","0","0"
"Miller","2020-03-30","2","20","1","2","7.1","3.6"
"Miller","2020-03-31","0","20","0","2","7.1","3.6"
"Miller","2020-04-01","1","21","1","3","21.4","10.7"
"Miller","2020-04-02","13","34","3","6","24.7","12.4"
"Miller","2020-04-03","26","60","0","6","24.7","12.4"
"Miller","2020-04-04","15","75","0","6","24.7","12.4"
"Miller","2020-04-05","0","75","0","6","24.7","12.4"
"Miller","2020-04-06","8","83","3","9","22.9","15"
"Miller","2020-04-07","12","95","1","10","24.1","15.6"
"Miller","2020-04-08","18","113","0","10","9.8","15.6"
"Miller","2020-04-09","10","123","1","11","8","16.4"
"Miller","2020-04-10","20","143","0","11","8","16.4"
"Miller","2020-04-11","8","151","0","11","8","16.4"
"Miller","2020-04-12","0","151","0","11","8","16.4"
"Miller","2020-04-13","10","161","1","12","4","13.5"
"Miller","2020-04-14","30","191","7","19","6.2","15.2"
"Miller","2020-04-15","18","209","1","20","7","8.4"
"Miller","2020-04-16","36","245","4","24","7.1","7.6"
"Miller","2020-04-17","38","283","1","25","7.5","7.7"
"Miller","2020-04-18","11","294","0","25","7.5","7.7"
"Miller","2020-04-19","0","294","0","25","7.5","7.7"
"Miller","2020-04-20","4","298","1","26","9.7","6.9"
"Miller","2020-04-21","6","304","2","28","11.1","8.6"
"Miller","2020-04-22","27","331","1","29","10.8","8.9"
"Miller","2020-04-23","12","343","0","29","9.2","8.2"
"Miller","2020-04-24","22","365","1","30","9.5","8.5"
"Miller","2020-04-25","21","386","0","30","9.5","8.5"
"Miller","2020-04-26","0","386","0","30","9.5","8.5"
"Miller","2020-04-27","6","392","0","30","5.9","7.8"
"Miller","2020-04-28","12","404","0","30","1.2","6.1"
"Miller","2020-04-29","14","418","0","30","0.6","5.7"
"Miller","2020-04-30","5","423","1","31","3.5","6.4"
"Miller","2020-05-01","17","440","1","32","3.7","6.6"
"Miller","2020-05-02","18","458","0","32","3.7","6.6"
"Miller","2020-05-03","3","461","0","32","3.7","6.6"
"Miller","2020-05-04","11","472","0","32","3.7","4.8"
"Miller","2020-05-05","27","499","1","33","4.2","2.7"
"Miller","2020-05-06","20","519","0","33","4.2","2.4"
"Miller","2020-05-07","42","561","0","33","1.4","2.4"
"Miller","2020-05-08","19","580","0","33","0.5","2.1"
"Miller","2020-05-09","14","594","0","33","0.5","2.1"
"Miller","2020-05-10","0","594","0","33","0.5","2.1"
"Miller","2020-05-11","4","598","0","33","0.5","2.1"
"Miller","2020-05-12","18","616","1","34","0.8","2.5"
"Miller","2020-05-13","23","639","0","34","0.8","2.5"
"Miller","2020-05-14","18","657","0","34","0.8","1.1"
"Miller","2020-05-15","23","680","0","34","0.8","0.7"
"Miller","2020-05-16","10","690","0","34","0.8","0.7"
"Miller","2020-05-17","0","690","0","34","0.8","0.7"
"Miller","2020-05-18","7","697","0","34","0.8","0.7"
"Miller","2020-05-19","40","737","0","34","0","0.4"
"Miller","2020-05-20","83","820","1","35","0.2","0.5"
"Miller","2020-05-21","26","846","1","36","0.7","0.8"
"Miller","2020-05-22","27","873","1","37","1.3","1"
"Miller","2020-05-23","2","875","0","37","1.3","1"
"Miller","2020-05-24","0","875","0","37","1.3","1"
"Miller","2020-05-25","2","877","0","37","1.3","1"
"Miller","2020-05-26","33","910","1","38","1.7","0.8"
"Miller","2020-05-27","19","929","0","38","1.5","0.8"
"Miller","2020-05-28","49","978","0","38","1","0.8"
"Miller","2020-05-29","43","1021","1","39","0.8","1"
"Miller","2020-05-30","8","1029","0","39","0.8","1"
"Miller","2020-05-31","1","1030","0","39","0.8","1"
"Miller","2020-06-01","6","1036","0","39","0.8","1"
"Miller","2020-06-02","26","1062","0","39","0.3","1"
"Miller","2020-06-03","37","1099","1","40","0.7","1.1"
"Miller","2020-06-04","18","1117","1","41","1.5","1.2"
"Miller","2020-06-05","28","1145","0","41","1.2","1"
"Miller","2020-06-06","15","1160","0","41","1.2","1"
"Miller","2020-06-07","0","1160","0","41","1.2","1"
"Miller","2020-06-08","16","1176","0","41","1.2","1"
"Miller","2020-06-09","16","1192","3","44","3.9","2.1"
"Miller","2020-06-10","17","1209","0","44","3.5","2.1"
"Miller","2020-06-11","11","1220","0","44","2.7","2.1"
"Miller","2020-06-12","18","1238","0","44","2.7","1.9"
"Miller","2020-06-13","0","1238","0","44","2.7","1.9"
"Miller","2020-06-14","4","1242","0","44","2.7","1.9"
"Miller","2020-06-15","9","1251","0","44","2.7","1.9"
"Miller","2020-06-16","13","1264","0","44","0","1.9"
"Miller","2020-06-17","26","1290","1","45","0.5","2"
"Miller","2020-06-18","28","1318","0","45","0.5","1.6"
"Miller","2020-06-19","19","1337","0","45","0.5","1.6"
"Miller","2020-06-20","6","1343","0","45","0.5","1.6"
"Miller","2020-06-21","1","1344","0","45","0.5","1.6"
"Miller","2020-06-22","7","1351","0","45","0.5","1.6"
"Miller","2020-06-23","19","1370","2","47","2.1","1"
"Miller","2020-06-24","38","1408","2","49","2.3","1.4"
"Miller","2020-06-25","17","1425","0","49","2.3","1.4"
"Miller","2020-06-26","19","1444","0","49","2.3","1.4"
"Miller","2020-06-27","4","1448","0","49","2.3","1.4"
"Miller","2020-06-28","3","1451","1","50","7","3.8"
"Miller","2020-06-29","19","1470","1","51","7.8","4.2"
"Miller","2020-06-30","17","1487","0","51","6.3","4.2"
"Miller","2020-07-01","16","1503","1","52","6.4","4.3"
"Miller","2020-07-02","32","1535","0","52","6.4","4.3"
"Miller","2020-07-03","21","1556","1","53","7.1","4.7"
"Miller","2020-07-04","2","1558","0","53","7.1","4.7"
"Miller","2020-07-05","2","1560","1","54","9.5","8.2"
"Miller","2020-07-06","21","1581","0","54","8.7","8.2"
"Miller","2020-07-07","3","1584","1","55","13.5","9.9"
"Miller","2020-07-08","22","1606","0","55","12.6","9.5"
"Miller","2020-07-09","29","1635","4","59","14.6","10.5"
"Miller","2020-07-10","11","1646","0","59","13.9","10.5"
"Miller","2020-07-11","22","1668","2","61","15.2","11.1"
"Miller","2020-07-12","21","1689","2","63","9.4","9.4"
"Miller","2020-07-13","31","1720","1","64","9.9","9.3"
"Miller","2020-07-14","20","1740","3","67","7.2","10.4"
"Miller","2020-07-15","19","1759","1","68","8","10.3"
"Miller","2020-07-16","51","1810","6","74","7.7","11.1"
"Miller","2020-07-17","45","1855","4","78","9","11.4"
"Miller","2020-07-18","48","1903","3","81","8.6","11.9"
"Miller","2020-07-19","1","1904","0","81","7.2","8.3"
"Miller","2020-07-20","29","1933","3","84","8.2","9"
"Miller","2020-07-21","61","1994","7","91","7.7","7.5"
"Miller","2020-07-22","48","2042","3","94","7.9","7.9"
"Miller","2020-07-23","35","2077","11","105","10.7","9.2"
"Miller","2020-07-24","94","2171","17","122","12","10.5"
"Miller","2020-07-25","49","2220","10","132","14","11.3"
"Miller","2020-07-26","1","2221","0","132","14","10.6"
"Miller","2020-07-27","16","2237","1","133","13.4","10.8"
"Miller","2020-07-28","35","2272","9","142","15.4","11.6"
"Miller","2020-07-29","53","2325","4","146","15.6","11.7"
"Miller","2020-07-30","41","2366","3","149","12.2","11.4"
"Miller","2020-07-31","30","2396","1","150","10.1","11"
"Miller","2020-08-01","25","2421","3","153","8.9","11.4"
"Miller","2020-08-02","1","2422","0","153","8.9","11.4"
"Miller","2020-08-03","13","2435","1","154","9.1","11.3"
"Miller","2020-08-04","26","2461","2","156","6.5","11"
"Miller","2020-08-05","80","2541","6","162","6.5","11.1"
"Miller","2020-08-06","45","2586","8","170","8","10.1"
"Miller","2020-08-07","67","2653","5","175","8.6","9.3"
"Miller","2020-08-08","54","2707","3","178","7.7","8.3"
"Miller","2020-08-09","3","2710","2","180","17.2","13"
"Miller","2020-08-10","33","2743","1","181","16.5","12.8"
"Miller","2020-08-11","12","2755","3","184","19","12.8"
"Miller","2020-08-12","54","2809","6","190","19.5","13"
"Miller","2020-08-13","23","2832","3","193","18.8","13.4"
"Miller","2020-08-14","34","2866","8","201","21.1","14.9"
"Miller","2020-08-15","25","2891","8","209","24.9","16.3"
"Miller","2020-08-16","1","2892","0","209","15.4","16.3"
"Miller","2020-08-17","18","2910","0","209","15","15.7"
"Miller","2020-08-18","45","2955","11","220","14.9","16.9"
"Miller","2020-08-19","32","2987","7","227","16.4","18"
"Miller","2020-08-20","33","3020","6","233","17.1","18"
"Miller","2020-08-21","40","3060","8","241","16.6","18.9"
"Miller","2020-08-22","30","3090","6","247","14.9","19.9"
"Miller","2020-08-23","1","3091","0","247","14.9","15.2"
"Miller","2020-08-24","24","3115","1","248","15.5","15.2"
"Miller","2020-08-25","36","3151","3","251","13.2","14"
"Miller","2020-08-26","36","3187","7","258","12.9","14.6"
"Miller","2020-08-27","24","3211","2","260","11.5","14.3"
"Miller","2020-08-28","21","3232","2","262","10","13.3"
"Miller","2020-08-29","19","3251","6","268","11.6","13.3"
"Miller","2020-08-30","0","3251","0","268","11.6","13.3"
"Miller","2020-08-31","6","3257","0","268","11","13.3"
"Miller","2020-09-01","35","3292","8","276","13.1","13.2"
"Miller","2020-09-02","26","3318","3","279","12","12.4"
"Miller","2020-09-03","27","3345","4","283","12.9","12.2"
"Miller","2020-09-04","18","3363","2","285","13.1","11.6"
"Miller","2020-09-05","26","3389","0","285","8.6","10.1"
"Miller","2020-09-06","2","3391","0","285","8.6","10.1"
"Miller","2020-09-07","3","3394","0","285","8.6","9.8"
"Miller","2020-09-08","9","3403","1","286","6.9","10"
"Miller","2020-09-09","36","3439","0","286","5.3","8.6"
"Miller","2020-09-10","48","3487","3","289","4.1","8.5"
"Miller","2020-09-11","189","3676","2","291","2.6","7.9"
"Miller","2020-09-12","3","3679","0","291","2.6","5.6"
"Miller","2020-09-13","2","3681","0","291","2.6","5.6"
"Miller","2020-09-14","65","3746","2","293","3.1","5.8"
"Miller","2020-09-15","28","3774","0","293","1.5","4.2"
"Miller","2020-09-16","37","3811","0","293","1.5","3.4"
"Miller","2020-09-17","109","3920","1","294","0.7","2.4"
"Miller","2020-09-18","83","4003","0","294","0.6","1.6"
"Miller","2020-09-19","21","4024","3","297","2.6","2.6"
"Miller","2020-09-20","1","4025","0","297","2.6","2.6"
"Miller","2020-09-21","62","4087","0","297","2.2","2.6"
"Miller","2020-09-22","37","4124","6","303","4.5","3"
"Miller","2020-09-23","56","4180","6","309","6","3.8"
"Miller","2020-09-24","126","4306","2","311","6.1","3.4"
"Miller","2020-09-25","88","4394","8","319","7.4","4"
"Miller","2020-09-26","21","4415","2","321","6.7","4.7"
"Miller","2020-09-27","1","4416","0","321","6.7","4.7"
"Miller","2020-09-28","46","4462","0","321","6.7","4.5"
"Miller","2020-09-29","62","4524","4","325","5.3","4.9"
"Miller","2020-09-30","62","4586","3","328","4.5","5.3"
"Miller","2020-10-01","167","4753","6","334","4.8","5.5"
"Miller","2020-10-02","76","4829","4","338","4.2","5.8"
"Miller","2020-10-03","25","4854","1","339","3.4","5.1"
"Miller","2020-10-04","1","4855","0","339","3.4","5.1"
"Miller","2020-10-05","55","4910","2","341","4","5.4"
"Miller","2020-10-06","44","4954","2","343","3.7","4.5"
"Miller","2020-10-07","52","5006","4","347","4.1","4.3"
"Miller","2020-10-08","164","5170","3","350","3.9","4.3"
"Miller","2020-10-09","45","5215","2","352","3.7","4"
"Miller","2020-10-10","26","5241","1","353","3.7","3.6"
"Miller","2020-10-11","0","5241","0","353","3.7","3.6"
"Miller","2020-10-12","39","5280","0","353","3.2","3.6"
"Miller","2020-10-13","38","5318","3","356","3.7","3.7"
"Miller","2020-10-14","53","5371","0","356","2.6","3.3"
"Miller","2020-10-15","93","5464","1","357","2.5","3.2"
"Miller","2020-10-16","33","5497","2","359","2.7","3.2"
"Miller","2020-10-17","27","5524","2","361","3.2","3.5"
"Miller","2020-10-18","2","5526","1","362","10.3","7"
"Miller","2020-10-19","47","5573","0","362","10.3","6.8"
"Miller","2020-10-20","39","5612","4","366","10.7","7.2"
"Miller","2020-10-21","41","5653","4","370","12.1","7.3"
"Miller","2020-10-22","164","5817","7","377","12.5","7.5"
"Miller","2020-10-23","27","5844","3","380","13.3","8"
"Miller","2020-10-24","19","5863","5","385","16","9.6"
"Miller","2020-10-25","1","5864","0","385","8.8","9.6"
"Miller","2020-10-26","57","5921","0","385","8.8","9.6"
"Miller","2020-10-27","17","5938","1","386","8.2","9.4"
"Miller","2020-10-28","42","5980","0","386","6.8","9.4"
"Miller","2020-10-29","143","6123","5","391","6.7","9.6"
"Miller","2020-10-30","18","6141","2","393","6.7","10"
"Miller","2020-10-31","22","6163","4","397","5.5","10.7"
"Miller","2020-11-01","0","6163","0","397","5.5","7.2"
"Miller","2020-11-02","46","6209","3","400","6.5","7.6"
"Miller","2020-11-03","8","6217","0","400","5.6","6.9"
"Miller","2020-11-04","60","6277","2","402","6.1","6.4"
"Miller","2020-11-05","147","6424","4","406","6","6.3"
"Miller","2020-11-06","37","6461","1","407","4.8","5.7"
"Miller","2020-11-07","47","6508","5","412","3.7","4.6"
"Miller","2020-11-08","3","6511","0","412","3.7","4.6"
"Miller","2020-11-09","43","6554","1","413","3.1","4.8"
"Miller","2020-11-10","62","6616","2","415","3.6","4.6"
"Miller","2020-11-11","61","6677","3","418","3.8","4.9"
"Miller","2020-11-12","110","6787","6","424","4.2","5.1"
"Miller","2020-11-13","32","6819","1","425","4.2","4.5"
"Miller","2020-11-14","25","6844","4","429","5","4.4"
"Miller","2020-11-15","2","6846","0","429","5","4.4"
"Miller","2020-11-16","70","6916","1","430","4.9","4"
"Miller","2020-11-17","75","6991","1","431","4.6","4.1"
"Miller","2020-11-18","37","7028","0","431","3.9","3.8"
"Miller","2020-11-19","99","7127","0","431","3.1","3.7"
"Miller","2020-11-20","53","7180","4","435","3.8","4"
"Miller","2020-11-21","20","7200","1","436","2.2","3.6"
"Miller","2020-11-22","2","7202","0","436","2.2","3.6"
"Miller","2020-11-23","18","7220","1","437","2.8","3.8"
"Miller","2020-11-24","67","7287","4","441","3.4","4"
"Miller","2020-11-25","71","7358","8","449","5","4.5"
"Miller","2020-11-26","58","7416","0","449","5","4.1"
"Miller","2020-11-27","66","7482","3","452","4.6","4.2"
"Miller","2020-11-28","33","7515","5","457","6.1","4.1"
"Miller","2020-11-29","1","7516","0","457","6.1","4.1"
"Miller","2020-11-30","33","7549","0","457","5.3","4"
"Miller","2020-12-01","64","7613","0","457","4.4","3.9"
"Miller","2020-12-02","57","7670","3","460","3.6","4.3"
"Miller","2020-12-03","77","7747","4","464","4.3","4.7"
"Miller","2020-12-04","63","7810","0","464","3.7","4.1"
"Miller","2020-12-05","28","7838","0","464","1.5","3.8"
"Miller","2020-12-06","3","7841","0","464","1.5","3.8"
"Miller","2020-12-07","52","7893","3","467","2.3","3.8"
"Miller","2020-12-08","90","7983","2","469","2.6","3.5"
"Miller","2020-12-09","61","8044","6","475","3.3","3.4"
"Miller","2020-12-10","103","8147","3","478","3","3.6"
"Miller","2020-12-11","32","8179","2","480","3.9","3.8"
"Miller","2020-12-12","48","8227","5","485","5.3","3.4"
"Miller","2020-12-13","1","8228","0","485","5.3","3.4"
"Miller","2020-12-14","80","8308","0","485","4.5","3.4"
"Miller","2020-12-15","110","8418","5","490","4.9","3.7"
"Miller","2020-12-16","173","8591","15","505","4.7","4"
"Miller","2020-12-17","85","8676","4","509","4.9","4"
"Miller","2020-12-18","74","8750","10","519","6","4.9"
"Miller","2020-12-19","92","8842","8","527","5.7","5.5"
"Miller","2020-12-20","10","8852","1","528","7.2","6.3"
"Miller","2020-12-21","184","9036","10","538","7.9","6.2"
"Miller","2020-12-22","267","9303","31","569","8.9","6.9"
"Miller","2020-12-23","209","9512","18","587","8.9","6.8"
"Miller","2020-12-24","157","9669","23","610","10.4","7.7"
"Miller","2020-12-25","19","9688","0","610","8.4","7.2"
"Miller","2020-12-26","12","9700","3","613","10.8","8.2"
"Miller","2020-12-27","17","9717","2","615","11","9.1"
"Miller","2020-12-28","175","9892","8","623","10.9","9.4"
"Miller","2020-12-29","176","10068","6","629","9.7","9.3"
"Miller","2020-12-30","185","10253","24","653","10.3","9.6"
"Miller","2020-12-31","134","10387","19","672","10.3","10.3"
"Miller","2021-01-01","62","10449","1","673","10.5","9.5"
"Miller","2021-01-02","2","10451","0","673","6.9","8.8"
"Miller","2021-01-03","2","10453","0","673","5.2","8.1"
"Miller","2021-01-04","52","10505","8","681","6.8","8.8"
"Miller","2021-01-05","143","10648","29","710","9.2","9.5"
"Miller","2021-01-06","63","10711","10","720","9.6","10"
"Miller","2021-01-07","112","10823","8","728","8.6","9.4"
"Miller","2021-01-08","34","10857","3","731","9.6","10.1"
"Miller","2021-01-09","30","10887","6","737","12.5","9.7"
"Miller","2021-01-10","5","10892","0","737","12.5","8.9"
"Miller","2021-01-11","45","10937","1","738","10.6","8.7"
"Miller","2021-01-12","87","11024","7","745","8.9","9"
"Miller","2021-01-13","56","11080","6","751","8.1","8.9"
"Miller","2021-01-14","130","11210","4","755","7.6","8.1"
"Miller","2021-01-15","70","11280","7","762","7.7","8.7"
"Miller","2021-01-16","32","11312","4","766","6.7","9.6"
"Miller","2021-01-17","0","11312","0","766","6.7","9.6"
"Miller","2021-01-18","43","11355","4","770","7.7","9.1"
"Miller","2021-01-19","70","11425","5","775","7.5","8.2"
"Miller","2021-01-20","88","11513","2","777","6.3","7.2"
"Miller","2021-01-21","135","11648","3","780","6.2","6.9"
"Miller","2021-01-22","51","11699","5","785","6.2","7"
"Miller","2021-01-23","29","11728","1","786","4.9","5.8"
"Miller","2021-01-24","0","11728","0","786","4.9","5.8"
"Miller","2021-01-25","54","11782","1","787","3.8","5.7"
"Miller","2021-01-26","92","11874","8","795","4","5.8"
"Miller","2021-01-27","58","11932","2","797","4.2","5.3"
"Miller","2021-01-28","137","12069","5","802","4.4","5.3"
"Miller","2021-01-29","46","12115","4","806","4.3","5.2"
"Miller","2021-01-30","22","12137","2","808","5.1","5"
"Miller","2021-01-31","1","12138","0","808","5.1","5"
"Miller","2021-02-01","47","12185","3","811","5.7","4.8"
"Miller","2021-02-02","86","12271","2","813","4.8","4.4"
"Miller","2021-02-03","54","12325","2","815","4.8","4.5"
"Miller","2021-02-04","140","12465","6","821","4.9","4.7"
"Miller","2021-02-05","29","12494","4","825","5.7","5"
"Miller","2021-02-06","0","12494","0","825","4.4","4.7"
"Miller","2021-02-07","0","12494","0","825","4.4","4.7"
"Miller","2021-02-08","0","12494","0","825","3.4","4.6"
"Mitchell","2020-02-01","0","0","0","0",".","."
"Mitchell","2020-02-02","0","0","0","0",".","."
"Mitchell","2020-02-03","0","0","0","0",".","."
"Mitchell","2020-02-04","0","0","0","0",".","."
"Mitchell","2020-02-05","0","0","0","0",".","."
"Mitchell","2020-02-06","0","0","0","0",".","."
"Mitchell","2020-02-07","0","0","0","0","0","."
"Mitchell","2020-02-08","0","0","0","0","0","."
"Mitchell","2020-02-09","0","0","0","0","0","."
"Mitchell","2020-02-10","0","0","0","0","0","."
"Mitchell","2020-02-11","0","0","0","0","0","."
"Mitchell","2020-02-12","0","0","0","0","0","."
"Mitchell","2020-02-13","0","0","0","0","0","."
"Mitchell","2020-02-14","0","0","0","0","0","0"
"Mitchell","2020-02-15","0","0","0","0","0","0"
"Mitchell","2020-02-16","0","0","0","0","0","0"
"Mitchell","2020-02-17","0","0","0","0","0","0"
"Mitchell","2020-02-18","0","0","0","0","0","0"
"Mitchell","2020-02-19","0","0","0","0","0","0"
"Mitchell","2020-02-20","0","0","0","0","0","0"
"Mitchell","2020-02-21","0","0","0","0","0","0"
"Mitchell","2020-02-22","0","0","0","0","0","0"
"Mitchell","2020-02-23","0","0","0","0","0","0"
"Mitchell","2020-02-24","0","0","0","0","0","0"
"Mitchell","2020-02-25","0","0","0","0","0","0"
"Mitchell","2020-02-26","0","0","0","0","0","0"
"Mitchell","2020-02-27","0","0","0","0","0","0"
"Mitchell","2020-02-28","0","0","0","0","0","0"
"Mitchell","2020-02-29","0","0","0","0","0","0"
"Mitchell","2020-03-01","0","0","0","0","0","0"
"Mitchell","2020-03-02","0","0","0","0","0","0"
"Mitchell","2020-03-03","0","0","0","0","0","0"
"Mitchell","2020-03-04","0","0","0","0","0","0"
"Mitchell","2020-03-05","0","0","0","0","0","0"
"Mitchell","2020-03-06","0","0","0","0","0","0"
"Mitchell","2020-03-07","0","0","0","0","0","0"
"Mitchell","2020-03-08","0","0","0","0","0","0"
"Mitchell","2020-03-09","0","0","0","0","0","0"
"Mitchell","2020-03-10","0","0","0","0","0","0"
"Mitchell","2020-03-11","1","1","0","0","0","0"
"Mitchell","2020-03-12","1","2","1","1","14.3","7.1"
"Mitchell","2020-03-13","2","4","0","1","14.3","7.1"
"Mitchell","2020-03-14","1","5","0","1","14.3","7.1"
"Mitchell","2020-03-15","4","9","3","4","25","12.5"
"Mitchell","2020-03-16","2","11","0","4","25","12.5"
"Mitchell","2020-03-17","8","19","1","5","26.8","13.4"
"Mitchell","2020-03-18","3","22","1","6","31.5","15.8"
"Mitchell","2020-03-19","3","25","3","9","31.5","22.9"
"Mitchell","2020-03-20","4","29","1","10","35.1","24.7"
"Mitchell","2020-03-21","3","32","0","10","35.1","24.7"
"Mitchell","2020-03-22","2","34","1","11","31.5","28.3"
"Mitchell","2020-03-23","13","47","2","13","33.7","29.4"
"Mitchell","2020-03-24","32","79","17","30","39.5","33.2"
"Mitchell","2020-03-25","26","105","14","44","42.5","37"
"Mitchell","2020-03-26","23","128","12","56","35.6","33.6"
"Mitchell","2020-03-27","19","147","16","72","44.1","39.6"
"Mitchell","2020-03-28","13","160","9","81","54","44.6"
"Mitchell","2020-03-29","24","184","21","102","59.4","45.5"
"Mitchell","2020-03-30","14","198","6","108","63.3","48.5"
"Mitchell","2020-03-31","24","222","11","119","62.2","50.9"
"Mitchell","2020-04-01","21","243","11","130","62","52.3"
"Mitchell","2020-04-02","18","261","6","136","59.3","47.5"
"Mitchell","2020-04-03","18","279","10","146","55.2","49.7"
"Mitchell","2020-04-04","8","287","4","150","52.5","53.2"
"Mitchell","2020-04-05","6","293","3","153","47.1","53.2"
"Mitchell","2020-04-06","25","318","12","165","47.9","55.6"
"Mitchell","2020-04-07","4","322","1","166","44.9","53.6"
"Mitchell","2020-04-08","15","337","10","176","46.9","54.5"
"Mitchell","2020-04-09","22","359","11","187","49.3","54.3"
"Mitchell","2020-04-10","21","380","12","199","49.5","52.4"
"Mitchell","2020-04-11","6","386","3","202","49.5","51"
"Mitchell","2020-04-12","6","392","4","206","51.9","49.5"
"Mitchell","2020-04-13","17","409","15","221","57.7","52.8"
"Mitchell","2020-04-14","25","434","10","231","59.8","52.4"
"Mitchell","2020-04-15","55","489","45","276","62","54.5"
"Mitchell","2020-04-16","21","510","13","289","63.7","56.5"
"Mitchell","2020-04-17","12","522","10","299","67.4","58.5"
"Mitchell","2020-04-18","8","530","4","303","67.4","58.5"
"Mitchell","2020-04-19","6","536","2","305","62.7","57.3"
"Mitchell","2020-04-20","13","549","4","309","54.5","56.1"
"Mitchell","2020-04-21","41","590","12","321","52.9","56.4"
"Mitchell","2020-04-22","97","687","12","333","43","52.5"
"Mitchell","2020-04-23","22","709","2","335","35.5","49.6"
"Mitchell","2020-04-24","92","801","7","342","24.6","46"
"Mitchell","2020-04-25","24","825","3","345","19.3","43.3"
"Mitchell","2020-04-26","8","833","3","348","19.9","41.3"
"Mitchell","2020-04-27","54","887","3","351","16.3","35.4"
"Mitchell","2020-04-28","62","949","8","359","13.9","33.4"
"Mitchell","2020-04-29","18","967","0","359","12.2","27.6"
"Mitchell","2020-04-30","23","990","8","367","15.8","25.6"
"Mitchell","2020-05-01","98","1088","31","398","19.3","22"
"Mitchell","2020-05-02","8","1096","0","398","17.5","18.4"
"Mitchell","2020-05-03","6","1102","2","400","16.9","18.4"
"Mitchell","2020-05-04","34","1136","2","402","16.9","16.6"
"Mitchell","2020-05-05","48","1184","7","409","17.2","15.6"
"Mitchell","2020-05-06","52","1236","3","412","18","15.1"
"Mitchell","2020-05-07","18","1254","4","416","16.2","16"
"Mitchell","2020-05-08","47","1301","4","420","12.9","16.1"
"Mitchell","2020-05-09","27","1328","2","422","14","15.7"
"Mitchell","2020-05-10","3","1331","3","425","23.5","20.2"
"Mitchell","2020-05-11","30","1361","3","428","24.1","20.5"
"Mitchell","2020-05-12","35","1396","3","431","23.2","20.2"
"Mitchell","2020-05-13","33","1429","1","432","22.8","20.4"
"Mitchell","2020-05-14","75","1504","7","439","21","18.6"
"Mitchell","2020-05-15","8","1512","1","440","21.5","17.2"
"Mitchell","2020-05-16","13","1525","4","444","24.9","19.4"
"Mitchell","2020-05-17","27","1552","1","445","11.1","17.3"
"Mitchell","2020-05-18","32","1584","4","449","11.5","17.8"
"Mitchell","2020-05-19","57","1641","4","453","11.3","17.2"
"Mitchell","2020-05-20","27","1668","1","454","11.4","17.1"
"Mitchell","2020-05-21","87","1755","3","457","10.5","15.7"
"Mitchell","2020-05-22","68","1823","4","461","9.6","15.6"
"Mitchell","2020-05-23","13","1836","0","461","5.2","15"
"Mitchell","2020-05-24","6","1842","0","461","4.7","7.9"
"Mitchell","2020-05-25","8","1850","2","463","6.4","9"
"Mitchell","2020-05-26","48","1898","9","472","8.1","9.7"
"Mitchell","2020-05-27","17","1915","1","473","8.4","9.9"
"Mitchell","2020-05-28","25","1940","0","473","7.9","9.2"
"Mitchell","2020-05-29","69","2009","6","479","8.3","9"
"Mitchell","2020-05-30","8","2017","0","479","8.3","6.8"
"Mitchell","2020-05-31","1","2018","0","479","8.3","6.5"
"Mitchell","2020-06-01","27","2045","2","481","5.8","6.1"
"Mitchell","2020-06-02","44","2089","1","482","3.5","5.8"
"Mitchell","2020-06-03","37","2126","0","482","2.6","5.5"
"Mitchell","2020-06-04","106","2232","1","483","2.8","5.3"
"Mitchell","2020-06-05","24","2256","0","483","1.5","4.9"
"Mitchell","2020-06-06","8","2264","0","483","1.5","4.9"
"Mitchell","2020-06-07","9","2273","1","484","3.1","5.7"
"Mitchell","2020-06-08","39","2312","0","484","2","3.9"
"Mitchell","2020-06-09","27","2339","0","484","1.7","2.6"
"Mitchell","2020-06-10","19","2358","3","487","4","3.3"
"Mitchell","2020-06-11","83","2441","4","491","4.5","3.6"
"Mitchell","2020-06-12","22","2463","1","492","5.2","3.3"
"Mitchell","2020-06-13","1","2464","0","492","5.2","3.3"
"Mitchell","2020-06-14","6","2470","3","495","10.7","6.9"
"Mitchell","2020-06-15","31","2501","0","495","10.7","6.4"
"Mitchell","2020-06-16","61","2562","1","496","11","6.3"
"Mitchell","2020-06-17","19","2581","0","496","8.7","6.3"
"Mitchell","2020-06-18","97","2678","2","498","8.3","6.4"
"Mitchell","2020-06-19","26","2704","1","499","8.2","6.7"
"Mitchell","2020-06-20","6","2710","3","502","15.4","10.3"
"Mitchell","2020-06-21","7","2717","1","503","10.3","10.5"
"Mitchell","2020-06-22","39","2756","1","504","10.6","10.7"
"Mitchell","2020-06-23","33","2789","0","504","10.4","10.7"
"Mitchell","2020-06-24","13","2802","2","506","12.6","10.7"
"Mitchell","2020-06-25","66","2868","3","509","12.9","10.6"
"Mitchell","2020-06-26","23","2891","3","512","14.3","11.2"
"Mitchell","2020-06-27","6","2897","0","512","7.1","11.2"
"Mitchell","2020-06-28","7","2904","1","513","7.1","8.7"
"Mitchell","2020-06-29","16","2920","1","514","7.6","9.1"
"Mitchell","2020-06-30","27","2947","4","518","9.8","10.1"
"Mitchell","2020-07-01","14","2961","1","519","8.6","10.6"
"Mitchell","2020-07-02","23","2984","5","524","11","12"
"Mitchell","2020-07-03","107","3091","8","532","10.2","12.3"
"Mitchell","2020-07-04","4","3095","0","532","10.2","8.7"
"Mitchell","2020-07-05","10","3105","0","532","8.2","7.7"
"Mitchell","2020-07-06","30","3135","4","536","9.2","8.4"
"Mitchell","2020-07-07","46","3181","3","539","8","8.9"
"Mitchell","2020-07-08","44","3225","1","540","7.3","8"
"Mitchell","2020-07-09","124","3349","12","552","5.6","8.3"
"Mitchell","2020-07-10","32","3381","3","555","5.9","8.1"
"Mitchell","2020-07-11","12","3393","2","557","8.3","9.3"
"Mitchell","2020-07-12","7","3400","1","558","10.3","9.3"
"Mitchell","2020-07-13","30","3430","3","561","9.8","9.5"
"Mitchell","2020-07-14","36","3466","6","567","11.3","9.7"
"Mitchell","2020-07-15","33","3499","5","572","13.1","10.2"
"Mitchell","2020-07-16","132","3631","21","593","14","9.8"
"Mitchell","2020-07-17","32","3663","2","595","13.6","9.7"
"Mitchell","2020-07-18","4","3667","1","596","14.8","11.5"
"Mitchell","2020-07-19","7","3674","2","598","16.8","13.5"
"Mitchell","2020-07-20","27","3701","2","600","16.4","13.1"
"Mitchell","2020-07-21","34","3735","3","603","15.3","13.3"
"Mitchell","2020-07-22","31","3766","3","606","14.5","13.8"
"Mitchell","2020-07-23","184","3950","14","620","13.3","13.7"
"Mitchell","2020-07-24","63","4013","4","624","13.3","13.5"
"Mitchell","2020-07-25","6","4019","1","625","12.2","13.5"
"Mitchell","2020-07-26","12","4031","2","627","10.5","13.6"
"Mitchell","2020-07-27","35","4066","2","629","10.2","13.3"
"Mitchell","2020-07-28","33","4099","5","634","11.1","13.2"
"Mitchell","2020-07-29","16","4115","7","641","16","15.3"
"Mitchell","2020-07-30","185","4300","10","651","15.7","14.5"
"Mitchell","2020-07-31","24","4324","3","654","16.6","14.9"
"Mitchell","2020-08-01","35","4359","1","655","14.6","13.4"
"Mitchell","2020-08-02","11","4370","2","657","14.8","12.6"
"Mitchell","2020-08-03","47","4417","8","665","16.4","13.3"
"Mitchell","2020-08-04","35","4452","3","668","15.5","13.3"
"Mitchell","2020-08-05","29","4481","0","668","9.2","12.6"
"Mitchell","2020-08-06","129","4610","2","670","8.7","12.2"
"Mitchell","2020-08-07","35","4645","3","673","8.1","12.3"
"Mitchell","2020-08-08","21","4666","0","673","7.7","11.1"
"Mitchell","2020-08-09","12","4678","0","673","5.1","9.9"
"Mitchell","2020-08-10","36","4714","6","679","5.1","10.7"
"Mitchell","2020-08-11","21","4735","4","683","6.5","11"
"Mitchell","2020-08-12","25","4760","2","685","7.7","8.5"
"Mitchell","2020-08-13","98","4858","7","692","8.5","8.6"
"Mitchell","2020-08-14","18","4876","2","694","8.9","8.5"
"Mitchell","2020-08-15","7","4883","1","695","10.9","9.3"
"Mitchell","2020-08-16","9","4892","0","695","10.9","8"
"Mitchell","2020-08-17","25","4917","3","698","10.2","7.6"
"Mitchell","2020-08-18","19","4936","2","700","9","7.8"
"Mitchell","2020-08-19","18","4954","1","701","8.7","8.2"
"Mitchell","2020-08-20","106","5060","8","709","8.7","8.6"
"Mitchell","2020-08-21","33","5093","5","714","9.3","9.1"
"Mitchell","2020-08-22","6","5099","1","715","9.6","10.3"
"Mitchell","2020-08-23","8","5107","3","718","15","12.9"
"Mitchell","2020-08-24","20","5127","2","720","14.7","12.5"
"Mitchell","2020-08-25","21","5148","2","722","14.6","11.8"
"Mitchell","2020-08-26","23","5171","5","727","16.9","12.8"
"Mitchell","2020-08-27","83","5254","8","735","17.2","12.9"
"Mitchell","2020-08-28","18","5272","3","738","17.4","13.3"
"Mitchell","2020-08-29","9","5281","2","740","18.2","13.9"
"Mitchell","2020-08-30","9","5290","1","741","14.4","14.7"
"Mitchell","2020-08-31","16","5306","4","745","16.6","15.6"
"Mitchell","2020-09-01","24","5330","2","747","16.4","15.5"
"Mitchell","2020-09-02","26","5356","3","750","14.9","15.9"
"Mitchell","2020-09-03","74","5430","9","759","15.3","16.2"
"Mitchell","2020-09-04","51","5481","2","761","13.5","15.4"
"Mitchell","2020-09-05","11","5492","6","767","18.1","18.1"
"Mitchell","2020-09-06","2","5494","0","767","16.5","15.5"
"Mitchell","2020-09-07","6","5500","1","768","15.3","15.9"
"Mitchell","2020-09-08","38","5538","4","772","15.6","16"
"Mitchell","2020-09-09","142","5680","2","774","14.2","14.6"
"Mitchell","2020-09-10","76","5756","8","782","13.9","14.6"
"Mitchell","2020-09-11","25","5781","3","785","15.1","14.3"
"Mitchell","2020-09-12","25","5806","0","785","7.3","12.7"
"Mitchell","2020-09-13","5","5811","1","786","10.2","13.3"
"Mitchell","2020-09-14","41","5852","5","791","9.5","12.4"
"Mitchell","2020-09-15","21","5873","2","793","9.4","12.5"
"Mitchell","2020-09-16","21","5894","3","796","11.2","12.7"
"Mitchell","2020-09-17","19","5913","0","796","9.7","11.8"
"Mitchell","2020-09-18","48","5961","3","799","8.9","12"
"Mitchell","2020-09-19","4","5965","0","799","8.9","8.1"
"Mitchell","2020-09-20","11","5976","2","801","8.6","9.4"
"Mitchell","2020-09-21","21","5997","0","801","6.9","8.2"
"Mitchell","2020-09-22","32","6029","3","804","6.9","8.1"
"Mitchell","2020-09-23","35","6064","4","808","6.5","8.8"
"Mitchell","2020-09-24","78","6142","8","816","7.9","8.8"
"Mitchell","2020-09-25","23","6165","2","818","8.3","8.6"
"Mitchell","2020-09-26","8","6173","6","824","19","13.9"
"Mitchell","2020-09-27","5","6178","1","825","19.3","13.9"
"Mitchell","2020-09-28","31","6209","0","825","19.3","13.1"
"Mitchell","2020-09-29","29","6238","0","825","17.9","12.4"
"Mitchell","2020-09-30","23","6261","2","827","17.5","12"
"Mitchell","2020-10-01","25","6286","2","829","17.2","12.6"
"Mitchell","2020-10-02","46","6332","2","831","16.6","12.4"
"Mitchell","2020-10-03","7","6339","0","831","5.9","12.4"
"Mitchell","2020-10-04","7","6346","0","831","3","11.1"
"Mitchell","2020-10-05","20","6366","0","831","3","11.1"
"Mitchell","2020-10-06","31","6397","2","833","3.9","10.9"
"Mitchell","2020-10-07","34","6431","0","833","2.7","10.1"
"Mitchell","2020-10-08","66","6497","4","837","2.4","9.8"
"Mitchell","2020-10-09","19","6516","0","837","1.8","9.2"
"Mitchell","2020-10-10","13","6529","0","837","1.8","3.8"
"Mitchell","2020-10-11","7","6536","1","838","3.8","3.4"
"Mitchell","2020-10-12","26","6562","0","838","3.8","3.4"
"Mitchell","2020-10-13","22","6584","1","839","3.6","3.7"
"Mitchell","2020-10-14","23","6607","1","840","4.2","3.4"
"Mitchell","2020-10-15","12","6619","0","840","3.3","2.9"
"Mitchell","2020-10-16","48","6667","1","841","3.6","2.7"
"Mitchell","2020-10-17","9","6676","0","841","3.6","2.7"
"Mitchell","2020-10-18","4","6680","0","841","1.6","2.7"
"Mitchell","2020-10-19","32","6712","1","842","2","2.9"
"Mitchell","2020-10-20","28","6740","3","845","2.9","3.2"
"Mitchell","2020-10-21","19","6759","0","845","2.3","3.2"
"Mitchell","2020-10-22","70","6829","4","849","3.1","3.2"
"Mitchell","2020-10-23","23","6852","1","850","3.4","3.5"
"Mitchell","2020-10-24","15","6867","0","850","3.4","3.5"
"Mitchell","2020-10-25","2","6869","0","850","3.4","2.5"
"Mitchell","2020-10-26","26","6895","3","853","4.6","3.3"
"Mitchell","2020-10-27","21","6916","1","854","3.8","3.3"
"Mitchell","2020-10-28","29","6945","1","855","4.3","3.3"
"Mitchell","2020-10-29","16","6961","0","855","3.4","3.3"
"Mitchell","2020-10-30","20","6981","1","856","3.5","3.5"
"Mitchell","2020-10-31","33","7014","2","858","4.4","3.9"
"Mitchell","2020-11-01","16","7030","0","858","4.4","3.9"
"Mitchell","2020-11-02","25","7055","2","860","3.9","4.3"
"Mitchell","2020-11-03","19","7074","1","861","4","3.9"
"Mitchell","2020-11-04","31","7105","0","861","3.5","3.9"
"Mitchell","2020-11-05","55","7160","5","866","4.8","4.1"
"Mitchell","2020-11-06","15","7175","4","870","7.9","5.7"
"Mitchell","2020-11-07","5","7180","0","870","7","5.7"
"Mitchell","2020-11-08","7","7187","0","870","7","5.7"
"Mitchell","2020-11-09","22","7209","2","872","7.2","5.5"
"Mitchell","2020-11-10","22","7231","1","873","7.1","5.5"
"Mitchell","2020-11-11","36","7267","1","874","7.5","5.5"
"Mitchell","2020-11-12","13","7280","0","874","6.2","5.5"
"Mitchell","2020-11-13","18","7298","1","875","3.1","5.5"
"Mitchell","2020-11-14","28","7326","1","876","3.6","5.3"
"Mitchell","2020-11-15","3","7329","2","878","13.2","10.1"
"Mitchell","2020-11-16","29","7358","1","879","12.4","9.8"
"Mitchell","2020-11-17","19","7377","1","880","12.5","9.8"
"Mitchell","2020-11-18","56","7433","0","880","12.1","9.8"
"Mitchell","2020-11-19","49","7482","4","884","13.2","9.7"
"Mitchell","2020-11-20","16","7498","0","884","12.4","7.8"
"Mitchell","2020-11-21","35","7533","6","890","14.4","9"
"Mitchell","2020-11-22","9","7542","2","892","8","10.6"
"Mitchell","2020-11-23","30","7572","1","893","8","10.2"
"Mitchell","2020-11-24","23","7595","1","894","7.9","10.2"
"Mitchell","2020-11-25","25","7620","2","896","9","10.6"
"Mitchell","2020-11-26","27","7647","2","898","8.9","11.1"
"Mitchell","2020-11-27","15","7662","1","899","9.9","11.2"
"Mitchell","2020-11-28","11","7673","2","901","10","12.2"
"Mitchell","2020-11-29","6","7679","0","901","6.8","7.4"
"Mitchell","2020-11-30","35","7714","4","905","8","8"
"Mitchell","2020-12-01","33","7747","3","908","8.7","8.3"
"Mitchell","2020-12-02","30","7777","2","910","8.5","8.8"
"Mitchell","2020-12-03","24","7801","3","913","9.2","9.1"
"Mitchell","2020-12-04","21","7822","0","913","8.3","9.1"
"Mitchell","2020-12-05","7","7829","3","916","11.8","10.9"
"Mitchell","2020-12-06","6","7835","5","921","23.7","15.3"
"Mitchell","2020-12-07","48","7883","3","924","23","15.5"
"Mitchell","2020-12-08","35","7918","6","930","24.1","16.4"
"Mitchell","2020-12-09","52","7970","6","936","24.8","16.6"
"Mitchell","2020-12-10","50","8020","9","945","25.6","17.4"
"Mitchell","2020-12-11","41","8061","7","952","28","18.1"
"Mitchell","2020-12-12","15","8076","0","952","21.9","16.8"
"Mitchell","2020-12-13","12","8088","4","956","14.8","19.2"
"Mitchell","2020-12-14","39","8127","4","960","15.3","19.1"
"Mitchell","2020-12-15","31","8158","8","968","16.6","20.3"
"Mitchell","2020-12-16","207","8365","21","989","16.4","20.6"
"Mitchell","2020-12-17","39","8404","12","1001","18.2","21.9"
"Mitchell","2020-12-18","23","8427","8","1009","20.7","24.4"
"Mitchell","2020-12-19","12","8439","2","1011","23.1","22.5"
"Mitchell","2020-12-20","5","8444","0","1011","18.3","16.6"
"Mitchell","2020-12-21","35","8479","6","1017","19.3","17.3"
"Mitchell","2020-12-22","93","8572","30","1047","20.3","18.4"
"Mitchell","2020-12-23","140","8712","23","1070","21.1","18.8"
"Mitchell","2020-12-24","20","8732","2","1072","18.2","18.2"
"Mitchell","2020-12-25","15","8747","7","1079","19.9","20.3"
"Mitchell","2020-12-26","14","8761","6","1085","23.6","23.4"
"Mitchell","2020-12-27","17","8778","8","1093","30.3","24.3"
"Mitchell","2020-12-28","40","8818","10","1103","31.5","25.4"
"Mitchell","2020-12-29","52","8870","15","1118","31","25.6"
"Mitchell","2020-12-30","249","9119","31","1149","30.4","25.8"
"Mitchell","2020-12-31","40","9159","9","1158","32.2","25.2"
"Mitchell","2021-01-01","10","9169","4","1162","31.2","25.6"
"Mitchell","2021-01-02","37","9206","6","1168","27.4","25.5"
"Mitchell","2021-01-03","39","9245","4","1172","22.2","26.3"
"Mitchell","2021-01-04","45","9290","6","1178","20.5","26"
"Mitchell","2021-01-05","39","9329","5","1183","18.2","24.6"
"Mitchell","2021-01-06","169","9498","22","1205","18.3","24.4"
"Mitchell","2021-01-07","95","9593","6","1211","16","24.1"
"Mitchell","2021-01-08","43","9636","6","1217","12.3","21.8"
"Mitchell","2021-01-09","11","9647","3","1220","13.9","20.6"
"Mitchell","2021-01-10","18","9665","3","1223","14.8","18.5"
"Mitchell","2021-01-11","48","9713","15","1238","17.3","18.9"
"Mitchell","2021-01-12","43","9756","6","1244","17.5","17.9"
"Mitchell","2021-01-13","113","9869","17","1261","17.8","18"
"Mitchell","2021-01-14","34","9903","5","1266","19","17.5"
"Mitchell","2021-01-15","43","9946","4","1270","18.3","15.3"
"Mitchell","2021-01-16","10","9956","0","1270","14.4","14.1"
"Mitchell","2021-01-17","12","9968","3","1273","15.6","15.2"
"Mitchell","2021-01-18","39","10007","11","1284","15.2","16.3"
"Mitchell","2021-01-19","22","10029","1","1285","13.8","15.7"
"Mitchell","2021-01-20","202","10231","11","1296","12.5","15.1"
"Mitchell","2021-01-21","134","10365","31","1327","13.7","16.3"
"Mitchell","2021-01-22","43","10408","4","1331","13.7","16"
"Mitchell","2021-01-23","25","10433","0","1331","13.7","14"
"Mitchell","2021-01-24","16","10449","1","1332","11","13.3"
"Mitchell","2021-01-25","40","10489","9","1341","10.2","12.7"
"Mitchell","2021-01-26","34","10523","4","1345","11.2","12.5"
"Mitchell","2021-01-27","124","10647","12","1357","11.8","12.1"
"Mitchell","2021-01-28","31","10678","3","1360","9.9","11.8"
"Mitchell","2021-01-29","37","10715","7","1367","11.3","12.5"
"Mitchell","2021-01-30","11","10726","1","1368","12.6","13.1"
"Mitchell","2021-01-31","3","10729","0","1368","11.7","11.3"
"Mitchell","2021-02-01","21","10750","3","1371","10.5","10.3"
"Mitchell","2021-02-02","27","10777","3","1374","10.4","10.8"
"Mitchell","2021-02-03","22","10799","2","1376","10.3","11.1"
"Mitchell","2021-02-04","130","10929","8","1384","9.8","9.8"
"Mitchell","2021-02-05","29","10958","1","1385","7.6","9.4"
"Mitchell","2021-02-06","4","10962","0","1385","6.3","9.4"
"Mitchell","2021-02-07","4","10966","0","1385","6.3","9"
"Mitchell","2021-02-08","0","10966","0","1385","4.3","7.4"
"Monroe","2020-02-01","0","0","0","0",".","."
"Monroe","2020-02-02","0","0","0","0",".","."
"Monroe","2020-02-03","0","0","0","0",".","."
"Monroe","2020-02-04","0","0","0","0",".","."
"Monroe","2020-02-05","0","0","0","0",".","."
"Monroe","2020-02-06","0","0","0","0",".","."
"Monroe","2020-02-07","0","0","0","0","0","."
"Monroe","2020-02-08","0","0","0","0","0","."
"Monroe","2020-02-09","0","0","0","0","0","."
"Monroe","2020-02-10","0","0","0","0","0","."
"Monroe","2020-02-11","0","0","0","0","0","."
"Monroe","2020-02-12","0","0","0","0","0","."
"Monroe","2020-02-13","0","0","0","0","0","."
"Monroe","2020-02-14","0","0","0","0","0","0"
"Monroe","2020-02-15","0","0","0","0","0","0"
"Monroe","2020-02-16","0","0","0","0","0","0"
"Monroe","2020-02-17","0","0","0","0","0","0"
"Monroe","2020-02-18","0","0","0","0","0","0"
"Monroe","2020-02-19","0","0","0","0","0","0"
"Monroe","2020-02-20","0","0","0","0","0","0"
"Monroe","2020-02-21","0","0","0","0","0","0"
"Monroe","2020-02-22","0","0","0","0","0","0"
"Monroe","2020-02-23","0","0","0","0","0","0"
"Monroe","2020-02-24","0","0","0","0","0","0"
"Monroe","2020-02-25","0","0","0","0","0","0"
"Monroe","2020-02-26","0","0","0","0","0","0"
"Monroe","2020-02-27","0","0","0","0","0","0"
"Monroe","2020-02-28","0","0","0","0","0","0"
"Monroe","2020-02-29","0","0","0","0","0","0"
"Monroe","2020-03-01","0","0","0","0","0","0"
"Monroe","2020-03-02","0","0","0","0","0","0"
"Monroe","2020-03-03","0","0","0","0","0","0"
"Monroe","2020-03-04","0","0","0","0","0","0"
"Monroe","2020-03-05","0","0","0","0","0","0"
"Monroe","2020-03-06","0","0","0","0","0","0"
"Monroe","2020-03-07","0","0","0","0","0","0"
"Monroe","2020-03-08","0","0","0","0","0","0"
"Monroe","2020-03-09","0","0","0","0","0","0"
"Monroe","2020-03-10","0","0","0","0","0","0"
"Monroe","2020-03-11","0","0","0","0","0","0"
"Monroe","2020-03-12","0","0","0","0","0","0"
"Monroe","2020-03-13","3","3","0","0","0","0"
"Monroe","2020-03-14","0","3","0","0","0","0"
"Monroe","2020-03-15","1","4","0","0","0","0"
"Monroe","2020-03-16","5","9","0","0","0","0"
"Monroe","2020-03-17","7","16","0","0","0","0"
"Monroe","2020-03-18","4","20","1","1","3.6","1.8"
"Monroe","2020-03-19","6","26","0","1","3.6","1.8"
"Monroe","2020-03-20","11","37","2","3","6.2","3.1"
"Monroe","2020-03-21","1","38","0","3","6.2","3.1"
"Monroe","2020-03-22","4","42","1","4","9.7","4.9"
"Monroe","2020-03-23","13","55","2","6","11.9","6"
"Monroe","2020-03-24","8","63","0","6","11.9","6"
"Monroe","2020-03-25","5","68","1","7","11.2","7.4"
"Monroe","2020-03-26","12","80","1","8","12.4","8"
"Monroe","2020-03-27","13","93","1","9","10.9","8.5"
"Monroe","2020-03-28","0","93","0","9","10.9","8.5"
"Monroe","2020-03-29","1","94","0","9","7.3","8.5"
"Monroe","2020-03-30","4","98","0","9","5.1","8.5"
"Monroe","2020-03-31","7","105","0","9","5.1","8.5"
"Monroe","2020-04-01","14","119","0","9","2.3","6.8"
"Monroe","2020-04-02","11","130","3","12","5","8.7"
"Monroe","2020-04-03","20","150","4","16","6.8","8.8"
"Monroe","2020-04-04","0","150","0","16","6.8","8.8"
"Monroe","2020-04-05","3","153","0","16","6.8","7"
"Monroe","2020-04-06","12","165","1","17","7.9","6.5"
"Monroe","2020-04-07","7","172","0","17","7.9","6.5"
"Monroe","2020-04-08","7","179","0","17","7.9","5.1"
"Monroe","2020-04-09","4","183","0","17","4","4.5"
"Monroe","2020-04-10","9","192","1","18","2.8","4.8"
"Monroe","2020-04-11","3","195","0","18","2.8","4.8"
"Monroe","2020-04-12","0","195","0","18","2.8","4.8"
"Monroe","2020-04-13","22","217","0","18","1.6","4.8"
"Monroe","2020-04-14","9","226","1","19","3.2","5.6"
"Monroe","2020-04-15","13","239","0","19","3.2","5.6"
"Monroe","2020-04-16","8","247","0","19","3.2","3.6"
"Monroe","2020-04-17","9","256","0","19","1.6","2.2"
"Monroe","2020-04-18","2","258","0","19","1.6","2.2"
"Monroe","2020-04-19","1","259","0","19","1.6","2.2"
"Monroe","2020-04-20","14","273","4","23","5.7","3.6"
"Monroe","2020-04-21","12","285","2","25","6.5","4.8"
"Monroe","2020-04-22","18","303","1","26","7.3","5.2"
"Monroe","2020-04-23","12","315","0","26","7.3","5.2"
"Monroe","2020-04-24","17","332","1","27","8.1","4.8"
"Monroe","2020-04-25","14","346","6","33","14.2","7.9"
"Monroe","2020-04-26","4","350","0","33","14.2","7.9"
"Monroe","2020-04-27","12","362","0","33","10.1","7.9"
"Monroe","2020-04-28","10","372","0","33","7.8","7.1"
"Monroe","2020-04-29","15","387","1","34","7.9","7.6"
"Monroe","2020-04-30","13","400","0","34","7.9","7.6"
"Monroe","2020-05-01","11","411","1","35","8.4","8.2"
"Monroe","2020-05-02","4","415","0","35","2.3","8.2"
"Monroe","2020-05-03","6","421","0","35","2.3","8.2"
"Monroe","2020-05-04","16","437","5","40","6.7","8.4"
"Monroe","2020-05-05","12","449","1","41","7.9","7.8"
"Monroe","2020-05-06","20","469","0","41","7","7.4"
"Monroe","2020-05-07","8","477","0","41","7","7.4"
"Monroe","2020-05-08","16","493","1","42","6.5","7.5"
"Monroe","2020-05-09","6","499","1","43","8.9","5.6"
"Monroe","2020-05-10","4","503","1","44","12.5","7.4"
"Monroe","2020-05-11","22","525","3","47","10","8.3"
"Monroe","2020-05-12","18","543","2","49","10.4","9.1"
"Monroe","2020-05-13","6","549","2","51","15.1","11"
"Monroe","2020-05-14","13","562","2","53","17.3","12.1"
"Monroe","2020-05-15","111","673","5","58","17.1","11.8"
"Monroe","2020-05-16","2","675","1","59","21.9","15.4"
"Monroe","2020-05-17","5","680","2","61","24","18.2"
"Monroe","2020-05-18","20","700","5","66","25.6","17.8"
"Monroe","2020-05-19","29","729","2","68","25","17.7"
"Monroe","2020-05-20","69","798","3","71","20.9","18"
"Monroe","2020-05-21","23","821","0","71","18.7","18"
"Monroe","2020-05-22","28","849","2","73","19.1","18.1"
"Monroe","2020-05-23","13","862","3","76","15.2","18.5"
"Monroe","2020-05-24","8","870","2","78","13.1","18.5"
"Monroe","2020-05-25","10","880","3","81","13.8","19.7"
"Monroe","2020-05-26","26","906","3","84","14.4","19.7"
"Monroe","2020-05-27","14","920","0","84","13.8","17.3"
"Monroe","2020-05-28","7","927","0","84","13.8","16.3"
"Monroe","2020-05-29","13","940","2","86","15","17"
"Monroe","2020-05-30","14","954","4","90","15.8","15.5"
"Monroe","2020-05-31","6","960","1","91","14.6","13.8"
"Monroe","2020-06-01","21","981","1","92","11","12.4"
"Monroe","2020-06-02","18","999","0","92","9.3","11.9"
"Monroe","2020-06-03","53","1052","2","94","9.9","11.9"
"Monroe","2020-06-04","21","1073","2","96","11.2","12.5"
"Monroe","2020-06-05","23","1096","0","96","9","12"
"Monroe","2020-06-06","4","1100","0","96","5","10.4"
"Monroe","2020-06-07","1","1101","0","96","2.6","8.6"
"Monroe","2020-06-08","24","1125","1","97","2.5","6.7"
"Monroe","2020-06-09","23","1148","0","97","2.5","5.9"
"Monroe","2020-06-10","44","1192","2","99","2.6","6.2"
"Monroe","2020-06-11","32","1224","4","103","3","7.1"
"Monroe","2020-06-12","30","1254","3","106","4.5","6.8"
"Monroe","2020-06-13","1","1255","0","106","4.5","4.7"
"Monroe","2020-06-14","2","1257","0","106","4.5","3.5"
"Monroe","2020-06-15","21","1278","1","107","4.5","3.5"
"Monroe","2020-06-16","33","1311","0","107","4.5","3.5"
"Monroe","2020-06-17","60","1371","2","109","4.4","3.5"
"Monroe","2020-06-18","26","1397","3","112","4.2","3.6"
"Monroe","2020-06-19","43","1440","8","120","5.5","5"
"Monroe","2020-06-20","15","1455","7","127","12.1","8.3"
"Monroe","2020-06-21","13","1468","0","127","12.1","8.3"
"Monroe","2020-06-22","63","1531","3","130","12.1","8.3"
"Monroe","2020-06-23","43","1574","2","132","12.8","8.7"
"Monroe","2020-06-24","75","1649","10","142","14.2","9.3"
"Monroe","2020-06-25","45","1694","5","147","14.2","9.2"
"Monroe","2020-06-26","33","1727","6","153","14.1","9.8"
"Monroe","2020-06-27","12","1739","2","155","9.8","11"
"Monroe","2020-06-28","11","1750","1","156","11.1","11.6"
"Monroe","2020-06-29","74","1824","5","161","11.4","11.8"
"Monroe","2020-06-30","89","1913","23","184","14.4","13.6"
"Monroe","2020-07-01","113","2026","12","196","14","14.1"
"Monroe","2020-07-02","69","2095","7","203","13.9","14"
"Monroe","2020-07-03","19","2114","3","206","13.6","13.8"
"Monroe","2020-07-04","10","2124","7","213","21.2","15.5"
"Monroe","2020-07-05","11","2135","2","215","22.5","16.8"
"Monroe","2020-07-06","115","2250","13","228","23.1","17.3"
"Monroe","2020-07-07","81","2331","12","240","21.6","18"
"Monroe","2020-07-08","104","2435","10","250","21.4","17.7"
"Monroe","2020-07-09","67","2502","14","264","22.9","18.4"
"Monroe","2020-07-10","70","2572","10","274","22.7","18.1"
"Monroe","2020-07-11","16","2588","5","279","17.2","19.2"
"Monroe","2020-07-12","15","2603","6","285","20.3","21.4"
"Monroe","2020-07-13","133","2736","42","327","23.2","23.2"
"Monroe","2020-07-14","62","2798","14","341","24.3","22.9"
"Monroe","2020-07-15","119","2917","12","353","24.4","22.9"
"Monroe","2020-07-16","45","2962","11","364","24.9","23.9"
"Monroe","2020-07-17","76","3038","8","372","24.4","23.5"
"Monroe","2020-07-18","15","3053","3","375","22.7","20"
"Monroe","2020-07-19","20","3073","5","380","20.6","20.5"
"Monroe","2020-07-20","53","3126","19","399","21.2","22.2"
"Monroe","2020-07-21","51","3177","9","408","20.5","22.4"
"Monroe","2020-07-22","82","3259","17","425","22","23.2"
"Monroe","2020-07-23","103","3362","11","436","20.1","22.5"
"Monroe","2020-07-24","81","3443","28","464","23.5","23.9"
"Monroe","2020-07-25","18","3461","4","468","23.8","23.3"
"Monroe","2020-07-26","25","3486","5","473","23.1","21.9"
"Monroe","2020-07-27","65","3551","11","484","20.4","20.8"
"Monroe","2020-07-28","50","3601","12","496","21.3","20.9"
"Monroe","2020-07-29","104","3705","9","505","19.6","20.8"
"Monroe","2020-07-30","46","3751","11","516","21.5","20.8"
"Monroe","2020-07-31","71","3822","14","530","19.3","21.4"
"Monroe","2020-08-01","21","3843","5","535","19.6","21.7"
"Monroe","2020-08-02","25","3868","2","537","17.9","20.5"
"Monroe","2020-08-03","53","3921","6","543","17.1","18.7"
"Monroe","2020-08-04","39","3960","3","546","14.7","18"
"Monroe","2020-08-05","69","4029","10","556","15.6","17.6"
"Monroe","2020-08-06","52","4081","5","561","13.5","17.5"
"Monroe","2020-08-07","101","4182","12","573","12.4","15.9"
"Monroe","2020-08-08","24","4206","7","580","13.2","16.4"
"Monroe","2020-08-09","78","4284","10","590","13.9","15.9"
"Monroe","2020-08-10","39","4323","8","598","15.2","16.1"
"Monroe","2020-08-11","42","4365","6","604","16.1","15.4"
"Monroe","2020-08-12","112","4477","17","621","16.2","15.9"
"Monroe","2020-08-13","47","4524","7","628","17","15.2"
"Monroe","2020-08-14","72","4596","6","634","16.5","14.4"
"Monroe","2020-08-15","73","4669","6","640","13.5","13.3"
"Monroe","2020-08-16","26","4695","8","648","16","14.9"
"Monroe","2020-08-17","43","4738","8","656","15.8","15.5"
"Monroe","2020-08-18","41","4779","5","661","15.5","15.8"
"Monroe","2020-08-19","63","4842","6","667","14.6","15.4"
"Monroe","2020-08-20","38","4880","5","672","14.4","15.7"
"Monroe","2020-08-21","47","4927","6","678","15","15.7"
"Monroe","2020-08-22","14","4941","3","681","16.9","15.2"
"Monroe","2020-08-23","30","4971","2","683","13.5","14.8"
"Monroe","2020-08-24","43","5014","5","688","12.5","14.1"
"Monroe","2020-08-25","47","5061","11","699","14.1","14.8"
"Monroe","2020-08-26","45","5106","5","704","14.3","14.5"
"Monroe","2020-08-27","27","5133","3","707","14","14.2"
"Monroe","2020-08-28","110","5243","15","722","14.1","14.6"
"Monroe","2020-08-29","62","5305","2","724","11.5","14.2"
"Monroe","2020-08-30","24","5329","0","724","10.6","12"
"Monroe","2020-08-31","47","5376","6","730","10.8","11.6"
"Monroe","2020-09-01","36","5412","3","733","8.6","11.3"
"Monroe","2020-09-02","67","5479","3","736","7.7","11"
"Monroe","2020-09-03","28","5507","3","739","7.6","10.8"
"Monroe","2020-09-04","80","5587","8","747","7.1","10.6"
"Monroe","2020-09-05","41","5628","2","749","7.3","9.4"
"Monroe","2020-09-06","16","5644","2","751","9.1","9.8"
"Monroe","2020-09-07","6","5650","2","753","12","11.4"
"Monroe","2020-09-08","27","5677","1","754","11.4","10"
"Monroe","2020-09-09","22","5699","5","759","14","10.8"
"Monroe","2020-09-10","44","5743","4","763","13.7","10.7"
"Monroe","2020-09-11","117","5860","1","764","12.4","9.8"
"Monroe","2020-09-12","32","5892","4","768","13.5","10.4"
"Monroe","2020-09-13","12","5904","3","771","15.3","12.2"
"Monroe","2020-09-14","24","5928","1","772","11.1","11.6"
"Monroe","2020-09-15","38","5966","4","776","12.1","11.7"
"Monroe","2020-09-16","58","6024","4","780","9.9","11.9"
"Monroe","2020-09-17","59","6083","3","783","9.3","11.5"
"Monroe","2020-09-18","30","6113","2","785","10.1","11.3"
"Monroe","2020-09-19","13","6126","3","788","11.6","12.6"
"Monroe","2020-09-20","10","6136","1","789","9.5","12.4"
"Monroe","2020-09-21","45","6181","6","795","10.8","11"
"Monroe","2020-09-22","43","6224","4","799","10.6","11.4"
"Monroe","2020-09-23","35","6259","2","801","10.5","10.2"
"Monroe","2020-09-24","43","6302","4","805","11.1","10.2"
"Monroe","2020-09-25","30","6332","0","805","10.1","10.1"
"Monroe","2020-09-26","22","6354","6","811","10.7","11.2"
"Monroe","2020-09-27","15","6369","1","812","10.2","9.9"
"Monroe","2020-09-28","33","6402","4","816","10.1","10.4"
"Monroe","2020-09-29","39","6441","1","817","9.1","9.9"
"Monroe","2020-09-30","36","6477","4","821","9.9","10.2"
"Monroe","2020-10-01","38","6515","3","824","9.7","10.4"
"Monroe","2020-10-02","38","6553","5","829","11.5","10.8"
"Monroe","2020-10-03","16","6569","3","832","10.3","10.5"
"Monroe","2020-10-04","11","6580","1","833","10.7","10.4"
"Monroe","2020-10-05","66","6646","6","839","10.2","10.1"
"Monroe","2020-10-06","134","6780","3","842","10.2","9.6"
"Monroe","2020-10-07","75","6855","3","845","9.2","9.5"
"Monroe","2020-10-08","46","6901","1","846","8.4","9"
"Monroe","2020-10-09","32","6933","3","849","7.8","9.7"
"Monroe","2020-10-10","34","6967","2","851","6","8.2"
"Monroe","2020-10-11","12","6979","1","852","5.9","8.3"
"Monroe","2020-10-12","37","7016","1","853","5","7.6"
"Monroe","2020-10-13","41","7057","3","856","5.7","7.9"
"Monroe","2020-10-14","31","7088","5","861","7.4","8.3"
"Monroe","2020-10-15","34","7122","5","866","9.2","8.8"
"Monroe","2020-10-16","26","7148","0","866","7.9","7.8"
"Monroe","2020-10-17","7","7155","1","867","9.1","7.5"
"Monroe","2020-10-18","6","7161","1","868","10.3","8.1"
"Monroe","2020-10-19","52","7213","3","871","10.7","7.8"
"Monroe","2020-10-20","45","7258","2","873","10.3","8"
"Monroe","2020-10-21","29","7287","3","876","9.5","8.4"
"Monroe","2020-10-22","29","7316","2","878","8.3","8.8"
"Monroe","2020-10-23","46","7362","3","881","9.3","8.6"
"Monroe","2020-10-24","11","7373","0","881","7.2","8.2"
"Monroe","2020-10-25","14","7387","4","885","8.9","9.6"
"Monroe","2020-10-26","48","7435","4","889","9.3","10"
"Monroe","2020-10-27","37","7472","2","891","9.4","9.9"
"Monroe","2020-10-28","51","7523","6","897","9.6","9.6"
"Monroe","2020-10-29","42","7565","3","900","9.7","9"
"Monroe","2020-10-30","34","7599","4","904","10.4","9.9"
"Monroe","2020-10-31","16","7615","4","908","14","10.6"
"Monroe","2020-11-01","6","7621","0","908","9.9","9.4"
"Monroe","2020-11-02","39","7660","7","915","11.3","10.3"
"Monroe","2020-11-03","44","7704","5","920","12.1","10.8"
"Monroe","2020-11-04","28","7732","1","921","11","10.3"
"Monroe","2020-11-05","34","7766","4","925","11.6","10.7"
"Monroe","2020-11-06","40","7806","3","928","11","10.7"
"Monroe","2020-11-07","15","7821","3","931","10.3","12.2"
"Monroe","2020-11-08","13","7834","3","934","13.6","11.8"
"Monroe","2020-11-09","46","7880","4","938","12.3","11.8"
"Monroe","2020-11-10","44","7924","6","944","12.6","12.4"
"Monroe","2020-11-11","46","7970","10","954","15.2","13.1"
"Monroe","2020-11-12","35","8005","3","957","14.7","13.2"
"Monroe","2020-11-13","49","8054","4","961","14.8","12.9"
"Monroe","2020-11-14","18","8072","3","964","14.4","12.3"
"Monroe","2020-11-15","13","8085","2","966","13.3","13.4"
"Monroe","2020-11-16","59","8144","8","974","14","13.1"
"Monroe","2020-11-17","43","8187","6","980","14","13.3"
"Monroe","2020-11-18","55","8242","6","986","12.5","13.8"
"Monroe","2020-11-19","50","8292","13","999","14.9","14.8"
"Monroe","2020-11-20","41","8333","7","1006","16.2","15.5"
"Monroe","2020-11-21","11","8344","3","1009","17.7","16.1"
"Monroe","2020-11-22","14","8358","4","1013","19.6","16.4"
"Monroe","2020-11-23","33","8391","3","1016","19","16.5"
"Monroe","2020-11-24","30","8421","5","1021","19.4","16.7"
"Monroe","2020-11-25","43","8464","11","1032","21.5","17"
"Monroe","2020-11-26","4","8468","1","1033","21.3","18.1"
"Monroe","2020-11-27","32","8500","7","1040","22","19.1"
"Monroe","2020-11-28","13","8513","1","1041","19.2","18.5"
"Monroe","2020-11-29","15","8528","2","1043","17","18.3"
"Monroe","2020-11-30","56","8584","13","1056","19.1","19"
"Monroe","2020-12-01","47","8631","10","1066","19.7","19.5"
"Monroe","2020-12-02","56","8687","10","1076","18.6","20"
"Monroe","2020-12-03","24","8711","2","1078","16.2","18.8"
"Monroe","2020-12-04","43","8754","3","1081","14.1","18.1"
"Monroe","2020-12-05","20","8774","4","1085","15.9","17.5"
"Monroe","2020-12-06","24","8798","6","1091","17.5","17.3"
"Monroe","2020-12-07","68","8866","12","1103","16.7","17.9"
"Monroe","2020-12-08","76","8942","15","1118","16.5","18.1"
"Monroe","2020-12-09","96","9038","18","1136","16.6","17.6"
"Monroe","2020-12-10","115","9153","15","1151","17.3","16.8"
"Monroe","2020-12-11","54","9207","15","1166","20.3","17.2"
"Monroe","2020-12-12","27","9234","5","1171","20.1","18"
"Monroe","2020-12-13","26","9260","4","1175","18.7","18.1"
"Monroe","2020-12-14","96","9356","16","1191","18.6","17.6"
"Monroe","2020-12-15","73","9429","18","1209","19.3","17.9"
"Monroe","2020-12-16","85","9514","14","1223","18.9","17.8"
"Monroe","2020-12-17","68","9582","18","1241","20.8","19.1"
"Monroe","2020-12-18","71","9653","10","1251","18.9","19.6"
"Monroe","2020-12-19","26","9679","11","1262","22.3","21.2"
"Monroe","2020-12-20","24","9703","5","1267","23.1","20.9"
"Monroe","2020-12-21","101","9804","30","1297","24.9","21.7"
"Monroe","2020-12-22","69","9873","19","1316","25.3","22.3"
"Monroe","2020-12-23","107","9980","27","1343","26.6","22.8"
"Monroe","2020-12-24","47","10027","15","1358","27.4","24.1"
"Monroe","2020-12-25","10","10037","4","1362","31.1","25"
"Monroe","2020-12-26","40","10077","11","1373","29","25.6"
"Monroe","2020-12-27","39","10116","13","1386","30.7","26.9"
"Monroe","2020-12-28","93","10209","24","1410","30.2","27.6"
"Monroe","2020-12-29","73","10282","10","1420","28.2","26.8"
"Monroe","2020-12-30","93","10375","21","1441","27.8","27.2"
"Monroe","2020-12-31","68","10443","17","1458","26.8","27.1"
"Monroe","2021-01-01","15","10458","3","1461","24","27.5"
"Monroe","2021-01-02","14","10472","3","1464","23.1","26"
"Monroe","2021-01-03","13","10485","5","1469","23.9","27.3"
"Monroe","2021-01-04","74","10559","19","1488","23.8","27"
"Monroe","2021-01-05","90","10649","15","1503","24.3","26.2"
"Monroe","2021-01-06","84","10733","20","1523","24.4","26.1"
"Monroe","2021-01-07","80","10813","14","1537","23.4","25.1"
"Monroe","2021-01-08","164","10977","19","1556","22.2","23.1"
"Monroe","2021-01-09","17","10994","4","1560","22.5","22.8"
"Monroe","2021-01-10","30","11024","5","1565","19.3","21.6"
"Monroe","2021-01-11","88","11112","24","1589","19.6","21.7"
"Monroe","2021-01-12","78","11190","11","1600","19.2","21.7"
"Monroe","2021-01-13","74","11264","14","1614","18.5","21.5"
"Monroe","2021-01-14","55","11319","7","1621","17.8","20.6"
"Monroe","2021-01-15","80","11399","16","1637","19","20.6"
"Monroe","2021-01-16","22","11421","2","1639","17","19.7"
"Monroe","2021-01-17","23","11444","5","1644","17.7","18.5"
"Monroe","2021-01-18","57","11501","13","1657","17.1","18.3"
"Monroe","2021-01-19","69","11570","15","1672","18.1","18.7"
"Monroe","2021-01-20","74","11644","7","1679","16.8","17.7"
"Monroe","2021-01-21","71","11715","10","1689","17","17.4"
"Monroe","2021-01-22","93","11808","18","1707","16.9","18"
"Monroe","2021-01-23","21","11829","5","1712","19","18"
"Monroe","2021-01-24","24","11853","8","1720","20.7","19.2"
"Monroe","2021-01-25","70","11923","15","1735","20.5","18.8"
"Monroe","2021-01-26","61","11984","15","1750","20.9","19.5"
"Monroe","2021-01-27","65","12049","10","1760","21.7","19.3"
"Monroe","2021-01-28","53","12102","8","1768","21.9","19.4"
"Monroe","2021-01-29","62","12164","8","1776","20.9","18.9"
"Monroe","2021-01-30","37","12201","5","1781","19.5","19.2"
"Monroe","2021-01-31","29","12230","11","1792","20.1","20.4"
"Monroe","2021-02-01","67","12297","13","1805","19.8","20.1"
"Monroe","2021-02-02","45","12342","7","1812","18.5","19.7"
"Monroe","2021-02-03","52","12394","12","1824","19.6","20.7"
"Monroe","2021-02-04","49","12443","5","1829","18.9","20.4"
"Monroe","2021-02-05","31","12474","2","1831","18","19.5"
"Monroe","2021-02-06","5","12479","0","1831","16.1","17.8"
"Monroe","2021-02-07","0","12479","0","1831","10.7","15.4"
"Monroe","2021-02-08","0","12479","0","1831","7.9","13.9"
"Montgomery","2020-02-01","0","0","0","0",".","."
"Montgomery","2020-02-02","0","0","0","0",".","."
"Montgomery","2020-02-03","0","0","0","0",".","."
"Montgomery","2020-02-04","0","0","0","0",".","."
"Montgomery","2020-02-05","0","0","0","0",".","."
"Montgomery","2020-02-06","0","0","0","0",".","."
"Montgomery","2020-02-07","0","0","0","0","0","."
"Montgomery","2020-02-08","0","0","0","0","0","."
"Montgomery","2020-02-09","0","0","0","0","0","."
"Montgomery","2020-02-10","0","0","0","0","0","."
"Montgomery","2020-02-11","0","0","0","0","0","."
"Montgomery","2020-02-12","0","0","0","0","0","."
"Montgomery","2020-02-13","0","0","0","0","0","."
"Montgomery","2020-02-14","0","0","0","0","0","0"
"Montgomery","2020-02-15","0","0","0","0","0","0"
"Montgomery","2020-02-16","0","0","0","0","0","0"
"Montgomery","2020-02-17","0","0","0","0","0","0"
"Montgomery","2020-02-18","0","0","0","0","0","0"
"Montgomery","2020-02-19","0","0","0","0","0","0"
"Montgomery","2020-02-20","0","0","0","0","0","0"
"Montgomery","2020-02-21","0","0","0","0","0","0"
"Montgomery","2020-02-22","0","0","0","0","0","0"
"Montgomery","2020-02-23","0","0","0","0","0","0"
"Montgomery","2020-02-24","0","0","0","0","0","0"
"Montgomery","2020-02-25","0","0","0","0","0","0"
"Montgomery","2020-02-26","0","0","0","0","0","0"
"Montgomery","2020-02-27","0","0","0","0","0","0"
"Montgomery","2020-02-28","0","0","0","0","0","0"
"Montgomery","2020-02-29","0","0","0","0","0","0"
"Montgomery","2020-03-01","0","0","0","0","0","0"
"Montgomery","2020-03-02","0","0","0","0","0","0"
"Montgomery","2020-03-03","0","0","0","0","0","0"
"Montgomery","2020-03-04","0","0","0","0","0","0"
"Montgomery","2020-03-05","0","0","0","0","0","0"
"Montgomery","2020-03-06","0","0","0","0","0","0"
"Montgomery","2020-03-07","0","0","0","0","0","0"
"Montgomery","2020-03-08","0","0","0","0","0","0"
"Montgomery","2020-03-09","0","0","0","0","0","0"
"Montgomery","2020-03-10","0","0","0","0","0","0"
"Montgomery","2020-03-11","0","0","0","0","0","0"
"Montgomery","2020-03-12","0","0","0","0","0","0"
"Montgomery","2020-03-13","0","0","0","0","0","0"
"Montgomery","2020-03-14","0","0","0","0","0","0"
"Montgomery","2020-03-15","0","0","0","0","0","0"
"Montgomery","2020-03-16","1","1","0","0","0","0"
"Montgomery","2020-03-17","5","6","0","0","0","0"
"Montgomery","2020-03-18","0","6","0","0","0","0"
"Montgomery","2020-03-19","0","6","0","0","0","0"
"Montgomery","2020-03-20","2","8","0","0","0","0"
"Montgomery","2020-03-21","0","8","0","0","0","0"
"Montgomery","2020-03-22","0","8","0","0","0","0"
"Montgomery","2020-03-23","0","8","0","0","0","0"
"Montgomery","2020-03-24","2","10","0","0","0","0"
"Montgomery","2020-03-25","2","12","0","0","0","0"
"Montgomery","2020-03-26","1","13","0","0","0","0"
"Montgomery","2020-03-27","0","13","0","0","0","0"
"Montgomery","2020-03-28","0","13","0","0","0","0"
"Montgomery","2020-03-29","0","13","0","0","0","0"
"Montgomery","2020-03-30","1","14","0","0","0","0"
"Montgomery","2020-03-31","0","14","0","0","0","0"
"Montgomery","2020-04-01","0","14","0","0","0","0"
"Montgomery","2020-04-02","0","14","0","0","0","0"
"Montgomery","2020-04-03","0","14","0","0","0","0"
"Montgomery","2020-04-04","0","14","0","0","0","0"
"Montgomery","2020-04-05","1","15","0","0","0","0"
"Montgomery","2020-04-06","0","15","0","0","0","0"
"Montgomery","2020-04-07","3","18","1","1","4.8","2.4"
"Montgomery","2020-04-08","4","22","0","1","4.8","2.4"
"Montgomery","2020-04-09","0","22","0","1","4.8","2.4"
"Montgomery","2020-04-10","4","26","1","2","8.3","4.2"
"Montgomery","2020-04-11","3","29","0","2","8.3","4.2"
"Montgomery","2020-04-12","0","29","0","2","8.3","4.2"
"Montgomery","2020-04-13","0","29","0","2","8.3","4.2"
"Montgomery","2020-04-14","0","29","0","2","3.6","4.2"
"Montgomery","2020-04-15","2","31","1","3","10.7","7.7"
"Montgomery","2020-04-16","1","32","0","3","10.7","7.7"
"Montgomery","2020-04-17","1","33","0","3","7.1","7.7"
"Montgomery","2020-04-18","1","34","1","4","21.4","14.9"
"Montgomery","2020-04-19","1","35","0","4","21.4","14.9"
"Montgomery","2020-04-20","3","38","0","4","21.4","14.9"
"Montgomery","2020-04-21","1","39","0","4","21.4","12.5"
"Montgomery","2020-04-22","2","41","0","4","14.3","12.5"
"Montgomery","2020-04-23","3","44","1","5","19","14.9"
"Montgomery","2020-04-24","2","46","0","5","19","13.1"
"Montgomery","2020-04-25","0","46","0","5","4.8","13.1"
"Montgomery","2020-04-26","0","46","0","5","4.8","13.1"
"Montgomery","2020-04-27","4","50","0","5","4.8","13.1"
"Montgomery","2020-04-28","3","53","0","5","4.8","13.1"
"Montgomery","2020-04-29","3","56","0","5","4.8","9.5"
"Montgomery","2020-04-30","1","57","0","5","0","9.5"
"Montgomery","2020-05-01","4","61","1","6","3.6","11.3"
"Montgomery","2020-05-02","0","61","0","6","3.6","4.2"
"Montgomery","2020-05-03","1","62","1","7","17.9","11.3"
"Montgomery","2020-05-04","2","64","0","7","17.9","11.3"
"Montgomery","2020-05-05","3","67","0","7","17.9","11.3"
"Montgomery","2020-05-06","5","72","0","7","17.9","11.3"
"Montgomery","2020-05-07","6","78","3","10","25","12.5"
"Montgomery","2020-05-08","4","82","0","10","21.4","12.5"
"Montgomery","2020-05-09","4","86","0","10","21.4","12.5"
"Montgomery","2020-05-10","1","87","0","10","7.1","12.5"
"Montgomery","2020-05-11","1","88","0","10","7.1","12.5"
"Montgomery","2020-05-12","5","93","1","11","10","13.9"
"Montgomery","2020-05-13","2","95","0","11","10","13.9"
"Montgomery","2020-05-14","0","95","0","11","2.9","13.9"
"Montgomery","2020-05-15","1","96","0","11","2.9","12.1"
"Montgomery","2020-05-16","0","96","0","11","2.9","12.1"
"Montgomery","2020-05-17","0","96","0","11","2.9","5"
"Montgomery","2020-05-18","3","99","0","11","2.9","5"
"Montgomery","2020-05-19","5","104","1","12","2.9","6.4"
"Montgomery","2020-05-20","2","106","0","12","2.9","6.4"
"Montgomery","2020-05-21","3","109","0","12","2.9","2.9"
"Montgomery","2020-05-22","2","111","0","12","2.9","2.9"
"Montgomery","2020-05-23","1","112","0","12","2.9","2.9"
"Montgomery","2020-05-24","0","112","0","12","2.9","2.9"
"Montgomery","2020-05-25","3","115","1","13","7.6","5.2"
"Montgomery","2020-05-26","4","119","0","13","4.8","3.8"
"Montgomery","2020-05-27","10","129","0","13","4.8","3.8"
"Montgomery","2020-05-28","7","136","0","13","4.8","3.8"
"Montgomery","2020-05-29","2","138","0","13","4.8","3.8"
"Montgomery","2020-05-30","5","143","0","13","4.8","3.8"
"Montgomery","2020-05-31","0","143","0","13","4.8","3.8"
"Montgomery","2020-06-01","13","156","1","14","1.1","4.4"
"Montgomery","2020-06-02","8","164","3","17","6.5","5.6"
"Montgomery","2020-06-03","11","175","0","17","6.5","5.6"
"Montgomery","2020-06-04","5","180","0","17","6.5","5.6"
"Montgomery","2020-06-05","1","181","1","18","20.7","12.8"
"Montgomery","2020-06-06","7","188","1","19","22.8","13.8"
"Montgomery","2020-06-07","1","189","0","19","22.8","13.8"
"Montgomery","2020-06-08","9","198","2","21","24.9","13"
"Montgomery","2020-06-09","9","207","1","22","21.1","13.8"
"Montgomery","2020-06-10","10","217","0","22","21.1","13.8"
"Montgomery","2020-06-11","7","224","2","24","25.2","15.8"
"Montgomery","2020-06-12","4","228","0","24","10.9","15.8"
"Montgomery","2020-06-13","3","231","1","25","13.6","18.2"
"Montgomery","2020-06-14","2","233","0","25","13.6","18.2"
"Montgomery","2020-06-15","12","245","0","25","10.4","17.6"
"Montgomery","2020-06-16","11","256","2","27","11.4","16.3"
"Montgomery","2020-06-17","4","260","0","27","11.4","16.3"
"Montgomery","2020-06-18","3","263","0","27","7.4","16.3"
"Montgomery","2020-06-19","0","263","0","27","7.4","9.1"
"Montgomery","2020-06-20","2","265","0","27","2.6","8.1"
"Montgomery","2020-06-21","0","265","0","27","2.6","8.1"
"Montgomery","2020-06-22","7","272","2","29","6.7","8.6"
"Montgomery","2020-06-23","9","281","2","31","7.3","9.3"
"Montgomery","2020-06-24","11","292","1","32","8.6","10"
"Montgomery","2020-06-25","13","305","0","32","8.6","8"
"Montgomery","2020-06-26","9","314","1","33","10.1","8.8"
"Montgomery","2020-06-27","4","318","0","33","10.1","6.4"
"Montgomery","2020-06-28","3","321","1","34","14.9","8.8"
"Montgomery","2020-06-29","11","332","1","35","12.1","9.4"
"Montgomery","2020-06-30","12","344","6","41","16.1","11.7"
"Montgomery","2020-07-01","14","358","3","44","17.9","13.2"
"Montgomery","2020-07-02","9","367","3","47","22.6","15.6"
"Montgomery","2020-07-03","6","373","0","47","21","15.6"
"Montgomery","2020-07-04","1","374","0","47","21","15.6"
"Montgomery","2020-07-05","3","377","1","48","21","18"
"Montgomery","2020-07-06","17","394","3","51","22.2","17.2"
"Montgomery","2020-07-07","16","410","3","54","17.8","16.9"
"Montgomery","2020-07-08","13","423","5","59","20.2","19"
"Montgomery","2020-07-09","10","433","4","63","21.2","21.9"
"Montgomery","2020-07-10","12","445","4","67","25.9","23.5"
"Montgomery","2020-07-11","3","448","2","69","35.5","28.2"
"Montgomery","2020-07-12","9","457","0","69","30.7","25.9"
"Montgomery","2020-07-13","15","472","0","69","28.2","25.2"
"Montgomery","2020-07-14","22","494","4","73","28.1","22.9"
"Montgomery","2020-07-15","9","503","2","75","25.8","23"
"Montgomery","2020-07-16","10","513","5","80","27.2","24.2"
"Montgomery","2020-07-17","5","518","2","82","28.2","27"
"Montgomery","2020-07-18","8","526","3","85","24","29.7"
"Montgomery","2020-07-19","8","534","5","90","32.9","31.8"
"Montgomery","2020-07-20","12","546","5","95","38.9","33.5"
"Montgomery","2020-07-21","12","558","6","101","43.4","35.8"
"Montgomery","2020-07-22","15","573","2","103","42.1","34"
"Montgomery","2020-07-23","20","593","1","104","35.7","31.5"
"Montgomery","2020-07-24","10","603","2","106","32.9","30.5"
"Montgomery","2020-07-25","2","605","0","106","27.5","25.7"
"Montgomery","2020-07-26","3","608","1","107","23.3","28.1"
"Montgomery","2020-07-27","13","621","4","111","21.8","30.3"
"Montgomery","2020-07-28","14","635","4","115","18.7","31.1"
"Montgomery","2020-07-29","13","648","2","117","19","30.6"
"Montgomery","2020-07-30","11","659","2","119","20.9","28.3"
"Montgomery","2020-07-31","11","670","3","122","21.9","27.4"
"Montgomery","2020-08-01","4","674","1","123","25.5","26.5"
"Montgomery","2020-08-02","11","685","7","130","29.8","26.6"
"Montgomery","2020-08-03","15","700","5","135","30.2","26"
"Montgomery","2020-08-04","11","711","2","137","28.7","23.7"
"Montgomery","2020-08-05","13","724","4","141","30.9","25"
"Montgomery","2020-08-06","9","733","1","142","29.9","25.4"
"Montgomery","2020-08-07","15","748","0","142","26","24"
"Montgomery","2020-08-08","9","757","2","144","25.6","25.6"
"Montgomery","2020-08-09","7","764","2","146","20.6","25.2"
"Montgomery","2020-08-10","8","772","1","147","17.6","23.9"
"Montgomery","2020-08-11","12","784","3","150","18.6","23.7"
"Montgomery","2020-08-12","16","800","3","153","16.9","23.9"
"Montgomery","2020-08-13","11","811","2","155","17.9","23.9"
"Montgomery","2020-08-14","5","816","1","156","20.7","23.4"
"Montgomery","2020-08-15","8","824","3","159","22.9","24.3"
"Montgomery","2020-08-16","2","826","0","159","18.8","19.7"
"Montgomery","2020-08-17","9","835","1","160","18.6","18.1"
"Montgomery","2020-08-18","13","848","2","162","17.3","17.9"
"Montgomery","2020-08-19","19","867","3","165","16.9","16.9"
"Montgomery","2020-08-20","9","876","0","165","14.3","16.1"
"Montgomery","2020-08-21","25","901","2","167","12.5","16.6"
"Montgomery","2020-08-22","10","911","0","167","7.2","15.1"
"Montgomery","2020-08-23","4","915","1","168","10.8","14.8"
"Montgomery","2020-08-24","13","928","0","168","9.2","13.9"
"Montgomery","2020-08-25","20","948","4","172","9.8","13.6"
"Montgomery","2020-08-26","6","954","1","173","10","13.4"
"Montgomery","2020-08-27","16","970","3","176","12.6","13.4"
"Montgomery","2020-08-28","9","979","4","180","17.8","15.2"
"Montgomery","2020-08-29","12","991","6","186","25","16.1"
"Montgomery","2020-08-30","7","998","1","187","23.4","17.1"
"Montgomery","2020-08-31","10","1008","4","191","29.2","19.2"
"Montgomery","2020-09-01","13","1021","2","193","28.5","19.2"
"Montgomery","2020-09-02","51","1072","1","194","26.4","18.2"
"Montgomery","2020-09-03","8","1080","1","195","25.5","19.1"
"Montgomery","2020-09-04","10","1090","8","203","30.6","24.2"
"Montgomery","2020-09-05","4","1094","2","205","30.6","27.8"
"Montgomery","2020-09-06","4","1098","1","206","32.1","27.8"
"Montgomery","2020-09-07","4","1102","1","207","30","29.6"
"Montgomery","2020-09-08","8","1110","2","209","31.4","29.9"
"Montgomery","2020-09-09","47","1157","4","213","32.3","29.3"
"Montgomery","2020-09-10","10","1167","3","216","34.8","30.1"
"Montgomery","2020-09-11","11","1178","4","220","28.6","29.6"
"Montgomery","2020-09-12","5","1183","1","221","24.3","27.4"
"Montgomery","2020-09-13","2","1185","0","221","20.7","26.4"
"Montgomery","2020-09-14","13","1198","2","223","19.3","24.7"
"Montgomery","2020-09-15","17","1215","7","230","21.6","26.5"
"Montgomery","2020-09-16","51","1266","11","241","23.5","27.9"
"Montgomery","2020-09-17","16","1282","0","241","19.2","27"
"Montgomery","2020-09-18","8","1290","3","244","19.4","24"
"Montgomery","2020-09-19","8","1298","1","245","18.3","21.3"
"Montgomery","2020-09-20","0","1298","0","245","18.3","19.5"
"Montgomery","2020-09-21","17","1315","2","247","17.8","18.6"
"Montgomery","2020-09-22","2","1317","1","248","19","20.3"
"Montgomery","2020-09-23","40","1357","7","255","18.5","21"
"Montgomery","2020-09-24","12","1369","1","256","19.7","19.4"
"Montgomery","2020-09-25","7","1376","1","257","16.3","17.9"
"Montgomery","2020-09-26","0","1376","0","257","14.6","16.4"
"Montgomery","2020-09-27","0","1376","0","257","14.6","16.4"
"Montgomery","2020-09-28","7","1383","0","257","12.9","15.3"
"Montgomery","2020-09-29","10","1393","1","258","7.2","13.1"
"Montgomery","2020-09-30","51","1444","11","269","7.7","13.1"
"Montgomery","2020-10-01","12","1456","1","270","7.7","13.7"
"Montgomery","2020-10-02","18","1474","3","273","8.1","12.2"
"Montgomery","2020-10-03","7","1481","1","274","10.1","12.3"
"Montgomery","2020-10-04","3","1484","2","276","19.6","17.1"
"Montgomery","2020-10-05","13","1497","5","281","25.1","19"
"Montgomery","2020-10-06","7","1504","0","281","23.7","15.4"
"Montgomery","2020-10-07","48","1552","12","293","24.2","16"
"Montgomery","2020-10-08","21","1573","1","294","23.7","15.7"
"Montgomery","2020-10-09","7","1580","0","294","21.3","14.7"
"Montgomery","2020-10-10","6","1586","2","296","24","17.1"
"Montgomery","2020-10-11","6","1592","1","297","16.9","18.3"
"Montgomery","2020-10-12","13","1605","1","298","12.5","18.8"
"Montgomery","2020-10-13","15","1620","3","301","15.4","19.5"
"Montgomery","2020-10-14","24","1644","2","303","13","18.6"
"Montgomery","2020-10-15","5","1649","1","304","15.1","19.4"
"Montgomery","2020-10-16","8","1657","1","305","16.9","19.1"
"Montgomery","2020-10-17","11","1668","2","307","14.8","19.4"
"Montgomery","2020-10-18","1","1669","0","307","12.4","14.6"
"Montgomery","2020-10-19","14","1683","1","308","12.3","12.4"
"Montgomery","2020-10-20","7","1690","1","309","11.5","13.4"
"Montgomery","2020-10-21","35","1725","1","310","10.7","11.8"
"Montgomery","2020-10-22","36","1761","17","327","14.6","14.9"
"Montgomery","2020-10-23","9","1770","1","328","14.4","15.7"
"Montgomery","2020-10-24","19","1789","1","329","12.6","13.7"
"Montgomery","2020-10-25","3","1792","0","329","12.6","12.5"
"Montgomery","2020-10-26","7","1799","2","331","15.6","14"
"Montgomery","2020-10-27","10","1809","2","333","16.4","14"
"Montgomery","2020-10-28","47","1856","1","334","16.3","13.5"
"Montgomery","2020-10-29","8","1864","1","335","11.4","13"
"Montgomery","2020-10-30","5","1869","0","335","9.8","12.1"
"Montgomery","2020-10-31","3","1872","1","336","13.8","13.2"
"Montgomery","2020-11-01","6","1878","3","339","20.9","16.7"
"Montgomery","2020-11-02","13","1891","0","339","16.9","16.2"
"Montgomery","2020-11-03","10","1901","1","340","15.4","15.9"
"Montgomery","2020-11-04","31","1932","1","341","15.6","16"
"Montgomery","2020-11-05","7","1939","2","343","17.9","14.6"
"Montgomery","2020-11-06","10","1949","0","343","17.9","13.8"
"Montgomery","2020-11-07","5","1954","0","343","13.1","13.5"
"Montgomery","2020-11-08","0","1954","0","343","6","13.5"
"Montgomery","2020-11-09","15","1969","3","346","8.8","12.8"
"Montgomery","2020-11-10","16","1985","3","349","10.1","12.8"
"Montgomery","2020-11-11","5","1990","1","350","12.5","14"
"Montgomery","2020-11-12","9","1999","1","351","10","13.9"
"Montgomery","2020-11-13","11","2010","1","352","11.3","14.6"
"Montgomery","2020-11-14","5","2015","1","353","14.1","13.6"
"Montgomery","2020-11-15","3","2018","1","354","18.9","12.4"
"Montgomery","2020-11-16","16","2034","2","356","17.8","13.3"
"Montgomery","2020-11-17","19","2053","1","357","15.9","13"
"Montgomery","2020-11-18","48","2101","4","361","14.2","13.4"
"Montgomery","2020-11-19","20","2121","0","361","12.6","11.3"
"Montgomery","2020-11-20","11","2132","0","361","11.3","11.3"
"Montgomery","2020-11-21","5","2137","0","361","8.5","11.3"
"Montgomery","2020-11-22","4","2141","1","362","7.3","13.1"
"Montgomery","2020-11-23","19","2160","4","366","8.5","13.2"
"Montgomery","2020-11-24","12","2172","0","366","7.8","11.8"
"Montgomery","2020-11-25","38","2210","4","370","8.1","11.2"
"Montgomery","2020-11-26","3","2213","1","371","12.8","12.7"
"Montgomery","2020-11-27","9","2222","1","372","14.4","12.9"
"Montgomery","2020-11-28","9","2231","0","372","14.4","11.5"
"Montgomery","2020-11-29","10","2241","2","374","13.7","10.5"
"Montgomery","2020-11-30","14","2255","1","375","11.7","10.1"
"Montgomery","2020-12-01","29","2284","0","375","11.7","9.7"
"Montgomery","2020-12-02","27","2311","2","377","11.3","9.7"
"Montgomery","2020-12-03","18","2329","2","379","8.1","10.5"
"Montgomery","2020-12-04","11","2340","3","382","10.4","12.4"
"Montgomery","2020-12-05","9","2349","2","384","13.6","14"
"Montgomery","2020-12-06","7","2356","3","387","16.9","15.3"
"Montgomery","2020-12-07","9","2365","0","387","15.8","13.8"
"Montgomery","2020-12-08","12","2377","1","388","17","14.4"
"Montgomery","2020-12-09","46","2423","3","391","16.9","14.1"
"Montgomery","2020-12-10","18","2441","1","392","16.1","12.1"
"Montgomery","2020-12-11","12","2453","1","393","13.4","11.9"
"Montgomery","2020-12-12","3","2456","1","394","15","14.3"
"Montgomery","2020-12-13","12","2468","0","394","8.9","12.9"
"Montgomery","2020-12-14","14","2482","1","395","9.9","12.9"
"Montgomery","2020-12-15","28","2510","5","400","11.2","14.1"
"Montgomery","2020-12-16","77","2587","16","416","13.3","15.1"
"Montgomery","2020-12-17","79","2666","7","423","13.8","14.9"
"Montgomery","2020-12-18","25","2691","9","432","17.7","15.6"
"Montgomery","2020-12-19","13","2704","3","435","16.2","15.6"
"Montgomery","2020-12-20","16","2720","7","442","22.5","15.7"
"Montgomery","2020-12-21","25","2745","8","450","26","18"
"Montgomery","2020-12-22","37","2782","6","456","25.8","18.5"
"Montgomery","2020-12-23","79","2861","16","472","25.7","19.5"
"Montgomery","2020-12-24","13","2874","4","476","28.9","21.3"
"Montgomery","2020-12-25","3","2877","2","478","33.2","25.5"
"Montgomery","2020-12-26","9","2886","6","484","39.5","27.9"
"Montgomery","2020-12-27","13","2899","6","490","39.8","31.2"
"Montgomery","2020-12-28","26","2925","11","501","41.3","33.7"
"Montgomery","2020-12-29","32","2957","13","514","44.8","35.3"
"Montgomery","2020-12-30","115","3072","25","539","45","35.4"
"Montgomery","2020-12-31","20","3092","10","549","47.7","38.3"
"Montgomery","2021-01-01","4","3096","3","552","48.9","41.1"
"Montgomery","2021-01-02","10","3106","6","558","48","43.7"
"Montgomery","2021-01-03","5","3111","3","561","50","44.9"
"Montgomery","2021-01-04","12","3123","4","565","48.7","45"
"Montgomery","2021-01-05","45","3168","11","576","46.4","45.6"
"Montgomery","2021-01-06","97","3265","11","587","44.9","44.9"
"Montgomery","2021-01-07","18","3283","4","591","40.9","44.3"
"Montgomery","2021-01-08","20","3303","8","599","35.9","42.4"
"Montgomery","2021-01-09","14","3317","1","600","28.4","38.2"
"Montgomery","2021-01-10","15","3332","3","603","22.6","36.3"
"Montgomery","2021-01-11","27","3359","11","614","23.7","36.2"
"Montgomery","2021-01-12","15","3374","4","618","24","35.2"
"Montgomery","2021-01-13","14","3388","2","620","24.4","34.7"
"Montgomery","2021-01-14","12","3400","1","621","22.5","31.7"
"Montgomery","2021-01-15","20","3420","3","624","18.9","27.4"
"Montgomery","2021-01-16","4","3424","1","625","21.4","24.9"
"Montgomery","2021-01-17","3","3427","1","626","23.3","23"
"Montgomery","2021-01-18","12","3439","2","628","19.9","21.8"
"Montgomery","2021-01-19","14","3453","2","630","18.1","21.1"
"Montgomery","2021-01-20","102","3555","15","645","18.2","21.3"
"Montgomery","2021-01-21","22","3577","4","649","19.6","21"
"Montgomery","2021-01-22","15","3592","4","653","21.3","20.1"
"Montgomery","2021-01-23","9","3601","1","654","19.3","20.4"
"Montgomery","2021-01-24","5","3606","2","656","20.2","21.8"
"Montgomery","2021-01-25","9","3615","2","658","21","20.5"
"Montgomery","2021-01-26","23","3638","5","663","22.1","20.1"
"Montgomery","2021-01-27","22","3660","5","668","23.2","20.7"
"Montgomery","2021-01-28","19","3679","4","672","23.6","21.6"
"Montgomery","2021-01-29","12","3691","2","674","22.2","21.7"
"Montgomery","2021-01-30","8","3699","2","676","24.2","21.7"
"Montgomery","2021-01-31","8","3707","2","678","22.1","21.1"
"Montgomery","2021-02-01","17","3724","6","684","23.9","22.5"
"Montgomery","2021-02-02","18","3742","4","688","24","23"
"Montgomery","2021-02-03","48","3790","5","693","22.2","22.7"
"Montgomery","2021-02-04","13","3803","0","693","19.2","21.4"
"Montgomery","2021-02-05","12","3815","1","694","18","20.1"
"Montgomery","2021-02-06","0","3815","0","694","14.5","19.3"
"Montgomery","2021-02-07","0","3815","0","694","10.9","16.5"
"Montgomery","2021-02-08","0","3815","0","694","5.9","14.9"
"Morgan","2020-02-01","0","0","0","0",".","."
"Morgan","2020-02-02","0","0","0","0",".","."
"Morgan","2020-02-03","0","0","0","0",".","."
"Morgan","2020-02-04","0","0","0","0",".","."
"Morgan","2020-02-05","0","0","0","0",".","."
"Morgan","2020-02-06","0","0","0","0",".","."
"Morgan","2020-02-07","0","0","0","0","0","."
"Morgan","2020-02-08","0","0","0","0","0","."
"Morgan","2020-02-09","0","0","0","0","0","."
"Morgan","2020-02-10","0","0","0","0","0","."
"Morgan","2020-02-11","0","0","0","0","0","."
"Morgan","2020-02-12","0","0","0","0","0","."
"Morgan","2020-02-13","0","0","0","0","0","."
"Morgan","2020-02-14","0","0","0","0","0","0"
"Morgan","2020-02-15","0","0","0","0","0","0"
"Morgan","2020-02-16","0","0","0","0","0","0"
"Morgan","2020-02-17","0","0","0","0","0","0"
"Morgan","2020-02-18","0","0","0","0","0","0"
"Morgan","2020-02-19","0","0","0","0","0","0"
"Morgan","2020-02-20","0","0","0","0","0","0"
"Morgan","2020-02-21","0","0","0","0","0","0"
"Morgan","2020-02-22","0","0","0","0","0","0"
"Morgan","2020-02-23","0","0","0","0","0","0"
"Morgan","2020-02-24","0","0","0","0","0","0"
"Morgan","2020-02-25","0","0","0","0","0","0"
"Morgan","2020-02-26","0","0","0","0","0","0"
"Morgan","2020-02-27","0","0","0","0","0","0"
"Morgan","2020-02-28","0","0","0","0","0","0"
"Morgan","2020-02-29","0","0","0","0","0","0"
"Morgan","2020-03-01","0","0","0","0","0","0"
"Morgan","2020-03-02","0","0","0","0","0","0"
"Morgan","2020-03-03","0","0","0","0","0","0"
"Morgan","2020-03-04","0","0","0","0","0","0"
"Morgan","2020-03-05","0","0","0","0","0","0"
"Morgan","2020-03-06","0","0","0","0","0","0"
"Morgan","2020-03-07","0","0","0","0","0","0"
"Morgan","2020-03-08","0","0","0","0","0","0"
"Morgan","2020-03-09","0","0","0","0","0","0"
"Morgan","2020-03-10","0","0","0","0","0","0"
"Morgan","2020-03-11","0","0","0","0","0","0"
"Morgan","2020-03-12","8","8","0","0","0","0"
"Morgan","2020-03-13","5","13","0","0","0","0"
"Morgan","2020-03-14","0","13","0","0","0","0"
"Morgan","2020-03-15","0","13","0","0","0","0"
"Morgan","2020-03-16","3","16","0","0","0","0"
"Morgan","2020-03-17","10","26","1","1","1.4","0.7"
"Morgan","2020-03-18","4","30","0","1","1.4","0.7"
"Morgan","2020-03-19","7","37","0","1","1.4","0.7"
"Morgan","2020-03-20","11","48","0","1","1.4","0.7"
"Morgan","2020-03-21","6","54","0","1","1.4","0.7"
"Morgan","2020-03-22","10","64","0","1","1.4","0.7"
"Morgan","2020-03-23","8","72","1","2","3.2","1.6"
"Morgan","2020-03-24","17","89","0","2","1.8","1.6"
"Morgan","2020-03-25","13","102","0","2","1.8","1.6"
"Morgan","2020-03-26","6","108","1","3","4.2","2.8"
"Morgan","2020-03-27","10","118","1","4","5.6","3.5"
"Morgan","2020-03-28","2","120","1","5","12.7","7.1"
"Morgan","2020-03-29","10","130","0","5","12.7","7.1"
"Morgan","2020-03-30","22","152","1","6","11.6","7.4"
"Morgan","2020-03-31","6","158","0","6","11.6","6.7"
"Morgan","2020-04-01","17","175","1","7","12.4","7.1"
"Morgan","2020-04-02","11","186","1","8","11.4","7.8"
"Morgan","2020-04-03","9","195","1","9","11.5","8.6"
"Morgan","2020-04-04","6","201","0","9","4.4","8.6"
"Morgan","2020-04-05","0","201","0","9","4.4","8.6"
"Morgan","2020-04-06","6","207","0","9","3.7","7.7"
"Morgan","2020-04-07","27","234","4","13","5.8","8.7"
"Morgan","2020-04-08","29","263","0","13","5","8.7"
"Morgan","2020-04-09","23","286","1","14","4.3","7.8"
"Morgan","2020-04-10","23","309","0","14","2.7","7.1"
"Morgan","2020-04-11","13","322","2","16","4.9","4.7"
"Morgan","2020-04-12","2","324","0","16","4.9","4.7"
"Morgan","2020-04-13","15","339","1","17","5.9","4.8"
"Morgan","2020-04-14","19","358","4","21","6.8","6.3"
"Morgan","2020-04-15","10","368","0","21","6.8","5.9"
"Morgan","2020-04-16","12","380","3","24","9.7","7"
"Morgan","2020-04-17","15","395","0","24","9.7","6.2"
"Morgan","2020-04-18","8","403","0","24","7.5","6.2"
"Morgan","2020-04-19","2","405","0","24","7.5","6.2"
"Morgan","2020-04-20","9","414","0","24","6.6","6.2"
"Morgan","2020-04-21","10","424","0","24","3.6","5.2"
"Morgan","2020-04-22","18","442","1","25","4.4","5.6"
"Morgan","2020-04-23","15","457","1","26","1.7","5.7"
"Morgan","2020-04-24","7","464","0","26","1.7","5.7"
"Morgan","2020-04-25","3","467","0","26","1.7","4.6"
"Morgan","2020-04-26","4","471","0","26","1.7","4.6"
"Morgan","2020-04-27","30","501","2","28","2.7","4.6"
"Morgan","2020-04-28","17","518","1","29","3.5","3.6"
"Morgan","2020-04-29","25","543","0","29","2.7","3.6"
"Morgan","2020-04-30","16","559","2","31","3.6","2.7"
"Morgan","2020-05-01","26","585","3","34","5.2","3.5"
"Morgan","2020-05-02","11","596","3","37","9.1","5.4"
"Morgan","2020-05-03","8","604","1","38","10.9","6.3"
"Morgan","2020-05-04","25","629","1","39","10.5","6.6"
"Morgan","2020-05-05","42","671","4","43","11","7.3"
"Morgan","2020-05-06","34","705","0","43","11","6.9"
"Morgan","2020-05-07","15","720","1","44","10.2","6.9"
"Morgan","2020-05-08","16","736","0","44","8.6","6.9"
"Morgan","2020-05-09","12","748","1","45","5.9","7.5"
"Morgan","2020-05-10","2","750","0","45","4.1","7.5"
"Morgan","2020-05-11","29","779","0","45","3.5","7"
"Morgan","2020-05-12","19","798","1","46","2.9","7"
"Morgan","2020-05-13","25","823","4","50","5.2","8.1"
"Morgan","2020-05-14","15","838","0","50","4.2","7.2"
"Morgan","2020-05-15","13","851","1","51","5.3","6.9"
"Morgan","2020-05-16","6","857","0","51","4.1","5"
"Morgan","2020-05-17","3","860","0","51","4.1","4.1"
"Morgan","2020-05-18","17","877","5","56","8.3","5.9"
"Morgan","2020-05-19","18","895","0","56","7.6","5.2"
"Morgan","2020-05-20","34","929","2","58","6.1","5.7"
"Morgan","2020-05-21","29","958","0","58","6.1","5.2"
"Morgan","2020-05-22","11","969","0","58","5","5.2"
"Morgan","2020-05-23","3","972","0","58","5","4.6"
"Morgan","2020-05-24","5","977","0","58","5","4.6"
"Morgan","2020-05-25","6","983","0","58","0.8","4.6"
"Morgan","2020-05-26","12","995","1","59","2","4.8"
"Morgan","2020-05-27","30","1025","0","59","1.2","3.7"
"Morgan","2020-05-28","29","1054","2","61","2.2","4.2"
"Morgan","2020-05-29","15","1069","0","61","2.2","3.6"
"Morgan","2020-05-30","5","1074","0","61","2.2","3.6"
"Morgan","2020-05-31","7","1081","0","61","2.2","3.6"
"Morgan","2020-06-01","19","1100","0","61","2.2","1.5"
"Morgan","2020-06-02","13","1113","0","61","1","1.5"
"Morgan","2020-06-03","16","1129","0","61","1","1.1"
"Morgan","2020-06-04","27","1156","0","61","0","1.1"
"Morgan","2020-06-05","27","1183","0","61","0","1.1"
"Morgan","2020-06-06","4","1187","0","61","0","1.1"
"Morgan","2020-06-07","3","1190","0","61","0","1.1"
"Morgan","2020-06-08","18","1208","0","61","0","1.1"
"Morgan","2020-06-09","22","1230","1","62","0.6","0.8"
"Morgan","2020-06-10","14","1244","1","63","1.7","1.3"
"Morgan","2020-06-11","23","1267","2","65","2.9","1.5"
"Morgan","2020-06-12","19","1286","0","65","2.9","1.5"
"Morgan","2020-06-13","1","1287","0","65","2.9","1.5"
"Morgan","2020-06-14","10","1297","0","65","2.9","1.5"
"Morgan","2020-06-15","26","1323","2","67","4","2"
"Morgan","2020-06-16","14","1337","1","68","4.4","2.5"
"Morgan","2020-06-17","21","1358","0","68","3.4","2.5"
"Morgan","2020-06-18","28","1386","0","68","2.1","2.5"
"Morgan","2020-06-19","24","1410","0","68","2.1","2.5"
"Morgan","2020-06-20","13","1423","0","68","2.1","2.5"
"Morgan","2020-06-21","10","1433","1","69","3.5","3.2"
"Morgan","2020-06-22","26","1459","0","69","2.4","3.2"
"Morgan","2020-06-23","28","1487","2","71","2.4","3.4"
"Morgan","2020-06-24","42","1529","2","73","3.1","3.2"
"Morgan","2020-06-25","35","1564","3","76","4.4","3.2"
"Morgan","2020-06-26","50","1614","1","77","4.6","3.4"
"Morgan","2020-06-27","13","1627","0","77","4.6","3.4"
"Morgan","2020-06-28","7","1634","1","78","5.3","4.4"
"Morgan","2020-06-29","41","1675","1","79","5.6","4"
"Morgan","2020-06-30","37","1712","12","91","9.2","5.8"
"Morgan","2020-07-01","48","1760","6","97","10.3","6.7"
"Morgan","2020-07-02","46","1806","5","102","10.6","7.5"
"Morgan","2020-07-03","26","1832","2","104","11.5","8"
"Morgan","2020-07-04","16","1848","1","105","12.4","8.5"
"Morgan","2020-07-05","14","1862","3","108","13.4","9.3"
"Morgan","2020-07-06","30","1892","5","113","15.4","10.5"
"Morgan","2020-07-07","25","1917","2","115","11.9","10.6"
"Morgan","2020-07-08","52","1969","11","126","13.2","11.7"
"Morgan","2020-07-09","42","2011","5","131","13.3","12"
"Morgan","2020-07-10","38","2049","5","136","14.1","12.8"
"Morgan","2020-07-11","33","2082","8","144","16.7","14.5"
"Morgan","2020-07-12","20","2102","3","147","15.7","14.6"
"Morgan","2020-07-13","65","2167","9","156","15.3","15.4"
"Morgan","2020-07-14","50","2217","9","165","16.8","14.3"
"Morgan","2020-07-15","38","2255","4","169","15.2","14.2"
"Morgan","2020-07-16","42","2297","2","171","14.2","13.8"
"Morgan","2020-07-17","45","2342","6","177","14.2","14.2"
"Morgan","2020-07-18","16","2358","3","180","13.5","15.1"
"Morgan","2020-07-19","7","2365","1","181","13.4","14.5"
"Morgan","2020-07-20","83","2448","15","196","14","14.6"
"Morgan","2020-07-21","50","2498","17","213","16.2","16.5"
"Morgan","2020-07-22","54","2552","9","222","17.1","16.2"
"Morgan","2020-07-23","52","2604","16","238","20.8","17.5"
"Morgan","2020-07-24","63","2667","15","253","22.3","18.3"
"Morgan","2020-07-25","26","2693","10","263","25.2","19.3"
"Morgan","2020-07-26","13","2706","4","267","27.5","20.4"
"Morgan","2020-07-27","52","2758","18","285","29.9","21.9"
"Morgan","2020-07-28","47","2805","19","304","30.8","23.5"
"Morgan","2020-07-29","57","2862","22","326","33.9","25.5"
"Morgan","2020-07-30","42","2904","7","333","31.9","26.4"
"Morgan","2020-07-31","34","2938","14","347","34.4","28.4"
"Morgan","2020-08-01","12","2950","1","348","30.1","27.6"
"Morgan","2020-08-02","9","2959","2","350","28.9","28.2"
"Morgan","2020-08-03","42","3001","9","359","27","28.4"
"Morgan","2020-08-04","66","3067","16","375","24.7","27.7"
"Morgan","2020-08-05","44","3111","7","382","21.4","27.7"
"Morgan","2020-08-06","39","3150","7","389","21.6","26.8"
"Morgan","2020-08-07","35","3185","7","396","18.6","26.5"
"Morgan","2020-08-08","21","3206","4","400","20.1","25.1"
"Morgan","2020-08-09","17","3223","6","406","22","25.4"
"Morgan","2020-08-10","40","3263","8","414","21.8","24.4"
"Morgan","2020-08-11","34","3297","7","421","21.3","23"
"Morgan","2020-08-12","33","3330","1","422","19.4","20.4"
"Morgan","2020-08-13","44","3374","10","432","20.1","20.9"
"Morgan","2020-08-14","35","3409","5","437","19.3","18.9"
"Morgan","2020-08-15","25","3434","7","444","20.6","20.3"
"Morgan","2020-08-16","12","3446","5","449","21.5","21.7"
"Morgan","2020-08-17","28","3474","3","452","20.1","21"
"Morgan","2020-08-18","35","3509","4","456","18.8","20"
"Morgan","2020-08-19","26","3535","8","464","22.8","21.1"
"Morgan","2020-08-20","21","3556","4","468","22.3","21.2"
"Morgan","2020-08-21","18","3574","1","469","21","20.2"
"Morgan","2020-08-22","6","3580","0","469","17","18.8"
"Morgan","2020-08-23","7","3587","0","469","11.1","16.3"
"Morgan","2020-08-24","23","3610","6","475","13.3","16.7"
"Morgan","2020-08-25","14","3624","3","478","14.7","16.8"
"Morgan","2020-08-26","20","3644","1","479","11","16.9"
"Morgan","2020-08-27","14","3658","2","481","10.3","16.3"
"Morgan","2020-08-28","23","3681","3","484","11.4","16.2"
"Morgan","2020-08-29","6","3687","1","485","13.8","15.4"
"Morgan","2020-08-30","6","3693","1","486","16.2","13.6"
"Morgan","2020-08-31","24","3717","3","489","14.2","13.7"
"Morgan","2020-09-01","41","3758","6","495","13.3","14"
"Morgan","2020-09-02","12","3770","2","497","14.9","13"
"Morgan","2020-09-03","19","3789","2","499","14.4","12.4"
"Morgan","2020-09-04","25","3814","3","502","14.2","12.8"
"Morgan","2020-09-05","11","3825","1","503","13.2","13.5"
"Morgan","2020-09-06","7","3832","0","503","10.8","13.5"
"Morgan","2020-09-07","4","3836","0","503","9","11.6"
"Morgan","2020-09-08","27","3863","1","504","7.4","10.3"
"Morgan","2020-09-09","21","3884","3","507","7.1","11"
"Morgan","2020-09-10","19","3903","1","508","6.3","10.4"
"Morgan","2020-09-11","26","3929","1","509","5.2","9.7"
"Morgan","2020-09-12","4","3933","2","511","11","12.1"
"Morgan","2020-09-13","8","3941","0","511","11","10.9"
"Morgan","2020-09-14","20","3961","0","511","11","10"
"Morgan","2020-09-15","25","3986","3","514","12.2","9.8"
"Morgan","2020-09-16","15","4001","2","516","12.1","9.6"
"Morgan","2020-09-17","17","4018","1","517","12.2","9.2"
"Morgan","2020-09-18","16","4034","0","517","11.6","8.4"
"Morgan","2020-09-19","5","4039","1","518","7.3","9.2"
"Morgan","2020-09-20","3","4042","0","518","7.3","9.2"
"Morgan","2020-09-21","26","4068","3","521","9","10"
"Morgan","2020-09-22","21","4089","1","522","7.9","10.1"
"Morgan","2020-09-23","15","4104","1","523","7","9.5"
"Morgan","2020-09-24","20","4124","1","524","6.9","9.5"
"Morgan","2020-09-25","19","4143","1","525","7.6","9.6"
"Morgan","2020-09-26","5","4148","0","525","4.7","6"
"Morgan","2020-09-27","3","4151","0","525","4.7","6"
"Morgan","2020-09-28","17","4168","0","525","3.1","6"
"Morgan","2020-09-29","19","4187","2","527","3.9","5.9"
"Morgan","2020-09-30","14","4201","2","529","5","6"
"Morgan","2020-10-01","24","4225","1","530","4.9","5.9"
"Morgan","2020-10-02","17","4242","1","531","5","6.3"
"Morgan","2020-10-03","10","4252","1","532","6.4","5.6"
"Morgan","2020-10-04","3","4255","1","533","11.2","8"
"Morgan","2020-10-05","21","4276","2","535","12.5","7.8"
"Morgan","2020-10-06","26","4302","3","538","12.7","8.3"
"Morgan","2020-10-07","22","4324","1","539","11.3","8.1"
"Morgan","2020-10-08","22","4346","2","541","12","8.4"
"Morgan","2020-10-09","19","4365","2","543","12.7","8.8"
"Morgan","2020-10-10","7","4372","1","544","13.3","9.8"
"Morgan","2020-10-11","4","4376","0","544","8.5","9.8"
"Morgan","2020-10-12","21","4397","2","546","8.5","10.5"
"Morgan","2020-10-13","19","4416","1","547","7.6","10.1"
"Morgan","2020-10-14","13","4429","1","548","8.1","9.7"
"Morgan","2020-10-15","33","4462","2","550","7.6","9.8"
"Morgan","2020-10-16","11","4473","1","551","7.4","10"
"Morgan","2020-10-17","5","4478","0","551","5.4","9.3"
"Morgan","2020-10-18","1","4479","0","551","5.4","6.9"
"Morgan","2020-10-19","16","4495","3","554","6.7","7.6"
"Morgan","2020-10-20","20","4515","2","556","7.4","7.5"
"Morgan","2020-10-21","29","4544","5","561","8.7","8.4"
"Morgan","2020-10-22","16","4560","1","562","8.8","8.2"
"Morgan","2020-10-23","19","4579","2","564","9","8.2"
"Morgan","2020-10-24","8","4587","1","565","10.8","8.1"
"Morgan","2020-10-25","4","4591","0","565","10.8","8.1"
"Morgan","2020-10-26","15","4606","3","568","10.9","8.8"
"Morgan","2020-10-27","20","4626","2","570","10.9","9.2"
"Morgan","2020-10-28","21","4647","4","574","11.2","10"
"Morgan","2020-10-29","20","4667","2","576","11.7","10.2"
"Morgan","2020-10-30","12","4679","2","578","12.6","10.8"
"Morgan","2020-10-31","12","4691","3","581","14.4","12.6"
"Morgan","2020-11-01","9","4700","2","583","17.6","14.2"
"Morgan","2020-11-02","12","4712","2","585","17.1","14"
"Morgan","2020-11-03","15","4727","0","585","15.7","13.3"
"Morgan","2020-11-04","29","4756","1","586","13.4","12.3"
"Morgan","2020-11-05","10","4766","1","587","13.4","12.6"
"Morgan","2020-11-06","15","4781","0","587","11","11.8"
"Morgan","2020-11-07","2","4783","0","587","7.5","10.9"
"Morgan","2020-11-08","4","4787","1","588","7.9","12.7"
"Morgan","2020-11-09","31","4818","5","593","7.8","12.4"
"Morgan","2020-11-10","20","4838","2","595","9.2","12.4"
"Morgan","2020-11-11","18","4856","2","597","10.3","11.9"
"Morgan","2020-11-12","16","4872","0","597","8.9","11.2"
"Morgan","2020-11-13","20","4892","1","598","9.6","10.3"
"Morgan","2020-11-14","9","4901","2","600","12.8","10.1"
"Morgan","2020-11-15","8","4909","2","602","12.8","10.3"
"Morgan","2020-11-16","25","4934","2","604","11.6","9.7"
"Morgan","2020-11-17","24","4958","1","605","10.8","10"
"Morgan","2020-11-18","37","4995","2","607","10","10.1"
"Morgan","2020-11-19","22","5017","0","607","10","9.4"
"Morgan","2020-11-20","23","5040","0","607","9.3","9.4"
"Morgan","2020-11-21","3","5043","1","608","10.8","11.8"
"Morgan","2020-11-22","10","5053","1","609","8.7","10.7"
"Morgan","2020-11-23","34","5087","0","609","7.6","9.6"
"Morgan","2020-11-24","24","5111","3","612","8.7","9.8"
"Morgan","2020-11-25","31","5142","0","612","8","9"
"Morgan","2020-11-26","2","5144","0","612","8","9"
"Morgan","2020-11-27","21","5165","1","613","8.7","9"
"Morgan","2020-11-28","7","5172","1","614","5.9","8.4"
"Morgan","2020-11-29","10","5182","0","614","4.5","6.6"
"Morgan","2020-11-30","31","5213","5","619","6.8","7.2"
"Morgan","2020-12-01","30","5243","8","627","8.8","8.8"
"Morgan","2020-12-02","36","5279","3","630","10","9"
"Morgan","2020-12-03","24","5303","5","635","13","10.5"
"Morgan","2020-12-04","24","5327","1","636","12.9","10.8"
"Morgan","2020-12-05","9","5336","0","636","10.9","8.4"
"Morgan","2020-12-06","13","5349","3","639","14.2","9.3"
"Morgan","2020-12-07","37","5386","4","643","13.4","10.1"
"Morgan","2020-12-08","22","5408","5","648","12.8","10.8"
"Morgan","2020-12-09","47","5455","6","654","13.5","11.8"
"Morgan","2020-12-10","45","5500","8","662","13","13"
"Morgan","2020-12-11","31","5531","5","667","14.8","13.8"
"Morgan","2020-12-12","22","5553","3","670","16.7","13.8"
"Morgan","2020-12-13","16","5569","5","675","17.9","16"
"Morgan","2020-12-14","43","5612","6","681","18.3","15.9"
"Morgan","2020-12-15","22","5634","2","683","16.4","14.6"
"Morgan","2020-12-16","96","5730","9","692","15.9","14.7"
"Morgan","2020-12-17","28","5758","7","699","16.9","15"
"Morgan","2020-12-18","39","5797","4","703","16.1","15.4"
"Morgan","2020-12-19","26","5823","3","706","15.8","16.2"
"Morgan","2020-12-20","19","5842","9","715","18.1","18"
"Morgan","2020-12-21","34","5876","9","724","19.9","19.1"
"Morgan","2020-12-22","38","5914","7","731","21.2","18.8"
"Morgan","2020-12-23","44","5958","7","738","22.1","19"
"Morgan","2020-12-24","30","5988","6","744","21.4","19.2"
"Morgan","2020-12-25","7","5995","2","746","24","20.1"
"Morgan","2020-12-26","22","6017","8","754","27.6","21.7"
"Morgan","2020-12-27","20","6037","5","759","24.4","21.2"
"Morgan","2020-12-28","47","6084","15","774","25.2","22.5"
"Morgan","2020-12-29","41","6125","8","782","25.3","23.3"
"Morgan","2020-12-30","25","6150","5","787","25.9","24"
"Morgan","2020-12-31","32","6182","6","793","25.7","23.6"
"Morgan","2021-01-01","14","6196","4","797","25.7","24.9"
"Morgan","2021-01-02","17","6213","2","799","22.2","24.9"
"Morgan","2021-01-03","18","6231","4","803","21.8","23.1"
"Morgan","2021-01-04","46","6277","14","817","21.6","23.4"
"Morgan","2021-01-05","67","6344","18","835","22.7","24"
"Morgan","2021-01-06","59","6403","19","854","24.4","25.2"
"Morgan","2021-01-07","40","6443","11","865","25.7","25.7"
"Morgan","2021-01-08","41","6484","10","875","25.1","25.4"
"Morgan","2021-01-09","19","6503","7","882","28.6","25.4"
"Morgan","2021-01-10","17","6520","3","885","28","24.9"
"Morgan","2021-01-11","55","6575","11","896","26.5","24.1"
"Morgan","2021-01-12","38","6613","10","906","26.4","24.5"
"Morgan","2021-01-13","36","6649","8","914","25","24.7"
"Morgan","2021-01-14","40","6689","6","920","23.2","24.4"
"Morgan","2021-01-15","28","6717","3","923","21.2","23.2"
"Morgan","2021-01-16","21","6738","5","928","19.4","24"
"Morgan","2021-01-17","19","6757","3","931","19.1","23.6"
"Morgan","2021-01-18","25","6782","4","935","18.6","22.5"
"Morgan","2021-01-19","47","6829","6","941","16.6","21.5"
"Morgan","2021-01-20","42","6871","6","947","15.5","20.2"
"Morgan","2021-01-21","45","6916","3","950","14.3","18.7"
"Morgan","2021-01-22","49","6965","9","959","15.4","18.3"
"Morgan","2021-01-23","15","6980","2","961","13.9","16.6"
"Morgan","2021-01-24","10","6990","4","965","17.3","18.2"
"Morgan","2021-01-25","39","7029","5","970","16.9","17.7"
"Morgan","2021-01-26","81","7110","8","978","16.5","16.5"
"Morgan","2021-01-27","31","7141","1","979","14.9","15.2"
"Morgan","2021-01-28","43","7184","6","985","15.9","15.1"
"Morgan","2021-01-29","37","7221","7","992","16","15.7"
"Morgan","2021-01-30","13","7234","3","995","17.4","15.6"
"Morgan","2021-01-31","14","7248","3","998","14.8","16.1"
"Morgan","2021-02-01","30","7278","5","1003","15.3","16.1"
"Morgan","2021-02-02","25","7303","2","1005","15","15.8"
"Morgan","2021-02-03","28","7331","8","1013","18.7","16.8"
"Morgan","2021-02-04","29","7360","0","1013","16.7","16.3"
"Morgan","2021-02-05","22","7382","1","1014","14.6","15.3"
"Morgan","2021-02-06","7","7389","2","1016","15.4","16.4"
"Morgan","2021-02-07","2","7391","0","1016","12.3","13.5"
"Morgan","2021-02-08","0","7391","0","1016","10","12.6"
"Murray","2020-02-01","0","0","0","0",".","."
"Murray","2020-02-02","0","0","0","0",".","."
"Murray","2020-02-03","0","0","0","0",".","."
"Murray","2020-02-04","0","0","0","0",".","."
"Murray","2020-02-05","0","0","0","0",".","."
"Murray","2020-02-06","0","0","0","0",".","."
"Murray","2020-02-07","0","0","0","0","0","."
"Murray","2020-02-08","0","0","0","0","0","."
"Murray","2020-02-09","0","0","0","0","0","."
"Murray","2020-02-10","0","0","0","0","0","."
"Murray","2020-02-11","0","0","0","0","0","."
"Murray","2020-02-12","0","0","0","0","0","."
"Murray","2020-02-13","0","0","0","0","0","."
"Murray","2020-02-14","0","0","0","0","0","0"
"Murray","2020-02-15","0","0","0","0","0","0"
"Murray","2020-02-16","0","0","0","0","0","0"
"Murray","2020-02-17","0","0","0","0","0","0"
"Murray","2020-02-18","0","0","0","0","0","0"
"Murray","2020-02-19","0","0","0","0","0","0"
"Murray","2020-02-20","0","0","0","0","0","0"
"Murray","2020-02-21","0","0","0","0","0","0"
"Murray","2020-02-22","0","0","0","0","0","0"
"Murray","2020-02-23","0","0","0","0","0","0"
"Murray","2020-02-24","0","0","0","0","0","0"
"Murray","2020-02-25","0","0","0","0","0","0"
"Murray","2020-02-26","0","0","0","0","0","0"
"Murray","2020-02-27","0","0","0","0","0","0"
"Murray","2020-02-28","0","0","0","0","0","0"
"Murray","2020-02-29","0","0","0","0","0","0"
"Murray","2020-03-01","0","0","0","0","0","0"
"Murray","2020-03-02","0","0","0","0","0","0"
"Murray","2020-03-03","0","0","0","0","0","0"
"Murray","2020-03-04","0","0","0","0","0","0"
"Murray","2020-03-05","0","0","0","0","0","0"
"Murray","2020-03-06","0","0","0","0","0","0"
"Murray","2020-03-07","0","0","0","0","0","0"
"Murray","2020-03-08","0","0","0","0","0","0"
"Murray","2020-03-09","0","0","0","0","0","0"
"Murray","2020-03-10","0","0","0","0","0","0"
"Murray","2020-03-11","0","0","0","0","0","0"
"Murray","2020-03-12","2","2","0","0","0","0"
"Murray","2020-03-13","5","7","0","0","0","0"
"Murray","2020-03-14","0","7","0","0","0","0"
"Murray","2020-03-15","0","7","0","0","0","0"
"Murray","2020-03-16","4","11","0","0","0","0"
"Murray","2020-03-17","7","18","0","0","0","0"
"Murray","2020-03-18","7","25","1","1","2","1"
"Murray","2020-03-19","5","30","0","1","2","1"
"Murray","2020-03-20","4","34","0","1","2","1"
"Murray","2020-03-21","7","41","3","4","8.2","4.1"
"Murray","2020-03-22","2","43","0","4","8.2","4.1"
"Murray","2020-03-23","5","48","1","5","11","5.5"
"Murray","2020-03-24","5","53","0","5","11","5.5"
"Murray","2020-03-25","6","59","0","5","9","5.5"
"Murray","2020-03-26","5","64","0","5","9","5.5"
"Murray","2020-03-27","3","67","1","6","13.7","7.9"
"Murray","2020-03-28","0","67","0","6","7.6","7.9"
"Murray","2020-03-29","0","67","0","6","7.6","7.9"
"Murray","2020-03-30","10","77","0","6","4.8","7.9"
"Murray","2020-03-31","5","82","0","6","4.8","7.9"
"Murray","2020-04-01","2","84","0","6","4.8","6.9"
"Murray","2020-04-02","1","85","0","6","4.8","6.9"
"Murray","2020-04-03","6","91","0","6","0","6.9"
"Murray","2020-04-04","3","94","0","6","0","3.8"
"Murray","2020-04-05","1","95","0","6","0","3.8"
"Murray","2020-04-06","7","102","1","7","2","3.4"
"Murray","2020-04-07","3","105","0","7","2","3.4"
"Murray","2020-04-08","4","109","1","8","5.6","5.2"
"Murray","2020-04-09","4","113","0","8","5.6","5.2"
"Murray","2020-04-10","7","120","0","8","5.6","2.8"
"Murray","2020-04-11","3","123","0","8","5.6","2.8"
"Murray","2020-04-12","1","124","0","8","5.6","2.8"
"Murray","2020-04-13","3","127","0","8","3.6","2.8"
"Murray","2020-04-14","2","129","0","8","3.6","2.8"
"Murray","2020-04-15","8","137","0","8","0","2.8"
"Murray","2020-04-16","6","143","1","9","2.4","4"
"Murray","2020-04-17","7","150","0","9","2.4","4"
"Murray","2020-04-18","5","155","1","10","5.2","5.4"
"Murray","2020-04-19","3","158","0","10","5.2","5.4"
"Murray","2020-04-20","12","170","5","15","11.2","7.4"
"Murray","2020-04-21","10","180","0","15","11.2","7.4"
"Murray","2020-04-22","10","190","3","18","15.5","7.7"
"Murray","2020-04-23","6","196","1","19","15.5","8.9"
"Murray","2020-04-24","20","216","1","20","16.2","9.3"
"Murray","2020-04-25","10","226","1","21","14.8","10"
"Murray","2020-04-26","1","227","0","21","14.8","10"
"Murray","2020-04-27","13","240","0","21","8.8","10"
"Murray","2020-04-28","9","249","0","21","8.8","10"
"Murray","2020-04-29","13","262","0","21","4.5","10"
"Murray","2020-04-30","66","328","5","26","3.2","9.4"
"Murray","2020-05-01","16","344","0","26","2.5","9.4"
"Murray","2020-05-02","8","352","0","26","1.1","7.9"
"Murray","2020-05-03","5","357","0","26","1.1","7.9"
"Murray","2020-05-04","8","365","1","27","2.9","5.8"
"Murray","2020-05-05","21","386","1","28","3.5","6.2"
"Murray","2020-05-06","13","399","1","29","4.6","4.6"
"Murray","2020-05-07","37","436","1","30","4","3.6"
"Murray","2020-05-08","25","461","2","32","5.1","3.8"
"Murray","2020-05-09","18","479","0","32","5.1","3.1"
"Murray","2020-05-10","13","492","0","32","5.1","3.1"
"Murray","2020-05-11","32","524","5","37","5.5","4.2"
"Murray","2020-05-12","39","563","5","42","6.7","5.1"
"Murray","2020-05-13","14","577","4","46","9.7","7.2"
"Murray","2020-05-14","38","615","1","47","9.7","6.8"
"Murray","2020-05-15","11","626","3","50","12.4","8.8"
"Murray","2020-05-16","15","641","0","50","12.4","8.8"
"Murray","2020-05-17","10","651","1","51","13.8","9.5"
"Murray","2020-05-18","14","665","0","51","11.6","8.6"
"Murray","2020-05-19","16","681","1","52","10.7","8.7"
"Murray","2020-05-20","31","712","2","54","7.5","8.6"
"Murray","2020-05-21","87","799","6","60","8.1","8.9"
"Murray","2020-05-22","16","815","2","62","6","9.2"
"Murray","2020-05-23","39","854","3","65","7.1","9.8"
"Murray","2020-05-24","4","858","0","65","5.7","9.8"
"Murray","2020-05-25","6","864","0","65","5.7","8.6"
"Murray","2020-05-26","27","891","2","67","5.8","8.3"
"Murray","2020-05-27","25","916","5","72","7.8","7.7"
"Murray","2020-05-28","73","989","2","74","7.2","7.7"
"Murray","2020-05-29","21","1010","0","74","5.4","5.7"
"Murray","2020-05-30","5","1015","0","74","4.3","5.7"
"Murray","2020-05-31","6","1021","0","74","4.3","5"
"Murray","2020-06-01","57","1078","8","82","6.3","6"
"Murray","2020-06-02","45","1123","1","83","5.6","5.7"
"Murray","2020-06-03","37","1160","4","87","4.3","6"
"Murray","2020-06-04","76","1236","6","93","5","6.1"
"Murray","2020-06-05","26","1262","2","95","6.1","5.7"
"Murray","2020-06-06","7","1269","1","96","8.1","6.2"
"Murray","2020-06-07","4","1273","0","96","8.1","6.2"
"Murray","2020-06-08","64","1337","10","106","8.4","7.3"
"Murray","2020-06-09","46","1383","5","111","9.6","7.6"
"Murray","2020-06-10","23","1406","2","113","9.3","6.8"
"Murray","2020-06-11","74","1480","10","123","10.1","7.5"
"Murray","2020-06-12","29","1509","2","125","10","8"
"Murray","2020-06-13","8","1517","0","125","7.9","8"
"Murray","2020-06-14","8","1525","0","125","7.9","8"
"Murray","2020-06-15","23","1548","4","129","8.2","8.3"
"Murray","2020-06-16","21","1569","3","132","8.7","9.1"
"Murray","2020-06-17","23","1592","3","135","9.3","9.3"
"Murray","2020-06-18","23","1615","1","136","8","9"
"Murray","2020-06-19","24","1639","1","137","7.6","8.8"
"Murray","2020-06-20","10","1649","2","139","10.5","9.2"
"Murray","2020-06-21","10","1659","1","140","11.9","9.9"
"Murray","2020-06-22","39","1698","8","148","12.3","10.3"
"Murray","2020-06-23","24","1722","2","150","11.5","10.1"
"Murray","2020-06-24","32","1754","6","156","12.3","10.8"
"Murray","2020-06-25","26","1780","5","161","14.4","11.2"
"Murray","2020-06-26","32","1812","4","165","15.6","11.6"
"Murray","2020-06-27","17","1829","4","169","16.1","13.3"
"Murray","2020-06-28","13","1842","2","171","16.9","14.4"
"Murray","2020-06-29","31","1873","3","174","15.3","13.8"
"Murray","2020-06-30","37","1910","4","178","15.7","13.6"
"Murray","2020-07-01","54","1964","9","187","15.4","13.9"
"Murray","2020-07-02","40","2004","7","194","15.2","14.8"
"Murray","2020-07-03","21","2025","5","199","16.8","16.2"
"Murray","2020-07-04","5","2030","2","201","19.1","17.6"
"Murray","2020-07-05","13","2043","3","204","20.2","18.6"
"Murray","2020-07-06","50","2093","12","216","22.3","18.8"
"Murray","2020-07-07","60","2153","14","230","24.1","19.9"
"Murray","2020-07-08","57","2210","7","237","23.4","19.4"
"Murray","2020-07-09","65","2275","16","253","24.4","19.8"
"Murray","2020-07-10","51","2326","6","259","22.7","19.7"
"Murray","2020-07-11","13","2339","1","260","18.1","18.6"
"Murray","2020-07-12","13","2352","4","264","19.2","19.7"
"Murray","2020-07-13","53","2405","12","276","19","20.6"
"Murray","2020-07-14","59","2464","7","283","17.4","20.7"
"Murray","2020-07-15","64","2528","13","296","18.5","21"
"Murray","2020-07-16","37","2565","4","300","16.6","20.5"
"Murray","2020-07-17","39","2604","16","316","20.7","21.7"
"Murray","2020-07-18","14","2618","2","318","21.7","19.9"
"Murray","2020-07-19","15","2633","2","320","19.2","19.2"
"Murray","2020-07-20","52","2685","10","330","18.7","18.9"
"Murray","2020-07-21","26","2711","5","335","19.7","18.6"
"Murray","2020-07-22","31","2742","2","337","17.8","18.1"
"Murray","2020-07-23","47","2789","7","344","18.4","17.5"
"Murray","2020-07-24","47","2836","7","351","14.6","17.7"
"Murray","2020-07-25","20","2856","3","354","14.7","18.2"
"Murray","2020-07-26","17","2873","8","362","19.5","19.4"
"Murray","2020-07-27","47","2920","6","368","18.6","18.7"
"Murray","2020-07-28","39","2959","3","371","17","18.4"
"Murray","2020-07-29","45","3004","6","377","17.9","17.9"
"Murray","2020-07-30","33","3037","2","379","16.7","17.5"
"Murray","2020-07-31","44","3081","5","384","16.2","15.4"
"Murray","2020-08-01","16","3097","3","387","16.7","15.7"
"Murray","2020-08-02","13","3110","3","390","13.3","16.4"
"Murray","2020-08-03","37","3147","5","395","13.4","16"
"Murray","2020-08-04","16","3163","3","398","15","16"
"Murray","2020-08-05","39","3202","3","401","14.2","16.1"
"Murray","2020-08-06","28","3230","4","405","15.3","16"
"Murray","2020-08-07","35","3265","6","411","16.2","16.2"
"Murray","2020-08-08","19","3284","2","413","15","15.9"
"Murray","2020-08-09","15","3299","0","413","11.7","12.5"
"Murray","2020-08-10","46","3345","8","421","12.3","12.8"
"Murray","2020-08-11","46","3391","3","424","10.5","12.7"
"Murray","2020-08-12","48","3439","5","429","10.9","12.5"
"Murray","2020-08-13","24","3463","5","434","11.8","13.6"
"Murray","2020-08-14","53","3516","0","434","9.4","12.8"
"Murray","2020-08-15","10","3526","1","435","9.3","12.2"
"Murray","2020-08-16","18","3544","1","436","10.1","10.9"
"Murray","2020-08-17","45","3589","5","441","9.2","10.7"
"Murray","2020-08-18","48","3637","3","444","9.2","9.8"
"Murray","2020-08-19","32","3669","2","446","8.6","9.7"
"Murray","2020-08-20","24","3693","1","447","6.2","9"
"Murray","2020-08-21","39","3732","1","448","6.6","8"
"Murray","2020-08-22","17","3749","2","450","6.8","8.1"
"Murray","2020-08-23","10","3759","2","452","8.9","9.5"
"Murray","2020-08-24","36","3795","4","456","8.9","9"
"Murray","2020-08-25","43","3838","3","459","9","9.1"
"Murray","2020-08-26","39","3877","3","462","9.2","8.9"
"Murray","2020-08-27","29","3906","1","463","9.1","7.6"
"Murray","2020-08-28","48","3954","1","464","9","7.8"
"Murray","2020-08-29","13","3967","0","464","7.3","7.1"
"Murray","2020-08-30","16","3983","0","464","4.5","6.7"
"Murray","2020-08-31","44","4027","2","466","3.5","6.2"
"Murray","2020-09-01","53","4080","3","469","3.3","6.2"
"Murray","2020-09-02","44","4124","0","469","2.2","5.7"
"Murray","2020-09-03","38","4162","2","471","2.5","5.8"
"Murray","2020-09-04","36","4198","0","471","2.2","5.6"
"Murray","2020-09-05","13","4211","0","471","2.2","4.8"
"Murray","2020-09-06","13","4224","1","472","3.3","3.9"
"Murray","2020-09-07","11","4235","0","472","2.7","3.1"
"Murray","2020-09-08","149","4384","2","474","2","2.7"
"Murray","2020-09-09","48","4432","6","480","3.8","3"
"Murray","2020-09-10","68","4500","2","482","3.5","3"
"Murray","2020-09-11","126","4626","2","484","3.7","3"
"Murray","2020-09-12","12","4638","2","486","6.1","4.2"
"Murray","2020-09-13","19","4657","4","490","8","5.7"
"Murray","2020-09-14","60","4717","4","494","9","5.8"
"Murray","2020-09-15","153","4870","2","496","9","5.5"
"Murray","2020-09-16","41","4911","0","496","7.2","5.5"
"Murray","2020-09-17","51","4962","1","497","7","5.3"
"Murray","2020-09-18","42","5004","3","500","7.8","5.8"
"Murray","2020-09-19","22","5026","3","503","7.4","6.7"
"Murray","2020-09-20","16","5042","0","503","4.4","6.2"
"Murray","2020-09-21","58","5100","4","507","4.4","6.7"
"Murray","2020-09-22","78","5178","4","511","5","7"
"Murray","2020-09-23","57","5235","5","516","6.2","6.7"
"Murray","2020-09-24","39","5274","3","519","7","7"
"Murray","2020-09-25","37","5311","2","521","6.8","7.3"
"Murray","2020-09-26","16","5327","2","523","6.6","7"
"Murray","2020-09-27","17","5344","1","524","7.5","5.9"
"Murray","2020-09-28","36","5380","4","528","8.1","6.2"
"Murray","2020-09-29","60","5440","1","529","7.6","6.3"
"Murray","2020-09-30","43","5483","0","529","6.3","6.3"
"Murray","2020-10-01","23","5506","3","532","7.1","7.1"
"Murray","2020-10-02","33","5539","4","536","8","7.4"
"Murray","2020-10-03","14","5553","2","538","8.3","7.5"
"Murray","2020-10-04","13","5566","2","540","9.7","8.6"
"Murray","2020-10-05","40","5606","1","541","8.4","8.2"
"Murray","2020-10-06","61","5667","0","541","8.2","7.9"
"Murray","2020-10-07","36","5703","0","541","8.2","7.3"
"Murray","2020-10-08","47","5750","6","547","8.2","7.6"
"Murray","2020-10-09","24","5774","2","549","7.6","7.8"
"Murray","2020-10-10","6","5780","1","550","8","8.1"
"Murray","2020-10-11","7","5787","0","550","5.8","7.7"
"Murray","2020-10-12","43","5830","7","557","7.7","8.1"
"Murray","2020-10-13","37","5867","7","564","10.4","9.3"
"Murray","2020-10-14","35","5902","4","568","12.1","10.1"
"Murray","2020-10-15","50","5952","5","573","11.7","9.9"
"Murray","2020-10-16","40","5992","2","575","11.2","9.4"
"Murray","2020-10-17","14","6006","1","576","9.8","8.9"
"Murray","2020-10-18","10","6016","1","577","11.3","8.5"
"Murray","2020-10-19","52","6068","3","580","9.8","8.7"
"Murray","2020-10-20","44","6112","9","589","10","10.2"
"Murray","2020-10-21","42","6154","4","593","9.7","10.9"
"Murray","2020-10-22","25","6179","1","594","8.8","10.3"
"Murray","2020-10-23","58","6237","2","596","8.6","9.9"
"Murray","2020-10-24","15","6252","4","600","11.4","10.6"
"Murray","2020-10-25","19","6271","4","604","13","12.1"
"Murray","2020-10-26","59","6330","4","608","13.1","11.4"
"Murray","2020-10-27","67","6397","4","612","11.1","10.5"
"Murray","2020-10-28","42","6439","6","618","11.7","10.7"
"Murray","2020-10-29","62","6501","10","628","13.5","11.2"
"Murray","2020-10-30","38","6539","3","631","14.1","11.4"
"Murray","2020-10-31","35","6574","9","640","14","12.7"
"Murray","2020-11-01","24","6598","3","643","12.8","12.9"
"Murray","2020-11-02","63","6661","3","646","12.5","12.8"
"Murray","2020-11-03","66","6727","15","661","14.9","13"
"Murray","2020-11-04","63","6790","4","665","13.7","12.7"
"Murray","2020-11-05","63","6853","9","674","13.5","13.5"
"Murray","2020-11-06","50","6903","7","681","14.3","14.2"
"Murray","2020-11-07","29","6932","9","690","15.1","14.5"
"Murray","2020-11-08","22","6954","4","694","15.9","14.3"
"Murray","2020-11-09","79","7033","6","700","16.3","14.4"
"Murray","2020-11-10","64","7097","6","706","14.4","14.6"
"Murray","2020-11-11","58","7155","8","714","15.5","14.6"
"Murray","2020-11-12","77","7232","12","726","15.7","14.6"
"Murray","2020-11-13","69","7301","17","743","17.2","15.8"
"Murray","2020-11-14","24","7325","2","745","13.9","14.5"
"Murray","2020-11-15","29","7354","6","751","14.3","15.1"
"Murray","2020-11-16","74","7428","12","763","15.5","15.9"
"Murray","2020-11-17","76","7504","10","773","16.1","15.2"
"Murray","2020-11-18","72","7576","9","782","15.9","15.7"
"Murray","2020-11-19","74","7650","18","800","17.1","16.4"
"Murray","2020-11-20","74","7724","13","813","16.1","16.6"
"Murray","2020-11-21","42","7766","16","829","20.4","17.1"
"Murray","2020-11-22","16","7782","4","833","21","17.6"
"Murray","2020-11-23","78","7860","18","851","22","18.7"
"Murray","2020-11-24","66","7926","14","865","23.1","19.6"
"Murray","2020-11-25","74","8000","13","878","23.8","19.9"
"Murray","2020-11-26","15","8015","6","884","26.1","21.6"
"Murray","2020-11-27","58","8073","14","898","27","21.6"
"Murray","2020-11-28","42","8115","13","911","26","23.2"
"Murray","2020-11-29","43","8158","15","926","27.4","24.2"
"Murray","2020-11-30","145","8303","25","951","26.6","24.3"
"Murray","2020-12-01","107","8410","21","972","26.3","24.7"
"Murray","2020-12-02","119","8529","10","982","25","24.4"
"Murray","2020-12-03","89","8618","22","1004","22.9","24.5"
"Murray","2020-12-04","90","8708","16","1020","21.9","24.5"
"Murray","2020-12-05","53","8761","13","1033","21","23.5"
"Murray","2020-12-06","53","8814","10","1043","18.7","23.1"
"Murray","2020-12-07","112","8926","17","1060","18.4","22.5"
"Murray","2020-12-08","101","9027","18","1078","18.2","22.3"
"Murray","2020-12-09","145","9172","15","1093","18.5","21.7"
"Murray","2020-12-10","92","9264","9","1102","16.3","19.6"
"Murray","2020-12-11","61","9325","14","1116","17.1","19.5"
"Murray","2020-12-12","42","9367","13","1129","18","19.5"
"Murray","2020-12-13","43","9410","10","1139","18.6","18.7"
"Murray","2020-12-14","102","9512","15","1154","18.5","18.5"
"Murray","2020-12-15","103","9615","25","1179","19.5","18.8"
"Murray","2020-12-16","100","9715","13","1192","19.8","19.2"
"Murray","2020-12-17","98","9813","12","1204","20.2","18.3"
"Murray","2020-12-18","67","9880","20","1224","21.2","19.1"
"Murray","2020-12-19","52","9932","9","1233","19.2","18.6"
"Murray","2020-12-20","42","9974","13","1246","20.3","19.5"
"Murray","2020-12-21","133","10107","29","1275","21.3","19.9"
"Murray","2020-12-22","110","10217","24","1299","21","20.2"
"Murray","2020-12-23","136","10353","31","1330","22.4","21.1"
"Murray","2020-12-24","67","10420","21","1351","25.1","22.7"
"Murray","2020-12-25","12","10432","1","1352","22.1","21.6"
"Murray","2020-12-26","75","10507","33","1385","25.9","22.5"
"Murray","2020-12-27","49","10556","16","1401","26.1","23.2"
"Murray","2020-12-28","139","10695","34","1435","26.5","23.9"
"Murray","2020-12-29","124","10819","18","1453","25.4","23.2"
"Murray","2020-12-30","139","10958","19","1472","24.1","23.3"
"Murray","2020-12-31","77","11035","19","1491","23.2","24.2"
"Murray","2021-01-01","16","11051","6","1497","27.4","24.7"
"Murray","2021-01-02","31","11082","10","1507","25.7","25.8"
"Murray","2021-01-03","39","11121","13","1520","25.8","25.9"
"Murray","2021-01-04","53","11174","14","1534","26.1","26.3"
"Murray","2021-01-05","113","11287","23","1557","26.9","26.2"
"Murray","2021-01-06","147","11434","29","1586","27.8","25.9"
"Murray","2021-01-07","86","11520","19","1605","27.4","25.3"
"Murray","2021-01-08","91","11611","24","1629","25.8","26.6"
"Murray","2021-01-09","43","11654","15","1644","26.2","25.9"
"Murray","2021-01-10","55","11709","15","1659","25.3","25.5"
"Murray","2021-01-11","132","11841","23","1682","24","25"
"Murray","2021-01-12","144","11985","27","1709","23.8","25.3"
"Murray","2021-01-13","113","12098","20","1729","23.5","25.6"
"Murray","2021-01-14","98","12196","21","1750","23.4","25.4"
"Murray","2021-01-15","84","12280","25","1775","23.9","24.8"
"Murray","2021-01-16","43","12323","12","1787","22.9","24.5"
"Murray","2021-01-17","40","12363","13","1800","23.6","24.5"
"Murray","2021-01-18","119","12482","15","1815","23","23.5"
"Murray","2021-01-19","124","12606","19","1834","22.5","23.1"
"Murray","2021-01-20","117","12723","20","1854","22.4","22.9"
"Murray","2021-01-21","81","12804","24","1878","23.5","23.5"
"Murray","2021-01-22","72","12876","13","1891","21.9","22.9"
"Murray","2021-01-23","48","12924","12","1903","21.5","22.2"
"Murray","2021-01-24","49","12973","13","1916","20.6","22.1"
"Murray","2021-01-25","131","13104","30","1946","22.1","22.5"
"Murray","2021-01-26","110","13214","19","1965","22.4","22.4"
"Murray","2021-01-27","150","13364","23","1988","22.1","22.2"
"Murray","2021-01-28","104","13468","20","2008","20.6","22.1"
"Murray","2021-01-29","83","13551","19","2027","21.3","21.6"
"Murray","2021-01-30","49","13600","11","2038","20.9","21.2"
"Murray","2021-01-31","51","13651","11","2049","20.2","20.4"
"Murray","2021-02-01","154","13805","43","2092","21","21.5"
"Murray","2021-02-02","121","13926","17","2109","20.5","21.4"
"Murray","2021-02-03","108","14034","14","2123","20.2","21.1"
"Murray","2021-02-04","93","14127","10","2133","18.9","19.8"
"Murray","2021-02-05","41","14168","9","2142","18.8","20.1"
"Murray","2021-02-06","12","14180","2","2144","18","19.5"
"Murray","2021-02-07","2","14182","0","2144","14.9","17.6"
"Murray","2021-02-08","0","14182","0","2144","10.9","15.9"
"Muscogee","2020-02-01","0","0","0","0",".","."
"Muscogee","2020-02-02","0","0","0","0",".","."
"Muscogee","2020-02-03","0","0","0","0",".","."
"Muscogee","2020-02-04","0","0","0","0",".","."
"Muscogee","2020-02-05","0","0","0","0",".","."
"Muscogee","2020-02-06","0","0","0","0",".","."
"Muscogee","2020-02-07","0","0","0","0","0","."
"Muscogee","2020-02-08","0","0","0","0","0","."
"Muscogee","2020-02-09","0","0","0","0","0","."
"Muscogee","2020-02-10","0","0","0","0","0","."
"Muscogee","2020-02-11","0","0","0","0","0","."
"Muscogee","2020-02-12","0","0","0","0","0","."
"Muscogee","2020-02-13","0","0","0","0","0","."
"Muscogee","2020-02-14","0","0","0","0","0","0"
"Muscogee","2020-02-15","0","0","0","0","0","0"
"Muscogee","2020-02-16","0","0","0","0","0","0"
"Muscogee","2020-02-17","0","0","0","0","0","0"
"Muscogee","2020-02-18","0","0","0","0","0","0"
"Muscogee","2020-02-19","0","0","0","0","0","0"
"Muscogee","2020-02-20","0","0","0","0","0","0"
"Muscogee","2020-02-21","0","0","0","0","0","0"
"Muscogee","2020-02-22","0","0","0","0","0","0"
"Muscogee","2020-02-23","0","0","0","0","0","0"
"Muscogee","2020-02-24","0","0","0","0","0","0"
"Muscogee","2020-02-25","0","0","0","0","0","0"
"Muscogee","2020-02-26","0","0","0","0","0","0"
"Muscogee","2020-02-27","0","0","0","0","0","0"
"Muscogee","2020-02-28","0","0","0","0","0","0"
"Muscogee","2020-02-29","0","0","0","0","0","0"
"Muscogee","2020-03-01","0","0","0","0","0","0"
"Muscogee","2020-03-02","0","0","0","0","0","0"
"Muscogee","2020-03-03","0","0","0","0","0","0"
"Muscogee","2020-03-04","0","0","0","0","0","0"
"Muscogee","2020-03-05","0","0","0","0","0","0"
"Muscogee","2020-03-06","0","0","0","0","0","0"
"Muscogee","2020-03-07","0","0","0","0","0","0"
"Muscogee","2020-03-08","0","0","0","0","0","0"
"Muscogee","2020-03-09","1","1","0","0","0","0"
"Muscogee","2020-03-10","5","6","0","0","0","0"
"Muscogee","2020-03-11","6","12","0","0","0","0"
"Muscogee","2020-03-12","3","15","0","0","0","0"
"Muscogee","2020-03-13","4","19","0","0","0","0"
"Muscogee","2020-03-14","1","20","1","1","14.3","7.1"
"Muscogee","2020-03-15","0","20","0","1","14.3","7.1"
"Muscogee","2020-03-16","13","33","1","2","15.4","7.7"
"Muscogee","2020-03-17","15","48","0","2","15.4","7.7"
"Muscogee","2020-03-18","29","77","2","4","16.4","8.2"
"Muscogee","2020-03-19","61","138","3","7","17.1","8.5"
"Muscogee","2020-03-20","33","171","4","11","18.8","9.4"
"Muscogee","2020-03-21","5","176","1","12","7.4","10.8"
"Muscogee","2020-03-22","13","189","0","12","7.4","10.8"
"Muscogee","2020-03-23","44","233","2","14","6.9","11.2"
"Muscogee","2020-03-24","102","335","2","16","7.2","11.3"
"Muscogee","2020-03-25","73","408","8","24","7.8","12.1"
"Muscogee","2020-03-26","93","501","9","33","8.5","12.8"
"Muscogee","2020-03-27","85","586","6","39","7.7","13.3"
"Muscogee","2020-03-28","1","587","0","39","4.9","6.1"
"Muscogee","2020-03-29","13","600","5","44","10.4","8.9"
"Muscogee","2020-03-30","57","657","5","49","11","9"
"Muscogee","2020-03-31","27","684","6","55","13.9","10.5"
"Muscogee","2020-04-01","101","785","13","68","14.2","11"
"Muscogee","2020-04-02","72","857","3","71","13.4","10.9"
"Muscogee","2020-04-03","36","893","3","74","13.5","10.6"
"Muscogee","2020-04-04","15","908","1","75","14.5","9.7"
"Muscogee","2020-04-05","9","917","1","76","10.6","10.5"
"Muscogee","2020-04-06","29","946","2","78","10.3","10.7"
"Muscogee","2020-04-07","44","990","5","83","8.8","11.3"
"Muscogee","2020-04-08","105","1095","12","95","8.6","11.4"
"Muscogee","2020-04-09","69","1164","11","106","10.2","11.8"
"Muscogee","2020-04-10","145","1309","18","124","10.8","12.2"
"Muscogee","2020-04-11","33","1342","3","127","11.2","12.8"
"Muscogee","2020-04-12","17","1359","2","129","11.3","10.9"
"Muscogee","2020-04-13","90","1449","8","137","11.6","10.9"
"Muscogee","2020-04-14","71","1520","7","144","11.3","10.1"
"Muscogee","2020-04-15","80","1600","10","154","11.5","10"
"Muscogee","2020-04-16","86","1686","12","166","11.2","10.7"
"Muscogee","2020-04-17","83","1769","7","173","10.6","10.7"
"Muscogee","2020-04-18","47","1816","3","176","10.3","10.7"
"Muscogee","2020-04-19","15","1831","2","178","10.5","10.9"
"Muscogee","2020-04-20","120","1951","4","182","9.7","10.6"
"Muscogee","2020-04-21","136","2087","12","194","9.5","10.4"
"Muscogee","2020-04-22","145","2232","12","206","8.9","10.2"
"Muscogee","2020-04-23","52","2284","0","206","6.9","9.1"
"Muscogee","2020-04-24","204","2488","11","217","6.5","8.6"
"Muscogee","2020-04-25","91","2579","4","221","6.2","8.2"
"Muscogee","2020-04-26","42","2621","1","222","4.7","7.6"
"Muscogee","2020-04-27","164","2785","8","230","4.9","7.3"
"Muscogee","2020-04-28","128","2913","4","234","4.1","6.8"
"Muscogee","2020-04-29","120","3033","4","238","3.4","6.1"
"Muscogee","2020-04-30","173","3206","5","243","3.8","5.4"
"Muscogee","2020-05-01","86","3292","7","250","4.2","5.3"
"Muscogee","2020-05-02","146","3438","11","261","4.6","5.4"
"Muscogee","2020-05-03","169","3607","4","265","4.6","4.6"
"Muscogee","2020-05-04","121","3728","9","274","5","4.9"
"Muscogee","2020-05-05","127","3855","2","276","4.8","4.4"
"Muscogee","2020-05-06","198","4053","7","283","4.8","4.1"
"Muscogee","2020-05-07","170","4223","2","285","4.5","4.2"
"Muscogee","2020-05-08","127","4350","6","291","4.1","4.1"
"Muscogee","2020-05-09","300","4650","3","294","3.1","3.9"
"Muscogee","2020-05-10","50","4700","0","294","2.8","3.7"
"Muscogee","2020-05-11","268","4968","13","307","2.4","3.7"
"Muscogee","2020-05-12","237","5205","9","316","2.7","3.7"
"Muscogee","2020-05-13","217","5422","16","332","3.3","4"
"Muscogee","2020-05-14","252","5674","20","352","4.2","4.4"
"Muscogee","2020-05-15","237","5911","18","370","4.7","4.4"
"Muscogee","2020-05-16","467","6378","24","394","5.2","4.2"
"Muscogee","2020-05-17","65","6443","2","396","5.7","4.2"
"Muscogee","2020-05-18","155","6598","13","409","6.2","4.3"
"Muscogee","2020-05-19","257","6855","15","424","6.5","4.6"
"Muscogee","2020-05-20","420","7275","16","440","6","4.6"
"Muscogee","2020-05-21","222","7497","9","449","5.4","4.8"
"Muscogee","2020-05-22","176","7673","8","457","5","4.8"
"Muscogee","2020-05-23","22","7695","3","460","6.2","5.7"
"Muscogee","2020-05-24","29","7724","0","460","5.8","5.7"
"Muscogee","2020-05-25","80","7804","5","465","5.4","5.8"
"Muscogee","2020-05-26","124","7928","12","477","6","6.2"
"Muscogee","2020-05-27","208","8136","10","487","6.1","6.1"
"Muscogee","2020-05-28","619","8755","33","520","6.3","5.9"
"Muscogee","2020-05-29","398","9153","27","547","6.6","5.8"
"Muscogee","2020-05-30","341","9494","31","578","6","6.1"
"Muscogee","2020-05-31","83","9577","9","587","7.5","6.6"
"Muscogee","2020-06-01","342","9919","36","623","8.2","6.8"
"Muscogee","2020-06-02","331","10250","28","651","8","7"
"Muscogee","2020-06-03","354","10604","34","685","8.7","7.4"
"Muscogee","2020-06-04","276","10880","26","711","9.2","7.8"
"Muscogee","2020-06-05","272","11152","26","737","9.6","8.1"
"Muscogee","2020-06-06","131","11283","13","750","9.8","7.9"
"Muscogee","2020-06-07","92","11375","11","761","9.9","8.7"
"Muscogee","2020-06-08","478","11853","35","796","9.5","8.8"
"Muscogee","2020-06-09","314","12167","23","819","9.3","8.6"
"Muscogee","2020-06-10","309","12476","25","844","9.1","8.9"
"Muscogee","2020-06-11","404","12880","35","879","9","9.1"
"Muscogee","2020-06-12","282","13162","31","910","9.2","9.4"
"Muscogee","2020-06-13","87","13249","21","931","11.2","10.5"
"Muscogee","2020-06-14","134","13383","10","941","10.6","10.2"
"Muscogee","2020-06-15","362","13745","50","991","11.5","10.5"
"Muscogee","2020-06-16","338","14083","45","1036","12.4","10.8"
"Muscogee","2020-06-17","358","14441","25","1061","12.2","10.6"
"Muscogee","2020-06-18","389","14830","54","1115","12.9","11"
"Muscogee","2020-06-19","378","15208","64","1179","13.8","11.5"
"Muscogee","2020-06-20","225","15433","31","1210","12.3","11.8"
"Muscogee","2020-06-21","88","15521","15","1225","13.7","12.1"
"Muscogee","2020-06-22","552","16073","103","1328","14.4","12.9"
"Muscogee","2020-06-23","443","16516","70","1398","14.7","13.5"
"Muscogee","2020-06-24","423","16939","84","1482","16.6","14.4"
"Muscogee","2020-06-25","469","17408","91","1573","17.4","15.1"
"Muscogee","2020-06-26","509","17917","78","1651","17.1","15.5"
"Muscogee","2020-06-27","325","18242","56","1707","17.6","15"
"Muscogee","2020-06-28","146","18388","38","1745","18.9","16.3"
"Muscogee","2020-06-29","602","18990","140","1885","19.6","17"
"Muscogee","2020-06-30","678","19668","106","1991","19.5","17.1"
"Muscogee","2020-07-01","729","20397","119","2110","19","17.8"
"Muscogee","2020-07-02","729","21126","142","2252","19","18.2"
"Muscogee","2020-07-03","573","21699","81","2333","18.9","18"
"Muscogee","2020-07-04","89","21788","24","2357","20.3","18.9"
"Muscogee","2020-07-05","326","22114","68","2425","19.5","19.2"
"Muscogee","2020-07-06","733","22847","168","2593","19.5","19.5"
"Muscogee","2020-07-07","717","23564","132","2725","19.9","19.7"
"Muscogee","2020-07-08","792","24356","114","2839","19.6","19.3"
"Muscogee","2020-07-09","729","25085","91","2930","18.6","18.8"
"Muscogee","2020-07-10","885","25970","130","3060","18.7","18.8"
"Muscogee","2020-07-11","208","26178","35","3095","17.2","18.7"
"Muscogee","2020-07-12","111","26289","23","3118","17.2","18.4"
"Muscogee","2020-07-13","556","26845","102","3220","16.6","18"
"Muscogee","2020-07-14","407","27252","69","3289","16.3","18.1"
"Muscogee","2020-07-15","497","27749","54","3343","15.8","17.7"
"Muscogee","2020-07-16","615","28364","68","3411","15.6","17.1"
"Muscogee","2020-07-17","566","28930","67","3478","15.2","17"
"Muscogee","2020-07-18","534","29464","55","3533","14.3","15.8"
"Muscogee","2020-07-19","137","29601","14","3547","12.8","15"
"Muscogee","2020-07-20","600","30201","64","3611","11.7","14.1"
"Muscogee","2020-07-21","392","30593","49","3660","11.1","13.7"
"Muscogee","2020-07-22","462","31055","48","3708","11","13.4"
"Muscogee","2020-07-23","600","31655","68","3776","11","13.3"
"Muscogee","2020-07-24","539","32194","50","3826","10.7","12.9"
"Muscogee","2020-07-25","572","32766","73","3899","11","12.7"
"Muscogee","2020-07-26","126","32892","13","3912","11","11.9"
"Muscogee","2020-07-27","545","33437","75","3987","11.5","11.6"
"Muscogee","2020-07-28","443","33880","57","4044","11.5","11.3"
"Muscogee","2020-07-29","445","34325","53","4097","11.7","11.4"
"Muscogee","2020-07-30","464","34789","47","4144","11.6","11.3"
"Muscogee","2020-07-31","384","35173","42","4186","11.8","11.2"
"Muscogee","2020-08-01","395","35568","25","4211","10.9","11"
"Muscogee","2020-08-02","76","35644","11","4222","11.5","11.3"
"Muscogee","2020-08-03","557","36201","63","4285","11.1","11.3"
"Muscogee","2020-08-04","444","36645","39","4324","10.6","11"
"Muscogee","2020-08-05","477","37122","39","4363","10","10.9"
"Muscogee","2020-08-06","412","37534","54","4417","10.4","11"
"Muscogee","2020-08-07","442","37976","25","4442","9.7","10.8"
"Muscogee","2020-08-08","216","38192","22","4464","10.2","10.6"
"Muscogee","2020-08-09","144","38336","16","4480","9.8","10.6"
"Muscogee","2020-08-10","458","38794","51","4531","9.7","10.4"
"Muscogee","2020-08-11","297","39091","39","4570","10.4","10.5"
"Muscogee","2020-08-12","358","39449","32","4602","10.5","10.2"
"Muscogee","2020-08-13","397","39846","38","4640","10","10.2"
"Muscogee","2020-08-14","469","40315","32","4672","10.1","9.9"
"Muscogee","2020-08-15","258","40573","17","4689","9.6","9.9"
"Muscogee","2020-08-16","149","40722","17","4706","9.7","9.7"
"Muscogee","2020-08-17","237","40959","22","4728","9.4","9.6"
"Muscogee","2020-08-18","310","41269","34","4762","9.1","9.7"
"Muscogee","2020-08-19","326","41595","31","4793","9.2","9.8"
"Muscogee","2020-08-20","317","41912","31","4824","9.2","9.6"
"Muscogee","2020-08-21","456","42368","35","4859","9.3","9.7"
"Muscogee","2020-08-22","213","42581","11","4870","9.1","9.4"
"Muscogee","2020-08-23","104","42685","7","4877","8.4","9.1"
"Muscogee","2020-08-24","248","42933","20","4897","8.3","8.8"
"Muscogee","2020-08-25","298","43231","21","4918","7.7","8.4"
"Muscogee","2020-08-26","328","43559","19","4937","7.2","8.2"
"Muscogee","2020-08-27","257","43816","27","4964","7.3","8.2"
"Muscogee","2020-08-28","263","44079","19","4983","7.2","8.3"
"Muscogee","2020-08-29","170","44249","21","5004","8.2","8.7"
"Muscogee","2020-08-30","136","44385","10","5014","8.3","8.4"
"Muscogee","2020-08-31","320","44705","24","5038","8.3","8.3"
"Muscogee","2020-09-01","241","44946","23","5061","8.6","8.2"
"Muscogee","2020-09-02","244","45190","22","5083","9.1","8.1"
"Muscogee","2020-09-03","325","45515","14","5097","8.2","7.7"
"Muscogee","2020-09-04","339","45854","20","5117","8","7.6"
"Muscogee","2020-09-05","259","46113","11","5128","6.8","7.5"
"Muscogee","2020-09-06","233","46346","10","5138","6.4","7.4"
"Muscogee","2020-09-07","84","46430","2","5140","5.7","7"
"Muscogee","2020-09-08","328","46758","31","5171","5.7","7.1"
"Muscogee","2020-09-09","274","47032","14","5185","5.1","7.1"
"Muscogee","2020-09-10","291","47323","25","5210","5.7","6.9"
"Muscogee","2020-09-11","323","47646","21","5231","5.8","6.9"
"Muscogee","2020-09-12","128","47774","6","5237","5.9","6.3"
"Muscogee","2020-09-13","99","47873","9","5246","6.5","6.5"
"Muscogee","2020-09-14","304","48177","15","5261","6.9","6.3"
"Muscogee","2020-09-15","198","48375","15","5276","6.6","6.1"
"Muscogee","2020-09-16","278","48653","13","5289","6.6","5.8"
"Muscogee","2020-09-17","246","48899","9","5298","5.9","5.8"
"Muscogee","2020-09-18","354","49253","19","5317","5.7","5.8"
"Muscogee","2020-09-19","196","49449","17","5334","6.3","6.1"
"Muscogee","2020-09-20","113","49562","8","5342","6","6.3"
"Muscogee","2020-09-21","291","49853","12","5354","5.9","6.4"
"Muscogee","2020-09-22","297","50150","24","5378","6","6.3"
"Muscogee","2020-09-23","337","50487","16","5394","6","6.3"
"Muscogee","2020-09-24","275","50762","14","5408","6.2","6"
"Muscogee","2020-09-25","309","51071","24","5432","6.5","6.1"
"Muscogee","2020-09-26","185","51256","11","5443","6.1","6.2"
"Muscogee","2020-09-27","78","51334","7","5450","6.4","6.2"
"Muscogee","2020-09-28","367","51701","8","5458","6.1","6"
"Muscogee","2020-09-29","326","52027","9","5467","5.4","5.7"
"Muscogee","2020-09-30","300","52327","13","5480","5.3","5.6"
"Muscogee","2020-10-01","368","52695","8","5488","4.9","5.5"
"Muscogee","2020-10-02","435","53130","14","5502","4.2","5.4"
"Muscogee","2020-10-03","294","53424","5","5507","3.6","4.9"
"Muscogee","2020-10-04","133","53557","6","5513","3","4.7"
"Muscogee","2020-10-05","370","53927","13","5526","3.2","4.6"
"Muscogee","2020-10-06","373","54300","16","5542","3.4","4.4"
"Muscogee","2020-10-07","381","54681","5","5547","3","4.1"
"Muscogee","2020-10-08","457","55138","12","5559","3","4"
"Muscogee","2020-10-09","534","55672","13","5572","2.9","3.6"
"Muscogee","2020-10-10","270","55942","14","5586","3.4","3.5"
"Muscogee","2020-10-11","149","56091","5","5591","3.2","3.1"
"Muscogee","2020-10-12","343","56434","8","5599","3.1","3.1"
"Muscogee","2020-10-13","311","56745","11","5610","3","3.2"
"Muscogee","2020-10-14","319","57064","13","5623","3.4","3.2"
"Muscogee","2020-10-15","384","57448","12","5635","3.4","3.2"
"Muscogee","2020-10-16","235","57683","11","5646","3.8","3.3"
"Muscogee","2020-10-17","386","58069","7","5653","3.3","3.3"
"Muscogee","2020-10-18","103","58172","8","5661","3.9","3.6"
"Muscogee","2020-10-19","380","58552","19","5680","4.3","3.7"
"Muscogee","2020-10-20","265","58817","6","5686","4.1","3.5"
"Muscogee","2020-10-21","329","59146","12","5698","4","3.7"
"Muscogee","2020-10-22","352","59498","15","5713","4.2","3.8"
"Muscogee","2020-10-23","397","59895","8","5721","3.8","3.8"
"Muscogee","2020-10-24","136","60031","7","5728","4.3","3.8"
"Muscogee","2020-10-25","86","60117","7","5735","4.4","4.1"
"Muscogee","2020-10-26","375","60492","19","5754","4.4","4.3"
"Muscogee","2020-10-27","301","60793","12","5766","4.6","4.4"
"Muscogee","2020-10-28","341","61134","13","5779","4.6","4.3"
"Muscogee","2020-10-29","331","61465","12","5791","4.5","4.4"
"Muscogee","2020-10-30","376","61841","14","5805","4.8","4.3"
"Muscogee","2020-10-31","146","61987","13","5818","5.3","4.8"
"Muscogee","2020-11-01","128","62115","12","5830","5.5","4.9"
"Muscogee","2020-11-02","317","62432","5","5835","5","4.7"
"Muscogee","2020-11-03","239","62671","10","5845","5","4.8"
"Muscogee","2020-11-04","394","63065","20","5865","5.2","4.9"
"Muscogee","2020-11-05","348","63413","10","5875","5.1","4.8"
"Muscogee","2020-11-06","299","63712","14","5889","5.2","5"
"Muscogee","2020-11-07","130","63842","9","5898","5","5.1"
"Muscogee","2020-11-08","86","63928","9","5907","5.1","5.3"
"Muscogee","2020-11-09","292","64220","16","5923","5.7","5.3"
"Muscogee","2020-11-10","337","64557","17","5940","5.8","5.4"
"Muscogee","2020-11-11","291","64848","7","5947","5.4","5.3"
"Muscogee","2020-11-12","310","65158","9","5956","5.4","5.3"
"Muscogee","2020-11-13","440","65598","14","5970","5.2","5.2"
"Muscogee","2020-11-14","353","65951","10","5980","4.6","4.8"
"Muscogee","2020-11-15","217","66168","8","5988","3.6","4.4"
"Muscogee","2020-11-16","302","66470","9","5997","3.3","4.5"
"Muscogee","2020-11-17","412","66882","18","6015","3.2","4.5"
"Muscogee","2020-11-18","450","67332","16","6031","3.4","4.4"
"Muscogee","2020-11-19","383","67715","13","6044","3.4","4.4"
"Muscogee","2020-11-20","496","68211","35","6079","4","4.6"
"Muscogee","2020-11-21","348","68559","16","6095","4.2","4.4"
"Muscogee","2020-11-22","260","68819","9","6104","4.2","3.9"
"Muscogee","2020-11-23","544","69363","27","6131","4.5","3.9"
"Muscogee","2020-11-24","331","69694","24","6155","4.9","4"
"Muscogee","2020-11-25","477","70171","24","6179","5.1","4.2"
"Muscogee","2020-11-26","69","70240","0","6179","4.6","4"
"Muscogee","2020-11-27","290","70530","21","6200","4.6","4.3"
"Muscogee","2020-11-28","252","70782","34","6234","5.9","5.1"
"Muscogee","2020-11-29","184","70966","26","6260","7.4","5.8"
"Muscogee","2020-11-30","541","71507","46","6306","7.9","6.2"
"Muscogee","2020-12-01","349","71856","35","6341","8.3","6.6"
"Muscogee","2020-12-02","609","72465","49","6390","8.8","6.9"
"Muscogee","2020-12-03","559","73024","58","6448","10.3","7.4"
"Muscogee","2020-12-04","537","73561","54","6502","10.7","7.7"
"Muscogee","2020-12-05","473","74034","39","6541","9.9","7.9"
"Muscogee","2020-12-06","165","74199","25","6566","10.1","8.8"
"Muscogee","2020-12-07","568","74767","64","6630","10.5","9.2"
"Muscogee","2020-12-08","502","75269","46","6676","10.3","9.3"
"Muscogee","2020-12-09","559","75828","55","6731","10.6","9.7"
"Muscogee","2020-12-10","623","76451","63","6794","10.5","10.4"
"Muscogee","2020-12-11","564","77015","75","6869","11","10.8"
"Muscogee","2020-12-12","412","77427","46","6915","11.4","10.7"
"Muscogee","2020-12-13","174","77601","34","6949","12.1","11.1"
"Muscogee","2020-12-14","799","78400","104","7053","12.3","11.4"
"Muscogee","2020-12-15","653","79053","94","7147","13.1","11.7"
"Muscogee","2020-12-16","472","79525","55","7202","13.3","11.9"
"Muscogee","2020-12-17","724","80249","83","7285","13.5","12"
"Muscogee","2020-12-18","682","80931","73","7358","13.1","12.1"
"Muscogee","2020-12-19","637","81568","59","7417","12.9","12.1"
"Muscogee","2020-12-20","238","81806","38","7455","12.4","12.2"
"Muscogee","2020-12-21","694","82500","99","7554","12.5","12.4"
"Muscogee","2020-12-22","698","83198","80","7634","12.1","12.6"
"Muscogee","2020-12-23","687","83885","99","7733","12.5","12.9"
"Muscogee","2020-12-24","732","84617","79","7812","12.4","13"
"Muscogee","2020-12-25","56","84673","11","7823","13.7","13.4"
"Muscogee","2020-12-26","403","85076","95","7918","15.7","14.3"
"Muscogee","2020-12-27","232","85308","55","7973","16.8","14.6"
"Muscogee","2020-12-28","786","86094","142","8115","17.4","15"
"Muscogee","2020-12-29","755","86849","172","8287","19","15.6"
"Muscogee","2020-12-30","1045","87894","169","8456","19.2","15.9"
"Muscogee","2020-12-31","957","88851","120","8576","19.5","16"
"Muscogee","2021-01-01","195","89046","32","8608","19","16.4"
"Muscogee","2021-01-02","357","89403","81","8689","18.9","17.3"
"Muscogee","2021-01-03","188","89591","54","8743","19.6","18.2"
"Muscogee","2021-01-04","742","90333","150","8893","19.9","18.7"
"Muscogee","2021-01-05","1261","91594","236","9129","19.4","19.2"
"Muscogee","2021-01-06","900","92494","152","9281","19.5","19.4"
"Muscogee","2021-01-07","869","93363","137","9418","19.9","19.7"
"Muscogee","2021-01-08","670","94033","112","9530","20","19.5"
"Muscogee","2021-01-09","621","94654","120","9650","19.5","19.2"
"Muscogee","2021-01-10","205","94859","49","9699","18.8","19.2"
"Muscogee","2021-01-11","573","95432","101","9800","18.4","19.2"
"Muscogee","2021-01-12","770","96202","155","9955","18.6","19"
"Muscogee","2021-01-13","864","97066","121","10076","18.2","18.8"
"Muscogee","2021-01-14","819","97885","106","10182","17.8","18.9"
"Muscogee","2021-01-15","645","98530","120","10302","18.1","19"
"Muscogee","2021-01-16","446","98976","77","10379","17.8","18.6"
"Muscogee","2021-01-17","212","99188","37","10416","16.9","17.8"
"Muscogee","2021-01-18","408","99596","81","10497","17.2","17.8"
"Muscogee","2021-01-19","730","100326","136","10633","17","17.8"
"Muscogee","2021-01-20","698","101024","84","10717","16.7","17.4"
"Muscogee","2021-01-21","686","101710","107","10824","17.1","17.4"
"Muscogee","2021-01-22","657","102367","83","10907","16.2","17.1"
"Muscogee","2021-01-23","407","102774","69","10976","16.2","17"
"Muscogee","2021-01-24","178","102952","43","11019","17.1","17"
"Muscogee","2021-01-25","569","103521","100","11119","16.8","17"
"Muscogee","2021-01-26","539","104060","98","11217","16.7","16.8"
"Muscogee","2021-01-27","562","104622","85","11302","17.2","16.9"
"Muscogee","2021-01-28","641","105263","91","11393","17","17"
"Muscogee","2021-01-29","535","105798","87","11480","17.5","16.9"
"Muscogee","2021-01-30","296","106094","63","11543","18.1","17.1"
"Muscogee","2021-01-31","204","106298","34","11577","17","17.1"
"Muscogee","2021-02-01","573","106871","74","11651","16.4","16.6"
"Muscogee","2021-02-02","458","107329","57","11708","15.6","16.1"
"Muscogee","2021-02-03","543","107872","62","11770","15","16.1"
"Muscogee","2021-02-04","453","108325","66","11836","15.1","16"
"Muscogee","2021-02-05","391","108716","40","11876","14.2","15.9"
"Muscogee","2021-02-06","72","108788","9","11885","13","15.5"
"Muscogee","2021-02-07","7","108795","0","11885","10.6","13.8"
"Muscogee","2021-02-08","0","108795","0","11885","8.7","12.6"
"Newton","2020-02-01","0","0","0","0",".","."
"Newton","2020-02-02","0","0","0","0",".","."
"Newton","2020-02-03","0","0","0","0",".","."
"Newton","2020-02-04","0","0","0","0",".","."
"Newton","2020-02-05","0","0","0","0",".","."
"Newton","2020-02-06","0","0","0","0",".","."
"Newton","2020-02-07","0","0","0","0","0","."
"Newton","2020-02-08","0","0","0","0","0","."
"Newton","2020-02-09","0","0","0","0","0","."
"Newton","2020-02-10","0","0","0","0","0","."
"Newton","2020-02-11","0","0","0","0","0","."
"Newton","2020-02-12","0","0","0","0","0","."
"Newton","2020-02-13","0","0","0","0","0","."
"Newton","2020-02-14","0","0","0","0","0","0"
"Newton","2020-02-15","0","0","0","0","0","0"
"Newton","2020-02-16","0","0","0","0","0","0"
"Newton","2020-02-17","0","0","0","0","0","0"
"Newton","2020-02-18","0","0","0","0","0","0"
"Newton","2020-02-19","0","0","0","0","0","0"
"Newton","2020-02-20","0","0","0","0","0","0"
"Newton","2020-02-21","0","0","0","0","0","0"
"Newton","2020-02-22","0","0","0","0","0","0"
"Newton","2020-02-23","0","0","0","0","0","0"
"Newton","2020-02-24","0","0","0","0","0","0"
"Newton","2020-02-25","0","0","0","0","0","0"
"Newton","2020-02-26","0","0","0","0","0","0"
"Newton","2020-02-27","0","0","0","0","0","0"
"Newton","2020-02-28","0","0","0","0","0","0"
"Newton","2020-02-29","0","0","0","0","0","0"
"Newton","2020-03-01","1","1","0","0","0","0"
"Newton","2020-03-02","0","1","0","0","0","0"
"Newton","2020-03-03","0","1","0","0","0","0"
"Newton","2020-03-04","0","1","0","0","0","0"
"Newton","2020-03-05","2","3","0","0","0","0"
"Newton","2020-03-06","0","3","0","0","0","0"
"Newton","2020-03-07","0","3","0","0","0","0"
"Newton","2020-03-08","0","3","0","0","0","0"
"Newton","2020-03-09","1","4","0","0","0","0"
"Newton","2020-03-10","0","4","0","0","0","0"
"Newton","2020-03-11","3","7","0","0","0","0"
"Newton","2020-03-12","5","12","1","1","2.9","1.4"
"Newton","2020-03-13","3","15","2","3","12.4","6.2"
"Newton","2020-03-14","4","19","0","3","12.4","6.2"
"Newton","2020-03-15","1","20","1","4","26.7","13.3"
"Newton","2020-03-16","13","33","3","7","30","15"
"Newton","2020-03-17","12","45","1","8","31.2","15.6"
"Newton","2020-03-18","15","60","2","10","33.1","16.5"
"Newton","2020-03-19","12","72","1","11","31.4","17.1"
"Newton","2020-03-20","18","90","4","15","25","18.7"
"Newton","2020-03-21","17","107","2","17","26.7","19.6"
"Newton","2020-03-22","16","123","2","19","14.2","20.4"
"Newton","2020-03-23","27","150","4","23","13","21.5"
"Newton","2020-03-24","38","188","9","32","15.2","23.2"
"Newton","2020-03-25","32","220","5","37","15.6","24.3"
"Newton","2020-03-26","41","261","2","39","15.1","23.2"
"Newton","2020-03-27","22","283","5","44","15.1","20.1"
"Newton","2020-03-28","5","288","0","44","13.5","20.1"
"Newton","2020-03-29","2","290","0","44","11.7","12.9"
"Newton","2020-03-30","24","314","4","48","11.9","12.5"
"Newton","2020-03-31","27","341","2","50","9.6","12.4"
"Newton","2020-04-01","31","372","4","54","9.2","12.4"
"Newton","2020-04-02","28","400","1","55","9","12.1"
"Newton","2020-04-03","26","426","5","60","8.5","11.8"
"Newton","2020-04-04","18","444","6","66","13.3","13.4"
"Newton","2020-04-05","9","453","3","69","18.1","14.9"
"Newton","2020-04-06","39","492","5","74","17.5","14.7"
"Newton","2020-04-07","54","546","5","79","17.8","13.7"
"Newton","2020-04-08","43","589","9","88","18.9","14.1"
"Newton","2020-04-09","37","626","6","94","20.7","14.9"
"Newton","2020-04-10","32","658","7","101","21.1","14.8"
"Newton","2020-04-11","28","686","1","102","16.9","15.1"
"Newton","2020-04-12","11","697","2","104","14.7","16.4"
"Newton","2020-04-13","52","749","7","111","14.8","16.1"
"Newton","2020-04-14","57","806","8","119","15.5","16.6"
"Newton","2020-04-15","47","853","4","123","13.7","16.3"
"Newton","2020-04-16","177","1030","12","135","12.3","16.5"
"Newton","2020-04-17","71","1101","1","136","9.4","15.3"
"Newton","2020-04-18","29","1130","5","141","11.4","14.1"
"Newton","2020-04-19","25","1155","3","144","10.5","12.6"
"Newton","2020-04-20","58","1213","5","149","9.8","12.3"
"Newton","2020-04-21","91","1304","5","154","8.6","12"
"Newton","2020-04-22","104","1408","8","162","8.5","11.1"
"Newton","2020-04-23","121","1529","9","171","8.6","10.5"
"Newton","2020-04-24","107","1636","7","178","9.3","9.4"
"Newton","2020-04-25","47","1683","4","182","8","9.7"
"Newton","2020-04-26","21","1704","3","185","8.4","9.4"
"Newton","2020-04-27","164","1868","6","191","7.7","8.7"
"Newton","2020-04-28","145","2013","9","200","7.8","8.2"
"Newton","2020-04-29","91","2104","2","202","7","7.7"
"Newton","2020-04-30","298","2402","16","218","6.7","7.6"
"Newton","2020-05-01","319","2721","18","236","6.6","7.9"
"Newton","2020-05-02","24","2745","2","238","6.5","7.3"
"Newton","2020-05-03","32","2777","2","240","5.4","6.9"
"Newton","2020-05-04","119","2896","7","247","5.7","6.7"
"Newton","2020-05-05","138","3034","14","261","6.3","7"
"Newton","2020-05-06","104","3138","7","268","6.9","6.9"
"Newton","2020-05-07","149","3287","1","269","6.2","6.5"
"Newton","2020-05-08","47","3334","2","271","6","6.3"
"Newton","2020-05-09","14","3348","1","272","5.9","6.2"
"Newton","2020-05-10","34","3382","2","274","5.8","5.6"
"Newton","2020-05-11","174","3556","11","285","5.9","5.8"
"Newton","2020-05-12","176","3732","4","289","4.8","5.5"
"Newton","2020-05-13","141","3873","9","298","4.7","5.8"
"Newton","2020-05-14","156","4029","8","306","5.3","5.8"
"Newton","2020-05-15","152","4181","4","310","5.1","5.6"
"Newton","2020-05-16","47","4228","2","312","4.7","5.3"
"Newton","2020-05-17","47","4275","4","316","5.1","5.4"
"Newton","2020-05-18","175","4450","6","322","4.7","5.3"
"Newton","2020-05-19","179","4629","15","337","5.5","5.1"
"Newton","2020-05-20","183","4812","20","357","6.2","5.4"
"Newton","2020-05-21","90","4902","11","368","7.2","6.3"
"Newton","2020-05-22","200","5102","9","377","7.5","6.3"
"Newton","2020-05-23","36","5138","5","382","8.8","6.8"
"Newton","2020-05-24","41","5179","3","385","8.7","6.9"
"Newton","2020-05-25","26","5205","2","387","9.3","7"
"Newton","2020-05-26","182","5387","12","399","9","7.3"
"Newton","2020-05-27","175","5562","5","404","7.9","7"
"Newton","2020-05-28","119","5681","4","408","6.6","6.9"
"Newton","2020-05-29","109","5790","5","413","6.6","7"
"Newton","2020-05-30","41","5831","2","415","5.3","7.1"
"Newton","2020-05-31","54","5885","5","420","5.6","7.1"
"Newton","2020-06-01","143","6028","5","425","5","7.1"
"Newton","2020-06-02","143","6171","4","429","4.5","6.7"
"Newton","2020-06-03","148","6319","7","436","4.7","6.3"
"Newton","2020-06-04","111","6430","4","440","4.8","5.7"
"Newton","2020-06-05","95","6525","7","447","5.2","5.9"
"Newton","2020-06-06","42","6567","2","449","5.1","5.2"
"Newton","2020-06-07","40","6607","3","452","4.9","5.2"
"Newton","2020-06-08","131","6738","6","458","5","5"
"Newton","2020-06-09","130","6868","7","465","5.4","4.9"
"Newton","2020-06-10","148","7016","9","474","5.6","5.2"
"Newton","2020-06-11","127","7143","13","487","6.6","5.7"
"Newton","2020-06-12","122","7265","9","496","6.6","5.9"
"Newton","2020-06-13","49","7314","5","501","7.3","6.2"
"Newton","2020-06-14","25","7339","5","506","9.1","7"
"Newton","2020-06-15","185","7524","18","524","9.9","7.5"
"Newton","2020-06-16","147","7671","7","531","9.8","7.6"
"Newton","2020-06-17","143","7814","7","538","9.6","7.6"
"Newton","2020-06-18","174","7988","18","556","9.6","8.1"
"Newton","2020-06-19","169","8157","12","568","9.6","8.1"
"Newton","2020-06-20","52","8209","8","576","10.3","8.8"
"Newton","2020-06-21","39","8248","4","580","8.9","9"
"Newton","2020-06-22","218","8466","32","612","9.6","9.7"
"Newton","2020-06-23","174","8640","23","635","10.8","10.3"
"Newton","2020-06-24","223","8863","20","655","11.4","10.5"
"Newton","2020-06-25","198","9061","21","676","11.5","10.5"
"Newton","2020-06-26","193","9254","32","708","12.8","11.2"
"Newton","2020-06-27","68","9322","11","719","12.9","11.6"
"Newton","2020-06-28","55","9377","4","723","12.5","10.7"
"Newton","2020-06-29","286","9663","24","747","11.6","10.6"
"Newton","2020-06-30","304","9967","38","785","11.5","11.2"
"Newton","2020-07-01","288","10255","26","811","11.5","11.5"
"Newton","2020-07-02","239","10494","27","838","11.6","11.5"
"Newton","2020-07-03","96","10590","15","853","11.5","12.1"
"Newton","2020-07-04","20","10610","5","858","12.7","12.8"
"Newton","2020-07-05","58","10668","13","871","14.9","13.7"
"Newton","2020-07-06","284","10952","52","923","16.3","14"
"Newton","2020-07-07","307","11259","37","960","16.2","13.9"
"Newton","2020-07-08","272","11531","38","998","17","14.2"
"Newton","2020-07-09","273","11804","37","1035","17.3","14.4"
"Newton","2020-07-10","255","12059","33","1068","16.9","14.2"
"Newton","2020-07-11","78","12137","15","1083","16.1","14.4"
"Newton","2020-07-12","50","12187","12","1095","16.3","15.6"
"Newton","2020-07-13","192","12379","25","1120","15.5","15.9"
"Newton","2020-07-14","170","12549","34","1154","16.7","16.5"
"Newton","2020-07-15","151","12700","36","1190","18.1","17.5"
"Newton","2020-07-16","164","12864","29","1219","18.7","18"
"Newton","2020-07-17","142","13006","19","1238","18.7","17.8"
"Newton","2020-07-18","69","13075","21","1259","20.3","18.2"
"Newton","2020-07-19","67","13142","12","1271","19.5","17.9"
"Newton","2020-07-20","152","13294","34","1305","20.8","18.2"
"Newton","2020-07-21","152","13446","24","1329","20.2","18.4"
"Newton","2020-07-22","165","13611","18","1347","18.4","18.2"
"Newton","2020-07-23","135","13746","29","1376","18.9","18.8"
"Newton","2020-07-24","213","13959","32","1408","19.1","18.9"
"Newton","2020-07-25","111","14070","25","1433","18","19.2"
"Newton","2020-07-26","66","14136","10","1443","17.6","18.5"
"Newton","2020-07-27","298","14434","26","1469","15.7","18.2"
"Newton","2020-07-28","252","14686","27","1496","14.9","17.6"
"Newton","2020-07-29","239","14925","29","1525","15.1","16.7"
"Newton","2020-07-30","264","15189","35","1560","13.9","16.4"
"Newton","2020-07-31","295","15484","27","1587","13.1","16.1"
"Newton","2020-08-01","86","15570","7","1594","11","14.5"
"Newton","2020-08-02","41","15611","6","1600","11","14.3"
"Newton","2020-08-03","240","15851","23","1623","11.1","13.4"
"Newton","2020-08-04","236","16087","33","1656","11.6","13.2"
"Newton","2020-08-05","216","16303","27","1683","11.6","13.4"
"Newton","2020-08-06","239","16542","34","1717","11.7","12.8"
"Newton","2020-08-07","211","16753","28","1745","12.3","12.7"
"Newton","2020-08-08","96","16849","11","1756","12.8","11.9"
"Newton","2020-08-09","74","16923","15","1771","13.6","12.3"
"Newton","2020-08-10","295","17218","32","1803","13.8","12.4"
"Newton","2020-08-11","157","17375","19","1822","13.5","12.5"
"Newton","2020-08-12","265","17640","33","1855","13.5","12.6"
"Newton","2020-08-13","257","17897","29","1884","13.1","12.4"
"Newton","2020-08-14","258","18155","18","1902","12.2","12.3"
"Newton","2020-08-15","100","18255","13","1915","12.4","12.6"
"Newton","2020-08-16","93","18348","12","1927","11.4","12.5"
"Newton","2020-08-17","263","18611","13","1940","10.5","12.2"
"Newton","2020-08-18","170","18781","13","1953","9.9","11.7"
"Newton","2020-08-19","198","18979","16","1969","9.3","11.4"
"Newton","2020-08-20","161","19140","16","1985","9.1","11.1"
"Newton","2020-08-21","202","19342","13","1998","9","10.6"
"Newton","2020-08-22","87","19429","11","2009","8.9","10.7"
"Newton","2020-08-23","51","19480","5","2014","8.5","9.9"
"Newton","2020-08-24","220","19700","23","2037","9.3","9.9"
"Newton","2020-08-25","206","19906","21","2058","9.7","9.8"
"Newton","2020-08-26","249","20155","26","2084","10","9.6"
"Newton","2020-08-27","192","20347","13","2097","9.5","9.3"
"Newton","2020-08-28","242","20589","21","2118","9.9","9.4"
"Newton","2020-08-29","66","20655","7","2125","9.6","9.3"
"Newton","2020-08-30","52","20707","11","2136","11.2","9.8"
"Newton","2020-08-31","201","20908","24","2160","11.4","10.3"
"Newton","2020-09-01","149","21057","9","2169","10.8","10.2"
"Newton","2020-09-02","169","21226","10","2179","10.2","10.1"
"Newton","2020-09-03","150","21376","4","2183","9.6","9.6"
"Newton","2020-09-04","170","21546","11","2194","9.3","9.6"
"Newton","2020-09-05","77","21623","8","2202","9.2","9.4"
"Newton","2020-09-06","85","21708","13","2215","8.4","9.8"
"Newton","2020-09-07","53","21761","1","2216","7","9.2"
"Newton","2020-09-08","169","21930","15","2231","7.4","9.1"
"Newton","2020-09-09","223","22153","13","2244","7.3","8.8"
"Newton","2020-09-10","161","22314","14","2258","8.2","8.9"
"Newton","2020-09-11","249","22563","6","2264","7.6","8.4"
"Newton","2020-09-12","40","22603","6","2270","8.3","8.8"
"Newton","2020-09-13","39","22642","3","2273","7.2","7.8"
"Newton","2020-09-14","271","22913","11","2284","7.5","7.2"
"Newton","2020-09-15","156","23069","10","2294","7.2","7.3"
"Newton","2020-09-16","246","23315","14","2308","7.1","7.2"
"Newton","2020-09-17","132","23447","8","2316","6.8","7.5"
"Newton","2020-09-18","309","23756","9","2325","6.8","7.2"
"Newton","2020-09-19","58","23814","2","2327","5.2","6.7"
"Newton","2020-09-20","30","23844","2","2329","5","6.1"
"Newton","2020-09-21","282","24126","14","2343","5.2","6.3"
"Newton","2020-09-22","146","24272","8","2351","5","6.1"
"Newton","2020-09-23","205","24477","5","2356","4.6","5.9"
"Newton","2020-09-24","120","24597","8","2364","4.7","5.7"
"Newton","2020-09-25","278","24875","18","2382","5.2","6"
"Newton","2020-09-26","49","24924","4","2386","5.8","5.5"
"Newton","2020-09-27","43","24967","6","2392","6.9","6"
"Newton","2020-09-28","254","25221","6","2398","6.5","5.8"
"Newton","2020-09-29","182","25403","9","2407","6.4","5.7"
"Newton","2020-09-30","239","25642","13","2420","6.9","5.7"
"Newton","2020-10-01","155","25797","7","2427","6.6","5.6"
"Newton","2020-10-02","235","26032","10","2437","6.2","5.7"
"Newton","2020-10-03","55","26087","4","2441","6.1","6"
"Newton","2020-10-04","37","26124","0","2441","4.1","5.5"
"Newton","2020-10-05","263","26387","9","2450","4.3","5.4"
"Newton","2020-10-06","144","26531","10","2460","4.6","5.5"
"Newton","2020-10-07","176","26707","5","2465","4.2","5.5"
"Newton","2020-10-08","161","26868","12","2477","4.6","5.6"
"Newton","2020-10-09","206","27074","11","2488","4.8","5.5"
"Newton","2020-10-10","57","27131","4","2492","4.7","5.4"
"Newton","2020-10-11","43","27174","1","2493","5","4.6"
"Newton","2020-10-12","137","27311","10","2503","5.6","4.9"
"Newton","2020-10-13","176","27487","12","2515","5.6","5.1"
"Newton","2020-10-14","154","27641","10","2525","6.1","5.1"
"Newton","2020-10-15","154","27795","6","2531","5.6","5.1"
"Newton","2020-10-16","100","27895","6","2537","5.7","5.2"
"Newton","2020-10-17","35","27930","2","2539","5.5","5.1"
"Newton","2020-10-18","27","27957","2","2541","6.2","5.6"
"Newton","2020-10-19","181","28138","11","2552","6.1","5.8"
"Newton","2020-10-20","166","28304","10","2562","5.9","5.8"
"Newton","2020-10-21","182","28486","14","2576","6.1","6.1"
"Newton","2020-10-22","149","28635","8","2584","6.3","6"
"Newton","2020-10-23","223","28858","20","2604","6.8","6.2"
"Newton","2020-10-24","61","28919","1","2605","6.2","5.8"
"Newton","2020-10-25","81","29000","11","2616","7.1","6.6"
"Newton","2020-10-26","175","29175","13","2629","7.2","6.7"
"Newton","2020-10-27","212","29387","15","2644","7.4","6.7"
"Newton","2020-10-28","193","29580","14","2658","7.3","6.7"
"Newton","2020-10-29","128","29708","10","2668","7.7","7"
"Newton","2020-10-30","232","29940","14","2682","7.3","7"
"Newton","2020-10-31","70","30010","9","2691","8.9","7.5"
"Newton","2020-11-01","75","30085","12","2703","9.2","8.1"
"Newton","2020-11-02","205","30290","18","2721","9.4","8.3"
"Newton","2020-11-03","175","30465","19","2740","9.9","8.7"
"Newton","2020-11-04","245","30710","22","2762","10.2","8.8"
"Newton","2020-11-05","217","30927","26","2788","10.8","9.2"
"Newton","2020-11-06","234","31161","26","2814","11.5","9.4"
"Newton","2020-11-07","94","31255","15","2829","12","10.4"
"Newton","2020-11-08","52","31307","9","2838","12.1","10.7"
"Newton","2020-11-09","227","31534","20","2858","12.1","10.8"
"Newton","2020-11-10","260","31794","28","2886","12.1","11"
"Newton","2020-11-11","161","31955","12","2898","11.9","11.1"
"Newton","2020-11-12","209","32164","19","2917","11.5","11.1"
"Newton","2020-11-13","219","32383","17","2934","11","11.3"
"Newton","2020-11-14","103","32486","9","2943","10","11"
"Newton","2020-11-15","71","32557","17","2960","10.9","11.5"
"Newton","2020-11-16","226","32783","23","2983","11.1","11.6"
"Newton","2020-11-17","273","33056","19","3002","10.6","11.4"
"Newton","2020-11-18","268","33324","30","3032","11.1","11.5"
"Newton","2020-11-19","234","33558","21","3053","11.1","11.3"
"Newton","2020-11-20","217","33775","20","3073","11.3","11.2"
"Newton","2020-11-21","89","33864","14","3087","12.3","11.2"
"Newton","2020-11-22","96","33960","9","3096","10.2","10.6"
"Newton","2020-11-23","276","34236","30","3126","10.3","10.7"
"Newton","2020-11-24","243","34479","23","3149","10.7","10.6"
"Newton","2020-11-25","224","34703","21","3170","10.4","10.8"
"Newton","2020-11-26","33","34736","5","3175","11.3","11.2"
"Newton","2020-11-27","129","34865","22","3197","12.4","11.9"
"Newton","2020-11-28","96","34961","18","3215","12.9","12.6"
"Newton","2020-11-29","80","35041","14","3229","14","12.1"
"Newton","2020-11-30","340","35381","56","3285","14.8","12.6"
"Newton","2020-12-01","282","35663","49","3334","16","13.3"
"Newton","2020-12-02","312","35975","47","3381","16.8","13.6"
"Newton","2020-12-03","300","36275","48","3429","16.9","14.1"
"Newton","2020-12-04","273","36548","37","3466","16.4","14.4"
"Newton","2020-12-05","154","36702","36","3502","17","15"
"Newton","2020-12-06","88","36790","15","3517","17","15.5"
"Newton","2020-12-07","348","37138","54","3571","16.8","15.8"
"Newton","2020-12-08","361","37499","57","3628","16.6","16.3"
"Newton","2020-12-09","346","37845","61","3689","17","16.9"
"Newton","2020-12-10","323","38168","65","3754","17.6","17.2"
"Newton","2020-12-11","268","38436","46","3800","18.1","17.2"
"Newton","2020-12-12","153","38589","39","3839","18.4","17.7"
"Newton","2020-12-13","95","38684","26","3865","19.9","18.4"
"Newton","2020-12-14","411","39095","56","3921","19.6","18.2"
"Newton","2020-12-15","403","39498","62","3983","19.5","18.1"
"Newton","2020-12-16","382","39880","72","4055","19.7","18.4"
"Newton","2020-12-17","376","40256","73","4128","19.6","18.6"
"Newton","2020-12-18","397","40653","72","4200","19.8","18.9"
"Newton","2020-12-19","160","40813","25","4225","18.3","18.4"
"Newton","2020-12-20","102","40915","15","4240","16.5","18.2"
"Newton","2020-12-21","355","41270","63","4303","17.1","18.4"
"Newton","2020-12-22","338","41608","68","4371","17.8","18.7"
"Newton","2020-12-23","301","41909","81","4452","19","19.3"
"Newton","2020-12-24","158","42067","37","4489","19.5","19.6"
"Newton","2020-12-25","34","42101","8","4497","20.3","20"
"Newton","2020-12-26","137","42238","36","4533","21.8","20.1"
"Newton","2020-12-27","109","42347","26","4559","23.1","19.8"
"Newton","2020-12-28","335","42682","79","4638","24","20.5"
"Newton","2020-12-29","363","43045","103","4741","25.1","21.5"
"Newton","2020-12-30","371","43416","91","4832","24.8","21.9"
"Newton","2020-12-31","291","43707","55","4887","24.1","21.8"
"Newton","2021-01-01","62","43769","21","4908","25.6","23"
"Newton","2021-01-02","137","43906","24","4932","24.4","23.1"
"Newton","2021-01-03","108","44014","20","4952","23.6","23.4"
"Newton","2021-01-04","294","44308","62","5014","23.3","23.6"
"Newton","2021-01-05","424","44732","88","5102","22.2","23.7"
"Newton","2021-01-06","374","45106","86","5188","21.9","23.4"
"Newton","2021-01-07","436","45542","102","5290","22.6","23.4"
"Newton","2021-01-08","382","45924","83","5373","20.9","23.2"
"Newton","2021-01-09","156","46080","42","5415","22.2","23.3"
"Newton","2021-01-10","118","46198","25","5440","22.6","23.1"
"Newton","2021-01-11","385","46583","79","5519","22.5","22.9"
"Newton","2021-01-12","369","46952","84","5603","22.8","22.5"
"Newton","2021-01-13","320","47272","47","5650","21.6","21.8"
"Newton","2021-01-14","294","47566","62","5712","21.3","21.9"
"Newton","2021-01-15","327","47893","66","5778","21.1","21"
"Newton","2021-01-16","168","48061","35","5813","20.2","21.2"
"Newton","2021-01-17","113","48174","17","5830","19.3","20.9"
"Newton","2021-01-18","206","48380","51","5881","19.9","21.2"
"Newton","2021-01-19","376","48756","53","5934","18.7","20.7"
"Newton","2021-01-20","342","49098","56","5990","18.9","20.3"
"Newton","2021-01-21","314","49412","45","6035","17.9","19.6"
"Newton","2021-01-22","308","49720","42","6077","17","19"
"Newton","2021-01-23","167","49887","23","6100","16","18.1"
"Newton","2021-01-24","108","49995","31","6131","18","18.6"
"Newton","2021-01-25","377","50372","49","6180","16.3","18.1"
"Newton","2021-01-26","320","50692","53","6233","16.6","17.6"
"Newton","2021-01-27","317","51009","54","6287","16.7","17.8"
"Newton","2021-01-28","320","51329","32","6319","16.1","17"
"Newton","2021-01-29","272","51601","35","6354","16","16.5"
"Newton","2021-01-30","131","51732","15","6369","15.7","15.8"
"Newton","2021-01-31","108","51840","18","6387","13.9","15.9"
"Newton","2021-02-01","309","52149","41","6428","14","15.1"
"Newton","2021-02-02","275","52424","39","6467","13.6","15.1"
"Newton","2021-02-03","276","52700","39","6506","13.2","15"
"Newton","2021-02-04","262","52962","33","6539","13.6","14.8"
"Newton","2021-02-05","178","53140","15","6554","13","14.5"
"Newton","2021-02-06","38","53178","8","6562","14.3","15"
"Newton","2021-02-07","9","53187","0","6562","12","12.9"
"Newton","2021-02-08","0","53187","0","6562","10.1","12"
"Oconee","2020-02-01","0","0","0","0",".","."
"Oconee","2020-02-02","0","0","0","0",".","."
"Oconee","2020-02-03","0","0","0","0",".","."
"Oconee","2020-02-04","0","0","0","0",".","."
"Oconee","2020-02-05","0","0","0","0",".","."
"Oconee","2020-02-06","0","0","0","0",".","."
"Oconee","2020-02-07","0","0","0","0","0","."
"Oconee","2020-02-08","0","0","0","0","0","."
"Oconee","2020-02-09","0","0","0","0","0","."
"Oconee","2020-02-10","0","0","0","0","0","."
"Oconee","2020-02-11","0","0","0","0","0","."
"Oconee","2020-02-12","0","0","0","0","0","."
"Oconee","2020-02-13","0","0","0","0","0","."
"Oconee","2020-02-14","0","0","0","0","0","0"
"Oconee","2020-02-15","0","0","0","0","0","0"
"Oconee","2020-02-16","0","0","0","0","0","0"
"Oconee","2020-02-17","0","0","0","0","0","0"
"Oconee","2020-02-18","0","0","0","0","0","0"
"Oconee","2020-02-19","0","0","0","0","0","0"
"Oconee","2020-02-20","0","0","0","0","0","0"
"Oconee","2020-02-21","0","0","0","0","0","0"
"Oconee","2020-02-22","0","0","0","0","0","0"
"Oconee","2020-02-23","0","0","0","0","0","0"
"Oconee","2020-02-24","0","0","0","0","0","0"
"Oconee","2020-02-25","0","0","0","0","0","0"
"Oconee","2020-02-26","0","0","0","0","0","0"
"Oconee","2020-02-27","0","0","0","0","0","0"
"Oconee","2020-02-28","0","0","0","0","0","0"
"Oconee","2020-02-29","0","0","0","0","0","0"
"Oconee","2020-03-01","0","0","0","0","0","0"
"Oconee","2020-03-02","0","0","0","0","0","0"
"Oconee","2020-03-03","0","0","0","0","0","0"
"Oconee","2020-03-04","0","0","0","0","0","0"
"Oconee","2020-03-05","0","0","0","0","0","0"
"Oconee","2020-03-06","0","0","0","0","0","0"
"Oconee","2020-03-07","0","0","0","0","0","0"
"Oconee","2020-03-08","1","1","0","0","0","0"
"Oconee","2020-03-09","1","2","0","0","0","0"
"Oconee","2020-03-10","2","4","0","0","0","0"
"Oconee","2020-03-11","0","4","0","0","0","0"
"Oconee","2020-03-12","11","15","1","1","1.3","0.6"
"Oconee","2020-03-13","8","23","0","1","1.3","0.6"
"Oconee","2020-03-14","1","24","0","1","1.3","0.6"
"Oconee","2020-03-15","3","27","1","2","6.1","3"
"Oconee","2020-03-16","11","38","1","3","7.4","3.7"
"Oconee","2020-03-17","8","46","0","3","7.4","3.7"
"Oconee","2020-03-18","13","59","0","3","7.4","3.7"
"Oconee","2020-03-19","24","83","3","6","7.8","4.6"
"Oconee","2020-03-20","19","102","1","7","8.6","4.9"
"Oconee","2020-03-21","4","106","0","7","8.6","4.9"
"Oconee","2020-03-22","1","107","0","7","3.8","4.9"
"Oconee","2020-03-23","11","118","0","7","2.5","4.9"
"Oconee","2020-03-24","29","147","7","14","6","6.7"
"Oconee","2020-03-25","13","160","3","17","9.3","8.3"
"Oconee","2020-03-26","17","177","1","18","8.3","8.1"
"Oconee","2020-03-27","13","190","0","18","7.6","8.1"
"Oconee","2020-03-28","3","193","1","19","12.3","10.5"
"Oconee","2020-03-29","2","195","0","19","12.3","8.1"
"Oconee","2020-03-30","10","205","1","20","13.8","8.2"
"Oconee","2020-03-31","9","214","0","20","10.3","8.2"
"Oconee","2020-04-01","9","223","0","20","7","8.2"
"Oconee","2020-04-02","4","227","0","20","6.2","7.3"
"Oconee","2020-04-03","30","257","2","22","7.1","7.4"
"Oconee","2020-04-04","0","257","0","22","2.4","7.4"
"Oconee","2020-04-05","1","258","0","22","2.4","7.4"
"Oconee","2020-04-06","11","269","2","24","3.5","8.7"
"Oconee","2020-04-07","5","274","0","24","3.5","6.9"
"Oconee","2020-04-08","12","286","2","26","5.9","6.5"
"Oconee","2020-04-09","17","303","3","29","8.5","7.3"
"Oconee","2020-04-10","29","332","6","35","10.5","8.8"
"Oconee","2020-04-11","3","335","0","35","10.5","6.4"
"Oconee","2020-04-12","3","338","0","35","10.5","6.4"
"Oconee","2020-04-13","8","346","0","35","7.9","5.7"
"Oconee","2020-04-14","9","355","1","36","9.4","6.5"
"Oconee","2020-04-15","9","364","0","36","7.1","6.5"
"Oconee","2020-04-16","8","372","0","36","4.5","6.5"
"Oconee","2020-04-17","7","379","0","36","1.6","6"
"Oconee","2020-04-18","2","381","0","36","1.6","6"
"Oconee","2020-04-19","1","382","0","36","1.6","6"
"Oconee","2020-04-20","10","392","0","36","1.6","4.7"
"Oconee","2020-04-21","11","403","1","37","1.3","5.4"
"Oconee","2020-04-22","8","411","0","37","1.3","4.2"
"Oconee","2020-04-23","9","420","2","39","4.5","4.5"
"Oconee","2020-04-24","3","423","0","39","4.5","3"
"Oconee","2020-04-25","2","425","0","39","4.5","3"
"Oconee","2020-04-26","2","427","0","39","4.5","3"
"Oconee","2020-04-27","16","443","0","39","4.5","3"
"Oconee","2020-04-28","12","455","1","40","4.4","2.8"
"Oconee","2020-04-29","20","475","1","41","5.1","3.2"
"Oconee","2020-04-30","5","480","0","41","1.9","3.2"
"Oconee","2020-05-01","18","498","1","42","2.7","3.6"
"Oconee","2020-05-02","5","503","0","42","2.7","3.6"
"Oconee","2020-05-03","1","504","1","43","17","10.7"
"Oconee","2020-05-04","18","522","1","44","17.8","11.1"
"Oconee","2020-05-05","11","533","0","44","16.6","10.5"
"Oconee","2020-05-06","26","559","0","44","15.9","10.5"
"Oconee","2020-05-07","13","572","0","44","15.9","8.9"
"Oconee","2020-05-08","13","585","1","45","16.2","9.4"
"Oconee","2020-05-09","3","588","1","46","20.9","11.8"
"Oconee","2020-05-10","2","590","0","46","6.7","11.8"
"Oconee","2020-05-11","31","621","1","47","6.3","12"
"Oconee","2020-05-12","26","647","2","49","7.4","12"
"Oconee","2020-05-13","17","664","0","49","7.4","11.6"
"Oconee","2020-05-14","10","674","0","49","7.4","11.6"
"Oconee","2020-05-15","22","696","1","50","7","11.6"
"Oconee","2020-05-16","11","707","0","50","2.2","11.6"
"Oconee","2020-05-17","10","717","2","52","5.1","5.9"
"Oconee","2020-05-18","24","741","0","52","4.6","5.5"
"Oconee","2020-05-19","32","773","2","54","4.4","5.9"
"Oconee","2020-05-20","19","792","0","54","4.4","5.9"
"Oconee","2020-05-21","20","812","0","54","4.4","5.9"
"Oconee","2020-05-22","25","837","0","54","3.8","5.4"
"Oconee","2020-05-23","12","849","1","55","4.9","3.6"
"Oconee","2020-05-24","2","851","0","55","2.1","3.6"
"Oconee","2020-05-25","6","857","0","55","2.1","3.3"
"Oconee","2020-05-26","37","894","3","58","2.3","3.4"
"Oconee","2020-05-27","40","934","0","58","2.3","3.4"
"Oconee","2020-05-28","29","963","0","58","2.3","3.4"
"Oconee","2020-05-29","31","994","2","60","3.3","3.5"
"Oconee","2020-05-30","11","1005","0","60","2.1","3.5"
"Oconee","2020-05-31","8","1013","0","60","2.1","2.1"
"Oconee","2020-06-01","27","1040","0","60","2.1","2.1"
"Oconee","2020-06-02","21","1061","1","61","1.6","2"
"Oconee","2020-06-03","31","1092","2","63","2.5","2.4"
"Oconee","2020-06-04","31","1123","0","63","2.5","2.4"
"Oconee","2020-06-05","55","1178","1","64","1.9","2.6"
"Oconee","2020-06-06","19","1197","0","64","1.9","2"
"Oconee","2020-06-07","10","1207","0","64","1.9","2"
"Oconee","2020-06-08","32","1239","1","65","2.3","2.2"
"Oconee","2020-06-09","32","1271","0","65","1.6","1.6"
"Oconee","2020-06-10","28","1299","0","65","0.7","1.6"
"Oconee","2020-06-11","30","1329","0","65","0.7","1.6"
"Oconee","2020-06-12","44","1373","1","66","0.8","1.3"
"Oconee","2020-06-13","11","1384","1","67","2.1","2"
"Oconee","2020-06-14","10","1394","0","67","2.1","2"
"Oconee","2020-06-15","41","1435","2","69","2.3","2.3"
"Oconee","2020-06-16","31","1466","1","70","2.8","2.2"
"Oconee","2020-06-17","34","1500","1","71","3.2","2"
"Oconee","2020-06-18","46","1546","3","74","4.1","2.4"
"Oconee","2020-06-19","25","1571","0","74","3.8","2.3"
"Oconee","2020-06-20","17","1588","1","75","3.3","2.7"
"Oconee","2020-06-21","13","1601","0","75","3.3","2.7"
"Oconee","2020-06-22","82","1683","3","78","3.2","2.7"
"Oconee","2020-06-23","45","1728","5","83","4.3","3.5"
"Oconee","2020-06-24","55","1783","4","87","4.9","4.1"
"Oconee","2020-06-25","76","1859","8","95","5.5","4.8"
"Oconee","2020-06-26","66","1925","6","101","6.8","5.3"
"Oconee","2020-06-27","53","1978","6","107","7.6","5.5"
"Oconee","2020-06-28","35","2013","6","113","10","6.7"
"Oconee","2020-06-29","85","2098","11","124","11.3","7.3"
"Oconee","2020-06-30","65","2163","8","132","11.5","7.9"
"Oconee","2020-07-01","59","2222","6","138","11.9","8.4"
"Oconee","2020-07-02","87","2309","14","152","12.7","9.1"
"Oconee","2020-07-03","48","2357","5","157","12.9","9.9"
"Oconee","2020-07-04","7","2364","0","157","11.3","9.4"
"Oconee","2020-07-05","29","2393","2","159","9.8","9.9"
"Oconee","2020-07-06","95","2488","13","172","9.9","10.6"
"Oconee","2020-07-07","68","2556","9","181","10.1","10.8"
"Oconee","2020-07-08","56","2612","7","188","10.4","11.2"
"Oconee","2020-07-09","81","2693","13","201","10.4","11.6"
"Oconee","2020-07-10","77","2770","4","205","9.7","11.3"
"Oconee","2020-07-11","15","2785","1","206","10.6","10.9"
"Oconee","2020-07-12","16","2801","5","211","14.1","12"
"Oconee","2020-07-13","52","2853","7","218","14.1","12"
"Oconee","2020-07-14","44","2897","8","226","14.8","12.4"
"Oconee","2020-07-15","54","2951","8","234","15.1","12.7"
"Oconee","2020-07-16","65","3016","7","241","14.3","12.4"
"Oconee","2020-07-17","49","3065","5","246","15","12.4"
"Oconee","2020-07-18","26","3091","2","248","15.2","12.9"
"Oconee","2020-07-19","29","3120","4","252","12.7","13.4"
"Oconee","2020-07-20","67","3187","11","263","13.1","13.6"
"Oconee","2020-07-21","44","3231","3","266","11.5","13.1"
"Oconee","2020-07-22","46","3277","3","269","10.3","12.7"
"Oconee","2020-07-23","56","3333","13","282","12.1","13.2"
"Oconee","2020-07-24","47","3380","4","286","11.9","13.5"
"Oconee","2020-07-25","26","3406","5","291","13.5","14.3"
"Oconee","2020-07-26","12","3418","4","295","16.3","14.5"
"Oconee","2020-07-27","47","3465","6","301","15.8","14.4"
"Oconee","2020-07-28","59","3524","6","307","16.2","13.9"
"Oconee","2020-07-29","48","3572","6","313","17.1","13.7"
"Oconee","2020-07-30","43","3615","4","317","15.1","13.6"
"Oconee","2020-07-31","49","3664","4","321","15.1","13.5"
"Oconee","2020-08-01","17","3681","3","324","14.8","14.2"
"Oconee","2020-08-02","14","3695","1","325","11.1","13.7"
"Oconee","2020-08-03","40","3735","7","332","11.8","13.8"
"Oconee","2020-08-04","52","3787","6","338","12","14.1"
"Oconee","2020-08-05","42","3829","3","341","11.2","14.2"
"Oconee","2020-08-06","53","3882","4","345","11","13"
"Oconee","2020-08-07","63","3945","4","349","10.7","12.9"
"Oconee","2020-08-08","22","3967","1","350","8.8","11.8"
"Oconee","2020-08-09","24","3991","1","351","8.4","9.7"
"Oconee","2020-08-10","59","4050","1","352","6.1","9"
"Oconee","2020-08-11","73","4123","5","357","5.5","8.7"
"Oconee","2020-08-12","57","4180","5","362","5.7","8.5"
"Oconee","2020-08-13","57","4237","1","363","4.9","7.9"
"Oconee","2020-08-14","49","4286","2","365","4.6","7.6"
"Oconee","2020-08-15","18","4304","2","367","5.5","7.2"
"Oconee","2020-08-16","24","4328","2","369","6.1","7.2"
"Oconee","2020-08-17","63","4391","6","375","7.2","6.7"
"Oconee","2020-08-18","94","4485","9","384","7.6","6.5"
"Oconee","2020-08-19","103","4588","10","394","7.7","6.7"
"Oconee","2020-08-20","92","4680","7","401","8.6","6.7"
"Oconee","2020-08-21","119","4799","8","409","8.9","6.7"
"Oconee","2020-08-22","36","4835","4","413","8.9","7.2"
"Oconee","2020-08-23","22","4857","3","416","9.7","7.9"
"Oconee","2020-08-24","90","4947","3","419","8.8","8"
"Oconee","2020-08-25","85","5032","1","420","7.6","7.6"
"Oconee","2020-08-26","87","5119","6","426","7.2","7.5"
"Oconee","2020-08-27","80","5199","4","430","6.8","7.7"
"Oconee","2020-08-28","99","5298","8","438","7","8"
"Oconee","2020-08-29","44","5342","4","442","6.7","7.8"
"Oconee","2020-08-30","31","5373","3","445","6.2","7.9"
"Oconee","2020-08-31","80","5453","13","458","8","8.4"
"Oconee","2020-09-01","94","5547","10","468","9.4","8.5"
"Oconee","2020-09-02","90","5637","11","479","10.1","8.7"
"Oconee","2020-09-03","70","5707","5","484","10.4","8.6"
"Oconee","2020-09-04","98","5805","9","493","10.6","8.8"
"Oconee","2020-09-05","42","5847","2","495","10","8.4"
"Oconee","2020-09-06","12","5859","4","499","13.4","9.8"
"Oconee","2020-09-07","26","5885","0","499","11","9.5"
"Oconee","2020-09-08","99","5984","9","508","10.8","10.1"
"Oconee","2020-09-09","81","6065","5","513","10","10"
"Oconee","2020-09-10","98","6163","10","523","10.4","10.4"
"Oconee","2020-09-11","83","6246","4","527","9.8","10.2"
"Oconee","2020-09-12","21","6267","2","529","10.4","10.2"
"Oconee","2020-09-13","26","6293","2","531","6.8","10.1"
"Oconee","2020-09-14","68","6361","8","539","8.5","9.8"
"Oconee","2020-09-15","90","6451","8","547","8.4","9.6"
"Oconee","2020-09-16","52","6503","2","549","8.1","9"
"Oconee","2020-09-17","66","6569","2","551","7.1","8.7"
"Oconee","2020-09-18","56","6625","2","553","6.9","8.3"
"Oconee","2020-09-19","36","6661","1","554","5.9","8.2"
"Oconee","2020-09-20","14","6675","2","556","6.9","6.8"
"Oconee","2020-09-21","66","6741","6","562","6.5","7.5"
"Oconee","2020-09-22","50","6791","3","565","6.1","7.3"
"Oconee","2020-09-23","52","6843","1","566","5.8","7"
"Oconee","2020-09-24","44","6887","3","569","6.4","6.7"
"Oconee","2020-09-25","64","6951","7","576","7.4","7.2"
"Oconee","2020-09-26","15","6966","3","579","9.9","7.9"
"Oconee","2020-09-27","23","6989","3","582","9.7","8.3"
"Oconee","2020-09-28","114","7103","10","592","9.6","8.1"
"Oconee","2020-09-29","107","7210","2","594","9.1","7.6"
"Oconee","2020-09-30","85","7295","1","595","8.9","7.4"
"Oconee","2020-10-01","112","7407","9","604","9.1","7.7"
"Oconee","2020-10-02","92","7499","3","607","8","7.7"
"Oconee","2020-10-03","31","7530","6","613","7.9","8.9"
"Oconee","2020-10-04","21","7551","3","616","8.1","8.9"
"Oconee","2020-10-05","78","7629","6","622","8","8.8"
"Oconee","2020-10-06","107","7736","3","625","8.1","8.6"
"Oconee","2020-10-07","70","7806","2","627","8.3","8.6"
"Oconee","2020-10-08","77","7883","2","629","7.6","8.3"
"Oconee","2020-10-09","65","7948","2","631","7.5","7.8"
"Oconee","2020-10-10","29","7977","2","633","5.7","6.8"
"Oconee","2020-10-11","22","7999","2","635","5","6.6"
"Oconee","2020-10-12","67","8066","3","638","4.5","6.2"
"Oconee","2020-10-13","68","8134","3","641","4.8","6.4"
"Oconee","2020-10-14","72","8206","5","646","5.4","6.8"
"Oconee","2020-10-15","62","8268","6","652","6.4","7"
"Oconee","2020-10-16","57","8325","5","657","7.2","7.4"
"Oconee","2020-10-17","36","8361","3","660","7.4","6.6"
"Oconee","2020-10-18","10","8371","1","661","7.5","6.3"
"Oconee","2020-10-19","84","8455","8","669","8.2","6.4"
"Oconee","2020-10-20","76","8531","4","673","8.4","6.6"
"Oconee","2020-10-21","89","8620","3","676","7.8","6.6"
"Oconee","2020-10-22","55","8675","5","681","7.8","7.1"
"Oconee","2020-10-23","37","8712","1","682","6.9","7"
"Oconee","2020-10-24","30","8742","0","682","5.7","6.5"
"Oconee","2020-10-25","20","8762","2","684","5.7","6.6"
"Oconee","2020-10-26","68","8830","3","687","5","6.6"
"Oconee","2020-10-27","72","8902","1","688","4.4","6.4"
"Oconee","2020-10-28","63","8965","0","688","3.9","5.9"
"Oconee","2020-10-29","51","9016","3","691","3.5","5.6"
"Oconee","2020-10-30","60","9076","4","695","4","5.5"
"Oconee","2020-10-31","23","9099","2","697","5.3","5.5"
"Oconee","2020-11-01","24","9123","3","700","5.6","5.7"
"Oconee","2020-11-02","72","9195","6","706","6.2","5.6"
"Oconee","2020-11-03","62","9257","1","707","6.2","5.3"
"Oconee","2020-11-04","74","9331","3","710","6.8","5.4"
"Oconee","2020-11-05","78","9409","3","713","6.5","5"
"Oconee","2020-11-06","57","9466","6","719","7.1","5.6"
"Oconee","2020-11-07","26","9492","4","723","8","6.7"
"Oconee","2020-11-08","16","9508","0","723","6.3","6"
"Oconee","2020-11-09","84","9592","10","733","6.8","6.5"
"Oconee","2020-11-10","83","9675","5","738","7.4","6.8"
"Oconee","2020-11-11","91","9766","7","745","7.9","7.4"
"Oconee","2020-11-12","81","9847","2","747","7.7","7.1"
"Oconee","2020-11-13","65","9912","5","752","7.3","7.2"
"Oconee","2020-11-14","31","9943","4","756","7","7.5"
"Oconee","2020-11-15","19","9962","1","757","7.7","7"
"Oconee","2020-11-16","81","10043","4","761","6.7","6.7"
"Oconee","2020-11-17","85","10128","4","765","6.5","7"
"Oconee","2020-11-18","108","10236","4","769","6","6.9"
"Oconee","2020-11-19","141","10377","9","778","6.5","7.1"
"Oconee","2020-11-20","164","10541","4","782","5.8","6.5"
"Oconee","2020-11-21","58","10599","4","786","4.9","5.9"
"Oconee","2020-11-22","48","10647","4","790","5.3","6.5"
"Oconee","2020-11-23","124","10771","9","799","5.7","6.2"
"Oconee","2020-11-24","115","10886","9","808","6.1","6.3"
"Oconee","2020-11-25","89","10975","10","818","7.2","6.6"
"Oconee","2020-11-26","15","10990","4","822","10.1","8.3"
"Oconee","2020-11-27","74","11064","13","835","12.3","9"
"Oconee","2020-11-28","44","11108","7","842","13.5","9.2"
"Oconee","2020-11-29","40","11148","4","846","13.8","9.6"
"Oconee","2020-11-30","106","11254","14","860","14.6","10.2"
"Oconee","2020-12-01","99","11353","8","868","14.7","10.4"
"Oconee","2020-12-02","143","11496","14","882","14.5","10.8"
"Oconee","2020-12-03","109","11605","7","889","11.6","10.8"
"Oconee","2020-12-04","108","11713","17","906","11.3","11.8"
"Oconee","2020-12-05","61","11774","8","914","10.9","12.2"
"Oconee","2020-12-06","34","11808","1","915","9.9","11.8"
"Oconee","2020-12-07","133","11941","16","931","9.7","12.2"
"Oconee","2020-12-08","129","12070","10","941","9.7","12.2"
"Oconee","2020-12-09","118","12188","22","963","10.9","12.7"
"Oconee","2020-12-10","118","12306","10","973","11.2","11.4"
"Oconee","2020-12-11","139","12445","25","998","11.6","11.4"
"Oconee","2020-12-12","87","12532","14","1012","12","11.4"
"Oconee","2020-12-13","35","12567","9","1021","15.2","12.6"
"Oconee","2020-12-14","138","12705","16","1037","15.2","12.5"
"Oconee","2020-12-15","164","12869","26","1063","16.3","13"
"Oconee","2020-12-16","147","13016","24","1087","16","13.5"
"Oconee","2020-12-17","160","13176","36","1123","18","14.6"
"Oconee","2020-12-18","176","13352","22","1145","17.2","14.4"
"Oconee","2020-12-19","88","13440","23","1168","18.7","15.3"
"Oconee","2020-12-20","78","13518","21","1189","18.8","17"
"Oconee","2020-12-21","187","13705","37","1226","20","17.6"
"Oconee","2020-12-22","204","13909","36","1262","20.3","18.3"
"Oconee","2020-12-23","200","14109","41","1303","20.9","18.4"
"Oconee","2020-12-24","124","14233","34","1337","21.6","19.8"
"Oconee","2020-12-25","7","14240","3","1340","25.9","21.6"
"Oconee","2020-12-26","131","14371","31","1371","25.5","22.1"
"Oconee","2020-12-27","76","14447","22","1393","25.8","22.3"
"Oconee","2020-12-28","174","14621","50","1443","27.1","23.6"
"Oconee","2020-12-29","162","14783","51","1494","29.1","24.7"
"Oconee","2020-12-30","152","14935","42","1536","30.1","25.5"
"Oconee","2020-12-31","128","15063","36","1572","30.2","25.9"
"Oconee","2021-01-01","58","15121","16","1588","28","27"
"Oconee","2021-01-02","63","15184","21","1609","29.4","27.5"
"Oconee","2021-01-03","70","15254","26","1635","30.6","28.2"
"Oconee","2021-01-04","146","15400","28","1663","29.2","28.2"
"Oconee","2021-01-05","156","15556","43","1706","28.7","28.9"
"Oconee","2021-01-06","243","15799","46","1752","27.4","28.8"
"Oconee","2021-01-07","197","15996","39","1791","26.2","28.2"
"Oconee","2021-01-08","163","16159","31","1822","25","26.5"
"Oconee","2021-01-09","101","16260","32","1854","24.8","27.1"
"Oconee","2021-01-10","94","16354","21","1875","22.6","26.6"
"Oconee","2021-01-11","195","16549","38","1913","22.7","25.9"
"Oconee","2021-01-12","174","16723","30","1943","21.2","24.9"
"Oconee","2021-01-13","152","16875","25","1968","20.9","24.1"
"Oconee","2021-01-14","163","17038","29","1997","20.6","23.4"
"Oconee","2021-01-15","133","17171","25","2022","20.5","22.8"
"Oconee","2021-01-16","68","17239","9","2031","17.9","21.3"
"Oconee","2021-01-17","71","17310","13","2044","17.3","20"
"Oconee","2021-01-18","108","17418","13","2057","16.3","19.5"
"Oconee","2021-01-19","141","17559","22","2079","16","18.6"
"Oconee","2021-01-20","141","17700","21","2100","15.8","18.3"
"Oconee","2021-01-21","150","17850","19","2119","15.1","17.8"
"Oconee","2021-01-22","116","17966","13","2132","14","17.3"
"Oconee","2021-01-23","74","18040","18","2150","15.6","16.7"
"Oconee","2021-01-24","59","18099","6","2156","14.4","15.9"
"Oconee","2021-01-25","140","18239","17","2173","14.4","15.3"
"Oconee","2021-01-26","145","18384","19","2192","14.1","15.1"
"Oconee","2021-01-27","151","18535","16","2208","13.5","14.6"
"Oconee","2021-01-28","116","18651","18","2226","13.9","14.5"
"Oconee","2021-01-29","128","18779","12","2238","13.6","13.8"
"Oconee","2021-01-30","61","18840","7","2245","11.8","13.7"
"Oconee","2021-01-31","50","18890","9","2254","12.9","13.7"
"Oconee","2021-02-01","139","19029","12","2266","12.4","13.4"
"Oconee","2021-02-02","125","19154","9","2275","11.5","12.8"
"Oconee","2021-02-03","99","19253","11","2286","11.6","12.5"
"Oconee","2021-02-04","86","19339","6","2292","10.4","12.1"
"Oconee","2021-02-05","56","19395","11","2303","11.9","12.7"
"Oconee","2021-02-06","28","19423","5","2308","12.8","12.3"
"Oconee","2021-02-07","3","19426","0","2308","10.2","11.5"
"Oconee","2021-02-08","0","19426","0","2308","9","10.7"
"Oglethorpe","2020-02-01","0","0","0","0",".","."
"Oglethorpe","2020-02-02","0","0","0","0",".","."
"Oglethorpe","2020-02-03","0","0","0","0",".","."
"Oglethorpe","2020-02-04","0","0","0","0",".","."
"Oglethorpe","2020-02-05","0","0","0","0",".","."
"Oglethorpe","2020-02-06","0","0","0","0",".","."
"Oglethorpe","2020-02-07","0","0","0","0","0","."
"Oglethorpe","2020-02-08","0","0","0","0","0","."
"Oglethorpe","2020-02-09","0","0","0","0","0","."
"Oglethorpe","2020-02-10","0","0","0","0","0","."
"Oglethorpe","2020-02-11","0","0","0","0","0","."
"Oglethorpe","2020-02-12","0","0","0","0","0","."
"Oglethorpe","2020-02-13","0","0","0","0","0","."
"Oglethorpe","2020-02-14","0","0","0","0","0","0"
"Oglethorpe","2020-02-15","0","0","0","0","0","0"
"Oglethorpe","2020-02-16","0","0","0","0","0","0"
"Oglethorpe","2020-02-17","0","0","0","0","0","0"
"Oglethorpe","2020-02-18","0","0","0","0","0","0"
"Oglethorpe","2020-02-19","0","0","0","0","0","0"
"Oglethorpe","2020-02-20","0","0","0","0","0","0"
"Oglethorpe","2020-02-21","0","0","0","0","0","0"
"Oglethorpe","2020-02-22","0","0","0","0","0","0"
"Oglethorpe","2020-02-23","0","0","0","0","0","0"
"Oglethorpe","2020-02-24","0","0","0","0","0","0"
"Oglethorpe","2020-02-25","0","0","0","0","0","0"
"Oglethorpe","2020-02-26","0","0","0","0","0","0"
"Oglethorpe","2020-02-27","0","0","0","0","0","0"
"Oglethorpe","2020-02-28","0","0","0","0","0","0"
"Oglethorpe","2020-02-29","0","0","0","0","0","0"
"Oglethorpe","2020-03-01","0","0","0","0","0","0"
"Oglethorpe","2020-03-02","0","0","0","0","0","0"
"Oglethorpe","2020-03-03","0","0","0","0","0","0"
"Oglethorpe","2020-03-04","0","0","0","0","0","0"
"Oglethorpe","2020-03-05","0","0","0","0","0","0"
"Oglethorpe","2020-03-06","0","0","0","0","0","0"
"Oglethorpe","2020-03-07","0","0","0","0","0","0"
"Oglethorpe","2020-03-08","0","0","0","0","0","0"
"Oglethorpe","2020-03-09","0","0","0","0","0","0"
"Oglethorpe","2020-03-10","0","0","0","0","0","0"
"Oglethorpe","2020-03-11","0","0","0","0","0","0"
"Oglethorpe","2020-03-12","0","0","0","0","0","0"
"Oglethorpe","2020-03-13","0","0","0","0","0","0"
"Oglethorpe","2020-03-14","0","0","0","0","0","0"
"Oglethorpe","2020-03-15","0","0","0","0","0","0"
"Oglethorpe","2020-03-16","1","1","0","0","0","0"
"Oglethorpe","2020-03-17","0","1","0","0","0","0"
"Oglethorpe","2020-03-18","3","4","0","0","0","0"
"Oglethorpe","2020-03-19","4","8","0","0","0","0"
"Oglethorpe","2020-03-20","5","13","0","0","0","0"
"Oglethorpe","2020-03-21","1","14","0","0","0","0"
"Oglethorpe","2020-03-22","2","16","1","1","7.1","3.6"
"Oglethorpe","2020-03-23","2","18","0","1","7.1","3.6"
"Oglethorpe","2020-03-24","7","25","0","1","7.1","3.6"
"Oglethorpe","2020-03-25","12","37","0","1","7.1","3.6"
"Oglethorpe","2020-03-26","3","40","0","1","7.1","3.6"
"Oglethorpe","2020-03-27","3","43","0","1","7.1","3.6"
"Oglethorpe","2020-03-28","1","44","0","1","7.1","3.6"
"Oglethorpe","2020-03-29","0","44","0","1","0","3.6"
"Oglethorpe","2020-03-30","0","44","0","1","0","3.6"
"Oglethorpe","2020-03-31","4","48","0","1","0","3.6"
"Oglethorpe","2020-04-01","7","55","0","1","0","3.6"
"Oglethorpe","2020-04-02","2","57","0","1","0","3.6"
"Oglethorpe","2020-04-03","3","60","0","1","0","3.6"
"Oglethorpe","2020-04-04","1","61","0","1","0","3.6"
"Oglethorpe","2020-04-05","0","61","0","1","0","0"
"Oglethorpe","2020-04-06","2","63","1","2","7.1","3.6"
"Oglethorpe","2020-04-07","2","65","0","2","7.1","3.6"
"Oglethorpe","2020-04-08","4","69","0","2","7.1","3.6"
"Oglethorpe","2020-04-09","4","73","2","4","14.3","7.1"
"Oglethorpe","2020-04-10","1","74","0","4","14.3","7.1"
"Oglethorpe","2020-04-11","0","74","0","4","14.3","7.1"
"Oglethorpe","2020-04-12","2","76","0","4","14.3","7.1"
"Oglethorpe","2020-04-13","2","78","0","4","7.1","7.1"
"Oglethorpe","2020-04-14","6","84","0","4","7.1","7.1"
"Oglethorpe","2020-04-15","4","88","0","4","7.1","7.1"
"Oglethorpe","2020-04-16","7","95","0","4","0","7.1"
"Oglethorpe","2020-04-17","5","100","0","4","0","7.1"
"Oglethorpe","2020-04-18","0","100","0","4","0","7.1"
"Oglethorpe","2020-04-19","2","102","1","5","7.1","10.7"
"Oglethorpe","2020-04-20","4","106","0","5","7.1","7.1"
"Oglethorpe","2020-04-21","12","118","3","8","10.7","8.9"
"Oglethorpe","2020-04-22","12","130","0","8","10.7","8.9"
"Oglethorpe","2020-04-23","7","137","0","8","10.7","5.4"
"Oglethorpe","2020-04-24","0","137","0","8","10.7","5.4"
"Oglethorpe","2020-04-25","2","139","0","8","10.7","5.4"
"Oglethorpe","2020-04-26","1","140","0","8","3.6","5.4"
"Oglethorpe","2020-04-27","7","147","0","8","3.6","5.4"
"Oglethorpe","2020-04-28","10","157","1","9","1.4","6.1"
"Oglethorpe","2020-04-29","10","167","0","9","1.4","6.1"
"Oglethorpe","2020-04-30","6","173","0","9","1.4","6.1"
"Oglethorpe","2020-05-01","8","181","0","9","1.4","6.1"
"Oglethorpe","2020-05-02","3","184","0","9","1.4","6.1"
"Oglethorpe","2020-05-03","1","185","0","9","1.4","2.5"
"Oglethorpe","2020-05-04","6","191","1","10","3.8","3.7"
"Oglethorpe","2020-05-05","10","201","0","10","2.4","1.9"
"Oglethorpe","2020-05-06","16","217","0","10","2.4","1.9"
"Oglethorpe","2020-05-07","9","226","0","10","2.4","1.9"
"Oglethorpe","2020-05-08","8","234","0","10","2.4","1.9"
"Oglethorpe","2020-05-09","0","234","0","10","2.4","1.9"
"Oglethorpe","2020-05-10","1","235","0","10","2.4","1.9"
"Oglethorpe","2020-05-11","11","246","0","10","0","1.9"
"Oglethorpe","2020-05-12","6","252","0","10","0","1.2"
"Oglethorpe","2020-05-13","15","267","0","10","0","1.2"
"Oglethorpe","2020-05-14","12","279","1","11","1.2","1.8"
"Oglethorpe","2020-05-15","12","291","0","11","1.2","1.8"
"Oglethorpe","2020-05-16","5","296","0","11","1.2","1.8"
"Oglethorpe","2020-05-17","4","300","1","12","4.8","3.6"
"Oglethorpe","2020-05-18","9","309","0","12","4.8","2.4"
"Oglethorpe","2020-05-19","17","326","0","12","4.8","2.4"
"Oglethorpe","2020-05-20","7","333","0","12","4.8","2.4"
"Oglethorpe","2020-05-21","8","341","0","12","3.6","2.4"
"Oglethorpe","2020-05-22","5","346","0","12","3.6","2.4"
"Oglethorpe","2020-05-23","11","357","1","13","4.9","3"
"Oglethorpe","2020-05-24","2","359","0","13","1.3","3"
"Oglethorpe","2020-05-25","2","361","0","13","1.3","3"
"Oglethorpe","2020-05-26","14","375","2","15","3.3","4.1"
"Oglethorpe","2020-05-27","12","387","0","15","3.3","4.1"
"Oglethorpe","2020-05-28","13","400","2","17","5.5","4.6"
"Oglethorpe","2020-05-29","7","407","0","17","5.5","4.6"
"Oglethorpe","2020-05-30","0","407","0","17","4.2","4.6"
"Oglethorpe","2020-05-31","9","416","0","17","4.2","2.8"
"Oglethorpe","2020-06-01","8","424","3","20","9.6","5.4"
"Oglethorpe","2020-06-02","7","431","0","20","7.6","5.4"
"Oglethorpe","2020-06-03","14","445","0","20","7.6","5.4"
"Oglethorpe","2020-06-04","11","456","1","21","6.7","6.1"
"Oglethorpe","2020-06-05","13","469","1","22","7.8","6.6"
"Oglethorpe","2020-06-06","2","471","0","22","7.8","6"
"Oglethorpe","2020-06-07","6","477","0","22","7.8","6"
"Oglethorpe","2020-06-08","11","488","0","22","2.4","6"
"Oglethorpe","2020-06-09","23","511","2","24","3.6","5.6"
"Oglethorpe","2020-06-10","15","526","0","24","3.6","5.6"
"Oglethorpe","2020-06-11","21","547","3","27","4.4","5.5"
"Oglethorpe","2020-06-12","11","558","0","27","3.3","5.5"
"Oglethorpe","2020-06-13","10","568","2","29","6.1","6.9"
"Oglethorpe","2020-06-14","3","571","0","29","6.1","6.9"
"Oglethorpe","2020-06-15","11","582","2","31","8.7","5.6"
"Oglethorpe","2020-06-16","18","600","3","34","9.9","6.8"
"Oglethorpe","2020-06-17","14","614","2","36","11.9","7.8"
"Oglethorpe","2020-06-18","12","626","3","39","13.4","8.9"
"Oglethorpe","2020-06-19","13","639","2","41","15.6","9.5"
"Oglethorpe","2020-06-20","4","643","0","41","12.8","9.5"
"Oglethorpe","2020-06-21","4","647","0","41","12.8","9.5"
"Oglethorpe","2020-06-22","16","663","0","41","10.2","9.5"
"Oglethorpe","2020-06-23","18","681","2","43","9.4","9.6"
"Oglethorpe","2020-06-24","20","701","2","45","8.8","10.4"
"Oglethorpe","2020-06-25","13","714","0","45","5.2","9.3"
"Oglethorpe","2020-06-26","18","732","1","46","3.8","9.7"
"Oglethorpe","2020-06-27","11","743","1","47","5.1","8.9"
"Oglethorpe","2020-06-28","4","747","1","48","8.7","10.7"
"Oglethorpe","2020-06-29","18","765","0","48","8.7","9.4"
"Oglethorpe","2020-06-30","19","784","1","49","7.8","8.6"
"Oglethorpe","2020-07-01","25","809","3","52","8.1","8.5"
"Oglethorpe","2020-07-02","17","826","2","54","9.8","7.5"
"Oglethorpe","2020-07-03","20","846","4","58","11.9","7.8"
"Oglethorpe","2020-07-04","8","854","1","59","12.4","8.7"
"Oglethorpe","2020-07-05","12","866","0","59","8.8","8.7"
"Oglethorpe","2020-07-06","28","894","6","65","11.9","10.3"
"Oglethorpe","2020-07-07","31","925","8","73","14.8","11.3"
"Oglethorpe","2020-07-08","16","941","3","76","15.7","11.9"
"Oglethorpe","2020-07-09","46","987","8","84","16.6","13.2"
"Oglethorpe","2020-07-10","31","1018","8","92","17.4","14.6"
"Oglethorpe","2020-07-11","14","1032","7","99","22.7","17.6"
"Oglethorpe","2020-07-12","6","1038","1","100","25.1","17"
"Oglethorpe","2020-07-13","19","1057","4","104","25.1","18.5"
"Oglethorpe","2020-07-14","25","1082","3","107","23.1","18.9"
"Oglethorpe","2020-07-15","21","1103","0","107","20.4","18.1"
"Oglethorpe","2020-07-16","18","1121","2","109","19.5","18"
"Oglethorpe","2020-07-17","16","1137","0","109","15.8","16.6"
"Oglethorpe","2020-07-18","6","1143","1","110","11.1","16.9"
"Oglethorpe","2020-07-19","9","1152","2","112","11.9","18.5"
"Oglethorpe","2020-07-20","22","1174","5","117","12.1","18.6"
"Oglethorpe","2020-07-21","20","1194","3","120","12.5","17.8"
"Oglethorpe","2020-07-22","14","1208","1","121","13.6","17"
"Oglethorpe","2020-07-23","22","1230","1","122","12.6","16.1"
"Oglethorpe","2020-07-24","14","1244","2","124","14.7","15.2"
"Oglethorpe","2020-07-25","13","1257","2","126","14.5","12.8"
"Oglethorpe","2020-07-26","12","1269","1","127","12.5","12.2"
"Oglethorpe","2020-07-27","13","1282","1","128","10.3","11.2"
"Oglethorpe","2020-07-28","24","1306","7","135","12.4","12.4"
"Oglethorpe","2020-07-29","25","1331","4","139","13.6","13.6"
"Oglethorpe","2020-07-30","9","1340","2","141","16.2","14.4"
"Oglethorpe","2020-07-31","14","1354","2","143","16.2","15.4"
"Oglethorpe","2020-08-01","10","1364","4","147","19.7","17.1"
"Oglethorpe","2020-08-02","9","1373","1","148","20.1","16.3"
"Oglethorpe","2020-08-03","22","1395","4","152","21.6","16"
"Oglethorpe","2020-08-04","26","1421","3","155","19","15.7"
"Oglethorpe","2020-08-05","23","1444","3","158","18.6","16.1"
"Oglethorpe","2020-08-06","31","1475","7","165","18.7","17.4"
"Oglethorpe","2020-08-07","20","1495","3","168","18.8","17.5"
"Oglethorpe","2020-08-08","8","1503","1","169","14.9","17.3"
"Oglethorpe","2020-08-09","6","1509","3","172","20.4","20.2"
"Oglethorpe","2020-08-10","18","1527","4","176","21","21.3"
"Oglethorpe","2020-08-11","20","1547","5","181","22.9","21"
"Oglethorpe","2020-08-12","19","1566","1","182","21.8","20.2"
"Oglethorpe","2020-08-13","20","1586","3","185","20.7","19.7"
"Oglethorpe","2020-08-14","20","1606","2","187","20","19.4"
"Oglethorpe","2020-08-15","6","1612","0","187","18.2","16.5"
"Oglethorpe","2020-08-16","12","1624","1","188","12.3","16.3"
"Oglethorpe","2020-08-17","29","1653","2","190","10.1","15.5"
"Oglethorpe","2020-08-18","19","1672","0","190","6.5","14.7"
"Oglethorpe","2020-08-19","18","1690","3","193","8.1","15"
"Oglethorpe","2020-08-20","25","1715","1","194","6.6","13.6"
"Oglethorpe","2020-08-21","28","1743","1","195","5.6","12.8"
"Oglethorpe","2020-08-22","8","1751","1","196","7.4","12.8"
"Oglethorpe","2020-08-23","9","1760","0","196","6.2","9.2"
"Oglethorpe","2020-08-24","31","1791","2","198","6.2","8.1"
"Oglethorpe","2020-08-25","20","1811","1","199","6.9","6.7"
"Oglethorpe","2020-08-26","24","1835","0","199","4.5","6.3"
"Oglethorpe","2020-08-27","25","1860","3","202","5.6","6.1"
"Oglethorpe","2020-08-28","20","1880","2","204","6.6","6.1"
"Oglethorpe","2020-08-29","17","1897","2","206","6.5","6.9"
"Oglethorpe","2020-08-30","4","1901","0","206","6.5","6.3"
"Oglethorpe","2020-08-31","24","1925","1","207","6.1","6.2"
"Oglethorpe","2020-09-01","18","1943","3","210","7.8","7.3"
"Oglethorpe","2020-09-02","23","1966","3","213","9.7","7.1"
"Oglethorpe","2020-09-03","23","1989","1","214","8.6","7.1"
"Oglethorpe","2020-09-04","17","2006","1","215","8","7.3"
"Oglethorpe","2020-09-05","10","2016","1","216","7.7","7.1"
"Oglethorpe","2020-09-06","8","2024","0","216","7.7","7.1"
"Oglethorpe","2020-09-07","4","2028","0","216","7.1","6.6"
"Oglethorpe","2020-09-08","22","2050","3","219","6.7","7.3"
"Oglethorpe","2020-09-09","23","2073","1","220","5.5","7.6"
"Oglethorpe","2020-09-10","31","2104","2","222","5.8","7.2"
"Oglethorpe","2020-09-11","17","2121","1","223","5.8","6.9"
"Oglethorpe","2020-09-12","9","2130","0","223","4.3","6"
"Oglethorpe","2020-09-13","10","2140","0","223","4.3","6"
"Oglethorpe","2020-09-14","21","2161","0","223","4.3","5.7"
"Oglethorpe","2020-09-15","36","2197","1","224","2.8","4.7"
"Oglethorpe","2020-09-16","20","2217","2","226","3.6","4.5"
"Oglethorpe","2020-09-17","30","2247","2","228","3.6","4.7"
"Oglethorpe","2020-09-18","18","2265","2","230","4.4","5.1"
"Oglethorpe","2020-09-19","15","2280","1","231","5.3","4.8"
"Oglethorpe","2020-09-20","2","2282","0","231","5.3","4.8"
"Oglethorpe","2020-09-21","20","2302","2","233","6.7","5.5"
"Oglethorpe","2020-09-22","23","2325","0","233","6.3","4.6"
"Oglethorpe","2020-09-23","8","2333","1","234","6.7","5.1"
"Oglethorpe","2020-09-24","15","2348","0","234","5.8","4.7"
"Oglethorpe","2020-09-25","26","2374","0","234","4.2","4.3"
"Oglethorpe","2020-09-26","5","2379","0","234","3.2","4.3"
"Oglethorpe","2020-09-27","8","2387","2","236","6.8","6.1"
"Oglethorpe","2020-09-28","18","2405","2","238","6.9","6.8"
"Oglethorpe","2020-09-29","13","2418","2","240","9.1","7.7"
"Oglethorpe","2020-09-30","13","2431","1","241","8.5","7.6"
"Oglethorpe","2020-10-01","12","2443","1","242","9.6","7.7"
"Oglethorpe","2020-10-02","21","2464","1","243","10.3","7.2"
"Oglethorpe","2020-10-03","7","2471","2","245","14.4","8.8"
"Oglethorpe","2020-10-04","5","2476","1","246","13.7","10.2"
"Oglethorpe","2020-10-05","32","2508","6","252","14.8","10.9"
"Oglethorpe","2020-10-06","20","2528","2","254","14","11.6"
"Oglethorpe","2020-10-07","27","2555","5","259","15.6","12"
"Oglethorpe","2020-10-08","13","2568","2","261","16.6","13.1"
"Oglethorpe","2020-10-09","22","2590","0","261","15.9","13.1"
"Oglethorpe","2020-10-10","4","2594","1","262","15.4","14.9"
"Oglethorpe","2020-10-11","7","2601","2","264","16.6","15.1"
"Oglethorpe","2020-10-12","16","2617","1","265","14.8","14.8"
"Oglethorpe","2020-10-13","21","2638","3","268","15.4","14.7"
"Oglethorpe","2020-10-14","16","2654","2","270","14.6","15.1"
"Oglethorpe","2020-10-15","25","2679","4","274","14.7","15.6"
"Oglethorpe","2020-10-16","17","2696","2","276","16.3","16.1"
"Oglethorpe","2020-10-17","7","2703","1","277","14.8","15.1"
"Oglethorpe","2020-10-18","3","2706","1","278","15.5","16"
"Oglethorpe","2020-10-19","24","2730","3","281","16.4","15.6"
"Oglethorpe","2020-10-20","17","2747","2","283","16","15.7"
"Oglethorpe","2020-10-21","22","2769","6","289","18.1","16.4"
"Oglethorpe","2020-10-22","26","2795","3","292","17.5","16.1"
"Oglethorpe","2020-10-23","18","2813","2","294","17.4","16.9"
"Oglethorpe","2020-10-24","4","2817","0","294","15.4","15.1"
"Oglethorpe","2020-10-25","3","2820","2","296","20.1","17.8"
"Oglethorpe","2020-10-26","29","2849","5","301","20.8","18.6"
"Oglethorpe","2020-10-27","23","2872","3","304","21","18.5"
"Oglethorpe","2020-10-28","22","2894","2","306","18.4","18.3"
"Oglethorpe","2020-10-29","29","2923","3","309","18.2","17.9"
"Oglethorpe","2020-10-30","31","2954","4","313","18.5","17.9"
"Oglethorpe","2020-10-31","8","2962","2","315","22","18.7"
"Oglethorpe","2020-11-01","4","2966","1","316","16.1","18.1"
"Oglethorpe","2020-11-02","20","2986","6","322","17.9","19.4"
"Oglethorpe","2020-11-03","14","3000","0","322","16","18.5"
"Oglethorpe","2020-11-04","14","3014","0","322","14.7","16.6"
"Oglethorpe","2020-11-05","21","3035","1","323","14","16.1"
"Oglethorpe","2020-11-06","20","3055","0","323","12.1","15.3"
"Oglethorpe","2020-11-07","6","3061","2","325","13.3","17.7"
"Oglethorpe","2020-11-08","8","3069","0","325","9.7","12.9"
"Oglethorpe","2020-11-09","33","3102","1","326","5.9","11.9"
"Oglethorpe","2020-11-10","26","3128","0","326","5.9","11"
"Oglethorpe","2020-11-11","17","3145","0","326","5.9","10.3"
"Oglethorpe","2020-11-12","16","3161","0","326","5.2","9.6"
"Oglethorpe","2020-11-13","26","3187","1","327","5.7","8.9"
"Oglethorpe","2020-11-14","7","3194","1","328","3","8.2"
"Oglethorpe","2020-11-15","14","3208","2","330","5.1","7.4"
"Oglethorpe","2020-11-16","35","3243","3","333","5.9","5.9"
"Oglethorpe","2020-11-17","34","3277","2","335","6.7","6.3"
"Oglethorpe","2020-11-18","28","3305","5","340","9.2","7.6"
"Oglethorpe","2020-11-19","25","3330","2","342","10.4","7.8"
"Oglethorpe","2020-11-20","30","3360","5","347","12.2","9"
"Oglethorpe","2020-11-21","9","3369","3","350","14.9","9"
"Oglethorpe","2020-11-22","11","3380","0","350","12.9","9"
"Oglethorpe","2020-11-23","38","3418","6","356","13.9","9.9"
"Oglethorpe","2020-11-24","20","3438","4","360","15.9","11.3"
"Oglethorpe","2020-11-25","25","3463","3","363","15.1","12.2"
"Oglethorpe","2020-11-26","4","3467","1","364","17.5","14"
"Oglethorpe","2020-11-27","22","3489","1","365","15.8","14"
"Oglethorpe","2020-11-28","8","3497","1","366","12.8","13.9"
"Oglethorpe","2020-11-29","10","3507","1","367","14.3","13.6"
"Oglethorpe","2020-11-30","36","3543","7","374","14.8","14.4"
"Oglethorpe","2020-12-01","82","3625","4","378","12.6","14.3"
"Oglethorpe","2020-12-02","37","3662","3","381","12.1","13.6"
"Oglethorpe","2020-12-03","29","3691","4","385","10.5","14"
"Oglethorpe","2020-12-04","31","3722","3","388","11.2","13.5"
"Oglethorpe","2020-12-05","15","3737","1","389","10.4","11.6"
"Oglethorpe","2020-12-06","14","3751","3","392","12","13.1"
"Oglethorpe","2020-12-07","39","3790","6","398","11.4","13.1"
"Oglethorpe","2020-12-08","37","3827","5","403","12.7","12.6"
"Oglethorpe","2020-12-09","38","3865","7","410","14.1","13.1"
"Oglethorpe","2020-12-10","50","3915","10","420","15","12.7"
"Oglethorpe","2020-12-11","27","3942","5","425","16.3","13.7"
"Oglethorpe","2020-12-12","26","3968","9","434","20.3","15.3"
"Oglethorpe","2020-12-13","18","3986","4","438","20.4","16.2"
"Oglethorpe","2020-12-14","99","4085","16","454","20.5","16"
"Oglethorpe","2020-12-15","49","4134","9","463","21.2","16.9"
"Oglethorpe","2020-12-16","49","4183","13","476","22.3","18.2"
"Oglethorpe","2020-12-17","40","4223","11","487","23.4","19.2"
"Oglethorpe","2020-12-18","47","4270","13","500","24.7","20.5"
"Oglethorpe","2020-12-19","19","4289","1","501","20.5","20.4"
"Oglethorpe","2020-12-20","14","4303","2","503","19.4","19.9"
"Oglethorpe","2020-12-21","50","4353","10","513","19.9","20.2"
"Oglethorpe","2020-12-22","51","4404","12","525","20.7","20.9"
"Oglethorpe","2020-12-23","47","4451","21","546","23.3","22.8"
"Oglethorpe","2020-12-24","22","4473","7","553","23.9","23.7"
"Oglethorpe","2020-12-25","7","4480","1","554","22","23.4"
"Oglethorpe","2020-12-26","26","4506","5","559","24","22.3"
"Oglethorpe","2020-12-27","24","4530","11","570","28.5","23.9"
"Oglethorpe","2020-12-28","86","4616","8","578","27","23.4"
"Oglethorpe","2020-12-29","44","4660","14","592","28.1","24.4"
"Oglethorpe","2020-12-30","37","4697","21","613","29.9","26.6"
"Oglethorpe","2020-12-31","46","4743","12","625","29","26.5"
"Oglethorpe","2021-01-01","22","4765","11","636","34.1","28.1"
"Oglethorpe","2021-01-02","19","4784","11","647","39.7","31.8"
"Oglethorpe","2021-01-03","15","4799","5","652","37.9","33.2"
"Oglethorpe","2021-01-04","50","4849","11","663","39.7","33.3"
"Oglethorpe","2021-01-05","40","4889","12","675","39.4","33.8"
"Oglethorpe","2021-01-06","80","4969","23","698","35.4","32.7"
"Oglethorpe","2021-01-07","54","5023","15","713","35.7","32.4"
"Oglethorpe","2021-01-08","39","5062","14","727","33.7","33.9"
"Oglethorpe","2021-01-09","15","5077","2","729","27.3","33.5"
"Oglethorpe","2021-01-10","19","5096","6","735","27","32.5"
"Oglethorpe","2021-01-11","41","5137","7","742","26.3","33"
"Oglethorpe","2021-01-12","47","5184","8","750","24.5","32"
"Oglethorpe","2021-01-13","45","5229","9","759","23.2","29.3"
"Oglethorpe","2021-01-14","46","5275","9","768","22.1","28.9"
"Oglethorpe","2021-01-15","45","5320","9","777","19.8","26.7"
"Oglethorpe","2021-01-16","18","5338","4","781","21.1","24.2"
"Oglethorpe","2021-01-17","12","5350","3","784","20.1","23.6"
"Oglethorpe","2021-01-18","42","5392","9","793","20.7","23.5"
"Oglethorpe","2021-01-19","33","5425","9","802","22.2","23.4"
"Oglethorpe","2021-01-20","35","5460","6","808","21.8","22.5"
"Oglethorpe","2021-01-21","48","5508","13","821","22.9","22.5"
"Oglethorpe","2021-01-22","43","5551","11","832","23.7","21.7"
"Oglethorpe","2021-01-23","28","5579","4","836","22.5","21.8"
"Oglethorpe","2021-01-24","17","5596","3","839","21.5","20.8"
"Oglethorpe","2021-01-25","37","5633","6","845","20.7","20.7"
"Oglethorpe","2021-01-26","49","5682","6","851","18.6","20.4"
"Oglethorpe","2021-01-27","35","5717","7","858","19","20.4"
"Oglethorpe","2021-01-28","40","5757","5","863","16.9","19.9"
"Oglethorpe","2021-01-29","42","5799","3","866","14.3","19"
"Oglethorpe","2021-01-30","5","5804","1","867","15.1","18.8"
"Oglethorpe","2021-01-31","12","5816","2","869","15","18.2"
"Oglethorpe","2021-02-01","53","5869","7","876","14.5","17.6"
"Oglethorpe","2021-02-02","40","5909","3","879","13.9","16.2"
"Oglethorpe","2021-02-03","39","5948","3","882","12.1","15.6"
"Oglethorpe","2021-02-04","39","5987","6","888","12.5","14.7"
"Oglethorpe","2021-02-05","19","6006","5","893","15.3","14.8"
"Oglethorpe","2021-02-06","6","6012","2","895","17.2","16.1"
"Oglethorpe","2021-02-07","2","6014","0","895","14.8","14.9"
"Oglethorpe","2021-02-08","0","6014","0","895","12.9","13.7"
"Paulding","2020-02-01","0","0","0","0",".","."
"Paulding","2020-02-02","0","0","0","0",".","."
"Paulding","2020-02-03","0","0","0","0",".","."
"Paulding","2020-02-04","0","0","0","0",".","."
"Paulding","2020-02-05","0","0","0","0",".","."
"Paulding","2020-02-06","0","0","0","0",".","."
"Paulding","2020-02-07","0","0","0","0","0","."
"Paulding","2020-02-08","0","0","0","0","0","."
"Paulding","2020-02-09","0","0","0","0","0","."
"Paulding","2020-02-10","0","0","0","0","0","."
"Paulding","2020-02-11","0","0","0","0","0","."
"Paulding","2020-02-12","0","0","0","0","0","."
"Paulding","2020-02-13","0","0","0","0","0","."
"Paulding","2020-02-14","0","0","0","0","0","0"
"Paulding","2020-02-15","0","0","0","0","0","0"
"Paulding","2020-02-16","0","0","0","0","0","0"
"Paulding","2020-02-17","0","0","0","0","0","0"
"Paulding","2020-02-18","0","0","0","0","0","0"
"Paulding","2020-02-19","0","0","0","0","0","0"
"Paulding","2020-02-20","0","0","0","0","0","0"
"Paulding","2020-02-21","0","0","0","0","0","0"
"Paulding","2020-02-22","0","0","0","0","0","0"
"Paulding","2020-02-23","0","0","0","0","0","0"
"Paulding","2020-02-24","0","0","0","0","0","0"
"Paulding","2020-02-25","0","0","0","0","0","0"
"Paulding","2020-02-26","0","0","0","0","0","0"
"Paulding","2020-02-27","0","0","0","0","0","0"
"Paulding","2020-02-28","0","0","0","0","0","0"
"Paulding","2020-02-29","0","0","0","0","0","0"
"Paulding","2020-03-01","0","0","0","0","0","0"
"Paulding","2020-03-02","0","0","0","0","0","0"
"Paulding","2020-03-03","0","0","0","0","0","0"
"Paulding","2020-03-04","0","0","0","0","0","0"
"Paulding","2020-03-05","0","0","0","0","0","0"
"Paulding","2020-03-06","0","0","0","0","0","0"
"Paulding","2020-03-07","0","0","0","0","0","0"
"Paulding","2020-03-08","0","0","0","0","0","0"
"Paulding","2020-03-09","0","0","0","0","0","0"
"Paulding","2020-03-10","2","2","0","0","0","0"
"Paulding","2020-03-11","1","3","0","0","0","0"
"Paulding","2020-03-12","7","10","2","2","4.1","2"
"Paulding","2020-03-13","5","15","0","2","4.1","2"
"Paulding","2020-03-14","2","17","0","2","4.1","2"
"Paulding","2020-03-15","4","21","3","5","14.8","7.4"
"Paulding","2020-03-16","6","27","0","5","14.8","7.4"
"Paulding","2020-03-17","24","51","3","8","16.6","8.3"
"Paulding","2020-03-18","19","70","1","9","17.3","8.7"
"Paulding","2020-03-19","22","92","3","12","15.2","9.6"
"Paulding","2020-03-20","18","110","6","18","20","12"
"Paulding","2020-03-21","2","112","1","19","27.1","15.6"
"Paulding","2020-03-22","6","118","0","19","16.4","15.6"
"Paulding","2020-03-23","20","138","6","25","20.7","17.7"
"Paulding","2020-03-24","28","166","10","35","24","20.3"
"Paulding","2020-03-25","39","205","4","39","24.7","21"
"Paulding","2020-03-26","47","252","8","47","25.2","20.2"
"Paulding","2020-03-27","34","286","9","56","24.2","22.1"
"Paulding","2020-03-28","30","316","6","62","19.9","23.5"
"Paulding","2020-03-29","17","333","4","66","23.3","19.8"
"Paulding","2020-03-30","31","364","5","71","21.3","21"
"Paulding","2020-03-31","36","400","11","82","20.6","22.3"
"Paulding","2020-04-01","26","426","2","84","20.2","22.5"
"Paulding","2020-04-02","27","453","8","92","22","23.6"
"Paulding","2020-04-03","29","482","7","99","21.7","22.9"
"Paulding","2020-04-04","19","501","3","102","21.1","20.5"
"Paulding","2020-04-05","5","506","0","102","17.7","20.5"
"Paulding","2020-04-06","39","545","2","104","16.1","18.7"
"Paulding","2020-04-07","42","587","5","109","13.5","17"
"Paulding","2020-04-08","55","642","8","117","14.4","17.3"
"Paulding","2020-04-09","47","689","7","124","12.3","17.2"
"Paulding","2020-04-10","46","735","4","128","10.1","15.9"
"Paulding","2020-04-11","19","754","3","131","10.1","15.6"
"Paulding","2020-04-12","7","761","1","132","12.2","14.9"
"Paulding","2020-04-13","29","790","4","136","13.4","14.8"
"Paulding","2020-04-14","42","832","6","142","13.8","13.6"
"Paulding","2020-04-15","31","863","2","144","12.6","13.5"
"Paulding","2020-04-16","43","906","5","149","12.1","12.2"
"Paulding","2020-04-17","39","945","5","154","12.7","11.4"
"Paulding","2020-04-18","29","974","2","156","11.5","10.8"
"Paulding","2020-04-19","8","982","0","156","9.4","10.8"
"Paulding","2020-04-20","52","1034","6","162","9.1","11.3"
"Paulding","2020-04-21","72","1106","4","166","7.8","10.8"
"Paulding","2020-04-22","67","1173","9","175","8.8","10.7"
"Paulding","2020-04-23","37","1210","3","178","8.3","10.2"
"Paulding","2020-04-24","93","1303","4","182","7.1","9.9"
"Paulding","2020-04-25","33","1336","2","184","7","9.2"
"Paulding","2020-04-26","14","1350","0","184","7","8.2"
"Paulding","2020-04-27","62","1412","6","190","6.7","7.9"
"Paulding","2020-04-28","84","1496","8","198","7.3","7.6"
"Paulding","2020-04-29","61","1557","3","201","6.1","7.5"
"Paulding","2020-04-30","130","1687","6","207","5.6","7"
"Paulding","2020-05-01","59","1746","4","211","5.9","6.5"
"Paulding","2020-05-02","25","1771","0","211","5.1","6"
"Paulding","2020-05-03","35","1806","3","214","6.3","6.6"
"Paulding","2020-05-04","88","1894","8","222","6.2","6.5"
"Paulding","2020-05-05","61","1955","1","223","5.1","6.2"
"Paulding","2020-05-06","76","2031","3","226","4.9","5.5"
"Paulding","2020-05-07","78","2109","0","226","4.3","4.9"
"Paulding","2020-05-08","113","2222","6","232","4.1","5"
"Paulding","2020-05-09","89","2311","1","233","4.2","4.7"
"Paulding","2020-05-10","16","2327","1","234","3.9","5.1"
"Paulding","2020-05-11","150","2477","9","243","3.5","4.8"
"Paulding","2020-05-12","146","2623","4","247","3.6","4.4"
"Paulding","2020-05-13","187","2810","9","256","3.7","4.3"
"Paulding","2020-05-14","153","2963","5","261","4.2","4.3"
"Paulding","2020-05-15","171","3134","7","268","4","4.1"
"Paulding","2020-05-16","109","3243","8","276","4.9","4.6"
"Paulding","2020-05-17","197","3440","6","282","4.5","4.2"
"Paulding","2020-05-18","102","3542","6","288","4.5","4"
"Paulding","2020-05-19","181","3723","7","295","4.6","4.1"
"Paulding","2020-05-20","162","3885","3","298","4.2","4"
"Paulding","2020-05-21","170","4055","4","302","4.1","4.1"
"Paulding","2020-05-22","126","4181","4","306","3.9","4"
"Paulding","2020-05-23","29","4210","5","311","5.3","5.1"
"Paulding","2020-05-24","20","4230","1","312","5.6","5"
"Paulding","2020-05-25","10","4240","1","313","6.2","5.3"
"Paulding","2020-05-26","171","4411","6","319","6.2","5.4"
"Paulding","2020-05-27","149","4560","5","324","6.4","5.3"
"Paulding","2020-05-28","124","4684","10","334","7.2","5.6"
"Paulding","2020-05-29","94","4778","7","341","7.8","5.9"
"Paulding","2020-05-30","80","4858","7","348","6.6","6"
"Paulding","2020-05-31","31","4889","4","352","7.7","6.7"
"Paulding","2020-06-01","171","5060","11","363","7.2","6.7"
"Paulding","2020-06-02","159","5219","8","371","7.4","6.8"
"Paulding","2020-06-03","176","5395","5","376","7.4","6.9"
"Paulding","2020-06-04","90","5485","3","379","6.7","6.9"
"Paulding","2020-06-05","118","5603","10","389","6.8","7.3"
"Paulding","2020-06-06","94","5697","4","393","6.2","6.4"
"Paulding","2020-06-07","35","5732","2","395","5.2","6.4"
"Paulding","2020-06-08","165","5897","7","402","4.8","6"
"Paulding","2020-06-09","150","6047","10","412","5.1","6.3"
"Paulding","2020-06-10","184","6231","6","418","5.1","6.2"
"Paulding","2020-06-11","182","6413","12","430","5.6","6.1"
"Paulding","2020-06-12","157","6570","7","437","5","5.9"
"Paulding","2020-06-13","80","6650","3","440","5","5.6"
"Paulding","2020-06-14","31","6681","0","440","4.1","4.6"
"Paulding","2020-06-15","172","6853","8","448","4.2","4.5"
"Paulding","2020-06-16","174","7027","12","460","4.2","4.7"
"Paulding","2020-06-17","168","7195","19","479","5.4","5.3"
"Paulding","2020-06-18","184","7379","16","495","5.7","5.6"
"Paulding","2020-06-19","166","7545","16","511","6.4","5.7"
"Paulding","2020-06-20","110","7655","6","517","6.7","5.8"
"Paulding","2020-06-21","38","7693","5","522","8.5","6.3"
"Paulding","2020-06-22","284","7977","26","548","9.2","6.7"
"Paulding","2020-06-23","257","8234","17","565","9.1","6.7"
"Paulding","2020-06-24","264","8498","17","582","8.5","6.9"
"Paulding","2020-06-25","304","8802","32","614","8.7","7.2"
"Paulding","2020-06-26","300","9102","39","653","9.2","7.8"
"Paulding","2020-06-27","90","9192","8","661","9.7","8.2"
"Paulding","2020-06-28","44","9236","4","665","9.1","8.8"
"Paulding","2020-06-29","417","9653","50","715","9.5","9.3"
"Paulding","2020-06-30","435","10088","49","764","10.2","9.7"
"Paulding","2020-07-01","412","10500","40","804","10.6","9.5"
"Paulding","2020-07-02","344","10844","44","848","11","9.8"
"Paulding","2020-07-03","108","10952","8","856","10.2","9.7"
"Paulding","2020-07-04","45","10997","3","859","9.8","9.8"
"Paulding","2020-07-05","41","11038","3","862","9.6","9.3"
"Paulding","2020-07-06","432","11470","65","927","10","9.8"
"Paulding","2020-07-07","471","11941","60","987","10.2","10.2"
"Paulding","2020-07-08","356","12297","33","1020","10.2","10.4"
"Paulding","2020-07-09","364","12661","33","1053","9.6","10.3"
"Paulding","2020-07-10","388","13049","31","1084","9.7","9.9"
"Paulding","2020-07-11","69","13118","9","1093","10.6","10.2"
"Paulding","2020-07-12","55","13173","5","1098","10.9","10.2"
"Paulding","2020-07-13","351","13524","39","1137","10.3","10.2"
"Paulding","2020-07-14","344","13868","54","1191","10.8","10.5"
"Paulding","2020-07-15","335","14203","43","1234","11.3","10.7"
"Paulding","2020-07-16","330","14533","36","1270","11.5","10.6"
"Paulding","2020-07-17","337","14870","30","1300","11.7","10.7"
"Paulding","2020-07-18","239","15109","19","1319","10.9","10.8"
"Paulding","2020-07-19","44","15153","6","1325","11.6","11.2"
"Paulding","2020-07-20","327","15480","49","1374","12.1","11.2"
"Paulding","2020-07-21","321","15801","36","1410","11.5","11.1"
"Paulding","2020-07-22","298","16099","40","1450","11.6","11.4"
"Paulding","2020-07-23","335","16434","35","1485","11.5","11.5"
"Paulding","2020-07-24","303","16737","23","1508","11.3","11.5"
"Paulding","2020-07-25","65","16802","10","1518","12.4","11.7"
"Paulding","2020-07-26","43","16845","3","1521","11.4","11.5"
"Paulding","2020-07-27","347","17192","29","1550","10.5","11.3"
"Paulding","2020-07-28","327","17519","25","1575","10","10.7"
"Paulding","2020-07-29","296","17815","23","1598","9.2","10.4"
"Paulding","2020-07-30","275","18090","18","1616","8.6","10.1"
"Paulding","2020-07-31","271","18361","17","1633","8.4","9.9"
"Paulding","2020-08-01","141","18502","16","1649","7.8","10.1"
"Paulding","2020-08-02","78","18580","3","1652","7.4","9.4"
"Paulding","2020-08-03","326","18906","38","1690","7.9","9.2"
"Paulding","2020-08-04","321","19227","40","1730","8.6","9.3"
"Paulding","2020-08-05","280","19507","42","1772","9.6","9.4"
"Paulding","2020-08-06","357","19864","26","1798","9.7","9.2"
"Paulding","2020-08-07","330","20194","28","1826","10","9.2"
"Paulding","2020-08-08","75","20269","9","1835","10.1","9"
"Paulding","2020-08-09","58","20327","9","1844","11.8","9.6"
"Paulding","2020-08-10","343","20670","36","1880","11.6","9.7"
"Paulding","2020-08-11","364","21034","32","1912","11.1","9.8"
"Paulding","2020-08-12","340","21374","19","1931","9.7","9.7"
"Paulding","2020-08-13","330","21704","16","1947","9.4","9.5"
"Paulding","2020-08-14","293","21997","20","1967","9.2","9.6"
"Paulding","2020-08-15","108","22105","12","1979","9","9.6"
"Paulding","2020-08-16","52","22157","4","1983","7.9","9.8"
"Paulding","2020-08-17","128","22285","8","1991","7.3","9.5"
"Paulding","2020-08-18","313","22598","16","2007","6.8","8.9"
"Paulding","2020-08-19","319","22917","17","2024","6.7","8.2"
"Paulding","2020-08-20","305","23222","28","2052","7.4","8.4"
"Paulding","2020-08-21","279","23501","23","2075","7.6","8.4"
"Paulding","2020-08-22","57","23558","3","2078","6.7","7.9"
"Paulding","2020-08-23","57","23615","6","2084","7.1","7.5"
"Paulding","2020-08-24","296","23911","16","2100","7","7.2"
"Paulding","2020-08-25","275","24186","27","2127","7.7","7.2"
"Paulding","2020-08-26","249","24435","24","2151","8.3","7.5"
"Paulding","2020-08-27","254","24689","18","2169","8","7.7"
"Paulding","2020-08-28","259","24948","22","2191","8","7.8"
"Paulding","2020-08-29","78","25026","5","2196","8.2","7.5"
"Paulding","2020-08-30","35","25061","3","2199","7.9","7.5"
"Paulding","2020-08-31","310","25371","36","2235","8.8","7.9"
"Paulding","2020-09-01","139","25510","19","2254","9.4","8.5"
"Paulding","2020-09-02","101","25611","10","2264","9.4","8.8"
"Paulding","2020-09-03","333","25944","28","2292","9.6","8.8"
"Paulding","2020-09-04","236","26180","22","2314","9.7","8.9"
"Paulding","2020-09-05","77","26257","4","2318","9.5","8.9"
"Paulding","2020-09-06","59","26316","6","2324","9.8","8.8"
"Paulding","2020-09-07","77","26393","10","2334","10","9.4"
"Paulding","2020-09-08","134","26527","14","2348","9.5","9.4"
"Paulding","2020-09-09","158","26685","15","2363","9.4","9.4"
"Paulding","2020-09-10","276","26961","20","2383","9.3","9.4"
"Paulding","2020-09-11","255","27216","14","2397","8.7","9.2"
"Paulding","2020-09-12","51","27267","5","2402","9.4","9.5"
"Paulding","2020-09-13","47","27314","4","2406","9.1","9.4"
"Paulding","2020-09-14","282","27596","18","2424","8.2","9.1"
"Paulding","2020-09-15","126","27722","6","2430","7.4","8.4"
"Paulding","2020-09-16","135","27857","6","2436","6.7","8"
"Paulding","2020-09-17","131","27988","11","2447","6.8","8"
"Paulding","2020-09-18","303","28291","11","2458","6.6","7.6"
"Paulding","2020-09-19","95","28386","11","2469","6.8","8.1"
"Paulding","2020-09-20","32","28418","2","2471","6.5","7.8"
"Paulding","2020-09-21","225","28643","19","2490","6.8","7.5"
"Paulding","2020-09-22","110","28753","7","2497","7","7.2"
"Paulding","2020-09-23","110","28863","4","2501","6.9","6.8"
"Paulding","2020-09-24","184","29047","12","2513","6.6","6.7"
"Paulding","2020-09-25","208","29255","11","2524","6.9","6.7"
"Paulding","2020-09-26","49","29304","3","2527","6.1","6.5"
"Paulding","2020-09-27","45","29349","2","2529","5.8","6.2"
"Paulding","2020-09-28","162","29511","9","2538","5.4","6.1"
"Paulding","2020-09-29","97","29608","6","2544","5.4","6.2"
"Paulding","2020-09-30","117","29725","5","2549","5.5","6.2"
"Paulding","2020-10-01","227","29952","17","2566","5.6","6.1"
"Paulding","2020-10-02","195","30147","7","2573","5.4","6.1"
"Paulding","2020-10-03","64","30211","10","2583","6.7","6.4"
"Paulding","2020-10-04","40","30251","1","2584","6.5","6.1"
"Paulding","2020-10-05","216","30467","8","2592","6.2","5.8"
"Paulding","2020-10-06","178","30645","12","2604","6.3","5.8"
"Paulding","2020-10-07","155","30800","6","2610","6.2","5.9"
"Paulding","2020-10-08","138","30938","5","2615","5.7","5.6"
"Paulding","2020-10-09","110","31048","5","2620","5.8","5.6"
"Paulding","2020-10-10","57","31105","6","2626","5.1","5.9"
"Paulding","2020-10-11","48","31153","0","2626","4.7","5.6"
"Paulding","2020-10-12","126","31279","11","2637","5.4","5.8"
"Paulding","2020-10-13","133","31412","5","2642","5","5.6"
"Paulding","2020-10-14","103","31515","3","2645","4.9","5.5"
"Paulding","2020-10-15","124","31639","5","2650","4.9","5.3"
"Paulding","2020-10-16","267","31906","22","2672","5.5","5.6"
"Paulding","2020-10-17","63","31969","4","2676","4.9","5"
"Paulding","2020-10-18","49","32018","1","2677","5.2","4.9"
"Paulding","2020-10-19","214","32232","16","2693","5","5.2"
"Paulding","2020-10-20","151","32383","10","2703","5.4","5.2"
"Paulding","2020-10-21","137","32520","16","2719","6.6","5.8"
"Paulding","2020-10-22","141","32661","10","2729","7.1","6"
"Paulding","2020-10-23","285","32946","14","2743","6.6","6"
"Paulding","2020-10-24","73","33019","11","2754","7.8","6.4"
"Paulding","2020-10-25","46","33065","5","2759","9.1","7.1"
"Paulding","2020-10-26","205","33270","23","2782","9.6","7.3"
"Paulding","2020-10-27","164","33434","16","2798","10.1","7.7"
"Paulding","2020-10-28","177","33611","8","2806","9.1","7.8"
"Paulding","2020-10-29","118","33729","11","2817","9.4","8.2"
"Paulding","2020-10-30","254","33983","22","2839","9.9","8.3"
"Paulding","2020-10-31","95","34078","11","2850","9.4","8.6"
"Paulding","2020-11-01","65","34143","12","2862","10.5","9.8"
"Paulding","2020-11-02","267","34410","35","2897","10.8","10.2"
"Paulding","2020-11-03","137","34547","12","2909","10.6","10.4"
"Paulding","2020-11-04","189","34736","10","2919","10.7","9.9"
"Paulding","2020-11-05","298","35034","22","2941","10.5","9.9"
"Paulding","2020-11-06","259","35293","17","2958","10.2","10"
"Paulding","2020-11-07","100","35393","17","2975","10.9","10.2"
"Paulding","2020-11-08","59","35452","4","2979","9.3","9.9"
"Paulding","2020-11-09","288","35740","38","3017","9.3","10"
"Paulding","2020-11-10","181","35921","18","3035","9.5","10"
"Paulding","2020-11-11","169","36090","22","3057","10.6","10.6"
"Paulding","2020-11-12","398","36488","65","3122","11.8","11.1"
"Paulding","2020-11-13","358","36846","39","3161","12.5","11.3"
"Paulding","2020-11-14","99","36945","17","3178","12.5","11.7"
"Paulding","2020-11-15","74","37019","12","3190","13.8","11.5"
"Paulding","2020-11-16","363","37382","38","3228","13.4","11.4"
"Paulding","2020-11-17","248","37630","29","3257","13.7","11.6"
"Paulding","2020-11-18","230","37860","33","3290","13.9","12.2"
"Paulding","2020-11-19","517","38377","58","3348","13.1","12.5"
"Paulding","2020-11-20","470","38847","40","3388","12.8","12.6"
"Paulding","2020-11-21","100","38947","9","3397","11.6","12.1"
"Paulding","2020-11-22","79","39026","8","3405","10.8","12.3"
"Paulding","2020-11-23","554","39580","79","3484","11.3","12.4"
"Paulding","2020-11-24","217","39797","23","3507","11.2","12.4"
"Paulding","2020-11-25","206","40003","18","3525","10.4","12.1"
"Paulding","2020-11-26","27","40030","2","3527","9.8","11.5"
"Paulding","2020-11-27","193","40223","34","3561","11.1","12"
"Paulding","2020-11-28","109","40332","25","3586","13.1","12.4"
"Paulding","2020-11-29","87","40419","19","3605","14.8","12.8"
"Paulding","2020-11-30","528","40947","82","3687","15","13.1"
"Paulding","2020-12-01","405","41352","82","3769","16.3","13.7"
"Paulding","2020-12-02","274","41626","46","3815","17.5","13.9"
"Paulding","2020-12-03","632","42258","90","3905","18.5","14.1"
"Paulding","2020-12-04","498","42756","55","3960","17.5","14.3"
"Paulding","2020-12-05","101","42857","22","3982","17.4","15.2"
"Paulding","2020-12-06","67","42924","10","3992","16.4","15.6"
"Paulding","2020-12-07","569","43493","103","4095","16.7","15.8"
"Paulding","2020-12-08","489","43982","73","4168","16","16.2"
"Paulding","2020-12-09","284","44266","33","4201","15.2","16.4"
"Paulding","2020-12-10","720","44986","103","4304","15.2","16.9"
"Paulding","2020-12-11","579","45565","89","4393","15.9","16.7"
"Paulding","2020-12-12","159","45724","31","4424","15.5","16.4"
"Paulding","2020-12-13","103","45827","19","4443","16","16.2"
"Paulding","2020-12-14","674","46501","125","4568","16.1","16.4"
"Paulding","2020-12-15","756","47257","133","4701","16.5","16.2"
"Paulding","2020-12-16","300","47557","29","4730","16.2","15.7"
"Paulding","2020-12-17","814","48371","129","4859","16.4","15.8"
"Paulding","2020-12-18","766","49137","124","4983","16.5","16.2"
"Paulding","2020-12-19","142","49279","29","5012","16.7","16.1"
"Paulding","2020-12-20","135","49414","23","5035","16.5","16.3"
"Paulding","2020-12-21","914","50328","181","5216","16.7","16.4"
"Paulding","2020-12-22","831","51159","159","5375","16.9","16.7"
"Paulding","2020-12-23","329","51488","68","5443","18.4","17.3"
"Paulding","2020-12-24","198","51686","33","5476","18.6","17.5"
"Paulding","2020-12-25","39","51725","5","5481","18.1","17.3"
"Paulding","2020-12-26","134","51859","37","5518","19.1","17.9"
"Paulding","2020-12-27","90","51949","33","5551","21.9","19.2"
"Paulding","2020-12-28","1029","52978","210","5761","22","19.3"
"Paulding","2020-12-29","855","53833","154","5915","21.8","19.4"
"Paulding","2020-12-30","391","54224","84","5999","22","20.2"
"Paulding","2020-12-31","920","55144","201","6200","22.7","20.6"
"Paulding","2021-01-01","65","55209","14","6214","23.9","21"
"Paulding","2021-01-02","153","55362","47","6261","24.4","21.7"
"Paulding","2021-01-03","101","55463","24","6285","22.5","22.2"
"Paulding","2021-01-04","1046","56509","196","6481","22.3","22.1"
"Paulding","2021-01-05","1083","57592","181","6662","22.1","22"
"Paulding","2021-01-06","548","58140","105","6767","21.8","21.9"
"Paulding","2021-01-07","1012","59152","173","6940","21.1","21.9"
"Paulding","2021-01-08","732","59884","117","7057","20.3","22.1"
"Paulding","2021-01-09","180","60064","49","7106","19.8","22.1"
"Paulding","2021-01-10","115","60179","21","7127","19","20.8"
"Paulding","2021-01-11","525","60704","69","7196","18.2","20.3"
"Paulding","2021-01-12","893","61597","112","7308","17.6","19.9"
"Paulding","2021-01-13","442","62039","60","7368","16.8","19.3"
"Paulding","2021-01-14","778","62817","107","7475","16.4","18.7"
"Paulding","2021-01-15","776","63593","84","7559","15.6","18"
"Paulding","2021-01-16","247","63840","57","7616","15","17.4"
"Paulding","2021-01-17","126","63966","20","7636","14.7","16.9"
"Paulding","2021-01-18","448","64414","33","7669","13.9","16"
"Paulding","2021-01-19","534","64948","81","7750","14.2","15.9"
"Paulding","2021-01-20","402","65350","46","7796","13.9","15.4"
"Paulding","2021-01-21","330","65680","59","7855","14.5","15.4"
"Paulding","2021-01-22","663","66343","98","7953","15.1","15.4"
"Paulding","2021-01-23","213","66556","36","7989","14.2","14.6"
"Paulding","2021-01-24","122","66678","18","8007","14","14.4"
"Paulding","2021-01-25","809","67487","101","8108","14.8","14.3"
"Paulding","2021-01-26","429","67916","52","8160","14.3","14.3"
"Paulding","2021-01-27","364","68280","47","8207","14.5","14.2"
"Paulding","2021-01-28","387","68667","52","8259","13.9","14.2"
"Paulding","2021-01-29","434","69101","58","8317","13.7","14.4"
"Paulding","2021-01-30","258","69359","50","8367","14.1","14.1"
"Paulding","2021-01-31","158","69517","17","8384","13.5","13.8"
"Paulding","2021-02-01","433","69950","48","8432","13.3","14"
"Paulding","2021-02-02","356","70306","27","8459","12.6","13.5"
"Paulding","2021-02-03","347","70653","44","8503","12.6","13.6"
"Paulding","2021-02-04","316","70969","36","8539","12.3","13.1"
"Paulding","2021-02-05","242","71211","28","8567","12.1","12.9"
"Paulding","2021-02-06","37","71248","5","8572","11.2","12.6"
"Paulding","2021-02-07","14","71262","1","8573","10.7","12.1"
"Paulding","2021-02-08","0","71262","0","8573","9.1","11.2"
"Peach","2020-02-01","0","0","0","0",".","."
"Peach","2020-02-02","0","0","0","0",".","."
"Peach","2020-02-03","0","0","0","0",".","."
"Peach","2020-02-04","0","0","0","0",".","."
"Peach","2020-02-05","0","0","0","0",".","."
"Peach","2020-02-06","0","0","0","0",".","."
"Peach","2020-02-07","0","0","0","0","0","."
"Peach","2020-02-08","0","0","0","0","0","."
"Peach","2020-02-09","0","0","0","0","0","."
"Peach","2020-02-10","0","0","0","0","0","."
"Peach","2020-02-11","0","0","0","0","0","."
"Peach","2020-02-12","0","0","0","0","0","."
"Peach","2020-02-13","0","0","0","0","0","."
"Peach","2020-02-14","0","0","0","0","0","0"
"Peach","2020-02-15","0","0","0","0","0","0"
"Peach","2020-02-16","0","0","0","0","0","0"
"Peach","2020-02-17","0","0","0","0","0","0"
"Peach","2020-02-18","0","0","0","0","0","0"
"Peach","2020-02-19","0","0","0","0","0","0"
"Peach","2020-02-20","0","0","0","0","0","0"
"Peach","2020-02-21","0","0","0","0","0","0"
"Peach","2020-02-22","0","0","0","0","0","0"
"Peach","2020-02-23","0","0","0","0","0","0"
"Peach","2020-02-24","0","0","0","0","0","0"
"Peach","2020-02-25","0","0","0","0","0","0"
"Peach","2020-02-26","0","0","0","0","0","0"
"Peach","2020-02-27","0","0","0","0","0","0"
"Peach","2020-02-28","0","0","0","0","0","0"
"Peach","2020-02-29","0","0","0","0","0","0"
"Peach","2020-03-01","0","0","0","0","0","0"
"Peach","2020-03-02","0","0","0","0","0","0"
"Peach","2020-03-03","0","0","0","0","0","0"
"Peach","2020-03-04","0","0","0","0","0","0"
"Peach","2020-03-05","0","0","0","0","0","0"
"Peach","2020-03-06","0","0","0","0","0","0"
"Peach","2020-03-07","0","0","0","0","0","0"
"Peach","2020-03-08","0","0","0","0","0","0"
"Peach","2020-03-09","0","0","0","0","0","0"
"Peach","2020-03-10","0","0","0","0","0","0"
"Peach","2020-03-11","0","0","0","0","0","0"
"Peach","2020-03-12","0","0","0","0","0","0"
"Peach","2020-03-13","2","2","0","0","0","0"
"Peach","2020-03-14","0","2","0","0","0","0"
"Peach","2020-03-15","0","2","0","0","0","0"
"Peach","2020-03-16","1","3","0","0","0","0"
"Peach","2020-03-17","1","4","1","1","14.3","7.1"
"Peach","2020-03-18","3","7","1","2","19","9.5"
"Peach","2020-03-19","2","9","0","2","19","9.5"
"Peach","2020-03-20","11","20","5","7","25.5","12.8"
"Peach","2020-03-21","0","20","0","7","25.5","12.8"
"Peach","2020-03-22","9","29","4","11","31.9","15.9"
"Peach","2020-03-23","4","33","2","13","39","19.5"
"Peach","2020-03-24","5","38","1","14","27.6","20.9"
"Peach","2020-03-25","7","45","0","14","22.8","20.9"
"Peach","2020-03-26","5","50","1","15","25.7","22.4"
"Peach","2020-03-27","4","54","0","15","19.2","22.4"
"Peach","2020-03-28","2","56","0","15","19.2","22.4"
"Peach","2020-03-29","3","59","1","16","17.6","24.8"
"Peach","2020-03-30","12","71","2","18","12.9","25.9"
"Peach","2020-03-31","12","83","1","19","11.2","19.4"
"Peach","2020-04-01","12","95","1","20","12.4","17.6"
"Peach","2020-04-02","9","104","3","23","14.3","20"
"Peach","2020-04-03","14","118","6","29","20.4","19.8"
"Peach","2020-04-04","1","119","0","29","20.4","19.8"
"Peach","2020-04-05","5","124","0","29","15.6","16.6"
"Peach","2020-04-06","8","132","1","30","15.1","14"
"Peach","2020-04-07","7","139","2","32","17.9","14.6"
"Peach","2020-04-08","5","144","1","33","19.6","16"
"Peach","2020-04-09","5","149","1","34","17.7","16"
"Peach","2020-04-10","5","154","0","34","11.6","16"
"Peach","2020-04-11","1","155","0","34","11.6","16"
"Peach","2020-04-12","4","159","1","35","15.2","15.4"
"Peach","2020-04-13","16","175","7","42","19.6","17.3"
"Peach","2020-04-14","7","182","0","42","15.5","16.7"
"Peach","2020-04-15","7","189","1","43","14.7","17.2"
"Peach","2020-04-16","4","193","2","45","19","18.4"
"Peach","2020-04-17","2","195","0","45","19","15.3"
"Peach","2020-04-18","2","197","1","46","26.1","18.9"
"Peach","2020-04-19","7","204","0","46","22.6","18.9"
"Peach","2020-04-20","10","214","1","47","17.8","18.7"
"Peach","2020-04-21","11","225","4","51","22.9","19.2"
"Peach","2020-04-22","13","238","3","54","24.2","19.5"
"Peach","2020-04-23","3","241","1","55","21.8","20.4"
"Peach","2020-04-24","7","248","1","56","23.9","21.4"
"Peach","2020-04-25","3","251","0","56","16.7","21.4"
"Peach","2020-04-26","4","255","0","56","16.7","19.6"
"Peach","2020-04-27","6","261","0","56","15.3","16.5"
"Peach","2020-04-28","19","280","1","57","10.9","16.9"
"Peach","2020-04-29","17","297","3","60","10.1","17.1"
"Peach","2020-04-30","6","303","0","60","5.3","13.6"
"Peach","2020-05-01","11","314","2","62","5.9","14.9"
"Peach","2020-05-02","8","322","0","62","5.9","11.3"
"Peach","2020-05-03","2","324","0","62","5.9","11.3"
"Peach","2020-05-04","13","337","2","64","8.1","11.7"
"Peach","2020-05-05","18","355","2","66","8.9","9.9"
"Peach","2020-05-06","4","359","0","66","6.4","8.2"
"Peach","2020-05-07","15","374","0","66","6.4","5.8"
"Peach","2020-05-08","6","380","0","66","3.8","4.8"
"Peach","2020-05-09","5","385","1","67","6.6","6.3"
"Peach","2020-05-10","3","388","1","68","11.4","8.6"
"Peach","2020-05-11","38","426","5","73","11.1","9.6"
"Peach","2020-05-12","53","479","1","74","9.8","9.3"
"Peach","2020-05-13","49","528","1","75","10.1","8.2"
"Peach","2020-05-14","12","540","0","75","10.1","8.2"
"Peach","2020-05-15","2","542","1","76","17.2","10.5"
"Peach","2020-05-16","1","543","0","76","14.3","10.5"
"Peach","2020-05-17","2","545","0","76","9.6","10.5"
"Peach","2020-05-18","9","554","0","76","7.7","9.4"
"Peach","2020-05-19","11","565","0","76","7.4","8.6"
"Peach","2020-05-20","53","618","1","77","7.4","8.7"
"Peach","2020-05-21","21","639","2","79","8.8","9.4"
"Peach","2020-05-22","15","654","0","79","1.6","9.4"
"Peach","2020-05-23","7","661","0","79","1.6","8"
"Peach","2020-05-24","6","667","0","79","1.6","5.6"
"Peach","2020-05-25","3","670","0","79","1.6","4.7"
"Peach","2020-05-26","15","685","1","80","2.6","5"
"Peach","2020-05-27","35","720","1","81","2.7","5.1"
"Peach","2020-05-28","11","731","2","83","4","6.4"
"Peach","2020-05-29","7","738","0","83","4","2.8"
"Peach","2020-05-30","9","747","0","83","4","2.8"
"Peach","2020-05-31","2","749","0","83","4","2.8"
"Peach","2020-06-01","22","771","1","84","4.6","3.1"
"Peach","2020-06-02","14","785","2","86","5.7","4.1"
"Peach","2020-06-03","24","809","0","86","5.3","4"
"Peach","2020-06-04","24","833","1","87","3.3","3.6"
"Peach","2020-06-05","13","846","0","87","3.3","3.6"
"Peach","2020-06-06","6","852","1","88","5.7","4.8"
"Peach","2020-06-07","9","861","1","89","7.3","5.6"
"Peach","2020-06-08","20","881","0","89","6.6","5.6"
"Peach","2020-06-09","14","895","1","90","5.6","5.6"
"Peach","2020-06-10","27","922","2","92","6.6","6"
"Peach","2020-06-11","15","937","2","94","8","5.6"
"Peach","2020-06-12","9","946","0","94","8","5.6"
"Peach","2020-06-13","4","950","0","94","5.6","5.6"
"Peach","2020-06-14","3","953","0","94","4","5.6"
"Peach","2020-06-15","15","968","1","95","4.9","5.8"
"Peach","2020-06-16","18","986","1","96","4.7","5.1"
"Peach","2020-06-17","34","1020","1","97","4.1","5.4"
"Peach","2020-06-18","15","1035","0","97","2.2","5.1"
"Peach","2020-06-19","14","1049","0","97","2.2","5.1"
"Peach","2020-06-20","1","1050","0","97","2.2","3.9"
"Peach","2020-06-21","15","1065","0","97","2.2","3.1"
"Peach","2020-06-22","22","1087","1","98","1.9","3.4"
"Peach","2020-06-23","27","1114","1","99","1.6","3.2"
"Peach","2020-06-24","34","1148","0","99","1.2","2.6"
"Peach","2020-06-25","38","1186","3","102","2.3","2.2"
"Peach","2020-06-26","27","1213","0","102","2.3","2.2"
"Peach","2020-06-27","9","1222","0","102","2.3","2.2"
"Peach","2020-06-28","13","1235","1","103","3.4","2.8"
"Peach","2020-06-29","31","1266","3","106","4.1","3"
"Peach","2020-06-30","33","1299","5","111","5.8","3.7"
"Peach","2020-07-01","53","1352","5","116","7.1","4.1"
"Peach","2020-07-02","46","1398","3","119","6.9","4.6"
"Peach","2020-07-03","13","1411","1","120","8","5.2"
"Peach","2020-07-04","10","1421","5","125","15.2","8.7"
"Peach","2020-07-05","3","1424","2","127","23.6","13.5"
"Peach","2020-07-06","64","1488","12","139","24.9","14.5"
"Peach","2020-07-07","34","1522","9","148","26.5","16.1"
"Peach","2020-07-08","59","1581","9","157","27.3","17.2"
"Peach","2020-07-09","29","1610","4","161","28.4","17.7"
"Peach","2020-07-10","27","1637","7","168","31","19.5"
"Peach","2020-07-11","18","1655","3","171","26.2","20.7"
"Peach","2020-07-12","14","1669","5","176","21.8","22.7"
"Peach","2020-07-13","45","1714","7","183","21.3","23.1"
"Peach","2020-07-14","32","1746","4","187","19.3","22.9"
"Peach","2020-07-15","67","1813","9","196","19.1","23.2"
"Peach","2020-07-16","31","1844","1","197","17.6","23"
"Peach","2020-07-17","25","1869","5","202","16.7","23.9"
"Peach","2020-07-18","9","1878","2","204","17.5","21.9"
"Peach","2020-07-19","17","1895","3","207","14.9","18.4"
"Peach","2020-07-20","48","1943","12","219","16.3","18.8"
"Peach","2020-07-21","27","1970","4","223","16.6","18"
"Peach","2020-07-22","88","2058","19","242","17.8","18.4"
"Peach","2020-07-23","27","2085","4","246","19.4","18.5"
"Peach","2020-07-24","37","2122","4","250","18.1","17.4"
"Peach","2020-07-25","13","2135","2","252","17.2","17.3"
"Peach","2020-07-26","8","2143","1","253","16.4","15.7"
"Peach","2020-07-27","40","2183","11","264","16.8","16.5"
"Peach","2020-07-28","33","2216","8","272","18.1","17.4"
"Peach","2020-07-29","83","2299","9","281","16.6","17.2"
"Peach","2020-07-30","39","2338","9","290","17.8","18.6"
"Peach","2020-07-31","32","2370","9","299","20.2","19.2"
"Peach","2020-08-01","9","2379","6","305","27.6","22.4"
"Peach","2020-08-02","19","2398","3","308","28","22.2"
"Peach","2020-08-03","69","2467","9","317","26","21.4"
"Peach","2020-08-04","32","2499","3","320","23.8","21"
"Peach","2020-08-05","96","2595","10","330","23.8","20.2"
"Peach","2020-08-06","31","2626","6","336","23.3","20.5"
"Peach","2020-08-07","24","2650","4","340","21.6","20.9"
"Peach","2020-08-08","9","2659","2","342","15.3","21.4"
"Peach","2020-08-09","10","2669","1","343","14.4","21.2"
"Peach","2020-08-10","30","2699","8","351","16.4","21.2"
"Peach","2020-08-11","29","2728","8","359","19","21.4"
"Peach","2020-08-12","68","2796","11","370","19.8","21.8"
"Peach","2020-08-13","25","2821","7","377","21","22.1"
"Peach","2020-08-14","29","2850","9","386","23.1","22.4"
"Peach","2020-08-15","9","2859","3","389","24.7","20"
"Peach","2020-08-16","19","2878","4","393","26.3","20.4"
"Peach","2020-08-17","28","2906","6","399","25.5","21"
"Peach","2020-08-18","19","2925","5","404","25.3","22.2"
"Peach","2020-08-19","66","2991","4","408","23.9","21.8"
"Peach","2020-08-20","33","3024","4","412","21.6","21.3"
"Peach","2020-08-21","84","3108","8","420","18.5","20.8"
"Peach","2020-08-22","12","3120","1","421","15","19.8"
"Peach","2020-08-23","14","3134","4","425","16.1","21.2"
"Peach","2020-08-24","14","3148","1","426","14","19.8"
"Peach","2020-08-25","34","3182","3","429","11.5","18.4"
"Peach","2020-08-26","60","3242","7","436","12.3","18.1"
"Peach","2020-08-27","15","3257","1","437","11.5","16.6"
"Peach","2020-08-28","25","3282","2","439","11.3","14.9"
"Peach","2020-08-29","17","3299","2","441","11.8","13.4"
"Peach","2020-08-30","5","3304","1","442","10.6","13.3"
"Peach","2020-08-31","28","3332","3","445","11.1","12.6"
"Peach","2020-09-01","36","3368","6","451","12.2","11.9"
"Peach","2020-09-02","26","3394","3","454","12.2","12.3"
"Peach","2020-09-03","20","3414","3","457","13.4","12.5"
"Peach","2020-09-04","30","3444","4","461","14.1","12.7"
"Peach","2020-09-05","5","3449","1","462","15.3","13.6"
"Peach","2020-09-06","7","3456","0","462","12.5","11.5"
"Peach","2020-09-07","10","3466","3","465","15.2","13.2"
"Peach","2020-09-08","22","3488","5","470","16.1","14.1"
"Peach","2020-09-09","37","3525","5","475","16.4","14.3"
"Peach","2020-09-10","27","3552","0","475","14.2","13.8"
"Peach","2020-09-11","25","3577","0","475","12.3","13.2"
"Peach","2020-09-12","19","3596","4","479","12.5","13.9"
"Peach","2020-09-13","16","3612","2","481","14.3","13.4"
"Peach","2020-09-14","21","3633","3","484","12","13.6"
"Peach","2020-09-15","31","3664","2","486","9.7","12.9"
"Peach","2020-09-16","43","3707","3","489","8.8","12.6"
"Peach","2020-09-17","24","3731","1","490","9.3","11.8"
"Peach","2020-09-18","36","3767","3","493","10.5","11.4"
"Peach","2020-09-19","8","3775","1","494","9.3","10.9"
"Peach","2020-09-20","5","3780","0","494","7.5","10.9"
"Peach","2020-09-21","26","3806","4","498","7.7","9.8"
"Peach","2020-09-22","15","3821","2","500","8.7","9.2"
"Peach","2020-09-23","30","3851","3","503","9.1","8.9"
"Peach","2020-09-24","20","3871","2","505","9.9","9.6"
"Peach","2020-09-25","24","3895","1","506","9.3","9.9"
"Peach","2020-09-26","8","3903","0","506","7.6","8.4"
"Peach","2020-09-27","5","3908","0","506","7.6","7.5"
"Peach","2020-09-28","19","3927","4","510","8.4","8"
"Peach","2020-09-29","24","3951","2","512","7.7","8.2"
"Peach","2020-09-30","33","3984","1","513","6.7","7.9"
"Peach","2020-10-01","29","4013","1","514","5.7","7.8"
"Peach","2020-10-02","27","4040","2","516","6.2","7.8"
"Peach","2020-10-03","5","4045","0","516","6.2","6.9"
"Peach","2020-10-04","13","4058","0","516","6.2","6.9"
"Peach","2020-10-05","32","4090","1","517","3.6","6"
"Peach","2020-10-06","32","4122","5","522","4.7","6.2"
"Peach","2020-10-07","32","4154","2","524","5.1","5.9"
"Peach","2020-10-08","17","4171","1","525","5.5","5.6"
"Peach","2020-10-09","26","4197","3","528","6.1","6.1"
"Peach","2020-10-10","10","4207","0","528","6.1","6.1"
"Peach","2020-10-11","8","4215","1","529","7.8","7"
"Peach","2020-10-12","26","4241","5","534","10.1","6.9"
"Peach","2020-10-13","36","4277","2","536","8.7","6.7"
"Peach","2020-10-14","24","4301","0","536","7.8","6.5"
"Peach","2020-10-15","33","4334","5","541","9.1","7.3"
"Peach","2020-10-16","18","4352","1","542","8.3","7.2"
"Peach","2020-10-17","8","4360","2","544","11.9","9"
"Peach","2020-10-18","7","4367","3","547","16.2","12"
"Peach","2020-10-19","33","4400","2","549","14.3","12.2"
"Peach","2020-10-20","24","4424","3","552","15.3","12"
"Peach","2020-10-21","51","4475","7","559","17.3","12.5"
"Peach","2020-10-22","34","4509","5","564","17.2","13.2"
"Peach","2020-10-23","29","4538","4","568","18.4","13.3"
"Peach","2020-10-24","12","4550","0","568","14.8","13.3"
"Peach","2020-10-25","10","4560","2","570","11.5","13.9"
"Peach","2020-10-26","43","4603","10","580","14","14.2"
"Peach","2020-10-27","23","4626","2","582","13.5","14.4"
"Peach","2020-10-28","48","4674","8","590","13.9","15.6"
"Peach","2020-10-29","32","4706","3","593","13.1","15.2"
"Peach","2020-10-30","43","4749","7","600","13.5","15.9"
"Peach","2020-10-31","22","4771","0","600","13.5","14.1"
"Peach","2020-11-01","9","4780","2","602","13.8","12.7"
"Peach","2020-11-02","34","4814","3","605","11.7","12.9"
"Peach","2020-11-03","23","4837","5","610","13.6","13.5"
"Peach","2020-11-04","53","4890","7","617","13.1","13.5"
"Peach","2020-11-05","23","4913","1","618","12.4","12.7"
"Peach","2020-11-06","31","4944","4","622","11.9","12.7"
"Peach","2020-11-07","14","4958","3","625","15","14.2"
"Peach","2020-11-08","9","4967","4","629","18.1","16"
"Peach","2020-11-09","44","5011","9","638","19.8","15.8"
"Peach","2020-11-10","37","5048","4","642","18.2","15.9"
"Peach","2020-11-11","38","5086","5","647","18.2","15.7"
"Peach","2020-11-12","34","5120","3","650","18.9","15.6"
"Peach","2020-11-13","24","5144","4","654","19.4","15.6"
"Peach","2020-11-14","17","5161","3","657","18.9","16.9"
"Peach","2020-11-15","14","5175","2","659","14.5","16.3"
"Peach","2020-11-16","36","5211","3","662","12.8","16.3"
"Peach","2020-11-17","45","5256","5","667","12.9","15.5"
"Peach","2020-11-18","55","5311","8","675","13.1","15.6"
"Peach","2020-11-19","41","5352","7","682","14.2","16.5"
"Peach","2020-11-20","38","5390","4","686","13.4","16.4"
"Peach","2020-11-21","18","5408","4","690","14","16.4"
"Peach","2020-11-22","15","5423","0","690","12","13.3"
"Peach","2020-11-23","28","5451","1","691","11.3","12.1"
"Peach","2020-11-24","49","5500","10","701","12.6","12.7"
"Peach","2020-11-25","51","5551","10","711","13.3","13.2"
"Peach","2020-11-26","2","5553","1","712","18","16.1"
"Peach","2020-11-27","32","5585","3","715","17.9","15.6"
"Peach","2020-11-28","21","5606","4","719","17.4","15.7"
"Peach","2020-11-29","25","5631","4","723","19.7","15.8"
"Peach","2020-11-30","52","5683","12","735","22.5","16.9"
"Peach","2020-12-01","35","5718","5","740","21.6","17.1"
"Peach","2020-12-02","52","5770","6","746","20.5","16.9"
"Peach","2020-12-03","40","5810","5","751","15.1","16.6"
"Peach","2020-12-04","52","5862","5","756","15.2","16.5"
"Peach","2020-12-05","30","5892","5","761","14.8","16.1"
"Peach","2020-12-06","23","5915","2","763","13.8","16.7"
"Peach","2020-12-07","47","5962","6","769","12.3","17.4"
"Peach","2020-12-08","37","5999","4","773","11.8","16.7"
"Peach","2020-12-09","51","6050","12","785","13.5","17"
"Peach","2020-12-10","41","6091","2","787","12.4","13.8"
"Peach","2020-12-11","31","6122","5","792","13.4","14.3"
"Peach","2020-12-12","27","6149","3","795","12.6","13.7"
"Peach","2020-12-13","14","6163","3","798","14.4","14.1"
"Peach","2020-12-14","39","6202","8","806","15.5","13.9"
"Peach","2020-12-15","43","6245","6","812","15.9","13.9"
"Peach","2020-12-16","72","6317","18","830","16.1","14.8"
"Peach","2020-12-17","60","6377","13","843","18.5","15.5"
"Peach","2020-12-18","48","6425","3","846","17.1","15.2"
"Peach","2020-12-19","41","6466","6","852","17.6","15.1"
"Peach","2020-12-20","40","6506","10","862","18.1","16.3"
"Peach","2020-12-21","43","6549","9","871","18.2","16.8"
"Peach","2020-12-22","36","6585","15","886","22.2","19"
"Peach","2020-12-23","88","6673","19","905","21.7","18.9"
"Peach","2020-12-24","27","6700","12","917","24.9","21.7"
"Peach","2020-12-25","9","6709","3","920","28.8","23"
"Peach","2020-12-26","33","6742","8","928","30.2","23.9"
"Peach","2020-12-27","31","6773","9","937","30.7","24.4"
"Peach","2020-12-28","85","6858","26","963","32.1","25.2"
"Peach","2020-12-29","66","6924","16","979","29.6","25.9"
"Peach","2020-12-30","47","6971","17","996","31.7","26.7"
"Peach","2020-12-31","53","7024","10","1006","28.1","26.5"
"Peach","2021-01-01","16","7040","5","1011","27.8","28.3"
"Peach","2021-01-02","22","7062","10","1021","30.8","30.5"
"Peach","2021-01-03","27","7089","6","1027","29.8","30.3"
"Peach","2021-01-04","60","7149","18","1045","29.7","30.9"
"Peach","2021-01-05","91","7240","20","1065","29.4","29.5"
"Peach","2021-01-06","85","7325","18","1083","27.3","29.5"
"Peach","2021-01-07","67","7392","13","1096","27.4","27.7"
"Peach","2021-01-08","52","7444","8","1104","25.1","26.4"
"Peach","2021-01-09","38","7482","12","1116","23.1","27"
"Peach","2021-01-10","40","7522","7","1123","22.4","26.1"
"Peach","2021-01-11","74","7596","8","1131","19.7","24.7"
"Peach","2021-01-12","73","7669","19","1150","20.3","24.8"
"Peach","2021-01-13","66","7735","11","1161","19.6","23.5"
"Peach","2021-01-14","49","7784","7","1168","18.9","23.1"
"Peach","2021-01-15","58","7842","15","1183","20.4","22.7"
"Peach","2021-01-16","27","7869","7","1190","19.6","21.3"
"Peach","2021-01-17","18","7887","7","1197","22.6","22.5"
"Peach","2021-01-18","53","7940","8","1205","23.3","21.5"
"Peach","2021-01-19","65","8005","10","1215","21.7","21"
"Peach","2021-01-20","67","8072","21","1236","23.8","21.7"
"Peach","2021-01-21","55","8127","13","1249","25.2","22"
"Peach","2021-01-22","62","8189","11","1260","24","22.2"
"Peach","2021-01-23","21","8210","2","1262","21.7","20.6"
"Peach","2021-01-24","29","8239","5","1267","18.6","20.6"
"Peach","2021-01-25","59","8298","13","1280","19.6","21.4"
"Peach","2021-01-26","50","8348","9","1289","19.9","20.8"
"Peach","2021-01-27","73","8421","18","1307","19","21.4"
"Peach","2021-01-28","58","8479","9","1316","17.8","21.5"
"Peach","2021-01-29","60","8539","11","1327","17.9","21"
"Peach","2021-01-30","29","8568","4","1331","18.5","20.1"
"Peach","2021-01-31","14","8582","6","1337","22.2","20.4"
"Peach","2021-02-01","29","8611","5","1342","21.5","20.5"
"Peach","2021-02-02","45","8656","10","1352","22.1","21"
"Peach","2021-02-03","48","8704","5","1357","20.1","19.5"
"Peach","2021-02-04","26","8730","3","1360","19.5","18.7"
"Peach","2021-02-05","31","8761","4","1364","18.7","18.3"
"Peach","2021-02-06","6","8767","1","1365","19.1","18.8"
"Peach","2021-02-07","1","8768","0","1365","13","17.6"
"Peach","2021-02-08","0","8768","0","1365","10.5","16"
"Pickens","2020-02-01","0","0","0","0",".","."
"Pickens","2020-02-02","0","0","0","0",".","."
"Pickens","2020-02-03","0","0","0","0",".","."
"Pickens","2020-02-04","0","0","0","0",".","."
"Pickens","2020-02-05","0","0","0","0",".","."
"Pickens","2020-02-06","0","0","0","0",".","."
"Pickens","2020-02-07","0","0","0","0","0","."
"Pickens","2020-02-08","0","0","0","0","0","."
"Pickens","2020-02-09","0","0","0","0","0","."
"Pickens","2020-02-10","0","0","0","0","0","."
"Pickens","2020-02-11","0","0","0","0","0","."
"Pickens","2020-02-12","0","0","0","0","0","."
"Pickens","2020-02-13","0","0","0","0","0","."
"Pickens","2020-02-14","0","0","0","0","0","0"
"Pickens","2020-02-15","0","0","0","0","0","0"
"Pickens","2020-02-16","0","0","0","0","0","0"
"Pickens","2020-02-17","0","0","0","0","0","0"
"Pickens","2020-02-18","0","0","0","0","0","0"
"Pickens","2020-02-19","0","0","0","0","0","0"
"Pickens","2020-02-20","0","0","0","0","0","0"
"Pickens","2020-02-21","0","0","0","0","0","0"
"Pickens","2020-02-22","0","0","0","0","0","0"
"Pickens","2020-02-23","0","0","0","0","0","0"
"Pickens","2020-02-24","0","0","0","0","0","0"
"Pickens","2020-02-25","0","0","0","0","0","0"
"Pickens","2020-02-26","0","0","0","0","0","0"
"Pickens","2020-02-27","0","0","0","0","0","0"
"Pickens","2020-02-28","0","0","0","0","0","0"
"Pickens","2020-02-29","0","0","0","0","0","0"
"Pickens","2020-03-01","0","0","0","0","0","0"
"Pickens","2020-03-02","0","0","0","0","0","0"
"Pickens","2020-03-03","0","0","0","0","0","0"
"Pickens","2020-03-04","0","0","0","0","0","0"
"Pickens","2020-03-05","0","0","0","0","0","0"
"Pickens","2020-03-06","0","0","0","0","0","0"
"Pickens","2020-03-07","0","0","0","0","0","0"
"Pickens","2020-03-08","0","0","0","0","0","0"
"Pickens","2020-03-09","0","0","0","0","0","0"
"Pickens","2020-03-10","0","0","0","0","0","0"
"Pickens","2020-03-11","0","0","0","0","0","0"
"Pickens","2020-03-12","0","0","0","0","0","0"
"Pickens","2020-03-13","1","1","0","0","0","0"
"Pickens","2020-03-14","0","1","0","0","0","0"
"Pickens","2020-03-15","0","1","0","0","0","0"
"Pickens","2020-03-16","1","2","0","0","0","0"
"Pickens","2020-03-17","5","7","0","0","0","0"
"Pickens","2020-03-18","2","9","1","1","7.1","3.6"
"Pickens","2020-03-19","1","10","0","1","7.1","3.6"
"Pickens","2020-03-20","4","14","1","2","10.7","5.4"
"Pickens","2020-03-21","1","15","0","2","10.7","5.4"
"Pickens","2020-03-22","3","18","1","3","15.5","7.7"
"Pickens","2020-03-23","8","26","0","3","15.5","7.7"
"Pickens","2020-03-24","8","34","1","4","17.3","8.6"
"Pickens","2020-03-25","6","40","0","4","10.1","8.6"
"Pickens","2020-03-26","9","49","0","4","10.1","8.6"
"Pickens","2020-03-27","4","53","0","4","6.5","8.6"
"Pickens","2020-03-28","3","56","0","4","6.5","8.6"
"Pickens","2020-03-29","3","59","0","4","1.8","8.6"
"Pickens","2020-03-30","10","69","1","5","3.2","9.3"
"Pickens","2020-03-31","3","72","1","6","6.2","11.7"
"Pickens","2020-04-01","10","82","1","7","7.6","8.9"
"Pickens","2020-04-02","10","92","0","7","7.6","8.9"
"Pickens","2020-04-03","2","94","0","7","7.6","7.1"
"Pickens","2020-04-04","0","94","0","7","7.6","7.1"
"Pickens","2020-04-05","0","94","0","7","7.6","4.7"
"Pickens","2020-04-06","16","110","1","8","7.1","5.1"
"Pickens","2020-04-07","4","114","0","8","2.3","4.3"
"Pickens","2020-04-08","14","128","4","12","5","6.3"
"Pickens","2020-04-09","8","136","0","12","5","6.3"
"Pickens","2020-04-10","12","148","1","13","6.2","6.9"
"Pickens","2020-04-11","3","151","0","13","6.2","6.9"
"Pickens","2020-04-12","1","152","0","13","6.2","6.9"
"Pickens","2020-04-13","10","162","0","13","5.3","6.2"
"Pickens","2020-04-14","7","169","0","13","5.3","3.8"
"Pickens","2020-04-15","4","173","0","13","1.2","3.1"
"Pickens","2020-04-16","6","179","0","13","1.2","3.1"
"Pickens","2020-04-17","18","197","0","13","0","3.1"
"Pickens","2020-04-18","4","201","0","13","0","3.1"
"Pickens","2020-04-19","0","201","0","13","0","3.1"
"Pickens","2020-04-20","8","209","0","13","0","2.6"
"Pickens","2020-04-21","8","217","0","13","0","2.6"
"Pickens","2020-04-22","10","227","0","13","0","0.6"
"Pickens","2020-04-23","5","232","0","13","0","0.6"
"Pickens","2020-04-24","13","245","1","14","1.1","0.5"
"Pickens","2020-04-25","11","256","0","14","1.1","0.5"
"Pickens","2020-04-26","2","258","0","14","1.1","0.5"
"Pickens","2020-04-27","5","263","0","14","1.1","0.5"
"Pickens","2020-04-28","16","279","1","15","2","1"
"Pickens","2020-04-29","24","303","0","15","2","1"
"Pickens","2020-04-30","19","322","0","15","2","1"
"Pickens","2020-05-01","4","326","0","15","0.9","1"
"Pickens","2020-05-02","11","337","0","15","0.9","1"
"Pickens","2020-05-03","15","352","0","15","0.9","1"
"Pickens","2020-05-04","24","376","0","15","0.9","1"
"Pickens","2020-05-05","30","406","2","17","1","1.5"
"Pickens","2020-05-06","66","472","3","20","1.6","1.8"
"Pickens","2020-05-07","36","508","3","23","2.8","2.4"
"Pickens","2020-05-08","26","534","0","23","2.8","1.8"
"Pickens","2020-05-09","5","539","0","23","2.8","1.8"
"Pickens","2020-05-10","12","551","0","23","2.8","1.8"
"Pickens","2020-05-11","25","576","1","24","3.4","2.1"
"Pickens","2020-05-12","37","613","1","25","2.8","1.9"
"Pickens","2020-05-13","42","655","0","25","2.1","1.9"
"Pickens","2020-05-14","25","680","1","26","1.5","2.2"
"Pickens","2020-05-15","44","724","0","26","1.5","2.2"
"Pickens","2020-05-16","5","729","0","26","1.5","2.2"
"Pickens","2020-05-17","14","743","0","26","1.5","2.2"
"Pickens","2020-05-18","17","760","0","26","1","2.2"
"Pickens","2020-05-19","42","802","0","26","0.6","1.7"
"Pickens","2020-05-20","118","920","2","28","0.8","1.5"
"Pickens","2020-05-21","47","967","0","28","0.2","0.9"
"Pickens","2020-05-22","29","996","0","28","0.2","0.9"
"Pickens","2020-05-23","13","1009","0","28","0.2","0.9"
"Pickens","2020-05-24","15","1024","0","28","0.2","0.9"
"Pickens","2020-05-25","11","1035","0","28","0.2","0.6"
"Pickens","2020-05-26","39","1074","1","29","0.6","0.6"
"Pickens","2020-05-27","72","1146","2","31","0.8","0.8"
"Pickens","2020-05-28","23","1169","0","31","0.8","0.5"
"Pickens","2020-05-29","43","1212","0","31","0.8","0.5"
"Pickens","2020-05-30","13","1225","0","31","0.8","0.5"
"Pickens","2020-05-31","17","1242","0","31","0.8","0.5"
"Pickens","2020-06-01","33","1275","1","32","1.2","0.7"
"Pickens","2020-06-02","50","1325","0","32","0.8","0.7"
"Pickens","2020-06-03","76","1401","4","36","1.2","1"
"Pickens","2020-06-04","41","1442","1","37","1.5","1.1"
"Pickens","2020-06-05","35","1477","1","38","1.9","1.4"
"Pickens","2020-06-06","19","1496","2","40","3.4","2.1"
"Pickens","2020-06-07","17","1513","0","40","3.4","2.1"
"Pickens","2020-06-08","42","1555","7","47","5.4","3.3"
"Pickens","2020-06-09","33","1588","1","48","5.8","3.3"
"Pickens","2020-06-10","75","1663","3","51","5.6","3.4"
"Pickens","2020-06-11","43","1706","1","52","5.6","3.6"
"Pickens","2020-06-12","51","1757","3","55","6.1","4"
"Pickens","2020-06-13","7","1764","0","55","4.6","4"
"Pickens","2020-06-14","21","1785","0","55","4.6","4"
"Pickens","2020-06-15","23","1808","3","58","4","4.7"
"Pickens","2020-06-16","49","1857","0","58","3.6","4.7"
"Pickens","2020-06-17","24","1881","0","58","3","4.3"
"Pickens","2020-06-18","22","1903","0","58","2.7","4.2"
"Pickens","2020-06-19","32","1935","3","61","3.2","4.6"
"Pickens","2020-06-20","6","1941","0","61","3.2","3.9"
"Pickens","2020-06-21","9","1950","0","61","3.2","3.9"
"Pickens","2020-06-22","29","1979","0","61","1.3","2.7"
"Pickens","2020-06-23","28","2007","0","61","1.3","2.5"
"Pickens","2020-06-24","38","2045","3","64","2.5","2.8"
"Pickens","2020-06-25","17","2062","0","64","2.5","2.6"
"Pickens","2020-06-26","42","2104","0","64","1.1","2.2"
"Pickens","2020-06-27","20","2124","1","65","1.8","2.5"
"Pickens","2020-06-28","17","2141","0","65","1.8","2.5"
"Pickens","2020-06-29","42","2183","1","66","2.2","1.8"
"Pickens","2020-06-30","31","2214","0","66","2.2","1.8"
"Pickens","2020-07-01","36","2250","3","69","2.2","2.4"
"Pickens","2020-07-02","46","2296","1","70","2.6","2.5"
"Pickens","2020-07-03","21","2317","2","72","3.9","2.5"
"Pickens","2020-07-04","16","2333","0","72","3.2","2.5"
"Pickens","2020-07-05","24","2357","0","72","3.2","2.5"
"Pickens","2020-07-06","88","2445","6","78","3.8","3"
"Pickens","2020-07-07","59","2504","4","82","4.8","3.5"
"Pickens","2020-07-08","64","2568","4","86","4.5","3.4"
"Pickens","2020-07-09","58","2626","5","91","5.4","4"
"Pickens","2020-07-10","63","2689","6","97","5.4","4.7"
"Pickens","2020-07-11","11","2700","1","98","6.7","5"
"Pickens","2020-07-12","15","2715","2","100","8.6","5.9"
"Pickens","2020-07-13","80","2795","11","111","9.6","6.7"
"Pickens","2020-07-14","60","2855","15","126","12.2","8.5"
"Pickens","2020-07-15","66","2921","12","138","13.9","9.2"
"Pickens","2020-07-16","54","2975","1","139","13","9.2"
"Pickens","2020-07-17","51","3026","9","148","14.1","9.8"
"Pickens","2020-07-18","24","3050","3","151","14.6","10.7"
"Pickens","2020-07-19","11","3061","0","151","12.7","10.7"
"Pickens","2020-07-20","51","3112","11","162","13.8","11.7"
"Pickens","2020-07-21","46","3158","6","168","12.1","12.2"
"Pickens","2020-07-22","47","3205","2","170","10.1","12"
"Pickens","2020-07-23","81","3286","3","173","10.4","11.7"
"Pickens","2020-07-24","56","3342","7","180","9.7","11.9"
"Pickens","2020-07-25","21","3363","2","182","9.2","11.9"
"Pickens","2020-07-26","15","3378","3","185","12.1","12.4"
"Pickens","2020-07-27","82","3460","20","205","12.5","13.2"
"Pickens","2020-07-28","57","3517","9","214","12.9","12.5"
"Pickens","2020-07-29","60","3577","6","220","13.7","11.9"
"Pickens","2020-07-30","73","3650","8","228","14.7","12.6"
"Pickens","2020-07-31","67","3717","9","237","14.9","12.3"
"Pickens","2020-08-01","21","3738","4","241","16.2","12.7"
"Pickens","2020-08-02","16","3754","3","244","16.1","14.1"
"Pickens","2020-08-03","72","3826","4","248","13.4","12.9"
"Pickens","2020-08-04","48","3874","5","253","12.6","12.7"
"Pickens","2020-08-05","48","3922","2","255","11.8","12.7"
"Pickens","2020-08-06","32","3954","0","255","10.2","12.5"
"Pickens","2020-08-07","47","4001","6","261","10.1","12.5"
"Pickens","2020-08-08","20","4021","4","265","10.2","13.2"
"Pickens","2020-08-09","77","4098","11","276","9.6","12.8"
"Pickens","2020-08-10","83","4181","7","283","10","11.7"
"Pickens","2020-08-11","47","4228","3","286","9.4","11"
"Pickens","2020-08-12","34","4262","3","289","10.1","10.9"
"Pickens","2020-08-13","46","4308","4","293","11.3","10.8"
"Pickens","2020-08-14","65","4373","4","297","10.4","10.2"
"Pickens","2020-08-15","23","4396","0","297","7.5","8.9"
"Pickens","2020-08-16","38","4434","1","298","5.9","7.7"
"Pickens","2020-08-17","52","4486","2","300","5.2","7.6"
"Pickens","2020-08-18","34","4520","2","302","5.1","7.3"
"Pickens","2020-08-19","53","4573","4","306","5","7.5"
"Pickens","2020-08-20","44","4617","8","314","6.3","8.8"
"Pickens","2020-08-21","53","4670","2","316","6","8.2"
"Pickens","2020-08-22","17","4687","2","318","7.7","7.6"
"Pickens","2020-08-23","29","4716","2","320","8.3","7.1"
"Pickens","2020-08-24","64","4780","4","324","8.6","6.9"
"Pickens","2020-08-25","46","4826","5","329","9.3","7.2"
"Pickens","2020-08-26","61","4887","3","332","9","7"
"Pickens","2020-08-27","55","4942","3","335","7.1","6.7"
"Pickens","2020-08-28","56","4998","6","341","8.1","7.1"
"Pickens","2020-08-29","21","5019","3","344","8.5","8.1"
"Pickens","2020-08-30","18","5037","0","344","7.5","7.9"
"Pickens","2020-08-31","52","5089","1","345","6.9","7.7"
"Pickens","2020-09-01","50","5139","2","347","5.9","7.6"
"Pickens","2020-09-02","48","5187","3","350","6.1","7.5"
"Pickens","2020-09-03","63","5250","3","353","6","6.6"
"Pickens","2020-09-04","76","5326","7","360","5.8","6.9"
"Pickens","2020-09-05","50","5376","4","364","4.9","6.7"
"Pickens","2020-09-06","33","5409","2","366","5.7","6.6"
"Pickens","2020-09-07","9","5418","2","368","8.6","7.8"
"Pickens","2020-09-08","77","5495","2","370","8.4","7.2"
"Pickens","2020-09-09","49","5544","5","375","9","7.5"
"Pickens","2020-09-10","44","5588","3","378","9.3","7.6"
"Pickens","2020-09-11","33","5621","4","382","9.7","7.7"
"Pickens","2020-09-12","18","5639","1","383","9.4","7.1"
"Pickens","2020-09-13","22","5661","6","389","12.4","9.1"
"Pickens","2020-09-14","44","5705","1","390","9.5","9.1"
"Pickens","2020-09-15","123","5828","3","393","9.5","9"
"Pickens","2020-09-16","52","5880","2","395","8.6","8.8"
"Pickens","2020-09-17","50","5930","6","401","9.4","9.3"
"Pickens","2020-09-18","44","5974","3","404","8.6","9.2"
"Pickens","2020-09-19","24","5998","0","404","7.8","8.6"
"Pickens","2020-09-20","14","6012","1","405","4.9","8.7"
"Pickens","2020-09-21","29","6041","1","406","5.1","7.3"
"Pickens","2020-09-22","45","6086","0","406","4.8","7.1"
"Pickens","2020-09-23","48","6134","3","409","5.1","6.9"
"Pickens","2020-09-24","49","6183","3","412","4.3","6.8"
"Pickens","2020-09-25","45","6228","0","412","3.3","5.9"
"Pickens","2020-09-26","29","6257","0","412","3.3","5.5"
"Pickens","2020-09-27","12","6269","2","414","4.6","4.8"
"Pickens","2020-09-28","50","6319","1","415","4.4","4.8"
"Pickens","2020-09-29","57","6376","4","419","5.4","5.1"
"Pickens","2020-09-30","46","6422","0","419","4.5","4.8"
"Pickens","2020-10-01","61","6483","2","421","4.1","4.2"
"Pickens","2020-10-02","68","6551","2","423","4.6","3.9"
"Pickens","2020-10-03","48","6599","2","425","5.2","4.2"
"Pickens","2020-10-04","18","6617","2","427","4.4","4.5"
"Pickens","2020-10-05","57","6674","1","428","4.3","4.4"
"Pickens","2020-10-06","99","6773","3","431","3.8","4.6"
"Pickens","2020-10-07","98","6871","3","434","4.2","4.4"
"Pickens","2020-10-08","43","6914","2","436","4.4","4.3"
"Pickens","2020-10-09","80","6994","7","443","5.2","4.9"
"Pickens","2020-10-10","34","7028","3","446","5.9","5.5"
"Pickens","2020-10-11","9","7037","1","447","5.9","5.1"
"Pickens","2020-10-12","50","7087","3","450","6.5","5.4"
"Pickens","2020-10-13","50","7137","3","453","6.9","5.3"
"Pickens","2020-10-14","93","7230","5","458","7.2","5.7"
"Pickens","2020-10-15","49","7279","2","460","7.2","5.8"
"Pickens","2020-10-16","60","7339","1","461","6.2","5.7"
"Pickens","2020-10-17","26","7365","4","465","7.1","6.5"
"Pickens","2020-10-18","27","7392","8","473","9.7","7.8"
"Pickens","2020-10-19","48","7440","8","481","11.3","8.9"
"Pickens","2020-10-20","57","7497","3","484","11.2","9"
"Pickens","2020-10-21","83","7580","3","487","10.9","9.1"
"Pickens","2020-10-22","45","7625","6","493","12.2","9.7"
"Pickens","2020-10-23","68","7693","6","499","13.2","9.7"
"Pickens","2020-10-24","31","7724","3","502","12.4","9.8"
"Pickens","2020-10-25","15","7739","0","502","8.2","9"
"Pickens","2020-10-26","75","7814","9","511","7.5","9.4"
"Pickens","2020-10-27","102","7916","8","519","7.9","9.5"
"Pickens","2020-10-28","60","7976","3","522","8.1","9.5"
"Pickens","2020-10-29","60","8036","3","525","6.9","9.6"
"Pickens","2020-10-30","66","8102","6","531","6.9","10.1"
"Pickens","2020-10-31","18","8120","3","534","7.9","10.2"
"Pickens","2020-11-01","18","8138","3","537","10.3","9.3"
"Pickens","2020-11-02","51","8189","4","541","9.7","8.6"
"Pickens","2020-11-03","63","8252","6","547","10","8.9"
"Pickens","2020-11-04","43","8295","9","556","12.2","10.2"
"Pickens","2020-11-05","66","8361","2","558","12","9.4"
"Pickens","2020-11-06","89","8450","5","563","11.5","9.2"
"Pickens","2020-11-07","27","8477","4","567","11.2","9.6"
"Pickens","2020-11-08","20","8497","4","571","11.7","11"
"Pickens","2020-11-09","57","8554","6","577","12.1","10.9"
"Pickens","2020-11-10","46","8600","1","578","11","10.5"
"Pickens","2020-11-11","40","8640","3","581","9.1","10.7"
"Pickens","2020-11-12","86","8726","12","593","10.7","11.3"
"Pickens","2020-11-13","54","8780","6","599","11.4","11.5"
"Pickens","2020-11-14","60","8840","3","602","10","10.6"
"Pickens","2020-11-15","33","8873","2","604","8","9.9"
"Pickens","2020-11-16","61","8934","5","609","7.7","9.9"
"Pickens","2020-11-17","44","8978","8","617","10","10.5"
"Pickens","2020-11-18","62","9040","7","624","10.5","9.8"
"Pickens","2020-11-19","70","9110","6","630","9.8","10.2"
"Pickens","2020-11-20","79","9189","6","636","9.3","10.4"
"Pickens","2020-11-21","42","9231","2","638","9.2","9.6"
"Pickens","2020-11-22","24","9255","0","638","8.4","8.2"
"Pickens","2020-11-23","54","9309","11","649","10.1","8.9"
"Pickens","2020-11-24","64","9373","7","656","9.1","9.5"
"Pickens","2020-11-25","51","9424","8","664","9.7","10.1"
"Pickens","2020-11-26","17","9441","3","667","11","10.4"
"Pickens","2020-11-27","74","9515","14","681","12.6","10.9"
"Pickens","2020-11-28","39","9554","9","690","15.2","12.2"
"Pickens","2020-11-29","27","9581","3","693","16.8","12.6"
"Pickens","2020-11-30","99","9680","21","714","16.9","13.5"
"Pickens","2020-12-01","76","9756","11","725","17.4","13.3"
"Pickens","2020-12-02","53","9809","7","732","17.1","13.4"
"Pickens","2020-12-03","62","9871","10","742","16.9","13.9"
"Pickens","2020-12-04","79","9950","14","756","16.7","14.7"
"Pickens","2020-12-05","38","9988","6","762","15.7","15.4"
"Pickens","2020-12-06","37","10025","9","771","17.6","17.2"
"Pickens","2020-12-07","99","10124","26","797","18.3","17.6"
"Pickens","2020-12-08","113","10237","16","813","18.2","17.8"
"Pickens","2020-12-09","68","10305","8","821","18","17.6"
"Pickens","2020-12-10","135","10440","13","834","17.1","17"
"Pickens","2020-12-11","76","10516","8","842","16.1","16.4"
"Pickens","2020-12-12","26","10542","4","846","16","15.8"
"Pickens","2020-12-13","37","10579","15","861","18.3","17.9"
"Pickens","2020-12-14","70","10649","17","878","18","18.2"
"Pickens","2020-12-15","150","10799","14","892","17.4","17.8"
"Pickens","2020-12-16","71","10870","14","906","18.5","18.3"
"Pickens","2020-12-17","87","10957","19","925","20.2","18.7"
"Pickens","2020-12-18","86","11043","9","934","20.2","18.1"
"Pickens","2020-12-19","43","11086","8","942","20.7","18.3"
"Pickens","2020-12-20","45","11131","15","957","19.7","19"
"Pickens","2020-12-21","91","11222","18","975","19","18.5"
"Pickens","2020-12-22","144","11366","23","998","20","18.7"
"Pickens","2020-12-23","92","11458","19","1017","20.1","19.3"
"Pickens","2020-12-24","95","11553","13","1030","18.9","19.6"
"Pickens","2020-12-25","14","11567","3","1033","20.5","20.4"
"Pickens","2020-12-26","61","11628","21","1054","22.8","21.7"
"Pickens","2020-12-27","42","11670","18","1072","24.1","21.9"
"Pickens","2020-12-28","94","11764","30","1102","25.8","22.4"
"Pickens","2020-12-29","177","11941","39","1141","26.7","23.3"
"Pickens","2020-12-30","96","12037","32","1173","28.5","24.3"
"Pickens","2020-12-31","81","12118","17","1190","29.6","24.2"
"Pickens","2021-01-01","30","12148","10","1200","31.3","25.9"
"Pickens","2021-01-02","36","12184","14","1214","31.9","27.3"
"Pickens","2021-01-03","38","12222","16","1230","31.8","28"
"Pickens","2021-01-04","63","12285","16","1246","30.9","28.4"
"Pickens","2021-01-05","96","12381","26","1272","31.6","29.2"
"Pickens","2021-01-06","124","12505","42","1314","31.7","30.1"
"Pickens","2021-01-07","136","12641","31","1345","31.9","30.7"
"Pickens","2021-01-08","147","12788","25","1370","29.6","30.4"
"Pickens","2021-01-09","35","12823","11","1381","28.5","30.2"
"Pickens","2021-01-10","32","12855","15","1396","29.2","30.5"
"Pickens","2021-01-11","132","12987","13","1409","27","28.9"
"Pickens","2021-01-12","74","13061","20","1429","27","29.3"
"Pickens","2021-01-13","88","13149","17","1446","24.9","28.3"
"Pickens","2021-01-14","92","13241","18","1464","24.4","28.2"
"Pickens","2021-01-15","97","13338","13","1477","23.9","26.8"
"Pickens","2021-01-16","43","13381","10","1487","22.8","25.6"
"Pickens","2021-01-17","24","13405","6","1493","19.6","24.4"
"Pickens","2021-01-18","146","13551","18","1511","20","23.5"
"Pickens","2021-01-19","76","13627","14","1525","18.8","22.9"
"Pickens","2021-01-20","84","13711","11","1536","17.9","21.4"
"Pickens","2021-01-21","105","13816","26","1562","18.6","21.5"
"Pickens","2021-01-22","108","13924","17","1579","18.9","21.4"
"Pickens","2021-01-23","56","13980","9","1588","17.9","20.3"
"Pickens","2021-01-24","31","14011","6","1594","17.1","18.4"
"Pickens","2021-01-25","162","14173","19","1613","17","18.5"
"Pickens","2021-01-26","94","14267","17","1630","17","17.9"
"Pickens","2021-01-27","95","14362","10","1640","16.6","17.2"
"Pickens","2021-01-28","80","14442","12","1652","15.2","16.9"
"Pickens","2021-01-29","106","14548","5","1657","13.6","16.3"
"Pickens","2021-01-30","34","14582","8","1665","14.7","16.3"
"Pickens","2021-01-31","29","14611","10","1675","16.9","17"
"Pickens","2021-02-01","156","14767","18","1693","16.8","16.9"
"Pickens","2021-02-02","88","14855","13","1706","16.4","16.7"
"Pickens","2021-02-03","91","14946","8","1714","16.1","16.4"
"Pickens","2021-02-04","56","15002","7","1721","15.8","15.5"
"Pickens","2021-02-05","60","15062","8","1729","17","15.3"
"Pickens","2021-02-06","8","15070","2","1731","17.2","16"
"Pickens","2021-02-07","1","15071","0","1731","12.3","14.6"
"Pickens","2021-02-08","0","15071","0","1731","10.6","13.7"
"Pierce","2020-02-01","0","0","0","0",".","."
"Pierce","2020-02-02","0","0","0","0",".","."
"Pierce","2020-02-03","0","0","0","0",".","."
"Pierce","2020-02-04","0","0","0","0",".","."
"Pierce","2020-02-05","0","0","0","0",".","."
"Pierce","2020-02-06","0","0","0","0",".","."
"Pierce","2020-02-07","0","0","0","0","0","."
"Pierce","2020-02-08","0","0","0","0","0","."
"Pierce","2020-02-09","0","0","0","0","0","."
"Pierce","2020-02-10","0","0","0","0","0","."
"Pierce","2020-02-11","0","0","0","0","0","."
"Pierce","2020-02-12","0","0","0","0","0","."
"Pierce","2020-02-13","0","0","0","0","0","."
"Pierce","2020-02-14","0","0","0","0","0","0"
"Pierce","2020-02-15","0","0","0","0","0","0"
"Pierce","2020-02-16","0","0","0","0","0","0"
"Pierce","2020-02-17","0","0","0","0","0","0"
"Pierce","2020-02-18","0","0","0","0","0","0"
"Pierce","2020-02-19","0","0","0","0","0","0"
"Pierce","2020-02-20","0","0","0","0","0","0"
"Pierce","2020-02-21","0","0","0","0","0","0"
"Pierce","2020-02-22","0","0","0","0","0","0"
"Pierce","2020-02-23","0","0","0","0","0","0"
"Pierce","2020-02-24","0","0","0","0","0","0"
"Pierce","2020-02-25","0","0","0","0","0","0"
"Pierce","2020-02-26","0","0","0","0","0","0"
"Pierce","2020-02-27","0","0","0","0","0","0"
"Pierce","2020-02-28","0","0","0","0","0","0"
"Pierce","2020-02-29","0","0","0","0","0","0"
"Pierce","2020-03-01","0","0","0","0","0","0"
"Pierce","2020-03-02","0","0","0","0","0","0"
"Pierce","2020-03-03","0","0","0","0","0","0"
"Pierce","2020-03-04","0","0","0","0","0","0"
"Pierce","2020-03-05","0","0","0","0","0","0"
"Pierce","2020-03-06","0","0","0","0","0","0"
"Pierce","2020-03-07","0","0","0","0","0","0"
"Pierce","2020-03-08","0","0","0","0","0","0"
"Pierce","2020-03-09","0","0","0","0","0","0"
"Pierce","2020-03-10","0","0","0","0","0","0"
"Pierce","2020-03-11","0","0","0","0","0","0"
"Pierce","2020-03-12","0","0","0","0","0","0"
"Pierce","2020-03-13","0","0","0","0","0","0"
"Pierce","2020-03-14","0","0","0","0","0","0"
"Pierce","2020-03-15","0","0","0","0","0","0"
"Pierce","2020-03-16","7","7","0","0","0","0"
"Pierce","2020-03-17","13","20","0","0","0","0"
"Pierce","2020-03-18","2","22","1","1","7.1","3.6"
"Pierce","2020-03-19","4","26","0","1","7.1","3.6"
"Pierce","2020-03-20","2","28","0","1","7.1","3.6"
"Pierce","2020-03-21","2","30","0","1","7.1","3.6"
"Pierce","2020-03-22","3","33","1","2","11.9","6"
"Pierce","2020-03-23","7","40","1","3","13.9","7"
"Pierce","2020-03-24","5","45","2","5","19.7","9.8"
"Pierce","2020-03-25","6","51","2","7","17.3","12.2"
"Pierce","2020-03-26","10","61","4","11","23","15.1"
"Pierce","2020-03-27","8","69","3","14","28.4","17.7"
"Pierce","2020-03-28","0","69","0","14","28.4","17.7"
"Pierce","2020-03-29","0","69","0","14","23.6","17.7"
"Pierce","2020-03-30","6","75","1","15","23.9","18.9"
"Pierce","2020-03-31","4","79","2","17","25.4","22.5"
"Pierce","2020-04-01","8","87","1","18","22.4","19.8"
"Pierce","2020-04-02","6","93","3","21","23.8","23.4"
"Pierce","2020-04-03","6","99","0","21","18.5","23.4"
"Pierce","2020-04-04","3","102","2","23","28","28.2"
"Pierce","2020-04-05","0","102","0","23","28","25.8"
"Pierce","2020-04-06","12","114","3","26","29.2","26.5"
"Pierce","2020-04-07","7","121","0","26","22","23.7"
"Pierce","2020-04-08","7","128","1","27","22.3","22.3"
"Pierce","2020-04-09","3","131","2","29","24.7","24.2"
"Pierce","2020-04-10","4","135","0","29","24.7","21.6"
"Pierce","2020-04-11","4","139","1","30","18.7","23.3"
"Pierce","2020-04-12","0","139","0","30","18.7","23.3"
"Pierce","2020-04-13","5","144","0","30","15.1","22.2"
"Pierce","2020-04-14","7","151","0","30","15.1","18.6"
"Pierce","2020-04-15","8","159","0","30","13.1","17.7"
"Pierce","2020-04-16","7","166","0","30","3.6","14.1"
"Pierce","2020-04-17","15","181","2","32","5.5","15.1"
"Pierce","2020-04-18","0","181","0","32","1.9","10.3"
"Pierce","2020-04-19","5","186","0","32","1.9","10.3"
"Pierce","2020-04-20","7","193","0","32","1.9","8.5"
"Pierce","2020-04-21","1","194","0","32","1.9","8.5"
"Pierce","2020-04-22","12","206","0","32","1.9","7.5"
"Pierce","2020-04-23","2","208","0","32","1.9","2.7"
"Pierce","2020-04-24","4","212","0","32","0","2.7"
"Pierce","2020-04-25","0","212","0","32","0","1"
"Pierce","2020-04-26","0","212","0","32","0","1"
"Pierce","2020-04-27","4","216","0","32","0","1"
"Pierce","2020-04-28","11","227","0","32","0","1"
"Pierce","2020-04-29","15","242","1","33","1","1.4"
"Pierce","2020-04-30","7","249","1","34","3","2.4"
"Pierce","2020-05-01","4","253","0","34","3","1.5"
"Pierce","2020-05-02","1","254","0","34","3","1.5"
"Pierce","2020-05-03","0","254","0","34","3","1.5"
"Pierce","2020-05-04","10","264","0","34","3","1.5"
"Pierce","2020-05-05","9","273","0","34","3","1.5"
"Pierce","2020-05-06","7","280","0","34","2","1.5"
"Pierce","2020-05-07","8","288","1","35","1.8","2.4"
"Pierce","2020-05-08","1","289","0","35","1.8","2.4"
"Pierce","2020-05-09","3","292","1","36","6.5","4.8"
"Pierce","2020-05-10","0","292","0","36","6.5","4.8"
"Pierce","2020-05-11","14","306","0","36","6.5","4.8"
"Pierce","2020-05-12","11","317","3","39","10.4","6.7"
"Pierce","2020-05-13","15","332","0","39","10.4","6.2"
"Pierce","2020-05-14","10","342","3","42","12.9","7.4"
"Pierce","2020-05-15","7","349","0","42","12.9","7.4"
"Pierce","2020-05-16","4","353","2","44","15.3","10.9"
"Pierce","2020-05-17","1","354","0","44","15.3","10.9"
"Pierce","2020-05-18","18","372","1","45","16.1","11.3"
"Pierce","2020-05-19","14","386","4","49","16.3","13.4"
"Pierce","2020-05-20","21","407","2","51","17.7","14.1"
"Pierce","2020-05-21","21","428","3","54","15.4","14.2"
"Pierce","2020-05-22","5","433","0","54","15.4","14.2"
"Pierce","2020-05-23","2","435","0","54","8.3","11.8"
"Pierce","2020-05-24","0","435","0","54","8.3","11.8"
"Pierce","2020-05-25","2","437","1","55","14.6","15.4"
"Pierce","2020-05-26","26","463","4","59","12.7","14.5"
"Pierce","2020-05-27","20","483","0","59","11.4","14.5"
"Pierce","2020-05-28","30","513","2","61","10.3","12.9"
"Pierce","2020-05-29","7","520","2","63","14.4","14.9"
"Pierce","2020-05-30","2","522","0","63","14.4","11.3"
"Pierce","2020-05-31","1","523","0","63","14.4","11.3"
"Pierce","2020-06-01","19","542","3","66","9.5","12.1"
"Pierce","2020-06-02","10","552","3","69","11.6","12.2"
"Pierce","2020-06-03","22","574","5","74","14.8","13.1"
"Pierce","2020-06-04","36","610","1","75","14.3","12.3"
"Pierce","2020-06-05","16","626","0","75","10.2","12.3"
"Pierce","2020-06-06","0","626","0","75","10.2","12.3"
"Pierce","2020-06-07","3","629","0","75","10.2","12.3"
"Pierce","2020-06-08","28","657","1","76","8.4","9"
"Pierce","2020-06-09","25","682","0","76","4.2","7.9"
"Pierce","2020-06-10","23","705","2","78","2.1","8.5"
"Pierce","2020-06-11","44","749","0","78","1.8","8"
"Pierce","2020-06-12","21","770","1","79","2.4","6.3"
"Pierce","2020-06-13","4","774","0","79","2.4","6.3"
"Pierce","2020-06-14","1","775","0","79","2.4","6.3"
"Pierce","2020-06-15","34","809","3","82","3.2","5.8"
"Pierce","2020-06-16","31","840","3","85","4.6","4.4"
"Pierce","2020-06-17","35","875","2","87","4.1","3.1"
"Pierce","2020-06-18","40","915","0","87","4.1","2.9"
"Pierce","2020-06-19","18","933","4","91","6.6","4.5"
"Pierce","2020-06-20","3","936","1","92","11.4","6.9"
"Pierce","2020-06-21","2","938","1","93","18.5","10.5"
"Pierce","2020-06-22","35","973","6","99","19.7","11.5"
"Pierce","2020-06-23","47","1020","7","106","20.5","12.5"
"Pierce","2020-06-24","20","1040","3","109","21.8","13"
"Pierce","2020-06-25","74","1114","5","114","22.8","13.5"
"Pierce","2020-06-26","54","1168","5","119","20.9","13.8"
"Pierce","2020-06-27","13","1181","3","122","19.4","15.4"
"Pierce","2020-06-28","9","1190","1","123","13.9","16.2"
"Pierce","2020-06-29","39","1229","5","128","13.3","16.5"
"Pierce","2020-06-30","59","1288","13","141","14.3","17.4"
"Pierce","2020-07-01","31","1319","7","148","15.4","18.6"
"Pierce","2020-07-02","58","1377","4","152","15.4","19.1"
"Pierce","2020-07-03","34","1411","4","156","15.8","18.3"
"Pierce","2020-07-04","8","1419","3","159","17.8","18.6"
"Pierce","2020-07-05","6","1425","3","162","23.4","18.6"
"Pierce","2020-07-06","30","1455","5","167","23.9","18.6"
"Pierce","2020-07-07","51","1506","10","177","23.6","18.9"
"Pierce","2020-07-08","29","1535","7","184","23.8","19.6"
"Pierce","2020-07-09","81","1616","12","196","24.9","20.2"
"Pierce","2020-07-10","11","1627","2","198","25.8","20.8"
"Pierce","2020-07-11","5","1632","2","200","26.2","22"
"Pierce","2020-07-12","5","1637","1","201","21.9","22.6"
"Pierce","2020-07-13","32","1669","7","208","22.7","23.3"
"Pierce","2020-07-14","14","1683","2","210","21.9","22.7"
"Pierce","2020-07-15","30","1713","1","211","18.9","21.4"
"Pierce","2020-07-16","39","1752","2","213","17.5","21.2"
"Pierce","2020-07-17","28","1780","1","214","15.5","20.7"
"Pierce","2020-07-18","7","1787","2","216","13.8","20"
"Pierce","2020-07-19","1","1788","0","216","11","16.4"
"Pierce","2020-07-20","29","1817","4","220","9.8","16.2"
"Pierce","2020-07-21","16","1833","5","225","12.2","17.1"
"Pierce","2020-07-22","40","1873","1","226","12.1","15.5"
"Pierce","2020-07-23","14","1887","2","228","13.4","15.5"
"Pierce","2020-07-24","17","1904","2","230","14.6","15"
"Pierce","2020-07-25","5","1909","1","231","13.4","13.6"
"Pierce","2020-07-26","6","1915","0","231","13.4","12.2"
"Pierce","2020-07-27","46","1961","4","235","12.6","11.2"
"Pierce","2020-07-28","40","2001","4","239","9.6","10.9"
"Pierce","2020-07-29","26","2027","2","241","10.3","11.2"
"Pierce","2020-07-30","28","2055","3","244","9.8","11.6"
"Pierce","2020-07-31","4","2059","0","244","8.2","11.4"
"Pierce","2020-08-01","17","2076","1","245","6.1","9.8"
"Pierce","2020-08-02","10","2086","1","246","7.6","10.5"
"Pierce","2020-08-03","43","2129","1","247","6.7","9.7"
"Pierce","2020-08-04","32","2161","3","250","6.6","8.1"
"Pierce","2020-08-05","28","2189","3","253","7","8.7"
"Pierce","2020-08-06","20","2209","2","255","6.9","8.4"
"Pierce","2020-08-07","9","2218","0","255","6.9","7.5"
"Pierce","2020-08-08","7","2225","0","255","6.1","6.1"
"Pierce","2020-08-09","5","2230","1","256","7.5","7.5"
"Pierce","2020-08-10","50","2280","2","258","7.7","7.2"
"Pierce","2020-08-11","42","2322","7","265","8.8","7.7"
"Pierce","2020-08-12","41","2363","4","269","8.6","7.8"
"Pierce","2020-08-13","27","2390","1","270","7.7","7.3"
"Pierce","2020-08-14","50","2440","27","297","15.4","11.2"
"Pierce","2020-08-15","10","2450","2","299","18.3","12.2"
"Pierce","2020-08-16","1","2451","0","299","15.4","11.5"
"Pierce","2020-08-17","39","2490","2","301","15.6","11.7"
"Pierce","2020-08-18","35","2525","5","306","15.3","12"
"Pierce","2020-08-19","39","2564","7","313","16.4","12.5"
"Pierce","2020-08-20","13","2577","3","316","19.2","13.5"
"Pierce","2020-08-21","14","2591","3","319","14.6","15"
"Pierce","2020-08-22","5","2596","2","321","17.4","17.9"
"Pierce","2020-08-23","3","2599","0","321","17.4","16.4"
"Pierce","2020-08-24","36","2635","3","324","17.9","16.7"
"Pierce","2020-08-25","36","2671","0","324","15.8","15.5"
"Pierce","2020-08-26","26","2697","3","327","14.9","15.7"
"Pierce","2020-08-27","16","2713","2","329","13.4","16.3"
"Pierce","2020-08-28","10","2723","0","329","10.3","12.4"
"Pierce","2020-08-29","5","2728","1","330","7.5","12.4"
"Pierce","2020-08-30","14","2742","1","331","8.5","13"
"Pierce","2020-08-31","45","2787","6","337","9.2","13.5"
"Pierce","2020-09-01","41","2828","2","339","9.9","12.9"
"Pierce","2020-09-02","41","2869","0","339","8.3","11.6"
"Pierce","2020-09-03","16","2885","0","339","6.5","9.9"
"Pierce","2020-09-04","15","2900","2","341","8.4","9.4"
"Pierce","2020-09-05","7","2907","0","341","5.5","6.5"
"Pierce","2020-09-06","12","2919","3","344","8.1","8.3"
"Pierce","2020-09-07","28","2947","2","346","7.2","8.2"
"Pierce","2020-09-08","67","3014","4","350","7.3","8.6"
"Pierce","2020-09-09","34","3048","5","355","9.5","8.9"
"Pierce","2020-09-10","29","3077","4","359","11.4","8.9"
"Pierce","2020-09-11","23","3100","3","362","11.4","9.9"
"Pierce","2020-09-12","6","3106","1","363","13.8","9.6"
"Pierce","2020-09-13","10","3116","1","364","11.6","9.8"
"Pierce","2020-09-14","44","3160","1","365","10.9","9.1"
"Pierce","2020-09-15","47","3207","2","367","10.7","9"
"Pierce","2020-09-16","47","3254","2","369","9.2","9.3"
"Pierce","2020-09-17","27","3281","2","371","8.3","9.8"
"Pierce","2020-09-18","18","3299","0","371","6.4","8.9"
"Pierce","2020-09-19","5","3304","0","371","4","8.9"
"Pierce","2020-09-20","2","3306","0","371","2.6","7.1"
"Pierce","2020-09-21","47","3353","1","372","2.6","6.7"
"Pierce","2020-09-22","43","3396","2","374","2.6","6.7"
"Pierce","2020-09-23","31","3427","1","375","2.5","5.8"
"Pierce","2020-09-24","15","3442","1","376","2.4","5.3"
"Pierce","2020-09-25","15","3457","0","376","2.4","4.4"
"Pierce","2020-09-26","7","3464","0","376","2.4","3.2"
"Pierce","2020-09-27","8","3472","1","377","4.2","3.4"
"Pierce","2020-09-28","46","3518","3","380","4.8","3.7"
"Pierce","2020-09-29","53","3571","1","381","4.4","3.5"
"Pierce","2020-09-30","24","3595","0","381","3.9","3.2"
"Pierce","2020-10-01","13","3608","0","381","3","2.7"
"Pierce","2020-10-02","19","3627","0","381","3","2.7"
"Pierce","2020-10-03","5","3632","0","381","3","2.7"
"Pierce","2020-10-04","9","3641","0","381","1.2","2.7"
"Pierce","2020-10-05","54","3695","0","381","0.3","2.5"
"Pierce","2020-10-06","47","3742","0","381","0","2.2"
"Pierce","2020-10-07","37","3779","3","384","1.2","2.5"
"Pierce","2020-10-08","48","3827","0","384","1.2","2.1"
"Pierce","2020-10-09","25","3852","0","384","1.2","2.1"
"Pierce","2020-10-10","8","3860","0","384","1.2","2.1"
"Pierce","2020-10-11","2","3862","0","384","1.2","1.2"
"Pierce","2020-10-12","49","3911","1","385","1.4","0.9"
"Pierce","2020-10-13","44","3955","2","387","2.1","1"
"Pierce","2020-10-14","21","3976","1","388","1.6","1.4"
"Pierce","2020-10-15","19","3995","1","389","2.4","1.8"
"Pierce","2020-10-16","39","4034","4","393","3.8","2.5"
"Pierce","2020-10-17","9","4043","1","394","5.4","3.3"
"Pierce","2020-10-18","33","4076","3","397","6.7","3.9"
"Pierce","2020-10-19","67","4143","3","400","7.1","4.3"
"Pierce","2020-10-20","50","4193","2","402","7","4.5"
"Pierce","2020-10-21","26","4219","3","405","8","4.8"
"Pierce","2020-10-22","18","4237","5","410","11.2","6.8"
"Pierce","2020-10-23","46","4283","1","411","10","6.9"
"Pierce","2020-10-24","28","4311","0","411","8.4","6.9"
"Pierce","2020-10-25","10","4321","3","414","11.4","9.1"
"Pierce","2020-10-26","73","4394","2","416","11.2","9.1"
"Pierce","2020-10-27","29","4423","2","418","11.6","9.3"
"Pierce","2020-10-28","33","4456","2","420","10.8","9.4"
"Pierce","2020-10-29","44","4500","5","425","8.5","9.8"
"Pierce","2020-10-30","40","4540","4","429","9.6","9.8"
"Pierce","2020-10-31","43","4583","0","429","9.6","9"
"Pierce","2020-11-01","7","4590","1","430","7.3","9.4"
"Pierce","2020-11-02","53","4643","1","431","7.2","9.2"
"Pierce","2020-11-03","44","4687","3","434","7.2","9.4"
"Pierce","2020-11-04","37","4724","3","437","7.5","9.2"
"Pierce","2020-11-05","31","4755","4","441","7.7","8.1"
"Pierce","2020-11-06","19","4774","1","442","7","8.3"
"Pierce","2020-11-07","38","4812","2","444","7.8","8.7"
"Pierce","2020-11-08","4","4816","0","444","5.7","6.5"
"Pierce","2020-11-09","58","4874","0","444","5.5","6.3"
"Pierce","2020-11-10","28","4902","0","444","4.5","5.9"
"Pierce","2020-11-11","37","4939","2","446","4.1","5.8"
"Pierce","2020-11-12","28","4967","2","448","3.3","5.5"
"Pierce","2020-11-13","17","4984","1","449","3.4","5.2"
"Pierce","2020-11-14","8","4992","0","449","2.6","5.2"
"Pierce","2020-11-15","4","4996","0","449","2.6","4.2"
"Pierce","2020-11-16","55","5051","1","450","2.9","4.2"
"Pierce","2020-11-17","87","5138","1","451","3.1","3.8"
"Pierce","2020-11-18","26","5164","2","453","3.4","3.8"
"Pierce","2020-11-19","17","5181","0","453","2.4","2.8"
"Pierce","2020-11-20","13","5194","0","453","1.5","2.5"
"Pierce","2020-11-21","9","5203","0","453","1.5","2.1"
"Pierce","2020-11-22","55","5258","0","453","1.5","2.1"
"Pierce","2020-11-23","64","5322","4","457","2.2","2.5"
"Pierce","2020-11-24","35","5357","1","458","2.4","2.7"
"Pierce","2020-11-25","48","5405","1","459","1.6","2.5"
"Pierce","2020-11-26","14","5419","0","459","1.6","2"
"Pierce","2020-11-27","13","5432","2","461","3.8","2.7"
"Pierce","2020-11-28","9","5441","1","462","5.4","3.5"
"Pierce","2020-11-29","28","5469","1","463","5.9","3.7"
"Pierce","2020-11-30","56","5525","1","464","5.3","3.7"
"Pierce","2020-12-01","54","5579","4","468","5.9","4.2"
"Pierce","2020-12-02","19","5598","3","471","7.9","4.7"
"Pierce","2020-12-03","18","5616","1","472","8.7","5.1"
"Pierce","2020-12-04","11","5627","0","472","6.5","5.1"
"Pierce","2020-12-05","9","5636","1","473","6.5","5.9"
"Pierce","2020-12-06","7","5643","4","477","14.1","10"
"Pierce","2020-12-07","65","5708","4","481","14.7","10"
"Pierce","2020-12-08","49","5757","2","483","14.3","10.1"
"Pierce","2020-12-09","37","5794","6","489","14.3","11.1"
"Pierce","2020-12-10","30","5824","3","492","15","11.8"
"Pierce","2020-12-11","29","5853","3","495","16.4","11.4"
"Pierce","2020-12-12","7","5860","0","495","14.8","10.7"
"Pierce","2020-12-13","10","5870","1","496","8.1","11.1"
"Pierce","2020-12-14","67","5937","4","500","8.1","11.4"
"Pierce","2020-12-15","47","5984","6","506","9.3","11.8"
"Pierce","2020-12-16","36","6020","4","510","8.6","11.5"
"Pierce","2020-12-17","29","6049","3","513","8.6","11.8"
"Pierce","2020-12-18","19","6068","4","517","10.2","13.3"
"Pierce","2020-12-19","67","6135","5","522","11.2","13"
"Pierce","2020-12-20","13","6148","2","524","12","10.1"
"Pierce","2020-12-21","76","6224","10","534","13","10.6"
"Pierce","2020-12-22","45","6269","3","537","12.2","10.7"
"Pierce","2020-12-23","41","6310","8","545","13.4","11"
"Pierce","2020-12-24","24","6334","4","549","14.3","11.5"
"Pierce","2020-12-25","7","6341","5","554","21.5","15.8"
"Pierce","2020-12-26","64","6405","5","559","21.5","16.4"
"Pierce","2020-12-27","18","6423","2","561","20.9","16.5"
"Pierce","2020-12-28","79","6502","10","571","20.8","16.9"
"Pierce","2020-12-29","57","6559","9","580","22.1","17.2"
"Pierce","2020-12-30","38","6597","4","584","20.9","17.1"
"Pierce","2020-12-31","16","6613","3","587","21.2","17.7"
"Pierce","2021-01-01","10","6623","6","593","19.5","20.5"
"Pierce","2021-01-02","18","6641","6","599","23.2","22.3"
"Pierce","2021-01-03","63","6704","4","603","22.5","21.7"
"Pierce","2021-01-04","89","6793","10","613","22.3","21.6"
"Pierce","2021-01-05","72","6865","17","630","23.4","22.8"
"Pierce","2021-01-06","24","6889","5","635","24.9","22.9"
"Pierce","2021-01-07","73","6962","7","642","23.6","22.4"
"Pierce","2021-01-08","64","7026","13","655","17.9","18.7"
"Pierce","2021-01-09","50","7076","3","658","14","18.6"
"Pierce","2021-01-10","12","7088","6","664","20.2","21.4"
"Pierce","2021-01-11","80","7168","11","675","20.6","21.4"
"Pierce","2021-01-12","56","7224","10","685","19.8","21.6"
"Pierce","2021-01-13","39","7263","5","690","18.6","21.7"
"Pierce","2021-01-14","75","7338","8","698","18.8","21.2"
"Pierce","2021-01-15","85","7423","6","704","16.9","17.4"
"Pierce","2021-01-16","12","7435","1","705","17.2","15.6"
"Pierce","2021-01-17","7","7442","2","707","14.2","17.2"
"Pierce","2021-01-18","75","7517","11","718","14.3","17.4"
"Pierce","2021-01-19","48","7565","7","725","13.8","16.8"
"Pierce","2021-01-20","48","7613","7","732","14.1","16.3"
"Pierce","2021-01-21","90","7703","10","742","14.1","16.5"
"Pierce","2021-01-22","56","7759","3","745","13.9","15.4"
"Pierce","2021-01-23","40","7799","5","750","14.5","15.8"
"Pierce","2021-01-24","8","7807","0","750","10.4","12.3"
"Pierce","2021-01-25","68","7875","7","757","9.8","12"
"Pierce","2021-01-26","59","7934","5","762","8.9","11.4"
"Pierce","2021-01-27","21","7955","4","766","9.5","11.8"
"Pierce","2021-01-28","109","8064","3","769","8.3","11.2"
"Pierce","2021-01-29","50","8114","5","774","9","11.4"
"Pierce","2021-01-30","9","8123","2","776","10.4","12.4"
"Pierce","2021-01-31","9","8132","0","776","10.4","10.4"
"Pierce","2021-02-01","59","8191","5","781","10.1","10"
"Pierce","2021-02-02","47","8238","2","783","9.5","9.2"
"Pierce","2021-02-03","24","8262","3","786","8.6","9.1"
"Pierce","2021-02-04","101","8363","2","788","8.5","8.4"
"Pierce","2021-02-05","30","8393","1","789","7.5","8.3"
"Pierce","2021-02-06","10","8403","2","791","7.2","8.8"
"Pierce","2021-02-07","0","8403","0","791","7.2","8.8"
"Pierce","2021-02-08","0","8403","0","791","6","8.1"
"Pike","2020-02-01","0","0","0","0",".","."
"Pike","2020-02-02","0","0","0","0",".","."
"Pike","2020-02-03","0","0","0","0",".","."
"Pike","2020-02-04","0","0","0","0",".","."
"Pike","2020-02-05","0","0","0","0",".","."
"Pike","2020-02-06","0","0","0","0",".","."
"Pike","2020-02-07","0","0","0","0","0","."
"Pike","2020-02-08","0","0","0","0","0","."
"Pike","2020-02-09","0","0","0","0","0","."
"Pike","2020-02-10","0","0","0","0","0","."
"Pike","2020-02-11","0","0","0","0","0","."
"Pike","2020-02-12","0","0","0","0","0","."
"Pike","2020-02-13","0","0","0","0","0","."
"Pike","2020-02-14","0","0","0","0","0","0"
"Pike","2020-02-15","0","0","0","0","0","0"
"Pike","2020-02-16","0","0","0","0","0","0"
"Pike","2020-02-17","0","0","0","0","0","0"
"Pike","2020-02-18","0","0","0","0","0","0"
"Pike","2020-02-19","0","0","0","0","0","0"
"Pike","2020-02-20","0","0","0","0","0","0"
"Pike","2020-02-21","0","0","0","0","0","0"
"Pike","2020-02-22","0","0","0","0","0","0"
"Pike","2020-02-23","0","0","0","0","0","0"
"Pike","2020-02-24","0","0","0","0","0","0"
"Pike","2020-02-25","0","0","0","0","0","0"
"Pike","2020-02-26","0","0","0","0","0","0"
"Pike","2020-02-27","0","0","0","0","0","0"
"Pike","2020-02-28","0","0","0","0","0","0"
"Pike","2020-02-29","0","0","0","0","0","0"
"Pike","2020-03-01","0","0","0","0","0","0"
"Pike","2020-03-02","0","0","0","0","0","0"
"Pike","2020-03-03","0","0","0","0","0","0"
"Pike","2020-03-04","0","0","0","0","0","0"
"Pike","2020-03-05","0","0","0","0","0","0"
"Pike","2020-03-06","0","0","0","0","0","0"
"Pike","2020-03-07","0","0","0","0","0","0"
"Pike","2020-03-08","0","0","0","0","0","0"
"Pike","2020-03-09","0","0","0","0","0","0"
"Pike","2020-03-10","1","1","0","0","0","0"
"Pike","2020-03-11","0","1","0","0","0","0"
"Pike","2020-03-12","0","1","0","0","0","0"
"Pike","2020-03-13","1","2","0","0","0","0"
"Pike","2020-03-14","0","2","0","0","0","0"
"Pike","2020-03-15","0","2","0","0","0","0"
"Pike","2020-03-16","4","6","0","0","0","0"
"Pike","2020-03-17","0","6","0","0","0","0"
"Pike","2020-03-18","5","11","0","0","0","0"
"Pike","2020-03-19","12","23","1","1","1.2","0.6"
"Pike","2020-03-20","5","28","0","1","1.2","0.6"
"Pike","2020-03-21","3","31","1","2","6","3"
"Pike","2020-03-22","4","35","1","3","9.5","4.8"
"Pike","2020-03-23","16","51","3","6","12.2","6.1"
"Pike","2020-03-24","4","55","0","6","12.2","6.1"
"Pike","2020-03-25","8","63","0","6","12.2","6.1"
"Pike","2020-03-26","4","67","1","7","14.6","7.9"
"Pike","2020-03-27","11","78","1","8","15.9","8.5"
"Pike","2020-03-28","5","83","0","8","11.1","8.5"
"Pike","2020-03-29","6","89","0","8","7.5","8.5"
"Pike","2020-03-30","13","102","1","9","6","9.1"
"Pike","2020-03-31","5","107","0","9","6","9.1"
"Pike","2020-04-01","6","113","1","10","8.3","10.3"
"Pike","2020-04-02","6","119","0","10","4.8","9.7"
"Pike","2020-04-03","5","124","1","11","6.3","11.1"
"Pike","2020-04-04","3","127","0","11","6.3","8.7"
"Pike","2020-04-05","1","128","0","11","6.3","6.9"
"Pike","2020-04-06","16","144","1","12","6.1","6"
"Pike","2020-04-07","7","151","0","12","6.1","6"
"Pike","2020-04-08","9","160","1","13","5.3","6.8"
"Pike","2020-04-09","10","170","3","16","9.6","7.2"
"Pike","2020-04-10","2","172","0","16","6.8","6.6"
"Pike","2020-04-11","4","176","1","17","10.3","8.3"
"Pike","2020-04-12","5","181","2","19","16.1","11.2"
"Pike","2020-04-13","8","189","3","22","20.5","13.3"
"Pike","2020-04-14","7","196","0","22","20.5","13.3"
"Pike","2020-04-15","17","213","0","22","18.9","12.1"
"Pike","2020-04-16","9","222","1","23","16.2","12.9"
"Pike","2020-04-17","8","230","0","23","16.2","11.5"
"Pike","2020-04-18","4","234","1","24","16.2","13.3"
"Pike","2020-04-19","2","236","1","25","17.7","16.9"
"Pike","2020-04-20","25","261","0","25","12.3","16.4"
"Pike","2020-04-21","27","288","1","26","12.8","16.7"
"Pike","2020-04-22","35","323","3","29","14.1","16.5"
"Pike","2020-04-23","10","333","0","29","12.5","14.3"
"Pike","2020-04-24","19","352","0","29","12.5","14.3"
"Pike","2020-04-25","3","355","0","29","8.9","12.6"
"Pike","2020-04-26","5","360","0","29","1.8","9.7"
"Pike","2020-04-27","20","380","0","29","1.8","7"
"Pike","2020-04-28","14","394","0","29","1.2","7"
"Pike","2020-04-29","14","408","0","29","0","7"
"Pike","2020-04-30","9","417","0","29","0","6.2"
"Pike","2020-05-01","12","429","0","29","0","6.2"
"Pike","2020-05-02","4","433","0","29","0","4.4"
"Pike","2020-05-03","3","436","0","29","0","0.9"
"Pike","2020-05-04","14","450","1","30","1","1.4"
"Pike","2020-05-05","3","453","0","30","1","1.1"
"Pike","2020-05-06","10","463","3","33","5.3","2.7"
"Pike","2020-05-07","7","470","0","33","5.3","2.7"
"Pike","2020-05-08","12","482","1","34","6.5","3.2"
"Pike","2020-05-09","5","487","1","35","9.4","4.7"
"Pike","2020-05-10","4","491","1","36","12.9","6.5"
"Pike","2020-05-11","13","504","1","37","13","7"
"Pike","2020-05-12","14","518","1","38","14","7.5"
"Pike","2020-05-13","10","528","0","38","9.7","7.5"
"Pike","2020-05-14","20","548","1","39","10.5","7.9"
"Pike","2020-05-15","14","562","1","40","10.3","8.4"
"Pike","2020-05-16","10","572","1","41","8.9","9.1"
"Pike","2020-05-17","4","576","0","41","5.3","9.1"
"Pike","2020-05-18","19","595","3","44","6.4","9.7"
"Pike","2020-05-19","106","701","5","49","6.1","10.1"
"Pike","2020-05-20","14","715","1","50","7.1","8.4"
"Pike","2020-05-21","13","728","2","52","8.6","9.5"
"Pike","2020-05-22","9","737","2","54","10.8","10.5"
"Pike","2020-05-23","5","742","0","54","9.3","9.1"
"Pike","2020-05-24","1","743","0","54","9.3","7.3"
"Pike","2020-05-25","3","746","0","54","7.1","6.8"
"Pike","2020-05-26","10","756","1","55","7.8","7"
"Pike","2020-05-27","20","776","2","57","8.2","7.7"
"Pike","2020-05-28","10","786","1","58","7.5","8"
"Pike","2020-05-29","6","792","0","58","4.3","7.5"
"Pike","2020-05-30","7","799","0","58","4.3","6.8"
"Pike","2020-05-31","3","802","0","58","4.3","6.8"
"Pike","2020-06-01","13","815","1","59","5.4","6.2"
"Pike","2020-06-02","15","830","2","61","5.9","6.8"
"Pike","2020-06-03","10","840","1","62","5.9","7"
"Pike","2020-06-04","12","852","0","62","4.4","5.9"
"Pike","2020-06-05","22","874","1","63","5.1","4.7"
"Pike","2020-06-06","10","884","0","63","5.1","4.7"
"Pike","2020-06-07","7","891","0","63","5.1","4.7"
"Pike","2020-06-08","23","914","1","64","4.6","5"
"Pike","2020-06-09","10","924","0","64","2.7","4.3"
"Pike","2020-06-10","15","939","2","66","3.2","4.5"
"Pike","2020-06-11","20","959","5","71","6.7","5.6"
"Pike","2020-06-12","17","976","5","76","10.3","7.7"
"Pike","2020-06-13","4","980","1","77","13.9","9.5"
"Pike","2020-06-14","4","984","1","78","17.4","11.3"
"Pike","2020-06-15","21","1005","3","81","18.9","11.7"
"Pike","2020-06-16","19","1024","1","82","19.6","11.2"
"Pike","2020-06-17","20","1044","2","84","19.1","11.2"
"Pike","2020-06-18","27","1071","1","85","16.1","11.4"
"Pike","2020-06-19","10","1081","0","85","11.9","11.1"
"Pike","2020-06-20","7","1088","1","86","10.4","12.1"
"Pike","2020-06-21","1","1089","0","86","6.8","12.1"
"Pike","2020-06-22","31","1120","3","89","6.1","12.5"
"Pike","2020-06-23","15","1135","0","89","5.4","12.5"
"Pike","2020-06-24","18","1153","2","91","5.5","12.3"
"Pike","2020-06-25","12","1165","1","92","6.2","11.1"
"Pike","2020-06-26","15","1180","1","93","7.2","9.5"
"Pike","2020-06-27","9","1189","1","94","6.7","8.5"
"Pike","2020-06-28","3","1192","2","96","16.2","11.5"
"Pike","2020-06-29","27","1219","3","99","16.4","11.3"
"Pike","2020-06-30","16","1235","2","101","18.2","11.8"
"Pike","2020-07-01","22","1257","2","103","17.9","11.7"
"Pike","2020-07-02","20","1277","1","104","17.4","11.8"
"Pike","2020-07-03","13","1290","3","107","19.8","13.5"
"Pike","2020-07-04","8","1298","1","108","20","13.3"
"Pike","2020-07-05","10","1308","3","111","14.8","15.5"
"Pike","2020-07-06","36","1344","4","115","14.8","15.6"
"Pike","2020-07-07","47","1391","0","115","13","15.6"
"Pike","2020-07-08","18","1409","3","118","14.1","16"
"Pike","2020-07-09","34","1443","3","121","14.6","16"
"Pike","2020-07-10","17","1460","2","123","13","16.4"
"Pike","2020-07-11","6","1466","2","125","16","18"
"Pike","2020-07-12","7","1473","2","127","15.8","15.3"
"Pike","2020-07-13","23","1496","2","129","15.4","15.1"
"Pike","2020-07-14","41","1537","4","133","16.8","14.9"
"Pike","2020-07-15","22","1559","4","137","17","15.5"
"Pike","2020-07-16","12","1571","1","138","16.9","15.8"
"Pike","2020-07-17","16","1587","5","143","19.7","16.4"
"Pike","2020-07-18","6","1593","1","144","17.4","16.7"
"Pike","2020-07-19","5","1598","2","146","19","17.4"
"Pike","2020-07-20","21","1619","1","147","18.4","16.9"
"Pike","2020-07-21","37","1656","4","151","18.6","17.7"
"Pike","2020-07-22","12","1668","2","153","18.4","17.7"
"Pike","2020-07-23","22","1690","7","160","21.7","19.3"
"Pike","2020-07-24","16","1706","2","162","19","19.4"
"Pike","2020-07-25","14","1720","3","165","19.7","18.5"
"Pike","2020-07-26","7","1727","0","165","14","16.5"
"Pike","2020-07-27","18","1745","3","168","15.7","17.1"
"Pike","2020-07-28","41","1786","1","169","14.5","16.5"
"Pike","2020-07-29","20","1806","1","170","12.8","15.6"
"Pike","2020-07-30","25","1831","3","173","10","15.9"
"Pike","2020-07-31","18","1849","0","173","8.2","13.6"
"Pike","2020-08-01","13","1862","0","173","5.2","12.4"
"Pike","2020-08-02","6","1868","2","175","9.9","12"
"Pike","2020-08-03","32","1900","1","176","8","11.8"
"Pike","2020-08-04","45","1945","3","179","8.6","11.5"
"Pike","2020-08-05","19","1964","4","183","10.9","11.9"
"Pike","2020-08-06","15","1979","3","186","12","11"
"Pike","2020-08-07","16","1995","3","189","14.7","11.5"
"Pike","2020-08-08","21","2016","6","195","18.8","12"
"Pike","2020-08-09","8","2024","2","197","17.6","13.8"
"Pike","2020-08-10","27","2051","4","201","19.3","13.6"
"Pike","2020-08-11","66","2117","4","205","19.2","13.9"
"Pike","2020-08-12","20","2137","1","206","16.9","13.9"
"Pike","2020-08-13","17","2154","1","207","14.9","13.4"
"Pike","2020-08-14","26","2180","5","212","14.9","14.8"
"Pike","2020-08-15","9","2189","2","214","14","16.4"
"Pike","2020-08-16","45","2234","3","217","11.4","14.5"
"Pike","2020-08-17","28","2262","3","220","10.8","15"
"Pike","2020-08-18","55","2317","5","225","11.3","15.2"
"Pike","2020-08-19","22","2339","2","227","11.8","14.4"
"Pike","2020-08-20","25","2364","0","227","11","12.9"
"Pike","2020-08-21","21","2385","1","228","8.9","11.9"
"Pike","2020-08-22","15","2400","4","232","9.6","11.8"
"Pike","2020-08-23","9","2409","2","234","11.8","11.6"
"Pike","2020-08-24","16","2425","1","235","11.2","11"
"Pike","2020-08-25","46","2471","1","236","10.2","10.7"
"Pike","2020-08-26","9","2480","0","236","8.9","10.4"
"Pike","2020-08-27","21","2501","1","237","9.5","10.3"
"Pike","2020-08-28","20","2521","2","239","10.3","9.6"
"Pike","2020-08-29","10","2531","0","239","6.5","8"
"Pike","2020-08-30","2","2533","1","240","10.5","11.1"
"Pike","2020-08-31","20","2553","5","245","13.1","12.1"
"Pike","2020-09-01","49","2602","1","246","13.1","11.6"
"Pike","2020-09-02","10","2612","2","248","16","12.4"
"Pike","2020-09-03","17","2629","3","251","17.8","13.7"
"Pike","2020-09-04","10","2639","0","251","16.4","13.3"
"Pike","2020-09-05","8","2647","0","251","16.4","11.4"
"Pike","2020-09-06","8","2655","1","252","11","10.7"
"Pike","2020-09-07","12","2667","0","252","7.5","10.3"
"Pike","2020-09-08","26","2693","5","257","9.9","11.5"
"Pike","2020-09-09","19","2712","2","259","8.6","12.3"
"Pike","2020-09-10","10","2722","1","260","7.5","12.6"
"Pike","2020-09-11","17","2739","0","260","7.5","11.9"
"Pike","2020-09-12","6","2745","0","260","7.5","11.9"
"Pike","2020-09-13","2","2747","0","260","5.7","8.4"
"Pike","2020-09-14","19","2766","0","260","5.7","6.6"
"Pike","2020-09-15","35","2801","4","264","4.6","7.2"
"Pike","2020-09-16","26","2827","1","265","3.6","6.1"
"Pike","2020-09-17","18","2845","1","266","3","5.2"
"Pike","2020-09-18","11","2856","2","268","5.6","6.5"
"Pike","2020-09-19","4","2860","0","268","5.6","6.5"
"Pike","2020-09-20","5","2865","0","268","5.6","5.6"
"Pike","2020-09-21","18","2883","1","269","6.4","6"
"Pike","2020-09-22","35","2918","6","275","7.2","5.9"
"Pike","2020-09-23","12","2930","1","276","7.8","5.7"
"Pike","2020-09-24","25","2955","1","277","7.6","5.3"
"Pike","2020-09-25","16","2971","3","280","7.7","6.6"
"Pike","2020-09-26","13","2984","1","281","8.8","7.2"
"Pike","2020-09-27","6","2990","0","281","8.8","7.2"
"Pike","2020-09-28","22","3012","9","290","13.8","10.1"
"Pike","2020-09-29","30","3042","2","292","12.3","9.8"
"Pike","2020-09-30","17","3059","0","292","11.1","9.5"
"Pike","2020-10-01","15","3074","1","293","11.5","9.6"
"Pike","2020-10-02","22","3096","2","295","10.1","8.9"
"Pike","2020-10-03","14","3110","2","297","11.1","9.9"
"Pike","2020-10-04","16","3126","0","297","11.1","9.9"
"Pike","2020-10-05","27","3153","1","298","5.8","9.8"
"Pike","2020-10-06","46","3199","5","303","6.4","9.4"
"Pike","2020-10-07","18","3217","1","304","7.2","9.2"
"Pike","2020-10-08","21","3238","1","305","6.9","9.2"
"Pike","2020-10-09","22","3260","4","309","8.2","9.2"
"Pike","2020-10-10","14","3274","2","311","8.2","9.6"
"Pike","2020-10-11","10","3284","0","311","8.2","9.6"
"Pike","2020-10-12","19","3303","2","313","9.2","7.5"
"Pike","2020-10-13","32","3335","1","314","8.1","7.2"
"Pike","2020-10-14","19","3354","2","316","8.8","8"
"Pike","2020-10-15","17","3371","3","319","10.6","8.8"
"Pike","2020-10-16","15","3386","0","319","8","8.1"
"Pike","2020-10-17","8","3394","1","320","7.8","8"
"Pike","2020-10-18","3","3397","0","320","7.8","8"
"Pike","2020-10-19","23","3420","2","322","7.5","8.3"
"Pike","2020-10-20","43","3463","2","324","7.7","7.9"
"Pike","2020-10-21","25","3488","4","328","8.5","8.6"
"Pike","2020-10-22","20","3508","3","331","8.1","9.4"
"Pike","2020-10-23","16","3524","2","333","9.9","9"
"Pike","2020-10-24","14","3538","0","333","8.1","7.9"
"Pike","2020-10-25","5","3543","0","333","8.1","7.9"
"Pike","2020-10-26","24","3567","3","336","8.7","8.1"
"Pike","2020-10-27","43","3610","4","340","9.3","8.5"
"Pike","2020-10-28","16","3626","0","340","7","7.8"
"Pike","2020-10-29","13","3639","1","341","6","7.1"
"Pike","2020-10-30","16","3655","0","341","4.2","7.1"
"Pike","2020-10-31","11","3666","0","341","4.2","6.2"
"Pike","2020-11-01","9","3675","2","343","7.4","7.8"
"Pike","2020-11-02","27","3702","1","344","6.1","7.4"
"Pike","2020-11-03","42","3744","1","345","5.1","7.2"
"Pike","2020-11-04","23","3767","3","348","7","7"
"Pike","2020-11-05","10","3777","1","349","7.3","6.7"
"Pike","2020-11-06","16","3793","1","350","8.2","6.2"
"Pike","2020-11-07","8","3801","0","350","8.2","6.2"
"Pike","2020-11-08","4","3805","0","350","5.1","6.2"
"Pike","2020-11-09","29","3834","5","355","7","6.6"
"Pike","2020-11-10","49","3883","4","359","7.8","6.5"
"Pike","2020-11-11","24","3907","4","363","8.3","7.7"
"Pike","2020-11-12","31","3938","1","364","7.4","7.3"
"Pike","2020-11-13","21","3959","3","367","8.5","8.4"
"Pike","2020-11-14","18","3977","2","369","10.1","9.2"
"Pike","2020-11-15","16","3993","3","372","12.8","8.9"
"Pike","2020-11-16","39","4032","7","379","12.9","9.9"
"Pike","2020-11-17","67","4099","6","385","13","10.4"
"Pike","2020-11-18","33","4132","4","389","12.3","10.3"
"Pike","2020-11-19","28","4160","5","394","14.4","10.9"
"Pike","2020-11-20","20","4180","1","395","13.1","10.8"
"Pike","2020-11-21","8","4188","0","395","11.5","10.8"
"Pike","2020-11-22","11","4199","3","398","12.7","12.8"
"Pike","2020-11-23","25","4224","4","402","12.5","12.7"
"Pike","2020-11-24","22","4246","2","404","12.5","12.7"
"Pike","2020-11-25","32","4278","3","407","12.1","12.2"
"Pike","2020-11-26","2","4280","0","407","9.5","12"
"Pike","2020-11-27","19","4299","4","411","11.8","12.5"
"Pike","2020-11-28","7","4306","2","413","15.9","13.7"
"Pike","2020-11-29","6","4312","0","413","12","12.4"
"Pike","2020-11-30","37","4349","6","419","12","12.3"
"Pike","2020-12-01","28","4377","6","425","13.8","13.1"
"Pike","2020-12-02","26","4403","5","430","15.2","13.6"
"Pike","2020-12-03","26","4429","3","433","16.9","13.2"
"Pike","2020-12-04","33","4462","6","439","16.5","14.1"
"Pike","2020-12-05","13","4475","1","440","13.5","14.7"
"Pike","2020-12-06","10","4485","3","443","17.8","14.9"
"Pike","2020-12-07","38","4523","5","448","17.3","14.7"
"Pike","2020-12-08","22","4545","2","450","15.6","14.7"
"Pike","2020-12-09","27","4572","4","454","14.9","15.1"
"Pike","2020-12-10","31","4603","7","461","16.5","16.7"
"Pike","2020-12-11","29","4632","6","467","16.9","16.7"
"Pike","2020-12-12","23","4655","3","470","17.6","15.5"
"Pike","2020-12-13","16","4671","3","473","16","16.9"
"Pike","2020-12-14","44","4715","10","483","17.4","17.4"
"Pike","2020-12-15","101","4816","11","494","17.6","16.6"
"Pike","2020-12-16","37","4853","3","497","16.7","15.8"
"Pike","2020-12-17","45","4898","8","505","16","16.3"
"Pike","2020-12-18","30","4928","5","510","15.4","16.1"
"Pike","2020-12-19","14","4942","3","513","16.6","17.1"
"Pike","2020-12-20","11","4953","0","513","13.9","15"
"Pike","2020-12-21","39","4992","5","518","12.5","15"
"Pike","2020-12-22","51","5043","7","525","12.9","15.3"
"Pike","2020-12-23","33","5076","8","533","15.2","16"
"Pike","2020-12-24","22","5098","6","539","16.6","16.3"
"Pike","2020-12-25","6","5104","1","540","16.6","16"
"Pike","2020-12-26","19","5123","5","545","17.3","17"
"Pike","2020-12-27","11","5134","4","549","22.5","18.2"
"Pike","2020-12-28","72","5206","18","567","24.2","18.4"
"Pike","2020-12-29","103","5309","20","587","25","19"
"Pike","2020-12-30","42","5351","13","600","26","20.6"
"Pike","2020-12-31","34","5385","7","607","25","20.8"
"Pike","2021-01-01","5","5390","1","608","25.5","21.1"
"Pike","2021-01-02","21","5411","6","614","25.8","21.6"
"Pike","2021-01-03","21","5432","8","622","26.1","24.3"
"Pike","2021-01-04","98","5530","19","641","25.3","24.8"
"Pike","2021-01-05","60","5590","11","652","25.1","25.1"
"Pike","2021-01-06","40","5630","9","661","23.9","25"
"Pike","2021-01-07","49","5679","10","671","23.9","24.5"
"Pike","2021-01-08","37","5716","9","680","24.5","25"
"Pike","2021-01-09","29","5745","2","682","21.4","23.6"
"Pike","2021-01-10","8","5753","3","685","21.3","23.7"
"Pike","2021-01-11","32","5785","6","691","21.2","23.3"
"Pike","2021-01-12","105","5890","11","702","20.1","22.6"
"Pike","2021-01-13","40","5930","9","711","20.1","22"
"Pike","2021-01-14","40","5970","8","719","20.1","22"
"Pike","2021-01-15","38","6008","6","725","18.8","21.7"
"Pike","2021-01-16","32","6040","4","729","19.6","20.5"
"Pike","2021-01-17","8","6048","2","731","17.9","19.6"
"Pike","2021-01-18","30","6078","6","737","18","19.6"
"Pike","2021-01-19","34","6112","7","744","19.5","19.8"
"Pike","2021-01-20","40","6152","7","751","18.8","19.4"
"Pike","2021-01-21","54","6206","6","757","17.5","18.8"
"Pike","2021-01-22","34","6240","4","761","16.9","17.9"
"Pike","2021-01-23","22","6262","3","764","17.1","18.4"
"Pike","2021-01-24","9","6271","1","765","15.1","16.5"
"Pike","2021-01-25","33","6304","4","769","14","16"
"Pike","2021-01-26","68","6372","8","777","12.7","16.1"
"Pike","2021-01-27","40","6412","4","781","11.6","15.2"
"Pike","2021-01-28","41","6453","8","789","12.8","15.2"
"Pike","2021-01-29","41","6494","5","794","12.9","14.9"
"Pike","2021-01-30","15","6509","4","798","14.8","15.9"
"Pike","2021-01-31","16","6525","1","799","14.1","14.6"
"Pike","2021-02-01","40","6565","6","805","14.5","14.2"
"Pike","2021-02-02","29","6594","5","810","15.3","14"
"Pike","2021-02-03","37","6631","6","816","16.2","13.9"
"Pike","2021-02-04","19","6650","3","819","15.6","14.2"
"Pike","2021-02-05","25","6675","1","820","14.5","13.7"
"Pike","2021-02-06","10","6685","1","821","12.1","13.4"
"Pike","2021-02-07","3","6688","0","821","11.2","12.6"
"Pike","2021-02-08","0","6688","0","821","9","11.8"
"Polk","2020-02-01","0","0","0","0",".","."
"Polk","2020-02-02","0","0","0","0",".","."
"Polk","2020-02-03","0","0","0","0",".","."
"Polk","2020-02-04","0","0","0","0",".","."
"Polk","2020-02-05","0","0","0","0",".","."
"Polk","2020-02-06","0","0","0","0",".","."
"Polk","2020-02-07","0","0","0","0","0","."
"Polk","2020-02-08","0","0","0","0","0","."
"Polk","2020-02-09","0","0","0","0","0","."
"Polk","2020-02-10","0","0","0","0","0","."
"Polk","2020-02-11","0","0","0","0","0","."
"Polk","2020-02-12","0","0","0","0","0","."
"Polk","2020-02-13","0","0","0","0","0","."
"Polk","2020-02-14","0","0","0","0","0","0"
"Polk","2020-02-15","0","0","0","0","0","0"
"Polk","2020-02-16","0","0","0","0","0","0"
"Polk","2020-02-17","0","0","0","0","0","0"
"Polk","2020-02-18","0","0","0","0","0","0"
"Polk","2020-02-19","0","0","0","0","0","0"
"Polk","2020-02-20","0","0","0","0","0","0"
"Polk","2020-02-21","0","0","0","0","0","0"
"Polk","2020-02-22","0","0","0","0","0","0"
"Polk","2020-02-23","0","0","0","0","0","0"
"Polk","2020-02-24","0","0","0","0","0","0"
"Polk","2020-02-25","0","0","0","0","0","0"
"Polk","2020-02-26","0","0","0","0","0","0"
"Polk","2020-02-27","0","0","0","0","0","0"
"Polk","2020-02-28","0","0","0","0","0","0"
"Polk","2020-02-29","0","0","0","0","0","0"
"Polk","2020-03-01","0","0","0","0","0","0"
"Polk","2020-03-02","0","0","0","0","0","0"
"Polk","2020-03-03","0","0","0","0","0","0"
"Polk","2020-03-04","0","0","0","0","0","0"
"Polk","2020-03-05","0","0","0","0","0","0"
"Polk","2020-03-06","0","0","0","0","0","0"
"Polk","2020-03-07","0","0","0","0","0","0"
"Polk","2020-03-08","0","0","0","0","0","0"
"Polk","2020-03-09","1","1","0","0","0","0"
"Polk","2020-03-10","5","6","0","0","0","0"
"Polk","2020-03-11","7","13","0","0","0","0"
"Polk","2020-03-12","7","20","0","0","0","0"
"Polk","2020-03-13","4","24","1","1","3.6","1.8"
"Polk","2020-03-14","2","26","0","1","3.6","1.8"
"Polk","2020-03-15","3","29","1","2","8.3","4.2"
"Polk","2020-03-16","11","40","0","2","8.3","4.2"
"Polk","2020-03-17","21","61","0","2","8.3","4.2"
"Polk","2020-03-18","15","76","1","3","9.3","4.6"
"Polk","2020-03-19","8","84","0","3","9.3","4.6"
"Polk","2020-03-20","9","93","0","3","5.7","4.6"
"Polk","2020-03-21","2","95","0","3","5.7","4.6"
"Polk","2020-03-22","7","102","5","8","11.2","9.7"
"Polk","2020-03-23","12","114","4","12","15.9","12.1"
"Polk","2020-03-24","4","118","0","12","15.9","12.1"
"Polk","2020-03-25","13","131","0","12","15","12.1"
"Polk","2020-03-26","10","141","2","14","17.8","13.6"
"Polk","2020-03-27","8","149","2","16","21.4","13.6"
"Polk","2020-03-28","12","161","4","20","26.2","15.9"
"Polk","2020-03-29","9","170","0","20","16","13.6"
"Polk","2020-03-30","16","186","2","22","13","14.4"
"Polk","2020-03-31","8","194","0","22","13","14.4"
"Polk","2020-04-01","9","203","1","23","14.6","14.8"
"Polk","2020-04-02","17","220","0","23","11.7","14.8"
"Polk","2020-04-03","9","229","1","24","9.7","15.6"
"Polk","2020-04-04","11","240","1","25","6.3","16.2"
"Polk","2020-04-05","5","245","0","25","6.3","11.1"
"Polk","2020-04-06","5","250","2","27","10.2","11.6"
"Polk","2020-04-07","11","261","1","28","11.5","12.2"
"Polk","2020-04-08","16","277","2","30","11.7","13.1"
"Polk","2020-04-09","14","291","0","30","11.7","11.7"
"Polk","2020-04-10","12","303","1","31","11.3","10.5"
"Polk","2020-04-11","14","317","3","34","13.1","9.7"
"Polk","2020-04-12","10","327","3","37","17.3","11.8"
"Polk","2020-04-13","15","342","4","41","15.4","12.8"
"Polk","2020-04-14","17","359","3","44","16.7","14.1"
"Polk","2020-04-15","15","374","1","45","15.8","13.8"
"Polk","2020-04-16","15","389","3","48","18.7","15.2"
"Polk","2020-04-17","21","410","1","49","18.2","14.7"
"Polk","2020-04-18","18","428","2","51","16.7","14.9"
"Polk","2020-04-19","3","431","0","51","12.4","14.9"
"Polk","2020-04-20","9","440","0","51","8.6","12"
"Polk","2020-04-21","21","461","2","53","7.4","12"
"Polk","2020-04-22","17","478","2","55","8.2","12"
"Polk","2020-04-23","17","495","0","55","5.3","12"
"Polk","2020-04-24","12","507","2","57","7","12.6"
"Polk","2020-04-25","13","520","1","58","6.5","11.6"
"Polk","2020-04-26","5","525","1","59","9.4","10.9"
"Polk","2020-04-27","15","540","2","61","11.3","9.9"
"Polk","2020-04-28","21","561","1","62","10.6","9"
"Polk","2020-04-29","21","582","0","62","8.9","8.5"
"Polk","2020-04-30","19","601","1","63","9.7","7.5"
"Polk","2020-05-01","21","622","3","66","9.3","8.2"
"Polk","2020-05-02","10","632","0","66","8.2","7.4"
"Polk","2020-05-03","6","638","0","66","5.4","7.4"
"Polk","2020-05-04","7","645","2","68","7.6","9.4"
"Polk","2020-05-05","25","670","1","69","7.4","9"
"Polk","2020-05-06","15","685","2","71","9.4","9.1"
"Polk","2020-05-07","27","712","2","73","9.7","9.7"
"Polk","2020-05-08","25","737","0","73","7.6","8.5"
"Polk","2020-05-09","14","751","0","73","7.6","7.9"
"Polk","2020-05-10","6","757","0","73","7.6","6.5"
"Polk","2020-05-11","15","772","1","74","4.5","6"
"Polk","2020-05-12","29","801","3","77","5.4","6.4"
"Polk","2020-05-13","21","822","1","78","4.2","6.8"
"Polk","2020-05-14","27","849","1","79","3.6","6.6"
"Polk","2020-05-15","18","867","2","81","5.2","6.4"
"Polk","2020-05-16","14","881","2","83","7.3","7.4"
"Polk","2020-05-17","6","887","0","83","7.3","7.4"
"Polk","2020-05-18","13","900","1","84","7.4","6"
"Polk","2020-05-19","40","940","6","90","8.1","6.7"
"Polk","2020-05-20","15","955","1","91","8.4","6.3"
"Polk","2020-05-21","23","978","5","96","10.9","7.3"
"Polk","2020-05-22","24","1002","2","98","10.5","7.9"
"Polk","2020-05-23","9","1011","1","99","10.1","8.7"
"Polk","2020-05-24","6","1017","1","100","12.5","9.9"
"Polk","2020-05-25","10","1027","2","102","14.2","10.8"
"Polk","2020-05-26","35","1062","0","102","12.1","10.1"
"Polk","2020-05-27","28","1090","1","103","11.6","10"
"Polk","2020-05-28","22","1112","0","103","8.5","9.7"
"Polk","2020-05-29","26","1138","4","107","9.5","10"
"Polk","2020-05-30","14","1152","1","108","9","9.5"
"Polk","2020-05-31","7","1159","1","109","8.6","10.5"
"Polk","2020-06-01","25","1184","1","110","6.3","10.3"
"Polk","2020-06-02","24","1208","2","112","7.5","9.8"
"Polk","2020-06-03","25","1233","4","116","9.3","10.5"
"Polk","2020-06-04","24","1257","1","117","9.9","9.2"
"Polk","2020-06-05","30","1287","1","118","8.2","8.9"
"Polk","2020-06-06","18","1305","1","119","8","8.5"
"Polk","2020-06-07","6","1311","1","120","8.3","8.5"
"Polk","2020-06-08","30","1341","3","123","9.2","7.7"
"Polk","2020-06-09","32","1373","1","124","8.4","8"
"Polk","2020-06-10","22","1395","1","125","6.8","8"
"Polk","2020-06-11","33","1428","0","125","6.2","8"
"Polk","2020-06-12","36","1464","1","126","6.1","7.1"
"Polk","2020-06-13","17","1481","1","127","6.1","7"
"Polk","2020-06-14","10","1491","2","129","6.6","7.5"
"Polk","2020-06-15","35","1526","0","129","5.2","7.2"
"Polk","2020-06-16","37","1563","4","133","6.3","7.3"
"Polk","2020-06-17","29","1592","4","137","7.6","7.2"
"Polk","2020-06-18","22","1614","1","138","8.3","7.2"
"Polk","2020-06-19","32","1646","2","140","8.8","7.4"
"Polk","2020-06-20","20","1666","1","141","8.6","7.4"
"Polk","2020-06-21","9","1675","0","141","5.8","6.2"
"Polk","2020-06-22","39","1714","2","143","6.5","5.8"
"Polk","2020-06-23","40","1754","5","148","6.7","6.5"
"Polk","2020-06-24","40","1794","4","152","6.2","6.9"
"Polk","2020-06-25","39","1833","3","155","6.7","7.5"
"Polk","2020-06-26","57","1890","1","156","6","7.4"
"Polk","2020-06-27","35","1925","1","157","5.7","7.2"
"Polk","2020-06-28","12","1937","3","160","9.3","7.5"
"Polk","2020-06-29","51","1988","10","170","11.3","8.9"
"Polk","2020-06-30","53","2041","6","176","11.2","9"
"Polk","2020-07-01","62","2103","11","187","12.3","9.2"
"Polk","2020-07-02","57","2160","11","198","13.9","10.3"
"Polk","2020-07-03","38","2198","8","206","16.7","11.4"
"Polk","2020-07-04","28","2226","8","214","20.4","13"
"Polk","2020-07-05","11","2237","5","219","23.3","16.3"
"Polk","2020-07-06","90","2327","27","246","24.8","18.1"
"Polk","2020-07-07","84","2411","16","262","25.9","18.5"
"Polk","2020-07-08","55","2466","9","271","25.7","19"
"Polk","2020-07-09","107","2573","18","289","25.3","19.6"
"Polk","2020-07-10","93","2666","10","299","23.9","20.3"
"Polk","2020-07-11","81","2747","17","316","22.8","21.6"
"Polk","2020-07-12","33","2780","14","330","22.3","22.8"
"Polk","2020-07-13","67","2847","15","345","21.3","23"
"Polk","2020-07-14","97","2944","15","360","20.7","23.3"
"Polk","2020-07-15","69","3013","10","370","20.5","23.1"
"Polk","2020-07-16","71","3084","14","384","20.9","23.1"
"Polk","2020-07-17","55","3139","12","396","22.5","23.2"
"Polk","2020-07-18","32","3171","9","405","23.5","23.1"
"Polk","2020-07-19","18","3189","2","407","19","20.7"
"Polk","2020-07-20","50","3239","8","415","18.1","19.7"
"Polk","2020-07-21","77","3316","13","428","18.3","19.5"
"Polk","2020-07-22","55","3371","15","443","20.1","20.3"
"Polk","2020-07-23","79","3450","12","455","19.5","20.2"
"Polk","2020-07-24","87","3537","13","468","18.5","20.5"
"Polk","2020-07-25","40","3577","12","480","18.8","21.1"
"Polk","2020-07-26","21","3598","3","483","19.2","19.1"
"Polk","2020-07-27","53","3651","13","496","20.4","19.3"
"Polk","2020-07-28","68","3719","15","511","21.2","19.7"
"Polk","2020-07-29","44","3763","10","521","20.5","20.3"
"Polk","2020-07-30","57","3820","6","527","19.9","19.7"
"Polk","2020-07-31","61","3881","13","540","20.8","19.6"
"Polk","2020-08-01","52","3933","12","552","19.8","19.3"
"Polk","2020-08-02","17","3950","4","556","21.1","20.2"
"Polk","2020-08-03","36","3986","10","566","21.6","21"
"Polk","2020-08-04","84","4070","19","585","21.7","21.4"
"Polk","2020-08-05","76","4146","8","593","19.9","20.2"
"Polk","2020-08-06","78","4224","10","603","20.2","20.1"
"Polk","2020-08-07","82","4306","12","615","19.3","20"
"Polk","2020-08-08","69","4375","8","623","17.6","18.7"
"Polk","2020-08-09","19","4394","3","626","16.5","18.8"
"Polk","2020-08-10","84","4478","10","636","14.3","17.9"
"Polk","2020-08-11","130","4608","22","658","13.5","17.6"
"Polk","2020-08-12","117","4725","18","676","14.2","17"
"Polk","2020-08-13","84","4809","8","684","13.7","17"
"Polk","2020-08-14","124","4933","15","699","13.3","16.3"
"Polk","2020-08-15","49","4982","7","706","13.7","15.7"
"Polk","2020-08-16","31","5013","0","706","11.4","14"
"Polk","2020-08-17","36","5049","8","714","12.9","13.6"
"Polk","2020-08-18","58","5107","13","727","13.7","13.6"
"Polk","2020-08-19","86","5193","7","734","12.7","13.4"
"Polk","2020-08-20","46","5239","7","741","13.5","13.6"
"Polk","2020-08-21","67","5306","3","744","12.4","12.9"
"Polk","2020-08-22","72","5378","17","761","13.7","13.7"
"Polk","2020-08-23","13","5391","1","762","14.8","13.1"
"Polk","2020-08-24","57","5448","11","773","14.4","13.7"
"Polk","2020-08-25","63","5511","7","780","12.8","13.2"
"Polk","2020-08-26","75","5586","8","788","13.2","12.9"
"Polk","2020-08-27","50","5636","6","794","12.7","13.1"
"Polk","2020-08-28","36","5672","5","799","14","13.2"
"Polk","2020-08-29","26","5698","1","800","11.2","12.5"
"Polk","2020-08-30","15","5713","0","800","10.1","12.5"
"Polk","2020-08-31","27","5740","2","802","8.4","11.4"
"Polk","2020-09-01","114","5854","12","814","8.3","10.6"
"Polk","2020-09-02","38","5892","5","819","8.7","10.9"
"Polk","2020-09-03","46","5938","4","823","8.2","10.5"
"Polk","2020-09-04","41","5979","2","825","6.9","10.5"
"Polk","2020-09-05","26","6005","0","825","6.4","8.8"
"Polk","2020-09-06","17","6022","2","827","8.1","9.1"
"Polk","2020-09-07","10","6032","2","829","9.9","9.1"
"Polk","2020-09-08","129","6161","9","838","9.4","8.8"
"Polk","2020-09-09","66","6227","12","850","10.1","9.4"
"Polk","2020-09-10","63","6290","7","857","10.4","9.3"
"Polk","2020-09-11","30","6320","2","859","10.7","8.8"
"Polk","2020-09-12","18","6338","0","859","10.7","8.5"
"Polk","2020-09-13","21","6359","2","861","10.4","9.2"
"Polk","2020-09-14","43","6402","6","867","9.5","9.7"
"Polk","2020-09-15","128","6530","9","876","9.5","9.4"
"Polk","2020-09-16","45","6575","0","876","6.9","8.5"
"Polk","2020-09-17","30","6605","4","880","7.2","8.8"
"Polk","2020-09-18","61","6666","9","889","8.4","9.5"
"Polk","2020-09-19","28","6694","3","892","9.9","10.3"
"Polk","2020-09-20","20","6714","1","893","9.3","9.8"
"Polk","2020-09-21","34","6748","4","897","8.9","9.2"
"Polk","2020-09-22","133","6881","9","906","8.9","9.2"
"Polk","2020-09-23","44","6925","3","909","9.9","8.4"
"Polk","2020-09-24","65","6990","3","912","8.6","7.9"
"Polk","2020-09-25","37","7027","2","914","7.3","7.8"
"Polk","2020-09-26","43","7070","3","917","6.8","8.3"
"Polk","2020-09-27","20","7090","2","919","7.5","8.4"
"Polk","2020-09-28","28","7118","1","920","6.3","7.6"
"Polk","2020-09-29","98","7216","9","929","6.7","7.8"
"Polk","2020-09-30","21","7237","2","931","7","8.5"
"Polk","2020-10-01","32","7269","1","932","6.8","7.7"
"Polk","2020-10-02","72","7341","2","934","6.5","6.9"
"Polk","2020-10-03","34","7375","1","935","5.9","6.3"
"Polk","2020-10-04","15","7390","1","936","5.4","6.4"
"Polk","2020-10-05","21","7411","2","938","6.2","6.3"
"Polk","2020-10-06","101","7512","13","951","6.8","6.7"
"Polk","2020-10-07","92","7604","3","954","5.9","6.5"
"Polk","2020-10-08","64","7668","5","959","6.6","6.7"
"Polk","2020-10-09","48","7716","5","964","7.6","7"
"Polk","2020-10-10","35","7751","3","967","8.4","7.2"
"Polk","2020-10-11","15","7766","2","969","9.4","7.4"
"Polk","2020-10-12","42","7808","4","973","9.4","7.8"
"Polk","2020-10-13","153","7961","17","990","9.1","8"
"Polk","2020-10-14","91","8052","4","994","9.3","7.6"
"Polk","2020-10-15","49","8101","7","1001","10.2","8.4"
"Polk","2020-10-16","50","8151","3","1004","9.6","8.6"
"Polk","2020-10-17","52","8203","11","1015","11.4","9.9"
"Polk","2020-10-18","11","8214","2","1017","12.1","10.7"
"Polk","2020-10-19","29","8243","3","1020","12.2","10.8"
"Polk","2020-10-20","121","8364","12","1032","12","10.6"
"Polk","2020-10-21","41","8405","7","1039","13.9","11.6"
"Polk","2020-10-22","62","8467","6","1045","13.2","11.7"
"Polk","2020-10-23","53","8520","8","1053","14.5","12"
"Polk","2020-10-24","42","8562","3","1056","12.5","11.9"
"Polk","2020-10-25","14","8576","1","1057","10.9","11.5"
"Polk","2020-10-26","33","8609","4","1061","11.2","11.7"
"Polk","2020-10-27","115","8724","12","1073","11.2","11.6"
"Polk","2020-10-28","62","8786","9","1082","10.9","12.4"
"Polk","2020-10-29","44","8830","3","1085","10.5","11.8"
"Polk","2020-10-30","17","8847","1","1086","9.2","11.8"
"Polk","2020-10-31","40","8887","6","1092","10.3","11.4"
"Polk","2020-11-01","19","8906","1","1093","10","10.5"
"Polk","2020-11-02","32","8938","6","1099","11","11.1"
"Polk","2020-11-03","118","9056","12","1111","10.9","11.1"
"Polk","2020-11-04","52","9108","4","1115","9.9","10.4"
"Polk","2020-11-05","44","9152","5","1120","10.6","10.5"
"Polk","2020-11-06","52","9204","3","1123","10.6","9.9"
"Polk","2020-11-07","35","9239","11","1134","12.9","11.6"
"Polk","2020-11-08","28","9267","9","1143","16.8","13.4"
"Polk","2020-11-09","53","9320","10","1153","16.8","13.9"
"Polk","2020-11-10","128","9448","20","1173","17.6","14.2"
"Polk","2020-11-11","50","9498","8","1181","18.7","14.3"
"Polk","2020-11-12","51","9549","9","1190","19.6","15.1"
"Polk","2020-11-13","50","9599","9","1199","21.4","16"
"Polk","2020-11-14","44","9643","4","1203","18.2","15.6"
"Polk","2020-11-15","30","9673","4","1207","15.5","16.1"
"Polk","2020-11-16","56","9729","14","1221","16.4","16.6"
"Polk","2020-11-17","101","9830","11","1232","15.7","16.6"
"Polk","2020-11-18","57","9887","4","1236","14.4","16.6"
"Polk","2020-11-19","56","9943","7","1243","13.7","16.7"
"Polk","2020-11-20","54","9997","6","1249","12.7","17"
"Polk","2020-11-21","57","10054","7","1256","13.2","15.7"
"Polk","2020-11-22","22","10076","4","1260","13.9","14.7"
"Polk","2020-11-23","47","10123","9","1269","13","14.7"
"Polk","2020-11-24","192","10315","23","1292","13.2","14.4"
"Polk","2020-11-25","70","10385","8","1300","13.8","14.1"
"Polk","2020-11-26","16","10401","3","1303","14.7","14.2"
"Polk","2020-11-27","52","10453","9","1312","15.6","14.1"
"Polk","2020-11-28","38","10491","8","1320","16.8","15"
"Polk","2020-11-29","26","10517","8","1328","18.6","16.2"
"Polk","2020-11-30","70","10587","13","1341","18.6","15.8"
"Polk","2020-12-01","76","10663","13","1354","19.3","16.2"
"Polk","2020-12-02","74","10737","11","1365","19.8","16.8"
"Polk","2020-12-03","91","10828","11","1376","18.8","16.8"
"Polk","2020-12-04","86","10914","9","1385","17.8","16.7"
"Polk","2020-12-05","42","10956","7","1392","17.2","17"
"Polk","2020-12-06","18","10974","3","1395","15.2","16.9"
"Polk","2020-12-07","97","11071","9","1404","13.9","16.2"
"Polk","2020-12-08","93","11164","10","1414","13","16.1"
"Polk","2020-12-09","98","11262","11","1425","12.4","16.1"
"Polk","2020-12-10","104","11366","9","1434","12","15.4"
"Polk","2020-12-11","140","11506","17","1451","12.2","15"
"Polk","2020-12-12","83","11589","15","1466","12.4","14.8"
"Polk","2020-12-13","29","11618","6","1472","13","14.1"
"Polk","2020-12-14","92","11710","21","1493","14.9","14.4"
"Polk","2020-12-15","146","11856","19","1512","15.2","14.1"
"Polk","2020-12-16","119","11975","19","1531","15.9","14.2"
"Polk","2020-12-17","94","12069","19","1550","17.6","14.8"
"Polk","2020-12-18","89","12158","21","1571","19.2","15.7"
"Polk","2020-12-19","70","12228","28","1599","22.3","17.4"
"Polk","2020-12-20","21","12249","8","1607","24.8","18.9"
"Polk","2020-12-21","96","12345","30","1637","26","20.5"
"Polk","2020-12-22","144","12489","34","1671","27.5","21.4"
"Polk","2020-12-23","114","12603","31","1702","29.1","22.5"
"Polk","2020-12-24","70","12673","21","1723","30.5","24"
"Polk","2020-12-25","22","12695","12","1735","35","27.1"
"Polk","2020-12-26","57","12752","14","1749","32.8","27.5"
"Polk","2020-12-27","42","12794","17","1766","33.1","29"
"Polk","2020-12-28","127","12921","29","1795","31.9","29"
"Polk","2020-12-29","188","13109","55","1850","32.7","30.1"
"Polk","2020-12-30","195","13304","62","1912","33.4","31.2"
"Polk","2020-12-31","216","13520","74","1986","34","32.2"
"Polk","2021-01-01","14","13534","3","1989","29.2","32.1"
"Polk","2021-01-02","35","13569","7","1996","28.6","30.7"
"Polk","2021-01-03","66","13635","22","2018","27.6","30.3"
"Polk","2021-01-04","172","13807","70","2088","30.1","31"
"Polk","2021-01-05","261","14068","96","2184","31.2","31.9"
"Polk","2021-01-06","160","14228","40","2224","30.2","31.8"
"Polk","2021-01-07","118","14346","24","2248","28.2","31.1"
"Polk","2021-01-08","147","14493","34","2282","28.5","28.8"
"Polk","2021-01-09","89","14582","19","2301","28.7","28.6"
"Polk","2021-01-10","44","14626","17","2318","29.4","28.5"
"Polk","2021-01-11","115","14741","29","2347","27.2","28.7"
"Polk","2021-01-12","141","14882","33","2380","25.3","28.2"
"Polk","2021-01-13","131","15013","29","2409","24.9","27.6"
"Polk","2021-01-14","127","15140","30","2439","25.4","26.8"
"Polk","2021-01-15","119","15259","27","2466","25.3","26.9"
"Polk","2021-01-16","81","15340","18","2484","25.4","27"
"Polk","2021-01-17","32","15372","8","2492","23.5","26.4"
"Polk","2021-01-18","84","15456","16","2508","22.6","24.9"
"Polk","2021-01-19","120","15576","19","2527","21.5","23.4"
"Polk","2021-01-20","100","15676","14","2541","20.3","22.6"
"Polk","2021-01-21","91","15767","18","2559","19.8","22.6"
"Polk","2021-01-22","75","15842","5","2564","17.5","21.4"
"Polk","2021-01-23","58","15900","12","2576","17.3","21.4"
"Polk","2021-01-24","39","15939","9","2585","17","20.2"
"Polk","2021-01-25","102","16041","15","2600","16.4","19.5"
"Polk","2021-01-26","109","16150","11","2611","15.6","18.5"
"Polk","2021-01-27","108","16258","19","2630","16.1","18.2"
"Polk","2021-01-28","64","16322","8","2638","15","17.4"
"Polk","2021-01-29","91","16413","15","2653","16.4","17"
"Polk","2021-01-30","50","16463","10","2663","16.4","16.8"
"Polk","2021-01-31","23","16486","5","2668","16.2","16.6"
"Polk","2021-02-01","82","16568","10","2678","15.8","16.1"
"Polk","2021-02-02","92","16660","11","2689","16.1","15.8"
"Polk","2021-02-03","71","16731","11","2700","15.8","15.9"
"Polk","2021-02-04","63","16794","12","2712","16.7","15.9"
"Polk","2021-02-05","37","16831","5","2717","16.3","16.4"
"Polk","2021-02-06","9","16840","1","2718","15","15.7"
"Polk","2021-02-07","0","16840","0","2718","11.9","14"
"Polk","2021-02-08","0","16840","0","2718","10.2","13"
"Pulaski","2020-02-01","0","0","0","0",".","."
"Pulaski","2020-02-02","0","0","0","0",".","."
"Pulaski","2020-02-03","0","0","0","0",".","."
"Pulaski","2020-02-04","0","0","0","0",".","."
"Pulaski","2020-02-05","0","0","0","0",".","."
"Pulaski","2020-02-06","0","0","0","0",".","."
"Pulaski","2020-02-07","0","0","0","0","0","."
"Pulaski","2020-02-08","0","0","0","0","0","."
"Pulaski","2020-02-09","0","0","0","0","0","."
"Pulaski","2020-02-10","0","0","0","0","0","."
"Pulaski","2020-02-11","0","0","0","0","0","."
"Pulaski","2020-02-12","0","0","0","0","0","."
"Pulaski","2020-02-13","0","0","0","0","0","."
"Pulaski","2020-02-14","0","0","0","0","0","0"
"Pulaski","2020-02-15","0","0","0","0","0","0"
"Pulaski","2020-02-16","0","0","0","0","0","0"
"Pulaski","2020-02-17","0","0","0","0","0","0"
"Pulaski","2020-02-18","0","0","0","0","0","0"
"Pulaski","2020-02-19","0","0","0","0","0","0"
"Pulaski","2020-02-20","0","0","0","0","0","0"
"Pulaski","2020-02-21","0","0","0","0","0","0"
"Pulaski","2020-02-22","0","0","0","0","0","0"
"Pulaski","2020-02-23","0","0","0","0","0","0"
"Pulaski","2020-02-24","0","0","0","0","0","0"
"Pulaski","2020-02-25","0","0","0","0","0","0"
"Pulaski","2020-02-26","0","0","0","0","0","0"
"Pulaski","2020-02-27","0","0","0","0","0","0"
"Pulaski","2020-02-28","0","0","0","0","0","0"
"Pulaski","2020-02-29","0","0","0","0","0","0"
"Pulaski","2020-03-01","0","0","0","0","0","0"
"Pulaski","2020-03-02","0","0","0","0","0","0"
"Pulaski","2020-03-03","0","0","0","0","0","0"
"Pulaski","2020-03-04","0","0","0","0","0","0"
"Pulaski","2020-03-05","0","0","0","0","0","0"
"Pulaski","2020-03-06","0","0","0","0","0","0"
"Pulaski","2020-03-07","0","0","0","0","0","0"
"Pulaski","2020-03-08","0","0","0","0","0","0"
"Pulaski","2020-03-09","0","0","0","0","0","0"
"Pulaski","2020-03-10","0","0","0","0","0","0"
"Pulaski","2020-03-11","0","0","0","0","0","0"
"Pulaski","2020-03-12","0","0","0","0","0","0"
"Pulaski","2020-03-13","0","0","0","0","0","0"
"Pulaski","2020-03-14","0","0","0","0","0","0"
"Pulaski","2020-03-15","0","0","0","0","0","0"
"Pulaski","2020-03-16","0","0","0","0","0","0"
"Pulaski","2020-03-17","1","1","0","0","0","0"
"Pulaski","2020-03-18","4","5","0","0","0","0"
"Pulaski","2020-03-19","3","8","0","0","0","0"
"Pulaski","2020-03-20","4","12","1","1","3.6","1.8"
"Pulaski","2020-03-21","2","14","0","1","3.6","1.8"
"Pulaski","2020-03-22","0","14","0","1","3.6","1.8"
"Pulaski","2020-03-23","9","23","0","1","3.6","1.8"
"Pulaski","2020-03-24","4","27","0","1","3.6","1.8"
"Pulaski","2020-03-25","3","30","1","2","8.3","4.2"
"Pulaski","2020-03-26","0","30","0","2","8.3","4.2"
"Pulaski","2020-03-27","4","34","1","3","8.3","6"
"Pulaski","2020-03-28","1","35","0","3","8.3","6"
"Pulaski","2020-03-29","0","35","0","3","8.3","6"
"Pulaski","2020-03-30","1","36","0","3","8.3","6"
"Pulaski","2020-03-31","8","44","0","3","8.3","6"
"Pulaski","2020-04-01","1","45","0","3","3.6","6"
"Pulaski","2020-04-02","2","47","0","3","3.6","6"
"Pulaski","2020-04-03","6","53","0","3","0","4.2"
"Pulaski","2020-04-04","2","55","1","4","7.1","7.7"
"Pulaski","2020-04-05","1","56","0","4","7.1","7.7"
"Pulaski","2020-04-06","3","59","1","5","11.9","10.1"
"Pulaski","2020-04-07","1","60","0","5","11.9","10.1"
"Pulaski","2020-04-08","1","61","1","6","26.2","14.9"
"Pulaski","2020-04-09","3","64","0","6","26.2","14.9"
"Pulaski","2020-04-10","1","65","0","6","26.2","13.1"
"Pulaski","2020-04-11","5","70","2","8","24.8","16"
"Pulaski","2020-04-12","0","70","0","8","24.8","16"
"Pulaski","2020-04-13","7","77","4","12","28.2","20"
"Pulaski","2020-04-14","10","87","5","17","35.3","23.6"
"Pulaski","2020-04-15","7","94","2","19","25.1","25.6"
"Pulaski","2020-04-16","2","96","1","20","32.2","29.2"
"Pulaski","2020-04-17","4","100","0","20","32.2","29.2"
"Pulaski","2020-04-18","2","102","0","20","26.5","25.6"
"Pulaski","2020-04-19","6","108","4","24","36.1","30.4"
"Pulaski","2020-04-20","7","115","2","26","32","30.1"
"Pulaski","2020-04-21","1","116","0","26","24.8","30.1"
"Pulaski","2020-04-22","3","119","1","27","25.5","25.3"
"Pulaski","2020-04-23","8","127","2","29","21.9","27.1"
"Pulaski","2020-04-24","2","129","0","29","21.9","27.1"
"Pulaski","2020-04-25","1","130","0","29","21.9","24.2"
"Pulaski","2020-04-26","0","130","0","29","12.4","24.2"
"Pulaski","2020-04-27","10","140","2","31","11.2","21.6"
"Pulaski","2020-04-28","5","145","1","32","14","19.4"
"Pulaski","2020-04-29","5","150","2","34","15","20.3"
"Pulaski","2020-04-30","5","155","0","34","11.4","16.7"
"Pulaski","2020-05-01","1","156","0","34","11.4","16.7"
"Pulaski","2020-05-02","4","160","0","34","11.4","16.7"
"Pulaski","2020-05-03","1","161","0","34","11.4","11.9"
"Pulaski","2020-05-04","5","166","0","34","8.6","9.9"
"Pulaski","2020-05-05","3","169","0","34","5.7","9.9"
"Pulaski","2020-05-06","2","171","0","34","0","7.5"
"Pulaski","2020-05-07","6","177","0","34","0","5.7"
"Pulaski","2020-05-08","2","179","0","34","0","5.7"
"Pulaski","2020-05-09","4","183","0","34","0","5.7"
"Pulaski","2020-05-10","2","185","0","34","0","5.7"
"Pulaski","2020-05-11","2","187","0","34","0","4.3"
"Pulaski","2020-05-12","5","192","0","34","0","2.9"
"Pulaski","2020-05-13","1","193","0","34","0","0"
"Pulaski","2020-05-14","6","199","0","34","0","0"
"Pulaski","2020-05-15","4","203","0","34","0","0"
"Pulaski","2020-05-16","2","205","0","34","0","0"
"Pulaski","2020-05-17","1","206","0","34","0","0"
"Pulaski","2020-05-18","4","210","0","34","0","0"
"Pulaski","2020-05-19","1","211","0","34","0","0"
"Pulaski","2020-05-20","265","476","2","36","0.1","0.1"
"Pulaski","2020-05-21","2","478","0","36","0.1","0.1"
"Pulaski","2020-05-22","5","483","0","36","0.1","0.1"
"Pulaski","2020-05-23","3","486","0","36","0.1","0.1"
"Pulaski","2020-05-24","1","487","0","36","0.1","0.1"
"Pulaski","2020-05-25","2","489","0","36","0.1","0.1"
"Pulaski","2020-05-26","11","500","1","37","1.4","0.7"
"Pulaski","2020-05-27","2","502","0","37","1.3","0.7"
"Pulaski","2020-05-28","3","505","0","37","1.3","0.7"
"Pulaski","2020-05-29","2","507","0","37","1.3","0.7"
"Pulaski","2020-05-30","1","508","1","38","15.6","7.8"
"Pulaski","2020-05-31","1","509","0","38","15.6","7.8"
"Pulaski","2020-06-01","6","515","0","38","15.6","7.8"
"Pulaski","2020-06-02","2","517","0","38","14.3","7.8"
"Pulaski","2020-06-03","9","526","2","40","17.5","9.4"
"Pulaski","2020-06-04","3","529","0","40","17.5","9.4"
"Pulaski","2020-06-05","1","530","0","40","17.5","9.4"
"Pulaski","2020-06-06","1","531","0","40","3.2","9.4"
"Pulaski","2020-06-07","0","531","0","40","3.2","9.4"
"Pulaski","2020-06-08","6","537","1","41","5.6","10.6"
"Pulaski","2020-06-09","1","538","0","41","5.6","9.9"
"Pulaski","2020-06-10","2","540","0","41","2.4","9.9"
"Pulaski","2020-06-11","5","545","0","41","2.4","9.9"
"Pulaski","2020-06-12","2","547","0","41","2.4","9.9"
"Pulaski","2020-06-13","0","547","0","41","2.4","2.8"
"Pulaski","2020-06-14","3","550","0","41","2.4","2.8"
"Pulaski","2020-06-15","18","568","0","41","0","2.8"
"Pulaski","2020-06-16","6","574","0","41","0","2.8"
"Pulaski","2020-06-17","0","574","0","41","0","1.2"
"Pulaski","2020-06-18","3","577","0","41","0","1.2"
"Pulaski","2020-06-19","4","581","0","41","0","1.2"
"Pulaski","2020-06-20","1","582","1","42","14.3","8.3"
"Pulaski","2020-06-21","2","584","0","42","14.3","8.3"
"Pulaski","2020-06-22","7","591","0","42","14.3","7.1"
"Pulaski","2020-06-23","7","598","0","42","14.3","7.1"
"Pulaski","2020-06-24","4","602","0","42","14.3","7.1"
"Pulaski","2020-06-25","6","608","1","43","16.7","8.3"
"Pulaski","2020-06-26","2","610","0","43","16.7","8.3"
"Pulaski","2020-06-27","2","612","1","44","9.5","11.9"
"Pulaski","2020-06-28","1","613","0","44","9.5","11.9"
"Pulaski","2020-06-29","27","640","0","44","9.5","11.9"
"Pulaski","2020-06-30","4","644","0","44","9.5","11.9"
"Pulaski","2020-07-01","9","653","0","44","9.5","11.9"
"Pulaski","2020-07-02","8","661","0","44","7.1","11.9"
"Pulaski","2020-07-03","5","666","1","45","10","13.3"
"Pulaski","2020-07-04","1","667","1","46","17.1","13.3"
"Pulaski","2020-07-05","0","667","0","46","17.1","13.3"
"Pulaski","2020-07-06","45","712","2","48","17.8","13.7"
"Pulaski","2020-07-07","8","720","0","48","17.8","13.7"
"Pulaski","2020-07-08","5","725","0","48","17.8","13.7"
"Pulaski","2020-07-09","5","730","0","48","17.8","12.5"
"Pulaski","2020-07-10","4","734","0","48","14.9","12.5"
"Pulaski","2020-07-11","1","735","0","48","0.6","8.9"
"Pulaski","2020-07-12","1","736","0","48","0.6","8.9"
"Pulaski","2020-07-13","69","805","6","54","1.2","9.5"
"Pulaski","2020-07-14","9","814","0","54","1.2","9.5"
"Pulaski","2020-07-15","13","827","0","54","1.2","9.5"
"Pulaski","2020-07-16","2","829","0","54","1.2","9.5"
"Pulaski","2020-07-17","3","832","0","54","1.2","8.1"
"Pulaski","2020-07-18","3","835","0","54","1.2","0.9"
"Pulaski","2020-07-19","3","838","1","55","6","3.3"
"Pulaski","2020-07-20","7","845","1","56","6.8","4"
"Pulaski","2020-07-21","3","848","0","56","6.8","4"
"Pulaski","2020-07-22","7","855","0","56","6.8","4"
"Pulaski","2020-07-23","10","865","1","57","8.2","4.7"
"Pulaski","2020-07-24","3","868","0","57","8.2","4.7"
"Pulaski","2020-07-25","2","870","0","57","8.2","4.7"
"Pulaski","2020-07-26","1","871","0","57","3.5","4.7"
"Pulaski","2020-07-27","15","886","2","59","3.3","5.1"
"Pulaski","2020-07-28","5","891","0","59","3.3","5.1"
"Pulaski","2020-07-29","4","895","1","60","6.9","6.9"
"Pulaski","2020-07-30","2","897","0","60","5.5","6.9"
"Pulaski","2020-07-31","11","908","1","61","6.8","7.5"
"Pulaski","2020-08-01","5","913","1","62","9.6","8.9"
"Pulaski","2020-08-02","1","914","0","62","9.6","6.6"
"Pulaski","2020-08-03","50","964","6","68","9.4","6.4"
"Pulaski","2020-08-04","5","969","2","70","15.2","9.2"
"Pulaski","2020-08-05","7","976","1","71","13.6","10.3"
"Pulaski","2020-08-06","6","982","0","71","13.6","9.6"
"Pulaski","2020-08-07","8","990","1","72","14.1","10.4"
"Pulaski","2020-08-08","4","994","1","73","14.8","12.2"
"Pulaski","2020-08-09","3","997","1","74","19.6","14.6"
"Pulaski","2020-08-10","32","1029","1","75","18.3","13.9"
"Pulaski","2020-08-11","7","1036","2","77","16.7","15.9"
"Pulaski","2020-08-12","11","1047","2","79","17.2","15.4"
"Pulaski","2020-08-13","11","1058","2","81","19.8","16.7"
"Pulaski","2020-08-14","10","1068","1","82","19.5","16.8"
"Pulaski","2020-08-15","5","1073","1","83","18.8","16.8"
"Pulaski","2020-08-16","6","1079","0","83","14","16.8"
"Pulaski","2020-08-17","11","1090","2","85","16.2","17.2"
"Pulaski","2020-08-18","20","1110","4","89","14.9","15.8"
"Pulaski","2020-08-19","10","1120","3","92","16.6","16.9"
"Pulaski","2020-08-20","6","1126","3","95","21.2","20.5"
"Pulaski","2020-08-21","5","1131","1","96","22.6","21"
"Pulaski","2020-08-22","3","1134","2","98","29.3","24"
"Pulaski","2020-08-23","8","1142","2","100","32.8","23.4"
"Pulaski","2020-08-24","135","1277","17","117","32","24.1"
"Pulaski","2020-08-25","11","1288","9","126","40.9","27.9"
"Pulaski","2020-08-26","11","1299","7","133","45.7","31.1"
"Pulaski","2020-08-27","5","1304","1","134","41.4","31.3"
"Pulaski","2020-08-28","17","1321","10","144","46.9","34.8"
"Pulaski","2020-08-29","2","1323","1","145","44.6","36.9"
"Pulaski","2020-08-30","2","1325","2","147","55.3","44.1"
"Pulaski","2020-08-31","162","1487","18","165","55.1","43.5"
"Pulaski","2020-09-01","8","1495","3","168","48.7","44.8"
"Pulaski","2020-09-02","7","1502","6","174","51.9","48.8"
"Pulaski","2020-09-03","6","1508","4","178","58.5","50"
"Pulaski","2020-09-04","2","1510","1","179","57.3","52.1"
"Pulaski","2020-09-05","0","1510","0","179","50.1","47.3"
"Pulaski","2020-09-06","3","1513","0","179","35.9","45.6"
"Pulaski","2020-09-07","0","1513","0","179","34.3","44.7"
"Pulaski","2020-09-08","15","1528","11","190","39.4","44.1"
"Pulaski","2020-09-09","13","1541","10","200","38.1","45"
"Pulaski","2020-09-10","34","1575","3","203","29.9","44.2"
"Pulaski","2020-09-11","4","1579","0","203","22.7","40"
"Pulaski","2020-09-12","1","1580","0","203","22.7","36.4"
"Pulaski","2020-09-13","2","1582","0","203","22.7","29.3"
"Pulaski","2020-09-14","47","1629","4","207","23.9","29.1"
"Pulaski","2020-09-15","3","1632","1","208","18.2","28.8"
"Pulaski","2020-09-16","7","1639","1","209","9.3","23.7"
"Pulaski","2020-09-17","9","1648","2","211","11.2","20.5"
"Pulaski","2020-09-18","7","1655","1","212","13.2","18"
"Pulaski","2020-09-19","3","1658","0","212","13.2","18"
"Pulaski","2020-09-20","3","1661","0","212","13.2","18"
"Pulaski","2020-09-21","49","1710","0","212","12","18"
"Pulaski","2020-09-22","4","1714","1","213","10.8","14.5"
"Pulaski","2020-09-23","0","1714","0","213","8.8","9"
"Pulaski","2020-09-24","8","1722","1","214","7.4","9.3"
"Pulaski","2020-09-25","2","1724","0","214","5.4","9.3"
"Pulaski","2020-09-26","1","1725","0","214","5.4","9.3"
"Pulaski","2020-09-27","1","1726","1","215","19.6","16.4"
"Pulaski","2020-09-28","55","1781","1","216","19.9","16"
"Pulaski","2020-09-29","5","1786","2","218","22","16.4"
"Pulaski","2020-09-30","0","1786","0","218","22","15.4"
"Pulaski","2020-10-01","6","1792","0","218","20.3","13.8"
"Pulaski","2020-10-02","2","1794","0","218","20.3","12.8"
"Pulaski","2020-10-03","0","1794","0","218","20.3","12.8"
"Pulaski","2020-10-04","0","1794","0","218","6","12.8"
"Pulaski","2020-10-05","48","1842","0","218","5.7","12.8"
"Pulaski","2020-10-06","5","1847","0","218","0","11"
"Pulaski","2020-10-07","2","1849","0","218","0","11"
"Pulaski","2020-10-08","2","1851","0","218","0","10.1"
"Pulaski","2020-10-09","1","1852","0","218","0","10.1"
"Pulaski","2020-10-10","4","1856","1","219","3.6","11.9"
"Pulaski","2020-10-11","1","1857","0","219","3.6","4.8"
"Pulaski","2020-10-12","11","1868","1","220","4.9","5.3"
"Pulaski","2020-10-13","4","1872","0","220","4.9","2.4"
"Pulaski","2020-10-14","6","1878","2","222","9.6","4.8"
"Pulaski","2020-10-15","5","1883","1","223","12.5","6.2"
"Pulaski","2020-10-16","7","1890","0","223","12.5","6.2"
"Pulaski","2020-10-17","2","1892","1","224","16.1","9.8"
"Pulaski","2020-10-18","1","1893","0","224","16.1","9.8"
"Pulaski","2020-10-19","59","1952","8","232","16.7","10.8"
"Pulaski","2020-10-20","4","1956","1","233","20.3","12.6"
"Pulaski","2020-10-21","5","1961","1","234","18.4","14"
"Pulaski","2020-10-22","4","1965","0","234","15.5","14"
"Pulaski","2020-10-23","7","1972","1","235","17.5","15"
"Pulaski","2020-10-24","0","1972","0","235","10.4","13.2"
"Pulaski","2020-10-25","3","1975","1","236","15.2","15.6"
"Pulaski","2020-10-26","70","2045","4","240","14","15.4"
"Pulaski","2020-10-27","6","2051","1","241","12.9","16.6"
"Pulaski","2020-10-28","3","2054","1","242","14.8","16.6"
"Pulaski","2020-10-29","3","2057","0","242","14.8","15.1"
"Pulaski","2020-10-30","6","2063","0","242","12.7","15.1"
"Pulaski","2020-10-31","2","2065","0","242","12.7","11.6"
"Pulaski","2020-11-01","3","2068","0","242","8","11.6"
"Pulaski","2020-11-02","26","2094","1","243","7.7","10.9"
"Pulaski","2020-11-03","24","2118","4","247","7.7","10.3"
"Pulaski","2020-11-04","30","2148","3","250","4.4","9.6"
"Pulaski","2020-11-05","4","2152","1","251","7.9","11.3"
"Pulaski","2020-11-06","3","2155","0","251","7.9","10.3"
"Pulaski","2020-11-07","0","2155","0","251","7.9","10.3"
"Pulaski","2020-11-08","1","2156","0","251","7.9","7.9"
"Pulaski","2020-11-09","60","2216","10","261","9.8","8.7"
"Pulaski","2020-11-10","19","2235","0","261","7.4","7.5"
"Pulaski","2020-11-11","6","2241","0","261","6","5.2"
"Pulaski","2020-11-12","4","2245","0","261","2.4","5.2"
"Pulaski","2020-11-13","5","2250","0","261","2.4","5.2"
"Pulaski","2020-11-14","3","2253","0","261","2.4","5.2"
"Pulaski","2020-11-15","6","2259","0","261","2.4","5.2"
"Pulaski","2020-11-16","15","2274","1","262","1","5.4"
"Pulaski","2020-11-17","7","2281","1","263","3","5.2"
"Pulaski","2020-11-18","2","2283","0","263","3","4.5"
"Pulaski","2020-11-19","2","2285","1","264","10.1","6.3"
"Pulaski","2020-11-20","6","2291","0","264","10.1","6.3"
"Pulaski","2020-11-21","2","2293","1","265","17.3","9.8"
"Pulaski","2020-11-22","3","2296","0","265","17.3","9.8"
"Pulaski","2020-11-23","32","2328","3","268","17.7","9.3"
"Pulaski","2020-11-24","7","2335","2","270","19.7","11.3"
"Pulaski","2020-11-25","2","2337","1","271","26.8","14.9"
"Pulaski","2020-11-26","0","2337","0","271","19.7","14.9"
"Pulaski","2020-11-27","9","2346","0","271","19.7","14.9"
"Pulaski","2020-11-28","4","2350","1","272","16.1","16.7"
"Pulaski","2020-11-29","3","2353","1","273","20.9","19.1"
"Pulaski","2020-11-30","76","2429","7","280","20.9","19.3"
"Pulaski","2020-12-01","6","2435","1","281","19.2","19.4"
"Pulaski","2020-12-02","2","2437","1","282","19.2","23"
"Pulaski","2020-12-03","13","2450","0","282","19.2","19.4"
"Pulaski","2020-12-04","10","2460","0","282","19.2","19.4"
"Pulaski","2020-12-05","2","2462","0","282","15.6","15.9"
"Pulaski","2020-12-06","2","2464","0","282","10.8","15.9"
"Pulaski","2020-12-07","60","2524","4","286","10.5","15.7"
"Pulaski","2020-12-08","5","2529","3","289","16.7","17.9"
"Pulaski","2020-12-09","3","2532","0","289","9.5","14.3"
"Pulaski","2020-12-10","4","2536","0","289","9.5","14.3"
"Pulaski","2020-12-11","10","2546","0","289","9.5","14.3"
"Pulaski","2020-12-12","3","2549","1","290","14.3","14.9"
"Pulaski","2020-12-13","1","2550","0","290","14.3","12.6"
"Pulaski","2020-12-14","50","2600","3","293","14.2","12.3"
"Pulaski","2020-12-15","10","2610","0","293","5.6","11.1"
"Pulaski","2020-12-16","6","2616","1","294","8","8.8"
"Pulaski","2020-12-17","7","2623","0","294","8","8.8"
"Pulaski","2020-12-18","3","2626","0","294","8","8.8"
"Pulaski","2020-12-19","3","2629","0","294","3.2","8.8"
"Pulaski","2020-12-20","3","2632","1","295","8","11.1"
"Pulaski","2020-12-21","88","2720","9","304","8.6","11.4"
"Pulaski","2020-12-22","3","2723","0","304","8.6","7.1"
"Pulaski","2020-12-23","7","2730","2","306","10.3","9.2"
"Pulaski","2020-12-24","9","2739","1","307","11.9","9.9"
"Pulaski","2020-12-25","3","2742","1","308","16.7","12.3"
"Pulaski","2020-12-26","1","2743","0","308","16.7","9.9"
"Pulaski","2020-12-27","1","2744","0","308","11.9","9.9"
"Pulaski","2020-12-28","118","2862","14","322","12.1","10.4"
"Pulaski","2020-12-29","9","2871","0","322","12.1","10.4"
"Pulaski","2020-12-30","10","2881","4","326","13.8","12"
"Pulaski","2020-12-31","11","2892","2","328","14.8","13.3"
"Pulaski","2021-01-01","0","2892","0","328","10","13.3"
"Pulaski","2021-01-02","1","2893","0","328","10","13.3"
"Pulaski","2021-01-03","12","2905","3","331","13.6","12.7"
"Pulaski","2021-01-04","164","3069","20","351","13.6","12.9"
"Pulaski","2021-01-05","16","3085","2","353","15.4","13.8"
"Pulaski","2021-01-06","9","3094","4","357","16","14.9"
"Pulaski","2021-01-07","8","3102","1","358","15.2","15"
"Pulaski","2021-01-08","9","3111","2","360","18.4","14.2"
"Pulaski","2021-01-09","3","3114","0","360","18.4","14.2"
"Pulaski","2021-01-10","6","3120","1","361","17.2","15.4"
"Pulaski","2021-01-11","5","3125","2","363","21.2","17.4"
"Pulaski","2021-01-12","19","3144","3","366","21.7","18.5"
"Pulaski","2021-01-13","5","3149","2","368","21","18.5"
"Pulaski","2021-01-14","9","3158","1","369","20.8","18"
"Pulaski","2021-01-15","14","3172","5","374","22.8","20.6"
"Pulaski","2021-01-16","6","3178","0","374","22.8","20.6"
"Pulaski","2021-01-17","2","3180","0","374","20.4","18.8"
"Pulaski","2021-01-18","75","3255","16","390","17.7","19.4"
"Pulaski","2021-01-19","12","3267","2","392","17.8","19.7"
"Pulaski","2021-01-20","9","3276","2","394","15.3","18.2"
"Pulaski","2021-01-21","4","3280","0","394","13.7","17.3"
"Pulaski","2021-01-22","4","3284","1","395","12.2","17.5"
"Pulaski","2021-01-23","1","3285","0","395","12.2","17.5"
"Pulaski","2021-01-24","6","3291","3","398","19.3","19.8"
"Pulaski","2021-01-25","12","3303","2","400","18.7","18.2"
"Pulaski","2021-01-26","9","3312","2","402","19.4","18.6"
"Pulaski","2021-01-27","8","3320","1","403","18.1","16.7"
"Pulaski","2021-01-28","7","3327","1","404","20.1","16.9"
"Pulaski","2021-01-29","4","3331","1","405","20.1","16.1"
"Pulaski","2021-01-30","5","3336","1","406","23","17.6"
"Pulaski","2021-01-31","3","3339","0","406","15.8","17.6"
"Pulaski","2021-02-01","130","3469","6","412","14.1","16.4"
"Pulaski","2021-02-02","28","3497","2","414","11.9","15.7"
"Pulaski","2021-02-03","24","3521","4","418","12.5","15.3"
"Pulaski","2021-02-04","8","3529","1","419","12.3","16.2"
"Pulaski","2021-02-05","3","3532","0","419","8.7","14.4"
"Pulaski","2021-02-06","1","3533","0","419","5.8","14.4"
"Pulaski","2021-02-07","0","3533","0","419","5.8","10.8"
"Pulaski","2021-02-08","0","3533","0","419","5.2","9.6"
"Putnam","2020-02-01","0","0","0","0",".","."
"Putnam","2020-02-02","0","0","0","0",".","."
"Putnam","2020-02-03","0","0","0","0",".","."
"Putnam","2020-02-04","0","0","0","0",".","."
"Putnam","2020-02-05","0","0","0","0",".","."
"Putnam","2020-02-06","0","0","0","0",".","."
"Putnam","2020-02-07","0","0","0","0","0","."
"Putnam","2020-02-08","0","0","0","0","0","."
"Putnam","2020-02-09","0","0","0","0","0","."
"Putnam","2020-02-10","0","0","0","0","0","."
"Putnam","2020-02-11","0","0","0","0","0","."
"Putnam","2020-02-12","0","0","0","0","0","."
"Putnam","2020-02-13","0","0","0","0","0","."
"Putnam","2020-02-14","0","0","0","0","0","0"
"Putnam","2020-02-15","0","0","0","0","0","0"
"Putnam","2020-02-16","0","0","0","0","0","0"
"Putnam","2020-02-17","0","0","0","0","0","0"
"Putnam","2020-02-18","0","0","0","0","0","0"
"Putnam","2020-02-19","0","0","0","0","0","0"
"Putnam","2020-02-20","0","0","0","0","0","0"
"Putnam","2020-02-21","0","0","0","0","0","0"
"Putnam","2020-02-22","0","0","0","0","0","0"
"Putnam","2020-02-23","0","0","0","0","0","0"
"Putnam","2020-02-24","0","0","0","0","0","0"
"Putnam","2020-02-25","0","0","0","0","0","0"
"Putnam","2020-02-26","0","0","0","0","0","0"
"Putnam","2020-02-27","0","0","0","0","0","0"
"Putnam","2020-02-28","0","0","0","0","0","0"
"Putnam","2020-02-29","0","0","0","0","0","0"
"Putnam","2020-03-01","0","0","0","0","0","0"
"Putnam","2020-03-02","0","0","0","0","0","0"
"Putnam","2020-03-03","0","0","0","0","0","0"
"Putnam","2020-03-04","0","0","0","0","0","0"
"Putnam","2020-03-05","0","0","0","0","0","0"
"Putnam","2020-03-06","0","0","0","0","0","0"
"Putnam","2020-03-07","0","0","0","0","0","0"
"Putnam","2020-03-08","0","0","0","0","0","0"
"Putnam","2020-03-09","0","0","0","0","0","0"
"Putnam","2020-03-10","1","1","0","0","0","0"
"Putnam","2020-03-11","0","1","0","0","0","0"
"Putnam","2020-03-12","3","4","0","0","0","0"
"Putnam","2020-03-13","2","6","0","0","0","0"
"Putnam","2020-03-14","0","6","0","0","0","0"
"Putnam","2020-03-15","0","6","0","0","0","0"
"Putnam","2020-03-16","3","9","0","0","0","0"
"Putnam","2020-03-17","1","10","0","0","0","0"
"Putnam","2020-03-18","6","16","0","0","0","0"
"Putnam","2020-03-19","1","17","0","0","0","0"
"Putnam","2020-03-20","3","20","0","0","0","0"
"Putnam","2020-03-21","1","21","0","0","0","0"
"Putnam","2020-03-22","2","23","0","0","0","0"
"Putnam","2020-03-23","2","25","0","0","0","0"
"Putnam","2020-03-24","1","26","0","0","0","0"
"Putnam","2020-03-25","1","27","0","0","0","0"
"Putnam","2020-03-26","6","33","0","0","0","0"
"Putnam","2020-03-27","4","37","0","0","0","0"
"Putnam","2020-03-28","0","37","0","0","0","0"
"Putnam","2020-03-29","0","37","0","0","0","0"
"Putnam","2020-03-30","2","39","1","1","7.1","3.6"
"Putnam","2020-03-31","4","43","0","1","7.1","3.6"
"Putnam","2020-04-01","7","50","0","1","7.1","3.6"
"Putnam","2020-04-02","7","57","0","1","7.1","3.6"
"Putnam","2020-04-03","3","60","0","1","7.1","3.6"
"Putnam","2020-04-04","11","71","0","1","7.1","3.6"
"Putnam","2020-04-05","8","79","3","4","12.5","6.3"
"Putnam","2020-04-06","5","84","0","4","5.4","6.3"
"Putnam","2020-04-07","1","85","0","4","5.4","6.3"
"Putnam","2020-04-08","8","93","0","4","5.4","6.3"
"Putnam","2020-04-09","5","98","1","5","8.2","7.7"
"Putnam","2020-04-10","3","101","1","6","13","10.1"
"Putnam","2020-04-11","5","106","4","10","24.4","15.8"
"Putnam","2020-04-12","1","107","0","10","19","15.8"
"Putnam","2020-04-13","6","113","0","10","19","12.2"
"Putnam","2020-04-14","14","127","3","13","22.1","13.7"
"Putnam","2020-04-15","13","140","1","14","23.2","14.3"
"Putnam","2020-04-16","16","156","6","20","25.7","17"
"Putnam","2020-04-17","24","180","4","24","23.3","18.2"
"Putnam","2020-04-18","15","195","0","24","11.9","18.2"
"Putnam","2020-04-19","4","199","0","24","11.9","15.5"
"Putnam","2020-04-20","12","211","0","24","11.9","15.5"
"Putnam","2020-04-21","16","227","0","24","8.8","15.5"
"Putnam","2020-04-22","12","239","0","24","7.7","15.5"
"Putnam","2020-04-23","27","266","6","30","5.6","15.6"
"Putnam","2020-04-24","8","274","0","30","3.2","13.3"
"Putnam","2020-04-25","20","294","5","35","6.7","9.3"
"Putnam","2020-04-26","4","298","0","35","6.7","9.3"
"Putnam","2020-04-27","10","308","3","38","11","11.5"
"Putnam","2020-04-28","19","327","1","39","11.8","10.3"
"Putnam","2020-04-29","7","334","2","41","15.9","11.8"
"Putnam","2020-04-30","10","344","0","41","12.7","9.1"
"Putnam","2020-05-01","20","364","3","44","14.8","9"
"Putnam","2020-05-02","14","378","2","46","13.3","10"
"Putnam","2020-05-03","7","385","2","48","17.4","12.1"
"Putnam","2020-05-04","15","400","2","50","15","13"
"Putnam","2020-05-05","13","413","1","51","15.4","13.6"
"Putnam","2020-05-06","50","463","1","52","11.6","13.7"
"Putnam","2020-05-07","24","487","1","53","12.1","12.4"
"Putnam","2020-05-08","12","499","0","53","10","12.4"
"Putnam","2020-05-09","12","511","1","54","9.2","11.2"
"Putnam","2020-05-10","3","514","0","54","5.1","11.2"
"Putnam","2020-05-11","9","523","0","54","3.2","9.1"
"Putnam","2020-05-12","15","538","1","55","3","9.2"
"Putnam","2020-05-13","18","556","0","55","2.7","7.1"
"Putnam","2020-05-14","7","563","0","55","2.1","7.1"
"Putnam","2020-05-15","20","583","0","55","2.1","6.1"
"Putnam","2020-05-16","11","594","1","56","2.3","5.7"
"Putnam","2020-05-17","6","600","0","56","2.3","3.7"
"Putnam","2020-05-18","18","618","1","57","3","3.1"
"Putnam","2020-05-19","16","634","1","58","3","3"
"Putnam","2020-05-20","9","643","1","59","4.6","3.7"
"Putnam","2020-05-21","46","689","2","61","5.2","3.7"
"Putnam","2020-05-22","14","703","0","61","5.2","3.7"
"Putnam","2020-05-23","6","709","0","61","3.9","3.1"
"Putnam","2020-05-24","3","712","0","61","3.9","3.1"
"Putnam","2020-05-25","7","719","0","61","3.1","3.1"
"Putnam","2020-05-26","19","738","1","62","3","3"
"Putnam","2020-05-27","24","762","1","63","2","3.3"
"Putnam","2020-05-28","22","784","0","63","1.3","3.3"
"Putnam","2020-05-29","14","798","0","63","1.3","3.3"
"Putnam","2020-05-30","7","805","0","63","1.3","2.6"
"Putnam","2020-05-31","3","808","0","63","1.3","2.6"
"Putnam","2020-06-01","9","817","1","64","2.9","3"
"Putnam","2020-06-02","26","843","2","66","3.3","3.1"
"Putnam","2020-06-03","28","871","1","67","3.2","2.6"
"Putnam","2020-06-04","78","949","0","67","3.2","2.3"
"Putnam","2020-06-05","30","979","2","69","4.1","2.7"
"Putnam","2020-06-06","7","986","1","70","6.2","3.8"
"Putnam","2020-06-07","2","988","0","70","6.2","3.8"
"Putnam","2020-06-08","21","1009","2","72","6","4.4"
"Putnam","2020-06-09","28","1037","1","73","5.4","4.3"
"Putnam","2020-06-10","29","1066","2","75","5.8","4.5"
"Putnam","2020-06-11","59","1125","3","78","6.6","4.9"
"Putnam","2020-06-12","21","1146","0","78","5.6","4.9"
"Putnam","2020-06-13","2","1148","0","78","3.6","4.9"
"Putnam","2020-06-14","4","1152","0","78","3.6","4.9"
"Putnam","2020-06-15","23","1175","2","80","3.5","4.7"
"Putnam","2020-06-16","17","1192","2","82","4.6","5"
"Putnam","2020-06-17","23","1215","1","83","4.3","5.1"
"Putnam","2020-06-18","65","1280","2","85","4","5.3"
"Putnam","2020-06-19","32","1312","3","88","5.3","5.5"
"Putnam","2020-06-20","9","1321","1","89","6.9","5.2"
"Putnam","2020-06-21","3","1324","0","89","6.9","5.2"
"Putnam","2020-06-22","33","1357","6","95","8.3","5.9"
"Putnam","2020-06-23","41","1398","17","112","12.5","8.6"
"Putnam","2020-06-24","25","1423","2","114","13","8.7"
"Putnam","2020-06-25","117","1540","21","135","15.2","9.6"
"Putnam","2020-06-26","45","1585","8","143","16.4","10.8"
"Putnam","2020-06-27","24","1609","3","146","16.6","11.7"
"Putnam","2020-06-28","5","1614","1","147","19.4","13.2"
"Putnam","2020-06-29","46","1660","8","155","19.3","13.8"
"Putnam","2020-06-30","30","1690","3","158","14.8","13.7"
"Putnam","2020-07-01","32","1722","4","162","15.4","14.2"
"Putnam","2020-07-02","100","1822","4","166","13.5","14.3"
"Putnam","2020-07-03","11","1833","1","167","12.2","14.3"
"Putnam","2020-07-04","6","1839","1","168","12.8","14.7"
"Putnam","2020-07-05","7","1846","2","170","14","16.7"
"Putnam","2020-07-06","64","1910","9","179","13.6","16.4"
"Putnam","2020-07-07","21","1931","4","183","14.8","14.8"
"Putnam","2020-07-08","89","2020","4","187","13.7","14.6"
"Putnam","2020-07-09","97","2117","9","196","14.5","14"
"Putnam","2020-07-10","22","2139","4","200","15.8","14"
"Putnam","2020-07-11","7","2146","1","201","15.4","14.1"
"Putnam","2020-07-12","9","2155","1","202","12.9","13.5"
"Putnam","2020-07-13","24","2179","2","204","12.1","12.8"
"Putnam","2020-07-14","31","2210","5","209","11.7","13.3"
"Putnam","2020-07-15","45","2255","8","217","13.6","13.6"
"Putnam","2020-07-16","94","2349","7","224","13.3","13.9"
"Putnam","2020-07-17","23","2372","5","229","13.8","14.8"
"Putnam","2020-07-18","7","2379","0","229","11.8","13.6"
"Putnam","2020-07-19","2","2381","0","229","10.2","11.6"
"Putnam","2020-07-20","121","2502","9","238","10.1","11.1"
"Putnam","2020-07-21","30","2532","6","244","10.6","11.2"
"Putnam","2020-07-22","22","2554","8","252","13.3","13.4"
"Putnam","2020-07-23","81","2635","9","261","13.8","13.6"
"Putnam","2020-07-24","20","2655","2","263","12.1","13"
"Putnam","2020-07-25","9","2664","3","266","16.9","14.3"
"Putnam","2020-07-26","9","2673","1","267","18.5","14.3"
"Putnam","2020-07-27","81","2754","3","270","17.9","14"
"Putnam","2020-07-28","24","2778","9","279","20.4","15.5"
"Putnam","2020-07-29","27","2805","3","282","16.8","15.1"
"Putnam","2020-07-30","106","2911","8","290","16.3","15.1"
"Putnam","2020-07-31","29","2940","8","298","18.8","15.5"
"Putnam","2020-08-01","12","2952","0","298","14.1","15.5"
"Putnam","2020-08-02","10","2962","1","299","13.9","16.2"
"Putnam","2020-08-03","95","3057","8","307","14.6","16.3"
"Putnam","2020-08-04","16","3073","5","312","13.7","17.1"
"Putnam","2020-08-05","21","3094","4","316","14.8","15.8"
"Putnam","2020-08-06","62","3156","5","321","14.9","15.6"
"Putnam","2020-08-07","36","3192","4","325","12.6","15.7"
"Putnam","2020-08-08","13","3205","0","325","12.6","13.3"
"Putnam","2020-08-09","12","3217","4","329","15.9","14.9"
"Putnam","2020-08-10","44","3261","3","332","15.7","15.1"
"Putnam","2020-08-11","21","3282","1","333","11.9","12.8"
"Putnam","2020-08-12","18","3300","4","337","12.3","13.6"
"Putnam","2020-08-13","25","3325","4","341","13.5","14.2"
"Putnam","2020-08-14","22","3347","3","344","13.8","13.2"
"Putnam","2020-08-15","2","3349","0","344","13.8","13.2"
"Putnam","2020-08-16","7","3356","1","345","11.1","13.5"
"Putnam","2020-08-17","20","3376","2","347","11.6","13.6"
"Putnam","2020-08-18","25","3401","3","350","12.6","12.2"
"Putnam","2020-08-19","24","3425","4","354","11.8","12.1"
"Putnam","2020-08-20","53","3478","13","367","13","13.2"
"Putnam","2020-08-21","32","3510","0","367","11.1","12.4"
"Putnam","2020-08-22","6","3516","1","368","13.4","13.6"
"Putnam","2020-08-23","10","3526","2","370","14.3","12.7"
"Putnam","2020-08-24","43","3569","3","373","13.8","12.7"
"Putnam","2020-08-25","25","3594","2","375","13.3","12.9"
"Putnam","2020-08-26","25","3619","3","378","12.6","12.2"
"Putnam","2020-08-27","49","3668","5","383","10.5","11.8"
"Putnam","2020-08-28","26","3694","1","384","11.1","11.1"
"Putnam","2020-08-29","7","3701","1","385","10.8","12.1"
"Putnam","2020-08-30","9","3710","1","386","9.5","11.9"
"Putnam","2020-08-31","47","3757","3","389","9.4","11.6"
"Putnam","2020-09-01","29","3786","2","391","9.2","11.3"
"Putnam","2020-09-02","15","3801","2","393","9.4","11"
"Putnam","2020-09-03","53","3854","4","397","9.1","9.8"
"Putnam","2020-09-04","28","3882","0","397","8.5","9.8"
"Putnam","2020-09-05","11","3893","0","397","6.5","8.6"
"Putnam","2020-09-06","9","3902","3","400","9.6","9.6"
"Putnam","2020-09-07","36","3938","1","401","9.1","9.3"
"Putnam","2020-09-08","25","3963","1","402","8.7","9"
"Putnam","2020-09-09","33","3996","2","404","7.7","8.6"
"Putnam","2020-09-10","26","4022","1","405","7.1","8.1"
"Putnam","2020-09-11","27","4049","2","407","8.2","8.4"
"Putnam","2020-09-12","9","4058","1","408","9.8","8.1"
"Putnam","2020-09-13","3","4061","1","409","9.8","9.7"
"Putnam","2020-09-14","50","4111","3","412","10.3","9.7"
"Putnam","2020-09-15","24","4135","0","412","9.7","9.2"
"Putnam","2020-09-16","41","4176","0","412","8.8","8.2"
"Putnam","2020-09-17","47","4223","3","415","9.2","8.2"
"Putnam","2020-09-18","37","4260","1","416","8.5","8.4"
"Putnam","2020-09-19","13","4273","2","418","9.1","9.5"
"Putnam","2020-09-20","21","4294","0","418","4.4","7.1"
"Putnam","2020-09-21","41","4335","2","420","4.2","7.2"
"Putnam","2020-09-22","33","4368","2","422","5.1","7.4"
"Putnam","2020-09-23","13","4381","1","423","6.2","7.5"
"Putnam","2020-09-24","33","4414","5","428","7.4","8.3"
"Putnam","2020-09-25","45","4459","1","429","7.3","7.9"
"Putnam","2020-09-26","27","4486","3","432","6.7","7.9"
"Putnam","2020-09-27","4","4490","0","432","6.7","5.5"
"Putnam","2020-09-28","54","4544","2","434","6.6","5.4"
"Putnam","2020-09-29","22","4566","2","436","7","6"
"Putnam","2020-09-30","21","4587","4","440","8.6","7.4"
"Putnam","2020-10-01","44","4631","7","447","8.7","8.1"
"Putnam","2020-10-02","33","4664","6","453","11","9.2"
"Putnam","2020-10-03","22","4686","1","454","10.1","8.4"
"Putnam","2020-10-04","8","4694","1","455","11.9","9.3"
"Putnam","2020-10-05","59","4753","8","463","13.3","9.9"
"Putnam","2020-10-06","32","4785","4","467","13.7","10.4"
"Putnam","2020-10-07","26","4811","2","469","12.1","10.4"
"Putnam","2020-10-08","44","4855","5","474","11.5","10.1"
"Putnam","2020-10-09","34","4889","1","475","9.3","10.2"
"Putnam","2020-10-10","7","4896","0","475","8.7","9.4"
"Putnam","2020-10-11","8","4904","1","476","8.7","10.3"
"Putnam","2020-10-12","27","4931","2","478","7.8","10.5"
"Putnam","2020-10-13","37","4968","5","483","7.9","10.8"
"Putnam","2020-10-14","21","4989","1","484","7.5","9.8"
"Putnam","2020-10-15","42","5031","5","489","7.6","9.5"
"Putnam","2020-10-16","22","5053","0","489","7.2","8.2"
"Putnam","2020-10-17","6","5059","0","489","7.2","7.9"
"Putnam","2020-10-18","8","5067","0","489","5.4","7"
"Putnam","2020-10-19","35","5102","3","492","5.5","6.7"
"Putnam","2020-10-20","24","5126","0","492","3.6","5.8"
"Putnam","2020-10-21","26","5152","1","493","3.5","5.5"
"Putnam","2020-10-22","44","5196","5","498","3.4","5.5"
"Putnam","2020-10-23","31","5227","1","499","3.9","5.5"
"Putnam","2020-10-24","10","5237","1","500","5.3","6.2"
"Putnam","2020-10-25","9","5246","0","500","5.3","5.3"
"Putnam","2020-10-26","42","5288","2","502","4.7","5.1"
"Putnam","2020-10-27","35","5323","2","504","5.6","4.6"
"Putnam","2020-10-28","40","5363","7","511","7.5","5.5"
"Putnam","2020-10-29","34","5397","3","514","7.1","5.3"
"Putnam","2020-10-30","31","5428","1","515","7.1","5.5"
"Putnam","2020-10-31","16","5444","0","515","5.7","5.5"
"Putnam","2020-11-01","8","5452","1","516","7.5","6.4"
"Putnam","2020-11-02","39","5491","3","519","7.9","6.3"
"Putnam","2020-11-03","40","5531","9","528","10.3","7.9"
"Putnam","2020-11-04","42","5573","3","531","8.8","8.2"
"Putnam","2020-11-05","35","5608","3","534","8.8","8"
"Putnam","2020-11-06","38","5646","2","536","9.1","8.1"
"Putnam","2020-11-07","11","5657","0","536","9.1","7.4"
"Putnam","2020-11-08","15","5672","0","536","7.3","7.4"
"Putnam","2020-11-09","23","5695","1","537","6.8","7.4"
"Putnam","2020-11-10","37","5732","3","540","4.8","7.5"
"Putnam","2020-11-11","24","5756","2","542","4.9","6.9"
"Putnam","2020-11-12","56","5812","3","545","4.5","6.6"
"Putnam","2020-11-13","27","5839","2","547","4.8","6.9"
"Putnam","2020-11-14","10","5849","0","547","4.8","6.9"
"Putnam","2020-11-15","8","5857","1","548","6.6","6.9"
"Putnam","2020-11-16","56","5913","1","549","6.2","6.5"
"Putnam","2020-11-17","38","5951","1","550","5.4","5.1"
"Putnam","2020-11-18","36","5987","3","553","5.4","5.2"
"Putnam","2020-11-19","29","6016","4","557","6.6","5.6"
"Putnam","2020-11-20","30","6046","2","559","6.5","5.7"
"Putnam","2020-11-21","8","6054","2","561","10.1","7.4"
"Putnam","2020-11-22","10","6064","0","561","8.3","7.4"
"Putnam","2020-11-23","29","6093","2","563","9","7.6"
"Putnam","2020-11-24","34","6127","4","567","10.4","7.9"
"Putnam","2020-11-25","35","6162","2","569","10","7.7"
"Putnam","2020-11-26","13","6175","1","570","9.1","7.9"
"Putnam","2020-11-27","31","6206","4","574","10","8.3"
"Putnam","2020-11-28","9","6215","0","574","6.4","8.3"
"Putnam","2020-11-29","13","6228","1","575","7.5","7.9"
"Putnam","2020-11-30","44","6272","5","580","8.2","8.6"
"Putnam","2020-12-01","37","6309","4","584","8","9.2"
"Putnam","2020-12-02","33","6342","3","587","8.5","9.2"
"Putnam","2020-12-03","61","6403","8","595","9.3","9.2"
"Putnam","2020-12-04","47","6450","3","598","8.4","9.2"
"Putnam","2020-12-05","17","6467","3","601","10.9","8.6"
"Putnam","2020-12-06","10","6477","3","604","14.1","10.8"
"Putnam","2020-12-07","35","6512","4","608","14.1","11.1"
"Putnam","2020-12-08","37","6549","4","612","14.1","11"
"Putnam","2020-12-09","41","6590","5","617","14.5","11.5"
"Putnam","2020-12-10","61","6651","15","632","16.2","12.7"
"Putnam","2020-12-11","30","6681","2","634","16.2","12.3"
"Putnam","2020-12-12","13","6694","1","635","14.8","12.8"
"Putnam","2020-12-13","13","6707","3","638","13.8","13.9"
"Putnam","2020-12-14","63","6770","15","653","15.5","14.8"
"Putnam","2020-12-15","62","6832","7","660","15.6","14.8"
"Putnam","2020-12-16","76","6908","11","671","15.9","15.2"
"Putnam","2020-12-17","125","7033","11","682","13.7","14.9"
"Putnam","2020-12-18","46","7079","7","689","14.9","15.5"
"Putnam","2020-12-19","17","7096","4","693","17.2","16"
"Putnam","2020-12-20","19","7115","5","698","17.6","15.7"
"Putnam","2020-12-21","61","7176","15","713","17.7","16.6"
"Putnam","2020-12-22","40","7216","8","721","19","17.3"
"Putnam","2020-12-23","40","7256","7","728","19.4","17.7"
"Putnam","2020-12-24","32","7288","14","742","24.4","19.1"
"Putnam","2020-12-25","6","7294","0","742","22.2","18.6"
"Putnam","2020-12-26","28","7322","12","754","25","21.1"
"Putnam","2020-12-27","26","7348","7","761","25.1","21.4"
"Putnam","2020-12-28","70","7418","19","780","25.5","21.6"
"Putnam","2020-12-29","46","7464","17","797","27.9","23.4"
"Putnam","2020-12-30","29","7493","4","801","27.3","23.4"
"Putnam","2020-12-31","81","7574","16","817","23.9","24.2"
"Putnam","2021-01-01","17","7591","5","822","28.1","25.2"
"Putnam","2021-01-02","25","7616","2","824","23.1","24.1"
"Putnam","2021-01-03","13","7629","3","827","22.6","23.8"
"Putnam","2021-01-04","66","7695","15","842","22","23.7"
"Putnam","2021-01-05","115","7810","6","848","17.4","22.7"
"Putnam","2021-01-06","84","7894","18","866","18.5","22.9"
"Putnam","2021-01-07","137","8031","30","896","18.8","21.4"
"Putnam","2021-01-08","81","8112","24","920","18.9","23.5"
"Putnam","2021-01-09","19","8131","6","926","22.2","22.7"
"Putnam","2021-01-10","22","8153","3","929","20.9","21.7"
"Putnam","2021-01-11","55","8208","9","938","20","21"
"Putnam","2021-01-12","56","8264","14","952","22.8","20.1"
"Putnam","2021-01-13","73","8337","20","972","23.6","21.1"
"Putnam","2021-01-14","94","8431","16","988","22.9","20.9"
"Putnam","2021-01-15","54","8485","9","997","21.1","20"
"Putnam","2021-01-16","18","8503","4","1001","19.8","21"
"Putnam","2021-01-17","24","8527","3","1004","19.6","20.2"
"Putnam","2021-01-18","43","8570","7","1011","19.6","19.8"
"Putnam","2021-01-19","58","8628","9","1020","18.2","20.5"
"Putnam","2021-01-20","45","8673","7","1027","16.5","20.1"
"Putnam","2021-01-21","83","8756","12","1039","16.2","19.6"
"Putnam","2021-01-22","46","8802","9","1048","16.6","18.8"
"Putnam","2021-01-23","27","8829","2","1050","14.5","17.1"
"Putnam","2021-01-24","12","8841","2","1052","15.1","17.3"
"Putnam","2021-01-25","66","8907","14","1066","15.8","17.7"
"Putnam","2021-01-26","47","8954","9","1075","16.3","17.3"
"Putnam","2021-01-27","57","9011","11","1086","16.8","16.7"
"Putnam","2021-01-28","88","9099","15","1101","17.2","16.7"
"Putnam","2021-01-29","45","9144","8","1109","16.9","16.8"
"Putnam","2021-01-30","19","9163","2","1111","17.4","15.9"
"Putnam","2021-01-31","23","9186","3","1114","16.9","16"
"Putnam","2021-02-01","59","9245","10","1124","16.3","16"
"Putnam","2021-02-02","38","9283","7","1131","16.2","16.2"
"Putnam","2021-02-03","48","9331","7","1138","15.5","16.2"
"Putnam","2021-02-04","92","9423","12","1150","14.9","16"
"Putnam","2021-02-05","35","9458","3","1153","13.6","15.3"
"Putnam","2021-02-06","6","9464","1","1154","14.5","15.9"
"Putnam","2021-02-07","2","9466","1","1155","19.7","18.3"
"Putnam","2021-02-08","0","9466","0","1155","17.3","16.8"
"Quitman","2020-02-01","0","0","0","0",".","."
"Quitman","2020-02-02","0","0","0","0",".","."
"Quitman","2020-02-03","0","0","0","0",".","."
"Quitman","2020-02-04","0","0","0","0",".","."
"Quitman","2020-02-05","0","0","0","0",".","."
"Quitman","2020-02-06","0","0","0","0",".","."
"Quitman","2020-02-07","0","0","0","0","0","."
"Quitman","2020-02-08","0","0","0","0","0","."
"Quitman","2020-02-09","0","0","0","0","0","."
"Quitman","2020-02-10","0","0","0","0","0","."
"Quitman","2020-02-11","0","0","0","0","0","."
"Quitman","2020-02-12","0","0","0","0","0","."
"Quitman","2020-02-13","0","0","0","0","0","."
"Quitman","2020-02-14","0","0","0","0","0","0"
"Quitman","2020-02-15","0","0","0","0","0","0"
"Quitman","2020-02-16","0","0","0","0","0","0"
"Quitman","2020-02-17","0","0","0","0","0","0"
"Quitman","2020-02-18","0","0","0","0","0","0"
"Quitman","2020-02-19","0","0","0","0","0","0"
"Quitman","2020-02-20","0","0","0","0","0","0"
"Quitman","2020-02-21","0","0","0","0","0","0"
"Quitman","2020-02-22","0","0","0","0","0","0"
"Quitman","2020-02-23","0","0","0","0","0","0"
"Quitman","2020-02-24","0","0","0","0","0","0"
"Quitman","2020-02-25","0","0","0","0","0","0"
"Quitman","2020-02-26","0","0","0","0","0","0"
"Quitman","2020-02-27","0","0","0","0","0","0"
"Quitman","2020-02-28","0","0","0","0","0","0"
"Quitman","2020-02-29","0","0","0","0","0","0"
"Quitman","2020-03-01","0","0","0","0","0","0"
"Quitman","2020-03-02","0","0","0","0","0","0"
"Quitman","2020-03-03","0","0","0","0","0","0"
"Quitman","2020-03-04","0","0","0","0","0","0"
"Quitman","2020-03-05","0","0","0","0","0","0"
"Quitman","2020-03-06","0","0","0","0","0","0"
"Quitman","2020-03-07","0","0","0","0","0","0"
"Quitman","2020-03-08","0","0","0","0","0","0"
"Quitman","2020-03-09","0","0","0","0","0","0"
"Quitman","2020-03-10","0","0","0","0","0","0"
"Quitman","2020-03-11","0","0","0","0","0","0"
"Quitman","2020-03-12","0","0","0","0","0","0"
"Quitman","2020-03-13","0","0","0","0","0","0"
"Quitman","2020-03-14","0","0","0","0","0","0"
"Quitman","2020-03-15","0","0","0","0","0","0"
"Quitman","2020-03-16","0","0","0","0","0","0"
"Quitman","2020-03-17","0","0","0","0","0","0"
"Quitman","2020-03-18","0","0","0","0","0","0"
"Quitman","2020-03-19","1","1","0","0","0","0"
"Quitman","2020-03-20","0","1","0","0","0","0"
"Quitman","2020-03-21","0","1","0","0","0","0"
"Quitman","2020-03-22","0","1","0","0","0","0"
"Quitman","2020-03-23","0","1","0","0","0","0"
"Quitman","2020-03-24","0","1","0","0","0","0"
"Quitman","2020-03-25","0","1","0","0","0","0"
"Quitman","2020-03-26","0","1","0","0","0","0"
"Quitman","2020-03-27","0","1","0","0","0","0"
"Quitman","2020-03-28","0","1","0","0","0","0"
"Quitman","2020-03-29","1","2","0","0","0","0"
"Quitman","2020-03-30","1","3","0","0","0","0"
"Quitman","2020-03-31","2","5","1","1","7.1","3.6"
"Quitman","2020-04-01","0","5","0","1","7.1","3.6"
"Quitman","2020-04-02","2","7","0","1","7.1","3.6"
"Quitman","2020-04-03","2","9","1","2","14.3","7.1"
"Quitman","2020-04-04","1","10","1","3","28.6","14.3"
"Quitman","2020-04-05","0","10","0","3","28.6","14.3"
"Quitman","2020-04-06","4","14","1","4","32.1","16.1"
"Quitman","2020-04-07","2","16","0","4","25","16.1"
"Quitman","2020-04-08","1","17","0","4","25","16.1"
"Quitman","2020-04-09","1","18","0","4","25","16.1"
"Quitman","2020-04-10","0","18","0","4","17.9","16.1"
"Quitman","2020-04-11","0","18","0","4","3.6","16.1"
"Quitman","2020-04-12","0","18","0","4","3.6","16.1"
"Quitman","2020-04-13","1","19","0","4","0","16.1"
"Quitman","2020-04-14","2","21","0","4","0","12.5"
"Quitman","2020-04-15","3","24","0","4","0","12.5"
"Quitman","2020-04-16","1","25","0","4","0","12.5"
"Quitman","2020-04-17","0","25","0","4","0","8.9"
"Quitman","2020-04-18","0","25","0","4","0","1.8"
"Quitman","2020-04-19","0","25","0","4","0","1.8"
"Quitman","2020-04-20","2","27","0","4","0","0"
"Quitman","2020-04-21","9","36","0","4","0","0"
"Quitman","2020-04-22","0","36","0","4","0","0"
"Quitman","2020-04-23","3","39","1","5","4.8","2.4"
"Quitman","2020-04-24","0","39","0","5","4.8","2.4"
"Quitman","2020-04-25","1","40","0","5","4.8","2.4"
"Quitman","2020-04-26","0","40","0","5","4.8","2.4"
"Quitman","2020-04-27","1","41","0","5","4.8","2.4"
"Quitman","2020-04-28","2","43","0","5","4.8","2.4"
"Quitman","2020-04-29","1","44","1","6","19","9.5"
"Quitman","2020-04-30","0","44","0","6","14.3","9.5"
"Quitman","2020-05-01","1","45","0","6","14.3","9.5"
"Quitman","2020-05-02","0","45","0","6","14.3","9.5"
"Quitman","2020-05-03","0","45","0","6","14.3","9.5"
"Quitman","2020-05-04","2","47","0","6","14.3","9.5"
"Quitman","2020-05-05","5","52","0","6","14.3","9.5"
"Quitman","2020-05-06","1","53","0","6","0","9.5"
"Quitman","2020-05-07","2","55","0","6","0","7.1"
"Quitman","2020-05-08","2","57","0","6","0","7.1"
"Quitman","2020-05-09","0","57","0","6","0","7.1"
"Quitman","2020-05-10","1","58","0","6","0","7.1"
"Quitman","2020-05-11","0","58","0","6","0","7.1"
"Quitman","2020-05-12","11","69","1","7","1.3","7.8"
"Quitman","2020-05-13","2","71","0","7","1.3","0.6"
"Quitman","2020-05-14","0","71","0","7","1.3","0.6"
"Quitman","2020-05-15","4","75","0","7","1.3","0.6"
"Quitman","2020-05-16","0","75","0","7","1.3","0.6"
"Quitman","2020-05-17","1","76","0","7","1.3","0.6"
"Quitman","2020-05-18","2","78","0","7","1.3","0.6"
"Quitman","2020-05-19","7","85","1","8","2","1.7"
"Quitman","2020-05-20","0","85","0","8","2","1.7"
"Quitman","2020-05-21","0","85","0","8","2","1.7"
"Quitman","2020-05-22","1","86","0","8","2","1.7"
"Quitman","2020-05-23","1","87","0","8","2","1.7"
"Quitman","2020-05-24","3","90","0","8","2","1.7"
"Quitman","2020-05-25","0","90","0","8","2","1.7"
"Quitman","2020-05-26","5","95","1","9","2.9","2.4"
"Quitman","2020-05-27","7","102","0","9","2.9","2.4"
"Quitman","2020-05-28","2","104","0","9","2.9","2.4"
"Quitman","2020-05-29","2","106","0","9","2.9","2.4"
"Quitman","2020-05-30","0","106","0","9","2.9","2.4"
"Quitman","2020-05-31","0","106","0","9","2.9","2.4"
"Quitman","2020-06-01","1","107","0","9","2.9","2.4"
"Quitman","2020-06-02","4","111","0","9","0","1.4"
"Quitman","2020-06-03","7","118","1","10","2","2.4"
"Quitman","2020-06-04","6","124","0","10","2","2.4"
"Quitman","2020-06-05","3","127","0","10","2","2.4"
"Quitman","2020-06-06","0","127","0","10","2","2.4"
"Quitman","2020-06-07","1","128","0","10","2","2.4"
"Quitman","2020-06-08","1","129","0","10","2","2.4"
"Quitman","2020-06-09","9","138","1","11","3.6","1.8"
"Quitman","2020-06-10","0","138","0","11","1.6","1.8"
"Quitman","2020-06-11","5","143","1","12","4.4","3.2"
"Quitman","2020-06-12","2","145","0","12","4.4","3.2"
"Quitman","2020-06-13","0","145","0","12","4.4","3.2"
"Quitman","2020-06-14","0","145","0","12","4.4","3.2"
"Quitman","2020-06-15","4","149","0","12","4.4","3.2"
"Quitman","2020-06-16","2","151","0","12","2.9","3.2"
"Quitman","2020-06-17","1","152","0","12","2.9","2.2"
"Quitman","2020-06-18","2","154","0","12","0","2.2"
"Quitman","2020-06-19","2","156","0","12","0","2.2"
"Quitman","2020-06-20","1","157","0","12","0","2.2"
"Quitman","2020-06-21","0","157","0","12","0","2.2"
"Quitman","2020-06-22","2","159","0","12","0","2.2"
"Quitman","2020-06-23","2","161","0","12","0","1.4"
"Quitman","2020-06-24","2","163","0","12","0","1.4"
"Quitman","2020-06-25","6","169","0","12","0","0"
"Quitman","2020-06-26","2","171","1","13","7.1","3.6"
"Quitman","2020-06-27","1","172","0","13","7.1","3.6"
"Quitman","2020-06-28","0","172","0","13","7.1","3.6"
"Quitman","2020-06-29","2","174","0","13","7.1","3.6"
"Quitman","2020-06-30","16","190","0","13","7.1","3.6"
"Quitman","2020-07-01","2","192","0","13","7.1","3.6"
"Quitman","2020-07-02","0","192","0","13","7.1","3.6"
"Quitman","2020-07-03","0","192","0","13","0","3.6"
"Quitman","2020-07-04","0","192","0","13","0","3.6"
"Quitman","2020-07-05","0","192","0","13","0","3.6"
"Quitman","2020-07-06","3","195","0","13","0","3.6"
"Quitman","2020-07-07","23","218","4","17","2.5","4.8"
"Quitman","2020-07-08","1","219","1","18","16.8","12"
"Quitman","2020-07-09","0","219","0","18","16.8","12"
"Quitman","2020-07-10","2","221","0","18","16.8","8.4"
"Quitman","2020-07-11","0","221","0","18","16.8","8.4"
"Quitman","2020-07-12","0","221","0","18","16.8","8.4"
"Quitman","2020-07-13","2","223","1","19","23.9","12"
"Quitman","2020-07-14","1","224","0","19","21.4","12"
"Quitman","2020-07-15","0","224","0","19","7.1","12"
"Quitman","2020-07-16","1","225","0","19","7.1","12"
"Quitman","2020-07-17","1","226","0","19","7.1","12"
"Quitman","2020-07-18","0","226","0","19","7.1","12"
"Quitman","2020-07-19","0","226","0","19","7.1","12"
"Quitman","2020-07-20","4","230","0","19","0","12"
"Quitman","2020-07-21","9","239","0","19","0","10.7"
"Quitman","2020-07-22","4","243","0","19","0","3.6"
"Quitman","2020-07-23","2","245","0","19","0","3.6"
"Quitman","2020-07-24","0","245","0","19","0","3.6"
"Quitman","2020-07-25","0","245","0","19","0","3.6"
"Quitman","2020-07-26","0","245","0","19","0","3.6"
"Quitman","2020-07-27","4","249","0","19","0","0"
"Quitman","2020-07-28","6","255","0","19","0","0"
"Quitman","2020-07-29","1","256","0","19","0","0"
"Quitman","2020-07-30","0","256","0","19","0","0"
"Quitman","2020-07-31","2","258","0","19","0","0"
"Quitman","2020-08-01","0","258","0","19","0","0"
"Quitman","2020-08-02","1","259","0","19","0","0"
"Quitman","2020-08-03","1","260","0","19","0","0"
"Quitman","2020-08-04","9","269","0","19","0","0"
"Quitman","2020-08-05","1","270","0","19","0","0"
"Quitman","2020-08-06","0","270","0","19","0","0"
"Quitman","2020-08-07","2","272","0","19","0","0"
"Quitman","2020-08-08","1","273","0","19","0","0"
"Quitman","2020-08-09","2","275","0","19","0","0"
"Quitman","2020-08-10","0","275","0","19","0","0"
"Quitman","2020-08-11","4","279","0","19","0","0"
"Quitman","2020-08-12","4","283","0","19","0","0"
"Quitman","2020-08-13","3","286","1","20","4.8","2.4"
"Quitman","2020-08-14","0","286","0","20","4.8","2.4"
"Quitman","2020-08-15","1","287","0","20","4.8","2.4"
"Quitman","2020-08-16","1","288","0","20","4.8","2.4"
"Quitman","2020-08-17","1","289","0","20","4.8","2.4"
"Quitman","2020-08-18","1","290","0","20","4.8","2.4"
"Quitman","2020-08-19","0","290","0","20","4.8","2.4"
"Quitman","2020-08-20","0","290","0","20","0","2.4"
"Quitman","2020-08-21","0","290","0","20","0","2.4"
"Quitman","2020-08-22","0","290","0","20","0","2.4"
"Quitman","2020-08-23","1","291","0","20","0","2.4"
"Quitman","2020-08-24","0","291","0","20","0","2.4"
"Quitman","2020-08-25","3","294","0","20","0","2.4"
"Quitman","2020-08-26","0","294","0","20","0","2.4"
"Quitman","2020-08-27","1","295","0","20","0","0"
"Quitman","2020-08-28","0","295","0","20","0","0"
"Quitman","2020-08-29","0","295","0","20","0","0"
"Quitman","2020-08-30","0","295","0","20","0","0"
"Quitman","2020-08-31","1","296","0","20","0","0"
"Quitman","2020-09-01","2","298","0","20","0","0"
"Quitman","2020-09-02","2","300","0","20","0","0"
"Quitman","2020-09-03","1","301","0","20","0","0"
"Quitman","2020-09-04","0","301","0","20","0","0"
"Quitman","2020-09-05","0","301","0","20","0","0"
"Quitman","2020-09-06","0","301","0","20","0","0"
"Quitman","2020-09-07","0","301","0","20","0","0"
"Quitman","2020-09-08","7","308","2","22","4.1","2"
"Quitman","2020-09-09","0","308","0","22","4.1","2"
"Quitman","2020-09-10","2","310","0","22","4.1","2"
"Quitman","2020-09-11","0","310","0","22","4.1","2"
"Quitman","2020-09-12","0","310","0","22","4.1","2"
"Quitman","2020-09-13","3","313","0","22","4.1","2"
"Quitman","2020-09-14","1","314","0","22","4.1","2"
"Quitman","2020-09-15","8","322","0","22","0","2"
"Quitman","2020-09-16","0","322","0","22","0","2"
"Quitman","2020-09-17","0","322","0","22","0","2"
"Quitman","2020-09-18","1","323","0","22","0","2"
"Quitman","2020-09-19","0","323","0","22","0","2"
"Quitman","2020-09-20","1","324","0","22","0","2"
"Quitman","2020-09-21","1","325","0","22","0","2"
"Quitman","2020-09-22","0","325","0","22","0","0"
"Quitman","2020-09-23","1","326","0","22","0","0"
"Quitman","2020-09-24","0","326","0","22","0","0"
"Quitman","2020-09-25","5","331","1","23","2.9","1.4"
"Quitman","2020-09-26","0","331","0","23","2.9","1.4"
"Quitman","2020-09-27","0","331","0","23","2.9","1.4"
"Quitman","2020-09-28","1","332","0","23","2.9","1.4"
"Quitman","2020-09-29","15","347","1","24","3.8","1.9"
"Quitman","2020-09-30","1","348","0","24","3.8","1.9"
"Quitman","2020-10-01","2","350","0","24","3.8","1.9"
"Quitman","2020-10-02","1","351","0","24","1","1.9"
"Quitman","2020-10-03","2","353","0","24","1","1.9"
"Quitman","2020-10-04","0","353","0","24","1","1.9"
"Quitman","2020-10-05","2","355","2","26","15.2","9"
"Quitman","2020-10-06","10","365","1","27","15.7","9.8"
"Quitman","2020-10-07","4","369","0","27","15.7","9.8"
"Quitman","2020-10-08","0","369","0","27","15.7","9.8"
"Quitman","2020-10-09","1","370","0","27","15.7","8.3"
"Quitman","2020-10-10","0","370","0","27","15.7","8.3"
"Quitman","2020-10-11","0","370","0","27","15.7","8.3"
"Quitman","2020-10-12","0","370","0","27","1.4","8.3"
"Quitman","2020-10-13","7","377","0","27","0","7.9"
"Quitman","2020-10-14","1","378","0","27","0","7.9"
"Quitman","2020-10-15","4","382","3","30","10.7","13.2"
"Quitman","2020-10-16","2","384","0","30","10.7","13.2"
"Quitman","2020-10-17","0","384","0","30","10.7","13.2"
"Quitman","2020-10-18","0","384","0","30","10.7","13.2"
"Quitman","2020-10-19","0","384","0","30","10.7","6.1"
"Quitman","2020-10-20","3","387","0","30","10.7","5.4"
"Quitman","2020-10-21","2","389","0","30","10.7","5.4"
"Quitman","2020-10-22","0","389","0","30","0","5.4"
"Quitman","2020-10-23","0","389","0","30","0","5.4"
"Quitman","2020-10-24","0","389","0","30","0","5.4"
"Quitman","2020-10-25","1","390","0","30","0","5.4"
"Quitman","2020-10-26","1","391","0","30","0","5.4"
"Quitman","2020-10-27","5","396","1","31","2.9","6.8"
"Quitman","2020-10-28","1","397","1","32","17.1","13.9"
"Quitman","2020-10-29","0","397","0","32","17.1","8.6"
"Quitman","2020-10-30","1","398","0","32","17.1","8.6"
"Quitman","2020-10-31","0","398","0","32","17.1","8.6"
"Quitman","2020-11-01","0","398","0","32","17.1","8.6"
"Quitman","2020-11-02","2","400","1","33","24.3","12.1"
"Quitman","2020-11-03","5","405","0","33","21.4","12.1"
"Quitman","2020-11-04","1","406","0","33","7.1","12.1"
"Quitman","2020-11-05","4","410","1","34","10.7","13.9"
"Quitman","2020-11-06","2","412","0","34","10.7","13.9"
"Quitman","2020-11-07","0","412","0","34","10.7","13.9"
"Quitman","2020-11-08","0","412","0","34","10.7","13.9"
"Quitman","2020-11-09","1","413","0","34","3.6","13.9"
"Quitman","2020-11-10","8","421","0","34","3.6","12.5"
"Quitman","2020-11-11","1","422","0","34","3.6","5.4"
"Quitman","2020-11-12","1","423","0","34","0","5.4"
"Quitman","2020-11-13","3","426","1","35","4.8","7.7"
"Quitman","2020-11-14","1","427","0","35","4.8","7.7"
"Quitman","2020-11-15","0","427","0","35","4.8","7.7"
"Quitman","2020-11-16","1","428","0","35","4.8","4.2"
"Quitman","2020-11-17","5","433","0","35","4.8","4.2"
"Quitman","2020-11-18","0","433","0","35","4.8","4.2"
"Quitman","2020-11-19","2","435","0","35","4.8","2.4"
"Quitman","2020-11-20","0","435","0","35","0","2.4"
"Quitman","2020-11-21","0","435","0","35","0","2.4"
"Quitman","2020-11-22","0","435","0","35","0","2.4"
"Quitman","2020-11-23","1","436","0","35","0","2.4"
"Quitman","2020-11-24","6","442","0","35","0","2.4"
"Quitman","2020-11-25","1","443","0","35","0","2.4"
"Quitman","2020-11-26","0","443","0","35","0","2.4"
"Quitman","2020-11-27","1","444","0","35","0","0"
"Quitman","2020-11-28","1","445","0","35","0","0"
"Quitman","2020-11-29","0","445","0","35","0","0"
"Quitman","2020-11-30","1","446","1","36","14.3","7.1"
"Quitman","2020-12-01","5","451","0","36","14.3","7.1"
"Quitman","2020-12-02","1","452","0","36","14.3","7.1"
"Quitman","2020-12-03","2","454","0","36","14.3","7.1"
"Quitman","2020-12-04","1","455","0","36","14.3","7.1"
"Quitman","2020-12-05","0","455","0","36","14.3","7.1"
"Quitman","2020-12-06","0","455","0","36","14.3","7.1"
"Quitman","2020-12-07","1","456","0","36","0","7.1"
"Quitman","2020-12-08","1","457","0","36","0","7.1"
"Quitman","2020-12-09","4","461","0","36","0","7.1"
"Quitman","2020-12-10","1","462","0","36","0","7.1"
"Quitman","2020-12-11","1","463","0","36","0","7.1"
"Quitman","2020-12-12","1","464","0","36","0","7.1"
"Quitman","2020-12-13","0","464","0","36","0","7.1"
"Quitman","2020-12-14","0","464","0","36","0","0"
"Quitman","2020-12-15","11","475","1","37","1.3","0.6"
"Quitman","2020-12-16","1","476","0","37","1.3","0.6"
"Quitman","2020-12-17","1","477","0","37","1.3","0.6"
"Quitman","2020-12-18","2","479","0","37","1.3","0.6"
"Quitman","2020-12-19","0","479","0","37","1.3","0.6"
"Quitman","2020-12-20","0","479","0","37","1.3","0.6"
"Quitman","2020-12-21","0","479","0","37","1.3","0.6"
"Quitman","2020-12-22","9","488","1","38","1.6","1.4"
"Quitman","2020-12-23","1","489","0","38","1.6","1.4"
"Quitman","2020-12-24","2","491","0","38","1.6","1.4"
"Quitman","2020-12-25","0","491","0","38","1.6","1.4"
"Quitman","2020-12-26","0","491","0","38","1.6","1.4"
"Quitman","2020-12-27","0","491","0","38","1.6","1.4"
"Quitman","2020-12-28","5","496","1","39","4.4","2.9"
"Quitman","2020-12-29","6","502","0","39","2.9","2.2"
"Quitman","2020-12-30","5","507","1","40","5.7","3.7"
"Quitman","2020-12-31","0","507","0","40","5.7","3.7"
"Quitman","2021-01-01","0","507","0","40","5.7","3.7"
"Quitman","2021-01-02","0","507","0","40","5.7","3.7"
"Quitman","2021-01-03","3","510","3","43","20","10.8"
"Quitman","2021-01-04","1","511","0","43","17.1","10.8"
"Quitman","2021-01-05","15","526","4","47","21","11.9"
"Quitman","2021-01-06","2","528","0","47","18.1","11.9"
"Quitman","2021-01-07","5","533","1","48","21","13.3"
"Quitman","2021-01-08","1","534","0","48","21","13.3"
"Quitman","2021-01-09","1","535","0","48","21","13.3"
"Quitman","2021-01-10","2","537","1","49","13.8","16.9"
"Quitman","2021-01-11","3","540","0","49","13.8","15.5"
"Quitman","2021-01-12","6","546","1","50","12.4","16.7"
"Quitman","2021-01-13","1","547","1","51","26.7","22.4"
"Quitman","2021-01-14","5","552","0","51","23.8","22.4"
"Quitman","2021-01-15","2","554","0","51","23.8","22.4"
"Quitman","2021-01-16","0","554","0","51","23.8","22.4"
"Quitman","2021-01-17","2","556","1","52","23.8","18.8"
"Quitman","2021-01-18","0","556","0","52","23.8","18.8"
"Quitman","2021-01-19","17","573","5","57","25.6","19"
"Quitman","2021-01-20","3","576","0","57","11.3","19"
"Quitman","2021-01-21","5","581","0","57","11.3","17.6"
"Quitman","2021-01-22","3","584","1","58","16.1","20"
"Quitman","2021-01-23","1","585","0","58","16.1","20"
"Quitman","2021-01-24","1","586","0","58","9","16.4"
"Quitman","2021-01-25","2","588","1","59","16.1","20"
"Quitman","2021-01-26","5","593","0","59","11.9","18.8"
"Quitman","2021-01-27","1","594","1","60","26.2","18.8"
"Quitman","2021-01-28","2","596","0","60","26.2","18.8"
"Quitman","2021-01-29","1","597","0","60","21.4","18.8"
"Quitman","2021-01-30","0","597","0","60","21.4","18.8"
"Quitman","2021-01-31","0","597","0","60","21.4","15.2"
"Quitman","2021-02-01","1","598","0","60","14.3","15.2"
"Quitman","2021-02-02","17","615","1","61","15.1","13.5"
"Quitman","2021-02-03","3","618","0","61","0.8","13.5"
"Quitman","2021-02-04","3","621","1","62","5.6","15.9"
"Quitman","2021-02-05","0","621","0","62","5.6","13.5"
"Quitman","2021-02-06","0","621","0","62","5.6","13.5"
"Quitman","2021-02-07","0","621","0","62","5.6","13.5"
"Quitman","2021-02-08","0","621","0","62","5.6","9.9"
"Rabun","2020-02-01","0","0","0","0",".","."
"Rabun","2020-02-02","0","0","0","0",".","."
"Rabun","2020-02-03","0","0","0","0",".","."
"Rabun","2020-02-04","0","0","0","0",".","."
"Rabun","2020-02-05","0","0","0","0",".","."
"Rabun","2020-02-06","0","0","0","0",".","."
"Rabun","2020-02-07","0","0","0","0","0","."
"Rabun","2020-02-08","0","0","0","0","0","."
"Rabun","2020-02-09","0","0","0","0","0","."
"Rabun","2020-02-10","0","0","0","0","0","."
"Rabun","2020-02-11","0","0","0","0","0","."
"Rabun","2020-02-12","0","0","0","0","0","."
"Rabun","2020-02-13","0","0","0","0","0","."
"Rabun","2020-02-14","0","0","0","0","0","0"
"Rabun","2020-02-15","0","0","0","0","0","0"
"Rabun","2020-02-16","0","0","0","0","0","0"
"Rabun","2020-02-17","0","0","0","0","0","0"
"Rabun","2020-02-18","0","0","0","0","0","0"
"Rabun","2020-02-19","0","0","0","0","0","0"
"Rabun","2020-02-20","0","0","0","0","0","0"
"Rabun","2020-02-21","0","0","0","0","0","0"
"Rabun","2020-02-22","0","0","0","0","0","0"
"Rabun","2020-02-23","0","0","0","0","0","0"
"Rabun","2020-02-24","0","0","0","0","0","0"
"Rabun","2020-02-25","0","0","0","0","0","0"
"Rabun","2020-02-26","0","0","0","0","0","0"
"Rabun","2020-02-27","0","0","0","0","0","0"
"Rabun","2020-02-28","0","0","0","0","0","0"
"Rabun","2020-02-29","0","0","0","0","0","0"
"Rabun","2020-03-01","0","0","0","0","0","0"
"Rabun","2020-03-02","0","0","0","0","0","0"
"Rabun","2020-03-03","0","0","0","0","0","0"
"Rabun","2020-03-04","0","0","0","0","0","0"
"Rabun","2020-03-05","0","0","0","0","0","0"
"Rabun","2020-03-06","1","1","0","0","0","0"
"Rabun","2020-03-07","0","1","0","0","0","0"
"Rabun","2020-03-08","0","1","0","0","0","0"
"Rabun","2020-03-09","0","1","0","0","0","0"
"Rabun","2020-03-10","0","1","0","0","0","0"
"Rabun","2020-03-11","1","2","0","0","0","0"
"Rabun","2020-03-12","3","5","0","0","0","0"
"Rabun","2020-03-13","1","6","0","0","0","0"
"Rabun","2020-03-14","0","6","0","0","0","0"
"Rabun","2020-03-15","1","7","0","0","0","0"
"Rabun","2020-03-16","2","9","0","0","0","0"
"Rabun","2020-03-17","6","15","0","0","0","0"
"Rabun","2020-03-18","3","18","0","0","0","0"
"Rabun","2020-03-19","4","22","0","0","0","0"
"Rabun","2020-03-20","4","26","0","0","0","0"
"Rabun","2020-03-21","1","27","0","0","0","0"
"Rabun","2020-03-22","2","29","0","0","0","0"
"Rabun","2020-03-23","4","33","0","0","0","0"
"Rabun","2020-03-24","2","35","0","0","0","0"
"Rabun","2020-03-25","3","38","0","0","0","0"
"Rabun","2020-03-26","5","43","0","0","0","0"
"Rabun","2020-03-27","0","43","0","0","0","0"
"Rabun","2020-03-28","0","43","0","0","0","0"
"Rabun","2020-03-29","0","43","0","0","0","0"
"Rabun","2020-03-30","0","43","0","0","0","0"
"Rabun","2020-03-31","2","45","0","0","0","0"
"Rabun","2020-04-01","3","48","0","0","0","0"
"Rabun","2020-04-02","2","50","0","0","0","0"
"Rabun","2020-04-03","4","54","0","0","0","0"
"Rabun","2020-04-04","1","55","0","0","0","0"
"Rabun","2020-04-05","0","55","0","0","0","0"
"Rabun","2020-04-06","0","55","0","0","0","0"
"Rabun","2020-04-07","5","60","0","0","0","0"
"Rabun","2020-04-08","0","60","0","0","0","0"
"Rabun","2020-04-09","3","63","0","0","0","0"
"Rabun","2020-04-10","1","64","0","0","0","0"
"Rabun","2020-04-11","0","64","0","0","0","0"
"Rabun","2020-04-12","0","64","0","0","0","0"
"Rabun","2020-04-13","2","66","0","0","0","0"
"Rabun","2020-04-14","2","68","0","0","0","0"
"Rabun","2020-04-15","1","69","0","0","0","0"
"Rabun","2020-04-16","11","80","0","0","0","0"
"Rabun","2020-04-17","4","84","0","0","0","0"
"Rabun","2020-04-18","1","85","0","0","0","0"
"Rabun","2020-04-19","1","86","0","0","0","0"
"Rabun","2020-04-20","5","91","0","0","0","0"
"Rabun","2020-04-21","7","98","0","0","0","0"
"Rabun","2020-04-22","5","103","0","0","0","0"
"Rabun","2020-04-23","8","111","0","0","0","0"
"Rabun","2020-04-24","9","120","0","0","0","0"
"Rabun","2020-04-25","2","122","0","0","0","0"
"Rabun","2020-04-26","0","122","0","0","0","0"
"Rabun","2020-04-27","3","125","0","0","0","0"
"Rabun","2020-04-28","7","132","0","0","0","0"
"Rabun","2020-04-29","12","144","0","0","0","0"
"Rabun","2020-04-30","22","166","0","0","0","0"
"Rabun","2020-05-01","14","180","0","0","0","0"
"Rabun","2020-05-02","6","186","0","0","0","0"
"Rabun","2020-05-03","4","190","0","0","0","0"
"Rabun","2020-05-04","5","195","0","0","0","0"
"Rabun","2020-05-05","13","208","1","1","1.1","0.5"
"Rabun","2020-05-06","10","218","0","1","1.1","0.5"
"Rabun","2020-05-07","6","224","0","1","1.1","0.5"
"Rabun","2020-05-08","10","234","0","1","1.1","0.5"
"Rabun","2020-05-09","6","240","0","1","1.1","0.5"
"Rabun","2020-05-10","0","240","0","1","1.1","0.5"
"Rabun","2020-05-11","10","250","0","1","1.1","0.5"
"Rabun","2020-05-12","10","260","0","1","0","0.5"
"Rabun","2020-05-13","11","271","0","1","0","0.5"
"Rabun","2020-05-14","5","276","0","1","0","0.5"
"Rabun","2020-05-15","7","283","0","1","0","0.5"
"Rabun","2020-05-16","3","286","0","1","0","0.5"
"Rabun","2020-05-17","2","288","0","1","0","0.5"
"Rabun","2020-05-18","5","293","0","1","0","0.5"
"Rabun","2020-05-19","6","299","0","1","0","0"
"Rabun","2020-05-20","13","312","0","1","0","0"
"Rabun","2020-05-21","4","316","0","1","0","0"
"Rabun","2020-05-22","2","318","0","1","0","0"
"Rabun","2020-05-23","0","318","0","1","0","0"
"Rabun","2020-05-24","2","320","0","1","0","0"
"Rabun","2020-05-25","1","321","0","1","0","0"
"Rabun","2020-05-26","3","324","0","1","0","0"
"Rabun","2020-05-27","14","338","1","2","1","0.5"
"Rabun","2020-05-28","12","350","0","2","1","0.5"
"Rabun","2020-05-29","9","359","0","2","1","0.5"
"Rabun","2020-05-30","3","362","0","2","1","0.5"
"Rabun","2020-05-31","1","363","0","2","1","0.5"
"Rabun","2020-06-01","16","379","1","3","1.9","1"
"Rabun","2020-06-02","18","397","0","3","1.9","1"
"Rabun","2020-06-03","15","412","0","3","0.9","1"
"Rabun","2020-06-04","22","434","0","3","0.9","1"
"Rabun","2020-06-05","14","448","0","3","0.9","1"
"Rabun","2020-06-06","6","454","0","3","0.9","1"
"Rabun","2020-06-07","0","454","0","3","0.9","1"
"Rabun","2020-06-08","11","465","0","3","0","1"
"Rabun","2020-06-09","18","483","0","3","0","1"
"Rabun","2020-06-10","15","498","0","3","0","0.4"
"Rabun","2020-06-11","11","509","0","3","0","0.4"
"Rabun","2020-06-12","9","518","2","5","3.2","2"
"Rabun","2020-06-13","10","528","0","5","3.2","2"
"Rabun","2020-06-14","3","531","0","5","3.2","2"
"Rabun","2020-06-15","8","539","0","5","3.2","1.6"
"Rabun","2020-06-16","19","558","0","5","3.2","1.6"
"Rabun","2020-06-17","15","573","1","6","4.1","2.1"
"Rabun","2020-06-18","12","585","1","7","5.3","2.7"
"Rabun","2020-06-19","14","599","0","7","2.1","2.7"
"Rabun","2020-06-20","9","608","0","7","2.1","2.7"
"Rabun","2020-06-21","0","608","0","7","2.1","2.7"
"Rabun","2020-06-22","13","621","1","8","3.2","3.2"
"Rabun","2020-06-23","20","641","1","9","4","3.6"
"Rabun","2020-06-24","22","663","2","11","4.3","4.2"
"Rabun","2020-06-25","13","676","1","12","4.2","4.8"
"Rabun","2020-06-26","22","698","0","12","4.2","3.2"
"Rabun","2020-06-27","10","708","4","16","9.9","6"
"Rabun","2020-06-28","3","711","0","16","9.9","6"
"Rabun","2020-06-29","15","726","1","17","9.8","6.5"
"Rabun","2020-06-30","31","757","5","22","11.4","7.7"
"Rabun","2020-07-01","34","791","4","26","11.8","8"
"Rabun","2020-07-02","39","830","4","30","12.1","8.2"
"Rabun","2020-07-03","12","842","1","31","13.3","8.8"
"Rabun","2020-07-04","7","849","0","31","7.6","8.8"
"Rabun","2020-07-05","2","851","0","31","7.6","8.8"
"Rabun","2020-07-06","46","897","9","40","9.4","9.6"
"Rabun","2020-07-07","26","923","0","40","7.1","9.2"
"Rabun","2020-07-08","58","981","11","51","8.2","10"
"Rabun","2020-07-09","49","1030","10","61","9.6","10.9"
"Rabun","2020-07-10","43","1073","6","67","10.4","11.9"
"Rabun","2020-07-11","13","1086","6","73","17","12.3"
"Rabun","2020-07-12","4","1090","0","73","17","12.3"
"Rabun","2020-07-13","36","1126","8","81","17.4","13.4"
"Rabun","2020-07-14","25","1151","5","86","20.2","13.7"
"Rabun","2020-07-15","29","1180","8","94","21.5","14.8"
"Rabun","2020-07-16","31","1211","7","101","21.8","15.7"
"Rabun","2020-07-17","37","1248","6","107","22.1","16.3"
"Rabun","2020-07-18","9","1257","2","109","18.7","17.8"
"Rabun","2020-07-19","4","1261","1","110","22.3","19.6"
"Rabun","2020-07-20","33","1294","5","115","21.3","19.3"
"Rabun","2020-07-21","22","1316","4","119","21","20.6"
"Rabun","2020-07-22","17","1333","1","120","17.9","19.7"
"Rabun","2020-07-23","30","1363","8","128","18.5","20.1"
"Rabun","2020-07-24","32","1395","5","133","18.4","20.2"
"Rabun","2020-07-25","9","1404","0","133","15.2","17"
"Rabun","2020-07-26","3","1407","2","135","21.2","21.7"
"Rabun","2020-07-27","22","1429","7","142","23.5","22.4"
"Rabun","2020-07-28","31","1460","2","144","21.9","21.4"
"Rabun","2020-07-29","30","1490","3","147","22.5","20.2"
"Rabun","2020-07-30","17","1507","1","148","19.5","19"
"Rabun","2020-07-31","13","1520","1","149","18.4","18.4"
"Rabun","2020-08-01","18","1538","4","153","21.5","18.4"
"Rabun","2020-08-02","7","1545","2","155","16.1","18.6"
"Rabun","2020-08-03","12","1557","1","156","12.7","18.1"
"Rabun","2020-08-04","11","1568","0","156","11.8","16.8"
"Rabun","2020-08-05","19","1587","2","158","11.9","17.2"
"Rabun","2020-08-06","9","1596","1","159","12.6","16.1"
"Rabun","2020-08-07","15","1611","1","160","12.5","15.4"
"Rabun","2020-08-08","6","1617","1","161","11.7","16.6"
"Rabun","2020-08-09","5","1622","0","161","7.6","11.9"
"Rabun","2020-08-10","13","1635","0","161","6.4","9.6"
"Rabun","2020-08-11","21","1656","1","162","7.1","9.5"
"Rabun","2020-08-12","19","1675","0","162","5.6","8.7"
"Rabun","2020-08-13","8","1683","0","162","4","8.3"
"Rabun","2020-08-14","17","1700","0","162","3.1","7.8"
"Rabun","2020-08-15","4","1704","0","162","0.7","6.2"
"Rabun","2020-08-16","4","1708","0","162","0.7","4.1"
"Rabun","2020-08-17","11","1719","0","162","0.7","3.6"
"Rabun","2020-08-18","10","1729","0","162","0","3.6"
"Rabun","2020-08-19","11","1740","1","163","1.3","3.4"
"Rabun","2020-08-20","9","1749","1","164","2.9","3.4"
"Rabun","2020-08-21","16","1765","1","165","3.8","3.4"
"Rabun","2020-08-22","13","1778","0","165","3.8","2.2"
"Rabun","2020-08-23","5","1783","0","165","3.8","2.2"
"Rabun","2020-08-24","11","1794","0","165","3.8","2.2"
"Rabun","2020-08-25","11","1805","1","166","5.1","2.5"
"Rabun","2020-08-26","25","1830","3","169","5.5","3.4"
"Rabun","2020-08-27","18","1848","0","169","3.9","3.4"
"Rabun","2020-08-28","11","1859","0","169","3","3.4"
"Rabun","2020-08-29","28","1887","3","172","4.5","4.2"
"Rabun","2020-08-30","5","1892","0","172","4.5","4.2"
"Rabun","2020-08-31","7","1899","1","173","6.6","5.2"
"Rabun","2020-09-01","26","1925","0","173","5.3","5.2"
"Rabun","2020-09-02","24","1949","0","173","3.6","4.5"
"Rabun","2020-09-03","9","1958","0","173","3.6","3.7"
"Rabun","2020-09-04","37","1995","5","178","5.5","4.3"
"Rabun","2020-09-05","10","2005","1","179","5.4","5"
"Rabun","2020-09-06","4","2009","0","179","5.4","5"
"Rabun","2020-09-07","3","2012","0","179","3.4","5"
"Rabun","2020-09-08","13","2025","0","179","3.4","4.3"
"Rabun","2020-09-09","15","2040","2","181","5.3","4.4"
"Rabun","2020-09-10","15","2055","2","183","7.2","5.4"
"Rabun","2020-09-11","14","2069","1","184","6.3","5.9"
"Rabun","2020-09-12","5","2074","0","184","4.8","5.1"
"Rabun","2020-09-13","3","2077","0","184","4.8","5.1"
"Rabun","2020-09-14","12","2089","1","185","6","4.7"
"Rabun","2020-09-15","14","2103","0","185","6","4.7"
"Rabun","2020-09-16","18","2121","1","186","4.9","5.1"
"Rabun","2020-09-17","19","2140","3","189","5.3","6.2"
"Rabun","2020-09-18","18","2158","0","189","4.2","5.2"
"Rabun","2020-09-19","11","2169","0","189","4.2","4.5"
"Rabun","2020-09-20","6","2175","2","191","9","6.9"
"Rabun","2020-09-21","24","2199","0","191","7.8","6.9"
"Rabun","2020-09-22","19","2218","2","193","9.3","7.7"
"Rabun","2020-09-23","16","2234","4","197","12.1","8.5"
"Rabun","2020-09-24","8","2242","0","197","9.8","7.5"
"Rabun","2020-09-25","19","2261","3","200","12.1","8.2"
"Rabun","2020-09-26","11","2272","1","201","13.4","8.8"
"Rabun","2020-09-27","4","2276","0","201","8.6","8.8"
"Rabun","2020-09-28","18","2294","1","202","9.4","8.6"
"Rabun","2020-09-29","9","2303","1","203","9.5","9.4"
"Rabun","2020-09-30","8","2311","1","204","7.7","9.9"
"Rabun","2020-10-01","16","2327","2","206","9.5","9.7"
"Rabun","2020-10-02","21","2348","2","208","8.6","10.4"
"Rabun","2020-10-03","16","2364","1","209","8.2","10.8"
"Rabun","2020-10-04","2","2366","0","209","8.2","8.4"
"Rabun","2020-10-05","24","2390","0","209","7.4","8.4"
"Rabun","2020-10-06","13","2403","1","210","6.9","8.2"
"Rabun","2020-10-07","18","2421","3","213","7.5","7.6"
"Rabun","2020-10-08","25","2446","3","216","7.4","8.5"
"Rabun","2020-10-09","32","2478","4","220","7.9","8.2"
"Rabun","2020-10-10","23","2501","1","221","7.6","7.9"
"Rabun","2020-10-11","4","2505","0","221","7.6","7.9"
"Rabun","2020-10-12","14","2519","0","221","7.6","7.5"
"Rabun","2020-10-13","14","2533","2","223","8.5","7.7"
"Rabun","2020-10-14","21","2554","1","224","6.8","7.2"
"Rabun","2020-10-15","41","2595","1","225","5.5","6.5"
"Rabun","2020-10-16","18","2613","2","227","5.3","6.6"
"Rabun","2020-10-17","7","2620","0","227","4.7","6.1"
"Rabun","2020-10-18","4","2624","0","227","4.7","6.1"
"Rabun","2020-10-19","20","2644","0","227","4.7","6.1"
"Rabun","2020-10-20","17","2661","0","227","2.6","5.6"
"Rabun","2020-10-21","19","2680","2","229","3.4","5.1"
"Rabun","2020-10-22","19","2699","4","233","6.1","5.8"
"Rabun","2020-10-23","14","2713","0","233","4.5","4.9"
"Rabun","2020-10-24","20","2733","3","236","6.7","5.7"
"Rabun","2020-10-25","2","2735","0","236","6.7","5.7"
"Rabun","2020-10-26","15","2750","0","236","6.7","5.7"
"Rabun","2020-10-27","16","2766","1","237","7.5","5.1"
"Rabun","2020-10-28","17","2783","1","238","6.9","5.2"
"Rabun","2020-10-29","21","2804","3","241","5.9","6"
"Rabun","2020-10-30","17","2821","1","242","6.8","5.6"
"Rabun","2020-10-31","8","2829","0","242","4.6","5.6"
"Rabun","2020-11-01","5","2834","0","242","4.6","5.6"
"Rabun","2020-11-02","20","2854","3","245","6.8","6.7"
"Rabun","2020-11-03","14","2868","0","245","5.9","6.7"
"Rabun","2020-11-04","20","2888","2","247","6.5","6.7"
"Rabun","2020-11-05","43","2931","11","258","8.1","7"
"Rabun","2020-11-06","30","2961","3","261","8.7","7.7"
"Rabun","2020-11-07","16","2977","1","262","9.5","7.1"
"Rabun","2020-11-08","9","2986","4","266","15.9","10.3"
"Rabun","2020-11-09","26","3012","5","271","16.5","11.6"
"Rabun","2020-11-10","24","3036","5","276","19.5","12.7"
"Rabun","2020-11-11","47","3083","12","288","21.7","14.1"
"Rabun","2020-11-12","55","3138","14","302","21.7","14.9"
"Rabun","2020-11-13","41","3179","7","309","22.7","15.7"
"Rabun","2020-11-14","9","3188","2","311","25","17.3"
"Rabun","2020-11-15","10","3198","2","313","21.5","18.7"
"Rabun","2020-11-16","29","3227","3","316","20.2","18.4"
"Rabun","2020-11-17","39","3266","6","322","19.4","19.5"
"Rabun","2020-11-18","35","3301","4","326","17.4","19.6"
"Rabun","2020-11-19","51","3352","6","332","15.5","18.6"
"Rabun","2020-11-20","41","3393","3","335","14.1","18.4"
"Rabun","2020-11-21","26","3419","4","339","13.1","19"
"Rabun","2020-11-22","16","3435","1","340","11.1","16.3"
"Rabun","2020-11-23","32","3467","4","344","11.4","15.8"
"Rabun","2020-11-24","39","3506","9","353","12.5","16"
"Rabun","2020-11-25","32","3538","4","357","12.7","15.1"
"Rabun","2020-11-26","10","3548","4","361","16.7","16.1"
"Rabun","2020-11-27","37","3585","11","372","19.9","17"
"Rabun","2020-11-28","14","3599","4","376","21.8","17.4"
"Rabun","2020-11-29","15","3614","8","384","28.5","19.8"
"Rabun","2020-11-30","72","3686","15","399","29.7","20.6"
"Rabun","2020-12-01","49","3735","15","414","30.8","21.7"
"Rabun","2020-12-02","58","3793","15","429","32.7","22.7"
"Rabun","2020-12-03","43","3836","12","441","31","23.8"
"Rabun","2020-12-04","67","3903","12","453","29.3","24.6"
"Rabun","2020-12-05","80","3983","17","470","28.2","25"
"Rabun","2020-12-06","13","3996","6","476","27.2","27.9"
"Rabun","2020-12-07","71","4067","16","492","27.5","28.6"
"Rabun","2020-12-08","90","4157","16","508","25.6","28.2"
"Rabun","2020-12-09","79","4236","20","528","25.6","29.1"
"Rabun","2020-12-10","41","4277","3","531","22.6","26.8"
"Rabun","2020-12-11","79","4356","18","549","23.3","26.3"
"Rabun","2020-12-12","44","4400","16","565","25.5","26.9"
"Rabun","2020-12-13","8","4408","5","570","27.8","27.5"
"Rabun","2020-12-14","75","4483","13","583","27.1","27.3"
"Rabun","2020-12-15","77","4560","15","598","27.3","26.5"
"Rabun","2020-12-16","109","4669","30","628","27.6","26.6"
"Rabun","2020-12-17","88","4757","25","653","30.6","26.6"
"Rabun","2020-12-18","82","4839","18","671","30.5","26.9"
"Rabun","2020-12-19","26","4865","8","679","29.7","27.6"
"Rabun","2020-12-20","12","4877","6","685","27.9","27.9"
"Rabun","2020-12-21","63","4940","9","694","27.5","27.3"
"Rabun","2020-12-22","109","5049","27","721","28.2","27.8"
"Rabun","2020-12-23","85","5134","35","756","30.2","28.9"
"Rabun","2020-12-24","43","5177","21","777","33.1","31.9"
"Rabun","2020-12-25","3","5180","0","777","30","30.2"
"Rabun","2020-12-26","12","5192","5","782","31.5","30.6"
"Rabun","2020-12-27","17","5209","10","792","32.8","30.4"
"Rabun","2020-12-28","54","5263","15","807","34.7","31.1"
"Rabun","2020-12-29","72","5335","19","826","35","31.6"
"Rabun","2020-12-30","103","5438","27","853","32.8","31.5"
"Rabun","2020-12-31","79","5517","21","874","29.6","31.4"
"Rabun","2021-01-01","14","5531","6","880","35.8","32.9"
"Rabun","2021-01-02","8","5539","1","881","31.6","31.6"
"Rabun","2021-01-03","12","5551","5","886","29.1","31"
"Rabun","2021-01-04","56","5607","6","892","26.7","30.7"
"Rabun","2021-01-05","122","5729","36","928","27.1","31.1"
"Rabun","2021-01-06","71","5800","19","947","27.2","30"
"Rabun","2021-01-07","184","5984","22","969","25.1","27.4"
"Rabun","2021-01-08","57","6041","14","983","22.5","29.1"
"Rabun","2021-01-09","18","6059","2","985","22.3","27"
"Rabun","2021-01-10","15","6074","4","989","20.2","24.7"
"Rabun","2021-01-11","63","6137","13","1002","21.6","24.2"
"Rabun","2021-01-12","47","6184","17","1019","22.6","24.9"
"Rabun","2021-01-13","62","6246","16","1035","22.4","24.8"
"Rabun","2021-01-14","83","6329","12","1047","22.8","24"
"Rabun","2021-01-15","37","6366","9","1056","22.7","22.6"
"Rabun","2021-01-16","25","6391","5","1061","24","23.2"
"Rabun","2021-01-17","13","6404","2","1063","22.4","21.3"
"Rabun","2021-01-18","33","6437","11","1074","24.2","22.9"
"Rabun","2021-01-19","47","6484","16","1090","23.9","23.2"
"Rabun","2021-01-20","35","6519","9","1099","23.9","23.2"
"Rabun","2021-01-21","51","6570","11","1110","24.9","23.8"
"Rabun","2021-01-22","61","6631","11","1121","24","23.4"
"Rabun","2021-01-23","18","6649","3","1124","23.5","23.8"
"Rabun","2021-01-24","10","6659","1","1125","22.8","22.6"
"Rabun","2021-01-25","44","6703","10","1135","21.3","22.7"
"Rabun","2021-01-26","42","6745","3","1138","17.4","20.7"
"Rabun","2021-01-27","43","6788","8","1146","16.4","20.1"
"Rabun","2021-01-28","54","6842","8","1154","15.4","20.2"
"Rabun","2021-01-29","62","6904","10","1164","15.2","19.6"
"Rabun","2021-01-30","30","6934","3","1167","14.2","18.9"
"Rabun","2021-01-31","6","6940","2","1169","17.5","20.2"
"Rabun","2021-02-01","37","6977","6","1175","16.6","18.9"
"Rabun","2021-02-02","41","7018","11","1186","19.4","18.4"
"Rabun","2021-02-03","27","7045","3","1189","18.3","17.4"
"Rabun","2021-02-04","35","7080","8","1197","19.5","17.5"
"Rabun","2021-02-05","13","7093","1","1198","18.3","16.7"
"Rabun","2021-02-06","3","7096","1","1199","21.6","17.9"
"Rabun","2021-02-07","0","7096","0","1199","16.9","17.2"
"Rabun","2021-02-08","0","7096","0","1199","14.5","15.6"
"Randolph","2020-02-01","0","0","0","0",".","."
"Randolph","2020-02-02","0","0","0","0",".","."
"Randolph","2020-02-03","0","0","0","0",".","."
"Randolph","2020-02-04","0","0","0","0",".","."
"Randolph","2020-02-05","0","0","0","0",".","."
"Randolph","2020-02-06","0","0","0","0",".","."
"Randolph","2020-02-07","0","0","0","0","0","."
"Randolph","2020-02-08","0","0","0","0","0","."
"Randolph","2020-02-09","0","0","0","0","0","."
"Randolph","2020-02-10","0","0","0","0","0","."
"Randolph","2020-02-11","0","0","0","0","0","."
"Randolph","2020-02-12","0","0","0","0","0","."
"Randolph","2020-02-13","0","0","0","0","0","."
"Randolph","2020-02-14","0","0","0","0","0","0"
"Randolph","2020-02-15","0","0","0","0","0","0"
"Randolph","2020-02-16","0","0","0","0","0","0"
"Randolph","2020-02-17","0","0","0","0","0","0"
"Randolph","2020-02-18","0","0","0","0","0","0"
"Randolph","2020-02-19","0","0","0","0","0","0"
"Randolph","2020-02-20","0","0","0","0","0","0"
"Randolph","2020-02-21","0","0","0","0","0","0"
"Randolph","2020-02-22","0","0","0","0","0","0"
"Randolph","2020-02-23","0","0","0","0","0","0"
"Randolph","2020-02-24","0","0","0","0","0","0"
"Randolph","2020-02-25","0","0","0","0","0","0"
"Randolph","2020-02-26","0","0","0","0","0","0"
"Randolph","2020-02-27","0","0","0","0","0","0"
"Randolph","2020-02-28","0","0","0","0","0","0"
"Randolph","2020-02-29","0","0","0","0","0","0"
"Randolph","2020-03-01","0","0","0","0","0","0"
"Randolph","2020-03-02","0","0","0","0","0","0"
"Randolph","2020-03-03","0","0","0","0","0","0"
"Randolph","2020-03-04","0","0","0","0","0","0"
"Randolph","2020-03-05","0","0","0","0","0","0"
"Randolph","2020-03-06","0","0","0","0","0","0"
"Randolph","2020-03-07","0","0","0","0","0","0"
"Randolph","2020-03-08","0","0","0","0","0","0"
"Randolph","2020-03-09","0","0","0","0","0","0"
"Randolph","2020-03-10","0","0","0","0","0","0"
"Randolph","2020-03-11","1","1","1","1","14.3","7.1"
"Randolph","2020-03-12","0","1","0","1","14.3","7.1"
"Randolph","2020-03-13","2","3","0","1","14.3","7.1"
"Randolph","2020-03-14","1","4","0","1","14.3","7.1"
"Randolph","2020-03-15","0","4","0","1","14.3","7.1"
"Randolph","2020-03-16","1","5","0","1","14.3","7.1"
"Randolph","2020-03-17","0","5","0","1","14.3","7.1"
"Randolph","2020-03-18","1","6","0","1","0","7.1"
"Randolph","2020-03-19","2","8","0","1","0","7.1"
"Randolph","2020-03-20","7","15","3","4","6.1","10.2"
"Randolph","2020-03-21","2","17","2","6","20.4","17.3"
"Randolph","2020-03-22","2","19","1","7","27.6","20.9"
"Randolph","2020-03-23","10","29","3","10","31.8","23.1"
"Randolph","2020-03-24","1","30","1","11","46.1","30.2"
"Randolph","2020-03-25","7","37","2","13","50.2","25.1"
"Randolph","2020-03-26","16","53","8","21","57.3","28.7"
"Randolph","2020-03-27","6","59","3","24","58.4","32.2"
"Randolph","2020-03-28","5","64","3","27","52.7","36.5"
"Randolph","2020-03-29","8","72","5","32","54.4","41"
"Randolph","2020-03-30","8","80","5","37","59.1","45.5"
"Randolph","2020-03-31","12","92","6","43","51.9","49"
"Randolph","2020-04-01","11","103","9","52","59.5","54.9"
"Randolph","2020-04-02","12","115","8","60","61.9","59.6"
"Randolph","2020-04-03","66","181","44","104","64.3","61.3"
"Randolph","2020-04-04","10","191","7","111","65.7","59.2"
"Randolph","2020-04-05","11","202","7","118","65.9","60.2"
"Randolph","2020-04-06","15","217","8","126","64.6","61.8"
"Randolph","2020-04-07","7","224","3","129","63.6","57.8"
"Randolph","2020-04-08","6","230","3","132","59","59.3"
"Randolph","2020-04-09","17","247","11","143","58.7","60.3"
"Randolph","2020-04-10","7","254","2","145","53.3","58.8"
"Randolph","2020-04-11","11","265","4","149","48.5","57.1"
"Randolph","2020-04-12","1","266","0","149","39.4","52.7"
"Randolph","2020-04-13","16","282","6","155","37.1","50.9"
"Randolph","2020-04-14","8","290","2","157","34.6","49.1"
"Randolph","2020-04-15","18","308","0","157","27.4","43.2"
"Randolph","2020-04-16","26","334","2","159","19.3","39"
"Randolph","2020-04-17","17","351","1","160","16.1","34.7"
"Randolph","2020-04-18","11","362","2","162","13.5","31"
"Randolph","2020-04-19","6","368","0","162","13.5","26.4"
"Randolph","2020-04-20","14","382","5","167","13.2","25.2"
"Randolph","2020-04-21","13","395","4","171","14","24.3"
"Randolph","2020-04-22","8","403","2","173","17.6","22.5"
"Randolph","2020-04-23","16","419","2","175","18.3","18.8"
"Randolph","2020-04-24","10","429","2","177","20.3","18.2"
"Randolph","2020-04-25","3","432","0","177","17.7","15.6"
"Randolph","2020-04-26","3","435","1","178","22.5","18"
"Randolph","2020-04-27","26","461","18","196","27.3","20.2"
"Randolph","2020-04-28","12","473","2","198","25.2","19.6"
"Randolph","2020-04-29","9","482","1","199","23.3","20.4"
"Randolph","2020-04-30","15","497","5","204","26.2","22.3"
"Randolph","2020-05-01","7","504","2","206","27.5","23.9"
"Randolph","2020-05-02","5","509","2","208","33.2","25.4"
"Randolph","2020-05-03","11","520","0","208","28.4","25.4"
"Randolph","2020-05-04","17","537","2","210","20.2","23.7"
"Randolph","2020-05-05","13","550","1","211","18.9","22.1"
"Randolph","2020-05-06","7","557","1","212","19.4","21.3"
"Randolph","2020-05-07","6","563","1","213","17","21.6"
"Randolph","2020-05-08","14","577","2","215","15","21.2"
"Randolph","2020-05-09","0","577","0","215","9.2","21.2"
"Randolph","2020-05-10","3","580","1","216","14","21.2"
"Randolph","2020-05-11","17","597","2","218","14","17.1"
"Randolph","2020-05-12","8","605","2","220","16.5","17.7"
"Randolph","2020-05-13","11","616","0","220","14.4","16.9"
"Randolph","2020-05-14","20","636","2","222","13.5","15.2"
"Randolph","2020-05-15","10","646","0","222","11.4","13.2"
"Randolph","2020-05-16","3","649","0","222","11.4","10.3"
"Randolph","2020-05-17","3","652","0","222","6.7","10.3"
"Randolph","2020-05-18","15","667","2","224","6.9","10.5"
"Randolph","2020-05-19","9","676","1","225","4.9","10.7"
"Randolph","2020-05-20","5","681","0","225","4.9","9.7"
"Randolph","2020-05-21","18","699","0","225","3.5","8.5"
"Randolph","2020-05-22","32","731","3","228","4.8","8.1"
"Randolph","2020-05-23","3","734","0","228","4.8","8.1"
"Randolph","2020-05-24","7","741","0","228","4.8","5.8"
"Randolph","2020-05-25","8","749","0","228","2.9","4.9"
"Randolph","2020-05-26","33","782","0","228","1.3","3.1"
"Randolph","2020-05-27","48","830","5","233","2.8","3.9"
"Randolph","2020-05-28","27","857","1","234","3.4","3.4"
"Randolph","2020-05-29","18","875","1","235","2.8","3.8"
"Randolph","2020-05-30","2","877","0","235","2.8","3.8"
"Randolph","2020-05-31","2","879","0","235","2.8","3.8"
"Randolph","2020-06-01","13","892","0","235","2.8","2.9"
"Randolph","2020-06-02","11","903","1","236","4.1","2.7"
"Randolph","2020-06-03","18","921","0","236","2.6","2.7"
"Randolph","2020-06-04","12","933","0","236","2.1","2.7"
"Randolph","2020-06-05","18","951","0","236","1.3","2.1"
"Randolph","2020-06-06","86","1037","1","237","1.5","2.1"
"Randolph","2020-06-07","6","1043","1","238","3.8","3.3"
"Randolph","2020-06-08","12","1055","1","239","5","3.9"
"Randolph","2020-06-09","6","1061","0","239","3.7","3.9"
"Randolph","2020-06-10","6","1067","1","240","6.1","4.4"
"Randolph","2020-06-11","25","1092","0","240","6.1","4.1"
"Randolph","2020-06-12","12","1104","1","241","7.3","4.3"
"Randolph","2020-06-13","0","1104","0","241","7.1","4.3"
"Randolph","2020-06-14","2","1106","1","242","11.9","7.9"
"Randolph","2020-06-15","12","1118","1","243","11.9","8.5"
"Randolph","2020-06-16","9","1127","2","245","15.1","9.4"
"Randolph","2020-06-17","5","1132","2","247","18.4","12.3"
"Randolph","2020-06-18","24","1156","0","247","18.4","12.3"
"Randolph","2020-06-19","13","1169","0","247","17.2","12.3"
"Randolph","2020-06-20","2","1171","0","247","17.2","12.2"
"Randolph","2020-06-21","2","1173","1","248","17.2","14.6"
"Randolph","2020-06-22","18","1191","2","250","17.6","14.8"
"Randolph","2020-06-23","4","1195","0","250","14.4","14.8"
"Randolph","2020-06-24","14","1209","0","250","8.7","13.6"
"Randolph","2020-06-25","27","1236","1","251","9.3","13.8"
"Randolph","2020-06-26","33","1269","2","253","10.1","13.7"
"Randolph","2020-06-27","1","1270","0","253","10.1","13.7"
"Randolph","2020-06-28","6","1276","2","255","7.7","12.5"
"Randolph","2020-06-29","24","1300","3","258","7.9","12.8"
"Randolph","2020-06-30","2","1302","0","258","7.9","11.2"
"Randolph","2020-07-01","9","1311","1","259","9.5","9.1"
"Randolph","2020-07-02","25","1336","2","261","10.1","9.7"
"Randolph","2020-07-03","4","1340","0","261","9.3","9.7"
"Randolph","2020-07-04","3","1343","0","261","9.3","9.7"
"Randolph","2020-07-05","5","1348","1","262","7.4","7.6"
"Randolph","2020-07-06","18","1366","1","263","6.4","7.2"
"Randolph","2020-07-07","11","1377","1","264","7.7","7.8"
"Randolph","2020-07-08","8","1385","2","266","9.7","9.6"
"Randolph","2020-07-09","40","1425","4","270","9.9","10"
"Randolph","2020-07-10","23","1448","4","274","12.4","10.9"
"Randolph","2020-07-11","3","1451","1","275","17.2","13.2"
"Randolph","2020-07-12","6","1457","4","279","23.9","15.6"
"Randolph","2020-07-13","11","1468","1","280","24.4","15.4"
"Randolph","2020-07-14","11","1479","0","280","23.1","15.4"
"Randolph","2020-07-15","5","1484","1","281","22.4","16"
"Randolph","2020-07-16","9","1493","0","281","20.9","15.4"
"Randolph","2020-07-17","11","1504","0","281","18.4","15.4"
"Randolph","2020-07-18","5","1509","2","283","19.4","18.3"
"Randolph","2020-07-19","6","1515","1","284","12.3","18.1"
"Randolph","2020-07-20","37","1552","3","287","12.1","18.2"
"Randolph","2020-07-21","11","1563","2","289","14.7","18.9"
"Randolph","2020-07-22","19","1582","3","292","14.1","18.2"
"Randolph","2020-07-23","48","1630","6","298","15.9","18.4"
"Randolph","2020-07-24","26","1656","5","303","18.6","18.5"
"Randolph","2020-07-25","6","1662","1","304","15.3","17.4"
"Randolph","2020-07-26","5","1667","2","306","18.6","15.4"
"Randolph","2020-07-27","62","1729","10","316","19.8","15.9"
"Randolph","2020-07-28","38","1767","1","317","17.6","16.1"
"Randolph","2020-07-29","19","1786","4","321","18.3","16.2"
"Randolph","2020-07-30","30","1816","7","328","19.9","17.9"
"Randolph","2020-07-31","29","1845","7","335","20.6","19.6"
"Randolph","2020-08-01","8","1853","3","338","23.5","19.4"
"Randolph","2020-08-02","0","1853","0","338","17.8","18.2"
"Randolph","2020-08-03","16","1869","3","341","18.2","19"
"Randolph","2020-08-04","14","1883","2","343","19.9","18.7"
"Randolph","2020-08-05","13","1896","2","345","19.1","18.7"
"Randolph","2020-08-06","36","1932","1","346","16.1","18"
"Randolph","2020-08-07","57","1989","6","352","14.2","17.4"
"Randolph","2020-08-08","1","1990","0","352","8.8","16.2"
"Randolph","2020-08-09","1","1991","0","352","8.8","13.3"
"Randolph","2020-08-10","13","2004","3","355","9.4","13.8"
"Randolph","2020-08-11","14","2018","1","356","8.4","14.1"
"Randolph","2020-08-12","8","2026","2","358","9.8","14.4"
"Randolph","2020-08-13","34","2060","4","362","11.1","13.6"
"Randolph","2020-08-14","11","2071","3","365","13.5","13.8"
"Randolph","2020-08-15","15","2086","4","369","17.3","13"
"Randolph","2020-08-16","4","2090","1","370","20.8","14.8"
"Randolph","2020-08-17","13","2103","3","373","20.8","15.1"
"Randolph","2020-08-18","11","2114","2","375","22.4","15.4"
"Randolph","2020-08-19","11","2125","2","377","21.4","15.6"
"Randolph","2020-08-20","38","2163","5","382","21.6","16.4"
"Randolph","2020-08-21","22","2185","0","382","17.8","15.6"
"Randolph","2020-08-22","3","2188","1","383","18.7","18"
"Randolph","2020-08-23","9","2197","1","384","16.7","18.8"
"Randolph","2020-08-24","15","2212","2","386","15.3","18.1"
"Randolph","2020-08-25","9","2221","2","388","15.9","19.2"
"Randolph","2020-08-26","9","2230","2","390","16.5","19"
"Randolph","2020-08-27","13","2243","1","391","15.7","18.7"
"Randolph","2020-08-28","10","2253","3","394","20","18.9"
"Randolph","2020-08-29","1","2254","1","395","29.5","24.1"
"Randolph","2020-08-30","3","2257","0","395","27.9","22.3"
"Randolph","2020-08-31","16","2273","3","398","28.7","22"
"Randolph","2020-09-01","10","2283","1","399","27","21.4"
"Randolph","2020-09-02","10","2293","3","402","28.1","22.3"
"Randolph","2020-09-03","18","2311","2","404","28.6","22.1"
"Randolph","2020-09-04","48","2359","3","407","25.2","22.6"
"Randolph","2020-09-05","2","2361","0","407","10.9","20.2"
"Randolph","2020-09-06","5","2366","0","407","10.9","19.4"
"Randolph","2020-09-07","0","2366","0","407","8.2","18.4"
"Randolph","2020-09-08","20","2386","1","408","7.5","17.2"
"Randolph","2020-09-09","10","2396","0","408","3.2","15.6"
"Randolph","2020-09-10","35","2431","0","408","1.6","15.1"
"Randolph","2020-09-11","10","2441","0","408","0.7","12.9"
"Randolph","2020-09-12","6","2447","1","409","3.1","7"
"Randolph","2020-09-13","1","2448","0","409","3.1","7"
"Randolph","2020-09-14","9","2457","1","410","4.7","6.4"
"Randolph","2020-09-15","7","2464","0","410","4","5.7"
"Randolph","2020-09-16","9","2473","0","410","4","3.6"
"Randolph","2020-09-17","11","2484","0","410","4","2.8"
"Randolph","2020-09-18","13","2497","0","410","4","2.3"
"Randolph","2020-09-19","2","2499","0","410","1.6","2.3"
"Randolph","2020-09-20","2","2501","0","410","1.6","2.3"
"Randolph","2020-09-21","9","2510","0","410","0","2.3"
"Randolph","2020-09-22","9","2519","0","410","0","2"
"Randolph","2020-09-23","5","2524","0","410","0","2"
"Randolph","2020-09-24","9","2533","0","410","0","2"
"Randolph","2020-09-25","6","2539","1","411","2.4","3.2"
"Randolph","2020-09-26","2","2541","0","411","2.4","2"
"Randolph","2020-09-27","2","2543","0","411","2.4","2"
"Randolph","2020-09-28","14","2557","1","412","3.4","1.7"
"Randolph","2020-09-29","9","2566","0","412","3.4","1.7"
"Randolph","2020-09-30","7","2573","0","412","3.4","1.7"
"Randolph","2020-10-01","15","2588","0","412","3.4","1.7"
"Randolph","2020-10-02","11","2599","0","412","1","1.7"
"Randolph","2020-10-03","2","2601","0","412","1","1.7"
"Randolph","2020-10-04","4","2605","1","413","4.6","3.5"
"Randolph","2020-10-05","13","2618","1","414","4.7","4"
"Randolph","2020-10-06","7","2625","0","414","4.7","4"
"Randolph","2020-10-07","13","2638","0","414","4.7","4"
"Randolph","2020-10-08","17","2655","1","415","5.5","4.5"
"Randolph","2020-10-09","42","2697","1","416","5.9","3.4"
"Randolph","2020-10-10","5","2702","0","416","5.9","3.4"
"Randolph","2020-10-11","4","2706","0","416","2.3","3.4"
"Randolph","2020-10-12","12","2718","0","416","1.2","2.9"
"Randolph","2020-10-13","12","2730","0","416","1.2","2.9"
"Randolph","2020-10-14","12","2742","0","416","1.2","2.9"
"Randolph","2020-10-15","23","2765","0","416","0.3","2.9"
"Randolph","2020-10-16","7","2772","0","416","0","2.9"
"Randolph","2020-10-17","3","2775","0","416","0","2.9"
"Randolph","2020-10-18","2","2777","0","416","0","1.1"
"Randolph","2020-10-19","14","2791","0","416","0","0.6"
"Randolph","2020-10-20","9","2800","1","417","1.6","1.4"
"Randolph","2020-10-21","6","2806","0","417","1.6","1.4"
"Randolph","2020-10-22","16","2822","1","418","2.5","1.4"
"Randolph","2020-10-23","4","2826","0","418","2.5","1.2"
"Randolph","2020-10-24","4","2830","0","418","2.5","1.2"
"Randolph","2020-10-25","0","2830","0","418","2.5","1.2"
"Randolph","2020-10-26","16","2846","0","418","2.5","1.2"
"Randolph","2020-10-27","6","2852","0","418","0.9","1.2"
"Randolph","2020-10-28","5","2857","0","418","0.9","1.2"
"Randolph","2020-10-29","14","2871","1","419","1","1.8"
"Randolph","2020-10-30","2","2873","0","419","1","1.8"
"Randolph","2020-10-31","1","2874","0","419","1","1.8"
"Randolph","2020-11-01","3","2877","0","419","1","1.8"
"Randolph","2020-11-02","15","2892","0","419","1","1.8"
"Randolph","2020-11-03","4","2896","0","419","1","1"
"Randolph","2020-11-04","11","2907","0","419","1","1"
"Randolph","2020-11-05","12","2919","1","420","1.2","1.1"
"Randolph","2020-11-06","4","2923","0","420","1.2","1.1"
"Randolph","2020-11-07","2","2925","0","420","1.2","1.1"
"Randolph","2020-11-08","2","2927","0","420","1.2","1.1"
"Randolph","2020-11-09","7","2934","0","420","1.2","1.1"
"Randolph","2020-11-10","9","2943","1","421","2.8","1.9"
"Randolph","2020-11-11","12","2955","0","421","2.8","1.9"
"Randolph","2020-11-12","4","2959","0","421","1.6","1.4"
"Randolph","2020-11-13","5","2964","1","422","4.4","2.8"
"Randolph","2020-11-14","3","2967","0","422","4.4","2.8"
"Randolph","2020-11-15","3","2970","0","422","4.4","2.8"
"Randolph","2020-11-16","5","2975","0","422","4.4","2.8"
"Randolph","2020-11-17","6","2981","0","422","2.9","2.8"
"Randolph","2020-11-18","8","2989","0","422","2.9","2.8"
"Randolph","2020-11-19","9","2998","0","422","2.9","2.2"
"Randolph","2020-11-20","6","3004","0","422","0","2.2"
"Randolph","2020-11-21","2","3006","1","423","7.1","5.8"
"Randolph","2020-11-22","1","3007","0","423","7.1","5.8"
"Randolph","2020-11-23","12","3019","1","424","8.3","6.4"
"Randolph","2020-11-24","6","3025","0","424","8.3","5.6"
"Randolph","2020-11-25","8","3033","0","424","8.3","5.6"
"Randolph","2020-11-26","3","3036","0","424","8.3","5.6"
"Randolph","2020-11-27","5","3041","0","424","8.3","4.2"
"Randolph","2020-11-28","0","3041","0","424","1.2","4.2"
"Randolph","2020-11-29","0","3041","0","424","1.2","4.2"
"Randolph","2020-11-30","12","3053","0","424","0","4.2"
"Randolph","2020-12-01","8","3061","0","424","0","4.2"
"Randolph","2020-12-02","13","3074","1","425","1.1","4.7"
"Randolph","2020-12-03","4","3078","0","425","1.1","4.7"
"Randolph","2020-12-04","6","3084","0","425","1.1","4.7"
"Randolph","2020-12-05","2","3086","0","425","1.1","1.1"
"Randolph","2020-12-06","2","3088","0","425","1.1","1.1"
"Randolph","2020-12-07","15","3103","1","426","2.1","1"
"Randolph","2020-12-08","10","3113","0","426","2.1","1"
"Randolph","2020-12-09","3","3116","0","426","1","1"
"Randolph","2020-12-10","7","3123","0","426","1","1"
"Randolph","2020-12-11","9","3132","0","426","1","1"
"Randolph","2020-12-12","2","3134","0","426","1","1"
"Randolph","2020-12-13","4","3138","0","426","1","1"
"Randolph","2020-12-14","21","3159","1","427","0.7","1.4"
"Randolph","2020-12-15","9","3168","0","427","0.7","1.4"
"Randolph","2020-12-16","5","3173","0","427","0.7","0.8"
"Randolph","2020-12-17","4","3177","0","427","0.7","0.8"
"Randolph","2020-12-18","15","3192","1","428","1.6","1.3"
"Randolph","2020-12-19","2","3194","0","428","1.6","1.3"
"Randolph","2020-12-20","9","3203","1","429","3.2","2.1"
"Randolph","2020-12-21","8","3211","2","431","6.1","3.4"
"Randolph","2020-12-22","10","3221","2","433","9","4.8"
"Randolph","2020-12-23","4","3225","0","433","9","4.8"
"Randolph","2020-12-24","4","3229","1","434","12.5","6.6"
"Randolph","2020-12-25","1","3230","0","434","11.6","6.6"
"Randolph","2020-12-26","3","3233","0","434","11.6","6.6"
"Randolph","2020-12-27","1","3234","0","434","10","6.6"
"Randolph","2020-12-28","7","3241","0","434","6.4","6.3"
"Randolph","2020-12-29","6","3247","2","436","8.3","8.7"
"Randolph","2020-12-30","7","3254","0","436","8.3","8.7"
"Randolph","2020-12-31","35","3289","3","439","6","9.3"
"Randolph","2021-01-01","4","3293","1","440","9.6","10.6"
"Randolph","2021-01-02","3","3296","0","440","9.6","10.6"
"Randolph","2021-01-03","3","3299","1","441","14.3","12.2"
"Randolph","2021-01-04","65","3364","3","444","15","10.7"
"Randolph","2021-01-05","12","3376","2","446","12.6","10.5"
"Randolph","2021-01-06","12","3388","1","447","13.8","11.1"
"Randolph","2021-01-07","9","3397","0","447","12.6","9.3"
"Randolph","2021-01-08","8","3405","3","450","14.3","12"
"Randolph","2021-01-09","2","3407","0","450","14.3","12"
"Randolph","2021-01-10","6","3413","2","452","14.3","14.3"
"Randolph","2021-01-11","44","3457","3","455","14.7","14.8"
"Randolph","2021-01-12","14","3471","0","455","12.3","12.4"
"Randolph","2021-01-13","14","3485","1","456","12.1","13"
"Randolph","2021-01-14","13","3498","1","457","13.2","12.9"
"Randolph","2021-01-15","22","3520","5","462","11.1","12.7"
"Randolph","2021-01-16","5","3525","0","462","11.1","12.7"
"Randolph","2021-01-17","4","3529","1","463","9.9","12.1"
"Randolph","2021-01-18","9","3538","2","465","12.1","13.4"
"Randolph","2021-01-19","13","3551","1","466","13.2","12.7"
"Randolph","2021-01-20","15","3566","1","467","13.1","12.6"
"Randolph","2021-01-21","10","3576","3","470","16.3","14.8"
"Randolph","2021-01-22","10","3586","3","473","17.4","14.2"
"Randolph","2021-01-23","6","3592","0","473","17.4","14.2"
"Randolph","2021-01-24","3","3595","1","474","18.6","14.2"
"Randolph","2021-01-25","54","3649","9","483","17.8","14.9"
"Randolph","2021-01-26","14","3663","5","488","21.8","17.5"
"Randolph","2021-01-27","8","3671","0","488","20.8","17"
"Randolph","2021-01-28","12","3683","2","490","18.9","17.6"
"Randolph","2021-01-29","19","3702","3","493","16.9","17.1"
"Randolph","2021-01-30","1","3703","0","493","16.9","17.1"
"Randolph","2021-01-31","2","3705","0","493","12.1","15.3"
"Randolph","2021-02-01","26","3731","2","495","10.8","14.3"
"Randolph","2021-02-02","12","3743","3","498","9.3","15.5"
"Randolph","2021-02-03","8","3751","1","499","11.1","16"
"Randolph","2021-02-04","11","3762","4","503","13.9","16.4"
"Randolph","2021-02-05","8","3770","2","505","15.2","16.1"
"Randolph","2021-02-06","2","3772","1","506","22.4","19.6"
"Randolph","2021-02-07","1","3773","0","506","22.4","17.2"
"Randolph","2021-02-08","0","3773","0","506","21.3","16.1"
"Richmond","2020-02-01","0","0","0","0",".","."
"Richmond","2020-02-02","0","0","0","0",".","."
"Richmond","2020-02-03","0","0","0","0",".","."
"Richmond","2020-02-04","0","0","0","0",".","."
"Richmond","2020-02-05","0","0","0","0",".","."
"Richmond","2020-02-06","0","0","0","0",".","."
"Richmond","2020-02-07","0","0","0","0","0","."
"Richmond","2020-02-08","0","0","0","0","0","."
"Richmond","2020-02-09","0","0","0","0","0","."
"Richmond","2020-02-10","0","0","0","0","0","."
"Richmond","2020-02-11","0","0","0","0","0","."
"Richmond","2020-02-12","0","0","0","0","0","."
"Richmond","2020-02-13","0","0","0","0","0","."
"Richmond","2020-02-14","0","0","0","0","0","0"
"Richmond","2020-02-15","0","0","0","0","0","0"
"Richmond","2020-02-16","0","0","0","0","0","0"
"Richmond","2020-02-17","0","0","0","0","0","0"
"Richmond","2020-02-18","0","0","0","0","0","0"
"Richmond","2020-02-19","0","0","0","0","0","0"
"Richmond","2020-02-20","0","0","0","0","0","0"
"Richmond","2020-02-21","0","0","0","0","0","0"
"Richmond","2020-02-22","0","0","0","0","0","0"
"Richmond","2020-02-23","0","0","0","0","0","0"
"Richmond","2020-02-24","0","0","0","0","0","0"
"Richmond","2020-02-25","0","0","0","0","0","0"
"Richmond","2020-02-26","0","0","0","0","0","0"
"Richmond","2020-02-27","0","0","0","0","0","0"
"Richmond","2020-02-28","0","0","0","0","0","0"
"Richmond","2020-02-29","0","0","0","0","0","0"
"Richmond","2020-03-01","0","0","0","0","0","0"
"Richmond","2020-03-02","0","0","0","0","0","0"
"Richmond","2020-03-03","0","0","0","0","0","0"
"Richmond","2020-03-04","0","0","0","0","0","0"
"Richmond","2020-03-05","0","0","0","0","0","0"
"Richmond","2020-03-06","0","0","0","0","0","0"
"Richmond","2020-03-07","3","3","0","0","0","0"
"Richmond","2020-03-08","1","4","0","0","0","0"
"Richmond","2020-03-09","4","8","0","0","0","0"
"Richmond","2020-03-10","0","8","0","0","0","0"
"Richmond","2020-03-11","2","10","0","0","0","0"
"Richmond","2020-03-12","1","11","0","0","0","0"
"Richmond","2020-03-13","3","14","0","0","0","0"
"Richmond","2020-03-14","7","21","0","0","0","0"
"Richmond","2020-03-15","12","33","0","0","0","0"
"Richmond","2020-03-16","46","79","1","1","0.3","0.2"
"Richmond","2020-03-17","39","118","2","3","1","0.5"
"Richmond","2020-03-18","14","132","1","4","2.1","1"
"Richmond","2020-03-19","17","149","0","4","2.1","1"
"Richmond","2020-03-20","27","176","5","9","4.7","2.4"
"Richmond","2020-03-21","13","189","2","11","6.9","3.5"
"Richmond","2020-03-22","3","192","0","11","6.9","3.5"
"Richmond","2020-03-23","16","208","2","13","8.4","4.3"
"Richmond","2020-03-24","26","234","6","19","10.9","6"
"Richmond","2020-03-25","12","246","1","20","11.1","6.6"
"Richmond","2020-03-26","20","266","2","22","12.5","7.3"
"Richmond","2020-03-27","21","287","2","24","11.3","8"
"Richmond","2020-03-28","3","290","1","25","13.8","10.4"
"Richmond","2020-03-29","2","292","0","25","13.8","10.4"
"Richmond","2020-03-30","18","310","2","27","13.6","11"
"Richmond","2020-03-31","22","332","1","28","11","11"
"Richmond","2020-04-01","50","382","2","30","10.4","10.7"
"Richmond","2020-04-02","115","497","13","43","10.5","11.5"
"Richmond","2020-04-03","230","727","39","82","11.6","11.4"
"Richmond","2020-04-04","288","1015","30","112","8.3","11.1"
"Richmond","2020-04-05","109","1124","22","134","11.2","12.5"
"Richmond","2020-04-06","121","1245","22","156","12.2","12.9"
"Richmond","2020-04-07","165","1410","15","171","12.9","11.9"
"Richmond","2020-04-08","151","1561","15","186","13.7","12"
"Richmond","2020-04-09","225","1786","77","263","17","13.8"
"Richmond","2020-04-10","138","1924","21","284","16.7","14.2"
"Richmond","2020-04-11","80","2004","9","293","16.9","12.6"
"Richmond","2020-04-12","34","2038","10","303","18.2","14.7"
"Richmond","2020-04-13","111","2149","10","313","16.9","14.6"
"Richmond","2020-04-14","113","2262","18","331","17.9","15.4"
"Richmond","2020-04-15","120","2382","14","345","18.1","15.9"
"Richmond","2020-04-16","106","2488","20","365","15.9","16.5"
"Richmond","2020-04-17","120","2608","11","376","15","15.9"
"Richmond","2020-04-18","91","2699","19","395","16.4","16.6"
"Richmond","2020-04-19","52","2751","16","411","16.6","17.4"
"Richmond","2020-04-20","226","2977","24","435","16.8","16.9"
"Richmond","2020-04-21","405","3382","25","460","15.4","16.7"
"Richmond","2020-04-22","181","3563","14","474","14.9","16.5"
"Richmond","2020-04-23","166","3729","12","486","13.2","14.6"
"Richmond","2020-04-24","295","4024","25","511","13.1","14.1"
"Richmond","2020-04-25","131","4155","11","522","11.3","13.9"
"Richmond","2020-04-26","81","4236","9","531","8.5","12.6"
"Richmond","2020-04-27","195","4431","13","544","8","12.4"
"Richmond","2020-04-28","257","4688","9","553","7.6","11.5"
"Richmond","2020-04-29","210","4898","18","571","7.7","11.3"
"Richmond","2020-04-30","208","5106","16","587","7.8","10.5"
"Richmond","2020-05-01","271","5377","16","603","7.4","10.3"
"Richmond","2020-05-02","197","5574","11","614","7","9.2"
"Richmond","2020-05-03","130","5704","12","626","6.7","7.6"
"Richmond","2020-05-04","218","5922","13","639","6.6","7.3"
"Richmond","2020-05-05","249","6171","12","651","6.8","7.2"
"Richmond","2020-05-06","327","6498","28","679","6.8","7.3"
"Richmond","2020-05-07","219","6717","14","693","6.6","7.2"
"Richmond","2020-05-08","244","6961","10","703","6.4","6.9"
"Richmond","2020-05-09","222","7183","9","712","6.2","6.6"
"Richmond","2020-05-10","28","7211","4","716","6.9","6.8"
"Richmond","2020-05-11","240","7451","4","720","6.3","6.5"
"Richmond","2020-05-12","322","7773","5","725","5.8","6.3"
"Richmond","2020-05-13","205","7978","12","737","5.4","6.1"
"Richmond","2020-05-14","579","8557","27","764","5.2","5.9"
"Richmond","2020-05-15","335","8892","6","770","4.8","5.6"
"Richmond","2020-05-16","288","9180","39","809","6.2","6.2"
"Richmond","2020-05-17","122","9302","4","813","4.6","5.8"
"Richmond","2020-05-18","210","9512","7","820","4.9","5.6"
"Richmond","2020-05-19","582","10094","25","845","5.3","5.5"
"Richmond","2020-05-20","226","10320","8","853","4.9","5.2"
"Richmond","2020-05-21","324","10644","18","871","5","5.1"
"Richmond","2020-05-22","218","10862","10","881","5.4","5.1"
"Richmond","2020-05-23","148","11010","9","890","4.4","5.3"
"Richmond","2020-05-24","155","11165","8","898","4.7","4.6"
"Richmond","2020-05-25","84","11249","1","899","4.3","4.6"
"Richmond","2020-05-26","219","11468","1","900","3.8","4.5"
"Richmond","2020-05-27","59","11527","1","901","3.5","4.2"
"Richmond","2020-05-28","191","11718","8","909","3.3","4.2"
"Richmond","2020-05-29","111","11829","4","913","3.2","4.3"
"Richmond","2020-05-30","42","11871","1","914","2.7","3.5"
"Richmond","2020-05-31","136","12007","8","922","2.8","3.7"
"Richmond","2020-06-01","222","12229","11","933","3.3","3.8"
"Richmond","2020-06-02","270","12499","11","944","3.8","3.8"
"Richmond","2020-06-03","203","12702","16","960","4.7","4.1"
"Richmond","2020-06-04","142","12844","8","968","4.9","4.1"
"Richmond","2020-06-05","140","12984","4","972","4.8","4"
"Richmond","2020-06-06","107","13091","8","980","5.5","4.1"
"Richmond","2020-06-07","59","13150","7","987","6.4","4.6"
"Richmond","2020-06-08","65","13215","2","989","6.1","4.7"
"Richmond","2020-06-09","227","13442","13","1002","6.4","5.1"
"Richmond","2020-06-10","302","13744","38","1040","7","5.9"
"Richmond","2020-06-11","238","13982","6","1046","6.6","5.8"
"Richmond","2020-06-12","214","14196","5","1051","6.5","5.7"
"Richmond","2020-06-13","136","14332","4","1055","5.9","5.7"
"Richmond","2020-06-14","146","14478","9","1064","5","5.7"
"Richmond","2020-06-15","315","14793","9","1073","5","5.6"
"Richmond","2020-06-16","364","15157","16","1089","4.8","5.6"
"Richmond","2020-06-17","81","15238","9","1098","4.6","5.8"
"Richmond","2020-06-18","174","15412","15","1113","5.5","6"
"Richmond","2020-06-19","248","15660","18","1131","6.2","6.4"
"Richmond","2020-06-20","174","15834","5","1136","6.2","6"
"Richmond","2020-06-21","70","15904","11","1147","7.5","6.3"
"Richmond","2020-06-22","372","16276","63","1210","9.6","7.3"
"Richmond","2020-06-23","338","16614","30","1240","10.2","7.5"
"Richmond","2020-06-24","351","16965","36","1276","10.1","7.3"
"Richmond","2020-06-25","343","17308","27","1303","10","7.7"
"Richmond","2020-06-26","354","17662","43","1346","10.7","8.4"
"Richmond","2020-06-27","252","17914","38","1384","12.4","9.3"
"Richmond","2020-06-28","193","18107","32","1416","12.5","10"
"Richmond","2020-06-29","443","18550","80","1496","12.7","11.1"
"Richmond","2020-06-30","655","19205","69","1565","12.9","11.6"
"Richmond","2020-07-01","570","19775","99","1664","13.9","12"
"Richmond","2020-07-02","552","20327","64","1728","14.5","12.2"
"Richmond","2020-07-03","456","20783","55","1783","14.5","12.6"
"Richmond","2020-07-04","103","20886","18","1801","14.8","13.6"
"Richmond","2020-07-05","310","21196","44","1845","14.5","13.5"
"Richmond","2020-07-06","666","21862","100","1945","14","13.4"
"Richmond","2020-07-07","572","22434","74","2019","14.4","13.7"
"Richmond","2020-07-08","643","23077","86","2105","13.8","13.9"
"Richmond","2020-07-09","646","23723","78","2183","13.9","14.2"
"Richmond","2020-07-10","710","24433","123","2306","14.6","14.5"
"Richmond","2020-07-11","523","24956","106","2412","15","14.9"
"Richmond","2020-07-12","512","25468","88","2500","15.5","15"
"Richmond","2020-07-13","667","26135","106","2606","15.6","14.8"
"Richmond","2020-07-14","744","26879","75","2681","15.2","14.8"
"Richmond","2020-07-15","722","27601","92","2773","15.1","14.4"
"Richmond","2020-07-16","742","28343","95","2868","15.2","14.5"
"Richmond","2020-07-17","500","28843","65","2933","14.6","14.6"
"Richmond","2020-07-18","439","29282","73","3006","14","14.5"
"Richmond","2020-07-19","515","29797","52","3058","13","14.2"
"Richmond","2020-07-20","659","30456","106","3164","13.1","14.3"
"Richmond","2020-07-21","676","31132","106","3270","13.9","14.5"
"Richmond","2020-07-22","693","31825","151","3421","15.2","15.1"
"Richmond","2020-07-23","674","32499","109","3530","15.6","15.4"
"Richmond","2020-07-24","627","33126","118","3648","16.5","15.5"
"Richmond","2020-07-25","509","33635","104","3752","17","15.5"
"Richmond","2020-07-26","389","34024","68","3820","18.1","15.6"
"Richmond","2020-07-27","1105","35129","167","3987","17.9","15.5"
"Richmond","2020-07-28","866","35995","149","4136","18.1","16"
"Richmond","2020-07-29","698","36693","127","4263","17.6","16.4"
"Richmond","2020-07-30","694","37387","143","4406","18.3","17"
"Richmond","2020-07-31","564","37951","100","4506","18.1","17.3"
"Richmond","2020-08-01","466","38417","81","4587","17.7","17.3"
"Richmond","2020-08-02","398","38815","75","4662","17.9","18"
"Richmond","2020-08-03","555","39370","126","4788","19","18.4"
"Richmond","2020-08-04","630","40000","122","4910","19.3","18.7"
"Richmond","2020-08-05","580","40580","96","5006","19","18.3"
"Richmond","2020-08-06","632","41212","105","5111","18.5","18.4"
"Richmond","2020-08-07","581","41793","92","5203","18.2","18.1"
"Richmond","2020-08-08","374","42167","59","5262","18","17.8"
"Richmond","2020-08-09","398","42565","56","5318","17.3","17.6"
"Richmond","2020-08-10","651","43216","99","5417","16.2","17.6"
"Richmond","2020-08-11","646","43862","130","5547","16.3","17.8"
"Richmond","2020-08-12","616","44478","114","5661","16.6","17.8"
"Richmond","2020-08-13","648","45126","112","5773","16.7","17.6"
"Richmond","2020-08-14","590","45716","98","5871","16.8","17.5"
"Richmond","2020-08-15","363","46079","64","5935","17.1","17.5"
"Richmond","2020-08-16","408","46487","56","5991","17","17.1"
"Richmond","2020-08-17","674","47161","78","6069","16.5","16.3"
"Richmond","2020-08-18","609","47770","102","6171","16","16.2"
"Richmond","2020-08-19","603","48373","86","6257","15.4","16"
"Richmond","2020-08-20","508","48881","47","6304","14.3","15.5"
"Richmond","2020-08-21","596","49477","81","6385","13.8","15.3"
"Richmond","2020-08-22","311","49788","50","6435","13.6","15.3"
"Richmond","2020-08-23","319","50107","28","6463","12.9","15"
"Richmond","2020-08-24","496","50603","93","6556","13.9","15.2"
"Richmond","2020-08-25","460","51063","69","6625","13.7","14.8"
"Richmond","2020-08-26","494","51557","77","6702","13.9","14.6"
"Richmond","2020-08-27","492","52049","60","6762","14.3","14.3"
"Richmond","2020-08-28","492","52541","51","6813","13.8","13.8"
"Richmond","2020-08-29","277","52818","35","6848","13.3","13.5"
"Richmond","2020-08-30","321","53139","56","6904","14.6","13.7"
"Richmond","2020-08-31","454","53593","46","6950","13.3","13.6"
"Richmond","2020-09-01","466","54059","50","7000","12.7","13.2"
"Richmond","2020-09-02","517","54576","54","7054","12","12.9"
"Richmond","2020-09-03","421","54997","67","7121","12.5","13.4"
"Richmond","2020-09-04","423","55420","81","7202","13.8","13.8"
"Richmond","2020-09-05","212","55632","20","7222","13.3","13.3"
"Richmond","2020-09-06","147","55779","25","7247","13.3","13.9"
"Richmond","2020-09-07","225","56004","14","7261","12.7","13"
"Richmond","2020-09-08","546","56550","88","7349","13.5","13.1"
"Richmond","2020-09-09","506","57056","59","7408","13.6","12.8"
"Richmond","2020-09-10","465","57521","68","7476","13.5","13"
"Richmond","2020-09-11","522","58043","78","7554","12.9","13.3"
"Richmond","2020-09-12","295","58338","39","7593","13.4","13.4"
"Richmond","2020-09-13","162","58500","17","7610","12.5","12.9"
"Richmond","2020-09-14","585","59085","60","7670","13","12.9"
"Richmond","2020-09-15","492","59577","59","7729","12.5","13"
"Richmond","2020-09-16","526","60103","64","7793","12.5","13.1"
"Richmond","2020-09-17","368","60471","51","7844","12.4","12.9"
"Richmond","2020-09-18","569","61040","72","7916","12.1","12.5"
"Richmond","2020-09-19","263","61303","20","7936","11.3","12.3"
"Richmond","2020-09-20","212","61515","21","7957","11.2","11.8"
"Richmond","2020-09-21","561","62076","37","7994","10.7","11.9"
"Richmond","2020-09-22","497","62573","51","8045","10.4","11.4"
"Richmond","2020-09-23","510","63083","43","8088","9.9","11.2"
"Richmond","2020-09-24","581","63664","64","8152","9.5","11"
"Richmond","2020-09-25","540","64204","40","8192","8.7","10.4"
"Richmond","2020-09-26","283","64487","19","8211","8.6","10"
"Richmond","2020-09-27","141","64628","7","8218","7.9","9.6"
"Richmond","2020-09-28","601","65229","33","8251","7.8","9.2"
"Richmond","2020-09-29","505","65734","31","8282","7.2","8.8"
"Richmond","2020-09-30","530","66264","53","8335","7.4","8.6"
"Richmond","2020-10-01","479","66743","35","8370","6.9","8.2"
"Richmond","2020-10-02","557","67300","32","8402","6.6","7.7"
"Richmond","2020-10-03","297","67597","20","8422","6.6","7.6"
"Richmond","2020-10-04","174","67771","6","8428","6.4","7.2"
"Richmond","2020-10-05","606","68377","40","8468","6.6","7.2"
"Richmond","2020-10-06","558","68935","54","8522","7.1","7.1"
"Richmond","2020-10-07","643","69578","47","8569","6.7","7"
"Richmond","2020-10-08","686","70264","37","8606","6.4","6.6"
"Richmond","2020-10-09","574","70838","42","8648","6.6","6.6"
"Richmond","2020-10-10","284","71122","21","8669","6.7","6.7"
"Richmond","2020-10-11","186","71308","9","8678","6.9","6.7"
"Richmond","2020-10-12","682","71990","37","8715","6.8","6.7"
"Richmond","2020-10-13","674","72664","31","8746","6","6.6"
"Richmond","2020-10-14","600","73264","44","8790","6","6.4"
"Richmond","2020-10-15","637","73901","41","8831","6.2","6.3"
"Richmond","2020-10-16","666","74567","38","8869","6","6.3"
"Richmond","2020-10-17","326","74893","19","8888","5.7","6.2"
"Richmond","2020-10-18","167","75060","9","8897","5.8","6.4"
"Richmond","2020-10-19","752","75812","45","8942","5.9","6.3"
"Richmond","2020-10-20","536","76348","37","8979","6.2","6.1"
"Richmond","2020-10-21","611","76959","35","9014","6","6"
"Richmond","2020-10-22","577","77536","37","9051","6","6.1"
"Richmond","2020-10-23","499","78035","26","9077","5.9","5.9"
"Richmond","2020-10-24","323","78358","24","9101","6.2","5.9"
"Richmond","2020-10-25","198","78556","10","9111","6.1","6"
"Richmond","2020-10-26","801","79357","59","9170","6.3","6.1"
"Richmond","2020-10-27","585","79942","34","9204","6.1","6.2"
"Richmond","2020-10-28","557","80499","43","9247","6.4","6.2"
"Richmond","2020-10-29","690","81189","59","9306","6.7","6.4"
"Richmond","2020-10-30","641","81830","43","9349","6.9","6.4"
"Richmond","2020-10-31","328","82158","22","9371","6.8","6.5"
"Richmond","2020-11-01","162","82320","8","9379","6.8","6.5"
"Richmond","2020-11-02","1136","83456","102","9481","7.1","6.7"
"Richmond","2020-11-03","666","84122","51","9532","7.3","6.7"
"Richmond","2020-11-04","764","84886","49","9581","7.1","6.8"
"Richmond","2020-11-05","944","85830","52","9633","6.7","6.7"
"Richmond","2020-11-06","931","86761","79","9712","7","7"
"Richmond","2020-11-07","500","87261","38","9750","7.1","7"
"Richmond","2020-11-08","372","87633","16","9766","7","6.9"
"Richmond","2020-11-09","1059","88692","85","9851","6.9","7"
"Richmond","2020-11-10","792","89484","67","9918","7","7.1"
"Richmond","2020-11-11","739","90223","51","9969","7","7.1"
"Richmond","2020-11-12","808","91031","59","10028","7.3","7"
"Richmond","2020-11-13","750","91781","43","10071","6.9","6.9"
"Richmond","2020-11-14","402","92183","41","10112","7.3","7.2"
"Richmond","2020-11-15","206","92389","19","10131","8","7.5"
"Richmond","2020-11-16","864","93253","84","10215","8.2","7.5"
"Richmond","2020-11-17","704","93957","67","10282","8.4","7.7"
"Richmond","2020-11-18","704","94661","65","10347","8.7","7.9"
"Richmond","2020-11-19","694","95355","79","10426","9.3","8.3"
"Richmond","2020-11-20","757","96112","61","10487","9.6","8.3"
"Richmond","2020-11-21","359","96471","29","10516","9.3","8.3"
"Richmond","2020-11-22","224","96695","16","10532","9","8.5"
"Richmond","2020-11-23","946","97641","88","10620","9","8.6"
"Richmond","2020-11-24","760","98401","90","10710","9.3","8.8"
"Richmond","2020-11-25","579","98980","45","10755","9.1","8.9"
"Richmond","2020-11-26","94","99074","17","10772","10","9.7"
"Richmond","2020-11-27","407","99481","52","10824","10.7","10.2"
"Richmond","2020-11-28","410","99891","54","10878","11.4","10.4"
"Richmond","2020-11-29","224","100115","31","10909","12.4","10.7"
"Richmond","2020-11-30","934","101049","129","11038","13","11"
"Richmond","2020-12-01","790","101839","117","11155","13.5","11.4"
"Richmond","2020-12-02","964","102803","149","11304","14.6","11.8"
"Richmond","2020-12-03","823","103626","97","11401","13.7","11.9"
"Richmond","2020-12-04","878","104504","124","11525","13.9","12.3"
"Richmond","2020-12-05","535","105039","121","11646","15.2","13.3"
"Richmond","2020-12-06","242","105281","29","11675","14.9","13.7"
"Richmond","2020-12-07","981","106262","114","11789","14.6","13.8"
"Richmond","2020-12-08","1024","107286","166","11955","14.8","14.1"
"Richmond","2020-12-09","1061","108347","171","12126","14.9","14.7"
"Richmond","2020-12-10","1053","109400","139","12265","15.1","14.4"
"Richmond","2020-12-11","980","110380","150","12415","15.3","14.6"
"Richmond","2020-12-12","449","110829","71","12486","14.3","14.8"
"Richmond","2020-12-13","294","111123","43","12529","14.7","14.8"
"Richmond","2020-12-14","1016","112139","147","12676","15.1","14.9"
"Richmond","2020-12-15","1089","113228","151","12827","14.8","14.8"
"Richmond","2020-12-16","963","114191","121","12948","14.3","14.6"
"Richmond","2020-12-17","903","115094","148","13096","14.7","14.9"
"Richmond","2020-12-18","880","115974","102","13198","14.2","14.7"
"Richmond","2020-12-19","469","116443","88","13286","14.6","14.5"
"Richmond","2020-12-20","298","116741","67","13353","15.7","15.2"
"Richmond","2020-12-21","1085","117826","157","13510","15.7","15.4"
"Richmond","2020-12-22","1029","118855","135","13645","15.6","15.2"
"Richmond","2020-12-23","975","119830","128","13773","15.7","15"
"Richmond","2020-12-24","240","120070","44","13817","16","15.4"
"Richmond","2020-12-25","75","120145","15","13832","17.2","15.7"
"Richmond","2020-12-26","396","120541","84","13916","17.5","16.1"
"Richmond","2020-12-27","279","120820","59","13975","17.3","16.5"
"Richmond","2020-12-28","1182","122002","240","14215","18.2","17"
"Richmond","2020-12-29","1021","123023","237","14452","19.6","17.6"
"Richmond","2020-12-30","1123","124146","208","14660","20.4","18"
"Richmond","2020-12-31","653","124799","121","14781","20.4","18.2"
"Richmond","2021-01-01","125","124924","42","14823","22.4","19.8"
"Richmond","2021-01-02","379","125303","112","14935","23.6","20.5"
"Richmond","2021-01-03","180","125483","55","14990","24.9","21.1"
"Richmond","2021-01-04","472","125955","121","15111","25.7","21.9"
"Richmond","2021-01-05","1570","127525","376","15487","25.8","22.7"
"Richmond","2021-01-06","1044","128569","238","15725","26.4","23.4"
"Richmond","2021-01-07","955","129524","245","15970","27.4","23.9"
"Richmond","2021-01-08","1059","130583","243","16213","25.9","24.1"
"Richmond","2021-01-09","612","131195","176","16389","25.8","24.7"
"Richmond","2021-01-10","303","131498","71","16460","24.7","24.8"
"Richmond","2021-01-11","1186","132684","278","16738","24.4","25"
"Richmond","2021-01-12","1247","133931","306","17044","24.5","25.1"
"Richmond","2021-01-13","1369","135300","298","17342","24.4","25.4"
"Richmond","2021-01-14","917","136217","193","17535","23.7","25.5"
"Richmond","2021-01-15","892","137109","208","17743","23.8","24.8"
"Richmond","2021-01-16","480","137589","113","17856","23","24.4"
"Richmond","2021-01-17","267","137856","44","17900","22","23.4"
"Richmond","2021-01-18","839","138695","202","18102","22.1","23.3"
"Richmond","2021-01-19","826","139521","160","18262","21.4","22.9"
"Richmond","2021-01-20","847","140368","192","18454","21.5","22.9"
"Richmond","2021-01-21","784","141152","176","18630","21.7","22.7"
"Richmond","2021-01-22","714","141866","144","18774","21.3","22.5"
"Richmond","2021-01-23","415","142281","92","18866","21.1","22"
"Richmond","2021-01-24","251","142532","43","18909","21.1","21.6"
"Richmond","2021-01-25","852","143384","171","19080","20.6","21.3"
"Richmond","2021-01-26","700","144084","137","19217","20.6","21"
"Richmond","2021-01-27","815","144899","154","19371","20.1","20.8"
"Richmond","2021-01-28","762","145661","139","19510","19.5","20.6"
"Richmond","2021-01-29","759","146420","139","19649","19.2","20.2"
"Richmond","2021-01-30","418","146838","82","19731","18.8","19.9"
"Richmond","2021-01-31","208","147046","44","19775","19.4","20.3"
"Richmond","2021-02-01","819","147865","125","19900","18.7","19.6"
"Richmond","2021-02-02","759","148624","110","20010","18","19.3"
"Richmond","2021-02-03","742","149366","123","20133","17.7","18.9"
"Richmond","2021-02-04","659","150025","76","20209","16.7","18.1"
"Richmond","2021-02-05","596","150621","83","20292","16.1","17.6"
"Richmond","2021-02-06","269","150890","36","20328","15.2","17"
"Richmond","2021-02-07","9","150899","3","20331","16.9","18.2"
"Richmond","2021-02-08","0","150899","0","20331","14.7","16.7"
"Rockdale","2020-02-01","0","0","0","0",".","."
"Rockdale","2020-02-02","0","0","0","0",".","."
"Rockdale","2020-02-03","0","0","0","0",".","."
"Rockdale","2020-02-04","0","0","0","0",".","."
"Rockdale","2020-02-05","0","0","0","0",".","."
"Rockdale","2020-02-06","0","0","0","0",".","."
"Rockdale","2020-02-07","0","0","0","0","0","."
"Rockdale","2020-02-08","0","0","0","0","0","."
"Rockdale","2020-02-09","0","0","0","0","0","."
"Rockdale","2020-02-10","0","0","0","0","0","."
"Rockdale","2020-02-11","0","0","0","0","0","."
"Rockdale","2020-02-12","0","0","0","0","0","."
"Rockdale","2020-02-13","0","0","0","0","0","."
"Rockdale","2020-02-14","0","0","0","0","0","0"
"Rockdale","2020-02-15","0","0","0","0","0","0"
"Rockdale","2020-02-16","0","0","0","0","0","0"
"Rockdale","2020-02-17","0","0","0","0","0","0"
"Rockdale","2020-02-18","0","0","0","0","0","0"
"Rockdale","2020-02-19","0","0","0","0","0","0"
"Rockdale","2020-02-20","0","0","0","0","0","0"
"Rockdale","2020-02-21","0","0","0","0","0","0"
"Rockdale","2020-02-22","0","0","0","0","0","0"
"Rockdale","2020-02-23","0","0","0","0","0","0"
"Rockdale","2020-02-24","0","0","0","0","0","0"
"Rockdale","2020-02-25","0","0","0","0","0","0"
"Rockdale","2020-02-26","0","0","0","0","0","0"
"Rockdale","2020-02-27","0","0","0","0","0","0"
"Rockdale","2020-02-28","0","0","0","0","0","0"
"Rockdale","2020-02-29","0","0","0","0","0","0"
"Rockdale","2020-03-01","0","0","0","0","0","0"
"Rockdale","2020-03-02","0","0","0","0","0","0"
"Rockdale","2020-03-03","0","0","0","0","0","0"
"Rockdale","2020-03-04","0","0","0","0","0","0"
"Rockdale","2020-03-05","0","0","0","0","0","0"
"Rockdale","2020-03-06","0","0","0","0","0","0"
"Rockdale","2020-03-07","0","0","0","0","0","0"
"Rockdale","2020-03-08","0","0","0","0","0","0"
"Rockdale","2020-03-09","0","0","0","0","0","0"
"Rockdale","2020-03-10","0","0","0","0","0","0"
"Rockdale","2020-03-11","0","0","0","0","0","0"
"Rockdale","2020-03-12","3","3","0","0","0","0"
"Rockdale","2020-03-13","3","6","3","3","14.3","7.1"
"Rockdale","2020-03-14","3","9","0","3","14.3","7.1"
"Rockdale","2020-03-15","1","10","0","3","14.3","7.1"
"Rockdale","2020-03-16","9","19","1","4","15.9","7.9"
"Rockdale","2020-03-17","10","29","1","5","17.3","8.7"
"Rockdale","2020-03-18","9","38","1","6","18.9","9.4"
"Rockdale","2020-03-19","19","57","6","12","23.4","11.7"
"Rockdale","2020-03-20","13","70","1","13","10.2","12.2"
"Rockdale","2020-03-21","3","73","0","13","10.2","12.2"
"Rockdale","2020-03-22","6","79","1","14","12.6","13.4"
"Rockdale","2020-03-23","30","109","10","24","15.8","15.8"
"Rockdale","2020-03-24","26","135","6","30","17.6","17.5"
"Rockdale","2020-03-25","22","157","7","37","20.6","19.7"
"Rockdale","2020-03-26","20","177","7","44","21.1","22.2"
"Rockdale","2020-03-27","27","204","7","51","23.7","17"
"Rockdale","2020-03-28","4","208","4","55","38","24.1"
"Rockdale","2020-03-29","3","211","3","58","49.9","31.2"
"Rockdale","2020-03-30","20","231","8","66","50.8","33.3"
"Rockdale","2020-03-31","16","247","3","69","50.2","33.9"
"Rockdale","2020-04-01","24","271","6","75","49.2","34.9"
"Rockdale","2020-04-02","33","304","6","81","46.8","34"
"Rockdale","2020-04-03","35","339","2","83","43.9","33.8"
"Rockdale","2020-04-04","16","355","3","86","32.3","35.2"
"Rockdale","2020-04-05","10","365","1","87","19.5","34.7"
"Rockdale","2020-04-06","38","403","4","91","15.3","33.1"
"Rockdale","2020-04-07","36","439","2","93","13.4","31.8"
"Rockdale","2020-04-08","46","485","3","96","10.7","30"
"Rockdale","2020-04-09","43","528","7","103","10.5","28.7"
"Rockdale","2020-04-10","39","567","7","110","12.2","28.1"
"Rockdale","2020-04-11","25","592","0","110","9.5","20.9"
"Rockdale","2020-04-12","5","597","0","110","8.1","13.8"
"Rockdale","2020-04-13","30","627","4","114","8.5","11.9"
"Rockdale","2020-04-14","52","679","5","119","9.1","11.2"
"Rockdale","2020-04-15","55","734","7","126","10","10.4"
"Rockdale","2020-04-16","202","936","14","140","8.7","9.6"
"Rockdale","2020-04-17","184","1120","11","151","6.9","9.6"
"Rockdale","2020-04-18","98","1218","2","153","7.2","8.4"
"Rockdale","2020-04-19","19","1237","0","153","7.2","7.7"
"Rockdale","2020-04-20","60","1297","5","158","6.5","7.5"
"Rockdale","2020-04-21","80","1377","8","166","6.6","7.8"
"Rockdale","2020-04-22","89","1466","3","169","5.2","7.6"
"Rockdale","2020-04-23","132","1598","7","176","5","6.8"
"Rockdale","2020-04-24","117","1715","9","185","5.2","6.1"
"Rockdale","2020-04-25","27","1742","3","188","6.5","6.9"
"Rockdale","2020-04-26","21","1763","1","189","7.2","7.2"
"Rockdale","2020-04-27","173","1936","10","199","6.9","6.7"
"Rockdale","2020-04-28","92","2028","10","209","7","6.8"
"Rockdale","2020-04-29","79","2107","3","212","7","6.1"
"Rockdale","2020-04-30","61","2168","3","215","7","6"
"Rockdale","2020-05-01","644","2812","15","230","6.2","5.7"
"Rockdale","2020-05-02","28","2840","2","232","5.7","6.1"
"Rockdale","2020-05-03","27","2867","2","234","6","6.6"
"Rockdale","2020-05-04","121","2988","6","240","5.9","6.4"
"Rockdale","2020-05-05","110","3098","6","246","5.1","6.1"
"Rockdale","2020-05-06","77","3175","2","248","5","6"
"Rockdale","2020-05-07","96","3271","8","256","5.5","6.2"
"Rockdale","2020-05-08","104","3375","3","259","5.5","5.9"
"Rockdale","2020-05-09","10","3385","0","259","4.5","5.1"
"Rockdale","2020-05-10","20","3405","3","262","5.6","5.8"
"Rockdale","2020-05-11","150","3555","2","264","5.1","5.5"
"Rockdale","2020-05-12","156","3711","0","264","4.3","4.7"
"Rockdale","2020-05-13","127","3838","3","267","4.3","4.6"
"Rockdale","2020-05-14","121","3959","0","267","3.1","4.3"
"Rockdale","2020-05-15","117","4076","5","272","3.3","4.4"
"Rockdale","2020-05-16","30","4106","0","272","3.3","3.9"
"Rockdale","2020-05-17","22","4128","0","272","1.1","3.4"
"Rockdale","2020-05-18","171","4299","6","278","1.4","3.3"
"Rockdale","2020-05-19","115","4414","2","280","1.7","3"
"Rockdale","2020-05-20","116","4530","6","286","2.1","3.2"
"Rockdale","2020-05-21","52","4582","0","286","2.1","2.6"
"Rockdale","2020-05-22","84","4666","6","292","2.5","2.9"
"Rockdale","2020-05-23","31","4697","0","292","2.5","2.9"
"Rockdale","2020-05-24","25","4722","2","294","3.7","2.4"
"Rockdale","2020-05-25","13","4735","0","294","3.2","2.3"
"Rockdale","2020-05-26","148","4883","7","301","3.6","2.6"
"Rockdale","2020-05-27","141","5024","3","304","3.1","2.6"
"Rockdale","2020-05-28","114","5138","4","308","3.6","2.9"
"Rockdale","2020-05-29","84","5222","4","312","3.3","2.9"
"Rockdale","2020-05-30","33","5255","1","313","3.7","3.1"
"Rockdale","2020-05-31","13","5268","0","313","2.6","3.1"
"Rockdale","2020-06-01","100","5368","5","318","3.3","3.2"
"Rockdale","2020-06-02","127","5495","7","325","3.4","3.5"
"Rockdale","2020-06-03","111","5606","2","327","3.4","3.3"
"Rockdale","2020-06-04","106","5712","4","331","3.4","3.5"
"Rockdale","2020-06-05","88","5800","5","336","3.5","3.4"
"Rockdale","2020-06-06","44","5844","3","339","4.1","3.9"
"Rockdale","2020-06-07","30","5874","2","341","5","3.8"
"Rockdale","2020-06-08","163","6037","4","345","4.7","4"
"Rockdale","2020-06-09","142","6179","8","353","4.7","4.1"
"Rockdale","2020-06-10","117","6296","4","357","4.9","4.1"
"Rockdale","2020-06-11","148","6444","6","363","5","4.2"
"Rockdale","2020-06-12","95","6539","3","366","4.6","4.1"
"Rockdale","2020-06-13","31","6570","3","369","5","4.5"
"Rockdale","2020-06-14","31","6601","4","373","5.9","5.5"
"Rockdale","2020-06-15","137","6738","9","382","6.5","5.6"
"Rockdale","2020-06-16","158","6896","8","390","6.4","5.5"
"Rockdale","2020-06-17","125","7021","8","398","6.8","5.9"
"Rockdale","2020-06-18","112","7133","4","402","6.8","5.9"
"Rockdale","2020-06-19","117","7250","11","413","7.7","6.1"
"Rockdale","2020-06-20","43","7293","6","419","8.3","6.6"
"Rockdale","2020-06-21","24","7317","6","425","10","7.9"
"Rockdale","2020-06-22","213","7530","14","439","10","8.2"
"Rockdale","2020-06-23","159","7689","11","450","10.3","8.3"
"Rockdale","2020-06-24","188","7877","16","466","10.6","8.7"
"Rockdale","2020-06-25","201","8078","24","490","11.8","9.3"
"Rockdale","2020-06-26","179","8257","17","507","11.8","9.7"
"Rockdale","2020-06-27","48","8305","7","514","11.9","10.1"
"Rockdale","2020-06-28","21","8326","4","518","11","10.5"
"Rockdale","2020-06-29","237","8563","26","544","11.6","10.8"
"Rockdale","2020-06-30","241","8804","23","567","12","11.1"
"Rockdale","2020-07-01","210","9014","24","591","12.4","11.5"
"Rockdale","2020-07-02","228","9242","33","624","12.8","12.3"
"Rockdale","2020-07-03","69","9311","18","642","15.2","13.5"
"Rockdale","2020-07-04","32","9343","9","651","17.1","14.5"
"Rockdale","2020-07-05","44","9387","10","661","17.6","14.3"
"Rockdale","2020-07-06","285","9672","38","699","18","14.8"
"Rockdale","2020-07-07","330","10002","32","731","18","15"
"Rockdale","2020-07-08","252","10254","26","757","17.8","15.1"
"Rockdale","2020-07-09","252","10506","46","803","18.4","15.6"
"Rockdale","2020-07-10","242","10748","40","843","17","16.1"
"Rockdale","2020-07-11","85","10833","16","859","15.7","16.4"
"Rockdale","2020-07-12","38","10871","8","867","15.4","16.5"
"Rockdale","2020-07-13","137","11008","17","884","15.3","16.6"
"Rockdale","2020-07-14","121","11129","21","905","16.4","17.2"
"Rockdale","2020-07-15","119","11248","20","925","17.3","17.6"
"Rockdale","2020-07-16","253","11501","23","948","16","17.2"
"Rockdale","2020-07-17","114","11615","10","958","14.9","15.9"
"Rockdale","2020-07-18","65","11680","13","971","15.1","15.4"
"Rockdale","2020-07-19","104","11784","11","982","13.6","14.5"
"Rockdale","2020-07-20","146","11930","24","1006","14.1","14.7"
"Rockdale","2020-07-21","147","12077","18","1024","13.4","14.9"
"Rockdale","2020-07-22","128","12205","15","1039","12.7","15"
"Rockdale","2020-07-23","142","12347","13","1052","12.7","14.4"
"Rockdale","2020-07-24","242","12589","34","1086","13.5","14.2"
"Rockdale","2020-07-25","81","12670","12","1098","12.7","13.9"
"Rockdale","2020-07-26","33","12703","3","1101","12.5","13"
"Rockdale","2020-07-27","298","13001","47","1148","12.4","13.3"
"Rockdale","2020-07-28","215","13216","31","1179","12.7","13.1"
"Rockdale","2020-07-29","229","13445","28","1207","12.8","12.7"
"Rockdale","2020-07-30","226","13671","22","1229","12.9","12.8"
"Rockdale","2020-07-31","203","13874","15","1244","11.9","12.7"
"Rockdale","2020-08-01","70","13944","3","1247","10.4","11.6"
"Rockdale","2020-08-02","35","13979","5","1252","11.2","11.8"
"Rockdale","2020-08-03","249","14228","20","1272","10.1","11.2"
"Rockdale","2020-08-04","238","14466","21","1293","9.3","11"
"Rockdale","2020-08-05","262","14728","28","1321","9","10.9"
"Rockdale","2020-08-06","236","14964","23","1344","9","11"
"Rockdale","2020-08-07","224","15188","22","1366","9.4","10.7"
"Rockdale","2020-08-08","87","15275","6","1372","9.8","10.1"
"Rockdale","2020-08-09","57","15332","7","1379","9.5","10.3"
"Rockdale","2020-08-10","262","15594","22","1401","9.5","9.8"
"Rockdale","2020-08-11","191","15785","22","1423","9.9","9.6"
"Rockdale","2020-08-12","265","16050","15","1438","9.2","9.1"
"Rockdale","2020-08-13","197","16247","11","1449","8.6","8.8"
"Rockdale","2020-08-14","253","16500","17","1466","8.2","8.8"
"Rockdale","2020-08-15","107","16607","11","1477","8.6","9.2"
"Rockdale","2020-08-16","49","16656","8","1485","9.2","9.3"
"Rockdale","2020-08-17","232","16888","21","1506","9.3","9.4"
"Rockdale","2020-08-18","177","17065","18","1524","9.1","9.5"
"Rockdale","2020-08-19","255","17320","22","1546","9.5","9.4"
"Rockdale","2020-08-20","168","17488","14","1560","9.9","9.3"
"Rockdale","2020-08-21","203","17691","9","1569","9.6","8.9"
"Rockdale","2020-08-22","63","17754","6","1575","9.5","9.1"
"Rockdale","2020-08-23","41","17795","3","1578","8.2","8.7"
"Rockdale","2020-08-24","171","17966","13","1591","8","8.7"
"Rockdale","2020-08-25","153","18119","8","1599","7.3","8.2"
"Rockdale","2020-08-26","146","18265","11","1610","7.1","8.3"
"Rockdale","2020-08-27","178","18443","11","1621","6.8","8.4"
"Rockdale","2020-08-28","210","18653","11","1632","6.9","8.3"
"Rockdale","2020-08-29","101","18754","12","1644","7.3","8.4"
"Rockdale","2020-08-30","46","18800","4","1648","7.5","7.8"
"Rockdale","2020-08-31","179","18979","11","1659","7.3","7.6"
"Rockdale","2020-09-01","103","19082","3","1662","6.9","7.1"
"Rockdale","2020-09-02","152","19234","5","1667","6.3","6.7"
"Rockdale","2020-09-03","129","19363","12","1679","6.8","6.8"
"Rockdale","2020-09-04","187","19550","8","1687","6.6","6.8"
"Rockdale","2020-09-05","47","19597","2","1689","5.6","6.4"
"Rockdale","2020-09-06","42","19639","3","1692","5.3","6.4"
"Rockdale","2020-09-07","34","19673","2","1694","5.3","6.3"
"Rockdale","2020-09-08","137","19810","11","1705","6","6.5"
"Rockdale","2020-09-09","169","19979","10","1715","6.4","6.4"
"Rockdale","2020-09-10","198","20177","8","1723","5.6","6.2"
"Rockdale","2020-09-11","168","20345","4","1727","5.4","6"
"Rockdale","2020-09-12","45","20390","3","1730","5.7","5.6"
"Rockdale","2020-09-13","22","20412","4","1734","7.3","6.3"
"Rockdale","2020-09-14","151","20563","7","1741","7.1","6.2"
"Rockdale","2020-09-15","141","20704","12","1753","7.2","6.6"
"Rockdale","2020-09-16","172","20876","15","1768","7.6","7"
"Rockdale","2020-09-17","115","20991","5","1773","7.6","6.6"
"Rockdale","2020-09-18","109","21100","4","1777","7.8","6.6"
"Rockdale","2020-09-19","83","21183","4","1781","7.6","6.6"
"Rockdale","2020-09-20","34","21217","3","1784","6.2","6.8"
"Rockdale","2020-09-21","144","21361","10","1794","6.5","6.8"
"Rockdale","2020-09-22","143","21504","3","1797","5.6","6.4"
"Rockdale","2020-09-23","183","21687","7","1804","4.9","6.3"
"Rockdale","2020-09-24","118","21805","5","1809","4.9","6.3"
"Rockdale","2020-09-25","166","21971","8","1817","5.1","6.5"
"Rockdale","2020-09-26","56","22027","2","1819","4.9","6.2"
"Rockdale","2020-09-27","36","22063","4","1823","5.2","5.7"
"Rockdale","2020-09-28","128","22191","2","1825","4.5","5.5"
"Rockdale","2020-09-29","149","22340","5","1830","4.6","5.1"
"Rockdale","2020-09-30","140","22480","8","1838","4.9","4.9"
"Rockdale","2020-10-01","135","22615","6","1844","4.9","4.9"
"Rockdale","2020-10-02","132","22747","2","1846","4.5","4.8"
"Rockdale","2020-10-03","77","22824","3","1849","4.5","4.7"
"Rockdale","2020-10-04","33","22857","1","1850","3.4","4.3"
"Rockdale","2020-10-05","145","23002","7","1857","3.8","4.1"
"Rockdale","2020-10-06","166","23168","10","1867","4.2","4.4"
"Rockdale","2020-10-07","202","23370","12","1879","4.2","4.6"
"Rockdale","2020-10-08","156","23526","14","1893","4.9","4.9"
"Rockdale","2020-10-09","198","23724","17","1910","5.9","5.2"
"Rockdale","2020-10-10","50","23774","6","1916","7.1","5.8"
"Rockdale","2020-10-11","37","23811","15","1931","12.4","7.9"
"Rockdale","2020-10-12","112","23923","6","1937","12.5","8.2"
"Rockdale","2020-10-13","139","24062","9","1946","12.6","8.4"
"Rockdale","2020-10-14","149","24211","11","1957","12.8","8.5"
"Rockdale","2020-10-15","162","24373","9","1966","12.3","8.6"
"Rockdale","2020-10-16","123","24496","10","1976","12.2","9.1"
"Rockdale","2020-10-17","70","24566","5","1981","11.5","9.3"
"Rockdale","2020-10-18","24","24590","4","1985","8.1","10.3"
"Rockdale","2020-10-19","228","24818","17","2002","8.4","10.4"
"Rockdale","2020-10-20","144","24962","14","2016","8.9","10.7"
"Rockdale","2020-10-21","181","25143","27","2043","9.9","11.4"
"Rockdale","2020-10-22","252","25395","19","2062","10.2","11.2"
"Rockdale","2020-10-23","175","25570","5","2067","9.5","10.8"
"Rockdale","2020-10-24","43","25613","4","2071","9.8","10.6"
"Rockdale","2020-10-25","51","25664","5","2076","8.8","8.5"
"Rockdale","2020-10-26","186","25850","18","2094","9.1","8.8"
"Rockdale","2020-10-27","141","25991","16","2110","9.3","9.1"
"Rockdale","2020-10-28","168","26159","9","2119","8","9"
"Rockdale","2020-10-29","130","26289","21","2140","9.2","9.7"
"Rockdale","2020-10-30","207","26496","27","2167","10.7","10.1"
"Rockdale","2020-10-31","67","26563","7","2174","10.8","10.3"
"Rockdale","2020-11-01","55","26618","5","2179","10.7","9.8"
"Rockdale","2020-11-02","216","26834","18","2197","10.5","9.8"
"Rockdale","2020-11-03","143","26977","11","2208","10","9.7"
"Rockdale","2020-11-04","208","27185","19","2227","10.6","9.3"
"Rockdale","2020-11-05","204","27389","11","2238","9","9.1"
"Rockdale","2020-11-06","171","27560","13","2251","8.2","9.5"
"Rockdale","2020-11-07","66","27626","6","2257","8","9.4"
"Rockdale","2020-11-08","50","27676","9","2266","9.3","10"
"Rockdale","2020-11-09","199","27875","19","2285","9.5","10"
"Rockdale","2020-11-10","203","28078","26","2311","10.2","10.1"
"Rockdale","2020-11-11","139","28217","11","2322","10.1","10.3"
"Rockdale","2020-11-12","183","28400","14","2336","10.4","9.7"
"Rockdale","2020-11-13","219","28619","16","2352","10.3","9.3"
"Rockdale","2020-11-14","97","28716","7","2359","10.1","9.1"
"Rockdale","2020-11-15","56","28772","14","2373","11.1","10.2"
"Rockdale","2020-11-16","262","29034","20","2393","10.8","10.1"
"Rockdale","2020-11-17","238","29272","20","2413","10.2","10.2"
"Rockdale","2020-11-18","230","29502","23","2436","10.5","10.3"
"Rockdale","2020-11-19","239","29741","19","2455","10.5","10.4"
"Rockdale","2020-11-20","283","30024","15","2470","10.2","10.3"
"Rockdale","2020-11-21","82","30106","9","2479","10.8","10.4"
"Rockdale","2020-11-22","75","30181","7","2486","8.5","9.8"
"Rockdale","2020-11-23","286","30467","28","2514","8.8","9.8"
"Rockdale","2020-11-24","227","30694","24","2538","9.1","9.6"
"Rockdale","2020-11-25","262","30956","26","2564","9.1","9.8"
"Rockdale","2020-11-26","52","31008","7","2571","9.9","10.2"
"Rockdale","2020-11-27","153","31161","24","2595","11.4","10.8"
"Rockdale","2020-11-28","139","31300","20","2615","11.9","11.3"
"Rockdale","2020-11-29","124","31424","11","2626","11.8","10.2"
"Rockdale","2020-11-30","322","31746","39","2665","12.1","10.5"
"Rockdale","2020-12-01","288","32034","38","2703","12.5","10.8"
"Rockdale","2020-12-02","321","32355","42","2745","13","11"
"Rockdale","2020-12-03","333","32688","54","2799","13.4","11.6"
"Rockdale","2020-12-04","292","32980","44","2843","13.3","12.3"
"Rockdale","2020-12-05","206","33186","14","2857","12.2","12"
"Rockdale","2020-12-06","108","33294","18","2875","13.3","12.6"
"Rockdale","2020-12-07","352","33646","47","2922","13.5","12.8"
"Rockdale","2020-12-08","336","33982","59","2981","14.1","13.3"
"Rockdale","2020-12-09","366","34348","73","3054","15.1","14"
"Rockdale","2020-12-10","303","34651","44","3098","14.8","14.1"
"Rockdale","2020-12-11","303","34954","41","3139","14.6","14"
"Rockdale","2020-12-12","183","35137","30","3169","16","14.1"
"Rockdale","2020-12-13","104","35241","18","3187","16.1","14.7"
"Rockdale","2020-12-14","375","35616","47","3234","16","14.7"
"Rockdale","2020-12-15","398","36014","56","3290","15.5","14.8"
"Rockdale","2020-12-16","343","36357","36","3326","14.1","14.6"
"Rockdale","2020-12-17","392","36749","53","3379","14","14.4"
"Rockdale","2020-12-18","355","37104","44","3423","13.8","14.2"
"Rockdale","2020-12-19","158","37262","31","3454","14.3","15.1"
"Rockdale","2020-12-20","84","37346","13","3467","14","15.1"
"Rockdale","2020-12-21","340","37686","40","3507","13.9","14.9"
"Rockdale","2020-12-22","402","38088","64","3571","14.2","14.8"
"Rockdale","2020-12-23","289","38377","64","3635","15.8","15"
"Rockdale","2020-12-24","194","38571","36","3671","16.6","15.3"
"Rockdale","2020-12-25","32","38603","11","3682","19.7","16.8"
"Rockdale","2020-12-26","146","38749","34","3716","20.2","17.2"
"Rockdale","2020-12-27","79","38828","19","3735","21.4","17.7"
"Rockdale","2020-12-28","354","39182","51","3786","21.8","17.9"
"Rockdale","2020-12-29","377","39559","62","3848","21.9","18"
"Rockdale","2020-12-30","408","39967","105","3953","22.4","19.1"
"Rockdale","2020-12-31","311","40278","65","4018","22.7","19.6"
"Rockdale","2021-01-01","48","40326","15","4033","22.3","21"
"Rockdale","2021-01-02","138","40464","24","4057","21.5","20.8"
"Rockdale","2021-01-03","92","40556","27","4084","22.2","21.8"
"Rockdale","2021-01-04","318","40874","59","4143","22.8","22.3"
"Rockdale","2021-01-05","421","41295","95","4238","23.7","22.8"
"Rockdale","2021-01-06","378","41673","80","4318","23","22.7"
"Rockdale","2021-01-07","452","42125","96","4414","23.1","22.9"
"Rockdale","2021-01-08","300","42425","46","4460","20.8","21.5"
"Rockdale","2021-01-09","208","42633","44","4504","21.3","21.4"
"Rockdale","2021-01-10","103","42736","23","4527","20.3","21.3"
"Rockdale","2021-01-11","431","43167","58","4585","19.6","21.2"
"Rockdale","2021-01-12","338","43505","61","4646","19","21.3"
"Rockdale","2021-01-13","342","43847","75","4721","19.1","21"
"Rockdale","2021-01-14","338","44185","47","4768","18","20.5"
"Rockdale","2021-01-15","467","44652","77","4845","18.2","19.5"
"Rockdale","2021-01-16","147","44799","20","4865","17.1","19.2"
"Rockdale","2021-01-17","91","44890","24","4889","17.7","19"
"Rockdale","2021-01-18","210","45100","30","4919","17.8","18.7"
"Rockdale","2021-01-19","326","45426","52","4971","17.5","18.2"
"Rockdale","2021-01-20","312","45738","40","5011","16.2","17.6"
"Rockdale","2021-01-21","261","45999","35","5046","16.1","17.1"
"Rockdale","2021-01-22","320","46319","29","5075","15.1","16.6"
"Rockdale","2021-01-23","120","46439","29","5104","16.6","16.8"
"Rockdale","2021-01-24","75","46514","15","5119","15.7","16.7"
"Rockdale","2021-01-25","291","46805","35","5154","15.3","16.6"
"Rockdale","2021-01-26","329","47134","36","5190","14.6","16.1"
"Rockdale","2021-01-27","250","47384","33","5223","14.7","15.4"
"Rockdale","2021-01-28","285","47669","30","5253","14.3","15.2"
"Rockdale","2021-01-29","247","47916","25","5278","14.4","14.7"
"Rockdale","2021-01-30","126","48042","17","5295","12.9","14.7"
"Rockdale","2021-01-31","83","48125","13","5308","12.3","14"
"Rockdale","2021-02-01","236","48361","22","5330","11.9","13.6"
"Rockdale","2021-02-02","244","48605","25","5355","11.8","13.2"
"Rockdale","2021-02-03","242","48847","28","5383","11.6","13.1"
"Rockdale","2021-02-04","281","49128","25","5408","11.3","12.8"
"Rockdale","2021-02-05","157","49285","15","5423","11.2","12.8"
"Rockdale","2021-02-06","45","49330","6","5429","11.2","12.1"
"Rockdale","2021-02-07","10","49340","4","5433","14.7","13.5"
"Rockdale","2021-02-08","0","49340","0","5433","13.4","12.6"
"Schley","2020-02-01","0","0","0","0",".","."
"Schley","2020-02-02","0","0","0","0",".","."
"Schley","2020-02-03","0","0","0","0",".","."
"Schley","2020-02-04","0","0","0","0",".","."
"Schley","2020-02-05","0","0","0","0",".","."
"Schley","2020-02-06","0","0","0","0",".","."
"Schley","2020-02-07","0","0","0","0","0","."
"Schley","2020-02-08","0","0","0","0","0","."
"Schley","2020-02-09","0","0","0","0","0","."
"Schley","2020-02-10","0","0","0","0","0","."
"Schley","2020-02-11","0","0","0","0","0","."
"Schley","2020-02-12","0","0","0","0","0","."
"Schley","2020-02-13","0","0","0","0","0","."
"Schley","2020-02-14","0","0","0","0","0","0"
"Schley","2020-02-15","0","0","0","0","0","0"
"Schley","2020-02-16","0","0","0","0","0","0"
"Schley","2020-02-17","0","0","0","0","0","0"
"Schley","2020-02-18","0","0","0","0","0","0"
"Schley","2020-02-19","0","0","0","0","0","0"
"Schley","2020-02-20","0","0","0","0","0","0"
"Schley","2020-02-21","0","0","0","0","0","0"
"Schley","2020-02-22","0","0","0","0","0","0"
"Schley","2020-02-23","0","0","0","0","0","0"
"Schley","2020-02-24","0","0","0","0","0","0"
"Schley","2020-02-25","0","0","0","0","0","0"
"Schley","2020-02-26","0","0","0","0","0","0"
"Schley","2020-02-27","0","0","0","0","0","0"
"Schley","2020-02-28","0","0","0","0","0","0"
"Schley","2020-02-29","0","0","0","0","0","0"
"Schley","2020-03-01","0","0","0","0","0","0"
"Schley","2020-03-02","0","0","0","0","0","0"
"Schley","2020-03-03","0","0","0","0","0","0"
"Schley","2020-03-04","0","0","0","0","0","0"
"Schley","2020-03-05","0","0","0","0","0","0"
"Schley","2020-03-06","0","0","0","0","0","0"
"Schley","2020-03-07","0","0","0","0","0","0"
"Schley","2020-03-08","0","0","0","0","0","0"
"Schley","2020-03-09","0","0","0","0","0","0"
"Schley","2020-03-10","0","0","0","0","0","0"
"Schley","2020-03-11","0","0","0","0","0","0"
"Schley","2020-03-12","0","0","0","0","0","0"
"Schley","2020-03-13","1","1","0","0","0","0"
"Schley","2020-03-14","0","1","0","0","0","0"
"Schley","2020-03-15","0","1","0","0","0","0"
"Schley","2020-03-16","1","2","0","0","0","0"
"Schley","2020-03-17","1","3","0","0","0","0"
"Schley","2020-03-18","0","3","0","0","0","0"
"Schley","2020-03-19","8","11","1","1","1.8","0.9"
"Schley","2020-03-20","1","12","0","1","1.8","0.9"
"Schley","2020-03-21","0","12","0","1","1.8","0.9"
"Schley","2020-03-22","2","14","2","3","16.1","8"
"Schley","2020-03-23","2","16","0","3","16.1","8"
"Schley","2020-03-24","2","18","1","4","23.2","11.6"
"Schley","2020-03-25","3","21","0","4","23.2","11.6"
"Schley","2020-03-26","1","22","0","4","21.4","11.6"
"Schley","2020-03-27","5","27","1","5","24.3","13"
"Schley","2020-03-28","3","30","1","6","29","15.4"
"Schley","2020-03-29","1","31","1","7","29","22.6"
"Schley","2020-03-30","5","36","0","7","29","22.6"
"Schley","2020-03-31","1","37","0","7","21.9","22.6"
"Schley","2020-04-01","7","44","3","10","28","25.6"
"Schley","2020-04-02","6","50","0","10","28","24.7"
"Schley","2020-04-03","4","54","2","12","32.3","28.3"
"Schley","2020-04-04","1","55","1","13","41.8","35.4"
"Schley","2020-04-05","2","57","0","13","27.6","28.3"
"Schley","2020-04-06","7","64","0","13","27.6","28.3"
"Schley","2020-04-07","9","73","1","14","29.1","25.5"
"Schley","2020-04-08","4","77","1","15","26.6","27.3"
"Schley","2020-04-09","4","81","0","15","26.6","27.3"
"Schley","2020-04-10","1","82","0","15","19.4","25.9"
"Schley","2020-04-11","0","82","0","15","5.2","23.5"
"Schley","2020-04-12","0","82","0","15","5.2","16.4"
"Schley","2020-04-13","5","87","1","16","8","17.8"
"Schley","2020-04-14","6","93","1","17","8.8","19"
"Schley","2020-04-15","3","96","0","17","5.2","15.9"
"Schley","2020-04-16","11","107","2","19","7.8","17.2"
"Schley","2020-04-17","3","110","0","19","7.8","13.6"
"Schley","2020-04-18","3","113","0","19","7.8","6.5"
"Schley","2020-04-19","2","115","0","19","7.8","6.5"
"Schley","2020-04-20","4","119","0","19","5","6.5"
"Schley","2020-04-21","7","126","0","19","2.6","5.7"
"Schley","2020-04-22","9","135","0","19","2.6","3.9"
"Schley","2020-04-23","0","135","0","19","0","3.9"
"Schley","2020-04-24","5","140","0","19","0","3.9"
"Schley","2020-04-25","3","143","1","20","4.8","6.3"
"Schley","2020-04-26","2","145","0","20","4.8","6.3"
"Schley","2020-04-27","5","150","0","20","4.8","4.9"
"Schley","2020-04-28","7","157","0","20","4.8","3.7"
"Schley","2020-04-29","7","164","0","20","4.8","3.7"
"Schley","2020-04-30","5","169","0","20","4.8","2.4"
"Schley","2020-05-01","3","172","0","20","4.8","2.4"
"Schley","2020-05-02","3","175","0","20","0","2.4"
"Schley","2020-05-03","0","175","0","20","0","2.4"
"Schley","2020-05-04","8","183","1","21","1.8","3.3"
"Schley","2020-05-05","6","189","0","21","1.8","3.3"
"Schley","2020-05-06","8","197","0","21","1.8","3.3"
"Schley","2020-05-07","3","200","0","21","1.8","3.3"
"Schley","2020-05-08","2","202","0","21","1.8","3.3"
"Schley","2020-05-09","0","202","0","21","1.8","0.9"
"Schley","2020-05-10","2","204","0","21","1.8","0.9"
"Schley","2020-05-11","8","212","2","23","3.6","2.7"
"Schley","2020-05-12","2","214","0","23","3.6","2.7"
"Schley","2020-05-13","3","217","0","23","3.6","2.7"
"Schley","2020-05-14","5","222","0","23","3.6","2.7"
"Schley","2020-05-15","2","224","0","23","3.6","2.7"
"Schley","2020-05-16","1","225","0","23","3.6","2.7"
"Schley","2020-05-17","1","226","0","23","3.6","2.7"
"Schley","2020-05-18","6","232","0","23","0","1.8"
"Schley","2020-05-19","10","242","0","23","0","1.8"
"Schley","2020-05-20","7","249","0","23","0","1.8"
"Schley","2020-05-21","9","258","0","23","0","1.8"
"Schley","2020-05-22","4","262","0","23","0","1.8"
"Schley","2020-05-23","3","265","0","23","0","1.8"
"Schley","2020-05-24","0","265","0","23","0","1.8"
"Schley","2020-05-25","2","267","0","23","0","0"
"Schley","2020-05-26","2","269","0","23","0","0"
"Schley","2020-05-27","3","272","0","23","0","0"
"Schley","2020-05-28","6","278","0","23","0","0"
"Schley","2020-05-29","9","287","0","23","0","0"
"Schley","2020-05-30","2","289","0","23","0","0"
"Schley","2020-05-31","4","293","0","23","0","0"
"Schley","2020-06-01","5","298","1","24","2.9","1.4"
"Schley","2020-06-02","9","307","1","25","4.4","2.2"
"Schley","2020-06-03","6","313","0","25","4.4","2.2"
"Schley","2020-06-04","16","329","0","25","4.4","2.2"
"Schley","2020-06-05","7","336","0","25","4.4","2.2"
"Schley","2020-06-06","2","338","0","25","4.4","2.2"
"Schley","2020-06-07","3","341","0","25","4.4","2.2"
"Schley","2020-06-08","7","348","0","25","1.6","2.2"
"Schley","2020-06-09","4","352","0","25","0","2.2"
"Schley","2020-06-10","12","364","1","26","1.2","2.8"
"Schley","2020-06-11","4","368","0","26","1.2","2.8"
"Schley","2020-06-12","4","372","0","26","1.2","2.8"
"Schley","2020-06-13","3","375","1","27","6","5.2"
"Schley","2020-06-14","0","375","0","27","6","5.2"
"Schley","2020-06-15","26","401","1","28","6.5","4"
"Schley","2020-06-16","9","410","0","28","6.5","3.3"
"Schley","2020-06-17","6","416","0","28","5.3","3.3"
"Schley","2020-06-18","15","431","0","28","5.3","3.3"
"Schley","2020-06-19","6","437","0","28","5.3","3.3"
"Schley","2020-06-20","2","439","0","28","0.5","3.3"
"Schley","2020-06-21","2","441","0","28","0.5","3.3"
"Schley","2020-06-22","10","451","0","28","0","3.3"
"Schley","2020-06-23","20","471","0","28","0","3.3"
"Schley","2020-06-24","16","487","1","29","0.9","3.1"
"Schley","2020-06-25","12","499","0","29","0.9","3.1"
"Schley","2020-06-26","13","512","2","31","3.1","4.2"
"Schley","2020-06-27","4","516","0","31","3.1","1.8"
"Schley","2020-06-28","1","517","0","31","3.1","1.8"
"Schley","2020-06-29","6","523","0","31","3.1","1.5"
"Schley","2020-06-30","6","529","0","31","3.1","1.5"
"Schley","2020-07-01","7","536","0","31","2.2","1.5"
"Schley","2020-07-02","3","539","0","31","2.2","1.5"
"Schley","2020-07-03","1","540","1","32","14.3","8.7"
"Schley","2020-07-04","1","541","0","32","14.3","8.7"
"Schley","2020-07-05","3","544","0","32","14.3","8.7"
"Schley","2020-07-06","21","565","6","38","18.4","10.7"
"Schley","2020-07-07","8","573","0","38","18.4","10.7"
"Schley","2020-07-08","17","590","0","38","18.4","10.3"
"Schley","2020-07-09","7","597","1","39","20.4","11.3"
"Schley","2020-07-10","9","606","1","40","7.7","11"
"Schley","2020-07-11","0","606","0","40","7.7","11"
"Schley","2020-07-12","2","608","0","40","7.7","11"
"Schley","2020-07-13","21","629","3","43","5.7","12"
"Schley","2020-07-14","23","652","3","46","7.5","12.9"
"Schley","2020-07-15","3","655","0","46","7.5","12.9"
"Schley","2020-07-16","6","661","0","46","5.5","12.9"
"Schley","2020-07-17","5","666","0","46","3.9","5.8"
"Schley","2020-07-18","5","671","1","47","6.8","7.2"
"Schley","2020-07-19","2","673","0","47","6.8","7.2"
"Schley","2020-07-20","31","704","8","55","8.4","7"
"Schley","2020-07-21","1","705","0","55","6.5","7"
"Schley","2020-07-22","3","708","1","56","11.3","9.4"
"Schley","2020-07-23","8","716","0","56","11.3","8.4"
"Schley","2020-07-24","9","725","1","57","12.9","8.4"
"Schley","2020-07-25","3","728","0","57","10","8.4"
"Schley","2020-07-26","3","731","2","59","19.6","13.2"
"Schley","2020-07-27","30","761","1","60","16.3","12.4"
"Schley","2020-07-28","24","785","1","61","16.9","11.7"
"Schley","2020-07-29","5","790","3","64","20.8","16"
"Schley","2020-07-30","6","796","2","66","25.5","18.4"
"Schley","2020-07-31","6","802","2","68","28.7","20.8"
"Schley","2020-08-01","1","803","0","68","28.7","19.4"
"Schley","2020-08-02","2","805","1","69","26.3","22.9"
"Schley","2020-08-03","23","828","1","70","26.5","21.4"
"Schley","2020-08-04","23","851","6","76","29.6","23.3"
"Schley","2020-08-05","3","854","0","76","21","20.9"
"Schley","2020-08-06","10","864","0","76","16.3","20.9"
"Schley","2020-08-07","10","874","0","76","11.5","20.1"
"Schley","2020-08-08","2","876","1","77","18.6","23.7"
"Schley","2020-08-09","3","879","0","77","11.5","18.9"
"Schley","2020-08-10","38","917","4","81","12.4","19.4"
"Schley","2020-08-11","38","955","3","84","9.8","19.7"
"Schley","2020-08-12","5","960","0","84","9.8","15.4"
"Schley","2020-08-13","6","966","0","84","9.8","13"
"Schley","2020-08-14","9","975","1","85","11.4","11.4"
"Schley","2020-08-15","1","976","0","85","4.2","11.4"
"Schley","2020-08-16","6","982","2","87","9","10.2"
"Schley","2020-08-17","9","991","3","90","12.2","12.3"
"Schley","2020-08-18","14","1005","0","90","11.1","10.4"
"Schley","2020-08-19","1","1006","0","90","11.1","10.4"
"Schley","2020-08-20","4","1010","0","90","11.1","10.4"
"Schley","2020-08-21","4","1014","1","91","13.1","12.2"
"Schley","2020-08-22","2","1016","0","91","13.1","8.7"
"Schley","2020-08-23","4","1020","0","91","8.3","8.7"
"Schley","2020-08-24","18","1038","2","93","5.2","8.7"
"Schley","2020-08-25","14","1052","1","94","6.2","8.6"
"Schley","2020-08-26","6","1058","0","94","6.2","8.6"
"Schley","2020-08-27","7","1065","2","96","10.3","10.7"
"Schley","2020-08-28","4","1069","0","96","6.7","9.9"
"Schley","2020-08-29","1","1070","0","96","6.7","9.9"
"Schley","2020-08-30","2","1072","0","96","6.7","7.5"
"Schley","2020-08-31","10","1082","2","98","8","6.6"
"Schley","2020-09-01","7","1089","0","98","6.9","6.6"
"Schley","2020-09-02","2","1091","0","98","6.9","6.6"
"Schley","2020-09-03","2","1093","0","98","2.9","6.6"
"Schley","2020-09-04","7","1100","0","98","2.9","4.8"
"Schley","2020-09-05","6","1106","0","98","2.9","4.8"
"Schley","2020-09-06","3","1109","1","99","7.6","7.2"
"Schley","2020-09-07","1","1110","0","99","4.8","6.4"
"Schley","2020-09-08","8","1118","0","99","4.8","5.9"
"Schley","2020-09-09","1","1119","0","99","4.8","5.9"
"Schley","2020-09-10","6","1125","1","100","7.1","5"
"Schley","2020-09-11","7","1132","1","101","9.2","6"
"Schley","2020-09-12","7","1139","0","101","9.2","6"
"Schley","2020-09-13","2","1141","0","101","4.4","6"
"Schley","2020-09-14","11","1152","0","101","4.4","4.6"
"Schley","2020-09-15","8","1160","1","102","6.2","5.5"
"Schley","2020-09-16","7","1167","0","102","6.2","5.5"
"Schley","2020-09-17","4","1171","0","102","3.8","5.5"
"Schley","2020-09-18","8","1179","1","103","3.6","6.4"
"Schley","2020-09-19","1","1180","0","103","3.6","6.4"
"Schley","2020-09-20","0","1180","0","103","3.6","4"
"Schley","2020-09-21","6","1186","0","103","3.6","4"
"Schley","2020-09-22","4","1190","0","103","1.8","4"
"Schley","2020-09-23","4","1194","0","103","1.8","4"
"Schley","2020-09-24","3","1197","0","103","1.8","2.8"
"Schley","2020-09-25","5","1202","0","103","0","1.8"
"Schley","2020-09-26","4","1206","1","104","3.6","3.6"
"Schley","2020-09-27","0","1206","0","104","3.6","3.6"
"Schley","2020-09-28","8","1214","0","104","3.6","3.6"
"Schley","2020-09-29","4","1218","1","105","7.1","4.5"
"Schley","2020-09-30","6","1224","0","105","7.1","4.5"
"Schley","2020-10-01","5","1229","0","105","7.1","4.5"
"Schley","2020-10-02","3","1232","0","105","7.1","3.6"
"Schley","2020-10-03","1","1233","0","105","3.6","3.6"
"Schley","2020-10-04","2","1235","0","105","3.6","3.6"
"Schley","2020-10-05","11","1246","0","105","3.6","3.6"
"Schley","2020-10-06","5","1251","0","105","0","3.6"
"Schley","2020-10-07","10","1261","1","106","1.4","4.3"
"Schley","2020-10-08","4","1265","0","106","1.4","4.3"
"Schley","2020-10-09","7","1272","1","107","3.5","5.3"
"Schley","2020-10-10","3","1275","1","108","8.2","5.9"
"Schley","2020-10-11","0","1275","0","108","8.2","5.9"
"Schley","2020-10-12","7","1282","0","108","8.2","5.9"
"Schley","2020-10-13","2","1284","0","108","8.2","4.1"
"Schley","2020-10-14","10","1294","1","109","8.2","4.8"
"Schley","2020-10-15","8","1302","0","109","8.2","4.8"
"Schley","2020-10-16","10","1312","0","109","6.2","4.8"
"Schley","2020-10-17","2","1314","0","109","1.4","4.8"
"Schley","2020-10-18","1","1315","0","109","1.4","4.8"
"Schley","2020-10-19","4","1319","0","109","1.4","4.8"
"Schley","2020-10-20","9","1328","0","109","1.4","4.8"
"Schley","2020-10-21","2","1330","0","109","0","4.1"
"Schley","2020-10-22","4","1334","0","109","0","4.1"
"Schley","2020-10-23","5","1339","0","109","0","3.1"
"Schley","2020-10-24","6","1345","0","109","0","0.7"
"Schley","2020-10-25","2","1347","0","109","0","0.7"
"Schley","2020-10-26","6","1353","0","109","0","0.7"
"Schley","2020-10-27","8","1361","1","110","1.8","1.6"
"Schley","2020-10-28","4","1365","0","110","1.8","0.9"
"Schley","2020-10-29","3","1368","0","110","1.8","0.9"
"Schley","2020-10-30","2","1370","0","110","1.8","0.9"
"Schley","2020-10-31","7","1377","0","110","1.8","0.9"
"Schley","2020-11-01","1","1378","0","110","1.8","0.9"
"Schley","2020-11-02","8","1386","0","110","1.8","0.9"
"Schley","2020-11-03","3","1389","0","110","0","0.9"
"Schley","2020-11-04","4","1393","2","112","7.1","4.5"
"Schley","2020-11-05","6","1399","1","113","9.5","5.7"
"Schley","2020-11-06","5","1404","0","113","9.5","5.7"
"Schley","2020-11-07","1","1405","0","113","9.5","5.7"
"Schley","2020-11-08","7","1412","1","114","11.6","6.7"
"Schley","2020-11-09","7","1419","0","114","11.6","6.7"
"Schley","2020-11-10","12","1431","0","114","11.6","5.8"
"Schley","2020-11-11","5","1436","0","114","4.4","5.8"
"Schley","2020-11-12","10","1446","0","114","2","5.8"
"Schley","2020-11-13","10","1456","0","114","2","5.8"
"Schley","2020-11-14","3","1459","0","114","2","5.8"
"Schley","2020-11-15","5","1464","0","114","0","5.8"
"Schley","2020-11-16","6","1470","1","115","2.4","7"
"Schley","2020-11-17","8","1478","1","116","4.2","7.9"
"Schley","2020-11-18","7","1485","0","116","4.2","4.3"
"Schley","2020-11-19","11","1496","1","117","5.5","3.8"
"Schley","2020-11-20","9","1505","1","118","7.1","4.5"
"Schley","2020-11-21","5","1510","0","118","7.1","4.5"
"Schley","2020-11-22","3","1513","0","118","7.1","3.5"
"Schley","2020-11-23","3","1516","0","118","4.7","3.5"
"Schley","2020-11-24","6","1522","1","119","5.3","4.7"
"Schley","2020-11-25","7","1529","1","120","7.3","5.7"
"Schley","2020-11-26","4","1533","0","120","6","5.7"
"Schley","2020-11-27","1","1534","0","120","4.4","5.7"
"Schley","2020-11-28","1","1535","0","120","4.4","5.7"
"Schley","2020-11-29","4","1539","2","122","11.6","9.3"
"Schley","2020-11-30","23","1562","4","126","14","9.4"
"Schley","2020-12-01","6","1568","1","127","14","9.7"
"Schley","2020-12-02","9","1577","0","127","12","9.7"
"Schley","2020-12-03","12","1589","0","127","12","9"
"Schley","2020-12-04","6","1595","2","129","16.8","10.6"
"Schley","2020-12-05","1","1596","0","129","16.8","10.6"
"Schley","2020-12-06","2","1598","0","129","9.6","10.6"
"Schley","2020-12-07","10","1608","1","130","8.6","11.3"
"Schley","2020-12-08","10","1618","0","130","6.2","10.1"
"Schley","2020-12-09","4","1622","0","130","6.2","9.1"
"Schley","2020-12-10","10","1632","2","132","9","10.5"
"Schley","2020-12-11","14","1646","1","133","5.3","11"
"Schley","2020-12-12","3","1649","0","133","5.3","11"
"Schley","2020-12-13","3","1652","0","133","5.3","7.5"
"Schley","2020-12-14","21","1673","1","134","4.6","6.6"
"Schley","2020-12-15","5","1678","2","136","10.3","8.2"
"Schley","2020-12-16","4","1682","0","136","10.3","8.2"
"Schley","2020-12-17","14","1696","1","137","8.4","8.7"
"Schley","2020-12-18","5","1701","1","138","10.3","7.8"
"Schley","2020-12-19","5","1706","0","138","10.3","7.8"
"Schley","2020-12-20","2","1708","0","138","10.3","7.8"
"Schley","2020-12-21","31","1739","3","141","11","7.8"
"Schley","2020-12-22","9","1748","0","141","5.3","7.8"
"Schley","2020-12-23","9","1757","2","143","8.4","9.4"
"Schley","2020-12-24","4","1761","0","143","7.4","7.9"
"Schley","2020-12-25","1","1762","0","143","4.6","7.4"
"Schley","2020-12-26","1","1763","0","143","4.6","7.4"
"Schley","2020-12-27","2","1765","0","143","4.6","7.4"
"Schley","2020-12-28","16","1781","0","143","3.2","7.1"
"Schley","2020-12-29","9","1790","4","147","9.5","7.4"
"Schley","2020-12-30","13","1803","1","148","7.4","7.9"
"Schley","2020-12-31","4","1807","0","148","7.4","7.4"
"Schley","2021-01-01","5","1812","0","148","7.4","6"
"Schley","2021-01-02","1","1813","0","148","7.4","6"
"Schley","2021-01-03","7","1820","2","150","11.5","8"
"Schley","2021-01-04","50","1870","1","151","11.8","7.5"
"Schley","2021-01-05","3","1873","0","151","5.5","7.5"
"Schley","2021-01-06","2","1875","1","152","11.5","9.5"
"Schley","2021-01-07","8","1883","0","152","11.5","9.5"
"Schley","2021-01-08","12","1895","1","153","12.7","10.1"
"Schley","2021-01-09","1","1896","0","153","12.7","10.1"
"Schley","2021-01-10","1","1897","0","153","8.6","10.1"
"Schley","2021-01-11","4","1901","0","153","8.3","10.1"
"Schley","2021-01-12","24","1925","5","158","11.3","8.4"
"Schley","2021-01-13","10","1935","2","160","7","9.3"
"Schley","2021-01-14","8","1943","1","161","8.8","10.2"
"Schley","2021-01-15","6","1949","1","162","10","11.4"
"Schley","2021-01-16","5","1954","1","163","12.9","12.8"
"Schley","2021-01-17","6","1960","1","164","15.2","11.9"
"Schley","2021-01-18","6","1966","2","166","20","14.2"
"Schley","2021-01-19","9","1975","0","166","17","14.2"
"Schley","2021-01-20","9","1984","2","168","17.3","12.2"
"Schley","2021-01-21","4","1988","1","169","19.1","14"
"Schley","2021-01-22","11","1999","1","170","18","14"
"Schley","2021-01-23","3","2002","1","171","19.9","16.4"
"Schley","2021-01-24","3","2005","0","171","17.6","16.4"
"Schley","2021-01-25","12","2017","3","174","16.4","18.2"
"Schley","2021-01-26","6","2023","0","174","16.4","16.7"
"Schley","2021-01-27","5","2028","0","174","13.2","15.3"
"Schley","2021-01-28","3","2031","1","175","14.4","16.8"
"Schley","2021-01-29","10","2041","0","175","13.1","15.6"
"Schley","2021-01-30","5","2046","0","175","8.3","14.1"
"Schley","2021-01-31","2","2048","0","175","8.3","13"
"Schley","2021-02-01","9","2057","0","175","4.8","10.6"
"Schley","2021-02-02","5","2062","2","177","10.5","13.4"
"Schley","2021-02-03","4","2066","0","177","10.5","11.8"
"Schley","2021-02-04","11","2077","3","180","9.6","12"
"Schley","2021-02-05","7","2084","0","180","9.6","11.4"
"Schley","2021-02-06","3","2087","2","182","19.1","13.7"
"Schley","2021-02-07","1","2088","0","182","19.1","13.7"
"Schley","2021-02-08","0","2088","0","182","19.1","11.9"
"Screven","2020-02-01","0","0","0","0",".","."
"Screven","2020-02-02","0","0","0","0",".","."
"Screven","2020-02-03","0","0","0","0",".","."
"Screven","2020-02-04","0","0","0","0",".","."
"Screven","2020-02-05","0","0","0","0",".","."
"Screven","2020-02-06","0","0","0","0",".","."
"Screven","2020-02-07","0","0","0","0","0","."
"Screven","2020-02-08","0","0","0","0","0","."
"Screven","2020-02-09","0","0","0","0","0","."
"Screven","2020-02-10","0","0","0","0","0","."
"Screven","2020-02-11","0","0","0","0","0","."
"Screven","2020-02-12","0","0","0","0","0","."
"Screven","2020-02-13","0","0","0","0","0","."
"Screven","2020-02-14","0","0","0","0","0","0"
"Screven","2020-02-15","0","0","0","0","0","0"
"Screven","2020-02-16","0","0","0","0","0","0"
"Screven","2020-02-17","0","0","0","0","0","0"
"Screven","2020-02-18","0","0","0","0","0","0"
"Screven","2020-02-19","0","0","0","0","0","0"
"Screven","2020-02-20","0","0","0","0","0","0"
"Screven","2020-02-21","0","0","0","0","0","0"
"Screven","2020-02-22","0","0","0","0","0","0"
"Screven","2020-02-23","0","0","0","0","0","0"
"Screven","2020-02-24","0","0","0","0","0","0"
"Screven","2020-02-25","0","0","0","0","0","0"
"Screven","2020-02-26","0","0","0","0","0","0"
"Screven","2020-02-27","0","0","0","0","0","0"
"Screven","2020-02-28","0","0","0","0","0","0"
"Screven","2020-02-29","0","0","0","0","0","0"
"Screven","2020-03-01","0","0","0","0","0","0"
"Screven","2020-03-02","0","0","0","0","0","0"
"Screven","2020-03-03","0","0","0","0","0","0"
"Screven","2020-03-04","0","0","0","0","0","0"
"Screven","2020-03-05","0","0","0","0","0","0"
"Screven","2020-03-06","0","0","0","0","0","0"
"Screven","2020-03-07","0","0","0","0","0","0"
"Screven","2020-03-08","0","0","0","0","0","0"
"Screven","2020-03-09","0","0","0","0","0","0"
"Screven","2020-03-10","0","0","0","0","0","0"
"Screven","2020-03-11","0","0","0","0","0","0"
"Screven","2020-03-12","0","0","0","0","0","0"
"Screven","2020-03-13","0","0","0","0","0","0"
"Screven","2020-03-14","0","0","0","0","0","0"
"Screven","2020-03-15","0","0","0","0","0","0"
"Screven","2020-03-16","0","0","0","0","0","0"
"Screven","2020-03-17","6","6","0","0","0","0"
"Screven","2020-03-18","0","6","0","0","0","0"
"Screven","2020-03-19","0","6","0","0","0","0"
"Screven","2020-03-20","1","7","0","0","0","0"
"Screven","2020-03-21","0","7","0","0","0","0"
"Screven","2020-03-22","0","7","0","0","0","0"
"Screven","2020-03-23","4","11","0","0","0","0"
"Screven","2020-03-24","5","16","0","0","0","0"
"Screven","2020-03-25","5","21","0","0","0","0"
"Screven","2020-03-26","5","26","0","0","0","0"
"Screven","2020-03-27","3","29","0","0","0","0"
"Screven","2020-03-28","0","29","0","0","0","0"
"Screven","2020-03-29","0","29","0","0","0","0"
"Screven","2020-03-30","3","32","0","0","0","0"
"Screven","2020-03-31","1","33","1","1","14.3","7.1"
"Screven","2020-04-01","0","33","0","1","14.3","7.1"
"Screven","2020-04-02","4","37","1","2","17.9","8.9"
"Screven","2020-04-03","2","39","0","2","17.9","8.9"
"Screven","2020-04-04","1","40","1","3","32.1","16.1"
"Screven","2020-04-05","2","42","0","3","32.1","16.1"
"Screven","2020-04-06","8","50","2","5","35.7","17.9"
"Screven","2020-04-07","4","54","1","6","25","19.6"
"Screven","2020-04-08","4","58","1","7","28.6","21.4"
"Screven","2020-04-09","5","63","0","7","25","21.4"
"Screven","2020-04-10","2","65","0","7","25","21.4"
"Screven","2020-04-11","2","67","0","7","10.7","21.4"
"Screven","2020-04-12","1","68","1","8","25","28.6"
"Screven","2020-04-13","5","73","0","8","21.4","28.6"
"Screven","2020-04-14","7","80","0","8","17.9","21.4"
"Screven","2020-04-15","7","87","0","8","14.3","21.4"
"Screven","2020-04-16","11","98","0","8","14.3","19.6"
"Screven","2020-04-17","4","102","0","8","14.3","19.6"
"Screven","2020-04-18","1","103","0","8","14.3","12.5"
"Screven","2020-04-19","0","103","0","8","0","12.5"
"Screven","2020-04-20","2","105","0","8","0","10.7"
"Screven","2020-04-21","5","110","0","8","0","8.9"
"Screven","2020-04-22","4","114","0","8","0","7.1"
"Screven","2020-04-23","2","116","0","8","0","7.1"
"Screven","2020-04-24","3","119","1","9","4.8","9.5"
"Screven","2020-04-25","0","119","0","9","4.8","9.5"
"Screven","2020-04-26","1","120","0","9","4.8","2.4"
"Screven","2020-04-27","5","125","0","9","4.8","2.4"
"Screven","2020-04-28","4","129","1","10","8.3","4.2"
"Screven","2020-04-29","3","132","0","10","8.3","4.2"
"Screven","2020-04-30","0","132","0","10","8.3","4.2"
"Screven","2020-05-01","5","137","0","10","3.6","4.2"
"Screven","2020-05-02","2","139","1","11","10.7","7.7"
"Screven","2020-05-03","0","139","0","11","10.7","7.7"
"Screven","2020-05-04","4","143","0","11","10.7","7.7"
"Screven","2020-05-05","8","151","0","11","7.1","7.7"
"Screven","2020-05-06","1","152","0","11","7.1","7.7"
"Screven","2020-05-07","5","157","0","11","7.1","7.7"
"Screven","2020-05-08","5","162","0","11","7.1","5.4"
"Screven","2020-05-09","0","162","0","11","0","5.4"
"Screven","2020-05-10","2","164","0","11","0","5.4"
"Screven","2020-05-11","4","168","0","11","0","5.4"
"Screven","2020-05-12","4","172","1","12","3.6","5.4"
"Screven","2020-05-13","5","177","0","12","3.6","5.4"
"Screven","2020-05-14","11","188","0","12","3.6","5.4"
"Screven","2020-05-15","6","194","1","13","6","6.5"
"Screven","2020-05-16","2","196","0","13","6","3"
"Screven","2020-05-17","3","199","1","14","10.7","5.4"
"Screven","2020-05-18","5","204","1","15","13.6","6.8"
"Screven","2020-05-19","2","206","0","15","10","6.8"
"Screven","2020-05-20","3","209","0","15","10","6.8"
"Screven","2020-05-21","13","222","0","15","10","6.8"
"Screven","2020-05-22","9","231","1","16","9.2","7.6"
"Screven","2020-05-23","1","232","0","16","9.2","7.6"
"Screven","2020-05-24","3","235","0","16","4.4","7.6"
"Screven","2020-05-25","2","237","0","16","1.6","7.6"
"Screven","2020-05-26","6","243","2","18","6.3","8.2"
"Screven","2020-05-27","9","252","0","18","6.3","8.2"
"Screven","2020-05-28","2","254","1","19","13.5","11.7"
"Screven","2020-05-29","2","256","0","19","11.9","10.6"
"Screven","2020-05-30","1","257","0","19","11.9","10.6"
"Screven","2020-05-31","1","258","1","20","26.2","15.3"
"Screven","2020-06-01","6","264","0","20","26.2","13.9"
"Screven","2020-06-02","6","270","0","20","21.4","13.9"
"Screven","2020-06-03","8","278","0","20","21.4","13.9"
"Screven","2020-06-04","8","286","1","21","16.1","14.8"
"Screven","2020-06-05","2","288","0","21","16.1","14"
"Screven","2020-06-06","0","288","0","21","16.1","14"
"Screven","2020-06-07","2","290","0","21","1.8","14"
"Screven","2020-06-08","3","293","1","22","6.5","16.4"
"Screven","2020-06-09","5","298","0","22","6.5","14"
"Screven","2020-06-10","3","301","0","22","6.5","14"
"Screven","2020-06-11","3","304","0","22","4.8","10.4"
"Screven","2020-06-12","9","313","0","22","4.8","10.4"
"Screven","2020-06-13","10","323","0","22","4.8","10.4"
"Screven","2020-06-14","2","325","0","22","4.8","3.3"
"Screven","2020-06-15","13","338","1","23","1.1","3.8"
"Screven","2020-06-16","5","343","0","23","1.1","3.8"
"Screven","2020-06-17","4","347","0","23","1.1","3.8"
"Screven","2020-06-18","2","349","0","23","1.1","2.9"
"Screven","2020-06-19","8","357","1","24","2.9","3.8"
"Screven","2020-06-20","4","361","0","24","2.9","3.8"
"Screven","2020-06-21","3","364","0","24","2.9","3.8"
"Screven","2020-06-22","14","378","0","24","1.8","1.4"
"Screven","2020-06-23","4","382","0","24","1.8","1.4"
"Screven","2020-06-24","14","396","1","25","2.8","2"
"Screven","2020-06-25","13","409","0","25","2.8","2"
"Screven","2020-06-26","23","432","1","26","1.6","2.3"
"Screven","2020-06-27","2","434","0","26","1.6","2.3"
"Screven","2020-06-28","2","436","0","26","1.6","2.3"
"Screven","2020-06-29","13","449","0","26","1.6","1.7"
"Screven","2020-06-30","9","458","1","27","3.2","2.5"
"Screven","2020-07-01","12","470","0","27","2.2","2.5"
"Screven","2020-07-02","21","491","1","28","2.9","2.8"
"Screven","2020-07-03","8","499","0","28","2.3","2"
"Screven","2020-07-04","3","502","1","29","7","4.3"
"Screven","2020-07-05","4","506","1","30","10.6","6.1"
"Screven","2020-07-06","20","526","3","33","12.7","7.2"
"Screven","2020-07-07","20","546","1","34","11.9","7.5"
"Screven","2020-07-08","16","562","1","35","12.8","7.5"
"Screven","2020-07-09","22","584","3","38","14","8.5"
"Screven","2020-07-10","20","604","0","38","14","8.1"
"Screven","2020-07-11","5","609","3","41","17.8","12.4"
"Screven","2020-07-12","4","613","0","41","14.3","12.4"
"Screven","2020-07-13","25","638","6","47","15.6","14.1"
"Screven","2020-07-14","15","653","1","48","15.8","13.8"
"Screven","2020-07-15","10","663","1","49","16.3","14.5"
"Screven","2020-07-16","15","678","1","50","15.3","14.7"
"Screven","2020-07-17","26","704","1","51","15.9","15"
"Screven","2020-07-18","6","710","2","53","12.1","15"
"Screven","2020-07-19","2","712","0","53","12.1","13.2"
"Screven","2020-07-20","11","723","2","55","11.2","13.4"
"Screven","2020-07-21","17","740","6","61","15.3","15.6"
"Screven","2020-07-22","17","757","3","64","16.4","16.4"
"Screven","2020-07-23","12","769","0","64","15.5","15.4"
"Screven","2020-07-24","8","777","1","65","16.7","16.3"
"Screven","2020-07-25","5","782","2","67","17.7","14.9"
"Screven","2020-07-26","12","794","2","69","20","16.1"
"Screven","2020-07-27","20","814","4","73","20.3","15.8"
"Screven","2020-07-28","10","824","2","75","18.1","16.7"
"Screven","2020-07-29","10","834","1","76","17","16.7"
"Screven","2020-07-30","12","846","2","78","19.4","17.4"
"Screven","2020-07-31","11","857","2","80","20.2","18.5"
"Screven","2020-08-01","5","862","0","80","14.5","16.1"
"Screven","2020-08-02","2","864","0","80","12.1","16.1"
"Screven","2020-08-03","10","874","4","84","15","17.6"
"Screven","2020-08-04","14","888","7","91","19.3","18.7"
"Screven","2020-08-05","9","897","2","93","21","19"
"Screven","2020-08-06","8","905","2","95","22.2","20.8"
"Screven","2020-08-07","23","928","2","97","20.8","20.5"
"Screven","2020-08-08","5","933","1","98","23.7","19.1"
"Screven","2020-08-09","6","939","1","99","26.1","19.1"
"Screven","2020-08-10","13","952","0","99","20.4","17.7"
"Screven","2020-08-11","21","973","7","106","18","18.6"
"Screven","2020-08-12","17","990","3","109","17.3","19.2"
"Screven","2020-08-13","7","997","1","110","15.8","19"
"Screven","2020-08-14","11","1008","1","111","15.9","18.4"
"Screven","2020-08-15","4","1012","1","112","16.6","20.1"
"Screven","2020-08-16","4","1016","1","113","17.8","21.9"
"Screven","2020-08-17","12","1028","0","113","17.8","19.1"
"Screven","2020-08-18","8","1036","0","113","13","15.5"
"Screven","2020-08-19","7","1043","1","114","12.5","14.9"
"Screven","2020-08-20","8","1051","0","114","10.5","13.1"
"Screven","2020-08-21","18","1069","0","114","9.2","12.5"
"Screven","2020-08-22","3","1072","1","115","10.4","13.5"
"Screven","2020-08-23","4","1076","0","115","6.8","12.3"
"Screven","2020-08-24","12","1088","2","117","9.2","13.5"
"Screven","2020-08-25","12","1100","2","119","11.6","12.3"
"Screven","2020-08-26","9","1109","1","120","11.1","11.8"
"Screven","2020-08-27","11","1120","2","122","13.7","12.1"
"Screven","2020-08-28","13","1133","2","124","15.9","12.5"
"Screven","2020-08-29","5","1138","1","125","14","12.2"
"Screven","2020-08-30","7","1145","2","127","18.1","12.4"
"Screven","2020-08-31","10","1155","2","129","18.6","13.9"
"Screven","2020-09-01","11","1166","0","129","16.2","13.9"
"Screven","2020-09-02","4","1170","0","129","14.6","12.9"
"Screven","2020-09-03","6","1176","0","129","12","12.9"
"Screven","2020-09-04","7","1183","1","130","11.8","13.9"
"Screven","2020-09-05","5","1188","1","131","11.8","12.9"
"Screven","2020-09-06","4","1192","3","134","18.5","18.3"
"Screven","2020-09-07","3","1195","0","134","15.6","17.1"
"Screven","2020-09-08","18","1213","2","136","17.2","16.7"
"Screven","2020-09-09","16","1229","2","138","19","16.8"
"Screven","2020-09-10","12","1241","2","140","21.4","16.7"
"Screven","2020-09-11","8","1249","0","140","19.3","15.6"
"Screven","2020-09-12","1","1250","0","140","16.5","14.2"
"Screven","2020-09-13","5","1255","0","140","5.8","12.1"
"Screven","2020-09-14","18","1273","3","143","8.1","11.9"
"Screven","2020-09-15","15","1288","1","144","7.5","12.3"
"Screven","2020-09-16","64","1352","3","147","6.4","12.7"
"Screven","2020-09-17","85","1437","2","149","4.3","12.9"
"Screven","2020-09-18","26","1463","2","151","5.4","12.4"
"Screven","2020-09-19","5","1468","1","152","8.3","12.4"
"Screven","2020-09-20","5","1473","2","154","14","9.9"
"Screven","2020-09-21","17","1490","2","156","13.3","10.7"
"Screven","2020-09-22","12","1502","0","156","12.4","9.9"
"Screven","2020-09-23","8","1510","3","159","17","11.7"
"Screven","2020-09-24","71","1581","6","165","17.9","11.1"
"Screven","2020-09-25","40","1621","2","167","17.5","11.5"
"Screven","2020-09-26","6","1627","1","168","17.1","12.7"
"Screven","2020-09-27","5","1632","0","168","11.3","12.7"
"Screven","2020-09-28","10","1642","2","170","12.5","12.9"
"Screven","2020-09-29","8","1650","0","170","12.5","12.4"
"Screven","2020-09-30","10","1660","0","170","7.2","12.1"
"Screven","2020-10-01","39","1699","5","175","7.8","12.8"
"Screven","2020-10-02","17","1716","0","175","7.1","12.3"
"Screven","2020-10-03","92","1808","1","176","4.8","10.9"
"Screven","2020-10-04","8","1816","0","176","4.8","8.1"
"Screven","2020-10-05","13","1829","2","178","4.2","8.4"
"Screven","2020-10-06","19","1848","1","179","4.9","8.7"
"Screven","2020-10-07","6","1854","0","179","4.9","6"
"Screven","2020-10-08","57","1911","4","183","4.1","5.9"
"Screven","2020-10-09","41","1952","3","186","5.2","6.1"
"Screven","2020-10-10","52","2004","0","186","5","4.9"
"Screven","2020-10-11","6","2010","0","186","5","4.9"
"Screven","2020-10-12","13","2023","2","188","5","4.6"
"Screven","2020-10-13","13","2036","1","189","5.3","5.1"
"Screven","2020-10-14","5","2041","1","190","8.2","6.6"
"Screven","2020-10-15","29","2070","1","191","7.7","5.9"
"Screven","2020-10-16","21","2091","3","194","8.7","6.9"
"Screven","2020-10-17","115","2206","0","194","8.7","6.8"
"Screven","2020-10-18","6","2212","1","195","11.1","8"
"Screven","2020-10-19","14","2226","0","195","8.9","6.9"
"Screven","2020-10-20","10","2236","0","195","7.8","6.6"
"Screven","2020-10-21","10","2246","1","196","6.3","7.3"
"Screven","2020-10-22","43","2289","1","197","6.2","6.9"
"Screven","2020-10-23","65","2354","3","200","4.8","6.7"
"Screven","2020-10-24","8","2362","0","200","4.8","6.7"
"Screven","2020-10-25","2","2364","0","200","2.4","6.7"
"Screven","2020-10-26","9","2373","0","200","2.4","5.6"
"Screven","2020-10-27","9","2382","2","202","5.6","6.7"
"Screven","2020-10-28","10","2392","1","203","5.6","6"
"Screven","2020-10-29","51","2443","1","204","5.5","5.9"
"Screven","2020-10-30","28","2471","1","205","5.4","5.1"
"Screven","2020-10-31","45","2516","0","205","5.4","5.1"
"Screven","2020-11-01","2","2518","0","205","5.4","3.9"
"Screven","2020-11-02","8","2526","1","206","7.2","4.8"
"Screven","2020-11-03","12","2538","0","206","4","4.8"
"Screven","2020-11-04","5","2543","0","206","2.6","4.1"
"Screven","2020-11-05","25","2568","0","206","2.3","3.9"
"Screven","2020-11-06","16","2584","1","207","2.7","4"
"Screven","2020-11-07","4","2588","0","207","2.7","4"
"Screven","2020-11-08","4","2592","0","207","2.7","4"
"Screven","2020-11-09","14","2606","1","208","1.9","4.5"
"Screven","2020-11-10","11","2617","0","208","1.9","3"
"Screven","2020-11-11","10","2627","0","208","1.9","2.2"
"Screven","2020-11-12","39","2666","3","211","3","2.7"
"Screven","2020-11-13","31","2697","1","212","2.6","2.6"
"Screven","2020-11-14","2","2699","0","212","2.6","2.6"
"Screven","2020-11-15","1","2700","0","212","2.6","2.6"
"Screven","2020-11-16","16","2716","1","213","2.5","2.2"
"Screven","2020-11-17","7","2723","0","213","2.5","2.2"
"Screven","2020-11-18","4","2727","0","213","2.5","2.2"
"Screven","2020-11-19","43","2770","1","214","1.7","2.3"
"Screven","2020-11-20","21","2791","1","215","1.9","2.2"
"Screven","2020-11-21","6","2797","0","215","1.9","2.2"
"Screven","2020-11-22","8","2805","0","215","1.9","2.2"
"Screven","2020-11-23","15","2820","1","216","2","2.2"
"Screven","2020-11-24","6","2826","1","217","4.3","3.4"
"Screven","2020-11-25","8","2834","0","217","4.3","3.4"
"Screven","2020-11-26","2","2836","0","217","4","2.8"
"Screven","2020-11-27","5","2841","0","217","3.3","2.6"
"Screven","2020-11-28","6","2847","0","217","3.3","2.6"
"Screven","2020-11-29","7","2854","0","217","3.3","2.6"
"Screven","2020-11-30","7","2861","0","217","2.4","2.2"
"Screven","2020-12-01","9","2870","2","219","3.2","3.8"
"Screven","2020-12-02","10","2880","0","219","3.2","3.8"
"Screven","2020-12-03","17","2897","1","220","4","4"
"Screven","2020-12-04","8","2905","0","220","4","3.7"
"Screven","2020-12-05","3","2908","1","221","8.8","6.1"
"Screven","2020-12-06","2","2910","0","221","8.8","6.1"
"Screven","2020-12-07","20","2930","1","222","9.5","5.9"
"Screven","2020-12-08","4","2934","0","222","6.3","4.7"
"Screven","2020-12-09","13","2947","2","224","8.5","5.8"
"Screven","2020-12-10","54","3001","7","231","9.5","6.8"
"Screven","2020-12-11","17","3018","2","233","11.2","7.6"
"Screven","2020-12-12","5","3023","1","234","9.3","9"
"Screven","2020-12-13","1","3024","0","234","9.3","9"
"Screven","2020-12-14","19","3043","1","235","9.3","9.4"
"Screven","2020-12-15","13","3056","1","236","10.4","8.4"
"Screven","2020-12-16","12","3068","1","237","9.4","9"
"Screven","2020-12-17","75","3143","8","245","9.1","9.3"
"Screven","2020-12-18","10","3153","2","247","10.3","10.7"
"Screven","2020-12-19","3","3156","0","247","7.4","8.4"
"Screven","2020-12-20","2","3158","1","248","14.6","11.9"
"Screven","2020-12-21","15","3173","2","250","15.7","12.5"
"Screven","2020-12-22","11","3184","1","251","15.9","13.2"
"Screven","2020-12-23","16","3200","3","254","17.4","13.4"
"Screven","2020-12-24","11","3211","5","259","22.4","15.7"
"Screven","2020-12-25","0","3211","0","259","19.5","14.9"
"Screven","2020-12-26","6","3217","1","260","21.9","14.7"
"Screven","2020-12-27","7","3224","1","261","16.8","15.7"
"Screven","2020-12-28","16","3240","5","266","19.4","17.5"
"Screven","2020-12-29","12","3252","4","270","22.8","19.4"
"Screven","2020-12-30","15","3267","3","273","23","20.2"
"Screven","2020-12-31","132","3399","30","303","19.8","21.1"
"Screven","2021-01-01","3","3402","1","304","24.5","22"
"Screven","2021-01-02","6","3408","2","306","26.9","24.4"
"Screven","2021-01-03","5","3413","3","309","33.4","25.1"
"Screven","2021-01-04","27","3440","14","323","36.4","27.9"
"Screven","2021-01-05","25","3465","6","329","35","28.9"
"Screven","2021-01-06","27","3492","4","333","34.3","28.6"
"Screven","2021-01-07","137","3629","14","347","32.5","26.1"
"Screven","2021-01-08","15","3644","6","353","33.5","29"
"Screven","2021-01-09","4","3648","0","353","28.7","27.8"
"Screven","2021-01-10","9","3657","3","356","24.9","29.2"
"Screven","2021-01-11","26","3683","7","363","21.3","28.8"
"Screven","2021-01-12","29","3712","4","367","19.9","27.5"
"Screven","2021-01-13","16","3728","6","373","23.1","28.7"
"Screven","2021-01-14","24","3752","5","378","24.6","28.6"
"Screven","2021-01-15","24","3776","8","386","23.7","28.6"
"Screven","2021-01-16","11","3787","0","386","23.7","26.2"
"Screven","2021-01-17","8","3795","4","390","26.1","25.5"
"Screven","2021-01-18","22","3817","3","393","24.2","22.7"
"Screven","2021-01-19","19","3836","4","397","25.2","22.5"
"Screven","2021-01-20","29","3865","5","402","22.3","22.7"
"Screven","2021-01-21","29","3894","2","404","20.3","22.5"
"Screven","2021-01-22","35","3929","6","410","18","20.8"
"Screven","2021-01-23","16","3945","7","417","24.2","24"
"Screven","2021-01-24","8","3953","1","418","18.9","22.5"
"Screven","2021-01-25","40","3993","9","427","20.2","22.2"
"Screven","2021-01-26","42","4035","7","434","19.5","22.4"
"Screven","2021-01-27","34","4069","3","437","18.3","20.3"
"Screven","2021-01-28","31","4100","7","444","20.6","20.4"
"Screven","2021-01-29","22","4122","4","448","20.7","19.4"
"Screven","2021-01-30","7","4129","2","450","18.5","21.4"
"Screven","2021-01-31","8","4137","1","451","18.5","18.7"
"Screven","2021-02-01","36","4173","4","455","16.9","18.5"
"Screven","2021-02-02","23","4196","3","458","16.4","18"
"Screven","2021-02-03","26","4222","5","463","17.9","18.1"
"Screven","2021-02-04","24","4246","4","467","17","18.8"
"Screven","2021-02-05","13","4259","0","467","14.4","17.6"
"Screven","2021-02-06","1","4260","0","467","10.4","14.5"
"Screven","2021-02-07","0","4260","0","467","8.6","13.6"
"Screven","2021-02-08","0","4260","0","467","7","12"
"Seminole","2020-02-01","0","0","0","0",".","."
"Seminole","2020-02-02","0","0","0","0",".","."
"Seminole","2020-02-03","0","0","0","0",".","."
"Seminole","2020-02-04","0","0","0","0",".","."
"Seminole","2020-02-05","0","0","0","0",".","."
"Seminole","2020-02-06","0","0","0","0",".","."
"Seminole","2020-02-07","0","0","0","0","0","."
"Seminole","2020-02-08","0","0","0","0","0","."
"Seminole","2020-02-09","0","0","0","0","0","."
"Seminole","2020-02-10","0","0","0","0","0","."
"Seminole","2020-02-11","0","0","0","0","0","."
"Seminole","2020-02-12","0","0","0","0","0","."
"Seminole","2020-02-13","0","0","0","0","0","."
"Seminole","2020-02-14","0","0","0","0","0","0"
"Seminole","2020-02-15","0","0","0","0","0","0"
"Seminole","2020-02-16","0","0","0","0","0","0"
"Seminole","2020-02-17","0","0","0","0","0","0"
"Seminole","2020-02-18","0","0","0","0","0","0"
"Seminole","2020-02-19","0","0","0","0","0","0"
"Seminole","2020-02-20","1","1","0","0","0","0"
"Seminole","2020-02-21","0","1","0","0","0","0"
"Seminole","2020-02-22","0","1","0","0","0","0"
"Seminole","2020-02-23","0","1","0","0","0","0"
"Seminole","2020-02-24","0","1","0","0","0","0"
"Seminole","2020-02-25","0","1","0","0","0","0"
"Seminole","2020-02-26","0","1","0","0","0","0"
"Seminole","2020-02-27","0","1","0","0","0","0"
"Seminole","2020-02-28","0","1","0","0","0","0"
"Seminole","2020-02-29","0","1","0","0","0","0"
"Seminole","2020-03-01","0","1","0","0","0","0"
"Seminole","2020-03-02","0","1","0","0","0","0"
"Seminole","2020-03-03","0","1","0","0","0","0"
"Seminole","2020-03-04","0","1","0","0","0","0"
"Seminole","2020-03-05","0","1","0","0","0","0"
"Seminole","2020-03-06","0","1","0","0","0","0"
"Seminole","2020-03-07","0","1","0","0","0","0"
"Seminole","2020-03-08","0","1","0","0","0","0"
"Seminole","2020-03-09","0","1","0","0","0","0"
"Seminole","2020-03-10","0","1","0","0","0","0"
"Seminole","2020-03-11","0","1","0","0","0","0"
"Seminole","2020-03-12","1","2","0","0","0","0"
"Seminole","2020-03-13","1","3","0","0","0","0"
"Seminole","2020-03-14","0","3","0","0","0","0"
"Seminole","2020-03-15","0","3","0","0","0","0"
"Seminole","2020-03-16","6","9","0","0","0","0"
"Seminole","2020-03-17","0","9","0","0","0","0"
"Seminole","2020-03-18","3","12","0","0","0","0"
"Seminole","2020-03-19","0","12","0","0","0","0"
"Seminole","2020-03-20","0","12","0","0","0","0"
"Seminole","2020-03-21","0","12","0","0","0","0"
"Seminole","2020-03-22","0","12","0","0","0","0"
"Seminole","2020-03-23","2","14","0","0","0","0"
"Seminole","2020-03-24","3","17","0","0","0","0"
"Seminole","2020-03-25","2","19","0","0","0","0"
"Seminole","2020-03-26","0","19","0","0","0","0"
"Seminole","2020-03-27","2","21","0","0","0","0"
"Seminole","2020-03-28","1","22","1","1","14.3","7.1"
"Seminole","2020-03-29","0","22","0","1","14.3","7.1"
"Seminole","2020-03-30","2","24","0","1","14.3","7.1"
"Seminole","2020-03-31","0","24","0","1","14.3","7.1"
"Seminole","2020-04-01","2","26","0","1","14.3","7.1"
"Seminole","2020-04-02","12","38","2","3","16.7","8.3"
"Seminole","2020-04-03","6","44","1","4","19","9.5"
"Seminole","2020-04-04","9","53","0","4","4.8","9.5"
"Seminole","2020-04-05","0","53","0","4","4.8","9.5"
"Seminole","2020-04-06","5","58","0","4","4.8","9.5"
"Seminole","2020-04-07","15","73","3","7","7.6","11"
"Seminole","2020-04-08","16","89","1","8","8.5","11.4"
"Seminole","2020-04-09","19","108","0","8","6.1","11.4"
"Seminole","2020-04-10","12","120","0","8","3.8","11.4"
"Seminole","2020-04-11","5","125","2","10","9.5","7.1"
"Seminole","2020-04-12","0","125","0","10","9.5","7.1"
"Seminole","2020-04-13","7","132","1","11","11.5","8.1"
"Seminole","2020-04-14","47","179","7","18","10.8","9.2"
"Seminole","2020-04-15","12","191","0","18","9.9","9.2"
"Seminole","2020-04-16","20","211","0","18","9.9","8"
"Seminole","2020-04-17","7","218","3","21","16","9.9"
"Seminole","2020-04-18","12","230","0","21","10.3","9.9"
"Seminole","2020-04-19","1","231","0","21","10.3","9.9"
"Seminole","2020-04-20","5","236","0","21","8.3","9.9"
"Seminole","2020-04-21","11","247","2","23","8.7","9.7"
"Seminole","2020-04-22","8","255","2","25","12.3","11.1"
"Seminole","2020-04-23","10","265","1","26","13.7","11.8"
"Seminole","2020-04-24","31","296","0","26","7.6","11.8"
"Seminole","2020-04-25","10","306","2","28","10.5","10.4"
"Seminole","2020-04-26","0","306","0","28","10.5","10.4"
"Seminole","2020-04-27","3","309","0","28","10.5","9.4"
"Seminole","2020-04-28","13","322","0","28","7.9","8.3"
"Seminole","2020-04-29","19","341","1","29","5","8.7"
"Seminole","2020-04-30","21","362","0","29","3.6","8.7"
"Seminole","2020-05-01","9","371","2","31","6.8","7.2"
"Seminole","2020-05-02","7","378","1","32","6","8.2"
"Seminole","2020-05-03","0","378","0","32","6","8.2"
"Seminole","2020-05-04","6","384","1","33","8.3","9.4"
"Seminole","2020-05-05","10","394","3","36","12.6","10.2"
"Seminole","2020-05-06","15","409","3","39","14.7","9.9"
"Seminole","2020-05-07","12","421","3","42","18.3","11"
"Seminole","2020-05-08","3","424","2","44","24.7","15.7"
"Seminole","2020-05-09","19","443","0","44","22.6","14.3"
"Seminole","2020-05-10","0","443","0","44","22.6","14.3"
"Seminole","2020-05-11","4","447","0","44","20.2","14.3"
"Seminole","2020-05-12","22","469","4","48","18.5","15.6"
"Seminole","2020-05-13","19","488","1","49","16.4","15.6"
"Seminole","2020-05-14","10","498","0","49","12.9","15.6"
"Seminole","2020-05-15","11","509","1","50","4.6","14.7"
"Seminole","2020-05-16","11","520","1","51","5.9","14.3"
"Seminole","2020-05-17","1","521","0","51","5.9","14.3"
"Seminole","2020-05-18","10","531","1","52","7.4","13.8"
"Seminole","2020-05-19","15","546","1","53","5.7","12.1"
"Seminole","2020-05-20","9","555","0","53","5","10.7"
"Seminole","2020-05-21","23","578","1","54","5.6","9.2"
"Seminole","2020-05-22","9","587","1","55","5.9","5.3"
"Seminole","2020-05-23","1","588","0","55","4.6","5.3"
"Seminole","2020-05-24","0","588","0","55","4.6","5.3"
"Seminole","2020-05-25","0","588","0","55","3.2","5.3"
"Seminole","2020-05-26","10","598","1","56","3.6","4.7"
"Seminole","2020-05-27","29","627","0","56","3.6","4.3"
"Seminole","2020-05-28","59","686","1","57","3.3","4.4"
"Seminole","2020-05-29","101","787","3","60","2.1","4"
"Seminole","2020-05-30","16","803","0","60","2.1","3.3"
"Seminole","2020-05-31","0","803","0","60","2.1","3.3"
"Seminole","2020-06-01","3","806","1","61","6.9","5"
"Seminole","2020-06-02","15","821","0","61","5.4","4.5"
"Seminole","2020-06-03","14","835","1","62","6.4","5"
"Seminole","2020-06-04","12","847","1","63","7.4","5.3"
"Seminole","2020-06-05","9","856","1","64","8.6","5.3"
"Seminole","2020-06-06","15","871","0","64","8.6","5.3"
"Seminole","2020-06-07","0","871","0","64","8.6","5.3"
"Seminole","2020-06-08","15","886","1","65","4.8","5.8"
"Seminole","2020-06-09","12","898","0","65","4.8","5.1"
"Seminole","2020-06-10","8","906","0","65","3.7","5.1"
"Seminole","2020-06-11","14","920","1","66","3.6","5.5"
"Seminole","2020-06-12","12","932","0","66","2","5.3"
"Seminole","2020-06-13","0","932","0","66","2","5.3"
"Seminole","2020-06-14","2","934","0","66","2","5.3"
"Seminole","2020-06-15","10","944","0","66","1","2.9"
"Seminole","2020-06-16","10","954","0","66","1","2.9"
"Seminole","2020-06-17","5","959","0","66","1","2.4"
"Seminole","2020-06-18","17","976","1","67","0.8","2.2"
"Seminole","2020-06-19","9","985","0","67","0.8","1.4"
"Seminole","2020-06-20","9","994","0","67","0.8","1.4"
"Seminole","2020-06-21","1","995","0","67","0.8","1.4"
"Seminole","2020-06-22","6","1001","0","67","0.8","0.9"
"Seminole","2020-06-23","11","1012","0","67","0.8","0.9"
"Seminole","2020-06-24","14","1026","1","68","1.9","1.4"
"Seminole","2020-06-25","11","1037","0","68","1","0.9"
"Seminole","2020-06-26","16","1053","1","69","1.9","1.4"
"Seminole","2020-06-27","10","1063","0","69","1.9","1.4"
"Seminole","2020-06-28","0","1063","0","69","1.9","1.4"
"Seminole","2020-06-29","9","1072","0","69","1.9","1.4"
"Seminole","2020-06-30","15","1087","1","70","2.9","1.9"
"Seminole","2020-07-01","12","1099","1","71","3","2.4"
"Seminole","2020-07-02","13","1112","0","71","3","2"
"Seminole","2020-07-03","2","1114","0","71","2.1","2"
"Seminole","2020-07-04","13","1127","0","71","2.1","2"
"Seminole","2020-07-05","3","1130","0","71","2.1","2"
"Seminole","2020-07-06","8","1138","1","72","3.9","2.9"
"Seminole","2020-07-07","6","1144","1","73","5.4","4.1"
"Seminole","2020-07-08","17","1161","3","76","6.7","4.9"
"Seminole","2020-07-09","6","1167","0","76","6.7","4.9"
"Seminole","2020-07-10","16","1183","2","78","8.5","5.3"
"Seminole","2020-07-11","9","1192","0","78","8.5","5.3"
"Seminole","2020-07-12","9","1201","1","79","10.1","6.1"
"Seminole","2020-07-13","9","1210","1","80","9.9","6.9"
"Seminole","2020-07-14","6","1216","1","81","9.9","7.6"
"Seminole","2020-07-15","14","1230","2","83","9.4","8"
"Seminole","2020-07-16","45","1275","9","92","12.2","9.5"
"Seminole","2020-07-17","15","1290","1","93","11.4","9.9"
"Seminole","2020-07-18","8","1298","0","93","11.4","9.9"
"Seminole","2020-07-19","0","1298","0","93","9.8","9.9"
"Seminole","2020-07-20","28","1326","4","97","10.3","10.1"
"Seminole","2020-07-21","9","1335","3","100","12.7","11.3"
"Seminole","2020-07-22","5","1340","1","101","13.5","11.4"
"Seminole","2020-07-23","42","1382","6","107","12.7","12.4"
"Seminole","2020-07-24","45","1427","13","120","15.8","13.6"
"Seminole","2020-07-25","30","1457","7","127","19.2","15.3"
"Seminole","2020-07-26","25","1482","6","133","22.6","16.2"
"Seminole","2020-07-27","11","1493","3","136","24.4","17.4"
"Seminole","2020-07-28","32","1525","8","144","23.3","18"
"Seminole","2020-07-29","54","1579","20","164","25.7","19.6"
"Seminole","2020-07-30","32","1611","8","172","27.2","19.9"
"Seminole","2020-07-31","24","1635","3","175","24.9","20.4"
"Seminole","2020-08-01","28","1663","9","184","26.1","22.6"
"Seminole","2020-08-02","5","1668","3","187","31.3","26.9"
"Seminole","2020-08-03","14","1682","2","189","29.4","26.9"
"Seminole","2020-08-04","38","1720","12","201","30.4","26.8"
"Seminole","2020-08-05","42","1762","9","210","28.1","26.9"
"Seminole","2020-08-06","50","1812","7","217","26.6","26.9"
"Seminole","2020-08-07","30","1842","5","222","27.2","26"
"Seminole","2020-08-08","37","1879","14","236","28","27.1"
"Seminole","2020-08-09","11","1890","1","237","20.7","26"
"Seminole","2020-08-10","17","1907","3","240","21.2","25.3"
"Seminole","2020-08-11","57","1964","15","255","20.4","25.4"
"Seminole","2020-08-12","26","1990","5","260","20.1","24.1"
"Seminole","2020-08-13","40","2030","5","265","19.9","23.2"
"Seminole","2020-08-14","13","2043","3","268","20.8","24"
"Seminole","2020-08-15","35","2078","5","273","17.4","22.7"
"Seminole","2020-08-16","0","2078","0","273","16.2","18.4"
"Seminole","2020-08-17","8","2086","0","273","13.6","17.4"
"Seminole","2020-08-18","46","2132","5","278","11.4","15.9"
"Seminole","2020-08-19","17","2149","3","281","11.2","15.7"
"Seminole","2020-08-20","29","2178","2","283","10.4","15.1"
"Seminole","2020-08-21","30","2208","6","289","10","15.4"
"Seminole","2020-08-22","33","2241","2","291","8.8","13.1"
"Seminole","2020-08-23","0","2241","0","291","8.8","12.5"
"Seminole","2020-08-24","73","2314","2","293","9.2","11.4"
"Seminole","2020-08-25","35","2349","7","300","10.5","11"
"Seminole","2020-08-26","25","2374","2","302","9.1","10.1"
"Seminole","2020-08-27","26","2400","3","305","9.8","10.1"
"Seminole","2020-08-28","24","2424","2","307","8.1","9"
"Seminole","2020-08-29","20","2444","7","314","12.2","10.5"
"Seminole","2020-08-30","2","2446","0","314","12.2","10.5"
"Seminole","2020-08-31","13","2459","1","315","12.9","11.1"
"Seminole","2020-09-01","43","2502","6","321","12.1","11.3"
"Seminole","2020-09-02","31","2533","9","330","15.1","12.1"
"Seminole","2020-09-03","70","2603","2","332","13.8","11.8"
"Seminole","2020-09-04","45","2648","4","336","13.9","11"
"Seminole","2020-09-05","25","2673","0","336","8.9","10.6"
"Seminole","2020-09-06","3","2676","0","336","8.9","10.6"
"Seminole","2020-09-07","2","2678","0","336","7.8","10.4"
"Seminole","2020-09-08","20","2698","0","336","5.8","8.9"
"Seminole","2020-09-09","44","2742","5","341","3.3","9.2"
"Seminole","2020-09-10","21","2763","5","346","6.3","10.1"
"Seminole","2020-09-11","71","2834","3","349","5.6","9.8"
"Seminole","2020-09-12","0","2834","0","349","5.6","7.3"
"Seminole","2020-09-13","1","2835","1","350","19.9","14.4"
"Seminole","2020-09-14","89","2924","3","353","20.4","14.1"
"Seminole","2020-09-15","38","2962","0","353","20.4","13.1"
"Seminole","2020-09-16","15","2977","1","354","19.7","11.5"
"Seminole","2020-09-17","21","2998","1","355","17","11.6"
"Seminole","2020-09-18","18","3016","0","355","16.4","11"
"Seminole","2020-09-19","13","3029","0","355","16.4","11"
"Seminole","2020-09-20","2","3031","0","355","2.1","11"
"Seminole","2020-09-21","41","3072","0","355","1.6","11"
"Seminole","2020-09-22","44","3116","0","355","1.6","11"
"Seminole","2020-09-23","100","3216","6","361","1.5","10.6"
"Seminole","2020-09-24","36","3252","1","362","1.3","9.1"
"Seminole","2020-09-25","39","3291","4","366","2.7","9.6"
"Seminole","2020-09-26","8","3299","1","367","4.5","10.5"
"Seminole","2020-09-27","3","3302","0","367","4.5","3.3"
"Seminole","2020-09-28","36","3338","0","367","4.5","3.1"
"Seminole","2020-09-29","26","3364","0","367","4.5","3.1"
"Seminole","2020-09-30","84","3448","5","372","4.5","3"
"Seminole","2020-10-01","41","3489","3","375","5.1","3.2"
"Seminole","2020-10-02","36","3525","3","378","4.9","3.8"
"Seminole","2020-10-03","24","3549","1","379","3.7","4.1"
"Seminole","2020-10-04","1","3550","0","379","3.7","4.1"
"Seminole","2020-10-05","21","3571","0","379","3.7","4.1"
"Seminole","2020-10-06","39","3610","1","380","4","4.3"
"Seminole","2020-10-07","68","3678","1","381","3.4","4"
"Seminole","2020-10-08","22","3700","1","382","3","4.1"
"Seminole","2020-10-09","35","3735","3","385","3","4"
"Seminole","2020-10-10","21","3756","0","385","2.5","3.1"
"Seminole","2020-10-11","2","3758","0","385","2.5","3.1"
"Seminole","2020-10-12","27","3785","1","386","3","3.3"
"Seminole","2020-10-13","26","3811","2","388","3.7","3.9"
"Seminole","2020-10-14","24","3835","0","388","3.5","3.5"
"Seminole","2020-10-15","16","3851","2","390","4.6","3.8"
"Seminole","2020-10-16","19","3870","0","390","3.4","3.2"
"Seminole","2020-10-17","19","3889","2","392","4.9","3.7"
"Seminole","2020-10-18","2","3891","0","392","4.9","3.7"
"Seminole","2020-10-19","19","3910","1","393","5.1","4.1"
"Seminole","2020-10-20","25","3935","1","394","4.6","4.2"
"Seminole","2020-10-21","33","3968","4","398","6.3","4.9"
"Seminole","2020-10-22","19","3987","1","399","5.3","5"
"Seminole","2020-10-23","12","3999","1","400","6.5","5"
"Seminole","2020-10-24","17","4016","0","400","5","5"
"Seminole","2020-10-25","1","4017","0","400","5","5"
"Seminole","2020-10-26","21","4038","1","401","4.9","5"
"Seminole","2020-10-27","32","4070","2","403","5.2","4.9"
"Seminole","2020-10-28","70","4140","0","403","3.5","4.9"
"Seminole","2020-10-29","31","4171","2","405","3.7","4.5"
"Seminole","2020-10-30","94","4265","2","407","2.8","4.6"
"Seminole","2020-10-31","18","4283","1","408","3.6","4.3"
"Seminole","2020-11-01","3","4286","2","410","13.1","9.1"
"Seminole","2020-11-02","28","4314","2","412","13.5","9.2"
"Seminole","2020-11-03","5","4319","1","413","15.4","10.3"
"Seminole","2020-11-04","55","4374","1","414","15.7","9.6"
"Seminole","2020-11-05","29","4403","6","420","17.7","10.7"
"Seminole","2020-11-06","20","4423","1","421","18.1","10.5"
"Seminole","2020-11-07","18","4441","3","424","19.7","11.7"
"Seminole","2020-11-08","4","4445","1","425","13.8","13.4"
"Seminole","2020-11-09","31","4476","1","426","13.2","13.3"
"Seminole","2020-11-10","69","4545","6","432","11.6","13.5"
"Seminole","2020-11-11","53","4598","6","438","12.9","14.3"
"Seminole","2020-11-12","30","4628","1","439","10.5","14.1"
"Seminole","2020-11-13","22","4650","4","443","12.3","15.2"
"Seminole","2020-11-14","19","4669","2","445","11.5","15.6"
"Seminole","2020-11-15","0","4669","0","445","7.9","10.8"
"Seminole","2020-11-16","23","4692","1","446","8.1","10.6"
"Seminole","2020-11-17","6","4698","1","447","9.2","10.4"
"Seminole","2020-11-18","20","4718","3","450","9.7","11.3"
"Seminole","2020-11-19","50","4768","5","455","10.7","10.6"
"Seminole","2020-11-20","50","4818","6","461","9.8","11.1"
"Seminole","2020-11-21","28","4846","6","467","11.3","11.4"
"Seminole","2020-11-22","4","4850","0","467","11.3","9.6"
"Seminole","2020-11-23","13","4863","2","469","12.9","10.5"
"Seminole","2020-11-24","47","4910","2","471","11.2","10.2"
"Seminole","2020-11-25","57","4967","3","474","9.8","9.7"
"Seminole","2020-11-26","3","4970","0","474","8.3","9.5"
"Seminole","2020-11-27","71","5041","5","479","7.6","8.7"
"Seminole","2020-11-28","18","5059","1","480","5.4","8.4"
"Seminole","2020-11-29","4","5063","3","483","16.1","13.7"
"Seminole","2020-11-30","34","5097","1","484","14.3","13.6"
"Seminole","2020-12-01","26","5123","1","485","14.2","12.7"
"Seminole","2020-12-02","73","5196","10","495","15.4","12.6"
"Seminole","2020-12-03","47","5243","2","497","16","12.2"
"Seminole","2020-12-04","20","5263","1","498","15.8","11.7"
"Seminole","2020-12-05","16","5279","1","499","15.9","10.6"
"Seminole","2020-12-06","3","5282","0","499","5.1","10.6"
"Seminole","2020-12-07","14","5296","0","499","4.7","9.5"
"Seminole","2020-12-08","70","5366","3","502","4.8","9.5"
"Seminole","2020-12-09","24","5390","2","504","4","9.7"
"Seminole","2020-12-10","17","5407","3","507","5.9","11"
"Seminole","2020-12-11","18","5425","2","509","6.8","11.3"
"Seminole","2020-12-12","18","5443","5","514","9.9","12.9"
"Seminole","2020-12-13","2","5445","1","515","17","11.1"
"Seminole","2020-12-14","23","5468","2","517","18.3","11.5"
"Seminole","2020-12-15","22","5490","1","518","18.3","11.5"
"Seminole","2020-12-16","17","5507","10","528","25.5","14.8"
"Seminole","2020-12-17","12","5519","0","528","23","14.5"
"Seminole","2020-12-18","9","5528","1","529","23","14.9"
"Seminole","2020-12-19","6","5534","1","530","21.4","15.6"
"Seminole","2020-12-20","0","5534","0","530","14.3","15.6"
"Seminole","2020-12-21","7","5541","2","532","17.1","17.7"
"Seminole","2020-12-22","12","5553","4","536","21.2","19.8"
"Seminole","2020-12-23","19","5572","6","542","17.3","21.4"
"Seminole","2020-12-24","8","5580","0","542","17.3","20.2"
"Seminole","2020-12-25","4","5584","0","542","15.7","19.4"
"Seminole","2020-12-26","3","5587","0","542","13.4","17.4"
"Seminole","2020-12-27","2","5589","0","542","13.4","13.8"
"Seminole","2020-12-28","11","5600","1","543","10.6","13.8"
"Seminole","2020-12-29","11","5611","2","545","8.4","14.8"
"Seminole","2020-12-30","26","5637","7","552","7.7","12.5"
"Seminole","2020-12-31","20","5657","6","558","12","14.7"
"Seminole","2021-01-01","0","5657","0","558","12","13.9"
"Seminole","2021-01-02","8","5665","0","558","12","12.7"
"Seminole","2021-01-03","0","5665","0","558","12","12.7"
"Seminole","2021-01-04","24","5689","2","560","11.9","11.2"
"Seminole","2021-01-05","19","5708","4","564","12.3","10.4"
"Seminole","2021-01-06","21","5729","2","566","9.8","8.8"
"Seminole","2021-01-07","34","5763","7","573","8.5","10.3"
"Seminole","2021-01-08","14","5777","2","575","10.5","11.3"
"Seminole","2021-01-09","5","5782","1","576","13.4","12.7"
"Seminole","2021-01-10","1","5783","0","576","13.4","12.7"
"Seminole","2021-01-11","20","5803","2","578","13.6","12.8"
"Seminole","2021-01-12","26","5829","6","584","13.9","13.1"
"Seminole","2021-01-13","23","5852","2","586","13.8","11.8"
"Seminole","2021-01-14","23","5875","1","587","11.5","10"
"Seminole","2021-01-15","80","5955","1","588","9.6","10.1"
"Seminole","2021-01-16","16","5971","2","590","8.6","11"
"Seminole","2021-01-17","2","5973","0","590","8.6","11"
"Seminole","2021-01-18","14","5987","0","590","7.1","10.4"
"Seminole","2021-01-19","15","6002","2","592","5.7","9.8"
"Seminole","2021-01-20","16","6018","1","593","5.4","9.6"
"Seminole","2021-01-21","27","6045","1","594","5.3","8.4"
"Seminole","2021-01-22","17","6062","0","594","5.1","7.4"
"Seminole","2021-01-23","7","6069","3","597","9.4","9"
"Seminole","2021-01-24","2","6071","0","597","9.4","9"
"Seminole","2021-01-25","26","6097","2","599","10.5","8.8"
"Seminole","2021-01-26","11","6108","2","601","11.2","8.5"
"Seminole","2021-01-27","10","6118","1","602","11.8","8.6"
"Seminole","2021-01-28","26","6144","1","603","11.8","8.5"
"Seminole","2021-01-29","13","6157","0","603","11.8","8.5"
"Seminole","2021-01-30","3","6160","0","603","5.7","7.6"
"Seminole","2021-01-31","2","6162","1","604","12.8","11.1"
"Seminole","2021-02-01","14","6176","2","606","13.8","12.2"
"Seminole","2021-02-02","17","6193","2","608","12.8","12"
"Seminole","2021-02-03","13","6206","0","608","11.4","11.6"
"Seminole","2021-02-04","21","6227","2","610","12.2","12"
"Seminole","2021-02-05","12","6239","1","611","13.4","12.6"
"Seminole","2021-02-06","0","6239","0","611","13.4","9.5"
"Seminole","2021-02-07","0","6239","0","611","6.3","9.5"
"Seminole","2021-02-08","0","6239","0","611","4.2","9"
"Spalding","2020-02-01","0","0","0","0",".","."
"Spalding","2020-02-02","0","0","0","0",".","."
"Spalding","2020-02-03","0","0","0","0",".","."
"Spalding","2020-02-04","0","0","0","0",".","."
"Spalding","2020-02-05","0","0","0","0",".","."
"Spalding","2020-02-06","0","0","0","0",".","."
"Spalding","2020-02-07","0","0","0","0","0","."
"Spalding","2020-02-08","0","0","0","0","0","."
"Spalding","2020-02-09","0","0","0","0","0","."
"Spalding","2020-02-10","0","0","0","0","0","."
"Spalding","2020-02-11","0","0","0","0","0","."
"Spalding","2020-02-12","0","0","0","0","0","."
"Spalding","2020-02-13","0","0","0","0","0","."
"Spalding","2020-02-14","0","0","0","0","0","0"
"Spalding","2020-02-15","0","0","0","0","0","0"
"Spalding","2020-02-16","0","0","0","0","0","0"
"Spalding","2020-02-17","0","0","0","0","0","0"
"Spalding","2020-02-18","0","0","0","0","0","0"
"Spalding","2020-02-19","0","0","0","0","0","0"
"Spalding","2020-02-20","0","0","0","0","0","0"
"Spalding","2020-02-21","0","0","0","0","0","0"
"Spalding","2020-02-22","0","0","0","0","0","0"
"Spalding","2020-02-23","0","0","0","0","0","0"
"Spalding","2020-02-24","0","0","0","0","0","0"
"Spalding","2020-02-25","0","0","0","0","0","0"
"Spalding","2020-02-26","0","0","0","0","0","0"
"Spalding","2020-02-27","0","0","0","0","0","0"
"Spalding","2020-02-28","0","0","0","0","0","0"
"Spalding","2020-02-29","0","0","0","0","0","0"
"Spalding","2020-03-01","0","0","0","0","0","0"
"Spalding","2020-03-02","0","0","0","0","0","0"
"Spalding","2020-03-03","0","0","0","0","0","0"
"Spalding","2020-03-04","0","0","0","0","0","0"
"Spalding","2020-03-05","0","0","0","0","0","0"
"Spalding","2020-03-06","0","0","0","0","0","0"
"Spalding","2020-03-07","0","0","0","0","0","0"
"Spalding","2020-03-08","0","0","0","0","0","0"
"Spalding","2020-03-09","0","0","0","0","0","0"
"Spalding","2020-03-10","3","3","0","0","0","0"
"Spalding","2020-03-11","1","4","0","0","0","0"
"Spalding","2020-03-12","5","9","1","1","2.9","1.4"
"Spalding","2020-03-13","10","19","2","3","5.7","2.9"
"Spalding","2020-03-14","0","19","0","3","5.7","2.9"
"Spalding","2020-03-15","4","23","0","3","5.7","2.9"
"Spalding","2020-03-16","10","33","4","7","11.4","5.7"
"Spalding","2020-03-17","15","48","6","13","17.1","8.6"
"Spalding","2020-03-18","14","62","2","15","19.2","9.6"
"Spalding","2020-03-19","22","84","1","16","17","9.9"
"Spalding","2020-03-20","13","97","1","17","15.2","10.5"
"Spalding","2020-03-21","18","115","1","18","16","10.9"
"Spalding","2020-03-22","4","119","1","19","19.6","12.6"
"Spalding","2020-03-23","25","144","1","20","14.4","12.9"
"Spalding","2020-03-24","16","160","1","21","9.6","13.4"
"Spalding","2020-03-25","18","178","1","22","8.4","13.8"
"Spalding","2020-03-26","39","217","4","26","9.2","13.1"
"Spalding","2020-03-27","26","243","11","37","14.1","14.7"
"Spalding","2020-03-28","15","258","4","41","17.1","16.6"
"Spalding","2020-03-29","12","270","4","45","18.3","19"
"Spalding","2020-03-30","35","305","7","52","20.6","17.5"
"Spalding","2020-03-31","43","348","10","62","23.1","16.3"
"Spalding","2020-04-01","36","384","9","71","25.8","17.1"
"Spalding","2020-04-02","29","413","1","72","24.9","17"
"Spalding","2020-04-03","26","439","5","77","21.6","17.8"
"Spalding","2020-04-04","19","458","3","80","20","18.6"
"Spalding","2020-04-05","4","462","1","81","18.8","18.6"
"Spalding","2020-04-06","47","509","5","86","17.5","19.1"
"Spalding","2020-04-07","41","550","6","92","16.2","19.7"
"Spalding","2020-04-08","19","569","1","93","13.4","19.6"
"Spalding","2020-04-09","30","599","6","99","15.8","20.3"
"Spalding","2020-04-10","21","620","1","100","13.7","17.6"
"Spalding","2020-04-11","9","629","1","101","13.1","16.5"
"Spalding","2020-04-12","6","635","1","102","11.9","15.3"
"Spalding","2020-04-13","22","657","7","109","14.9","16.2"
"Spalding","2020-04-14","19","676","4","113","15.8","16"
"Spalding","2020-04-15","36","712","0","113","15.1","14.2"
"Spalding","2020-04-16","39","751","3","116","13.3","14.5"
"Spalding","2020-04-17","21","772","4","120","15.3","14.5"
"Spalding","2020-04-18","12","784","1","121","14.9","14"
"Spalding","2020-04-19","8","792","1","122","14.3","13.1"
"Spalding","2020-04-20","47","839","3","125","10.7","12.8"
"Spalding","2020-04-21","56","895","7","132","9.5","12.7"
"Spalding","2020-04-22","109","1004","47","179","15.7","15.4"
"Spalding","2020-04-23","34","1038","1","180","15","14.1"
"Spalding","2020-04-24","40","1078","5","185","14","14.7"
"Spalding","2020-04-25","18","1096","1","186","13.6","14.3"
"Spalding","2020-04-26","9","1105","1","187","13.4","13.9"
"Spalding","2020-04-27","36","1141","4","191","14.1","12.4"
"Spalding","2020-04-28","40","1181","2","193","13","11.3"
"Spalding","2020-04-29","41","1222","4","197","8.3","12"
"Spalding","2020-04-30","44","1266","2","199","8.5","11.7"
"Spalding","2020-05-01","47","1313","4","203","7.9","11"
"Spalding","2020-05-02","16","1329","1","204","8","10.8"
"Spalding","2020-05-03","16","1345","2","206","8.2","10.8"
"Spalding","2020-05-04","44","1389","1","207","7","10.5"
"Spalding","2020-05-05","31","1420","5","212","8.6","10.8"
"Spalding","2020-05-06","19","1439","0","212","7.2","7.7"
"Spalding","2020-05-07","20","1459","2","214","8","8.2"
"Spalding","2020-05-08","19","1478","0","214","6.7","7.3"
"Spalding","2020-05-09","17","1495","2","216","7.5","7.8"
"Spalding","2020-05-10","3","1498","0","216","5.7","7"
"Spalding","2020-05-11","49","1547","3","219","6.3","6.6"
"Spalding","2020-05-12","39","1586","3","222","5.1","6.8"
"Spalding","2020-05-13","190","1776","2","224","5.2","6.2"
"Spalding","2020-05-14","33","1809","0","224","3.8","5.9"
"Spalding","2020-05-15","32","1841","3","227","5.1","5.9"
"Spalding","2020-05-16","22","1863","3","230","5.4","6.5"
"Spalding","2020-05-17","21","1884","2","232","6.8","6.3"
"Spalding","2020-05-18","53","1937","3","235","6.7","6.5"
"Spalding","2020-05-19","93","2030","13","248","7.6","6.3"
"Spalding","2020-05-20","61","2091","2","250","7.9","6.6"
"Spalding","2020-05-21","39","2130","1","251","8.3","6"
"Spalding","2020-05-22","53","2183","2","253","7.5","6.3"
"Spalding","2020-05-23","18","2201","0","253","5.5","5.5"
"Spalding","2020-05-24","8","2209","0","253","4.2","5.5"
"Spalding","2020-05-25","8","2217","1","254","5.2","5.9"
"Spalding","2020-05-26","53","2270","2","256","3.7","5.7"
"Spalding","2020-05-27","51","2321","2","258","3.8","5.9"
"Spalding","2020-05-28","37","2358","5","263","5.4","6.8"
"Spalding","2020-05-29","45","2403","3","266","5.8","6.6"
"Spalding","2020-05-30","13","2416","1","267","6.9","6.2"
"Spalding","2020-05-31","12","2428","1","268","8.1","6.1"
"Spalding","2020-06-01","77","2505","4","272","7","6.1"
"Spalding","2020-06-02","36","2541","2","274","7.3","5.5"
"Spalding","2020-06-03","48","2589","3","277","7.6","5.7"
"Spalding","2020-06-04","54","2643","2","279","6.2","5.8"
"Spalding","2020-06-05","48","2691","2","281","5.8","5.8"
"Spalding","2020-06-06","33","2724","2","283","5.6","6.2"
"Spalding","2020-06-07","23","2747","2","285","5.7","6.9"
"Spalding","2020-06-08","52","2799","3","288","5.7","6.4"
"Spalding","2020-06-09","52","2851","3","291","5.8","6.5"
"Spalding","2020-06-10","58","2909","6","297","6.4","7"
"Spalding","2020-06-11","52","2961","1","298","6.1","6.2"
"Spalding","2020-06-12","64","3025","3","301","6.2","6"
"Spalding","2020-06-13","26","3051","3","304","7","6.3"
"Spalding","2020-06-14","23","3074","2","306","7","6.3"
"Spalding","2020-06-15","68","3142","9","315","8","6.9"
"Spalding","2020-06-16","65","3207","3","318","7.9","6.8"
"Spalding","2020-06-17","63","3270","6","324","7.7","7.1"
"Spalding","2020-06-18","57","3327","4","328","8.5","7.3"
"Spalding","2020-06-19","51","3378","6","334","9.5","7.8"
"Spalding","2020-06-20","24","3402","6","340","11.4","9.2"
"Spalding","2020-06-21","12","3414","1","341","11.4","9.2"
"Spalding","2020-06-22","102","3516","18","359","12","10"
"Spalding","2020-06-23","69","3585","7","366","12.8","10.3"
"Spalding","2020-06-24","66","3651","13","379","14.2","11"
"Spalding","2020-06-25","46","3697","6","385","15.1","11.8"
"Spalding","2020-06-26","59","3756","8","393","15.3","12.4"
"Spalding","2020-06-27","40","3796","5","398","13.6","12.5"
"Spalding","2020-06-28","37","3833","11","409","16.6","14"
"Spalding","2020-06-29","111","3944","12","421","15.6","13.8"
"Spalding","2020-06-30","137","4081","21","442","16.4","14.6"
"Spalding","2020-07-01","125","4206","16","458","15.4","14.8"
"Spalding","2020-07-02","247","4453","13","471","14.3","14.7"
"Spalding","2020-07-03","71","4524","12","483","14.8","15.1"
"Spalding","2020-07-04","27","4551","5","488","15.6","14.6"
"Spalding","2020-07-05","47","4598","7","495","13.5","15.1"
"Spalding","2020-07-06","104","4702","9","504","13.2","14.4"
"Spalding","2020-07-07","113","4815","13","517","12.6","14.5"
"Spalding","2020-07-08","165","4980","14","531","12","13.7"
"Spalding","2020-07-09","108","5088","17","548","13.5","13.9"
"Spalding","2020-07-10","87","5175","14","562","13.4","14.1"
"Spalding","2020-07-11","58","5233","9","571","13","14.3"
"Spalding","2020-07-12","46","5279","14","585","15.2","14.4"
"Spalding","2020-07-13","94","5373","17","602","16.6","14.9"
"Spalding","2020-07-14","77","5450","8","610","16.4","14.5"
"Spalding","2020-07-15","158","5608","19","629","16.9","14.5"
"Spalding","2020-07-16","84","5692","12","641","16.7","15.1"
"Spalding","2020-07-17","75","5767","9","650","16.1","14.8"
"Spalding","2020-07-18","44","5811","10","660","17.1","15.1"
"Spalding","2020-07-19","47","5858","8","668","15.2","15.2"
"Spalding","2020-07-20","88","5946","16","684","15.2","15.9"
"Spalding","2020-07-21","83","6029","10","694","15.5","15.9"
"Spalding","2020-07-22","157","6186","13","707","14.9","15.9"
"Spalding","2020-07-23","115","6301","19","726","15.3","16"
"Spalding","2020-07-24","89","6390","14","740","15.8","15.9"
"Spalding","2020-07-25","52","6442","10","750","15.3","16.2"
"Spalding","2020-07-26","29","6471","5","755","15.3","15.3"
"Spalding","2020-07-27","123","6594","19","774","14.9","15.1"
"Spalding","2020-07-28","87","6681","13","787","15.3","15.4"
"Spalding","2020-07-29","197","6878","16","803","15.3","15.1"
"Spalding","2020-07-30","81","6959","10","813","14.7","15"
"Spalding","2020-07-31","64","7023","11","824","14.9","15.4"
"Spalding","2020-08-01","42","7065","13","837","16.6","15.9"
"Spalding","2020-08-02","31","7096","8","845","17.8","16.6"
"Spalding","2020-08-03","118","7214","14","859","17.3","16.1"
"Spalding","2020-08-04","83","7297","14","873","17.6","16.5"
"Spalding","2020-08-05","219","7516","17","890","17.5","16.4"
"Spalding","2020-08-06","79","7595","4","894","16.5","15.6"
"Spalding","2020-08-07","109","7704","17","911","16.3","15.6"
"Spalding","2020-08-08","96","7800","11","922","13.5","15"
"Spalding","2020-08-09","45","7845","9","931","12.7","15.2"
"Spalding","2020-08-10","91","7936","15","946","13.3","15.3"
"Spalding","2020-08-11","105","8041","8","954","12","14.8"
"Spalding","2020-08-12","188","8229","19","973","12.3","14.9"
"Spalding","2020-08-13","65","8294","6","979","12.9","14.7"
"Spalding","2020-08-14","66","8360","6","985","12","14.1"
"Spalding","2020-08-15","39","8399","7","992","12.9","13.2"
"Spalding","2020-08-16","32","8431","8","1000","13.6","13.1"
"Spalding","2020-08-17","93","8524","7","1007","12.4","12.8"
"Spalding","2020-08-18","88","8612","14","1021","13.5","12.8"
"Spalding","2020-08-19","173","8785","11","1032","13","12.7"
"Spalding","2020-08-20","81","8866","4","1036","12.4","12.7"
"Spalding","2020-08-21","303","9169","34","1070","12.7","12.3"
"Spalding","2020-08-22","61","9230","6","1076","11.5","12.2"
"Spalding","2020-08-23","98","9328","7","1083","9","11.3"
"Spalding","2020-08-24","124","9452","10","1093","9.1","10.7"
"Spalding","2020-08-25","101","9553","9","1102","8.1","10.8"
"Spalding","2020-08-26","106","9659","6","1108","8","10.5"
"Spalding","2020-08-27","92","9751","10","1118","8.8","10.6"
"Spalding","2020-08-28","102","9853","8","1126","8.3","10.5"
"Spalding","2020-08-29","65","9918","5","1131","8","9.8"
"Spalding","2020-08-30","56","9974","6","1137","8.5","8.8"
"Spalding","2020-08-31","124","10098","8","1145","8.3","8.7"
"Spalding","2020-09-01","81","10179","2","1147","7.4","7.7"
"Spalding","2020-09-02","113","10292","7","1154","7.5","7.7"
"Spalding","2020-09-03","66","10358","5","1159","7","7.9"
"Spalding","2020-09-04","151","10509","7","1166","6.5","7.4"
"Spalding","2020-09-05","89","10598","3","1169","5.9","7"
"Spalding","2020-09-06","37","10635","2","1171","5.2","6.8"
"Spalding","2020-09-07","53","10688","3","1174","5","6.7"
"Spalding","2020-09-08","99","10787","6","1180","5.6","6.5"
"Spalding","2020-09-09","127","10914","6","1186","5.3","6.4"
"Spalding","2020-09-10","103","11017","3","1189","4.7","5.8"
"Spalding","2020-09-11","92","11109","1","1190","4.2","5.4"
"Spalding","2020-09-12","27","11136","0","1190","3.7","4.8"
"Spalding","2020-09-13","41","11177","8","1198","5.7","5.4"
"Spalding","2020-09-14","87","11264","5","1203","5.7","5.4"
"Spalding","2020-09-15","98","11362","6","1209","5.7","5.6"
"Spalding","2020-09-16","122","11484","6","1215","5.8","5.6"
"Spalding","2020-09-17","71","11555","4","1219","6.1","5.4"
"Spalding","2020-09-18","83","11638","9","1228","7.5","5.9"
"Spalding","2020-09-19","68","11706","4","1232","8.4","6"
"Spalding","2020-09-20","38","11744","5","1237","7.5","6.6"
"Spalding","2020-09-21","73","11817","9","1246","8.4","7.1"
"Spalding","2020-09-22","65","11882","5","1251","8.6","7.2"
"Spalding","2020-09-23","119","12001","10","1261","9.1","7.4"
"Spalding","2020-09-24","66","12067","3","1264","9","7.6"
"Spalding","2020-09-25","124","12191","3","1267","7.8","7.7"
"Spalding","2020-09-26","76","12267","1","1268","7.1","7.8"
"Spalding","2020-09-27","22","12289","1","1269","5.9","6.7"
"Spalding","2020-09-28","85","12374","7","1276","5.3","6.9"
"Spalding","2020-09-29","98","12472","11","1287","5.8","7.2"
"Spalding","2020-09-30","92","12564","2","1289","4.9","7"
"Spalding","2020-10-01","59","12623","2","1291","4.8","6.9"
"Spalding","2020-10-02","107","12730","10","1301","5.7","6.8"
"Spalding","2020-10-03","41","12771","2","1303","6.3","6.7"
"Spalding","2020-10-04","40","12811","4","1307","7","6.5"
"Spalding","2020-10-05","97","12908","4","1311","6.4","5.9"
"Spalding","2020-10-06","113","13021","15","1326","6.7","6.3"
"Spalding","2020-10-07","97","13118","9","1335","7.8","6.3"
"Spalding","2020-10-08","85","13203","5","1340","8.1","6.4"
"Spalding","2020-10-09","102","13305","14","1354","8.7","7.2"
"Spalding","2020-10-10","68","13373","8","1362","9.7","8"
"Spalding","2020-10-11","46","13419","3","1365","9.2","8.1"
"Spalding","2020-10-12","116","13535","12","1377","10.1","8.3"
"Spalding","2020-10-13","111","13646","8","1385","9.2","8"
"Spalding","2020-10-14","91","13737","8","1393","9.2","8.5"
"Spalding","2020-10-15","90","13827","17","1410","11","9.6"
"Spalding","2020-10-16","95","13922","12","1422","10.9","9.8"
"Spalding","2020-10-17","42","13964","7","1429","11.6","10.7"
"Spalding","2020-10-18","41","14005","2","1431","11.3","10.3"
"Spalding","2020-10-19","128","14133","20","1451","12.1","11.1"
"Spalding","2020-10-20","158","14291","17","1468","12.6","10.9"
"Spalding","2020-10-21","134","14425","10","1478","12.4","10.8"
"Spalding","2020-10-22","107","14532","16","1494","11.9","11.4"
"Spalding","2020-10-23","88","14620","9","1503","11.5","11.2"
"Spalding","2020-10-24","53","14673","9","1512","11.6","11.6"
"Spalding","2020-10-25","30","14703","6","1518","13.7","12.5"
"Spalding","2020-10-26","215","14918","17","1535","12.6","12.4"
"Spalding","2020-10-27","179","15097","14","1549","12.2","12.4"
"Spalding","2020-10-28","102","15199","8","1557","12.2","12.3"
"Spalding","2020-10-29","88","15287","5","1562","10.9","11.4"
"Spalding","2020-10-30","97","15384","17","1579","12","11.7"
"Spalding","2020-10-31","63","15447","6","1585","10.9","11.2"
"Spalding","2020-11-01","32","15479","7","1592","11.2","12.4"
"Spalding","2020-11-02","111","15590","13","1605","11.7","12.2"
"Spalding","2020-11-03","207","15797","23","1628","12.2","12.2"
"Spalding","2020-11-04","100","15897","9","1637","12.3","12.3"
"Spalding","2020-11-05","91","15988","5","1642","12.3","11.6"
"Spalding","2020-11-06","122","16110","17","1659","11.8","11.9"
"Spalding","2020-11-07","53","16163","6","1665","12.1","11.5"
"Spalding","2020-11-08","57","16220","5","1670","10.2","10.7"
"Spalding","2020-11-09","108","16328","7","1677","9.4","10.6"
"Spalding","2020-11-10","198","16526","13","1690","8.8","10.5"
"Spalding","2020-11-11","94","16620","11","1701","9.2","10.8"
"Spalding","2020-11-12","97","16717","9","1710","9.7","11"
"Spalding","2020-11-13","91","16808","15","1725","10.1","10.9"
"Spalding","2020-11-14","101","16909","9","1734","9.7","10.9"
"Spalding","2020-11-15","51","16960","4","1738","9.6","9.9"
"Spalding","2020-11-16","149","17109","17","1755","10.3","9.9"
"Spalding","2020-11-17","163","17272","14","1769","10.6","9.7"
"Spalding","2020-11-18","118","17390","8","1777","9.9","9.5"
"Spalding","2020-11-19","114","17504","14","1791","10.3","10"
"Spalding","2020-11-20","108","17612","10","1801","9.3","9.7"
"Spalding","2020-11-21","108","17720","9","1810","9.2","9.5"
"Spalding","2020-11-22","47","17767","16","1826","13","11.3"
"Spalding","2020-11-23","110","17877","15","1841","13.3","11.8"
"Spalding","2020-11-24","105","17982","12","1853","13.7","12.1"
"Spalding","2020-11-25","112","18094","25","1878","15.9","12.9"
"Spalding","2020-11-26","9","18103","1","1879","15.7","13"
"Spalding","2020-11-27","93","18196","13","1892","16.4","12.9"
"Spalding","2020-11-28","67","18263","12","1904","17.8","13.5"
"Spalding","2020-11-29","61","18324","16","1920","16.7","14.8"
"Spalding","2020-11-30","139","18463","13","1933","16","14.7"
"Spalding","2020-12-01","158","18621","15","1948","15.8","14.7"
"Spalding","2020-12-02","115","18736","15","1963","14.4","15.2"
"Spalding","2020-12-03","113","18849","9","1972","14","14.9"
"Spalding","2020-12-04","129","18978","18","1990","14","15.2"
"Spalding","2020-12-05","50","19028","7","1997","13.4","15.6"
"Spalding","2020-12-06","25","19053","9","2006","14.8","15.7"
"Spalding","2020-12-07","167","19220","29","2035","16","16"
"Spalding","2020-12-08","159","19379","25","2060","16.9","16.3"
"Spalding","2020-12-09","147","19526","27","2087","17.6","16"
"Spalding","2020-12-10","131","19657","25","2112","19.2","16.6"
"Spalding","2020-12-11","140","19797","23","2135","19.6","16.8"
"Spalding","2020-12-12","88","19885","19","2154","20.7","17"
"Spalding","2020-12-13","65","19950","17","2171","19.2","17"
"Spalding","2020-12-14","192","20142","35","2206","19.4","17.7"
"Spalding","2020-12-15","255","20397","40","2246","19.4","18.1"
"Spalding","2020-12-16","188","20585","24","2270","18.6","18.1"
"Spalding","2020-12-17","124","20709","21","2291","18.3","18.7"
"Spalding","2020-12-18","142","20851","31","2322","19","19.3"
"Spalding","2020-12-19","80","20931","17","2339","19","19.8"
"Spalding","2020-12-20","41","20972","5","2344","17","18.1"
"Spalding","2020-12-21","153","21125","33","2377","17.5","18.4"
"Spalding","2020-12-22","159","21284","38","2415","18.6","19"
"Spalding","2020-12-23","160","21444","35","2450","19.9","19.2"
"Spalding","2020-12-24","72","21516","10","2460","19.5","18.9"
"Spalding","2020-12-25","19","21535","3","2463","18.6","18.8"
"Spalding","2020-12-26","57","21592","18","2481","20.1","19.5"
"Spalding","2020-12-27","44","21636","17","2498","23.9","20.4"
"Spalding","2020-12-28","163","21799","37","2535","24.1","20.8"
"Spalding","2020-12-29","227","22026","36","2571","22.9","20.8"
"Spalding","2020-12-30","140","22166","30","2601","22.8","21.4"
"Spalding","2020-12-31","118","22284","26","2627","24","21.8"
"Spalding","2021-01-01","15","22299","3","2630","24.6","21.6"
"Spalding","2021-01-02","85","22384","23","2653","24","22"
"Spalding","2021-01-03","61","22445","14","2667","21.7","22.8"
"Spalding","2021-01-04","170","22615","37","2704","21.6","22.8"
"Spalding","2021-01-05","346","22961","50","2754","21.4","22.1"
"Spalding","2021-01-06","170","23131","36","2790","21.3","22.1"
"Spalding","2021-01-07","215","23346","42","2832","21","22.5"
"Spalding","2021-01-08","214","23560","55","2887","21.8","23.2"
"Spalding","2021-01-09","85","23645","22","2909","21.6","22.8"
"Spalding","2021-01-10","58","23703","13","2922","21.6","21.6"
"Spalding","2021-01-11","174","23877","37","2959","21.5","21.5"
"Spalding","2021-01-12","150","24027","25","2984","21.8","21.6"
"Spalding","2021-01-13","134","24161","25","3009","21.4","21.4"
"Spalding","2021-01-14","148","24309","27","3036","21.3","21.1"
"Spalding","2021-01-15","110","24419","26","3062","21","21.4"
"Spalding","2021-01-16","66","24485","14","3076","20.3","21"
"Spalding","2021-01-17","47","24532","10","3086","20.1","20.8"
"Spalding","2021-01-18","139","24671","26","3112","19.8","20.6"
"Spalding","2021-01-19","221","24892","33","3145","19.5","20.7"
"Spalding","2021-01-20","145","25037","20","3165","18.8","20.1"
"Spalding","2021-01-21","116","25153","18","3183","18.4","19.9"
"Spalding","2021-01-22","149","25302","30","3213","17.9","19.5"
"Spalding","2021-01-23","41","25343","6","3219","17","18.6"
"Spalding","2021-01-24","60","25403","11","3230","16.6","18.4"
"Spalding","2021-01-25","137","25540","13","3243","15.3","17.5"
"Spalding","2021-01-26","131","25671","21","3264","15.4","17.5"
"Spalding","2021-01-27","127","25798","10","3274","14.6","16.7"
"Spalding","2021-01-28","108","25906","9","3283","13.5","16"
"Spalding","2021-01-29","133","26039","14","3297","12.2","15.1"
"Spalding","2021-01-30","49","26088","8","3305","12.4","14.7"
"Spalding","2021-01-31","50","26138","15","3320","14.1","15.3"
"Spalding","2021-02-01","128","26266","11","3331","14","14.6"
"Spalding","2021-02-02","145","26411","17","3348","13.3","14.4"
"Spalding","2021-02-03","99","26510","13","3361","14.1","14.3"
"Spalding","2021-02-04","101","26611","9","3370","14.2","13.9"
"Spalding","2021-02-05","83","26694","5","3375","13.5","12.9"
"Spalding","2021-02-06","27","26721","4","3379","13.3","12.9"
"Spalding","2021-02-07","6","26727","0","3379","9","11.6"
"Spalding","2021-02-08","0","26727","0","3379","7.8","10.9"
"Stephens","2020-02-01","0","0","0","0",".","."
"Stephens","2020-02-02","0","0","0","0",".","."
"Stephens","2020-02-03","0","0","0","0",".","."
"Stephens","2020-02-04","0","0","0","0",".","."
"Stephens","2020-02-05","0","0","0","0",".","."
"Stephens","2020-02-06","0","0","0","0",".","."
"Stephens","2020-02-07","0","0","0","0","0","."
"Stephens","2020-02-08","0","0","0","0","0","."
"Stephens","2020-02-09","0","0","0","0","0","."
"Stephens","2020-02-10","0","0","0","0","0","."
"Stephens","2020-02-11","0","0","0","0","0","."
"Stephens","2020-02-12","0","0","0","0","0","."
"Stephens","2020-02-13","0","0","0","0","0","."
"Stephens","2020-02-14","0","0","0","0","0","0"
"Stephens","2020-02-15","0","0","0","0","0","0"
"Stephens","2020-02-16","0","0","0","0","0","0"
"Stephens","2020-02-17","0","0","0","0","0","0"
"Stephens","2020-02-18","0","0","0","0","0","0"
"Stephens","2020-02-19","0","0","0","0","0","0"
"Stephens","2020-02-20","0","0","0","0","0","0"
"Stephens","2020-02-21","0","0","0","0","0","0"
"Stephens","2020-02-22","0","0","0","0","0","0"
"Stephens","2020-02-23","0","0","0","0","0","0"
"Stephens","2020-02-24","0","0","0","0","0","0"
"Stephens","2020-02-25","0","0","0","0","0","0"
"Stephens","2020-02-26","0","0","0","0","0","0"
"Stephens","2020-02-27","0","0","0","0","0","0"
"Stephens","2020-02-28","0","0","0","0","0","0"
"Stephens","2020-02-29","0","0","0","0","0","0"
"Stephens","2020-03-01","0","0","0","0","0","0"
"Stephens","2020-03-02","0","0","0","0","0","0"
"Stephens","2020-03-03","0","0","0","0","0","0"
"Stephens","2020-03-04","0","0","0","0","0","0"
"Stephens","2020-03-05","0","0","0","0","0","0"
"Stephens","2020-03-06","0","0","0","0","0","0"
"Stephens","2020-03-07","0","0","0","0","0","0"
"Stephens","2020-03-08","0","0","0","0","0","0"
"Stephens","2020-03-09","0","0","0","0","0","0"
"Stephens","2020-03-10","0","0","0","0","0","0"
"Stephens","2020-03-11","0","0","0","0","0","0"
"Stephens","2020-03-12","2","2","0","0","0","0"
"Stephens","2020-03-13","1","3","0","0","0","0"
"Stephens","2020-03-14","1","4","0","0","0","0"
"Stephens","2020-03-15","0","4","0","0","0","0"
"Stephens","2020-03-16","4","8","1","1","3.6","1.8"
"Stephens","2020-03-17","3","11","0","1","3.6","1.8"
"Stephens","2020-03-18","2","13","0","1","3.6","1.8"
"Stephens","2020-03-19","3","16","0","1","3.6","1.8"
"Stephens","2020-03-20","6","22","0","1","3.6","1.8"
"Stephens","2020-03-21","1","23","0","1","3.6","1.8"
"Stephens","2020-03-22","1","24","0","1","3.6","1.8"
"Stephens","2020-03-23","6","30","0","1","0","1.8"
"Stephens","2020-03-24","4","34","1","2","3.6","3.6"
"Stephens","2020-03-25","2","36","0","2","3.6","3.6"
"Stephens","2020-03-26","2","38","0","2","3.6","3.6"
"Stephens","2020-03-27","6","44","1","3","6","4.8"
"Stephens","2020-03-28","2","46","0","3","6","4.8"
"Stephens","2020-03-29","1","47","1","4","20.2","11.9"
"Stephens","2020-03-30","3","50","0","4","20.2","10.1"
"Stephens","2020-03-31","10","60","1","5","18.1","10.8"
"Stephens","2020-04-01","3","63","1","6","22.9","13.2"
"Stephens","2020-04-02","1","64","0","6","22.9","13.2"
"Stephens","2020-04-03","0","64","0","6","20.5","13.2"
"Stephens","2020-04-04","1","65","0","6","20.5","13.2"
"Stephens","2020-04-05","0","65","0","6","6.2","13.2"
"Stephens","2020-04-06","0","65","0","6","6.2","13.2"
"Stephens","2020-04-07","1","66","0","6","4.8","11.4"
"Stephens","2020-04-08","2","68","1","7","7.1","15"
"Stephens","2020-04-09","0","68","0","7","7.1","15"
"Stephens","2020-04-10","0","68","0","7","7.1","13.8"
"Stephens","2020-04-11","1","69","0","7","7.1","13.8"
"Stephens","2020-04-12","0","69","0","7","7.1","6.7"
"Stephens","2020-04-13","0","69","0","7","7.1","6.7"
"Stephens","2020-04-14","1","70","0","7","7.1","6"
"Stephens","2020-04-15","3","73","0","7","0","3.6"
"Stephens","2020-04-16","3","76","1","8","4.8","6"
"Stephens","2020-04-17","0","76","0","8","4.8","6"
"Stephens","2020-04-18","0","76","0","8","4.8","6"
"Stephens","2020-04-19","0","76","0","8","4.8","6"
"Stephens","2020-04-20","0","76","0","8","4.8","6"
"Stephens","2020-04-21","5","81","2","10","10.5","8.8"
"Stephens","2020-04-22","0","81","0","10","10.5","5.2"
"Stephens","2020-04-23","4","85","0","10","5.7","5.2"
"Stephens","2020-04-24","7","92","0","10","5.7","5.2"
"Stephens","2020-04-25","1","93","0","10","5.7","5.2"
"Stephens","2020-04-26","0","93","0","10","5.7","5.2"
"Stephens","2020-04-27","1","94","0","10","5.7","5.2"
"Stephens","2020-04-28","2","96","0","10","0","5.2"
"Stephens","2020-04-29","10","106","1","11","1.4","6"
"Stephens","2020-04-30","11","117","1","12","2.7","4.2"
"Stephens","2020-05-01","5","122","0","12","2.7","4.2"
"Stephens","2020-05-02","3","125","0","12","2.7","4.2"
"Stephens","2020-05-03","1","126","0","12","2.7","4.2"
"Stephens","2020-05-04","1","127","0","12","2.7","4.2"
"Stephens","2020-05-05","7","134","0","12","2.7","1.4"
"Stephens","2020-05-06","5","139","0","12","1.3","1.4"
"Stephens","2020-05-07","6","145","1","13","2.4","2.6"
"Stephens","2020-05-08","3","148","0","13","2.4","2.6"
"Stephens","2020-05-09","2","150","0","13","2.4","2.6"
"Stephens","2020-05-10","0","150","0","13","2.4","2.6"
"Stephens","2020-05-11","5","155","0","13","2.4","2.6"
"Stephens","2020-05-12","6","161","0","13","2.4","2.6"
"Stephens","2020-05-13","3","164","1","14","7.1","4.2"
"Stephens","2020-05-14","2","166","0","14","4.8","3.6"
"Stephens","2020-05-15","12","178","0","14","4.8","3.6"
"Stephens","2020-05-16","2","180","0","14","4.8","3.6"
"Stephens","2020-05-17","1","181","0","14","4.8","3.6"
"Stephens","2020-05-18","6","187","0","14","4.8","3.6"
"Stephens","2020-05-19","12","199","1","15","6","4.2"
"Stephens","2020-05-20","11","210","3","18","5.1","6.1"
"Stephens","2020-05-21","44","254","2","20","5.7","5.2"
"Stephens","2020-05-22","6","260","3","23","12.9","8.8"
"Stephens","2020-05-23","2","262","0","23","12.9","8.8"
"Stephens","2020-05-24","2","264","1","24","20","12.4"
"Stephens","2020-05-25","0","264","0","24","20","12.4"
"Stephens","2020-05-26","3","267","0","24","18.8","12.4"
"Stephens","2020-05-27","15","282","6","30","20.6","12.9"
"Stephens","2020-05-28","8","290","2","32","23.6","14.7"
"Stephens","2020-05-29","7","297","1","33","18.5","15.7"
"Stephens","2020-05-30","0","297","0","33","18.5","15.7"
"Stephens","2020-05-31","7","304","6","39","23.6","21.8"
"Stephens","2020-06-01","9","313","0","39","23.6","21.8"
"Stephens","2020-06-02","13","326","1","40","24.7","21.8"
"Stephens","2020-06-03","19","345","6","46","23.5","22.1"
"Stephens","2020-06-04","5","350","1","47","22.8","23.2"
"Stephens","2020-06-05","8","358","4","51","27.9","23.2"
"Stephens","2020-06-06","4","362","0","51","27.9","23.2"
"Stephens","2020-06-07","3","365","3","54","29.9","26.7"
"Stephens","2020-06-08","1","366","0","54","29.9","26.7"
"Stephens","2020-06-09","9","375","0","54","28.8","26.7"
"Stephens","2020-06-10","11","386","2","56","26.9","25.2"
"Stephens","2020-06-11","15","401","11","67","34.5","28.6"
"Stephens","2020-06-12","8","409","1","68","29.1","28.5"
"Stephens","2020-06-13","4","413","0","68","29.1","28.5"
"Stephens","2020-06-14","1","414","0","68","14.9","22.4"
"Stephens","2020-06-15","4","418","0","68","14.9","22.4"
"Stephens","2020-06-16","6","424","0","68","14.9","21.8"
"Stephens","2020-06-17","15","439","8","76","19.9","23.4"
"Stephens","2020-06-18","7","446","2","78","13.5","24"
"Stephens","2020-06-19","19","465","11","89","20","24.6"
"Stephens","2020-06-20","4","469","0","89","20","24.6"
"Stephens","2020-06-21","2","471","1","90","27.1","21"
"Stephens","2020-06-22","16","487","10","100","36","25.5"
"Stephens","2020-06-23","2","489","0","100","36","25.5"
"Stephens","2020-06-24","14","503","7","107","35.6","27.7"
"Stephens","2020-06-25","51","554","39","146","42.4","27.9"
"Stephens","2020-06-26","15","569","3","149","37","28.5"
"Stephens","2020-06-27","11","580","3","152","40.9","30.4"
"Stephens","2020-06-28","13","593","3","155","37","32.1"
"Stephens","2020-06-29","22","615","13","168","36.6","36.3"
"Stephens","2020-06-30","29","644","15","183","43.9","40"
"Stephens","2020-07-01","28","672","22","205","48","41.8"
"Stephens","2020-07-02","11","683","3","208","41","41.7"
"Stephens","2020-07-03","132","815","27","235","41.1","39"
"Stephens","2020-07-04","11","826","1","236","38.5","39.7"
"Stephens","2020-07-05","6","832","0","236","35.2","36.1"
"Stephens","2020-07-06","38","870","13","249","31.6","34.1"
"Stephens","2020-07-07","127","997","33","282","27.9","35.9"
"Stephens","2020-07-08","81","1078","27","309","21.5","34.8"
"Stephens","2020-07-09","18","1096","0","309","17.6","29.3"
"Stephens","2020-07-10","153","1249","55","364","19.8","30.4"
"Stephens","2020-07-11","69","1318","29","393","24.5","31.5"
"Stephens","2020-07-12","94","1412","19","412","27.4","31.3"
"Stephens","2020-07-13","25","1437","1","413","23.1","27.3"
"Stephens","2020-07-14","102","1539","35","448","24.3","26.1"
"Stephens","2020-07-15","224","1763","37","485","21.9","21.7"
"Stephens","2020-07-16","223","1986","45","530","24.7","21.2"
"Stephens","2020-07-17","284","2270","69","599","23.1","21.4"
"Stephens","2020-07-18","4","2274","0","599","17.1","20.8"
"Stephens","2020-07-19","26","2300","4","603","16.4","21.9"
"Stephens","2020-07-20","74","2374","17","620","19.1","21.1"
"Stephens","2020-07-21","52","2426","17","637","18.9","21.6"
"Stephens","2020-07-22","81","2507","33","670","22.3","22.1"
"Stephens","2020-07-23","60","2567","17","687","23.5","24.1"
"Stephens","2020-07-24","42","2609","5","692","21.7","22.4"
"Stephens","2020-07-25","63","2672","16","708","25.3","21.2"
"Stephens","2020-07-26","29","2701","16","724","31","23.7"
"Stephens","2020-07-27","70","2771","15","739","30.8","25"
"Stephens","2020-07-28","40","2811","6","745","28.3","23.6"
"Stephens","2020-07-29","41","2852","9","754","25.6","24"
"Stephens","2020-07-30","75","2927","25","779","26.3","24.9"
"Stephens","2020-07-31","35","2962","6","785","27.1","24.4"
"Stephens","2020-08-01","59","3021","22","807","28.8","27.1"
"Stephens","2020-08-02","29","3050","7","814","24.3","27.7"
"Stephens","2020-08-03","30","3080","7","821","24.6","27.7"
"Stephens","2020-08-04","24","3104","5","826","25.4","26.9"
"Stephens","2020-08-05","75","3179","20","846","26.1","25.9"
"Stephens","2020-08-06","45","3224","10","856","24.5","25.4"
"Stephens","2020-08-07","46","3270","12","868","25.8","26.4"
"Stephens","2020-08-08","42","3312","25","893","29","28.9"
"Stephens","2020-08-09","20","3332","6","899","29.8","27.1"
"Stephens","2020-08-10","77","3409","10","909","28.3","26.5"
"Stephens","2020-08-11","45","3454","10","919","28.5","27"
"Stephens","2020-08-12","55","3509","18","937","29.4","27.8"
"Stephens","2020-08-13","52","3561","12","949","29.5","27"
"Stephens","2020-08-14","38","3599","6","955","28","26.9"
"Stephens","2020-08-15","17","3616","0","955","19.5","24.3"
"Stephens","2020-08-16","65","3681","15","970","18.6","24.2"
"Stephens","2020-08-17","26","3707","3","973","18.3","23.3"
"Stephens","2020-08-18","29","3736","9","982","19.6","24.1"
"Stephens","2020-08-19","126","3862","22","1004","17.4","23.4"
"Stephens","2020-08-20","28","3890","1","1005","14.6","22.1"
"Stephens","2020-08-21","120","4010","8","1013","13.3","20.7"
"Stephens","2020-08-22","69","4079","15","1028","16.4","18"
"Stephens","2020-08-23","26","4105","2","1030","14.2","16.4"
"Stephens","2020-08-24","28","4133","8","1038","16.7","17.5"
"Stephens","2020-08-25","21","4154","9","1047","18.4","19"
"Stephens","2020-08-26","92","4246","23","1070","19.4","18.4"
"Stephens","2020-08-27","60","4306","11","1081","21.6","18.1"
"Stephens","2020-08-28","26","4332","5","1086","23.3","18.3"
"Stephens","2020-08-29","46","4378","0","1086","20.2","18.3"
"Stephens","2020-08-30","64","4442","8","1094","20.9","17.6"
"Stephens","2020-08-31","51","4493","15","1109","21","18.9"
"Stephens","2020-09-01","43","4536","10","1119","18.2","18.3"
"Stephens","2020-09-02","83","4619","11","1130","16.6","18"
"Stephens","2020-09-03","36","4655","2","1132","14.7","18.1"
"Stephens","2020-09-04","54","4709","2","1134","12.5","17.9"
"Stephens","2020-09-05","39","4748","3","1137","13.6","16.9"
"Stephens","2020-09-06","30","4778","3","1140","13.3","17.1"
"Stephens","2020-09-07","15","4793","2","1142","11","16"
"Stephens","2020-09-08","23","4816","1","1143","8.3","13.3"
"Stephens","2020-09-09","44","4860","8","1151","9","12.8"
"Stephens","2020-09-10","34","4894","6","1157","10.7","12.7"
"Stephens","2020-09-11","50","4944","7","1164","12.2","12.3"
"Stephens","2020-09-12","20","4964","2","1166","12.5","13.1"
"Stephens","2020-09-13","38","5002","4","1170","12.6","12.9"
"Stephens","2020-09-14","27","5029","3","1173","12.3","11.6"
"Stephens","2020-09-15","18","5047","3","1176","14","11.1"
"Stephens","2020-09-16","42","5089","7","1183","13.8","11.4"
"Stephens","2020-09-17","19","5108","3","1186","13.5","12.1"
"Stephens","2020-09-18","50","5158","15","1201","15.8","14"
"Stephens","2020-09-19","26","5184","5","1206","17.1","14.8"
"Stephens","2020-09-20","19","5203","5","1211","19.4","16"
"Stephens","2020-09-21","39","5242","8","1219","20.7","16.5"
"Stephens","2020-09-22","36","5278","9","1228","21.9","18"
"Stephens","2020-09-23","41","5319","18","1246","25.8","19.8"
"Stephens","2020-09-24","18","5337","2","1248","25.2","19.3"
"Stephens","2020-09-25","62","5399","15","1263","24.3","20.1"
"Stephens","2020-09-26","29","5428","8","1271","25.5","21.3"
"Stephens","2020-09-27","21","5449","4","1275","24.5","21.9"
"Stephens","2020-09-28","40","5489","5","1280","23.3","22"
"Stephens","2020-09-29","42","5531","9","1289","22.8","22.4"
"Stephens","2020-09-30","40","5571","10","1299","20.1","23"
"Stephens","2020-10-01","50","5621","16","1315","23.1","24.1"
"Stephens","2020-10-02","39","5660","8","1323","22.6","23.5"
"Stephens","2020-10-03","36","5696","14","1337","24.2","24.9"
"Stephens","2020-10-04","36","5732","7","1344","24.3","24.4"
"Stephens","2020-10-05","41","5773","10","1354","26","24.6"
"Stephens","2020-10-06","20","5793","4","1358","25.7","24.3"
"Stephens","2020-10-07","66","5859","24","1382","27.4","23.7"
"Stephens","2020-10-08","41","5900","11","1393","26.6","24.9"
"Stephens","2020-10-09","46","5946","8","1401","26.2","24.4"
"Stephens","2020-10-10","19","5965","5","1406","24.4","24.3"
"Stephens","2020-10-11","25","5990","7","1413","25.6","24.9"
"Stephens","2020-10-12","33","6023","3","1416","23.4","24.7"
"Stephens","2020-10-13","20","6043","1","1417","21.3","23.5"
"Stephens","2020-10-14","31","6074","5","1422","18.4","22.9"
"Stephens","2020-10-15","38","6112","10","1432","18.3","22.5"
"Stephens","2020-10-16","26","6138","8","1440","20.2","23.2"
"Stephens","2020-10-17","15","6153","1","1441","17.4","20.9"
"Stephens","2020-10-18","12","6165","0","1441","13.4","19.5"
"Stephens","2020-10-19","29","6194","2","1443","13.1","18.3"
"Stephens","2020-10-20","22","6216","2","1445","13.7","17.5"
"Stephens","2020-10-21","26","6242","5","1450","14.1","16.3"
"Stephens","2020-10-22","42","6284","7","1457","12.8","15.5"
"Stephens","2020-10-23","18","6302","3","1460","10.7","15.5"
"Stephens","2020-10-24","19","6321","5","1465","13.6","15.5"
"Stephens","2020-10-25","6","6327","0","1465","13.6","13.5"
"Stephens","2020-10-26","24","6351","1","1466","13.2","13.1"
"Stephens","2020-10-27","19","6370","3","1469","14.1","13.9"
"Stephens","2020-10-28","25","6395","2","1471","12.5","13.3"
"Stephens","2020-10-29","28","6423","3","1474","11.7","12.2"
"Stephens","2020-10-30","20","6443","2","1476","10.7","10.7"
"Stephens","2020-10-31","7","6450","2","1478","11","12.3"
"Stephens","2020-11-01","21","6471","6","1484","15.1","14.3"
"Stephens","2020-11-02","16","6487","0","1484","14.5","13.8"
"Stephens","2020-11-03","31","6518","3","1487","13.6","13.9"
"Stephens","2020-11-04","16","6534","2","1489","14.3","13.4"
"Stephens","2020-11-05","27","6561","3","1492","14.3","13"
"Stephens","2020-11-06","21","6582","6","1498","17","13.9"
"Stephens","2020-11-07","8","6590","1","1499","14.7","12.9"
"Stephens","2020-11-08","17","6607","4","1503","14","14.6"
"Stephens","2020-11-09","38","6645","9","1512","17.4","15.9"
"Stephens","2020-11-10","18","6663","5","1517","20","16.8"
"Stephens","2020-11-11","20","6683","3","1520","20.3","17.3"
"Stephens","2020-11-12","35","6718","7","1527","21.6","18"
"Stephens","2020-11-13","26","6744","4","1531","19.7","18.3"
"Stephens","2020-11-14","22","6766","2","1533","19.2","17"
"Stephens","2020-11-15","24","6790","3","1536","17.6","15.8"
"Stephens","2020-11-16","30","6820","4","1540","16.2","16.8"
"Stephens","2020-11-17","42","6862","7","1547","14.6","17.3"
"Stephens","2020-11-18","37","6899","5","1552","14.4","17.3"
"Stephens","2020-11-19","45","6944","5","1557","13.1","17.3"
"Stephens","2020-11-20","56","7000","5","1562","12.2","15.9"
"Stephens","2020-11-21","25","7025","4","1566","13.2","16.2"
"Stephens","2020-11-22","15","7040","3","1569","14.2","15.9"
"Stephens","2020-11-23","42","7082","4","1573","13.7","14.9"
"Stephens","2020-11-24","83","7165","14","1587","13.7","14.1"
"Stephens","2020-11-25","56","7221","11","1598","14.6","14.5"
"Stephens","2020-11-26","2","7223","1","1599","20.1","16.6"
"Stephens","2020-11-27","37","7260","13","1612","23.9","18"
"Stephens","2020-11-28","39","7299","9","1621","24.9","19"
"Stephens","2020-11-29","44","7343","14","1635","26.6","20.4"
"Stephens","2020-11-30","52","7395","6","1641","26.9","20.3"
"Stephens","2020-12-01","54","7449","9","1650","26.8","20.3"
"Stephens","2020-12-02","81","7530","16","1666","26.9","20.7"
"Stephens","2020-12-03","99","7629","22","1688","22.9","21.5"
"Stephens","2020-12-04","73","7702","15","1703","20.8","22.3"
"Stephens","2020-12-05","40","7742","11","1714","21.4","23.2"
"Stephens","2020-12-06","25","7767","7","1721","20.9","23.7"
"Stephens","2020-12-07","87","7854","21","1742","22.7","24.8"
"Stephens","2020-12-08","81","7935","15","1757","23","24.9"
"Stephens","2020-12-09","83","8018","18","1775","23.2","25"
"Stephens","2020-12-10","80","8098","21","1796","23.8","23.3"
"Stephens","2020-12-11","79","8177","24","1820","25.2","23"
"Stephens","2020-12-12","91","8268","26","1846","25.4","23.4"
"Stephens","2020-12-13","58","8326","8","1854","23.3","22.1"
"Stephens","2020-12-14","69","8395","17","1871","23.4","23"
"Stephens","2020-12-15","87","8482","24","1895","24.7","23.8"
"Stephens","2020-12-16","130","8612","27","1922","24.6","23.9"
"Stephens","2020-12-17","82","8694","16","1938","23.6","23.7"
"Stephens","2020-12-18","91","8785","21","1959","22.6","23.9"
"Stephens","2020-12-19","75","8860","21","1980","22.5","23.9"
"Stephens","2020-12-20","32","8892","13","1993","26.3","24.8"
"Stephens","2020-12-21","86","8978","25","2018","26.9","25.2"
"Stephens","2020-12-22","87","9065","19","2037","26.1","25.4"
"Stephens","2020-12-23","136","9201","38","2075","27.2","25.9"
"Stephens","2020-12-24","44","9245","12","2087","28.3","25.9"
"Stephens","2020-12-25","0","9245","0","2087","25","23.8"
"Stephens","2020-12-26","34","9279","9","2096","24.7","23.6"
"Stephens","2020-12-27","32","9311","17","2113","26.5","26.4"
"Stephens","2020-12-28","85","9396","31","2144","27.6","27.3"
"Stephens","2020-12-29","95","9491","24","2168","28.1","27.1"
"Stephens","2020-12-30","84","9575","24","2192","28.2","27.7"
"Stephens","2020-12-31","86","9661","19","2211","27.4","27.8"
"Stephens","2021-01-01","42","9703","14","2225","32.2","28.6"
"Stephens","2021-01-02","31","9734","10","2235","33","28.9"
"Stephens","2021-01-03","81","9815","35","2270","31.6","29.1"
"Stephens","2021-01-04","53","9868","9","2279","28.8","28.2"
"Stephens","2021-01-05","101","9969","22","2301","28.3","28.2"
"Stephens","2021-01-06","177","10146","45","2346","27.9","28"
"Stephens","2021-01-07","97","10243","24","2370","28.2","27.8"
"Stephens","2021-01-08","112","10355","23","2393","26.4","29.3"
"Stephens","2021-01-09","75","10430","15","2408","24.7","28.8"
"Stephens","2021-01-10","48","10478","13","2421","22.4","27"
"Stephens","2021-01-11","50","10528","17","2438","24.8","26.8"
"Stephens","2021-01-12","77","10605","23","2461","26","27.1"
"Stephens","2021-01-13","83","10688","10","2471","24","26"
"Stephens","2021-01-14","77","10765","13","2484","22.9","25.6"
"Stephens","2021-01-15","87","10852","26","2510","24.3","25.3"
"Stephens","2021-01-16","73","10925","18","2528","24.9","24.8"
"Stephens","2021-01-17","19","10944","7","2535","26.3","24.3"
"Stephens","2021-01-18","55","10999","14","2549","25.1","24.9"
"Stephens","2021-01-19","54","11053","7","2556","22.7","24.3"
"Stephens","2021-01-20","78","11131","20","2576","24.6","24.3"
"Stephens","2021-01-21","98","11229","23","2599","25.6","24.2"
"Stephens","2021-01-22","104","11333","17","2616","23.6","23.9"
"Stephens","2021-01-23","19","11352","1","2617","20.9","22.9"
"Stephens","2021-01-24","55","11407","11","2628","18.4","22.4"
"Stephens","2021-01-25","60","11467","16","2644","18.6","21.9"
"Stephens","2021-01-26","86","11553","15","2659","19.3","21"
"Stephens","2021-01-27","101","11654","18","2677","18.1","21.4"
"Stephens","2021-01-28","63","11717","14","2691","18","21.8"
"Stephens","2021-01-29","57","11774","5","2696","16.9","20.3"
"Stephens","2021-01-30","36","11810","8","2704","19.3","20.1"
"Stephens","2021-01-31","40","11850","11","2715","20.4","19.4"
"Stephens","2021-02-01","57","11907","8","2723","18.6","18.6"
"Stephens","2021-02-02","80","11987","10","2733","17.9","18.6"
"Stephens","2021-02-03","66","12053","7","2740","16.8","17.5"
"Stephens","2021-02-04","34","12087","5","2745","15.8","16.9"
"Stephens","2021-02-05","29","12116","2","2747","15.5","16.2"
"Stephens","2021-02-06","6","12122","1","2748","14.7","17"
"Stephens","2021-02-07","1","12123","0","2748","10.8","15.6"
"Stephens","2021-02-08","0","12123","0","2748","8.8","13.7"
"Stewart","2020-02-01","0","0","0","0",".","."
"Stewart","2020-02-02","0","0","0","0",".","."
"Stewart","2020-02-03","0","0","0","0",".","."
"Stewart","2020-02-04","0","0","0","0",".","."
"Stewart","2020-02-05","0","0","0","0",".","."
"Stewart","2020-02-06","0","0","0","0",".","."
"Stewart","2020-02-07","0","0","0","0","0","."
"Stewart","2020-02-08","0","0","0","0","0","."
"Stewart","2020-02-09","0","0","0","0","0","."
"Stewart","2020-02-10","0","0","0","0","0","."
"Stewart","2020-02-11","0","0","0","0","0","."
"Stewart","2020-02-12","0","0","0","0","0","."
"Stewart","2020-02-13","0","0","0","0","0","."
"Stewart","2020-02-14","0","0","0","0","0","0"
"Stewart","2020-02-15","0","0","0","0","0","0"
"Stewart","2020-02-16","0","0","0","0","0","0"
"Stewart","2020-02-17","0","0","0","0","0","0"
"Stewart","2020-02-18","0","0","0","0","0","0"
"Stewart","2020-02-19","0","0","0","0","0","0"
"Stewart","2020-02-20","0","0","0","0","0","0"
"Stewart","2020-02-21","0","0","0","0","0","0"
"Stewart","2020-02-22","0","0","0","0","0","0"
"Stewart","2020-02-23","0","0","0","0","0","0"
"Stewart","2020-02-24","0","0","0","0","0","0"
"Stewart","2020-02-25","0","0","0","0","0","0"
"Stewart","2020-02-26","0","0","0","0","0","0"
"Stewart","2020-02-27","0","0","0","0","0","0"
"Stewart","2020-02-28","0","0","0","0","0","0"
"Stewart","2020-02-29","0","0","0","0","0","0"
"Stewart","2020-03-01","0","0","0","0","0","0"
"Stewart","2020-03-02","0","0","0","0","0","0"
"Stewart","2020-03-03","0","0","0","0","0","0"
"Stewart","2020-03-04","0","0","0","0","0","0"
"Stewart","2020-03-05","0","0","0","0","0","0"
"Stewart","2020-03-06","0","0","0","0","0","0"
"Stewart","2020-03-07","0","0","0","0","0","0"
"Stewart","2020-03-08","0","0","0","0","0","0"
"Stewart","2020-03-09","0","0","0","0","0","0"
"Stewart","2020-03-10","0","0","0","0","0","0"
"Stewart","2020-03-11","0","0","0","0","0","0"
"Stewart","2020-03-12","0","0","0","0","0","0"
"Stewart","2020-03-13","0","0","0","0","0","0"
"Stewart","2020-03-14","0","0","0","0","0","0"
"Stewart","2020-03-15","0","0","0","0","0","0"
"Stewart","2020-03-16","0","0","0","0","0","0"
"Stewart","2020-03-17","2","2","0","0","0","0"
"Stewart","2020-03-18","2","4","0","0","0","0"
"Stewart","2020-03-19","2","6","0","0","0","0"
"Stewart","2020-03-20","0","6","0","0","0","0"
"Stewart","2020-03-21","0","6","0","0","0","0"
"Stewart","2020-03-22","0","6","0","0","0","0"
"Stewart","2020-03-23","2","8","0","0","0","0"
"Stewart","2020-03-24","3","11","0","0","0","0"
"Stewart","2020-03-25","2","13","0","0","0","0"
"Stewart","2020-03-26","1","14","0","0","0","0"
"Stewart","2020-03-27","3","17","3","3","14.3","7.1"
"Stewart","2020-03-28","2","19","0","3","14.3","7.1"
"Stewart","2020-03-29","0","19","0","3","14.3","7.1"
"Stewart","2020-03-30","0","19","0","3","14.3","7.1"
"Stewart","2020-03-31","1","20","0","3","14.3","7.1"
"Stewart","2020-04-01","1","21","0","3","14.3","7.1"
"Stewart","2020-04-02","0","21","0","3","14.3","7.1"
"Stewart","2020-04-03","2","23","0","3","0","7.1"
"Stewart","2020-04-04","1","24","0","3","0","7.1"
"Stewart","2020-04-05","0","24","0","3","0","7.1"
"Stewart","2020-04-06","2","26","1","4","7.1","10.7"
"Stewart","2020-04-07","1","27","0","4","7.1","10.7"
"Stewart","2020-04-08","1","28","0","4","7.1","10.7"
"Stewart","2020-04-09","3","31","0","4","7.1","10.7"
"Stewart","2020-04-10","6","37","2","6","11.9","6"
"Stewart","2020-04-11","1","38","0","6","11.9","6"
"Stewart","2020-04-12","2","40","0","6","11.9","6"
"Stewart","2020-04-13","5","45","1","7","7.6","7.4"
"Stewart","2020-04-14","2","47","0","7","7.6","7.4"
"Stewart","2020-04-15","2","49","1","8","14.8","11"
"Stewart","2020-04-16","1","50","0","8","14.8","11"
"Stewart","2020-04-17","0","50","0","8","10","11"
"Stewart","2020-04-18","1","51","0","8","10","11"
"Stewart","2020-04-19","0","51","0","8","10","11"
"Stewart","2020-04-20","4","55","1","9","10.7","9.2"
"Stewart","2020-04-21","3","58","0","9","10.7","9.2"
"Stewart","2020-04-22","3","61","0","9","3.6","9.2"
"Stewart","2020-04-23","6","67","2","11","8.3","11.5"
"Stewart","2020-04-24","3","70","1","12","13.1","11.5"
"Stewart","2020-04-25","0","70","0","12","13.1","11.5"
"Stewart","2020-04-26","2","72","0","12","13.1","11.5"
"Stewart","2020-04-27","1","73","0","12","9.5","10.1"
"Stewart","2020-04-28","0","73","0","12","9.5","10.1"
"Stewart","2020-04-29","7","80","1","13","11.6","7.6"
"Stewart","2020-04-30","6","86","0","13","6.8","7.6"
"Stewart","2020-05-01","5","91","1","14","4.9","9"
"Stewart","2020-05-02","2","93","0","14","4.9","9"
"Stewart","2020-05-03","1","94","0","14","4.9","9"
"Stewart","2020-05-04","4","98","1","15","8.5","9"
"Stewart","2020-05-05","2","100","0","15","8.5","9"
"Stewart","2020-05-06","4","104","2","17","13.6","12.6"
"Stewart","2020-05-07","3","107","1","18","18.3","12.6"
"Stewart","2020-05-08","6","113","2","20","20.2","12.6"
"Stewart","2020-05-09","1","114","1","21","34.5","19.7"
"Stewart","2020-05-10","0","114","0","21","34.5","19.7"
"Stewart","2020-05-11","2","116","0","21","31","19.7"
"Stewart","2020-05-12","3","119","1","22","35.7","22.1"
"Stewart","2020-05-13","8","127","0","22","28.6","21.1"
"Stewart","2020-05-14","2","129","0","22","23.8","21.1"
"Stewart","2020-05-15","12","141","2","24","21.4","20.8"
"Stewart","2020-05-16","2","143","0","24","7.1","20.8"
"Stewart","2020-05-17","2","145","0","24","7.1","20.8"
"Stewart","2020-05-18","9","154","1","25","8.7","19.8"
"Stewart","2020-05-19","5","159","0","25","4","19.8"
"Stewart","2020-05-20","3","162","0","25","4","16.3"
"Stewart","2020-05-21","2","164","0","25","4","13.9"
"Stewart","2020-05-22","12","176","1","26","2.8","12.1"
"Stewart","2020-05-23","0","176","0","26","2.8","5"
"Stewart","2020-05-24","1","177","0","26","2.8","5"
"Stewart","2020-05-25","0","177","0","26","1.2","5"
"Stewart","2020-05-26","3","180","1","27","6","5"
"Stewart","2020-05-27","4","184","1","28","9.5","6.7"
"Stewart","2020-05-28","8","192","0","28","9.5","6.7"
"Stewart","2020-05-29","11","203","0","28","8.3","5.6"
"Stewart","2020-05-30","2","205","0","28","8.3","5.6"
"Stewart","2020-05-31","3","208","0","28","8.3","5.6"
"Stewart","2020-06-01","5","213","2","30","14","7.6"
"Stewart","2020-06-02","5","218","0","30","9.3","7.6"
"Stewart","2020-06-03","38","256","2","32","6.5","8"
"Stewart","2020-06-04","4","260","0","32","6.5","8"
"Stewart","2020-06-05","7","267","0","32","6.5","7.4"
"Stewart","2020-06-06","0","267","0","32","6.5","7.4"
"Stewart","2020-06-07","3","270","0","32","6.5","7.4"
"Stewart","2020-06-08","8","278","0","32","0.8","7.4"
"Stewart","2020-06-09","3","281","0","32","0.8","5"
"Stewart","2020-06-10","6","287","1","33","2.4","4.4"
"Stewart","2020-06-11","7","294","0","33","2.4","4.4"
"Stewart","2020-06-12","3","297","1","34","7.1","6.8"
"Stewart","2020-06-13","2","299","0","34","7.1","6.8"
"Stewart","2020-06-14","2","301","0","34","7.1","6.8"
"Stewart","2020-06-15","3","304","0","34","7.1","3.9"
"Stewart","2020-06-16","4","308","2","36","14.3","7.5"
"Stewart","2020-06-17","17","325","4","40","15.3","8.8"
"Stewart","2020-06-18","1","326","0","40","15.3","8.8"
"Stewart","2020-06-19","15","341","1","41","11.5","9.3"
"Stewart","2020-06-20","0","341","0","41","11.5","9.3"
"Stewart","2020-06-21","1","342","0","41","11.5","9.3"
"Stewart","2020-06-22","9","351","2","43","14.6","10.9"
"Stewart","2020-06-23","4","355","1","44","11.1","12.7"
"Stewart","2020-06-24","21","376","5","49","11.1","13.2"
"Stewart","2020-06-25","6","382","1","50","13.5","14.4"
"Stewart","2020-06-26","16","398","1","51","13.4","12.4"
"Stewart","2020-06-27","1","399","1","52","27.7","19.6"
"Stewart","2020-06-28","5","404","2","54","33.4","22.4"
"Stewart","2020-06-29","129","533","67","121","37.7","26.1"
"Stewart","2020-06-30","5","538","0","121","34.1","22.6"
"Stewart","2020-07-01","24","562","4","125","33.1","22.1"
"Stewart","2020-07-02","3","565","0","125","30.7","22.1"
"Stewart","2020-07-03","5","570","2","127","35.5","24.5"
"Stewart","2020-07-04","2","572","0","127","21.2","24.5"
"Stewart","2020-07-05","4","576","0","127","15.5","24.5"
"Stewart","2020-07-06","20","596","5","132","11.7","24.7"
"Stewart","2020-07-07","3","599","0","132","11.7","22.9"
"Stewart","2020-07-08","34","633","2","134","10.1","21.6"
"Stewart","2020-07-09","4","637","0","134","10.1","20.4"
"Stewart","2020-07-10","20","657","3","137","6.6","21"
"Stewart","2020-07-11","3","660","1","138","11.3","16.3"
"Stewart","2020-07-12","2","662","0","138","11.3","13.4"
"Stewart","2020-07-13","7","669","1","139","9.8","10.7"
"Stewart","2020-07-14","0","669","0","139","9.8","10.7"
"Stewart","2020-07-15","17","686","3","142","11.5","10.8"
"Stewart","2020-07-16","2","688","0","142","11.5","10.8"
"Stewart","2020-07-17","20","708","1","143","10","8.3"
"Stewart","2020-07-18","1","709","1","144","19.6","15.4"
"Stewart","2020-07-19","3","712","2","146","29.1","20.2"
"Stewart","2020-07-20","5","717","2","148","32.8","21.3"
"Stewart","2020-07-21","2","719","0","148","32.8","21.3"
"Stewart","2020-07-22","14","733","3","151","33.3","22.4"
"Stewart","2020-07-23","8","741","2","153","36.9","24.2"
"Stewart","2020-07-24","18","759","4","157","39.3","24.7"
"Stewart","2020-07-25","3","762","1","158","29.8","24.7"
"Stewart","2020-07-26","3","765","0","158","20.3","24.7"
"Stewart","2020-07-27","3","768","0","158","14.6","23.7"
"Stewart","2020-07-28","7","775","1","159","16.6","24.7"
"Stewart","2020-07-29","12","787","4","163","18.3","25.8"
"Stewart","2020-07-30","9","796","3","166","19.5","28.2"
"Stewart","2020-07-31","2","798","0","166","16.3","27.8"
"Stewart","2020-08-01","3","801","2","168","21.1","25.4"
"Stewart","2020-08-02","2","803","0","168","21.1","20.7"
"Stewart","2020-08-03","3","806","0","168","21.1","17.8"
"Stewart","2020-08-04","4","810","1","169","22.6","19.6"
"Stewart","2020-08-05","11","821","0","169","17.9","18.1"
"Stewart","2020-08-06","7","828","3","172","19.2","19.4"
"Stewart","2020-08-07","8","836","0","172","19.2","17.8"
"Stewart","2020-08-08","0","836","0","172","9.7","15.4"
"Stewart","2020-08-09","4","840","1","173","13.3","17.2"
"Stewart","2020-08-10","6","846","1","174","15.6","18.4"
"Stewart","2020-08-11","1","847","0","174","12.1","17.3"
"Stewart","2020-08-12","19","866","1","175","12.8","15.3"
"Stewart","2020-08-13","9","875","0","175","6.7","13"
"Stewart","2020-08-14","9","884","1","176","8.3","13.8"
"Stewart","2020-08-15","2","886","1","177","15.4","12.6"
"Stewart","2020-08-16","4","890","0","177","11.9","12.6"
"Stewart","2020-08-17","3","893","0","177","9.5","12.6"
"Stewart","2020-08-18","1","894","0","177","9.5","10.8"
"Stewart","2020-08-19","1","895","0","177","8.7","10.8"
"Stewart","2020-08-20","3","898","1","178","13.5","10.1"
"Stewart","2020-08-21","23","921","0","178","11.9","10.1"
"Stewart","2020-08-22","1","922","0","178","4.8","10.1"
"Stewart","2020-08-23","3","925","0","178","4.8","8.3"
"Stewart","2020-08-24","3","928","0","178","4.8","7.1"
"Stewart","2020-08-25","3","931","0","178","4.8","7.1"
"Stewart","2020-08-26","8","939","0","178","4.8","6.7"
"Stewart","2020-08-27","2","941","0","178","0","6.7"
"Stewart","2020-08-28","7","948","1","179","2","7"
"Stewart","2020-08-29","2","950","0","179","2","3.4"
"Stewart","2020-08-30","2","952","0","179","2","3.4"
"Stewart","2020-08-31","4","956","0","179","2","3.4"
"Stewart","2020-09-01","3","959","1","180","6.8","5.8"
"Stewart","2020-09-02","6","965","0","180","6.8","5.8"
"Stewart","2020-09-03","14","979","0","180","6.8","3.4"
"Stewart","2020-09-04","6","985","0","180","4.8","3.4"
"Stewart","2020-09-05","2","987","0","180","4.8","3.4"
"Stewart","2020-09-06","2","989","0","180","4.8","3.4"
"Stewart","2020-09-07","0","989","0","180","4.8","3.4"
"Stewart","2020-09-08","3","992","0","180","0","3.4"
"Stewart","2020-09-09","9","1001","0","180","0","3.4"
"Stewart","2020-09-10","3","1004","0","180","0","3.4"
"Stewart","2020-09-11","7","1011","1","181","2","3.4"
"Stewart","2020-09-12","6","1017","1","182","4.4","4.6"
"Stewart","2020-09-13","3","1020","0","182","4.4","4.6"
"Stewart","2020-09-14","3","1023","0","182","4.4","4.6"
"Stewart","2020-09-15","1","1024","0","182","4.4","2.2"
"Stewart","2020-09-16","4","1028","0","182","4.4","2.2"
"Stewart","2020-09-17","2","1030","0","182","4.4","2.2"
"Stewart","2020-09-18","7","1037","0","182","2.4","2.2"
"Stewart","2020-09-19","0","1037","0","182","0","2.2"
"Stewart","2020-09-20","2","1039","0","182","0","2.2"
"Stewart","2020-09-21","1","1040","0","182","0","2.2"
"Stewart","2020-09-22","3","1043","0","182","0","2.2"
"Stewart","2020-09-23","8","1051","1","183","1.8","3.1"
"Stewart","2020-09-24","3","1054","0","183","1.8","3.1"
"Stewart","2020-09-25","4","1058","0","183","1.8","2.1"
"Stewart","2020-09-26","3","1061","0","183","1.8","0.9"
"Stewart","2020-09-27","1","1062","1","184","16.1","8"
"Stewart","2020-09-28","6","1068","0","184","16.1","8"
"Stewart","2020-09-29","1","1069","0","184","16.1","8"
"Stewart","2020-09-30","5","1074","0","184","14.3","8"
"Stewart","2020-10-01","3","1077","0","184","14.3","8"
"Stewart","2020-10-02","2","1079","0","184","14.3","8"
"Stewart","2020-10-03","0","1079","0","184","14.3","8"
"Stewart","2020-10-04","3","1082","0","184","0","8"
"Stewart","2020-10-05","3","1085","0","184","0","8"
"Stewart","2020-10-06","1","1086","0","184","0","8"
"Stewart","2020-10-07","9","1095","0","184","0","7.1"
"Stewart","2020-10-08","5","1100","0","184","0","7.1"
"Stewart","2020-10-09","8","1108","0","184","0","7.1"
"Stewart","2020-10-10","2","1110","0","184","0","7.1"
"Stewart","2020-10-11","2","1112","0","184","0","0"
"Stewart","2020-10-12","5","1117","0","184","0","0"
"Stewart","2020-10-13","3","1120","0","184","0","0"
"Stewart","2020-10-14","5","1125","0","184","0","0"
"Stewart","2020-10-15","7","1132","0","184","0","0"
"Stewart","2020-10-16","7","1139","1","185","2","1"
"Stewart","2020-10-17","2","1141","0","185","2","1"
"Stewart","2020-10-18","2","1143","0","185","2","1"
"Stewart","2020-10-19","3","1146","0","185","2","1"
"Stewart","2020-10-20","0","1146","0","185","2","1"
"Stewart","2020-10-21","6","1152","0","185","2","1"
"Stewart","2020-10-22","1","1153","0","185","2","1"
"Stewart","2020-10-23","2","1155","0","185","0","1"
"Stewart","2020-10-24","1","1156","0","185","0","1"
"Stewart","2020-10-25","1","1157","0","185","0","1"
"Stewart","2020-10-26","1","1158","0","185","0","1"
"Stewart","2020-10-27","3","1161","1","186","4.8","3.4"
"Stewart","2020-10-28","11","1172","2","188","7.4","4.7"
"Stewart","2020-10-29","2","1174","0","188","7.4","4.7"
"Stewart","2020-10-30","5","1179","0","188","7.4","3.7"
"Stewart","2020-10-31","2","1181","0","188","7.4","3.7"
"Stewart","2020-11-01","0","1181","0","188","7.4","3.7"
"Stewart","2020-11-02","2","1183","1","189","14.5","7.3"
"Stewart","2020-11-03","0","1183","0","189","9.7","7.3"
"Stewart","2020-11-04","5","1188","0","189","7.1","7.3"
"Stewart","2020-11-05","6","1194","0","189","7.1","7.3"
"Stewart","2020-11-06","4","1198","0","189","7.1","7.3"
"Stewart","2020-11-07","1","1199","0","189","7.1","7.3"
"Stewart","2020-11-08","3","1202","0","189","7.1","7.3"
"Stewart","2020-11-09","1","1203","0","189","0","7.3"
"Stewart","2020-11-10","2","1205","0","189","0","4.9"
"Stewart","2020-11-11","5","1210","0","189","0","3.6"
"Stewart","2020-11-12","1","1211","0","189","0","3.6"
"Stewart","2020-11-13","4","1215","0","189","0","3.6"
"Stewart","2020-11-14","2","1217","1","190","7.1","7.1"
"Stewart","2020-11-15","1","1218","0","190","7.1","7.1"
"Stewart","2020-11-16","3","1221","0","190","7.1","3.6"
"Stewart","2020-11-17","1","1222","0","190","7.1","3.6"
"Stewart","2020-11-18","5","1227","1","191","10","5"
"Stewart","2020-11-19","2","1229","0","191","10","5"
"Stewart","2020-11-20","3","1232","1","192","14.8","7.4"
"Stewart","2020-11-21","3","1235","1","193","12.4","9.8"
"Stewart","2020-11-22","1","1236","0","193","12.4","9.8"
"Stewart","2020-11-23","3","1239","0","193","12.4","9.8"
"Stewart","2020-11-24","0","1239","0","193","12.4","9.8"
"Stewart","2020-11-25","5","1244","0","193","9.5","9.8"
"Stewart","2020-11-26","2","1246","1","194","16.7","13.3"
"Stewart","2020-11-27","2","1248","0","194","11.9","13.3"
"Stewart","2020-11-28","0","1248","0","194","7.1","9.8"
"Stewart","2020-11-29","1","1249","0","194","7.1","9.8"
"Stewart","2020-11-30","6","1255","0","194","7.1","9.8"
"Stewart","2020-12-01","1","1256","0","194","7.1","9.8"
"Stewart","2020-12-02","2","1258","0","194","7.1","8.3"
"Stewart","2020-12-03","1","1259","0","194","0","8.3"
"Stewart","2020-12-04","5","1264","0","194","0","6"
"Stewart","2020-12-05","1","1265","0","194","0","3.6"
"Stewart","2020-12-06","3","1268","0","194","0","3.6"
"Stewart","2020-12-07","5","1273","2","196","5.7","6.4"
"Stewart","2020-12-08","3","1276","0","196","5.7","6.4"
"Stewart","2020-12-09","10","1286","1","197","7.1","7.1"
"Stewart","2020-12-10","8","1294","1","198","8.9","4.5"
"Stewart","2020-12-11","5","1299","0","198","8.9","4.5"
"Stewart","2020-12-12","3","1302","0","198","8.9","4.5"
"Stewart","2020-12-13","1","1303","0","198","8.9","4.5"
"Stewart","2020-12-14","4","1307","0","198","3.2","4.5"
"Stewart","2020-12-15","4","1311","0","198","3.2","4.5"
"Stewart","2020-12-16","31","1342","8","206","5.5","6.3"
"Stewart","2020-12-17","2","1344","0","206","3.7","6.3"
"Stewart","2020-12-18","4","1348","0","206","3.7","6.3"
"Stewart","2020-12-19","1","1349","0","206","3.7","6.3"
"Stewart","2020-12-20","2","1351","1","207","10.8","9.9"
"Stewart","2020-12-21","4","1355","1","208","14.4","8.8"
"Stewart","2020-12-22","6","1361","0","208","14.4","8.8"
"Stewart","2020-12-23","5","1366","0","208","10.7","8.1"
"Stewart","2020-12-24","4","1370","0","208","10.7","7.2"
"Stewart","2020-12-25","1","1371","0","208","10.7","7.2"
"Stewart","2020-12-26","3","1374","2","210","20.2","12"
"Stewart","2020-12-27","1","1375","1","211","27.4","19.1"
"Stewart","2020-12-28","4","1379","0","211","23.8","19.1"
"Stewart","2020-12-29","8","1387","2","213","27.4","20.9"
"Stewart","2020-12-30","15","1402","1","214","28.3","19.5"
"Stewart","2020-12-31","3","1405","1","215","33.1","21.9"
"Stewart","2021-01-01","3","1408","1","216","37.9","24.3"
"Stewart","2021-01-02","1","1409","1","217","42.6","31.4"
"Stewart","2021-01-03","5","1414","0","217","28.3","27.9"
"Stewart","2021-01-04","5","1419","1","218","31.2","27.5"
"Stewart","2021-01-05","13","1432","2","220","29.8","28.6"
"Stewart","2021-01-06","19","1451","2","222","30.4","29.4"
"Stewart","2021-01-07","11","1462","1","223","26.9","30"
"Stewart","2021-01-08","2","1464","1","224","29.3","33.6"
"Stewart","2021-01-09","1","1465","0","224","15","28.8"
"Stewart","2021-01-10","2","1467","1","225","22.1","25.2"
"Stewart","2021-01-11","14","1481","1","226","20.3","25.7"
"Stewart","2021-01-12","6","1487","0","226","18.1","24"
"Stewart","2021-01-13","23","1510","1","227","17.2","23.8"
"Stewart","2021-01-14","5","1515","1","228","18.8","22.8"
"Stewart","2021-01-15","3","1518","0","228","11.6","20.5"
"Stewart","2021-01-16","2","1520","2","230","25.9","20.5"
"Stewart","2021-01-17","2","1522","2","232","33.1","27.6"
"Stewart","2021-01-18","7","1529","1","233","34.1","27.2"
"Stewart","2021-01-19","5","1534","1","234","36.9","27.5"
"Stewart","2021-01-20","26","1560","1","235","36.9","27.1"
"Stewart","2021-01-21","4","1564","0","235","34","26.4"
"Stewart","2021-01-22","4","1568","1","236","37.6","24.6"
"Stewart","2021-01-23","6","1574","1","237","25.7","25.8"
"Stewart","2021-01-24","1","1575","1","238","25.7","29.4"
"Stewart","2021-01-25","4","1579","0","238","23.6","28.9"
"Stewart","2021-01-26","6","1585","2","240","25.5","31.2"
"Stewart","2021-01-27","19","1604","3","243","27.3","32.1"
"Stewart","2021-01-28","4","1608","0","243","27.3","30.6"
"Stewart","2021-01-29","4","1612","2","245","30.8","34.2"
"Stewart","2021-01-30","4","1616","1","246","32","28.9"
"Stewart","2021-01-31","2","1618","0","246","17.7","21.7"
"Stewart","2021-02-01","3","1621","0","246","17.7","20.7"
"Stewart","2021-02-02","4","1625","0","246","13","19.3"
"Stewart","2021-02-03","14","1639","3","249","13.8","20.5"
"Stewart","2021-02-04","2","1641","0","249","13.8","20.5"
"Stewart","2021-02-05","0","1641","0","249","6.6","18.7"
"Stewart","2021-02-06","0","1641","0","249","3.1","17.5"
"Stewart","2021-02-07","0","1641","0","249","3.1","10.4"
"Stewart","2021-02-08","0","1641","0","249","3.1","10.4"
"Sumter","2020-02-01","0","0","0","0",".","."
"Sumter","2020-02-02","0","0","0","0",".","."
"Sumter","2020-02-03","0","0","0","0",".","."
"Sumter","2020-02-04","0","0","0","0",".","."
"Sumter","2020-02-05","0","0","0","0",".","."
"Sumter","2020-02-06","0","0","0","0",".","."
"Sumter","2020-02-07","0","0","0","0","0","."
"Sumter","2020-02-08","0","0","0","0","0","."
"Sumter","2020-02-09","0","0","0","0","0","."
"Sumter","2020-02-10","0","0","0","0","0","."
"Sumter","2020-02-11","0","0","0","0","0","."
"Sumter","2020-02-12","0","0","0","0","0","."
"Sumter","2020-02-13","0","0","0","0","0","."
"Sumter","2020-02-14","0","0","0","0","0","0"
"Sumter","2020-02-15","0","0","0","0","0","0"
"Sumter","2020-02-16","0","0","0","0","0","0"
"Sumter","2020-02-17","0","0","0","0","0","0"
"Sumter","2020-02-18","0","0","0","0","0","0"
"Sumter","2020-02-19","0","0","0","0","0","0"
"Sumter","2020-02-20","0","0","0","0","0","0"
"Sumter","2020-02-21","0","0","0","0","0","0"
"Sumter","2020-02-22","0","0","0","0","0","0"
"Sumter","2020-02-23","0","0","0","0","0","0"
"Sumter","2020-02-24","0","0","0","0","0","0"
"Sumter","2020-02-25","0","0","0","0","0","0"
"Sumter","2020-02-26","0","0","0","0","0","0"
"Sumter","2020-02-27","0","0","0","0","0","0"
"Sumter","2020-02-28","0","0","0","0","0","0"
"Sumter","2020-02-29","0","0","0","0","0","0"
"Sumter","2020-03-01","0","0","0","0","0","0"
"Sumter","2020-03-02","0","0","0","0","0","0"
"Sumter","2020-03-03","0","0","0","0","0","0"
"Sumter","2020-03-04","0","0","0","0","0","0"
"Sumter","2020-03-05","0","0","0","0","0","0"
"Sumter","2020-03-06","0","0","0","0","0","0"
"Sumter","2020-03-07","0","0","0","0","0","0"
"Sumter","2020-03-08","0","0","0","0","0","0"
"Sumter","2020-03-09","0","0","0","0","0","0"
"Sumter","2020-03-10","0","0","0","0","0","0"
"Sumter","2020-03-11","0","0","0","0","0","0"
"Sumter","2020-03-12","2","2","0","0","0","0"
"Sumter","2020-03-13","8","10","1","1","1.8","0.9"
"Sumter","2020-03-14","5","15","1","2","4.6","2.3"
"Sumter","2020-03-15","4","19","1","3","8.2","4.1"
"Sumter","2020-03-16","8","27","2","5","11.8","5.9"
"Sumter","2020-03-17","4","31","2","7","18.9","9.5"
"Sumter","2020-03-18","8","39","5","12","27.9","13.9"
"Sumter","2020-03-19","10","49","4","16","33.6","16.8"
"Sumter","2020-03-20","14","63","4","20","35.9","18.8"
"Sumter","2020-03-21","8","71","4","24","40.2","22.4"
"Sumter","2020-03-22","6","77","3","27","43.7","26"
"Sumter","2020-03-23","21","98","8","35","45.6","28.7"
"Sumter","2020-03-24","44","142","12","47","42.3","30.6"
"Sumter","2020-03-25","24","166","10","57","39.4","33.6"
"Sumter","2020-03-26","32","198","15","72","40.4","37"
"Sumter","2020-03-27","29","227","10","82","41.2","38.5"
"Sumter","2020-03-28","18","245","9","91","41.2","40.7"
"Sumter","2020-03-29","7","252","4","95","42.2","43"
"Sumter","2020-03-30","37","289","15","110","42.6","44.1"
"Sumter","2020-03-31","12","301","10","120","50.6","46.5"
"Sumter","2020-04-01","49","350","17","137","49.6","44.5"
"Sumter","2020-04-02","49","399","22","159","49.3","44.8"
"Sumter","2020-04-03","30","429","15","174","51.5","46.4"
"Sumter","2020-04-04","32","461","16","190","51.5","46.4"
"Sumter","2020-04-05","9","470","4","194","49.7","46"
"Sumter","2020-04-06","61","531","29","223","50.7","46.6"
"Sumter","2020-04-07","54","585","17","240","43.3","46.9"
"Sumter","2020-04-08","22","607","8","248","43.5","46.6"
"Sumter","2020-04-09","60","667","18","266","41.4","45.4"
"Sumter","2020-04-10","40","707","11","277","38.2","44.9"
"Sumter","2020-04-11","13","720","5","282","36.5","44"
"Sumter","2020-04-12","10","730","5","287","37.3","43.5"
"Sumter","2020-04-13","42","772","10","297","33.9","42.3"
"Sumter","2020-04-14","88","860","19","316","32.5","37.9"
"Sumter","2020-04-15","56","916","9","325","29.6","36.6"
"Sumter","2020-04-16","64","980","20","345","29.8","35.6"
"Sumter","2020-04-17","64","1044","7","352","27.4","32.8"
"Sumter","2020-04-18","17","1061","2","354","23.6","30.1"
"Sumter","2020-04-19","17","1078","1","355","17.3","27.3"
"Sumter","2020-04-20","43","1121","10","365","17.3","25.6"
"Sumter","2020-04-21","53","1174","11","376","17.1","24.8"
"Sumter","2020-04-22","45","1219","7","383","17.1","23.3"
"Sumter","2020-04-23","38","1257","6","389","14.8","22.3"
"Sumter","2020-04-24","54","1311","15","404","17.3","22.4"
"Sumter","2020-04-25","21","1332","3","407","17.6","20.6"
"Sumter","2020-04-26","17","1349","3","410","19.3","18.3"
"Sumter","2020-04-27","87","1436","11","421","17.8","17.5"
"Sumter","2020-04-28","40","1476","7","428","17.3","17.2"
"Sumter","2020-04-29","55","1531","9","437","17.4","17.2"
"Sumter","2020-04-30","20","1551","4","441","18","16.4"
"Sumter","2020-05-01","50","1601","2","443","14.6","15.9"
"Sumter","2020-05-02","23","1624","1","444","13.2","15.4"
"Sumter","2020-05-03","14","1638","2","446","12.7","16"
"Sumter","2020-05-04","79","1717","16","462","13.8","15.8"
"Sumter","2020-05-05","75","1792","4","466","12.1","14.7"
"Sumter","2020-05-06","45","1837","2","468","10.4","13.9"
"Sumter","2020-05-07","17","1854","1","469","8.4","13.2"
"Sumter","2020-05-08","23","1877","1","470","8.4","11.5"
"Sumter","2020-05-09","7","1884","2","472","11.9","12.5"
"Sumter","2020-05-10","14","1898","0","472","9.8","11.3"
"Sumter","2020-05-11","38","1936","7","479","9.6","11.7"
"Sumter","2020-05-12","44","1980","6","485","10.8","11.4"
"Sumter","2020-05-13","93","2073","13","498","12.1","11.3"
"Sumter","2020-05-14","90","2163","10","508","12.9","10.6"
"Sumter","2020-05-15","38","2201","12","520","16.8","12.6"
"Sumter","2020-05-16","6","2207","0","520","12.7","12.3"
"Sumter","2020-05-17","27","2234","2","522","13.7","11.8"
"Sumter","2020-05-18","137","2371","9","531","12","10.8"
"Sumter","2020-05-19","157","2528","7","538","10.7","10.7"
"Sumter","2020-05-20","110","2638","5","543","9.4","10.8"
"Sumter","2020-05-21","96","2734","3","546","8.2","10.6"
"Sumter","2020-05-22","57","2791","4","550","4.7","10.7"
"Sumter","2020-05-23","19","2810","0","550","4.7","8.7"
"Sumter","2020-05-24","30","2840","3","553","5.1","9.4"
"Sumter","2020-05-25","32","2872","1","554","4.6","8.3"
"Sumter","2020-05-26","64","2936","8","562","5.8","8.2"
"Sumter","2020-05-27","116","3052","6","568","5.8","7.6"
"Sumter","2020-05-28","112","3164","1","569","5.5","6.9"
"Sumter","2020-05-29","55","3219","2","571","5","4.9"
"Sumter","2020-05-30","33","3252","0","571","5","4.9"
"Sumter","2020-05-31","29","3281","0","571","3.6","4.4"
"Sumter","2020-06-01","45","3326","0","571","3.2","3.9"
"Sumter","2020-06-02","146","3472","4","575","1.8","3.8"
"Sumter","2020-06-03","63","3535","2","577","1.5","3.7"
"Sumter","2020-06-04","121","3656","3","580","1.7","3.6"
"Sumter","2020-06-05","90","3746","1","581","1.4","3.2"
"Sumter","2020-06-06","35","3781","2","583","2.2","3.6"
"Sumter","2020-06-07","22","3803","1","584","2.8","3.2"
"Sumter","2020-06-08","54","3857","1","585","3.1","3.1"
"Sumter","2020-06-09","104","3961","5","590","3.4","2.6"
"Sumter","2020-06-10","62","4023","6","596","4.3","2.9"
"Sumter","2020-06-11","97","4120","17","613","6.5","4.1"
"Sumter","2020-06-12","51","4171","2","615","6.9","4.1"
"Sumter","2020-06-13","22","4193","1","616","6.7","4.4"
"Sumter","2020-06-14","21","4214","0","616","6","4.4"
"Sumter","2020-06-15","77","4291","7","623","7.1","5.1"
"Sumter","2020-06-16","104","4395","3","626","6.8","5.1"
"Sumter","2020-06-17","57","4452","3","629","6.2","5.2"
"Sumter","2020-06-18","119","4571","3","632","4","5.2"
"Sumter","2020-06-19","64","4635","6","638","4.8","5.8"
"Sumter","2020-06-20","12","4647","0","638","4.2","5.4"
"Sumter","2020-06-21","20","4667","0","638","4.2","5.1"
"Sumter","2020-06-22","100","4767","15","653","5","6"
"Sumter","2020-06-23","87","4854","2","655","4.9","5.9"
"Sumter","2020-06-24","68","4922","6","661","5.4","5.8"
"Sumter","2020-06-25","48","4970","4","665","6.3","5.1"
"Sumter","2020-06-26","54","5024","1","666","5.2","5"
"Sumter","2020-06-27","27","5051","2","668","6.2","5.2"
"Sumter","2020-06-28","26","5077","1","669","6.8","5.5"
"Sumter","2020-06-29","65","5142","7","676","6.2","5.6"
"Sumter","2020-06-30","177","5319","13","689","6.9","5.9"
"Sumter","2020-07-01","75","5394","10","699","7.6","6.5"
"Sumter","2020-07-02","60","5454","6","705","7.8","7"
"Sumter","2020-07-03","36","5490","5","710","9.5","7.3"
"Sumter","2020-07-04","23","5513","3","713","10.3","8.3"
"Sumter","2020-07-05","19","5532","3","716","12","9.4"
"Sumter","2020-07-06","139","5671","8","724","11.3","8.7"
"Sumter","2020-07-07","76","5747","1","725","10.4","8.7"
"Sumter","2020-07-08","114","5861","3","728","8.9","8.2"
"Sumter","2020-07-09","56","5917","4","732","8.5","8.2"
"Sumter","2020-07-10","100","6017","8","740","7.7","8.6"
"Sumter","2020-07-11","34","6051","3","743","7.1","8.7"
"Sumter","2020-07-12","29","6080","0","743","4.8","8.4"
"Sumter","2020-07-13","105","6185","10","753","5.3","8.3"
"Sumter","2020-07-14","71","6256","5","758","6.2","8.3"
"Sumter","2020-07-15","98","6354","7","765","6.8","7.9"
"Sumter","2020-07-16","68","6422","0","765","5.8","7.1"
"Sumter","2020-07-17","64","6486","8","773","6.4","7.1"
"Sumter","2020-07-18","21","6507","3","776","7.2","7.1"
"Sumter","2020-07-19","25","6532","2","778","8.4","6.6"
"Sumter","2020-07-20","60","6592","4","782","7.9","6.6"
"Sumter","2020-07-21","82","6674","10","792","8.7","7.4"
"Sumter","2020-07-22","136","6810","6","798","8.3","7.6"
"Sumter","2020-07-23","75","6885","11","809","10.4","8.1"
"Sumter","2020-07-24","57","6942","5","814","9.9","8.1"
"Sumter","2020-07-25","33","6975","1","815","8.2","7.7"
"Sumter","2020-07-26","19","6994","4","819","10.1","9.2"
"Sumter","2020-07-27","113","7107","10","829","10.4","9.2"
"Sumter","2020-07-28","68","7175","6","835","9.9","9.3"
"Sumter","2020-07-29","65","7240","6","841","10.6","9.5"
"Sumter","2020-07-30","62","7302","14","855","11.8","11.1"
"Sumter","2020-07-31","46","7348","3","858","11.4","10.6"
"Sumter","2020-08-01","40","7388","3","861","12.1","10.2"
"Sumter","2020-08-02","14","7402","2","863","11.1","10.6"
"Sumter","2020-08-03","124","7526","5","868","10.4","10.4"
"Sumter","2020-08-04","45","7571","3","871","10.1","10"
"Sumter","2020-08-05","121","7692","7","878","9.6","10.1"
"Sumter","2020-08-06","104","7796","9","887","7.6","9.7"
"Sumter","2020-08-07","121","7917","7","894","7.5","9.5"
"Sumter","2020-08-08","49","7966","1","895","6.7","9.4"
"Sumter","2020-08-09","51","8017","4","899","5.8","8.5"
"Sumter","2020-08-10","180","8197","7","906","5.8","8.1"
"Sumter","2020-08-11","93","8290","3","909","5.3","7.7"
"Sumter","2020-08-12","103","8393","8","917","5.6","7.6"
"Sumter","2020-08-13","94","8487","4","921","5","6.3"
"Sumter","2020-08-14","137","8624","4","925","4.6","6"
"Sumter","2020-08-15","31","8655","1","926","4.7","5.7"
"Sumter","2020-08-16","44","8699","4","930","4.9","5.4"
"Sumter","2020-08-17","65","8764","3","933","5","5.4"
"Sumter","2020-08-18","162","8926","10","943","5.4","5.4"
"Sumter","2020-08-19","184","9110","8","951","4.9","5.3"
"Sumter","2020-08-20","57","9167","2","953","4.8","4.9"
"Sumter","2020-08-21","113","9280","7","960","5.3","4.9"
"Sumter","2020-08-22","22","9302","4","964","7.4","6.1"
"Sumter","2020-08-23","23","9325","2","966","7.4","6.1"
"Sumter","2020-08-24","94","9419","11","977","8.4","6.7"
"Sumter","2020-08-25","38","9457","5","982","9.4","7.4"
"Sumter","2020-08-26","89","9546","2","984","9.1","7"
"Sumter","2020-08-27","53","9599","3","987","9.4","7.1"
"Sumter","2020-08-28","72","9671","8","995","10.1","7.7"
"Sumter","2020-08-29","18","9689","1","996","8.3","7.9"
"Sumter","2020-08-30","17","9706","2","998","8.7","8.1"
"Sumter","2020-08-31","95","9801","8","1006","8.3","8.3"
"Sumter","2020-09-01","40","9841","3","1009","7.5","8.4"
"Sumter","2020-09-02","72","9913","4","1013","7.9","8.5"
"Sumter","2020-09-03","62","9975","3","1016","7.8","8.6"
"Sumter","2020-09-04","108","10083","11","1027","7.7","8.9"
"Sumter","2020-09-05","137","10220","0","1027","6.9","7.6"
"Sumter","2020-09-06","69","10289","3","1030","5.8","7.3"
"Sumter","2020-09-07","16","10305","0","1030","4.6","6.5"
"Sumter","2020-09-08","129","10434","11","1041","4.8","6.1"
"Sumter","2020-09-09","105","10539","5","1046","4.7","6.3"
"Sumter","2020-09-10","70","10609","2","1048","4.4","6.1"
"Sumter","2020-09-11","84","10693","4","1052","3.6","5.6"
"Sumter","2020-09-12","60","10753","0","1052","3.6","5.3"
"Sumter","2020-09-13","32","10785","1","1053","3.4","4.6"
"Sumter","2020-09-14","111","10896","7","1060","4.3","4.5"
"Sumter","2020-09-15","51","10947","0","1060","3.1","3.9"
"Sumter","2020-09-16","91","11038","1","1061","2.6","3.6"
"Sumter","2020-09-17","123","11161","4","1065","2.6","3.5"
"Sumter","2020-09-18","189","11350","4","1069","2.3","2.9"
"Sumter","2020-09-19","49","11399","0","1069","2.3","2.9"
"Sumter","2020-09-20","18","11417","0","1069","1.8","2.6"
"Sumter","2020-09-21","61","11478","2","1071","1.4","2.9"
"Sumter","2020-09-22","38","11516","1","1072","1.8","2.4"
"Sumter","2020-09-23","53","11569","2","1074","2.2","2.4"
"Sumter","2020-09-24","57","11626","2","1076","2.2","2.4"
"Sumter","2020-09-25","99","11725","2","1078","2.2","2.2"
"Sumter","2020-09-26","27","11752","0","1078","2.2","2.2"
"Sumter","2020-09-27","16","11768","2","1080","4","2.9"
"Sumter","2020-09-28","58","11826","3","1083","4.2","2.8"
"Sumter","2020-09-29","37","11863","1","1084","4.2","3"
"Sumter","2020-09-30","66","11929","1","1085","3.9","3"
"Sumter","2020-10-01","48","11977","1","1086","3.7","3"
"Sumter","2020-10-02","50","12027","1","1087","3.7","2.9"
"Sumter","2020-10-03","22","12049","0","1087","3.7","2.9"
"Sumter","2020-10-04","27","12076","1","1088","2.5","3.2"
"Sumter","2020-10-05","66","12142","0","1088","1.7","3"
"Sumter","2020-10-06","28","12170","1","1089","1.8","3"
"Sumter","2020-10-07","279","12449","3","1092","1.8","2.8"
"Sumter","2020-10-08","44","12493","3","1095","2.5","3.1"
"Sumter","2020-10-09","94","12587","2","1097","2.5","3.1"
"Sumter","2020-10-10","51","12638","2","1099","3","3.4"
"Sumter","2020-10-11","45","12683","1","1100","2.8","2.6"
"Sumter","2020-10-12","83","12766","1","1101","3","2.4"
"Sumter","2020-10-13","83","12849","1","1102","2.7","2.2"
"Sumter","2020-10-14","111","12960","0","1102","2.5","2.1"
"Sumter","2020-10-15","99","13059","3","1105","2","2.2"
"Sumter","2020-10-16","148","13207","3","1108","1.9","2.2"
"Sumter","2020-10-17","53","13260","1","1109","1.7","2.3"
"Sumter","2020-10-18","16","13276","3","1112","4","3.4"
"Sumter","2020-10-19","50","13326","0","1112","3.8","3.4"
"Sumter","2020-10-20","42","13368","0","1112","3.7","3.2"
"Sumter","2020-10-21","62","13430","0","1112","3.7","3.1"
"Sumter","2020-10-22","41","13471","1","1113","3.6","2.8"
"Sumter","2020-10-23","40","13511","2","1115","4","3"
"Sumter","2020-10-24","20","13531","0","1115","3.7","2.7"
"Sumter","2020-10-25","16","13547","0","1115","1.1","2.5"
"Sumter","2020-10-26","63","13610","2","1117","1.5","2.7"
"Sumter","2020-10-27","40","13650","2","1119","2.2","3"
"Sumter","2020-10-28","69","13719","3","1122","2.9","3.3"
"Sumter","2020-10-29","36","13755","2","1124","3.3","3.4"
"Sumter","2020-10-30","38","13793","3","1127","3.7","3.9"
"Sumter","2020-10-31","27","13820","0","1127","3.7","3.7"
"Sumter","2020-11-01","20","13840","0","1127","3.7","2.4"
"Sumter","2020-11-02","81","13921","2","1129","3.6","2.6"
"Sumter","2020-11-03","33","13954","2","1131","3.8","3"
"Sumter","2020-11-04","60","14014","0","1131","3.1","3"
"Sumter","2020-11-05","43","14057","0","1131","2.3","2.8"
"Sumter","2020-11-06","44","14101","1","1132","1.5","2.6"
"Sumter","2020-11-07","20","14121","0","1132","1.5","2.6"
"Sumter","2020-11-08","17","14138","1","1133","2.4","3"
"Sumter","2020-11-09","84","14222","4","1137","2.7","3.2"
"Sumter","2020-11-10","53","14275","2","1139","2.4","3.1"
"Sumter","2020-11-11","92","14367","2","1141","2.7","2.9"
"Sumter","2020-11-12","71","14438","4","1145","3.5","2.9"
"Sumter","2020-11-13","122","14560","0","1145","3.2","2.4"
"Sumter","2020-11-14","76","14636","0","1145","3.2","2.4"
"Sumter","2020-11-15","72","14708","5","1150","3.3","2.9"
"Sumter","2020-11-16","88","14796","4","1154","3.3","3"
"Sumter","2020-11-17","98","14894","1","1155","2.9","2.6"
"Sumter","2020-11-18","213","15107","5","1160","2.9","2.8"
"Sumter","2020-11-19","63","15170","5","1165","3.3","3.4"
"Sumter","2020-11-20","31","15201","1","1166","3.7","3.4"
"Sumter","2020-11-21","18","15219","0","1166","3.7","3.4"
"Sumter","2020-11-22","15","15234","4","1170","6.5","4.9"
"Sumter","2020-11-23","120","15354","10","1180","7.1","5.2"
"Sumter","2020-11-24","78","15432","4","1184","7.7","5.3"
"Sumter","2020-11-25","110","15542","11","1195","8.8","5.8"
"Sumter","2020-11-26","127","15669","2","1197","7.8","5.6"
"Sumter","2020-11-27","44","15713","4","1201","8.7","6.2"
"Sumter","2020-11-28","29","15742","1","1202","9.2","6.4"
"Sumter","2020-11-29","20","15762","2","1204","6.8","6.7"
"Sumter","2020-11-30","165","15927","13","1217","6.7","6.9"
"Sumter","2020-12-01","69","15996","6","1223","7.2","7.5"
"Sumter","2020-12-02","195","16191","10","1233","6.5","7.7"
"Sumter","2020-12-03","81","16272","6","1239","7.4","7.6"
"Sumter","2020-12-04","107","16379","11","1250","7.5","8.1"
"Sumter","2020-12-05","118","16497","7","1257","7.9","8.5"
"Sumter","2020-12-06","57","16554","2","1259","7","6.9"
"Sumter","2020-12-07","158","16712","14","1273","7.1","6.9"
"Sumter","2020-12-08","114","16826","11","1284","7.3","7.2"
"Sumter","2020-12-09","177","17003","19","1303","8.1","7.3"
"Sumter","2020-12-10","126","17129","4","1307","7.4","7.4"
"Sumter","2020-12-11","277","17406","14","1321","6.7","7.1"
"Sumter","2020-12-12","28","17434","4","1325","7.9","7.9"
"Sumter","2020-12-13","26","17460","4","1329","9.6","8.3"
"Sumter","2020-12-14","173","17633","28","1357","10.6","8.9"
"Sumter","2020-12-15","83","17716","6","1363","10.3","8.8"
"Sumter","2020-12-16","263","17979","15","1378","9.6","8.8"
"Sumter","2020-12-17","207","18186","13","1391","10","8.7"
"Sumter","2020-12-18","85","18271","5","1396","10.1","8.4"
"Sumter","2020-12-19","74","18345","9","1405","9.8","8.9"
"Sumter","2020-12-20","75","18420","5","1410","8.6","9.1"
"Sumter","2020-12-21","159","18579","18","1428","7.9","9.3"
"Sumter","2020-12-22","116","18695","14","1442","8.6","9.4"
"Sumter","2020-12-23","463","19158","23","1465","8.5","9"
"Sumter","2020-12-24","201","19359","10","1475","8.3","9.2"
"Sumter","2020-12-25","10","19369","0","1475","7.5","8.8"
"Sumter","2020-12-26","29","19398","4","1479","7.7","8.8"
"Sumter","2020-12-27","24","19422","7","1486","10.9","9.7"
"Sumter","2020-12-28","146","19568","18","1504","11","9.5"
"Sumter","2020-12-29","98","19666","13","1517","11.2","9.9"
"Sumter","2020-12-30","467","20133","22","1539","11.2","9.8"
"Sumter","2020-12-31","248","20381","14","1553","11.3","9.8"
"Sumter","2021-01-01","21","20402","2","1555","12.6","10"
"Sumter","2021-01-02","12","20414","4","1559","15.4","11.6"
"Sumter","2021-01-03","39","20453","10","1569","14.9","12.9"
"Sumter","2021-01-04","245","20698","43","1612","15.7","13.4"
"Sumter","2021-01-05","129","20827","14","1626","15.3","13.3"
"Sumter","2021-01-06","482","21309","26","1652","15.4","13.3"
"Sumter","2021-01-07","254","21563","12","1664","15.3","13.3"
"Sumter","2021-01-08","51","21614","10","1674","16.7","14.7"
"Sumter","2021-01-09","40","21654","7","1681","14.5","14.9"
"Sumter","2021-01-10","40","21694","4","1685","12.2","13.6"
"Sumter","2021-01-11","147","21841","31","1716","12.7","14.2"
"Sumter","2021-01-12","118","21959","14","1730","12.9","14.1"
"Sumter","2021-01-13","442","22401","27","1757","13","14.2"
"Sumter","2021-01-14","204","22605","19","1776","13.6","14.5"
"Sumter","2021-01-15","150","22755","18","1794","12.6","14.6"
"Sumter","2021-01-16","62","22817","8","1802","11.9","13.2"
"Sumter","2021-01-17","24","22841","2","1804","11.7","11.9"
"Sumter","2021-01-18","69","22910","10","1814","10.7","11.7"
"Sumter","2021-01-19","92","23002","9","1823","10.4","11.7"
"Sumter","2021-01-20","323","23325","12","1835","10.1","11.5"
"Sumter","2021-01-21","150","23475","12","1847","9.9","11.8"
"Sumter","2021-01-22","259","23734","11","1858","8.8","10.7"
"Sumter","2021-01-23","57","23791","3","1861","7.7","9.8"
"Sumter","2021-01-24","19","23810","3","1864","8.8","10.2"
"Sumter","2021-01-25","144","23954","14","1878","8.1","9.4"
"Sumter","2021-01-26","219","24173","9","1887","7.3","8.8"
"Sumter","2021-01-27","180","24353","10","1897","7.5","8.8"
"Sumter","2021-01-28","260","24613","7","1904","6.8","8.3"
"Sumter","2021-01-29","103","24716","7","1911","7.1","8"
"Sumter","2021-01-30","28","24744","4","1915","8.4","8.1"
"Sumter","2021-01-31","19","24763","3","1918","8.4","8.6"
"Sumter","2021-02-01","75","24838","8","1926","8.6","8.3"
"Sumter","2021-02-02","96","24934","7","1933","9","8.1"
"Sumter","2021-02-03","186","25120","11","1944","9.1","8.3"
"Sumter","2021-02-04","82","25202","8","1952","10.1","8.4"
"Sumter","2021-02-05","64","25266","6","1958","10.4","8.8"
"Sumter","2021-02-06","87","25353","1","1959","8.6","8.5"
"Sumter","2021-02-07","8","25361","1","1960","8.1","8.3"
"Sumter","2021-02-08","0","25361","0","1960","6.6","7.6"
"Talbot","2020-02-01","0","0","0","0",".","."
"Talbot","2020-02-02","0","0","0","0",".","."
"Talbot","2020-02-03","0","0","0","0",".","."
"Talbot","2020-02-04","0","0","0","0",".","."
"Talbot","2020-02-05","0","0","0","0",".","."
"Talbot","2020-02-06","0","0","0","0",".","."
"Talbot","2020-02-07","0","0","0","0","0","."
"Talbot","2020-02-08","0","0","0","0","0","."
"Talbot","2020-02-09","0","0","0","0","0","."
"Talbot","2020-02-10","0","0","0","0","0","."
"Talbot","2020-02-11","0","0","0","0","0","."
"Talbot","2020-02-12","0","0","0","0","0","."
"Talbot","2020-02-13","0","0","0","0","0","."
"Talbot","2020-02-14","0","0","0","0","0","0"
"Talbot","2020-02-15","0","0","0","0","0","0"
"Talbot","2020-02-16","0","0","0","0","0","0"
"Talbot","2020-02-17","0","0","0","0","0","0"
"Talbot","2020-02-18","0","0","0","0","0","0"
"Talbot","2020-02-19","0","0","0","0","0","0"
"Talbot","2020-02-20","0","0","0","0","0","0"
"Talbot","2020-02-21","0","0","0","0","0","0"
"Talbot","2020-02-22","0","0","0","0","0","0"
"Talbot","2020-02-23","0","0","0","0","0","0"
"Talbot","2020-02-24","0","0","0","0","0","0"
"Talbot","2020-02-25","0","0","0","0","0","0"
"Talbot","2020-02-26","0","0","0","0","0","0"
"Talbot","2020-02-27","0","0","0","0","0","0"
"Talbot","2020-02-28","0","0","0","0","0","0"
"Talbot","2020-02-29","0","0","0","0","0","0"
"Talbot","2020-03-01","0","0","0","0","0","0"
"Talbot","2020-03-02","0","0","0","0","0","0"
"Talbot","2020-03-03","0","0","0","0","0","0"
"Talbot","2020-03-04","0","0","0","0","0","0"
"Talbot","2020-03-05","0","0","0","0","0","0"
"Talbot","2020-03-06","0","0","0","0","0","0"
"Talbot","2020-03-07","0","0","0","0","0","0"
"Talbot","2020-03-08","0","0","0","0","0","0"
"Talbot","2020-03-09","0","0","0","0","0","0"
"Talbot","2020-03-10","0","0","0","0","0","0"
"Talbot","2020-03-11","0","0","0","0","0","0"
"Talbot","2020-03-12","0","0","0","0","0","0"
"Talbot","2020-03-13","0","0","0","0","0","0"
"Talbot","2020-03-14","0","0","0","0","0","0"
"Talbot","2020-03-15","0","0","0","0","0","0"
"Talbot","2020-03-16","0","0","0","0","0","0"
"Talbot","2020-03-17","1","1","0","0","0","0"
"Talbot","2020-03-18","0","1","0","0","0","0"
"Talbot","2020-03-19","0","1","0","0","0","0"
"Talbot","2020-03-20","1","2","0","0","0","0"
"Talbot","2020-03-21","1","3","0","0","0","0"
"Talbot","2020-03-22","0","3","0","0","0","0"
"Talbot","2020-03-23","1","4","0","0","0","0"
"Talbot","2020-03-24","0","4","0","0","0","0"
"Talbot","2020-03-25","2","6","1","1","7.1","3.6"
"Talbot","2020-03-26","3","9","2","3","16.7","8.3"
"Talbot","2020-03-27","2","11","0","3","16.7","8.3"
"Talbot","2020-03-28","7","18","2","5","20.7","10.4"
"Talbot","2020-03-29","0","18","0","5","20.7","10.4"
"Talbot","2020-03-30","1","19","1","6","35","17.5"
"Talbot","2020-03-31","1","20","1","7","49.3","24.7"
"Talbot","2020-04-01","0","20","0","7","42.2","24.7"
"Talbot","2020-04-02","0","20","0","7","32.7","24.7"
"Talbot","2020-04-03","4","24","2","9","39.8","28.2"
"Talbot","2020-04-04","0","24","0","9","35.7","28.2"
"Talbot","2020-04-05","0","24","0","9","35.7","28.2"
"Talbot","2020-04-06","0","24","0","9","21.4","28.2"
"Talbot","2020-04-07","0","24","0","9","7.1","28.2"
"Talbot","2020-04-08","2","26","2","11","21.4","31.8"
"Talbot","2020-04-09","1","27","0","11","21.4","27"
"Talbot","2020-04-10","1","28","0","11","14.3","27"
"Talbot","2020-04-11","0","28","0","11","14.3","25"
"Talbot","2020-04-12","0","28","0","11","14.3","25"
"Talbot","2020-04-13","2","30","0","11","14.3","17.9"
"Talbot","2020-04-14","2","32","1","12","21.4","14.3"
"Talbot","2020-04-15","4","36","2","14","14.3","17.9"
"Talbot","2020-04-16","5","41","3","17","22.9","22.1"
"Talbot","2020-04-17","3","44","0","17","22.9","18.6"
"Talbot","2020-04-18","1","45","0","17","22.9","18.6"
"Talbot","2020-04-19","0","45","0","17","22.9","18.6"
"Talbot","2020-04-20","7","52","1","18","24.9","19.6"
"Talbot","2020-04-21","5","57","0","18","17.8","19.6"
"Talbot","2020-04-22","1","58","0","18","10.6","12.4"
"Talbot","2020-04-23","4","62","0","18","2","12.4"
"Talbot","2020-04-24","3","65","1","19","6.8","14.8"
"Talbot","2020-04-25","0","65","0","19","6.8","14.8"
"Talbot","2020-04-26","3","68","0","19","6.8","14.8"
"Talbot","2020-04-27","1","69","0","19","4.8","14.8"
"Talbot","2020-04-28","8","77","2","21","8.3","13"
"Talbot","2020-04-29","4","81","0","21","8.3","9.5"
"Talbot","2020-04-30","4","85","0","21","8.3","5.2"
"Talbot","2020-05-01","0","85","0","21","3.6","5.2"
"Talbot","2020-05-02","1","86","0","21","3.6","5.2"
"Talbot","2020-05-03","1","87","0","21","3.6","5.2"
"Talbot","2020-05-04","5","92","0","21","3.6","4.2"
"Talbot","2020-05-05","6","98","0","21","0","4.2"
"Talbot","2020-05-06","6","104","0","21","0","4.2"
"Talbot","2020-05-07","4","108","0","21","0","4.2"
"Talbot","2020-05-08","3","111","1","22","4.8","4.2"
"Talbot","2020-05-09","1","112","0","22","4.8","4.2"
"Talbot","2020-05-10","1","113","0","22","4.8","4.2"
"Talbot","2020-05-11","11","124","0","22","4.8","4.2"
"Talbot","2020-05-12","1","125","0","22","4.8","2.4"
"Talbot","2020-05-13","2","127","1","23","11.9","6"
"Talbot","2020-05-14","7","134","1","24","13.9","7"
"Talbot","2020-05-15","20","154","1","25","9.9","7.3"
"Talbot","2020-05-16","1","155","0","25","9.9","7.3"
"Talbot","2020-05-17","3","158","0","25","9.9","7.3"
"Talbot","2020-05-18","5","163","1","26","12.8","8.8"
"Talbot","2020-05-19","7","170","0","26","12.8","8.8"
"Talbot","2020-05-20","6","176","0","26","5.6","8.8"
"Talbot","2020-05-21","3","179","1","27","8.3","11.1"
"Talbot","2020-05-22","4","183","0","27","7.6","8.8"
"Talbot","2020-05-23","9","192","1","28","9.2","9.6"
"Talbot","2020-05-24","1","193","0","28","9.2","9.6"
"Talbot","2020-05-25","3","196","0","28","6.3","9.6"
"Talbot","2020-05-26","6","202","1","29","8.7","10.7"
"Talbot","2020-05-27","7","209","0","29","8.7","7.2"
"Talbot","2020-05-28","4","213","0","29","4","6.2"
"Talbot","2020-05-29","15","228","0","29","4","5.8"
"Talbot","2020-05-30","3","231","0","29","2.4","5.8"
"Talbot","2020-05-31","0","231","0","29","2.4","5.8"
"Talbot","2020-06-01","13","244","0","29","2.4","4.4"
"Talbot","2020-06-02","7","251","1","30","2","5.4"
"Talbot","2020-06-03","13","264","0","30","2","5.4"
"Talbot","2020-06-04","5","269","0","30","2","3"
"Talbot","2020-06-05","5","274","0","30","2","3"
"Talbot","2020-06-06","1","275","0","30","2","2.2"
"Talbot","2020-06-07","0","275","0","30","2","2.2"
"Talbot","2020-06-08","9","284","1","31","3.6","3"
"Talbot","2020-06-09","1","285","0","31","1.6","1.8"
"Talbot","2020-06-10","17","302","0","31","1.6","1.8"
"Talbot","2020-06-11","6","308","1","32","4","3"
"Talbot","2020-06-12","16","324","1","33","4.9","3.5"
"Talbot","2020-06-13","137","461","5","38","5.4","3.7"
"Talbot","2020-06-14","7","468","3","41","11.5","6.8"
"Talbot","2020-06-15","21","489","1","42","10.6","7.1"
"Talbot","2020-06-16","8","497","0","42","10.6","6.1"
"Talbot","2020-06-17","45","542","3","45","11.6","6.6"
"Talbot","2020-06-18","11","553","2","47","11.8","7.9"
"Talbot","2020-06-19","58","611","2","49","11.4","8.1"
"Talbot","2020-06-20","0","611","0","49","10.8","8.1"
"Talbot","2020-06-21","4","615","0","49","4.7","8.1"
"Talbot","2020-06-22","28","643","2","51","5.1","7.8"
"Talbot","2020-06-23","22","665","3","54","7","8.8"
"Talbot","2020-06-24","45","710","5","59","7.6","9.6"
"Talbot","2020-06-25","6","716","0","59","5","8.4"
"Talbot","2020-06-26","28","744","2","61","5.6","8.5"
"Talbot","2020-06-27","2","746","0","61","5.6","8.2"
"Talbot","2020-06-28","1","747","0","61","5.6","5.1"
"Talbot","2020-06-29","28","775","2","63","5.6","5.3"
"Talbot","2020-06-30","5","780","0","63","3.6","5.3"
"Talbot","2020-07-01","56","836","8","71","4.1","5.9"
"Talbot","2020-07-02","5","841","0","71","4.1","4.6"
"Talbot","2020-07-03","4","845","2","73","10.2","7.9"
"Talbot","2020-07-04","3","848","0","73","10.2","7.9"
"Talbot","2020-07-05","2","850","0","73","10.2","7.9"
"Talbot","2020-07-06","37","887","6","79","11.5","8.5"
"Talbot","2020-07-07","12","899","1","80","12.7","8.2"
"Talbot","2020-07-08","49","948","2","82","11.2","7.7"
"Talbot","2020-07-09","4","952","1","83","14.8","9.4"
"Talbot","2020-07-10","76","1028","0","83","7.7","8.9"
"Talbot","2020-07-11","3","1031","0","83","7.7","8.9"
"Talbot","2020-07-12","1","1032","0","83","7.7","8.9"
"Talbot","2020-07-13","26","1058","3","86","7","9.2"
"Talbot","2020-07-14","3","1061","0","86","5.8","9.2"
"Talbot","2020-07-15","27","1088","1","87","5.7","8.5"
"Talbot","2020-07-16","2","1090","0","87","2.2","8.5"
"Talbot","2020-07-17","81","1171","6","93","3.2","5.4"
"Talbot","2020-07-18","2","1173","1","94","10.4","9"
"Talbot","2020-07-19","3","1176","0","94","10.4","9"
"Talbot","2020-07-20","27","1203","2","96","9.8","8.4"
"Talbot","2020-07-21","5","1208","3","99","18.4","12.1"
"Talbot","2020-07-22","35","1243","1","100","18.2","12"
"Talbot","2020-07-23","5","1248","0","100","18.2","10.2"
"Talbot","2020-07-24","64","1312","3","103","17.9","10.5"
"Talbot","2020-07-25","3","1315","0","103","10.7","10.5"
"Talbot","2020-07-26","0","1315","0","103","10.7","10.5"
"Talbot","2020-07-27","27","1342","2","105","10.7","10.2"
"Talbot","2020-07-28","5","1347","0","105","2.1","10.2"
"Talbot","2020-07-29","32","1379","4","109","3.5","10.9"
"Talbot","2020-07-30","6","1385","1","110","5.9","12.1"
"Talbot","2020-07-31","43","1428","3","113","6.2","12"
"Talbot","2020-08-01","9","1437","1","114","7.8","9.3"
"Talbot","2020-08-02","1","1438","0","114","7.8","9.3"
"Talbot","2020-08-03","27","1465","2","116","7.8","9.3"
"Talbot","2020-08-04","5","1470","2","118","13.5","7.8"
"Talbot","2020-08-05","32","1502","2","120","12.6","8.1"
"Talbot","2020-08-06","6","1508","1","121","12.6","9.3"
"Talbot","2020-08-07","31","1539","3","124","13","9.6"
"Talbot","2020-08-08","4","1543","1","125","15","11.4"
"Talbot","2020-08-09","5","1548","1","126","17.9","12.8"
"Talbot","2020-08-10","21","1569","3","129","18.8","13.3"
"Talbot","2020-08-11","2","1571","0","129","13.1","13.3"
"Talbot","2020-08-12","19","1590","2","131","13.7","13.2"
"Talbot","2020-08-13","5","1595","1","132","14.2","13.4"
"Talbot","2020-08-14","51","1646","5","137","14.2","13.6"
"Talbot","2020-08-15","4","1650","0","137","10.7","12.8"
"Talbot","2020-08-16","1","1651","1","138","22.1","20"
"Talbot","2020-08-17","5","1656","0","138","20","19.4"
"Talbot","2020-08-18","7","1663","1","139","22.1","17.6"
"Talbot","2020-08-19","20","1683","0","139","20.6","17.2"
"Talbot","2020-08-20","4","1687","0","139","17.7","16"
"Talbot","2020-08-21","49","1736","1","140","16.6","15.4"
"Talbot","2020-08-22","46","1782","2","142","17.2","13.9"
"Talbot","2020-08-23","4","1786","1","143","6.5","14.3"
"Talbot","2020-08-24","46","1832","0","143","6.5","13.3"
"Talbot","2020-08-25","22","1854","0","143","4.5","13.3"
"Talbot","2020-08-26","22","1876","1","144","5.1","12.9"
"Talbot","2020-08-27","4","1880","0","144","5.1","11.4"
"Talbot","2020-08-28","41","1921","2","146","5.5","11.1"
"Talbot","2020-08-29","1","1922","0","146","4.9","11.1"
"Talbot","2020-08-30","1","1923","0","146","1.3","3.9"
"Talbot","2020-08-31","12","1935","0","146","1.3","3.9"
"Talbot","2020-09-01","5","1940","0","146","1.3","2.9"
"Talbot","2020-09-02","4","1944","0","146","0.7","2.9"
"Talbot","2020-09-03","13","1957","0","146","0.7","2.9"
"Talbot","2020-09-04","39","1996","3","149","1.1","3.3"
"Talbot","2020-09-05","5","2001","0","149","1.1","3"
"Talbot","2020-09-06","0","2001","0","149","1.1","1.2"
"Talbot","2020-09-07","2","2003","0","149","1.1","1.2"
"Talbot","2020-09-08","4","2007","0","149","1.1","1.2"
"Talbot","2020-09-09","12","2019","0","149","1.1","0.9"
"Talbot","2020-09-10","5","2024","0","149","1.1","0.9"
"Talbot","2020-09-11","25","2049","0","149","0","0.5"
"Talbot","2020-09-12","3","2052","1","150","4.8","2.9"
"Talbot","2020-09-13","1","2053","0","150","4.8","2.9"
"Talbot","2020-09-14","5","2058","0","150","4.8","2.9"
"Talbot","2020-09-15","4","2062","1","151","8.3","4.7"
"Talbot","2020-09-16","16","2078","0","151","8.3","4.7"
"Talbot","2020-09-17","7","2085","1","152","10.4","5.7"
"Talbot","2020-09-18","34","2119","0","152","10.4","5.2"
"Talbot","2020-09-19","5","2124","0","152","5.6","5.2"
"Talbot","2020-09-20","0","2124","0","152","5.6","5.2"
"Talbot","2020-09-21","9","2133","1","153","7.2","6"
"Talbot","2020-09-22","7","2140","1","154","5.7","7"
"Talbot","2020-09-23","6","2146","0","154","5.7","7"
"Talbot","2020-09-24","5","2151","0","154","3.6","7"
"Talbot","2020-09-25","24","2175","1","155","4.2","7.3"
"Talbot","2020-09-26","2","2177","0","155","4.2","4.9"
"Talbot","2020-09-27","1","2178","1","156","18.5","12.1"
"Talbot","2020-09-28","13","2191","0","156","16.9","12.1"
"Talbot","2020-09-29","1","2192","0","156","14.9","10.3"
"Talbot","2020-09-30","3","2195","0","156","14.9","10.3"
"Talbot","2020-10-01","5","2200","0","156","14.9","9.3"
"Talbot","2020-10-02","42","2242","1","157","14.6","9.4"
"Talbot","2020-10-03","2","2244","0","157","14.6","9.4"
"Talbot","2020-10-04","2","2246","0","157","0.3","9.4"
"Talbot","2020-10-05","9","2255","0","157","0.3","8.6"
"Talbot","2020-10-06","4","2259","0","157","0.3","7.6"
"Talbot","2020-10-07","10","2269","0","157","0.3","7.6"
"Talbot","2020-10-08","4","2273","0","157","0.3","7.6"
"Talbot","2020-10-09","36","2309","0","157","0","7.3"
"Talbot","2020-10-10","2","2311","0","157","0","7.3"
"Talbot","2020-10-11","1","2312","0","157","0","0.2"
"Talbot","2020-10-12","2","2314","0","157","0","0.2"
"Talbot","2020-10-13","3","2317","0","157","0","0.2"
"Talbot","2020-10-14","16","2333","0","157","0","0.2"
"Talbot","2020-10-15","4","2337","1","158","3.6","2"
"Talbot","2020-10-16","28","2365","0","158","3.6","1.8"
"Talbot","2020-10-17","1","2366","0","158","3.6","1.8"
"Talbot","2020-10-18","2","2368","0","158","3.6","1.8"
"Talbot","2020-10-19","9","2377","1","159","5.2","2.6"
"Talbot","2020-10-20","4","2381","0","159","5.2","2.6"
"Talbot","2020-10-21","17","2398","4","163","8.5","4.3"
"Talbot","2020-10-22","4","2402","1","164","8.5","6"
"Talbot","2020-10-23","31","2433","1","165","9","6.3"
"Talbot","2020-10-24","1","2434","0","165","9","6.3"
"Talbot","2020-10-25","0","2434","0","165","9","6.3"
"Talbot","2020-10-26","13","2447","1","166","8.5","6.8"
"Talbot","2020-10-27","8","2455","1","167","10.3","7.7"
"Talbot","2020-10-28","9","2464","0","167","6.9","7.7"
"Talbot","2020-10-29","7","2471","1","168","5.4","7"
"Talbot","2020-10-30","30","2501","1","169","5.4","7.2"
"Talbot","2020-10-31","14","2515","0","169","5.4","7.2"
"Talbot","2020-11-01","4","2519","0","169","5.4","7.2"
"Talbot","2020-11-02","31","2550","2","171","5.2","6.9"
"Talbot","2020-11-03","4","2554","0","171","3.4","6.9"
"Talbot","2020-11-04","19","2573","0","171","3.4","5.2"
"Talbot","2020-11-05","7","2580","0","171","1.4","3.4"
"Talbot","2020-11-06","23","2603","3","174","2.8","4.1"
"Talbot","2020-11-07","3","2606","0","174","2.8","4.1"
"Talbot","2020-11-08","3","2609","0","174","2.8","4.1"
"Talbot","2020-11-09","11","2620","0","174","1.9","3.5"
"Talbot","2020-11-10","7","2627","0","174","1.9","2.7"
"Talbot","2020-11-11","10","2637","1","175","3.3","3.4"
"Talbot","2020-11-12","3","2640","0","175","3.3","2.3"
"Talbot","2020-11-13","42","2682","0","175","1.4","2.1"
"Talbot","2020-11-14","5","2687","0","175","1.4","2.1"
"Talbot","2020-11-15","2","2689","0","175","1.4","2.1"
"Talbot","2020-11-16","12","2701","0","175","1.4","1.6"
"Talbot","2020-11-17","9","2710","0","175","1.4","1.6"
"Talbot","2020-11-18","6","2716","0","175","0","1.6"
"Talbot","2020-11-19","5","2721","0","175","0","1.6"
"Talbot","2020-11-20","1","2722","0","175","0","0.7"
"Talbot","2020-11-21","3","2725","0","175","0","0.7"
"Talbot","2020-11-22","0","2725","0","175","0","0.7"
"Talbot","2020-11-23","14","2739","0","175","0","0.7"
"Talbot","2020-11-24","5","2744","0","175","0","0.7"
"Talbot","2020-11-25","14","2758","0","175","0","0"
"Talbot","2020-11-26","1","2759","0","175","0","0"
"Talbot","2020-11-27","0","2759","0","175","0","0"
"Talbot","2020-11-28","1","2760","0","175","0","0"
"Talbot","2020-11-29","4","2764","0","175","0","0"
"Talbot","2020-11-30","13","2777","3","178","3.3","1.6"
"Talbot","2020-12-01","9","2786","2","180","6.5","3.2"
"Talbot","2020-12-02","7","2793","1","181","8.5","4.3"
"Talbot","2020-12-03","7","2800","2","183","12.6","6.3"
"Talbot","2020-12-04","58","2858","2","185","13.1","6.5"
"Talbot","2020-12-05","4","2862","1","186","16.7","8.3"
"Talbot","2020-12-06","1","2863","0","186","16.7","8.3"
"Talbot","2020-12-07","22","2885","1","187","14","8.7"
"Talbot","2020-12-08","8","2893","0","187","10.8","8.7"
"Talbot","2020-12-09","5","2898","0","187","8.8","8.7"
"Talbot","2020-12-10","9","2907","0","187","4.7","8.7"
"Talbot","2020-12-11","2","2909","0","187","4.2","8.7"
"Talbot","2020-12-12","3","2912","0","187","0.6","8.7"
"Talbot","2020-12-13","5","2917","1","188","3.5","10.1"
"Talbot","2020-12-14","18","2935","1","189","3.7","8.8"
"Talbot","2020-12-15","9","2944","3","192","8.4","9.6"
"Talbot","2020-12-16","7","2951","0","192","8.4","8.6"
"Talbot","2020-12-17","4","2955","0","192","8.4","6.6"
"Talbot","2020-12-18","70","3025","11","203","10.7","7.4"
"Talbot","2020-12-19","4","3029","2","205","17.8","9.2"
"Talbot","2020-12-20","5","3034","1","206","17.8","10.7"
"Talbot","2020-12-21","32","3066","4","210","18.8","11.2"
"Talbot","2020-12-22","15","3081","1","211","15","11.7"
"Talbot","2020-12-23","7","3088","1","212","17","12.7"
"Talbot","2020-12-24","3","3091","1","213","21.8","15.1"
"Talbot","2020-12-25","2","3093","0","213","19.5","15.1"
"Talbot","2020-12-26","3","3096","0","213","12.4","15.1"
"Talbot","2020-12-27","6","3102","4","217","19.1","18.4"
"Talbot","2020-12-28","16","3118","3","220","20","19.4"
"Talbot","2020-12-29","12","3130","4","224","23.8","19.4"
"Talbot","2020-12-30","4","3134","1","225","25.3","21.2"
"Talbot","2020-12-31","13","3147","0","225","20.5","21.2"
"Talbot","2021-01-01","3","3150","1","226","25.3","22.4"
"Talbot","2021-01-02","6","3156","4","230","34.8","23.6"
"Talbot","2021-01-03","7","3163","2","232","29.4","24.2"
"Talbot","2021-01-04","44","3207","15","247","31.6","25.8"
"Talbot","2021-01-05","23","3230","1","248","27.4","25.6"
"Talbot","2021-01-06","11","3241","0","248","23.9","24.6"
"Talbot","2021-01-07","18","3259","5","253","27.8","24.2"
"Talbot","2021-01-08","10","3269","0","253","23.1","24.2"
"Talbot","2021-01-09","4","3273","2","255","20.7","27.8"
"Talbot","2021-01-10","3","3276","0","255","16.6","23"
"Talbot","2021-01-11","38","3314","8","263","14.7","23.2"
"Talbot","2021-01-12","10","3324","0","263","14.1","20.8"
"Talbot","2021-01-13","9","3333","3","266","18.9","21.4"
"Talbot","2021-01-14","12","3345","2","268","17.3","22.6"
"Talbot","2021-01-15","81","3426","15","283","19.9","21.5"
"Talbot","2021-01-16","4","3430","2","285","19.9","20.3"
"Talbot","2021-01-17","4","3434","1","286","23.5","20.1"
"Talbot","2021-01-18","7","3441","2","288","24.6","19.7"
"Talbot","2021-01-19","10","3451","3","291","28.9","21.5"
"Talbot","2021-01-20","19","3470","4","295","27.1","23"
"Talbot","2021-01-21","4","3474","1","296","28.3","22.8"
"Talbot","2021-01-22","6","3480","2","298","30.4","25.2"
"Talbot","2021-01-23","8","3488","1","299","25.1","22.5"
"Talbot","2021-01-24","4","3492","2","301","28.6","26.1"
"Talbot","2021-01-25","27","3519","3","304","26.1","25.4"
"Talbot","2021-01-26","12","3531","2","306","24.2","26.6"
"Talbot","2021-01-27","20","3551","2","308","22.7","24.9"
"Talbot","2021-01-28","13","3564","4","312","23.5","25.9"
"Talbot","2021-01-29","73","3637","4","316","19.5","25"
"Talbot","2021-01-30","8","3645","0","316","17.7","21.4"
"Talbot","2021-01-31","3","3648","0","316","10.6","19.6"
"Talbot","2021-02-01","29","3677","3","319","10.5","18.3"
"Talbot","2021-02-02","14","3691","1","320","9.1","16.7"
"Talbot","2021-02-03","10","3701","2","322","10.5","16.6"
"Talbot","2021-02-04","13","3714","1","323","7.2","15.4"
"Talbot","2021-02-05","10","3724","0","323","6.5","13"
"Talbot","2021-02-06","6","3730","0","323","6.5","12.1"
"Talbot","2021-02-07","0","3730","0","323","6.5","8.5"
"Talbot","2021-02-08","0","3730","0","323","5","7.7"
"Taliaferro","2020-02-01","0","0","0","0",".","."
"Taliaferro","2020-02-02","0","0","0","0",".","."
"Taliaferro","2020-02-03","0","0","0","0",".","."
"Taliaferro","2020-02-04","0","0","0","0",".","."
"Taliaferro","2020-02-05","0","0","0","0",".","."
"Taliaferro","2020-02-06","0","0","0","0",".","."
"Taliaferro","2020-02-07","0","0","0","0","0","."
"Taliaferro","2020-02-08","0","0","0","0","0","."
"Taliaferro","2020-02-09","0","0","0","0","0","."
"Taliaferro","2020-02-10","0","0","0","0","0","."
"Taliaferro","2020-02-11","0","0","0","0","0","."
"Taliaferro","2020-02-12","0","0","0","0","0","."
"Taliaferro","2020-02-13","0","0","0","0","0","."
"Taliaferro","2020-02-14","0","0","0","0","0","0"
"Taliaferro","2020-02-15","0","0","0","0","0","0"
"Taliaferro","2020-02-16","0","0","0","0","0","0"
"Taliaferro","2020-02-17","0","0","0","0","0","0"
"Taliaferro","2020-02-18","0","0","0","0","0","0"
"Taliaferro","2020-02-19","0","0","0","0","0","0"
"Taliaferro","2020-02-20","0","0","0","0","0","0"
"Taliaferro","2020-02-21","0","0","0","0","0","0"
"Taliaferro","2020-02-22","0","0","0","0","0","0"
"Taliaferro","2020-02-23","0","0","0","0","0","0"
"Taliaferro","2020-02-24","0","0","0","0","0","0"
"Taliaferro","2020-02-25","0","0","0","0","0","0"
"Taliaferro","2020-02-26","0","0","0","0","0","0"
"Taliaferro","2020-02-27","0","0","0","0","0","0"
"Taliaferro","2020-02-28","0","0","0","0","0","0"
"Taliaferro","2020-02-29","0","0","0","0","0","0"
"Taliaferro","2020-03-01","0","0","0","0","0","0"
"Taliaferro","2020-03-02","0","0","0","0","0","0"
"Taliaferro","2020-03-03","0","0","0","0","0","0"
"Taliaferro","2020-03-04","0","0","0","0","0","0"
"Taliaferro","2020-03-05","0","0","0","0","0","0"
"Taliaferro","2020-03-06","0","0","0","0","0","0"
"Taliaferro","2020-03-07","0","0","0","0","0","0"
"Taliaferro","2020-03-08","0","0","0","0","0","0"
"Taliaferro","2020-03-09","0","0","0","0","0","0"
"Taliaferro","2020-03-10","0","0","0","0","0","0"
"Taliaferro","2020-03-11","0","0","0","0","0","0"
"Taliaferro","2020-03-12","0","0","0","0","0","0"
"Taliaferro","2020-03-13","0","0","0","0","0","0"
"Taliaferro","2020-03-14","0","0","0","0","0","0"
"Taliaferro","2020-03-15","0","0","0","0","0","0"
"Taliaferro","2020-03-16","0","0","0","0","0","0"
"Taliaferro","2020-03-17","0","0","0","0","0","0"
"Taliaferro","2020-03-18","0","0","0","0","0","0"
"Taliaferro","2020-03-19","0","0","0","0","0","0"
"Taliaferro","2020-03-20","0","0","0","0","0","0"
"Taliaferro","2020-03-21","0","0","0","0","0","0"
"Taliaferro","2020-03-22","0","0","0","0","0","0"
"Taliaferro","2020-03-23","0","0","0","0","0","0"
"Taliaferro","2020-03-24","0","0","0","0","0","0"
"Taliaferro","2020-03-25","1","1","0","0","0","0"
"Taliaferro","2020-03-26","0","1","0","0","0","0"
"Taliaferro","2020-03-27","2","3","0","0","0","0"
"Taliaferro","2020-03-28","0","3","0","0","0","0"
"Taliaferro","2020-03-29","0","3","0","0","0","0"
"Taliaferro","2020-03-30","1","4","0","0","0","0"
"Taliaferro","2020-03-31","0","4","0","0","0","0"
"Taliaferro","2020-04-01","1","5","0","0","0","0"
"Taliaferro","2020-04-02","1","6","0","0","0","0"
"Taliaferro","2020-04-03","0","6","0","0","0","0"
"Taliaferro","2020-04-04","0","6","0","0","0","0"
"Taliaferro","2020-04-05","0","6","0","0","0","0"
"Taliaferro","2020-04-06","0","6","0","0","0","0"
"Taliaferro","2020-04-07","0","6","0","0","0","0"
"Taliaferro","2020-04-08","0","6","0","0","0","0"
"Taliaferro","2020-04-09","0","6","0","0","0","0"
"Taliaferro","2020-04-10","0","6","0","0","0","0"
"Taliaferro","2020-04-11","0","6","0","0","0","0"
"Taliaferro","2020-04-12","0","6","0","0","0","0"
"Taliaferro","2020-04-13","1","7","0","0","0","0"
"Taliaferro","2020-04-14","0","7","0","0","0","0"
"Taliaferro","2020-04-15","0","7","0","0","0","0"
"Taliaferro","2020-04-16","2","9","0","0","0","0"
"Taliaferro","2020-04-17","0","9","0","0","0","0"
"Taliaferro","2020-04-18","0","9","0","0","0","0"
"Taliaferro","2020-04-19","0","9","0","0","0","0"
"Taliaferro","2020-04-20","0","9","0","0","0","0"
"Taliaferro","2020-04-21","3","12","0","0","0","0"
"Taliaferro","2020-04-22","0","12","0","0","0","0"
"Taliaferro","2020-04-23","1","13","0","0","0","0"
"Taliaferro","2020-04-24","0","13","0","0","0","0"
"Taliaferro","2020-04-25","0","13","0","0","0","0"
"Taliaferro","2020-04-26","1","14","0","0","0","0"
"Taliaferro","2020-04-27","1","15","0","0","0","0"
"Taliaferro","2020-04-28","0","15","0","0","0","0"
"Taliaferro","2020-04-29","2","17","1","1","7.1","3.6"
"Taliaferro","2020-04-30","1","18","0","1","7.1","3.6"
"Taliaferro","2020-05-01","1","19","0","1","7.1","3.6"
"Taliaferro","2020-05-02","0","19","0","1","7.1","3.6"
"Taliaferro","2020-05-03","0","19","0","1","7.1","3.6"
"Taliaferro","2020-05-04","0","19","0","1","7.1","3.6"
"Taliaferro","2020-05-05","0","19","0","1","7.1","3.6"
"Taliaferro","2020-05-06","2","21","0","1","0","3.6"
"Taliaferro","2020-05-07","0","21","0","1","0","3.6"
"Taliaferro","2020-05-08","1","22","0","1","0","3.6"
"Taliaferro","2020-05-09","0","22","0","1","0","3.6"
"Taliaferro","2020-05-10","0","22","0","1","0","3.6"
"Taliaferro","2020-05-11","1","23","0","1","0","3.6"
"Taliaferro","2020-05-12","0","23","0","1","0","3.6"
"Taliaferro","2020-05-13","0","23","0","1","0","0"
"Taliaferro","2020-05-14","0","23","0","1","0","0"
"Taliaferro","2020-05-15","0","23","0","1","0","0"
"Taliaferro","2020-05-16","1","24","0","1","0","0"
"Taliaferro","2020-05-17","0","24","0","1","0","0"
"Taliaferro","2020-05-18","2","26","0","1","0","0"
"Taliaferro","2020-05-19","1","27","1","2","14.3","7.1"
"Taliaferro","2020-05-20","1","28","0","2","14.3","7.1"
"Taliaferro","2020-05-21","0","28","0","2","14.3","7.1"
"Taliaferro","2020-05-22","1","29","0","2","14.3","7.1"
"Taliaferro","2020-05-23","0","29","0","2","14.3","7.1"
"Taliaferro","2020-05-24","0","29","0","2","14.3","7.1"
"Taliaferro","2020-05-25","0","29","0","2","14.3","7.1"
"Taliaferro","2020-05-26","0","29","0","2","0","7.1"
"Taliaferro","2020-05-27","0","29","0","2","0","7.1"
"Taliaferro","2020-05-28","0","29","0","2","0","7.1"
"Taliaferro","2020-05-29","0","29","0","2","0","7.1"
"Taliaferro","2020-05-30","0","29","0","2","0","7.1"
"Taliaferro","2020-05-31","0","29","0","2","0","7.1"
"Taliaferro","2020-06-01","1","30","0","2","0","7.1"
"Taliaferro","2020-06-02","0","30","0","2","0","0"
"Taliaferro","2020-06-03","1","31","0","2","0","0"
"Taliaferro","2020-06-04","0","31","0","2","0","0"
"Taliaferro","2020-06-05","0","31","0","2","0","0"
"Taliaferro","2020-06-06","0","31","0","2","0","0"
"Taliaferro","2020-06-07","0","31","0","2","0","0"
"Taliaferro","2020-06-08","0","31","0","2","0","0"
"Taliaferro","2020-06-09","2","33","0","2","0","0"
"Taliaferro","2020-06-10","1","34","0","2","0","0"
"Taliaferro","2020-06-11","4","38","0","2","0","0"
"Taliaferro","2020-06-12","0","38","0","2","0","0"
"Taliaferro","2020-06-13","0","38","0","2","0","0"
"Taliaferro","2020-06-14","0","38","0","2","0","0"
"Taliaferro","2020-06-15","0","38","0","2","0","0"
"Taliaferro","2020-06-16","0","38","0","2","0","0"
"Taliaferro","2020-06-17","0","38","0","2","0","0"
"Taliaferro","2020-06-18","2","40","0","2","0","0"
"Taliaferro","2020-06-19","0","40","0","2","0","0"
"Taliaferro","2020-06-20","0","40","0","2","0","0"
"Taliaferro","2020-06-21","0","40","0","2","0","0"
"Taliaferro","2020-06-22","0","40","0","2","0","0"
"Taliaferro","2020-06-23","1","41","0","2","0","0"
"Taliaferro","2020-06-24","4","45","0","2","0","0"
"Taliaferro","2020-06-25","5","50","0","2","0","0"
"Taliaferro","2020-06-26","0","50","0","2","0","0"
"Taliaferro","2020-06-27","2","52","0","2","0","0"
"Taliaferro","2020-06-28","0","52","0","2","0","0"
"Taliaferro","2020-06-29","1","53","0","2","0","0"
"Taliaferro","2020-06-30","1","54","0","2","0","0"
"Taliaferro","2020-07-01","1","55","0","2","0","0"
"Taliaferro","2020-07-02","14","69","0","2","0","0"
"Taliaferro","2020-07-03","0","69","0","2","0","0"
"Taliaferro","2020-07-04","0","69","0","2","0","0"
"Taliaferro","2020-07-05","0","69","0","2","0","0"
"Taliaferro","2020-07-06","0","69","0","2","0","0"
"Taliaferro","2020-07-07","1","70","0","2","0","0"
"Taliaferro","2020-07-08","3","73","0","2","0","0"
"Taliaferro","2020-07-09","2","75","0","2","0","0"
"Taliaferro","2020-07-10","2","77","0","2","0","0"
"Taliaferro","2020-07-11","2","79","0","2","0","0"
"Taliaferro","2020-07-12","1","80","0","2","0","0"
"Taliaferro","2020-07-13","2","82","0","2","0","0"
"Taliaferro","2020-07-14","0","82","0","2","0","0"
"Taliaferro","2020-07-15","1","83","0","2","0","0"
"Taliaferro","2020-07-16","0","83","0","2","0","0"
"Taliaferro","2020-07-17","0","83","0","2","0","0"
"Taliaferro","2020-07-18","2","85","0","2","0","0"
"Taliaferro","2020-07-19","3","88","2","4","9.5","4.8"
"Taliaferro","2020-07-20","2","90","1","5","16.7","8.3"
"Taliaferro","2020-07-21","1","91","0","5","16.7","8.3"
"Taliaferro","2020-07-22","1","92","1","6","31","15.5"
"Taliaferro","2020-07-23","30","122","0","6","31","15.5"
"Taliaferro","2020-07-24","2","124","0","6","31","15.5"
"Taliaferro","2020-07-25","2","126","0","6","31","15.5"
"Taliaferro","2020-07-26","0","126","0","6","21.4","15.5"
"Taliaferro","2020-07-27","3","129","0","6","14.3","15.5"
"Taliaferro","2020-07-28","3","132","2","8","23.8","20.2"
"Taliaferro","2020-07-29","1","133","0","8","9.5","20.2"
"Taliaferro","2020-07-30","34","167","1","9","9.9","20.4"
"Taliaferro","2020-07-31","1","168","0","9","9.9","20.4"
"Taliaferro","2020-08-01","0","168","0","9","9.9","20.4"
"Taliaferro","2020-08-02","1","169","0","9","9.9","15.7"
"Taliaferro","2020-08-03","3","172","0","9","9.9","12.1"
"Taliaferro","2020-08-04","2","174","0","9","0.4","12.1"
"Taliaferro","2020-08-05","2","176","0","9","0.4","5"
"Taliaferro","2020-08-06","1","177","0","9","0","5"
"Taliaferro","2020-08-07","0","177","0","9","0","5"
"Taliaferro","2020-08-08","1","178","0","9","0","5"
"Taliaferro","2020-08-09","0","178","0","9","0","5"
"Taliaferro","2020-08-10","1","179","0","9","0","5"
"Taliaferro","2020-08-11","4","183","1","10","3.6","2"
"Taliaferro","2020-08-12","3","186","0","10","3.6","2"
"Taliaferro","2020-08-13","1","187","0","10","3.6","1.8"
"Taliaferro","2020-08-14","2","189","0","10","3.6","1.8"
"Taliaferro","2020-08-15","1","190","0","10","3.6","1.8"
"Taliaferro","2020-08-16","0","190","0","10","3.6","1.8"
"Taliaferro","2020-08-17","1","191","0","10","3.6","1.8"
"Taliaferro","2020-08-18","0","191","0","10","0","1.8"
"Taliaferro","2020-08-19","0","191","0","10","0","1.8"
"Taliaferro","2020-08-20","2","193","0","10","0","1.8"
"Taliaferro","2020-08-21","1","194","0","10","0","1.8"
"Taliaferro","2020-08-22","0","194","0","10","0","1.8"
"Taliaferro","2020-08-23","0","194","0","10","0","1.8"
"Taliaferro","2020-08-24","0","194","0","10","0","1.8"
"Taliaferro","2020-08-25","0","194","0","10","0","0"
"Taliaferro","2020-08-26","1","195","1","11","14.3","7.1"
"Taliaferro","2020-08-27","2","197","0","11","14.3","7.1"
"Taliaferro","2020-08-28","1","198","0","11","14.3","7.1"
"Taliaferro","2020-08-29","0","198","0","11","14.3","7.1"
"Taliaferro","2020-08-30","0","198","0","11","14.3","7.1"
"Taliaferro","2020-08-31","2","200","0","11","14.3","7.1"
"Taliaferro","2020-09-01","2","202","0","11","14.3","7.1"
"Taliaferro","2020-09-02","1","203","0","11","0","7.1"
"Taliaferro","2020-09-03","0","203","0","11","0","7.1"
"Taliaferro","2020-09-04","0","203","0","11","0","7.1"
"Taliaferro","2020-09-05","1","204","0","11","0","7.1"
"Taliaferro","2020-09-06","0","204","0","11","0","7.1"
"Taliaferro","2020-09-07","0","204","0","11","0","7.1"
"Taliaferro","2020-09-08","1","205","0","11","0","7.1"
"Taliaferro","2020-09-09","0","205","0","11","0","0"
"Taliaferro","2020-09-10","1","206","0","11","0","0"
"Taliaferro","2020-09-11","1","207","0","11","0","0"
"Taliaferro","2020-09-12","1","208","0","11","0","0"
"Taliaferro","2020-09-13","0","208","0","11","0","0"
"Taliaferro","2020-09-14","0","208","0","11","0","0"
"Taliaferro","2020-09-15","1","209","0","11","0","0"
"Taliaferro","2020-09-16","2","211","0","11","0","0"
"Taliaferro","2020-09-17","1","212","1","12","14.3","7.1"
"Taliaferro","2020-09-18","1","213","0","12","14.3","7.1"
"Taliaferro","2020-09-19","0","213","0","12","14.3","7.1"
"Taliaferro","2020-09-20","0","213","0","12","14.3","7.1"
"Taliaferro","2020-09-21","4","217","0","12","14.3","7.1"
"Taliaferro","2020-09-22","3","220","0","12","14.3","7.1"
"Taliaferro","2020-09-23","1","221","0","12","14.3","7.1"
"Taliaferro","2020-09-24","0","221","0","12","0","7.1"
"Taliaferro","2020-09-25","1","222","0","12","0","7.1"
"Taliaferro","2020-09-26","3","225","0","12","0","7.1"
"Taliaferro","2020-09-27","1","226","0","12","0","7.1"
"Taliaferro","2020-09-28","0","226","0","12","0","7.1"
"Taliaferro","2020-09-29","0","226","0","12","0","7.1"
"Taliaferro","2020-09-30","2","228","0","12","0","7.1"
"Taliaferro","2020-10-01","0","228","0","12","0","0"
"Taliaferro","2020-10-02","1","229","0","12","0","0"
"Taliaferro","2020-10-03","0","229","0","12","0","0"
"Taliaferro","2020-10-04","0","229","0","12","0","0"
"Taliaferro","2020-10-05","0","229","0","12","0","0"
"Taliaferro","2020-10-06","1","230","1","13","14.3","7.1"
"Taliaferro","2020-10-07","2","232","0","13","14.3","7.1"
"Taliaferro","2020-10-08","1","233","0","13","14.3","7.1"
"Taliaferro","2020-10-09","1","234","0","13","14.3","7.1"
"Taliaferro","2020-10-10","0","234","0","13","14.3","7.1"
"Taliaferro","2020-10-11","0","234","0","13","14.3","7.1"
"Taliaferro","2020-10-12","2","236","0","13","14.3","7.1"
"Taliaferro","2020-10-13","1","237","0","13","0","7.1"
"Taliaferro","2020-10-14","1","238","0","13","0","7.1"
"Taliaferro","2020-10-15","3","241","0","13","0","7.1"
"Taliaferro","2020-10-16","1","242","0","13","0","7.1"
"Taliaferro","2020-10-17","0","242","0","13","0","7.1"
"Taliaferro","2020-10-18","1","243","0","13","0","7.1"
"Taliaferro","2020-10-19","3","246","0","13","0","7.1"
"Taliaferro","2020-10-20","1","247","0","13","0","0"
"Taliaferro","2020-10-21","0","247","0","13","0","0"
"Taliaferro","2020-10-22","1","248","0","13","0","0"
"Taliaferro","2020-10-23","1","249","0","13","0","0"
"Taliaferro","2020-10-24","3","252","2","15","9.5","4.8"
"Taliaferro","2020-10-25","0","252","0","15","9.5","4.8"
"Taliaferro","2020-10-26","0","252","0","15","9.5","4.8"
"Taliaferro","2020-10-27","4","256","2","17","16.7","8.3"
"Taliaferro","2020-10-28","0","256","0","17","16.7","8.3"
"Taliaferro","2020-10-29","0","256","0","17","16.7","8.3"
"Taliaferro","2020-10-30","0","256","0","17","16.7","8.3"
"Taliaferro","2020-10-31","1","257","0","17","7.1","8.3"
"Taliaferro","2020-11-01","0","257","0","17","7.1","8.3"
"Taliaferro","2020-11-02","0","257","0","17","7.1","8.3"
"Taliaferro","2020-11-03","3","260","0","17","0","8.3"
"Taliaferro","2020-11-04","0","260","0","17","0","8.3"
"Taliaferro","2020-11-05","2","262","1","18","7.1","11.9"
"Taliaferro","2020-11-06","1","263","0","18","7.1","11.9"
"Taliaferro","2020-11-07","0","263","0","18","7.1","7.1"
"Taliaferro","2020-11-08","0","263","0","18","7.1","7.1"
"Taliaferro","2020-11-09","0","263","0","18","7.1","7.1"
"Taliaferro","2020-11-10","3","266","0","18","7.1","3.6"
"Taliaferro","2020-11-11","1","267","0","18","7.1","3.6"
"Taliaferro","2020-11-12","2","269","0","18","0","3.6"
"Taliaferro","2020-11-13","1","270","0","18","0","3.6"
"Taliaferro","2020-11-14","1","271","1","19","14.3","10.7"
"Taliaferro","2020-11-15","2","273","0","19","14.3","10.7"
"Taliaferro","2020-11-16","3","276","0","19","14.3","10.7"
"Taliaferro","2020-11-17","2","278","0","19","14.3","10.7"
"Taliaferro","2020-11-18","0","278","0","19","14.3","10.7"
"Taliaferro","2020-11-19","1","279","0","19","14.3","7.1"
"Taliaferro","2020-11-20","5","284","1","20","17.1","8.6"
"Taliaferro","2020-11-21","1","285","0","20","2.9","8.6"
"Taliaferro","2020-11-22","0","285","0","20","2.9","8.6"
"Taliaferro","2020-11-23","1","286","0","20","2.9","8.6"
"Taliaferro","2020-11-24","3","289","0","20","2.9","8.6"
"Taliaferro","2020-11-25","2","291","0","20","2.9","8.6"
"Taliaferro","2020-11-26","0","291","0","20","2.9","8.6"
"Taliaferro","2020-11-27","1","292","0","20","0","8.6"
"Taliaferro","2020-11-28","0","292","0","20","0","1.4"
"Taliaferro","2020-11-29","0","292","0","20","0","1.4"
"Taliaferro","2020-11-30","4","296","0","20","0","1.4"
"Taliaferro","2020-12-01","1","297","0","20","0","1.4"
"Taliaferro","2020-12-02","0","297","0","20","0","1.4"
"Taliaferro","2020-12-03","0","297","0","20","0","1.4"
"Taliaferro","2020-12-04","0","297","0","20","0","0"
"Taliaferro","2020-12-05","0","297","0","20","0","0"
"Taliaferro","2020-12-06","1","298","0","20","0","0"
"Taliaferro","2020-12-07","0","298","0","20","0","0"
"Taliaferro","2020-12-08","3","301","0","20","0","0"
"Taliaferro","2020-12-09","1","302","1","21","14.3","7.1"
"Taliaferro","2020-12-10","4","306","0","21","14.3","7.1"
"Taliaferro","2020-12-11","0","306","0","21","14.3","7.1"
"Taliaferro","2020-12-12","1","307","0","21","14.3","7.1"
"Taliaferro","2020-12-13","0","307","0","21","14.3","7.1"
"Taliaferro","2020-12-14","0","307","0","21","14.3","7.1"
"Taliaferro","2020-12-15","3","310","0","21","14.3","7.1"
"Taliaferro","2020-12-16","10","320","2","23","2.9","8.6"
"Taliaferro","2020-12-17","0","320","0","23","2.9","8.6"
"Taliaferro","2020-12-18","1","321","0","23","2.9","8.6"
"Taliaferro","2020-12-19","2","323","0","23","2.9","8.6"
"Taliaferro","2020-12-20","0","323","0","23","2.9","8.6"
"Taliaferro","2020-12-21","4","327","0","23","2.9","8.6"
"Taliaferro","2020-12-22","4","331","0","23","2.9","8.6"
"Taliaferro","2020-12-23","2","333","0","23","0","1.4"
"Taliaferro","2020-12-24","0","333","0","23","0","1.4"
"Taliaferro","2020-12-25","0","333","0","23","0","1.4"
"Taliaferro","2020-12-26","2","335","0","23","0","1.4"
"Taliaferro","2020-12-27","3","338","3","26","14.3","8.6"
"Taliaferro","2020-12-28","0","338","0","26","14.3","8.6"
"Taliaferro","2020-12-29","3","341","1","27","19","11"
"Taliaferro","2020-12-30","1","342","0","27","19","9.5"
"Taliaferro","2020-12-31","2","344","2","29","33.3","16.7"
"Taliaferro","2021-01-01","1","345","0","29","33.3","16.7"
"Taliaferro","2021-01-02","1","346","0","29","33.3","16.7"
"Taliaferro","2021-01-03","0","346","0","29","19","16.7"
"Taliaferro","2021-01-04","2","348","1","30","26.2","20.2"
"Taliaferro","2021-01-05","8","356","5","35","30.4","24.7"
"Taliaferro","2021-01-06","8","364","1","36","32.1","25.6"
"Taliaferro","2021-01-07","7","371","0","36","17.9","25.6"
"Taliaferro","2021-01-08","2","373","1","37","25","29.2"
"Taliaferro","2021-01-09","5","378","2","39","30.7","32"
"Taliaferro","2021-01-10","2","380","1","40","37.9","28.5"
"Taliaferro","2021-01-11","6","386","1","41","33.1","29.6"
"Taliaferro","2021-01-12","5","391","2","43","29.9","30.1"
"Taliaferro","2021-01-13","2","393","0","43","28.1","30.1"
"Taliaferro","2021-01-14","5","398","3","46","36.7","27.3"
"Taliaferro","2021-01-15","8","406","1","47","31.3","28.2"
"Taliaferro","2021-01-16","5","411","0","47","25.6","28.2"
"Taliaferro","2021-01-17","0","411","0","47","18.5","28.2"
"Taliaferro","2021-01-18","3","414","0","47","16.1","24.6"
"Taliaferro","2021-01-19","3","417","1","48","15.1","22.5"
"Taliaferro","2021-01-20","3","420","2","50","24.6","26.4"
"Taliaferro","2021-01-21","2","422","1","51","23.2","29.9"
"Taliaferro","2021-01-22","1","423","0","51","21.4","26.4"
"Taliaferro","2021-01-23","2","425","0","51","21.4","23.5"
"Taliaferro","2021-01-24","1","426","1","52","35.7","27.1"
"Taliaferro","2021-01-25","1","427","0","52","35.7","25.9"
"Taliaferro","2021-01-26","4","431","0","52","31","23"
"Taliaferro","2021-01-27","2","433","1","53","28.6","26.6"
"Taliaferro","2021-01-28","2","435","0","53","21.4","22.3"
"Taliaferro","2021-01-29","2","437","1","54","28.6","25"
"Taliaferro","2021-01-30","4","441","1","55","32.1","26.8"
"Taliaferro","2021-01-31","2","443","0","55","17.9","26.8"
"Taliaferro","2021-02-01","0","443","0","55","17.9","26.8"
"Taliaferro","2021-02-02","4","447","0","55","17.9","24.4"
"Taliaferro","2021-02-03","1","448","0","55","10.7","19.6"
"Taliaferro","2021-02-04","0","448","0","55","10.7","16.1"
"Taliaferro","2021-02-05","0","448","0","55","3.6","16.1"
"Taliaferro","2021-02-06","0","448","0","55","0","16.1"
"Taliaferro","2021-02-07","0","448","0","55","0","8.9"
"Taliaferro","2021-02-08","0","448","0","55","0","8.9"
"Tattnall","2020-02-01","0","0","0","0",".","."
"Tattnall","2020-02-02","0","0","0","0",".","."
"Tattnall","2020-02-03","0","0","0","0",".","."
"Tattnall","2020-02-04","0","0","0","0",".","."
"Tattnall","2020-02-05","0","0","0","0",".","."
"Tattnall","2020-02-06","0","0","0","0",".","."
"Tattnall","2020-02-07","0","0","0","0","0","."
"Tattnall","2020-02-08","0","0","0","0","0","."
"Tattnall","2020-02-09","0","0","0","0","0","."
"Tattnall","2020-02-10","0","0","0","0","0","."
"Tattnall","2020-02-11","0","0","0","0","0","."
"Tattnall","2020-02-12","0","0","0","0","0","."
"Tattnall","2020-02-13","0","0","0","0","0","."
"Tattnall","2020-02-14","0","0","0","0","0","0"
"Tattnall","2020-02-15","0","0","0","0","0","0"
"Tattnall","2020-02-16","0","0","0","0","0","0"
"Tattnall","2020-02-17","0","0","0","0","0","0"
"Tattnall","2020-02-18","0","0","0","0","0","0"
"Tattnall","2020-02-19","0","0","0","0","0","0"
"Tattnall","2020-02-20","0","0","0","0","0","0"
"Tattnall","2020-02-21","0","0","0","0","0","0"
"Tattnall","2020-02-22","0","0","0","0","0","0"
"Tattnall","2020-02-23","0","0","0","0","0","0"
"Tattnall","2020-02-24","0","0","0","0","0","0"
"Tattnall","2020-02-25","0","0","0","0","0","0"
"Tattnall","2020-02-26","0","0","0","0","0","0"
"Tattnall","2020-02-27","0","0","0","0","0","0"
"Tattnall","2020-02-28","0","0","0","0","0","0"
"Tattnall","2020-02-29","0","0","0","0","0","0"
"Tattnall","2020-03-01","0","0","0","0","0","0"
"Tattnall","2020-03-02","0","0","0","0","0","0"
"Tattnall","2020-03-03","0","0","0","0","0","0"
"Tattnall","2020-03-04","0","0","0","0","0","0"
"Tattnall","2020-03-05","0","0","0","0","0","0"
"Tattnall","2020-03-06","0","0","0","0","0","0"
"Tattnall","2020-03-07","0","0","0","0","0","0"
"Tattnall","2020-03-08","0","0","0","0","0","0"
"Tattnall","2020-03-09","0","0","0","0","0","0"
"Tattnall","2020-03-10","0","0","0","0","0","0"
"Tattnall","2020-03-11","0","0","0","0","0","0"
"Tattnall","2020-03-12","1","1","0","0","0","0"
"Tattnall","2020-03-13","1","2","0","0","0","0"
"Tattnall","2020-03-14","0","2","0","0","0","0"
"Tattnall","2020-03-15","2","4","1","1","7.1","3.6"
"Tattnall","2020-03-16","2","6","0","1","7.1","3.6"
"Tattnall","2020-03-17","2","8","0","1","7.1","3.6"
"Tattnall","2020-03-18","4","12","0","1","7.1","3.6"
"Tattnall","2020-03-19","4","16","0","1","7.1","3.6"
"Tattnall","2020-03-20","3","19","0","1","7.1","3.6"
"Tattnall","2020-03-21","5","24","1","2","10","5"
"Tattnall","2020-03-22","1","25","0","2","2.9","5"
"Tattnall","2020-03-23","2","27","0","2","2.9","5"
"Tattnall","2020-03-24","3","30","0","2","2.9","5"
"Tattnall","2020-03-25","3","33","0","2","2.9","5"
"Tattnall","2020-03-26","2","35","0","2","2.9","5"
"Tattnall","2020-03-27","1","36","0","2","2.9","5"
"Tattnall","2020-03-28","3","39","0","2","0","5"
"Tattnall","2020-03-29","0","39","0","2","0","1.4"
"Tattnall","2020-03-30","1","40","0","2","0","1.4"
"Tattnall","2020-03-31","2","42","0","2","0","1.4"
"Tattnall","2020-04-01","2","44","1","3","7.1","5"
"Tattnall","2020-04-02","2","46","1","4","14.3","8.6"
"Tattnall","2020-04-03","5","51","0","4","14.3","8.6"
"Tattnall","2020-04-04","0","51","0","4","14.3","7.1"
"Tattnall","2020-04-05","0","51","0","4","14.3","7.1"
"Tattnall","2020-04-06","8","59","0","4","14.3","7.1"
"Tattnall","2020-04-07","6","65","0","4","14.3","7.1"
"Tattnall","2020-04-08","4","69","0","4","7.1","7.1"
"Tattnall","2020-04-09","5","74","0","4","0","7.1"
"Tattnall","2020-04-10","5","79","1","5","2.9","8.6"
"Tattnall","2020-04-11","0","79","0","5","2.9","8.6"
"Tattnall","2020-04-12","0","79","0","5","2.9","8.6"
"Tattnall","2020-04-13","1","80","0","5","2.9","8.6"
"Tattnall","2020-04-14","5","85","0","5","2.9","8.6"
"Tattnall","2020-04-15","7","92","0","5","2.9","5"
"Tattnall","2020-04-16","4","96","0","5","2.9","1.4"
"Tattnall","2020-04-17","6","102","0","5","0","1.4"
"Tattnall","2020-04-18","0","102","0","5","0","1.4"
"Tattnall","2020-04-19","6","108","0","5","0","1.4"
"Tattnall","2020-04-20","2","110","1","6","7.1","5"
"Tattnall","2020-04-21","8","118","1","7","8.9","5.9"
"Tattnall","2020-04-22","7","125","0","7","8.9","5.9"
"Tattnall","2020-04-23","5","130","1","8","11.8","7.3"
"Tattnall","2020-04-24","4","134","0","8","11.8","5.9"
"Tattnall","2020-04-25","0","134","0","8","11.8","5.9"
"Tattnall","2020-04-26","3","137","1","9","16.5","8.3"
"Tattnall","2020-04-27","10","147","0","9","9.4","8.3"
"Tattnall","2020-04-28","6","153","0","9","7.6","8.3"
"Tattnall","2020-04-29","5","158","0","9","7.6","8.3"
"Tattnall","2020-04-30","7","165","0","9","4.8","8.3"
"Tattnall","2020-05-01","10","175","0","9","4.8","8.3"
"Tattnall","2020-05-02","2","177","0","9","4.8","8.3"
"Tattnall","2020-05-03","2","179","0","9","0","8.3"
"Tattnall","2020-05-04","7","186","0","9","0","4.7"
"Tattnall","2020-05-05","8","194","0","9","0","3.8"
"Tattnall","2020-05-06","10","204","0","9","0","3.8"
"Tattnall","2020-05-07","3","207","0","9","0","2.4"
"Tattnall","2020-05-08","5","212","0","9","0","2.4"
"Tattnall","2020-05-09","1","213","0","9","0","2.4"
"Tattnall","2020-05-10","1","214","0","9","0","0"
"Tattnall","2020-05-11","6","220","0","9","0","0"
"Tattnall","2020-05-12","93","313","2","11","0.3","0.2"
"Tattnall","2020-05-13","5","318","2","13","6","3"
"Tattnall","2020-05-14","10","328","1","14","7.5","3.7"
"Tattnall","2020-05-15","4","332","0","14","7.5","3.7"
"Tattnall","2020-05-16","5","337","0","14","7.5","3.7"
"Tattnall","2020-05-17","5","342","0","14","7.5","3.7"
"Tattnall","2020-05-18","7","349","0","14","7.5","3.7"
"Tattnall","2020-05-19","9","358","0","14","7.1","3.7"
"Tattnall","2020-05-20","13","371","0","14","1.4","3.7"
"Tattnall","2020-05-21","16","387","1","15","0.9","4.2"
"Tattnall","2020-05-22","5","392","1","16","3.8","5.6"
"Tattnall","2020-05-23","2","394","1","17","10.9","9.2"
"Tattnall","2020-05-24","1","395","0","17","10.9","9.2"
"Tattnall","2020-05-25","3","398","0","17","10.9","9.2"
"Tattnall","2020-05-26","11","409","1","18","12.2","9.7"
"Tattnall","2020-05-27","12","421","3","21","15.8","8.6"
"Tattnall","2020-05-28","13","434","0","21","14.9","7.9"
"Tattnall","2020-05-29","12","446","0","21","12","7.9"
"Tattnall","2020-05-30","3","449","1","22","9.6","10.3"
"Tattnall","2020-05-31","2","451","0","22","9.6","10.3"
"Tattnall","2020-06-01","18","469","0","22","9.6","10.3"
"Tattnall","2020-06-02","9","478","0","22","8.3","10.3"
"Tattnall","2020-06-03","11","489","1","23","6.1","10.9"
"Tattnall","2020-06-04","19","508","0","23","6.1","10.5"
"Tattnall","2020-06-05","10","518","1","24","7.5","9.8"
"Tattnall","2020-06-06","5","523","1","25","5.6","7.6"
"Tattnall","2020-06-07","2","525","0","25","5.6","7.6"
"Tattnall","2020-06-08","25","550","4","29","7.9","8.8"
"Tattnall","2020-06-09","24","574","4","33","10.3","9.3"
"Tattnall","2020-06-10","14","588","5","38","14.1","10.1"
"Tattnall","2020-06-11","14","602","2","40","16.1","11.1"
"Tattnall","2020-06-12","17","619","5","45","18.9","13.2"
"Tattnall","2020-06-13","5","624","1","46","18.9","12.2"
"Tattnall","2020-06-14","9","633","2","48","22","13.8"
"Tattnall","2020-06-15","27","660","6","54","22.9","15.4"
"Tattnall","2020-06-16","73","733","2","56","20.9","15.6"
"Tattnall","2020-06-17","14","747","1","57","16.9","15.5"
"Tattnall","2020-06-18","95","842","10","67","16.3","16.2"
"Tattnall","2020-06-19","24","866","2","69","13.3","16.1"
"Tattnall","2020-06-20","8","874","1","70","12.2","15.6"
"Tattnall","2020-06-21","3","877","1","71","13.8","17.9"
"Tattnall","2020-06-22","42","919","9","80","13.7","18.3"
"Tattnall","2020-06-23","25","944","3","83","15","18"
"Tattnall","2020-06-24","47","991","10","93","17.1","17"
"Tattnall","2020-06-25","27","1018","4","97","17.7","17"
"Tattnall","2020-06-26","34","1052","3","100","17.7","15.5"
"Tattnall","2020-06-27","12","1064","2","102","18.3","15.3"
"Tattnall","2020-06-28","5","1069","1","103","16.4","15.1"
"Tattnall","2020-06-29","26","1095","5","108","16.1","14.9"
"Tattnall","2020-06-30","43","1138","9","117","17.4","16.2"
"Tattnall","2020-07-01","43","1181","12","129","18.3","17.7"
"Tattnall","2020-07-02","34","1215","2","131","17.1","17.4"
"Tattnall","2020-07-03","10","1225","2","133","18.7","18.2"
"Tattnall","2020-07-04","2","1227","0","133","16.3","17.3"
"Tattnall","2020-07-05","3","1230","1","134","18.2","17.3"
"Tattnall","2020-07-06","35","1265","6","140","17.9","17"
"Tattnall","2020-07-07","42","1307","6","146","16.9","17.2"
"Tattnall","2020-07-08","32","1339","7","153","16.1","17.2"
"Tattnall","2020-07-09","37","1376","8","161","18.3","17.7"
"Tattnall","2020-07-10","36","1412","8","169","18.6","18.6"
"Tattnall","2020-07-11","10","1422","3","172","22.9","19.6"
"Tattnall","2020-07-12","3","1425","1","173","22.9","20.6"
"Tattnall","2020-07-13","51","1476","18","191","25.5","21.7"
"Tattnall","2020-07-14","55","1531","19","210","28.4","22.7"
"Tattnall","2020-07-15","35","1566","12","222","30.2","23.1"
"Tattnall","2020-07-16","46","1612","15","237","31.8","25"
"Tattnall","2020-07-17","39","1651","15","252","34.1","26.4"
"Tattnall","2020-07-18","8","1659","3","255","35.1","29"
"Tattnall","2020-07-19","5","1664","1","256","33.2","28.1"
"Tattnall","2020-07-20","47","1711","12","268","31.8","28.7"
"Tattnall","2020-07-21","31","1742","7","275","30.1","29.3"
"Tattnall","2020-07-22","30","1772","7","282","28.6","29.4"
"Tattnall","2020-07-23","35","1807","12","294","28.8","30.3"
"Tattnall","2020-07-24","39","1846","7","301","25.9","30"
"Tattnall","2020-07-25","14","1860","8","309","28.7","31.9"
"Tattnall","2020-07-26","8","1868","1","310","27.6","30.4"
"Tattnall","2020-07-27","51","1919","13","323","27.6","29.7"
"Tattnall","2020-07-28","24","1943","9","332","29.7","29.9"
"Tattnall","2020-07-29","30","1973","7","339","29.7","29.2"
"Tattnall","2020-07-30","40","2013","10","349","28.4","28.6"
"Tattnall","2020-07-31","58","2071","9","358","28.1","27"
"Tattnall","2020-08-01","8","2079","4","362","27","27.9"
"Tattnall","2020-08-02","7","2086","4","366","33.4","30.5"
"Tattnall","2020-08-03","46","2132","13","379","33.8","30.7"
"Tattnall","2020-08-04","36","2168","8","387","31.6","30.7"
"Tattnall","2020-08-05","43","2211","9","396","31.3","30.5"
"Tattnall","2020-08-06","34","2245","5","401","29.8","29.1"
"Tattnall","2020-08-07","36","2281","8","409","30.8","29.4"
"Tattnall","2020-08-08","17","2298","4","413","27","27"
"Tattnall","2020-08-09","7","2305","1","414","20.9","27.2"
"Tattnall","2020-08-10","43","2348","12","426","20.8","27.3"
"Tattnall","2020-08-11","46","2394","12","438","21.4","26.5"
"Tattnall","2020-08-12","33","2427","12","450","23.6","27.4"
"Tattnall","2020-08-13","21","2448","4","454","24.2","27"
"Tattnall","2020-08-14","35","2483","3","457","22.3","26.5"
"Tattnall","2020-08-15","13","2496","4","461","23.3","25.1"
"Tattnall","2020-08-16","11","2507","2","463","23.8","22.4"
"Tattnall","2020-08-17","38","2545","6","469","22.1","21.5"
"Tattnall","2020-08-18","28","2573","3","472","19.9","20.7"
"Tattnall","2020-08-19","30","2603","6","478","17.6","20.6"
"Tattnall","2020-08-20","35","2638","5","483","16.9","20.6"
"Tattnall","2020-08-21","21","2659","4","487","18.4","20.3"
"Tattnall","2020-08-22","15","2674","1","488","15","19.1"
"Tattnall","2020-08-23","15","2689","3","491","15.2","19.5"
"Tattnall","2020-08-24","36","2725","3","494","14.1","18.1"
"Tattnall","2020-08-25","32","2757","3","497","14","16.9"
"Tattnall","2020-08-26","26","2783","3","500","12.7","15.2"
"Tattnall","2020-08-27","21","2804","2","502","12.1","14.5"
"Tattnall","2020-08-28","22","2826","1","503","10","14.2"
"Tattnall","2020-08-29","14","2840","5","508","14.1","14.6"
"Tattnall","2020-08-30","11","2851","2","510","13.9","14.6"
"Tattnall","2020-08-31","34","2885","5","515","14.8","14.5"
"Tattnall","2020-09-01","19","2904","5","520","17.2","15.6"
"Tattnall","2020-09-02","25","2929","4","524","17.9","15.3"
"Tattnall","2020-09-03","24","2953","5","529","19.5","15.8"
"Tattnall","2020-09-04","29","2982","5","534","21.3","15.6"
"Tattnall","2020-09-05","12","2994","1","535","17.4","15.8"
"Tattnall","2020-09-06","7","3001","0","535","14.8","14.3"
"Tattnall","2020-09-07","10","3011","0","535","12.7","13.7"
"Tattnall","2020-09-08","36","3047","14","549","14.5","15.8"
"Tattnall","2020-09-09","27","3074","8","557","16.4","17.1"
"Tattnall","2020-09-10","23","3097","4","561","15.9","17.7"
"Tattnall","2020-09-11","29","3126","5","566","15.9","18.6"
"Tattnall","2020-09-12","11","3137","2","568","17.3","17.4"
"Tattnall","2020-09-13","7","3144","1","569","19.4","17.1"
"Tattnall","2020-09-14","41","3185","5","574","21.1","16.9"
"Tattnall","2020-09-15","45","3230","9","583","18.4","16.4"
"Tattnall","2020-09-16","33","3263","14","597","20.2","18.3"
"Tattnall","2020-09-17","40","3303","5","602","19.5","17.7"
"Tattnall","2020-09-18","32","3335","7","609","20.2","18.1"
"Tattnall","2020-09-19","13","3348","3","612","20.9","19.1"
"Tattnall","2020-09-20","9","3357","1","613","20.5","19.9"
"Tattnall","2020-09-21","52","3409","10","623","21.5","21.3"
"Tattnall","2020-09-22","52","3461","4","627","19.7","19.1"
"Tattnall","2020-09-23","29","3490","4","631","15.6","17.9"
"Tattnall","2020-09-24","29","3519","3","634","15.3","17.4"
"Tattnall","2020-09-25","31","3550","3","637","13.6","16.9"
"Tattnall","2020-09-26","4","3554","0","637","10.3","15.6"
"Tattnall","2020-09-27","6","3560","1","638","11.1","15.8"
"Tattnall","2020-09-28","52","3612","3","641","9.1","15.3"
"Tattnall","2020-09-29","34","3646","2","643","8.9","14.3"
"Tattnall","2020-09-30","22","3668","4","647","9.5","12.6"
"Tattnall","2020-10-01","16","3684","3","650","10.7","13"
"Tattnall","2020-10-02","58","3742","3","653","10.1","11.8"
"Tattnall","2020-10-03","11","3753","3","656","14","12.1"
"Tattnall","2020-10-04","5","3758","2","658","17.3","14.2"
"Tattnall","2020-10-05","58","3816","5","663","17.7","13.4"
"Tattnall","2020-10-06","32","3848","3","666","18.2","13.5"
"Tattnall","2020-10-07","28","3876","3","669","17.1","13.3"
"Tattnall","2020-10-08","16","3892","2","671","16.2","13.5"
"Tattnall","2020-10-09","17","3909","0","671","15.5","12.8"
"Tattnall","2020-10-10","8","3917","2","673","15.2","14.6"
"Tattnall","2020-10-11","3","3920","1","674","14.2","15.8"
"Tattnall","2020-10-12","14","3934","0","674","13","15.3"
"Tattnall","2020-10-13","93","4027","16","690","14.1","16.2"
"Tattnall","2020-10-14","20","4047","5","695","16.1","16.6"
"Tattnall","2020-10-15","63","4110","5","700","15.5","15.9"
"Tattnall","2020-10-16","21","4131","7","707","20.3","17.9"
"Tattnall","2020-10-17","8","4139","0","707","16.7","15.9"
"Tattnall","2020-10-18","3","4142","0","707","11.9","13.1"
"Tattnall","2020-10-19","28","4170","5","712","14.5","13.7"
"Tattnall","2020-10-20","27","4197","3","715","13.6","13.9"
"Tattnall","2020-10-21","18","4215","2","717","11.6","13.9"
"Tattnall","2020-10-22","14","4229","2","719","12.5","14"
"Tattnall","2020-10-23","19","4248","3","722","10","15.1"
"Tattnall","2020-10-24","11","4259","0","722","10","13.4"
"Tattnall","2020-10-25","5","4264","0","722","10","11"
"Tattnall","2020-10-26","39","4303","6","728","9.7","12.1"
"Tattnall","2020-10-27","51","4354","9","737","10.6","12.1"
"Tattnall","2020-10-28","23","4377","1","738","9.6","10.6"
"Tattnall","2020-10-29","19","4396","3","741","9.9","11.2"
"Tattnall","2020-10-30","18","4414","2","743","9.2","9.6"
"Tattnall","2020-10-31","7","4421","0","743","9.2","9.6"
"Tattnall","2020-11-01","5","4426","0","743","9.2","9.6"
"Tattnall","2020-11-02","15","4441","3","746","9.8","9.8"
"Tattnall","2020-11-03","28","4469","5","751","9.9","10.2"
"Tattnall","2020-11-04","14","4483","1","752","10.3","10"
"Tattnall","2020-11-05","9","4492","1","753","9.6","9.7"
"Tattnall","2020-11-06","117","4609","2","755","8.3","8.7"
"Tattnall","2020-11-07","10","4619","1","756","9.7","9.4"
"Tattnall","2020-11-08","6","4625","1","757","12.1","10.6"
"Tattnall","2020-11-09","26","4651","4","761","11.4","10.6"
"Tattnall","2020-11-10","19","4670","2","763","10.4","10.1"
"Tattnall","2020-11-11","20","4690","3","766","11.5","10.9"
"Tattnall","2020-11-12","113","4803","1","767","10","9.8"
"Tattnall","2020-11-13","21","4824","0","767","9.8","9"
"Tattnall","2020-11-14","13","4837","0","767","8.4","9"
"Tattnall","2020-11-15","6","4843","1","768","8.4","10.2"
"Tattnall","2020-11-16","34","4877","4","772","7.8","9.6"
"Tattnall","2020-11-17","70","4947","3","775","6.9","8.7"
"Tattnall","2020-11-18","22","4969","2","777","6.1","8.8"
"Tattnall","2020-11-19","52","5021","1","778","6.2","8.1"
"Tattnall","2020-11-20","25","5046","3","781","8","8.9"
"Tattnall","2020-11-21","5","5051","0","781","8","8.2"
"Tattnall","2020-11-22","7","5058","0","781","5.6","7"
"Tattnall","2020-11-23","36","5094","8","789","7.1","7.5"
"Tattnall","2020-11-24","47","5141","1","790","6.8","6.9"
"Tattnall","2020-11-25","21","5162","1","791","6.1","6.1"
"Tattnall","2020-11-26","4","5166","0","791","5.9","6.1"
"Tattnall","2020-11-27","9","5175","2","793","7.3","7.6"
"Tattnall","2020-11-28","9","5184","3","796","12.1","10"
"Tattnall","2020-11-29","11","5195","3","799","16","10.8"
"Tattnall","2020-11-30","86","5281","9","808","14.3","10.7"
"Tattnall","2020-12-01","53","5334","6","814","15.6","11.2"
"Tattnall","2020-12-02","37","5371","9","823","18.4","12.3"
"Tattnall","2020-12-03","20","5391","6","829","22.7","14.3"
"Tattnall","2020-12-04","74","5465","6","835","20.7","14"
"Tattnall","2020-12-05","14","5479","4","839","20","16.1"
"Tattnall","2020-12-06","8","5487","1","840","17.9","16.9"
"Tattnall","2020-12-07","43","5530","8","848","19.1","16.7"
"Tattnall","2020-12-08","41","5571","6","854","19.5","17.6"
"Tattnall","2020-12-09","32","5603","5","859","18.3","18.4"
"Tattnall","2020-12-10","39","5642","5","864","15.8","19.3"
"Tattnall","2020-12-11","40","5682","11","875","18.6","19.6"
"Tattnall","2020-12-12","10","5692","0","875","14.5","17.3"
"Tattnall","2020-12-13","12","5704","4","879","17.5","17.7"
"Tattnall","2020-12-14","107","5811","20","899","17.5","18.3"
"Tattnall","2020-12-15","72","5883","7","906","16.8","18.2"
"Tattnall","2020-12-16","25","5908","6","912","18","18.2"
"Tattnall","2020-12-17","162","6070","11","923","17.1","16.5"
"Tattnall","2020-12-18","22","6092","5","928","16.5","17.5"
"Tattnall","2020-12-19","27","6119","4","932","18.6","16.6"
"Tattnall","2020-12-20","10","6129","3","935","18.1","17.8"
"Tattnall","2020-12-21","181","6310","17","952","16.8","17.1"
"Tattnall","2020-12-22","67","6377","11","963","17.7","17.3"
"Tattnall","2020-12-23","41","6418","17","980","20.2","19.1"
"Tattnall","2020-12-24","20","6438","3","983","21.4","19.3"
"Tattnall","2020-12-25","1","6439","0","983","18.2","17.3"
"Tattnall","2020-12-26","16","6455","6","989","21.4","20"
"Tattnall","2020-12-27","10","6465","6","995","25.7","21.9"
"Tattnall","2020-12-28","86","6551","25","1020","28.5","22.6"
"Tattnall","2020-12-29","78","6629","20","1040","29.8","23.8"
"Tattnall","2020-12-30","43","6672","11","1051","27.5","23.9"
"Tattnall","2020-12-31","50","6722","14","1065","29.4","25.4"
"Tattnall","2021-01-01","10","6732","1","1066","30.8","24.5"
"Tattnall","2021-01-02","11","6743","4","1070","30.7","26"
"Tattnall","2021-01-03","15","6758","4","1074","25.9","25.8"
"Tattnall","2021-01-04","95","6853","23","1097","25.2","26.9"
"Tattnall","2021-01-05","157","7010","40","1137","25.2","27.5"
"Tattnall","2021-01-06","64","7074","21","1158","26.2","26.9"
"Tattnall","2021-01-07","131","7205","17","1175","24.1","26.7"
"Tattnall","2021-01-08","52","7257","12","1187","25.9","28.4"
"Tattnall","2021-01-09","34","7291","11","1198","25.4","28"
"Tattnall","2021-01-10","30","7321","3","1201","23","24.4"
"Tattnall","2021-01-11","104","7425","26","1227","23.1","24.2"
"Tattnall","2021-01-12","68","7493","8","1235","21.1","23.2"
"Tattnall","2021-01-13","40","7533","8","1243","19.3","22.8"
"Tattnall","2021-01-14","109","7642","18","1261","19.8","21.9"
"Tattnall","2021-01-15","38","7680","3","1264","17.6","21.8"
"Tattnall","2021-01-16","19","7699","6","1270","17.5","21.5"
"Tattnall","2021-01-17","10","7709","3","1273","20.4","21.7"
"Tattnall","2021-01-18","66","7775","13","1286","19.6","21.4"
"Tattnall","2021-01-19","44","7819","10","1296","21.2","21.2"
"Tattnall","2021-01-20","46","7865","14","1310","22.7","21"
"Tattnall","2021-01-21","61","7926","7","1317","22","20.9"
"Tattnall","2021-01-22","106","8032","4","1321","21.4","19.5"
"Tattnall","2021-01-23","14","8046","4","1325","21","19.2"
"Tattnall","2021-01-24","13","8059","3","1328","20","20.2"
"Tattnall","2021-01-25","38","8097","14","1342","22.4","21"
"Tattnall","2021-01-26","45","8142","4","1346","20.4","20.8"
"Tattnall","2021-01-27","44","8186","4","1350","17.4","20"
"Tattnall","2021-01-28","38","8224","4","1354","17.3","19.6"
"Tattnall","2021-01-29","35","8259","8","1362","20","20.7"
"Tattnall","2021-01-30","10","8269","0","1362","15.9","18.4"
"Tattnall","2021-01-31","10","8279","5","1367","19.7","19.9"
"Tattnall","2021-02-01","44","8323","6","1373","16.4","19.4"
"Tattnall","2021-02-02","87","8410","9","1382","16.6","18.5"
"Tattnall","2021-02-03","31","8441","5","1387","17.6","17.5"
"Tattnall","2021-02-04","23","8464","5","1392","19.2","18.2"
"Tattnall","2021-02-05","21","8485","6","1398","20.1","20"
"Tattnall","2021-02-06","1","8486","0","1398","20.1","18"
"Tattnall","2021-02-07","0","8486","0","1398","12.9","16.3"
"Tattnall","2021-02-08","0","8486","0","1398","11","13.7"
"Taylor","2020-02-01","0","0","0","0",".","."
"Taylor","2020-02-02","0","0","0","0",".","."
"Taylor","2020-02-03","0","0","0","0",".","."
"Taylor","2020-02-04","0","0","0","0",".","."
"Taylor","2020-02-05","0","0","0","0",".","."
"Taylor","2020-02-06","0","0","0","0",".","."
"Taylor","2020-02-07","0","0","0","0","0","."
"Taylor","2020-02-08","0","0","0","0","0","."
"Taylor","2020-02-09","0","0","0","0","0","."
"Taylor","2020-02-10","0","0","0","0","0","."
"Taylor","2020-02-11","0","0","0","0","0","."
"Taylor","2020-02-12","0","0","0","0","0","."
"Taylor","2020-02-13","0","0","0","0","0","."
"Taylor","2020-02-14","0","0","0","0","0","0"
"Taylor","2020-02-15","0","0","0","0","0","0"
"Taylor","2020-02-16","0","0","0","0","0","0"
"Taylor","2020-02-17","0","0","0","0","0","0"
"Taylor","2020-02-18","0","0","0","0","0","0"
"Taylor","2020-02-19","0","0","0","0","0","0"
"Taylor","2020-02-20","0","0","0","0","0","0"
"Taylor","2020-02-21","0","0","0","0","0","0"
"Taylor","2020-02-22","0","0","0","0","0","0"
"Taylor","2020-02-23","0","0","0","0","0","0"
"Taylor","2020-02-24","0","0","0","0","0","0"
"Taylor","2020-02-25","0","0","0","0","0","0"
"Taylor","2020-02-26","0","0","0","0","0","0"
"Taylor","2020-02-27","0","0","0","0","0","0"
"Taylor","2020-02-28","0","0","0","0","0","0"
"Taylor","2020-02-29","0","0","0","0","0","0"
"Taylor","2020-03-01","0","0","0","0","0","0"
"Taylor","2020-03-02","0","0","0","0","0","0"
"Taylor","2020-03-03","0","0","0","0","0","0"
"Taylor","2020-03-04","0","0","0","0","0","0"
"Taylor","2020-03-05","0","0","0","0","0","0"
"Taylor","2020-03-06","0","0","0","0","0","0"
"Taylor","2020-03-07","0","0","0","0","0","0"
"Taylor","2020-03-08","0","0","0","0","0","0"
"Taylor","2020-03-09","0","0","0","0","0","0"
"Taylor","2020-03-10","0","0","0","0","0","0"
"Taylor","2020-03-11","2","2","0","0","0","0"
"Taylor","2020-03-12","0","2","0","0","0","0"
"Taylor","2020-03-13","0","2","0","0","0","0"
"Taylor","2020-03-14","0","2","0","0","0","0"
"Taylor","2020-03-15","0","2","0","0","0","0"
"Taylor","2020-03-16","0","2","0","0","0","0"
"Taylor","2020-03-17","1","3","0","0","0","0"
"Taylor","2020-03-18","2","5","0","0","0","0"
"Taylor","2020-03-19","3","8","0","0","0","0"
"Taylor","2020-03-20","1","9","0","0","0","0"
"Taylor","2020-03-21","0","9","0","0","0","0"
"Taylor","2020-03-22","1","10","1","1","14.3","7.1"
"Taylor","2020-03-23","2","12","0","1","14.3","7.1"
"Taylor","2020-03-24","3","15","0","1","14.3","7.1"
"Taylor","2020-03-25","5","20","1","2","17.1","8.6"
"Taylor","2020-03-26","1","21","1","3","31.4","15.7"
"Taylor","2020-03-27","3","24","0","3","31.4","15.7"
"Taylor","2020-03-28","0","24","0","3","31.4","15.7"
"Taylor","2020-03-29","0","24","0","3","17.1","15.7"
"Taylor","2020-03-30","2","26","0","3","17.1","15.7"
"Taylor","2020-03-31","0","26","0","3","17.1","15.7"
"Taylor","2020-04-01","4","30","2","5","21.4","19.3"
"Taylor","2020-04-02","5","35","3","8","15.7","23.6"
"Taylor","2020-04-03","1","36","0","8","15.7","23.6"
"Taylor","2020-04-04","0","36","0","8","15.7","23.6"
"Taylor","2020-04-05","2","38","2","10","30","23.6"
"Taylor","2020-04-06","3","41","0","10","30","23.6"
"Taylor","2020-04-07","11","52","1","11","31.3","24.2"
"Taylor","2020-04-08","4","56","2","13","31.3","26.4"
"Taylor","2020-04-09","5","61","2","15","28.4","22.1"
"Taylor","2020-04-10","1","62","0","15","28.4","22.1"
"Taylor","2020-04-11","1","63","0","15","28.4","22.1"
"Taylor","2020-04-12","0","63","0","15","14.2","22.1"
"Taylor","2020-04-13","0","63","0","15","14.2","22.1"
"Taylor","2020-04-14","3","66","2","17","22.4","26.8"
"Taylor","2020-04-15","2","68","1","18","22.4","26.8"
"Taylor","2020-04-16","4","72","0","18","16.7","22.6"
"Taylor","2020-04-17","6","78","0","18","16.7","22.6"
"Taylor","2020-04-18","0","78","0","18","16.7","22.6"
"Taylor","2020-04-19","0","78","0","18","16.7","15.4"
"Taylor","2020-04-20","6","84","2","20","21.4","17.8"
"Taylor","2020-04-21","3","87","0","20","11.9","17.1"
"Taylor","2020-04-22","9","96","1","21","6.3","14.4"
"Taylor","2020-04-23","6","102","0","21","6.3","11.5"
"Taylor","2020-04-24","3","105","1","22","11.1","13.9"
"Taylor","2020-04-25","0","105","0","22","11.1","13.9"
"Taylor","2020-04-26","1","106","0","22","11.1","13.9"
"Taylor","2020-04-27","4","110","0","22","6.3","13.9"
"Taylor","2020-04-28","4","114","0","22","6.3","9.1"
"Taylor","2020-04-29","5","119","2","24","10.5","8.4"
"Taylor","2020-04-30","4","123","0","24","10.5","8.4"
"Taylor","2020-05-01","4","127","1","25","9.3","10.2"
"Taylor","2020-05-02","4","131","0","25","9.3","10.2"
"Taylor","2020-05-03","4","135","0","25","9.3","10.2"
"Taylor","2020-05-04","5","140","0","25","9.3","7.8"
"Taylor","2020-05-05","4","144","0","25","9.3","7.8"
"Taylor","2020-05-06","1","145","0","25","3.6","7"
"Taylor","2020-05-07","8","153","2","27","7.1","8.8"
"Taylor","2020-05-08","3","156","0","27","3.6","6.4"
"Taylor","2020-05-09","1","157","0","27","3.6","6.4"
"Taylor","2020-05-10","2","159","0","27","3.6","6.4"
"Taylor","2020-05-11","7","166","0","27","3.6","6.4"
"Taylor","2020-05-12","6","172","0","27","3.6","6.4"
"Taylor","2020-05-13","8","180","0","27","3.6","3.6"
"Taylor","2020-05-14","13","193","1","28","1.1","4.1"
"Taylor","2020-05-15","10","203","0","28","1.1","2.3"
"Taylor","2020-05-16","1","204","0","28","1.1","2.3"
"Taylor","2020-05-17","1","205","0","28","1.1","2.3"
"Taylor","2020-05-18","6","211","1","29","3.5","3.5"
"Taylor","2020-05-19","2","213","0","29","3.5","3.5"
"Taylor","2020-05-20","5","218","0","29","3.5","3.5"
"Taylor","2020-05-21","9","227","2","31","5.6","3.3"
"Taylor","2020-05-22","2","229","0","31","5.6","3.3"
"Taylor","2020-05-23","1","230","0","31","5.6","3.3"
"Taylor","2020-05-24","0","230","0","31","5.6","3.3"
"Taylor","2020-05-25","2","232","0","31","3.2","3.3"
"Taylor","2020-05-26","3","235","0","31","3.2","3.3"
"Taylor","2020-05-27","9","244","0","31","3.2","3.3"
"Taylor","2020-05-28","11","255","0","31","0","2.8"
"Taylor","2020-05-29","6","261","0","31","0","2.8"
"Taylor","2020-05-30","0","261","0","31","0","2.8"
"Taylor","2020-05-31","2","263","0","31","0","2.8"
"Taylor","2020-06-01","5","268","0","31","0","1.6"
"Taylor","2020-06-02","6","274","0","31","0","1.6"
"Taylor","2020-06-03","4","278","0","31","0","1.6"
"Taylor","2020-06-04","5","283","0","31","0","0"
"Taylor","2020-06-05","10","293","1","32","1.4","0.7"
"Taylor","2020-06-06","0","293","0","32","1.4","0.7"
"Taylor","2020-06-07","1","294","0","32","1.4","0.7"
"Taylor","2020-06-08","5","299","0","32","1.4","0.7"
"Taylor","2020-06-09","5","304","1","33","4.3","2.1"
"Taylor","2020-06-10","5","309","0","33","4.3","2.1"
"Taylor","2020-06-11","11","320","1","34","5.6","2.8"
"Taylor","2020-06-12","5","325","1","35","7","4.2"
"Taylor","2020-06-13","1","326","0","35","7","4.2"
"Taylor","2020-06-14","6","332","0","35","7","4.2"
"Taylor","2020-06-15","4","336","0","35","7","4.2"
"Taylor","2020-06-16","15","351","0","35","4.2","4.2"
"Taylor","2020-06-17","10","361","0","35","4.2","4.2"
"Taylor","2020-06-18","11","372","0","35","2.9","4.2"
"Taylor","2020-06-19","9","381","1","36","1.6","4.3"
"Taylor","2020-06-20","2","383","0","36","1.6","4.3"
"Taylor","2020-06-21","17","400","0","36","1.6","4.3"
"Taylor","2020-06-22","9","409","0","36","1.6","4.3"
"Taylor","2020-06-23","10","419","0","36","1.6","2.9"
"Taylor","2020-06-24","6","425","0","36","1.6","2.9"
"Taylor","2020-06-25","23","448","0","36","1.6","2.2"
"Taylor","2020-06-26","8","456","0","36","0","0.8"
"Taylor","2020-06-27","1","457","0","36","0","0.8"
"Taylor","2020-06-28","2","459","0","36","0","0.8"
"Taylor","2020-06-29","7","466","0","36","0","0.8"
"Taylor","2020-06-30","23","489","0","36","0","0.8"
"Taylor","2020-07-01","9","498","0","36","0","0.8"
"Taylor","2020-07-02","9","507","0","36","0","0.8"
"Taylor","2020-07-03","2","509","0","36","0","0"
"Taylor","2020-07-04","1","510","0","36","0","0"
"Taylor","2020-07-05","0","510","0","36","0","0"
"Taylor","2020-07-06","21","531","2","38","1.4","0.7"
"Taylor","2020-07-07","8","539","0","38","1.4","0.7"
"Taylor","2020-07-08","28","567","6","44","4.4","2.2"
"Taylor","2020-07-09","14","581","1","45","5.4","2.7"
"Taylor","2020-07-10","24","605","7","52","9.6","4.8"
"Taylor","2020-07-11","1","606","0","52","9.6","4.8"
"Taylor","2020-07-12","1","607","0","52","9.6","4.8"
"Taylor","2020-07-13","7","614","0","52","8.2","4.8"
"Taylor","2020-07-14","21","635","1","53","8.9","5.1"
"Taylor","2020-07-15","10","645","2","55","8.7","6.6"
"Taylor","2020-07-16","22","667","0","55","7.7","6.6"
"Taylor","2020-07-17","21","688","2","57","4.9","7.3"
"Taylor","2020-07-18","4","692","0","57","4.9","7.3"
"Taylor","2020-07-19","2","694","0","57","4.9","7.3"
"Taylor","2020-07-20","8","702","1","58","6.7","7.5"
"Taylor","2020-07-21","25","727","4","62","8.3","8.6"
"Taylor","2020-07-22","12","739","0","62","5.4","7.1"
"Taylor","2020-07-23","21","760","1","63","6.1","6.9"
"Taylor","2020-07-24","29","789","6","69","7.7","6.3"
"Taylor","2020-07-25","4","793","0","69","7.7","6.3"
"Taylor","2020-07-26","3","796","0","69","7.7","6.3"
"Taylor","2020-07-27","5","801","2","71","11.6","9.2"
"Taylor","2020-07-28","25","826","0","71","9.4","8.8"
"Taylor","2020-07-29","2","828","0","71","9.4","7.4"
"Taylor","2020-07-30","34","862","3","74","9.9","8"
"Taylor","2020-07-31","12","874","3","77","10.5","9.1"
"Taylor","2020-08-01","5","879","2","79","16.3","12"
"Taylor","2020-08-02","2","881","0","79","16.3","12"
"Taylor","2020-08-03","7","888","0","79","10.5","11.1"
"Taylor","2020-08-04","48","936","1","80","10.8","10.1"
"Taylor","2020-08-05","6","942","0","80","10.8","10.1"
"Taylor","2020-08-06","19","961","0","80","9.6","9.8"
"Taylor","2020-08-07","24","985","8","88","10.8","10.7"
"Taylor","2020-08-08","2","987","0","88","5.1","10.7"
"Taylor","2020-08-09","6","993","0","88","5.1","10.7"
"Taylor","2020-08-10","7","1000","1","89","7.1","8.8"
"Taylor","2020-08-11","34","1034","7","96","9.7","10.3"
"Taylor","2020-08-12","2","1036","2","98","24","17.4"
"Taylor","2020-08-13","13","1049","0","98","24","16.8"
"Taylor","2020-08-14","22","1071","3","101","21.2","16"
"Taylor","2020-08-15","5","1076","1","102","24.1","14.6"
"Taylor","2020-08-16","6","1082","1","103","26.5","15.8"
"Taylor","2020-08-17","12","1094","1","104","25.6","16.4"
"Taylor","2020-08-18","16","1110","1","105","23.6","16.6"
"Taylor","2020-08-19","4","1114","0","105","9.3","16.6"
"Taylor","2020-08-20","17","1131","1","106","10.1","17.1"
"Taylor","2020-08-21","10","1141","2","108","11","16.1"
"Taylor","2020-08-22","2","1143","1","109","15.3","19.7"
"Taylor","2020-08-23","10","1153","3","112","17.2","21.8"
"Taylor","2020-08-24","14","1167","2","114","18.1","21.8"
"Taylor","2020-08-25","24","1191","1","115","17.8","20.7"
"Taylor","2020-08-26","18","1209","3","118","20.1","14.7"
"Taylor","2020-08-27","57","1266","13","131","22.6","16.3"
"Taylor","2020-08-28","20","1286","3","134","21.8","16.4"
"Taylor","2020-08-29","2","1288","0","134","14.7","15"
"Taylor","2020-08-30","8","1296","1","135","12.2","14.7"
"Taylor","2020-08-31","14","1310","1","136","11.2","14.6"
"Taylor","2020-09-01","15","1325","2","138","12.5","15.1"
"Taylor","2020-09-02","6","1331","1","139","12.5","16.3"
"Taylor","2020-09-03","14","1345","1","140","10.3","16.4"
"Taylor","2020-09-04","13","1358","4","144","12.5","17.2"
"Taylor","2020-09-05","5","1363","0","144","12.5","13.6"
"Taylor","2020-09-06","6","1369","1","145","13.1","12.7"
"Taylor","2020-09-07","5","1374","0","145","12.1","11.6"
"Taylor","2020-09-08","20","1394","5","150","13.7","13.1"
"Taylor","2020-09-09","7","1401","1","151","13.4","13"
"Taylor","2020-09-10","19","1420","3","154","14.6","12.4"
"Taylor","2020-09-11","11","1431","0","154","10.2","11.4"
"Taylor","2020-09-12","24","1455","3","157","12","12.3"
"Taylor","2020-09-13","5","1460","0","157","9.7","11.4"
"Taylor","2020-09-14","51","1511","13","170","13.3","12.7"
"Taylor","2020-09-15","35","1546","6","176","12.2","13"
"Taylor","2020-09-16","5","1551","2","178","15.8","14.6"
"Taylor","2020-09-17","8","1559","1","179","15.4","15"
"Taylor","2020-09-18","12","1571","0","179","15.4","12.8"
"Taylor","2020-09-19","3","1574","1","180","18.4","15.2"
"Taylor","2020-09-20","3","1577","0","180","18.4","14"
"Taylor","2020-09-21","6","1583","0","180","14.7","14"
"Taylor","2020-09-22","14","1597","3","183","15.3","13.7"
"Taylor","2020-09-23","5","1602","0","183","9.6","12.7"
"Taylor","2020-09-24","10","1612","1","184","9.3","12.3"
"Taylor","2020-09-25","14","1626","1","185","10.3","12.8"
"Taylor","2020-09-26","3","1629","1","186","10.3","14.3"
"Taylor","2020-09-27","4","1633","2","188","17.4","17.9"
"Taylor","2020-09-28","8","1641","0","188","17.4","16.1"
"Taylor","2020-09-29","34","1675","0","188","14.4","14.8"
"Taylor","2020-09-30","3","1678","1","189","19.1","14.4"
"Taylor","2020-10-01","23","1701","1","190","18.3","13.8"
"Taylor","2020-10-02","5","1706","0","190","17.3","13.8"
"Taylor","2020-10-03","7","1713","0","190","12.5","11.4"
"Taylor","2020-10-04","4","1717","0","190","5.4","11.4"
"Taylor","2020-10-05","8","1725","0","190","5.4","11.4"
"Taylor","2020-10-06","23","1748","0","190","5.4","9.9"
"Taylor","2020-10-07","2","1750","0","190","0.6","9.9"
"Taylor","2020-10-08","29","1779","0","190","0","9.2"
"Taylor","2020-10-09","10","1789","1","191","1.4","9.4"
"Taylor","2020-10-10","4","1793","1","192","5","8.8"
"Taylor","2020-10-11","1","1794","0","192","5","5.2"
"Taylor","2020-10-12","6","1800","0","192","5","5.2"
"Taylor","2020-10-13","19","1819","1","193","5.8","5.6"
"Taylor","2020-10-14","3","1822","0","193","5.8","3.2"
"Taylor","2020-10-15","17","1839","0","193","5.8","2.9"
"Taylor","2020-10-16","8","1847","1","194","6.1","3.8"
"Taylor","2020-10-17","1","1848","0","194","2.5","3.8"
"Taylor","2020-10-18","2","1850","0","194","2.5","3.8"
"Taylor","2020-10-19","6","1856","2","196","7.3","6.1"
"Taylor","2020-10-20","17","1873","1","197","7.4","6.6"
"Taylor","2020-10-21","11","1884","0","197","7.4","6.6"
"Taylor","2020-10-22","6","1890","2","199","12.1","9"
"Taylor","2020-10-23","7","1897","2","201","14.4","10.3"
"Taylor","2020-10-24","3","1900","0","201","14.4","8.5"
"Taylor","2020-10-25","2","1902","0","201","14.4","8.5"
"Taylor","2020-10-26","6","1908","0","201","9.7","8.5"
"Taylor","2020-10-27","12","1920","5","206","14.8","11.1"
"Taylor","2020-10-28","4","1924","0","206","14.8","11.1"
"Taylor","2020-10-29","9","1933","3","209","14.8","13.5"
"Taylor","2020-10-30","10","1943","2","211","13.6","14"
"Taylor","2020-10-31","3","1946","0","211","13.6","14"
"Taylor","2020-11-01","2","1948","0","211","13.6","14"
"Taylor","2020-11-02","6","1954","0","211","13.6","11.6"
"Taylor","2020-11-03","17","1971","2","213","9.3","12"
"Taylor","2020-11-04","10","1981","2","215","12.2","13.5"
"Taylor","2020-11-05","9","1990","0","215","7.4","11.1"
"Taylor","2020-11-06","12","2002","1","216","5.7","9.6"
"Taylor","2020-11-07","3","2005","0","216","5.7","9.6"
"Taylor","2020-11-08","4","2009","2","218","12.9","13.2"
"Taylor","2020-11-09","8","2017","0","218","12.9","13.2"
"Taylor","2020-11-10","14","2031","1","219","12.2","10.8"
"Taylor","2020-11-11","7","2038","1","220","11.4","11.8"
"Taylor","2020-11-12","15","2053","1","221","12.3","9.9"
"Taylor","2020-11-13","7","2060","1","222","13.2","9.5"
"Taylor","2020-11-14","1","2061","0","222","13.2","9.5"
"Taylor","2020-11-15","1","2062","0","222","6.1","9.5"
"Taylor","2020-11-16","14","2076","1","223","7.1","10"
"Taylor","2020-11-17","17","2093","0","223","6.1","9.1"
"Taylor","2020-11-18","11","2104","3","226","7.9","9.7"
"Taylor","2020-11-19","27","2131","4","230","9.1","10.7"
"Taylor","2020-11-20","12","2143","2","232","9.4","11.3"
"Taylor","2020-11-21","4","2147","1","233","13","13.1"
"Taylor","2020-11-22","2","2149","0","233","13","9.5"
"Taylor","2020-11-23","8","2157","1","234","13.8","10.4"
"Taylor","2020-11-24","26","2183","5","239","16.5","11.3"
"Taylor","2020-11-25","8","2191","2","241","16.2","12"
"Taylor","2020-11-26","1","2192","0","241","14.1","11.6"
"Taylor","2020-11-27","3","2195","2","243","21.2","15.3"
"Taylor","2020-11-28","1","2196","1","244","31.9","22.4"
"Taylor","2020-11-29","2","2198","1","245","39.1","26"
"Taylor","2020-11-30","5","2203","3","248","45.8","29.8"
"Taylor","2020-12-01","31","2234","2","250","44","30.3"
"Taylor","2020-12-02","6","2240","1","251","42.8","29.5"
"Taylor","2020-12-03","15","2255","3","254","45.7","29.9"
"Taylor","2020-12-04","7","2262","1","255","38.2","29.7"
"Taylor","2020-12-05","4","2266","0","255","23.9","27.9"
"Taylor","2020-12-06","3","2269","0","255","16.8","27.9"
"Taylor","2020-12-07","6","2275","2","257","13","29.4"
"Taylor","2020-12-08","19","2294","3","260","14.3","29.2"
"Taylor","2020-12-09","5","2299","3","263","20.5","31.7"
"Taylor","2020-12-10","19","2318","2","265","19.1","32.4"
"Taylor","2020-12-11","29","2347","6","271","20","29.1"
"Taylor","2020-12-12","6","2353","3","274","27.2","25.6"
"Taylor","2020-12-13","3","2356","1","275","32","24.4"
"Taylor","2020-12-14","8","2364","3","278","32.5","22.8"
"Taylor","2020-12-15","28","2392","3","281","31.8","23.1"
"Taylor","2020-12-16","11","2403","0","281","23.3","21.9"
"Taylor","2020-12-17","26","2429","3","284","23.4","21.3"
"Taylor","2020-12-18","10","2439","0","284","20.4","20.2"
"Taylor","2020-12-19","10","2449","4","288","19","23.1"
"Taylor","2020-12-20","8","2457","2","290","17.8","24.9"
"Taylor","2020-12-21","4","2461","0","290","12.5","22.5"
"Taylor","2020-12-22","34","2495","4","294","12.6","22.2"
"Taylor","2020-12-23","8","2503","2","296","16.2","19.7"
"Taylor","2020-12-24","5","2508","0","296","14.5","19"
"Taylor","2020-12-25","3","2511","1","297","19.3","19.9"
"Taylor","2020-12-26","10","2521","6","303","22.2","20.6"
"Taylor","2020-12-27","10","2531","4","307","24.3","21.1"
"Taylor","2020-12-28","15","2546","6","313","30","21.2"
"Taylor","2020-12-29","31","2577","3","316","29.7","21.2"
"Taylor","2020-12-30","10","2587","5","321","33.3","24.7"
"Taylor","2020-12-31","27","2614","5","326","35.9","25.2"
"Taylor","2021-01-01","3","2617","2","328","40.7","30"
"Taylor","2021-01-02","4","2621","1","329","35.7","28.9"
"Taylor","2021-01-03","5","2626","3","332","38.6","31.4"
"Taylor","2021-01-04","15","2641","3","335","35.7","32.9"
"Taylor","2021-01-05","31","2672","7","342","37.5","33.6"
"Taylor","2021-01-06","17","2689","8","350","37.1","35.2"
"Taylor","2021-01-07","29","2718","7","357","37.9","36.9"
"Taylor","2021-01-08","8","2726","1","358","30.2","35.4"
"Taylor","2021-01-09","6","2732","1","359","29","32.3"
"Taylor","2021-01-10","6","2738","3","362","27.6","33.1"
"Taylor","2021-01-11","11","2749","2","364","27.3","31.5"
"Taylor","2021-01-12","31","2780","10","374","28.7","33.1"
"Taylor","2021-01-13","13","2793","2","376","24.2","30.6"
"Taylor","2021-01-14","31","2824","6","382","23.5","30.7"
"Taylor","2021-01-15","10","2834","3","385","26","28.1"
"Taylor","2021-01-16","9","2843","4","389","29.9","29.5"
"Taylor","2021-01-17","18","2861","2","391","24.4","26"
"Taylor","2021-01-18","11","2872","2","393","24.4","25.8"
"Taylor","2021-01-19","18","2890","3","396","22.2","25.4"
"Taylor","2021-01-20","11","2901","0","396","20","22.1"
"Taylor","2021-01-21","29","2930","2","398","18.2","20.8"
"Taylor","2021-01-22","9","2939","2","400","17.1","21.5"
"Taylor","2021-01-23","4","2943","1","401","14.3","22.1"
"Taylor","2021-01-24","7","2950","2","403","16.8","20.6"
"Taylor","2021-01-25","7","2957","2","405","18.3","21.3"
"Taylor","2021-01-26","12","2969","3","408","19.5","20.8"
"Taylor","2021-01-27","13","2982","1","409","20.6","20.3"
"Taylor","2021-01-28","37","3019","3","412","20.7","19.5"
"Taylor","2021-01-29","5","3024","1","413","20.4","18.7"
"Taylor","2021-01-30","3","3027","0","413","16.8","15.6"
"Taylor","2021-01-31","2","3029","0","413","12.8","14.8"
"Taylor","2021-02-01","12","3041","1","414","9.9","14.1"
"Taylor","2021-02-02","26","3067","4","418","8.5","14"
"Taylor","2021-02-03","9","3076","0","418","7.4","14"
"Taylor","2021-02-04","12","3088","1","419","7.4","14.1"
"Taylor","2021-02-05","8","3096","1","420","6.4","13.4"
"Taylor","2021-02-06","4","3100","0","420","6.4","11.6"
"Taylor","2021-02-07","0","3100","0","420","6.4","9.6"
"Taylor","2021-02-08","0","3100","0","420","5.2","7.5"
"Telfair","2020-02-01","0","0","0","0",".","."
"Telfair","2020-02-02","0","0","0","0",".","."
"Telfair","2020-02-03","0","0","0","0",".","."
"Telfair","2020-02-04","0","0","0","0",".","."
"Telfair","2020-02-05","0","0","0","0",".","."
"Telfair","2020-02-06","0","0","0","0",".","."
"Telfair","2020-02-07","0","0","0","0","0","."
"Telfair","2020-02-08","0","0","0","0","0","."
"Telfair","2020-02-09","0","0","0","0","0","."
"Telfair","2020-02-10","0","0","0","0","0","."
"Telfair","2020-02-11","0","0","0","0","0","."
"Telfair","2020-02-12","0","0","0","0","0","."
"Telfair","2020-02-13","0","0","0","0","0","."
"Telfair","2020-02-14","0","0","0","0","0","0"
"Telfair","2020-02-15","0","0","0","0","0","0"
"Telfair","2020-02-16","0","0","0","0","0","0"
"Telfair","2020-02-17","0","0","0","0","0","0"
"Telfair","2020-02-18","0","0","0","0","0","0"
"Telfair","2020-02-19","0","0","0","0","0","0"
"Telfair","2020-02-20","0","0","0","0","0","0"
"Telfair","2020-02-21","0","0","0","0","0","0"
"Telfair","2020-02-22","0","0","0","0","0","0"
"Telfair","2020-02-23","0","0","0","0","0","0"
"Telfair","2020-02-24","0","0","0","0","0","0"
"Telfair","2020-02-25","0","0","0","0","0","0"
"Telfair","2020-02-26","0","0","0","0","0","0"
"Telfair","2020-02-27","0","0","0","0","0","0"
"Telfair","2020-02-28","0","0","0","0","0","0"
"Telfair","2020-02-29","0","0","0","0","0","0"
"Telfair","2020-03-01","0","0","0","0","0","0"
"Telfair","2020-03-02","0","0","0","0","0","0"
"Telfair","2020-03-03","0","0","0","0","0","0"
"Telfair","2020-03-04","0","0","0","0","0","0"
"Telfair","2020-03-05","0","0","0","0","0","0"
"Telfair","2020-03-06","0","0","0","0","0","0"
"Telfair","2020-03-07","0","0","0","0","0","0"
"Telfair","2020-03-08","0","0","0","0","0","0"
"Telfair","2020-03-09","0","0","0","0","0","0"
"Telfair","2020-03-10","0","0","0","0","0","0"
"Telfair","2020-03-11","0","0","0","0","0","0"
"Telfair","2020-03-12","0","0","0","0","0","0"
"Telfair","2020-03-13","0","0","0","0","0","0"
"Telfair","2020-03-14","0","0","0","0","0","0"
"Telfair","2020-03-15","1","1","0","0","0","0"
"Telfair","2020-03-16","0","1","0","0","0","0"
"Telfair","2020-03-17","1","2","0","0","0","0"
"Telfair","2020-03-18","1","3","0","0","0","0"
"Telfair","2020-03-19","4","7","0","0","0","0"
"Telfair","2020-03-20","7","14","0","0","0","0"
"Telfair","2020-03-21","0","14","0","0","0","0"
"Telfair","2020-03-22","1","15","0","0","0","0"
"Telfair","2020-03-23","8","23","0","0","0","0"
"Telfair","2020-03-24","11","34","0","0","0","0"
"Telfair","2020-03-25","1","35","0","0","0","0"
"Telfair","2020-03-26","2","37","0","0","0","0"
"Telfair","2020-03-27","1","38","0","0","0","0"
"Telfair","2020-03-28","0","38","0","0","0","0"
"Telfair","2020-03-29","1","39","0","0","0","0"
"Telfair","2020-03-30","0","39","0","0","0","0"
"Telfair","2020-03-31","2","41","1","1","7.1","3.6"
"Telfair","2020-04-01","1","42","1","2","21.4","10.7"
"Telfair","2020-04-02","2","44","0","2","21.4","10.7"
"Telfair","2020-04-03","4","48","0","2","21.4","10.7"
"Telfair","2020-04-04","4","52","1","3","25","12.5"
"Telfair","2020-04-05","2","54","0","3","25","12.5"
"Telfair","2020-04-06","1","55","0","3","25","12.5"
"Telfair","2020-04-07","13","68","2","5","20.1","13.6"
"Telfair","2020-04-08","3","71","0","5","5.8","13.6"
"Telfair","2020-04-09","8","79","0","5","5.8","13.6"
"Telfair","2020-04-10","2","81","0","5","5.8","13.6"
"Telfair","2020-04-11","9","90","1","6","3.8","14.4"
"Telfair","2020-04-12","3","93","0","6","3.8","14.4"
"Telfair","2020-04-13","8","101","2","8","7.4","16.2"
"Telfair","2020-04-14","6","107","0","8","5.2","12.6"
"Telfair","2020-04-15","3","110","0","8","5.2","5.5"
"Telfair","2020-04-16","4","114","0","8","5.2","5.5"
"Telfair","2020-04-17","4","118","0","8","5.2","5.5"
"Telfair","2020-04-18","2","120","1","9","10.7","7.2"
"Telfair","2020-04-19","1","121","1","10","25","14.4"
"Telfair","2020-04-20","38","159","1","11","21.8","14.6"
"Telfair","2020-04-21","10","169","3","14","26.1","15.6"
"Telfair","2020-04-22","6","175","0","14","26.1","15.6"
"Telfair","2020-04-23","2","177","0","14","26.1","15.6"
"Telfair","2020-04-24","7","184","4","18","34.3","19.7"
"Telfair","2020-04-25","0","184","0","18","27.1","18.9"
"Telfair","2020-04-26","1","185","0","18","12.8","18.9"
"Telfair","2020-04-27","4","189","0","18","12.4","17.1"
"Telfair","2020-04-28","8","197","1","19","9.9","18"
"Telfair","2020-04-29","3","200","0","19","9.9","18"
"Telfair","2020-04-30","4","204","0","19","9.9","18"
"Telfair","2020-05-01","6","210","1","20","4.2","19.2"
"Telfair","2020-05-02","1","211","0","20","4.2","15.6"
"Telfair","2020-05-03","2","213","0","20","4.2","8.5"
"Telfair","2020-05-04","5","218","0","20","4.2","8.3"
"Telfair","2020-05-05","7","225","0","20","2.4","6.2"
"Telfair","2020-05-06","4","229","0","20","2.4","6.2"
"Telfair","2020-05-07","1","230","0","20","2.4","6.2"
"Telfair","2020-05-08","3","233","1","21","4.8","4.5"
"Telfair","2020-05-09","4","237","0","21","4.8","4.5"
"Telfair","2020-05-10","0","237","0","21","4.8","4.5"
"Telfair","2020-05-11","2","239","0","21","4.8","4.5"
"Telfair","2020-05-12","1","240","0","21","4.8","3.6"
"Telfair","2020-05-13","6","246","0","21","4.8","3.6"
"Telfair","2020-05-14","5","251","0","21","4.8","3.6"
"Telfair","2020-05-15","3","254","0","21","0","2.4"
"Telfair","2020-05-16","3","257","0","21","0","2.4"
"Telfair","2020-05-17","2","259","0","21","0","2.4"
"Telfair","2020-05-18","8","267","0","21","0","2.4"
"Telfair","2020-05-19","5","272","0","21","0","2.4"
"Telfair","2020-05-20","8","280","0","21","0","2.4"
"Telfair","2020-05-21","4","284","0","21","0","2.4"
"Telfair","2020-05-22","9","293","0","21","0","0"
"Telfair","2020-05-23","2","295","0","21","0","0"
"Telfair","2020-05-24","2","297","0","21","0","0"
"Telfair","2020-05-25","4","301","0","21","0","0"
"Telfair","2020-05-26","7","308","0","21","0","0"
"Telfair","2020-05-27","1","309","0","21","0","0"
"Telfair","2020-05-28","11","320","1","22","1.3","0.6"
"Telfair","2020-05-29","7","327","0","22","1.3","0.6"
"Telfair","2020-05-30","2","329","0","22","1.3","0.6"
"Telfair","2020-05-31","0","329","0","22","1.3","0.6"
"Telfair","2020-06-01","5","334","0","22","1.3","0.6"
"Telfair","2020-06-02","10","344","0","22","1.3","0.6"
"Telfair","2020-06-03","5","349","0","22","1.3","0.6"
"Telfair","2020-06-04","1","350","0","22","0","0.6"
"Telfair","2020-06-05","4","354","0","22","0","0.6"
"Telfair","2020-06-06","2","356","2","24","14.3","7.8"
"Telfair","2020-06-07","0","356","0","24","14.3","7.8"
"Telfair","2020-06-08","9","365","0","24","14.3","7.8"
"Telfair","2020-06-09","9","374","0","24","14.3","7.8"
"Telfair","2020-06-10","2","376","1","25","21.4","11.4"
"Telfair","2020-06-11","7","383","0","25","21.4","10.7"
"Telfair","2020-06-12","7","390","5","30","31.6","15.8"
"Telfair","2020-06-13","4","394","2","32","24.5","19.4"
"Telfair","2020-06-14","0","394","0","32","24.5","19.4"
"Telfair","2020-06-15","4","398","0","32","24.5","19.4"
"Telfair","2020-06-16","11","409","2","34","27.1","20.7"
"Telfair","2020-06-17","3","412","1","35","24.7","23.1"
"Telfair","2020-06-18","6","418","2","37","29.5","25.4"
"Telfair","2020-06-19","6","424","0","37","19.3","25.4"
"Telfair","2020-06-20","0","424","0","37","12.1","18.3"
"Telfair","2020-06-21","2","426","1","38","19.3","21.9"
"Telfair","2020-06-22","8","434","3","41","24.6","24.6"
"Telfair","2020-06-23","7","441","1","42","24.1","25.6"
"Telfair","2020-06-24","10","451","1","43","20.7","22.7"
"Telfair","2020-06-25","16","467","1","44","16.9","23.2"
"Telfair","2020-06-26","7","474","0","44","16.9","18.1"
"Telfair","2020-06-27","2","476","0","44","16.9","14.5"
"Telfair","2020-06-28","1","477","1","45","24","21.6"
"Telfair","2020-06-29","6","483","2","47","23.4","24"
"Telfair","2020-06-30","6","489","0","47","21.4","22.7"
"Telfair","2020-07-01","9","498","1","48","21.5","21.1"
"Telfair","2020-07-02","12","510","3","51","24.2","20.5"
"Telfair","2020-07-03","5","515","1","52","27.1","22"
"Telfair","2020-07-04","1","516","1","53","41.3","29.1"
"Telfair","2020-07-05","2","518","1","54","34.2","29.1"
"Telfair","2020-07-06","6","524","0","54","29.4","26.4"
"Telfair","2020-07-07","6","530","1","55","31.8","26.6"
"Telfair","2020-07-08","6","536","3","58","37.4","29.5"
"Telfair","2020-07-09","4","540","2","60","41","32.6"
"Telfair","2020-07-10","5","545","1","61","41","34"
"Telfair","2020-07-11","1","546","0","61","26.7","34"
"Telfair","2020-07-12","2","548","0","61","19.5","26.9"
"Telfair","2020-07-13","5","553","1","62","22.4","25.9"
"Telfair","2020-07-14","6","559","1","63","22.4","27.1"
"Telfair","2020-07-15","6","565","2","65","20","28.7"
"Telfair","2020-07-16","5","570","0","65","12.9","26.9"
"Telfair","2020-07-17","8","578","1","66","11.8","26.4"
"Telfair","2020-07-18","3","581","1","67","16.5","21.6"
"Telfair","2020-07-19","0","581","0","67","16.5","18"
"Telfair","2020-07-20","6","587","1","68","16.1","19.2"
"Telfair","2020-07-21","2","589","0","68","13.7","18"
"Telfair","2020-07-22","1","590","0","68","8.9","14.5"
"Telfair","2020-07-23","3","593","1","69","13.7","13.3"
"Telfair","2020-07-24","9","602","0","69","11.9","11.8"
"Telfair","2020-07-25","0","602","0","69","7.1","11.8"
"Telfair","2020-07-26","0","602","0","69","7.1","11.8"
"Telfair","2020-07-27","3","605","1","70","9.5","12.8"
"Telfair","2020-07-28","11","616","0","70","9.5","11.6"
"Telfair","2020-07-29","3","619","1","71","14.3","11.6"
"Telfair","2020-07-30","15","634","5","76","14.3","14"
"Telfair","2020-07-31","4","638","1","77","17.9","14.9"
"Telfair","2020-08-01","4","642","0","77","17.9","12.5"
"Telfair","2020-08-02","0","642","0","77","17.9","12.5"
"Telfair","2020-08-03","8","650","0","77","13.1","11.3"
"Telfair","2020-08-04","2","652","0","77","13.1","11.3"
"Telfair","2020-08-05","8","660","2","79","11.9","13.1"
"Telfair","2020-08-06","6","666","2","81","11.9","13.1"
"Telfair","2020-08-07","3","669","1","82","13.1","15.5"
"Telfair","2020-08-08","3","672","0","82","13.1","15.5"
"Telfair","2020-08-09","2","674","2","84","27.4","22.6"
"Telfair","2020-08-10","14","688","1","85","28.4","20.7"
"Telfair","2020-08-11","7","695","0","85","28.4","20.7"
"Telfair","2020-08-12","1","696","0","85","24.8","18.4"
"Telfair","2020-08-13","3","699","0","85","20.1","16"
"Telfair","2020-08-14","2","701","0","85","15.3","14.2"
"Telfair","2020-08-15","18","719","3","88","17.7","15.4"
"Telfair","2020-08-16","0","719","0","88","3.4","15.4"
"Telfair","2020-08-17","6","725","1","89","4.8","16.6"
"Telfair","2020-08-18","5","730","0","89","4.8","16.6"
"Telfair","2020-08-19","11","741","1","90","6.1","15.4"
"Telfair","2020-08-20","4","745","0","90","6.1","13.1"
"Telfair","2020-08-21","3","748","1","91","10.8","13.1"
"Telfair","2020-08-22","5","753","1","92","11.3","14.5"
"Telfair","2020-08-23","0","753","0","92","11.3","7.4"
"Telfair","2020-08-24","4","757","0","92","8.9","6.8"
"Telfair","2020-08-25","10","767","1","93","10.3","7.6"
"Telfair","2020-08-26","5","772","0","93","9","7.6"
"Telfair","2020-08-27","6","778","1","94","11.4","8.7"
"Telfair","2020-08-28","5","783","1","95","9.5","10.2"
"Telfair","2020-08-29","3","786","0","95","6.7","9"
"Telfair","2020-08-30","6","792","0","95","6.7","9"
"Telfair","2020-08-31","9","801","1","96","8.3","8.6"
"Telfair","2020-09-01","9","810","0","96","6.8","8.6"
"Telfair","2020-09-02","6","816","1","97","9.2","9.1"
"Telfair","2020-09-03","7","823","2","99","10.9","11.2"
"Telfair","2020-09-04","3","826","0","99","8","8.8"
"Telfair","2020-09-05","1","827","0","99","8","7.4"
"Telfair","2020-09-06","8","835","0","99","8","7.4"
"Telfair","2020-09-07","5","840","0","99","6.5","7.4"
"Telfair","2020-09-08","7","847","0","99","6.5","6.6"
"Telfair","2020-09-09","6","853","1","100","6.5","7.8"
"Telfair","2020-09-10","8","861","2","102","6","8.4"
"Telfair","2020-09-11","3","864","1","103","10.7","9.4"
"Telfair","2020-09-12","3","867","0","103","10.7","9.4"
"Telfair","2020-09-13","2","869","1","104","17.9","13"
"Telfair","2020-09-14","11","880","1","105","19.2","12.8"
"Telfair","2020-09-15","16","896","0","105","19.2","12.8"
"Telfair","2020-09-16","6","902","1","106","19.2","12.8"
"Telfair","2020-09-17","13","915","1","107","16.7","11.3"
"Telfair","2020-09-18","8","923","1","108","13.7","12.2"
"Telfair","2020-09-19","1","924","1","109","28","19.4"
"Telfair","2020-09-20","5","929","0","109","20.8","19.4"
"Telfair","2020-09-21","8","937","0","109","19.6","19.4"
"Telfair","2020-09-22","10","947","1","110","21","20.1"
"Telfair","2020-09-23","3","950","0","110","18.6","18.9"
"Telfair","2020-09-24","4","954","0","110","17.5","17.1"
"Telfair","2020-09-25","3","957","0","110","15.7","14.7"
"Telfair","2020-09-26","1","958","0","110","1.4","14.7"
"Telfair","2020-09-27","1","959","1","111","15.7","18.3"
"Telfair","2020-09-28","8","967","1","112","17.5","18.5"
"Telfair","2020-09-29","9","976","0","112","16.1","18.5"
"Telfair","2020-09-30","5","981","0","112","16.1","17.3"
"Telfair","2020-10-01","6","987","0","112","16.1","16.8"
"Telfair","2020-10-02","4","991","1","113","19.6","17.7"
"Telfair","2020-10-03","0","991","0","113","19.6","10.5"
"Telfair","2020-10-04","5","996","1","114","8.2","12"
"Telfair","2020-10-05","7","1003","3","117","12.6","15"
"Telfair","2020-10-06","6","1009","1","118","14.9","15.5"
"Telfair","2020-10-07","5","1014","1","119","17.8","16.9"
"Telfair","2020-10-08","8","1022","0","119","17.8","16.9"
"Telfair","2020-10-09","2","1024","0","119","14.2","16.9"
"Telfair","2020-10-10","2","1026","0","119","14.2","16.9"
"Telfair","2020-10-11","8","1034","4","123","18.5","13.4"
"Telfair","2020-10-12","5","1039","0","123","12.4","12.5"
"Telfair","2020-10-13","6","1045","1","124","12.4","13.7"
"Telfair","2020-10-14","5","1050","0","124","9.5","13.7"
"Telfair","2020-10-15","9","1059","2","126","12.7","15.2"
"Telfair","2020-10-16","83","1142","55","181","22.2","18.2"
"Telfair","2020-10-17","1","1143","0","181","22.2","18.2"
"Telfair","2020-10-18","3","1146","0","181","15","16.8"
"Telfair","2020-10-19","9","1155","2","183","18.2","15.3"
"Telfair","2020-10-20","11","1166","3","186","19.7","16"
"Telfair","2020-10-21","8","1174","1","187","21.5","15.5"
"Telfair","2020-10-22","7","1181","0","187","18.3","15.5"
"Telfair","2020-10-23","4","1185","1","188","12.4","17.3"
"Telfair","2020-10-24","5","1190","0","188","12.4","17.3"
"Telfair","2020-10-25","3","1193","0","188","12.4","13.7"
"Telfair","2020-10-26","3","1196","0","188","9.3","13.7"
"Telfair","2020-10-27","10","1206","0","188","5.4","12.5"
"Telfair","2020-10-28","4","1210","1","189","7.1","14.3"
"Telfair","2020-10-29","5","1215","2","191","12.9","15.6"
"Telfair","2020-10-30","3","1218","0","191","9.3","10.9"
"Telfair","2020-10-31","7","1225","1","192","11.3","11.9"
"Telfair","2020-11-01","4","1229","0","192","11.3","11.9"
"Telfair","2020-11-02","48","1277","0","192","11.3","10.3"
"Telfair","2020-11-03","4","1281","1","193","14.9","10.1"
"Telfair","2020-11-04","8","1289","0","193","11.3","9.2"
"Telfair","2020-11-05","11","1300","0","193","5.6","9.2"
"Telfair","2020-11-06","6","1306","0","193","5.6","7.4"
"Telfair","2020-11-07","3","1309","0","193","3.6","7.4"
"Telfair","2020-11-08","6","1315","0","193","3.6","7.4"
"Telfair","2020-11-09","6","1321","2","195","8.3","9.8"
"Telfair","2020-11-10","8","1329","0","195","4.8","9.8"
"Telfair","2020-11-11","2","1331","0","195","4.8","8"
"Telfair","2020-11-12","6","1337","1","196","7.1","6.4"
"Telfair","2020-11-13","4","1341","0","196","7.1","6.4"
"Telfair","2020-11-14","4","1345","1","197","10.7","7.1"
"Telfair","2020-11-15","4","1349","0","197","10.7","7.1"
"Telfair","2020-11-16","5","1354","1","198","8.8","8.6"
"Telfair","2020-11-17","7","1361","1","199","10.9","7.8"
"Telfair","2020-11-18","3","1364","0","199","10.9","7.8"
"Telfair","2020-11-19","12","1376","2","201","10.9","9"
"Telfair","2020-11-20","6","1382","0","201","10.9","9"
"Telfair","2020-11-21","1","1383","0","201","7.3","9"
"Telfair","2020-11-22","2","1385","0","201","7.3","9"
"Telfair","2020-11-23","5","1390","0","201","4.4","6.6"
"Telfair","2020-11-24","14","1404","1","202","3.4","7.1"
"Telfair","2020-11-25","4","1408","0","202","3.4","7.1"
"Telfair","2020-11-26","1","1409","0","202","1","5.9"
"Telfair","2020-11-27","7","1416","1","203","3.1","7"
"Telfair","2020-11-28","3","1419","0","203","3.1","5.2"
"Telfair","2020-11-29","0","1419","0","203","3.1","5.2"
"Telfair","2020-11-30","5","1424","0","203","3.1","3.7"
"Telfair","2020-12-01","6","1430","0","203","2","2.7"
"Telfair","2020-12-02","9","1439","0","203","2","2.7"
"Telfair","2020-12-03","7","1446","0","203","2","1.5"
"Telfair","2020-12-04","4","1450","1","204","3.6","3.3"
"Telfair","2020-12-05","6","1456","0","204","3.6","3.3"
"Telfair","2020-12-06","3","1459","0","204","3.6","3.3"
"Telfair","2020-12-07","10","1469","1","205","5","4"
"Telfair","2020-12-08","7","1476","0","205","5","3.5"
"Telfair","2020-12-09","5","1481","1","206","7.9","4.9"
"Telfair","2020-12-10","10","1491","3","209","12.1","7.1"
"Telfair","2020-12-11","8","1499","2","211","12.1","7.9"
"Telfair","2020-12-12","4","1503","0","211","12.1","7.9"
"Telfair","2020-12-13","0","1503","0","211","12.1","7.9"
"Telfair","2020-12-14","7","1510","2","213","14.8","9.9"
"Telfair","2020-12-15","10","1520","0","213","14.8","9.9"
"Telfair","2020-12-16","11","1531","0","213","11.9","9.9"
"Telfair","2020-12-17","8","1539","2","215","11.2","11.7"
"Telfair","2020-12-18","9","1548","2","217","10.8","11.5"
"Telfair","2020-12-19","8","1556","1","218","12.6","12.4"
"Telfair","2020-12-20","8","1564","3","221","18","15.1"
"Telfair","2020-12-21","13","1577","0","221","13.9","14.3"
"Telfair","2020-12-22","16","1593","0","221","13.9","14.3"
"Telfair","2020-12-23","12","1605","0","221","13.9","12.9"
"Telfair","2020-12-24","4","1609","0","221","10.3","10.8"
"Telfair","2020-12-25","1","1610","0","221","7.1","9"
"Telfair","2020-12-26","6","1616","1","222","7.7","10.2"
"Telfair","2020-12-27","7","1623","3","225","8.5","13.2"
"Telfair","2020-12-28","15","1638","3","228","11.4","12.6"
"Telfair","2020-12-29","9","1647","1","229","12.9","13.4"
"Telfair","2020-12-30","15","1662","4","233","16.8","15.3"
"Telfair","2020-12-31","13","1675","2","235","19","14.6"
"Telfair","2021-01-01","5","1680","1","236","21.8","14.5"
"Telfair","2021-01-02","9","1689","1","237","21","14.4"
"Telfair","2021-01-03","5","1694","2","239","20.6","14.6"
"Telfair","2021-01-04","11","1705","4","243","22.9","17.2"
"Telfair","2021-01-05","18","1723","2","245","22.9","17.9"
"Telfair","2021-01-06","10","1733","3","248","23.4","20.1"
"Telfair","2021-01-07","6","1739","2","250","26","22.5"
"Telfair","2021-01-08","13","1752","1","251","24.2","23"
"Telfair","2021-01-09","3","1755","1","252","27.4","24.2"
"Telfair","2021-01-10","7","1762","0","252","21.7","21.2"
"Telfair","2021-01-11","16","1778","4","256","20.1","21.5"
"Telfair","2021-01-12","12","1790","1","257","19.7","21.3"
"Telfair","2021-01-13","7","1797","0","257","15.4","19.4"
"Telfair","2021-01-14","10","1807","2","259","13.5","19.7"
"Telfair","2021-01-15","6","1813","1","260","14.8","19.5"
"Telfair","2021-01-16","12","1825","1","261","11.2","19.3"
"Telfair","2021-01-17","4","1829","2","263","18.3","20"
"Telfair","2021-01-18","12","1841","1","264","16","18"
"Telfair","2021-01-19","14","1855","1","265","15.8","17.7"
"Telfair","2021-01-20","10","1865","1","266","17.2","16.3"
"Telfair","2021-01-21","7","1872","1","267","16.4","14.9"
"Telfair","2021-01-22","9","1881","2","269","17.2","16"
"Telfair","2021-01-23","6","1887","0","269","16","13.6"
"Telfair","2021-01-24","2","1889","0","269","8.9","13.6"
"Telfair","2021-01-25","14","1903","1","270","8.7","12.3"
"Telfair","2021-01-26","11","1914","2","272","10.3","13"
"Telfair","2021-01-27","4","1918","1","273","12.4","14.8"
"Telfair","2021-01-28","9","1927","2","275","13.5","15"
"Telfair","2021-01-29","74","2001","1","276","10.6","13.9"
"Telfair","2021-01-30","13","2014","4","280","15","15.5"
"Telfair","2021-01-31","3","2017","0","280","15","11.9"
"Telfair","2021-02-01","13","2030","3","283","17.2","13"
"Telfair","2021-02-02","10","2040","3","286","18.9","14.6"
"Telfair","2021-02-03","11","2051","2","288","17.9","15.2"
"Telfair","2021-02-04","13","2064","5","293","20.3","16.9"
"Telfair","2021-02-05","5","2069","0","293","20.1","15.3"
"Telfair","2021-02-06","1","2070","0","293","15.7","15.3"
"Telfair","2021-02-07","0","2070","0","293","15.7","15.3"
"Telfair","2021-02-08","0","2070","0","293","12.4","14.8"
"Terrell","2020-02-01","0","0","0","0",".","."
"Terrell","2020-02-02","0","0","0","0",".","."
"Terrell","2020-02-03","0","0","0","0",".","."
"Terrell","2020-02-04","0","0","0","0",".","."
"Terrell","2020-02-05","0","0","0","0",".","."
"Terrell","2020-02-06","0","0","0","0",".","."
"Terrell","2020-02-07","0","0","0","0","0","."
"Terrell","2020-02-08","0","0","0","0","0","."
"Terrell","2020-02-09","0","0","0","0","0","."
"Terrell","2020-02-10","0","0","0","0","0","."
"Terrell","2020-02-11","0","0","0","0","0","."
"Terrell","2020-02-12","0","0","0","0","0","."
"Terrell","2020-02-13","0","0","0","0","0","."
"Terrell","2020-02-14","0","0","0","0","0","0"
"Terrell","2020-02-15","0","0","0","0","0","0"
"Terrell","2020-02-16","0","0","0","0","0","0"
"Terrell","2020-02-17","0","0","0","0","0","0"
"Terrell","2020-02-18","0","0","0","0","0","0"
"Terrell","2020-02-19","0","0","0","0","0","0"
"Terrell","2020-02-20","0","0","0","0","0","0"
"Terrell","2020-02-21","0","0","0","0","0","0"
"Terrell","2020-02-22","0","0","0","0","0","0"
"Terrell","2020-02-23","0","0","0","0","0","0"
"Terrell","2020-02-24","0","0","0","0","0","0"
"Terrell","2020-02-25","0","0","0","0","0","0"
"Terrell","2020-02-26","0","0","0","0","0","0"
"Terrell","2020-02-27","0","0","0","0","0","0"
"Terrell","2020-02-28","0","0","0","0","0","0"
"Terrell","2020-02-29","0","0","0","0","0","0"
"Terrell","2020-03-01","0","0","0","0","0","0"
"Terrell","2020-03-02","0","0","0","0","0","0"
"Terrell","2020-03-03","0","0","0","0","0","0"
"Terrell","2020-03-04","0","0","0","0","0","0"
"Terrell","2020-03-05","0","0","0","0","0","0"
"Terrell","2020-03-06","0","0","0","0","0","0"
"Terrell","2020-03-07","0","0","0","0","0","0"
"Terrell","2020-03-08","0","0","0","0","0","0"
"Terrell","2020-03-09","0","0","0","0","0","0"
"Terrell","2020-03-10","0","0","0","0","0","0"
"Terrell","2020-03-11","0","0","0","0","0","0"
"Terrell","2020-03-12","0","0","0","0","0","0"
"Terrell","2020-03-13","2","2","1","1","7.1","3.6"
"Terrell","2020-03-14","2","4","1","2","14.3","7.1"
"Terrell","2020-03-15","0","4","0","2","14.3","7.1"
"Terrell","2020-03-16","3","7","1","3","19","9.5"
"Terrell","2020-03-17","5","12","0","3","19","9.5"
"Terrell","2020-03-18","4","16","1","4","22.6","11.3"
"Terrell","2020-03-19","7","23","2","6","26.7","13.4"
"Terrell","2020-03-20","8","31","5","11","28.5","17.8"
"Terrell","2020-03-21","13","44","9","20","31.2","22.8"
"Terrell","2020-03-22","2","46","1","21","38.4","26.3"
"Terrell","2020-03-23","19","65","8","29","39.6","29.3"
"Terrell","2020-03-24","25","90","11","40","45.9","32.5"
"Terrell","2020-03-25","13","103","7","47","50","36.3"
"Terrell","2020-03-26","12","115","6","53","53.1","39.9"
"Terrell","2020-03-27","14","129","7","60","51.3","39.9"
"Terrell","2020-03-28","13","142","8","68","50.2","40.7"
"Terrell","2020-03-29","5","147","2","70","48.8","43.6"
"Terrell","2020-03-30","23","170","11","81","49.6","44.6"
"Terrell","2020-03-31","8","178","4","85","50.5","48.2"
"Terrell","2020-04-01","16","194","8","93","49.9","50"
"Terrell","2020-04-02","11","205","3","96","46.7","49.9"
"Terrell","2020-04-03","7","212","6","102","51.8","51.5"
"Terrell","2020-04-04","6","218","3","105","50.1","50.2"
"Terrell","2020-04-05","7","225","2","107","48.5","48.6"
"Terrell","2020-04-06","26","251","12","119","48.2","48.9"
"Terrell","2020-04-07","9","260","5","124","49","49.7"
"Terrell","2020-04-08","12","272","3","127","45.5","47.7"
"Terrell","2020-04-09","11","283","4","131","46.8","46.7"
"Terrell","2020-04-10","9","292","2","133","37.7","44.7"
"Terrell","2020-04-11","16","308","2","135","32.3","41.2"
"Terrell","2020-04-12","2","310","0","135","28.3","38.4"
"Terrell","2020-04-13","12","322","1","136","22.9","35.5"
"Terrell","2020-04-14","27","349","7","143","18.6","33.8"
"Terrell","2020-04-15","20","369","3","146","17.2","31.3"
"Terrell","2020-04-16","21","390","4","150","14.7","30.7"
"Terrell","2020-04-17","6","396","1","151","13.9","25.8"
"Terrell","2020-04-18","11","407","1","152","13.4","22.9"
"Terrell","2020-04-19","7","414","1","153","15.5","21.9"
"Terrell","2020-04-20","23","437","5","158","17.4","20.1"
"Terrell","2020-04-21","10","447","1","159","15.1","16.9"
"Terrell","2020-04-22","16","463","3","162","15.7","16.4"
"Terrell","2020-04-23","11","474","3","165","16.8","15.8"
"Terrell","2020-04-24","17","491","5","170","18.7","16.3"
"Terrell","2020-04-25","4","495","1","171","20.9","17.2"
"Terrell","2020-04-26","4","499","1","172","22.5","19"
"Terrell","2020-04-27","17","516","5","177","23.5","20.5"
"Terrell","2020-04-28","18","534","2","179","23.7","19.4"
"Terrell","2020-04-29","34","568","3","182","22.3","19"
"Terrell","2020-04-30","14","582","1","183","19.4","18.1"
"Terrell","2020-05-01","12","594","1","184","16.4","17.5"
"Terrell","2020-05-02","13","607","2","186","15","18"
"Terrell","2020-05-03","6","613","0","186","11.5","17"
"Terrell","2020-05-04","24","637","1","187","7.9","15.7"
"Terrell","2020-05-05","10","647","0","187","6.3","15"
"Terrell","2020-05-06","18","665","0","187","5","13.6"
"Terrell","2020-05-07","45","710","1","188","4.3","11.9"
"Terrell","2020-05-08","1","711","0","188","3.1","9.8"
"Terrell","2020-05-09","2","713","0","188","0.9","8"
"Terrell","2020-05-10","62","775","1","189","1.1","6.3"
"Terrell","2020-05-11","9","784","2","191","3.7","5.8"
"Terrell","2020-05-12","5","789","1","192","6.6","6.4"
"Terrell","2020-05-13","55","844","1","193","6.8","5.9"
"Terrell","2020-05-14","6","850","0","193","6.5","5.4"
"Terrell","2020-05-15","7","857","1","194","8.6","5.8"
"Terrell","2020-05-16","77","934","6","200","9.7","5.3"
"Terrell","2020-05-17","4","938","0","200","9.4","5.3"
"Terrell","2020-05-18","23","961","1","201","6.9","5.3"
"Terrell","2020-05-19","25","986","3","204","5.7","6.2"
"Terrell","2020-05-20","6","992","0","204","5.5","6.2"
"Terrell","2020-05-21","25","1017","0","204","5.5","6"
"Terrell","2020-05-22","75","1092","5","209","4.4","6.5"
"Terrell","2020-05-23","2","1094","0","209","3.3","6.5"
"Terrell","2020-05-24","17","1111","0","209","3.3","6.4"
"Terrell","2020-05-25","12","1123","0","209","2.7","4.8"
"Terrell","2020-05-26","34","1157","3","212","2.2","4"
"Terrell","2020-05-27","42","1199","0","212","2.2","3.9"
"Terrell","2020-05-28","14","1213","2","214","4.3","4.9"
"Terrell","2020-05-29","10","1223","0","214","3.3","3.9"
"Terrell","2020-05-30","45","1268","2","216","3.9","3.6"
"Terrell","2020-05-31","10","1278","1","217","5.4","4.3"
"Terrell","2020-06-01","31","1309","1","218","5.8","4.2"
"Terrell","2020-06-02","18","1327","0","218","4.6","3.4"
"Terrell","2020-06-03","52","1379","0","218","4.6","3.4"
"Terrell","2020-06-04","11","1390","0","218","2.5","3.4"
"Terrell","2020-06-05","21","1411","1","219","3.2","3.3"
"Terrell","2020-06-06","8","1419","0","219","2.6","3.3"
"Terrell","2020-06-07","27","1446","1","220","1.7","3.5"
"Terrell","2020-06-08","16","1462","0","220","1.2","3.5"
"Terrell","2020-06-09","9","1471","1","221","2.8","3.7"
"Terrell","2020-06-10","11","1482","0","221","2.8","3.7"
"Terrell","2020-06-11","7","1489","2","223","6.9","4.7"
"Terrell","2020-06-12","12","1501","1","224","7.4","5.3"
"Terrell","2020-06-13","1","1502","0","224","7.4","5"
"Terrell","2020-06-14","2","1504","0","224","6.9","4.3"
"Terrell","2020-06-15","15","1519","0","224","6.9","4"
"Terrell","2020-06-16","9","1528","1","225","6.9","4.8"
"Terrell","2020-06-17","8","1536","1","226","8.6","5.7"
"Terrell","2020-06-18","13","1549","0","226","4.6","5.7"
"Terrell","2020-06-19","13","1562","1","227","4.5","5.9"
"Terrell","2020-06-20","2","1564","0","227","4.5","5.9"
"Terrell","2020-06-21","7","1571","0","227","4.5","5.7"
"Terrell","2020-06-22","17","1588","1","228","5.3","6.1"
"Terrell","2020-06-23","18","1606","1","229","4.5","5.7"
"Terrell","2020-06-24","8","1614","1","230","4.5","6.6"
"Terrell","2020-06-25","9","1623","5","235","12.5","8.5"
"Terrell","2020-06-26","7","1630","0","235","11.4","7.9"
"Terrell","2020-06-27","6","1636","0","235","11.4","7.9"
"Terrell","2020-06-28","4","1640","1","236","14.9","9.7"
"Terrell","2020-06-29","14","1654","1","237","15.1","10.2"
"Terrell","2020-06-30","14","1668","2","239","16.4","10.4"
"Terrell","2020-07-01","9","1677","0","239","14.6","9.5"
"Terrell","2020-07-02","13","1690","1","240","7.7","10.1"
"Terrell","2020-07-03","5","1695","0","240","7.7","9.5"
"Terrell","2020-07-04","8","1703","2","242","11.3","11.3"
"Terrell","2020-07-05","8","1711","4","246","14.9","14.9"
"Terrell","2020-07-06","11","1722","0","246","13.9","14.5"
"Terrell","2020-07-07","13","1735","1","247","12.9","14.6"
"Terrell","2020-07-08","9","1744","2","249","16.1","15.3"
"Terrell","2020-07-09","8","1752","2","251","18.6","13.1"
"Terrell","2020-07-10","13","1765","3","254","21.9","14.8"
"Terrell","2020-07-11","3","1768","1","255","23","17.2"
"Terrell","2020-07-12","6","1774","1","256","18.3","16.6"
"Terrell","2020-07-13","10","1784","1","257","19.7","16.8"
"Terrell","2020-07-14","21","1805","2","259","20","16.4"
"Terrell","2020-07-15","15","1820","0","259","16.8","16.4"
"Terrell","2020-07-16","9","1829","1","260","14.8","16.7"
"Terrell","2020-07-17","16","1845","1","261","12.4","17.1"
"Terrell","2020-07-18","6","1851","0","261","7.7","15.3"
"Terrell","2020-07-19","6","1857","0","261","5.3","11.8"
"Terrell","2020-07-20","11","1868","0","261","3.8","11.8"
"Terrell","2020-07-21","19","1887","2","263","4","12"
"Terrell","2020-07-22","8","1895","1","264","5.8","11.3"
"Terrell","2020-07-23","16","1911","2","266","6","10.4"
"Terrell","2020-07-24","10","1921","1","267","6.5","9.5"
"Terrell","2020-07-25","5","1926","0","267","6.5","7.1"
"Terrell","2020-07-26","6","1932","4","271","16","10.6"
"Terrell","2020-07-27","30","1962","4","275","17.9","10.9"
"Terrell","2020-07-28","22","1984","2","277","17.7","10.9"
"Terrell","2020-07-29","22","2006","1","278","16.6","11.2"
"Terrell","2020-07-30","26","2032","2","280","15.9","10.9"
"Terrell","2020-07-31","11","2043","0","280","14.5","10.5"
"Terrell","2020-08-01","6","2049","0","280","14.5","10.5"
"Terrell","2020-08-02","5","2054","0","280","5","10.5"
"Terrell","2020-08-03","17","2071","2","282","4.7","11.3"
"Terrell","2020-08-04","18","2089","2","284","5","11.4"
"Terrell","2020-08-05","29","2118","1","285","4.9","10.7"
"Terrell","2020-08-06","18","2136","2","287","5.3","10.6"
"Terrell","2020-08-07","9","2145","1","288","6.9","10.7"
"Terrell","2020-08-08","10","2155","2","290","9.8","12.1"
"Terrell","2020-08-09","4","2159","1","291","13.4","9.2"
"Terrell","2020-08-10","30","2189","2","293","12.6","8.7"
"Terrell","2020-08-11","20","2209","1","294","11.8","8.4"
"Terrell","2020-08-12","18","2227","1","295","12.1","8.5"
"Terrell","2020-08-13","12","2239","1","296","11.7","8.5"
"Terrell","2020-08-14","14","2253","1","297","11.1","9"
"Terrell","2020-08-15","7","2260","1","298","10.3","10"
"Terrell","2020-08-16","3","2263","1","299","11.5","12.4"
"Terrell","2020-08-17","7","2270","0","299","10.5","11.6"
"Terrell","2020-08-18","16","2286","3","302","12.5","12.1"
"Terrell","2020-08-19","21","2307","3","305","13.7","12.9"
"Terrell","2020-08-20","10","2317","0","305","12.5","12.1"
"Terrell","2020-08-21","13","2330","0","305","11.5","11.3"
"Terrell","2020-08-22","3","2333","0","305","9.5","9.9"
"Terrell","2020-08-23","8","2341","1","306","6.5","9"
"Terrell","2020-08-24","13","2354","1","307","7.6","9.1"
"Terrell","2020-08-25","19","2373","2","309","6.4","9.5"
"Terrell","2020-08-26","9","2382","1","310","6","9.9"
"Terrell","2020-08-27","12","2394","1","311","7.2","9.9"
"Terrell","2020-08-28","12","2406","1","312","8.4","9.9"
"Terrell","2020-08-29","5","2411","1","313","11.2","10.3"
"Terrell","2020-08-30","3","2414","0","313","9.4","8"
"Terrell","2020-08-31","16","2430","1","314","9.2","8.4"
"Terrell","2020-09-01","11","2441","0","314","7.7","7.1"
"Terrell","2020-09-02","13","2454","1","315","7.2","6.6"
"Terrell","2020-09-03","13","2467","0","315","6","6.6"
"Terrell","2020-09-04","19","2486","0","315","4.8","6.6"
"Terrell","2020-09-05","5","2491","1","316","4.8","8"
"Terrell","2020-09-06","4","2495","1","317","8.4","8.9"
"Terrell","2020-09-07","9","2504","0","317","7.5","8.4"
"Terrell","2020-09-08","21","2525","0","317","7.5","7.6"
"Terrell","2020-09-09","21","2546","0","317","6.4","6.8"
"Terrell","2020-09-10","12","2558","1","318","7.6","6.8"
"Terrell","2020-09-11","11","2569","1","319","8.9","6.9"
"Terrell","2020-09-12","3","2572","0","319","6.1","5.5"
"Terrell","2020-09-13","3","2575","1","320","7.3","7.8"
"Terrell","2020-09-14","12","2587","0","320","7.3","7.4"
"Terrell","2020-09-15","15","2602","0","320","7.3","7.4"
"Terrell","2020-09-16","11","2613","0","320","7.3","6.8"
"Terrell","2020-09-17","11","2624","0","320","6.1","6.8"
"Terrell","2020-09-18","16","2640","0","320","4.8","6.8"
"Terrell","2020-09-19","3","2643","0","320","4.8","5.4"
"Terrell","2020-09-20","3","2646","0","320","0","3.6"
"Terrell","2020-09-21","9","2655","0","320","0","3.6"
"Terrell","2020-09-22","18","2673","1","321","0.8","4"
"Terrell","2020-09-23","11","2684","0","321","0.8","4"
"Terrell","2020-09-24","13","2697","0","321","0.8","3.4"
"Terrell","2020-09-25","10","2707","0","321","0.8","2.8"
"Terrell","2020-09-26","5","2712","1","322","3.7","4.2"
"Terrell","2020-09-27","6","2718","0","322","3.7","1.8"
"Terrell","2020-09-28","17","2735","1","323","4.5","2.2"
"Terrell","2020-09-29","10","2745","0","323","3.7","2.2"
"Terrell","2020-09-30","11","2756","0","323","3.7","2.2"
"Terrell","2020-10-01","16","2772","1","324","4.6","2.7"
"Terrell","2020-10-02","17","2789","0","324","4.6","2.7"
"Terrell","2020-10-03","3","2792","0","324","1.7","2.7"
"Terrell","2020-10-04","3","2795","0","324","1.7","2.7"
"Terrell","2020-10-05","5","2800","0","324","0.9","2.7"
"Terrell","2020-10-06","11","2811","0","324","0.9","2.3"
"Terrell","2020-10-07","20","2831","0","324","0.9","2.3"
"Terrell","2020-10-08","11","2842","0","324","0","2.3"
"Terrell","2020-10-09","9","2851","0","324","0","2.3"
"Terrell","2020-10-10","1","2852","0","324","0","0.9"
"Terrell","2020-10-11","5","2857","0","324","0","0.9"
"Terrell","2020-10-12","14","2871","0","324","0","0.4"
"Terrell","2020-10-13","21","2892","1","325","0.7","0.8"
"Terrell","2020-10-14","14","2906","0","325","0.7","0.8"
"Terrell","2020-10-15","9","2915","0","325","0.7","0.3"
"Terrell","2020-10-16","11","2926","2","327","3.3","1.6"
"Terrell","2020-10-17","4","2930","0","327","3.3","1.6"
"Terrell","2020-10-18","5","2935","0","327","3.3","1.6"
"Terrell","2020-10-19","13","2948","0","327","3.3","1.6"
"Terrell","2020-10-20","10","2958","0","327","2.6","1.6"
"Terrell","2020-10-21","12","2970","0","327","2.6","1.6"
"Terrell","2020-10-22","10","2980","1","328","4","2.4"
"Terrell","2020-10-23","10","2990","1","329","2.9","3.1"
"Terrell","2020-10-24","7","2997","0","329","2.9","3.1"
"Terrell","2020-10-25","4","3001","0","329","2.9","3.1"
"Terrell","2020-10-26","15","3016","0","329","2.9","3.1"
"Terrell","2020-10-27","15","3031","0","329","2.9","2.7"
"Terrell","2020-10-28","13","3044","1","330","4","3.3"
"Terrell","2020-10-29","12","3056","0","330","2.5","3.3"
"Terrell","2020-10-30","13","3069","0","330","1.1","2"
"Terrell","2020-10-31","3","3072","0","330","1.1","2"
"Terrell","2020-11-01","3","3075","0","330","1.1","2"
"Terrell","2020-11-02","13","3088","1","331","2.2","2.5"
"Terrell","2020-11-03","14","3102","0","331","2.2","2.5"
"Terrell","2020-11-04","12","3114","1","332","2.3","3.1"
"Terrell","2020-11-05","17","3131","0","332","2.3","2.4"
"Terrell","2020-11-06","15","3146","0","332","2.3","1.7"
"Terrell","2020-11-07","6","3152","2","334","7.1","4.1"
"Terrell","2020-11-08","5","3157","0","334","7.1","4.1"
"Terrell","2020-11-09","15","3172","1","335","6.9","4.6"
"Terrell","2020-11-10","5","3177","0","335","6.9","4.6"
"Terrell","2020-11-11","16","3193","0","335","5.7","4"
"Terrell","2020-11-12","19","3212","0","335","5.7","4"
"Terrell","2020-11-13","11","3223","0","335","5.7","4"
"Terrell","2020-11-14","7","3230","0","335","1","4"
"Terrell","2020-11-15","7","3237","0","335","1","4"
"Terrell","2020-11-16","13","3250","2","337","2.2","4.6"
"Terrell","2020-11-17","14","3264","1","338","3.2","5.1"
"Terrell","2020-11-18","8","3272","1","339","5","5.4"
"Terrell","2020-11-19","13","3285","1","340","6.1","5.9"
"Terrell","2020-11-20","13","3298","0","340","6.1","5.9"
"Terrell","2020-11-21","5","3303","2","342","11.8","6.4"
"Terrell","2020-11-22","3","3306","0","342","11.8","6.4"
"Terrell","2020-11-23","27","3333","2","344","10.7","6.4"
"Terrell","2020-11-24","16","3349","1","345","10.5","6.9"
"Terrell","2020-11-25","18","3367","2","347","10.4","7.7"
"Terrell","2020-11-26","3","3370","0","347","9.3","7.7"
"Terrell","2020-11-27","4","3374","0","347","9.3","7.7"
"Terrell","2020-11-28","3","3377","2","349","13.1","12.4"
"Terrell","2020-11-29","3","3380","0","349","13.1","12.4"
"Terrell","2020-11-30","17","3397","2","351","13.7","12.2"
"Terrell","2020-12-01","23","3420","2","353","14","12.3"
"Terrell","2020-12-02","26","3446","1","354","13","11.7"
"Terrell","2020-12-03","22","3468","2","356","14.3","11.8"
"Terrell","2020-12-04","16","3484","3","359","17","13.1"
"Terrell","2020-12-05","8","3492","3","362","12.8","12.9"
"Terrell","2020-12-06","8","3500","3","365","18.2","15.6"
"Terrell","2020-12-07","27","3527","3","368","18.1","15.9"
"Terrell","2020-12-08","37","3564","8","376","19.9","17"
"Terrell","2020-12-09","31","3595","2","378","20.3","16.6"
"Terrell","2020-12-10","23","3618","5","383","22.1","18.2"
"Terrell","2020-12-11","23","3641","4","387","21.9","19.4"
"Terrell","2020-12-12","11","3652","1","388","17.8","15.3"
"Terrell","2020-12-13","7","3659","2","390","16.6","17.4"
"Terrell","2020-12-14","30","3689","6","396","17.8","18"
"Terrell","2020-12-15","18","3707","5","401","18.7","19.3"
"Terrell","2020-12-16","19","3726","5","406","21.6","20.9"
"Terrell","2020-12-17","21","3747","3","409","20.5","21.3"
"Terrell","2020-12-18","17","3764","2","411","19.7","20.8"
"Terrell","2020-12-19","12","3776","0","411","18.4","18.1"
"Terrell","2020-12-20","8","3784","5","416","23.2","19.9"
"Terrell","2020-12-21","28","3812","6","422","23.4","20.6"
"Terrell","2020-12-22","26","3838","3","425","21.1","19.9"
"Terrell","2020-12-23","17","3855","0","425","17.4","19.5"
"Terrell","2020-12-24","4","3859","0","425","15.3","17.9"
"Terrell","2020-12-25","2","3861","0","425","13.6","16.7"
"Terrell","2020-12-26","13","3874","3","428","16.9","17.7"
"Terrell","2020-12-27","3","3877","0","428","8","15.6"
"Terrell","2020-12-28","15","3892","1","429","5.9","14.7"
"Terrell","2020-12-29","17","3909","0","429","4.2","12.7"
"Terrell","2020-12-30","26","3935","6","435","7.5","12.5"
"Terrell","2020-12-31","20","3955","3","438","9.7","12.5"
"Terrell","2021-01-01","3","3958","0","438","9.7","11.7"
"Terrell","2021-01-02","7","3965","0","438","6.4","11.7"
"Terrell","2021-01-03","7","3972","0","438","6.4","7.2"
"Terrell","2021-01-04","20","3992","3","441","7.6","6.7"
"Terrell","2021-01-05","31","4023","3","444","9","6.6"
"Terrell","2021-01-06","18","4041","2","446","7.3","7.4"
"Terrell","2021-01-07","19","4060","0","446","5.1","7.4"
"Terrell","2021-01-08","13","4073","2","448","7.3","8.5"
"Terrell","2021-01-09","7","4080","0","448","7.3","6.9"
"Terrell","2021-01-10","5","4085","1","449","10.2","8.3"
"Terrell","2021-01-11","25","4110","3","452","9.7","8.7"
"Terrell","2021-01-12","22","4132","3","455","10.3","9.6"
"Terrell","2021-01-13","21","4153","3","458","10.8","9"
"Terrell","2021-01-14","19","4172","7","465","16","10.6"
"Terrell","2021-01-15","15","4187","0","465","13.8","10.6"
"Terrell","2021-01-16","11","4198","1","466","15.1","11.2"
"Terrell","2021-01-17","8","4206","1","467","14.1","12.1"
"Terrell","2021-01-18","17","4223","5","472","16.5","13.1"
"Terrell","2021-01-19","17","4240","2","474","16.3","13.3"
"Terrell","2021-01-20","20","4260","4","478","17.1","13.9"
"Terrell","2021-01-21","12","4272","1","479","13","14.5"
"Terrell","2021-01-22","16","4288","1","480","13.9","13.9"
"Terrell","2021-01-23","7","4295","0","480","12.6","13.9"
"Terrell","2021-01-24","5","4300","1","481","13.7","13.9"
"Terrell","2021-01-25","14","4314","2","483","11.5","14"
"Terrell","2021-01-26","11","4325","0","483","9.8","13.1"
"Terrell","2021-01-27","12","4337","4","487","11.7","14.4"
"Terrell","2021-01-28","14","4351","1","488","11.6","12.3"
"Terrell","2021-01-29","15","4366","2","490","12.6","13.2"
"Terrell","2021-01-30","7","4373","0","490","12.6","12.6"
"Terrell","2021-01-31","7","4380","1","491","11.8","12.7"
"Terrell","2021-02-01","10","4390","0","491","9.7","10.6"
"Terrell","2021-02-02","17","4407","1","492","10.6","10.2"
"Terrell","2021-02-03","25","4432","3","495","7.5","9.6"
"Terrell","2021-02-04","11","4443","2","497","9.1","10.3"
"Terrell","2021-02-05","20","4463","1","498","7.9","10.2"
"Terrell","2021-02-06","1","4464","0","498","7.9","10.2"
"Terrell","2021-02-07","3","4467","0","498","5.9","8.8"
"Terrell","2021-02-08","0","4467","0","498","5.9","7.8"
"Thomas","2020-02-01","0","0","0","0",".","."
"Thomas","2020-02-02","0","0","0","0",".","."
"Thomas","2020-02-03","0","0","0","0",".","."
"Thomas","2020-02-04","0","0","0","0",".","."
"Thomas","2020-02-05","0","0","0","0",".","."
"Thomas","2020-02-06","0","0","0","0",".","."
"Thomas","2020-02-07","0","0","0","0","0","."
"Thomas","2020-02-08","0","0","0","0","0","."
"Thomas","2020-02-09","0","0","0","0","0","."
"Thomas","2020-02-10","0","0","0","0","0","."
"Thomas","2020-02-11","0","0","0","0","0","."
"Thomas","2020-02-12","0","0","0","0","0","."
"Thomas","2020-02-13","0","0","0","0","0","."
"Thomas","2020-02-14","0","0","0","0","0","0"
"Thomas","2020-02-15","0","0","0","0","0","0"
"Thomas","2020-02-16","0","0","0","0","0","0"
"Thomas","2020-02-17","0","0","0","0","0","0"
"Thomas","2020-02-18","0","0","0","0","0","0"
"Thomas","2020-02-19","0","0","0","0","0","0"
"Thomas","2020-02-20","0","0","0","0","0","0"
"Thomas","2020-02-21","0","0","0","0","0","0"
"Thomas","2020-02-22","0","0","0","0","0","0"
"Thomas","2020-02-23","0","0","0","0","0","0"
"Thomas","2020-02-24","0","0","0","0","0","0"
"Thomas","2020-02-25","0","0","0","0","0","0"
"Thomas","2020-02-26","0","0","0","0","0","0"
"Thomas","2020-02-27","0","0","0","0","0","0"
"Thomas","2020-02-28","0","0","0","0","0","0"
"Thomas","2020-02-29","0","0","0","0","0","0"
"Thomas","2020-03-01","0","0","0","0","0","0"
"Thomas","2020-03-02","0","0","0","0","0","0"
"Thomas","2020-03-03","0","0","0","0","0","0"
"Thomas","2020-03-04","0","0","0","0","0","0"
"Thomas","2020-03-05","0","0","0","0","0","0"
"Thomas","2020-03-06","0","0","0","0","0","0"
"Thomas","2020-03-07","0","0","0","0","0","0"
"Thomas","2020-03-08","0","0","0","0","0","0"
"Thomas","2020-03-09","0","0","0","0","0","0"
"Thomas","2020-03-10","0","0","0","0","0","0"
"Thomas","2020-03-11","0","0","0","0","0","0"
"Thomas","2020-03-12","1","1","0","0","0","0"
"Thomas","2020-03-13","1","2","1","1","14.3","7.1"
"Thomas","2020-03-14","0","2","0","1","14.3","7.1"
"Thomas","2020-03-15","0","2","0","1","14.3","7.1"
"Thomas","2020-03-16","4","6","2","3","21.4","10.7"
"Thomas","2020-03-17","2","8","0","3","21.4","10.7"
"Thomas","2020-03-18","0","8","0","3","21.4","10.7"
"Thomas","2020-03-19","2","10","0","3","21.4","10.7"
"Thomas","2020-03-20","6","16","1","4","9.5","11.9"
"Thomas","2020-03-21","2","18","0","4","9.5","11.9"
"Thomas","2020-03-22","1","19","0","4","9.5","11.9"
"Thomas","2020-03-23","4","23","1","5","6","13.7"
"Thomas","2020-03-24","5","28","1","6","8.8","15.1"
"Thomas","2020-03-25","4","32","0","6","8.8","15.1"
"Thomas","2020-03-26","11","43","3","9","12.7","17.1"
"Thomas","2020-03-27","3","46","3","12","24.6","17.1"
"Thomas","2020-03-28","7","53","5","17","34.8","22.2"
"Thomas","2020-03-29","9","62","9","26","49.1","29.3"
"Thomas","2020-03-30","13","75","7","33","53.2","29.6"
"Thomas","2020-03-31","11","86","6","39","58.2","33.5"
"Thomas","2020-04-01","13","99","11","50","70.2","39.5"
"Thomas","2020-04-02","2","101","2","52","80.6","46.7"
"Thomas","2020-04-03","11","112","8","60","76.7","50.7"
"Thomas","2020-04-04","5","117","4","64","78","56.4"
"Thomas","2020-04-05","1","118","1","65","78","63.5"
"Thomas","2020-04-06","10","128","6","71","78.8","66"
"Thomas","2020-04-07","30","158","8","79","74.9","66.5"
"Thomas","2020-04-08","14","172","12","91","75","72.6"
"Thomas","2020-04-09","55","227","10","101","63.3","72"
"Thomas","2020-04-10","10","237","6","107","61.5","69.1"
"Thomas","2020-04-11","6","243","5","112","62","70"
"Thomas","2020-04-12","6","249","5","117","59.6","68.8"
"Thomas","2020-04-13","13","262","8","125","59.8","69.3"
"Thomas","2020-04-14","80","342","14","139","58.5","66.7"
"Thomas","2020-04-15","8","350","4","143","53.4","64.2"
"Thomas","2020-04-16","6","356","4","147","60.3","61.8"
"Thomas","2020-04-17","11","367","10","157","64.8","63.1"
"Thomas","2020-04-18","2","369","2","159","67.1","64.6"
"Thomas","2020-04-19","4","373","2","161","62.4","61"
"Thomas","2020-04-20","4","377","4","165","67.9","63.8"
"Thomas","2020-04-21","39","416","4","169","66.8","62.7"
"Thomas","2020-04-22","79","495","6","175","60.8","57.1"
"Thomas","2020-04-23","20","515","0","175","51.3","55.8"
"Thomas","2020-04-24","88","603","5","180","39.1","51.9"
"Thomas","2020-04-25","47","650","4","184","26","46.6"
"Thomas","2020-04-26","2","652","1","185","26","44.2"
"Thomas","2020-04-27","61","713","9","194","13.8","40.8"
"Thomas","2020-04-28","108","821","13","207","14.1","40.5"
"Thomas","2020-04-29","19","840","3","210","15.3","38"
"Thomas","2020-04-30","35","875","6","216","17.7","34.5"
"Thomas","2020-05-01","28","903","3","219","18.4","28.7"
"Thomas","2020-05-02","14","917","0","219","17.2","21.6"
"Thomas","2020-05-03","8","925","2","221","13.6","19.8"
"Thomas","2020-05-04","55","980","1","222","11.8","12.8"
"Thomas","2020-05-05","67","1047","6","228","11.3","12.7"
"Thomas","2020-05-06","67","1114","3","231","9.7","12.5"
"Thomas","2020-05-07","52","1166","2","233","7.8","12.8"
"Thomas","2020-05-08","57","1223","15","248","10.1","14.2"
"Thomas","2020-05-09","33","1256","7","255","13.1","15.1"
"Thomas","2020-05-10","0","1256","0","255","9.5","11.6"
"Thomas","2020-05-11","54","1310","7","262","11.1","11.4"
"Thomas","2020-05-12","35","1345","3","265","11.1","11.2"
"Thomas","2020-05-13","64","1409","9","274","12.4","11.1"
"Thomas","2020-05-14","37","1446","4","278","13.4","10.6"
"Thomas","2020-05-15","44","1490","8","286","12.3","11.2"
"Thomas","2020-05-16","29","1519","3","289","10.7","11.9"
"Thomas","2020-05-17","4","1523","2","291","17.8","13.7"
"Thomas","2020-05-18","20","1543","8","299","21.7","16.4"
"Thomas","2020-05-19","89","1632","14","313","22.7","16.9"
"Thomas","2020-05-20","10","1642","0","313","20.7","16.6"
"Thomas","2020-05-21","56","1698","0","313","19.2","16.3"
"Thomas","2020-05-22","47","1745","1","314","16.9","14.6"
"Thomas","2020-05-23","9","1754","0","314","15.4","13.1"
"Thomas","2020-05-24","2","1756","1","315","15.4","16.6"
"Thomas","2020-05-25","44","1800","1","316","10","15.9"
"Thomas","2020-05-26","19","1819","1","317","8.5","15.6"
"Thomas","2020-05-27","100","1919","6","323","9.4","15.1"
"Thomas","2020-05-28","28","1947","2","325","10.4","14.8"
"Thomas","2020-05-29","55","2002","5","330","11.4","14.1"
"Thomas","2020-05-30","53","2055","14","344","15.2","15.3"
"Thomas","2020-05-31","3","2058","0","344","8","11.7"
"Thomas","2020-06-01","26","2084","4","348","9.9","10"
"Thomas","2020-06-02","136","2220","3","351","9.5","9"
"Thomas","2020-06-03","95","2315","2","353","8.9","9.1"
"Thomas","2020-06-04","72","2387","3","356","8.5","9.4"
"Thomas","2020-06-05","81","2468","4","360","7.9","9.6"
"Thomas","2020-06-06","31","2499","2","362","5","10.1"
"Thomas","2020-06-07","5","2504","0","362","5","6.5"
"Thomas","2020-06-08","110","2614","0","362","2.8","6.4"
"Thomas","2020-06-09","63","2677","4","366","3.4","6.4"
"Thomas","2020-06-10","102","2779","3","369","3.5","6.2"
"Thomas","2020-06-11","28","2807","0","369","3","5.7"
"Thomas","2020-06-12","85","2892","1","370","2.4","5.2"
"Thomas","2020-06-13","59","2951","2","372","2","3.5"
"Thomas","2020-06-14","9","2960","0","372","2","3.5"
"Thomas","2020-06-15","114","3074","1","373","2.1","2.5"
"Thomas","2020-06-16","98","3172","12","385","2.9","3.2"
"Thomas","2020-06-17","83","3255","6","391","3.6","3.6"
"Thomas","2020-06-18","38","3293","1","392","3.9","3.4"
"Thomas","2020-06-19","166","3459","13","405","4.9","3.7"
"Thomas","2020-06-20","68","3527","11","416","6.7","4.3"
"Thomas","2020-06-21","11","3538","1","417","8","5"
"Thomas","2020-06-22","79","3617","4","421","8.6","5.4"
"Thomas","2020-06-23","128","3745","19","440","9","6"
"Thomas","2020-06-24","45","3790","2","442","8.6","6.1"
"Thomas","2020-06-25","266","4056","32","474","9.9","6.9"
"Thomas","2020-06-26","72","4128","4","478","9.6","7.2"
"Thomas","2020-06-27","133","4261","10","488","8.4","7.5"
"Thomas","2020-06-28","22","4283","3","491","9","8.5"
"Thomas","2020-06-29","277","4560","24","515","9.5","9.1"
"Thomas","2020-06-30","263","4823","23","538","8.7","8.8"
"Thomas","2020-07-01","87","4910","4","542","8.7","8.6"
"Thomas","2020-07-02","277","5187","25","567","8.2","9.1"
"Thomas","2020-07-03","15","5202","4","571","11.3","10.4"
"Thomas","2020-07-04","9","5211","1","572","11.8","10.1"
"Thomas","2020-07-05","9","5220","2","574","13","11"
"Thomas","2020-07-06","245","5465","34","608","13.7","11.6"
"Thomas","2020-07-07","332","5797","23","631","13.5","11.1"
"Thomas","2020-07-08","109","5906","11","642","14.3","11.5"
"Thomas","2020-07-09","314","6220","33","675","14.5","11.4"
"Thomas","2020-07-10","74","6294","8","683","12.2","11.7"
"Thomas","2020-07-11","19","6313","4","687","13.6","12.7"
"Thomas","2020-07-12","25","6338","3","690","12.2","12.6"
"Thomas","2020-07-13","76","6414","13","703","12.6","13.2"
"Thomas","2020-07-14","337","6751","39","742","13.3","13.4"
"Thomas","2020-07-15","186","6937","18","760","13.2","13.8"
"Thomas","2020-07-16","290","7227","13","773","12.4","13.4"
"Thomas","2020-07-17","90","7317","10","783","12.4","12.3"
"Thomas","2020-07-18","18","7335","1","784","10.2","11.9"
"Thomas","2020-07-19","25","7360","9","793","13.6","12.9"
"Thomas","2020-07-20","264","7624","26","819","12.6","12.6"
"Thomas","2020-07-21","302","7926","40","859","12.8","13.1"
"Thomas","2020-07-22","166","8092","21","880","13.3","13.3"
"Thomas","2020-07-23","245","8337","19","899","13.7","13.1"
"Thomas","2020-07-24","94","8431","10","909","13.7","13"
"Thomas","2020-07-25","53","8484","1","910","13.1","11.7"
"Thomas","2020-07-26","26","8510","9","919","12.9","13.3"
"Thomas","2020-07-27","260","8770","41","960","13.8","13.2"
"Thomas","2020-07-28","261","9031","36","996","13.9","13.4"
"Thomas","2020-07-29","68","9099","7","1003","13.5","13.4"
"Thomas","2020-07-30","219","9318","34","1037","14.6","14.2"
"Thomas","2020-07-31","171","9489","10","1047","14","13.8"
"Thomas","2020-08-01","35","9524","10","1057","17.8","15.5"
"Thomas","2020-08-02","23","9547","5","1062","15.9","14.4"
"Thomas","2020-08-03","268","9815","45","1107","16.1","14.9"
"Thomas","2020-08-04","74","9889","14","1121","16.8","15.3"
"Thomas","2020-08-05","256","10145","17","1138","16.3","14.9"
"Thomas","2020-08-06","154","10299","13","1151","15.3","15"
"Thomas","2020-08-07","71","10370","6","1157","15.7","14.8"
"Thomas","2020-08-08","62","10432","7","1164","13.2","15.5"
"Thomas","2020-08-09","56","10488","0","1164","10.1","13"
"Thomas","2020-08-10","224","10712","20","1184","9","12.5"
"Thomas","2020-08-11","72","10784","15","1199","9.2","13"
"Thomas","2020-08-12","224","11008","22","1221","9.7","13"
"Thomas","2020-08-13","203","11211","42","1263","11.4","13.4"
"Thomas","2020-08-14","57","11268","9","1272","12.5","14.1"
"Thomas","2020-08-15","86","11354","7","1279","12","12.6"
"Thomas","2020-08-16","13","11367","1","1280","13.1","11.6"
"Thomas","2020-08-17","56","11423","10","1290","14.4","11.7"
"Thomas","2020-08-18","59","11482","8","1298","13.4","11.3"
"Thomas","2020-08-19","224","11706","19","1317","13.2","11.4"
"Thomas","2020-08-20","131","11837","13","1330","11.6","11.5"
"Thomas","2020-08-21","57","11894","14","1344","12.9","12.7"
"Thomas","2020-08-22","75","11969","1","1345","11.9","12"
"Thomas","2020-08-23","19","11988","4","1349","13.8","13.5"
"Thomas","2020-08-24","135","12123","14","1363","12.8","13.6"
"Thomas","2020-08-25","57","12180","10","1373","13.3","13.3"
"Thomas","2020-08-26","165","12345","18","1391","13.7","13.4"
"Thomas","2020-08-27","133","12478","11","1402","13.4","12.5"
"Thomas","2020-08-28","43","12521","4","1406","11.3","12.1"
"Thomas","2020-08-29","71","12592","8","1414","12.7","12.3"
"Thomas","2020-08-30","11","12603","2","1416","12.3","13"
"Thomas","2020-08-31","178","12781","25","1441","12.8","12.8"
"Thomas","2020-09-01","43","12824","5","1446","11.9","12.6"
"Thomas","2020-09-02","125","12949","15","1461","12.1","12.9"
"Thomas","2020-09-03","110","13059","8","1469","12","12.7"
"Thomas","2020-09-04","49","13108","6","1475","12.4","11.8"
"Thomas","2020-09-05","52","13160","2","1477","11.3","12"
"Thomas","2020-09-06","8","13168","1","1478","10.5","11.4"
"Thomas","2020-09-07","22","13190","4","1482","11.1","11.9"
"Thomas","2020-09-08","48","13238","11","1493","12.7","12.3"
"Thomas","2020-09-09","144","13382","8","1501","11.8","11.9"
"Thomas","2020-09-10","54","13436","7","1508","12.6","12.3"
"Thomas","2020-09-11","147","13583","5","1513","11.3","11.9"
"Thomas","2020-09-12","14","13597","2","1515","12.8","12.1"
"Thomas","2020-09-13","20","13617","1","1516","11.8","11.1"
"Thomas","2020-09-14","143","13760","16","1532","10.8","10.9"
"Thomas","2020-09-15","102","13862","10","1542","8.9","10.8"
"Thomas","2020-09-16","169","14031","11","1553","9","10.4"
"Thomas","2020-09-17","72","14103","12","1565","9.6","11.1"
"Thomas","2020-09-18","56","14159","5","1570","10.3","10.8"
"Thomas","2020-09-19","103","14262","1","1571","8.4","10.6"
"Thomas","2020-09-20","35","14297","1","1572","8.1","9.9"
"Thomas","2020-09-21","151","14448","10","1582","7.5","9.1"
"Thomas","2020-09-22","45","14493","3","1585","7","8"
"Thomas","2020-09-23","184","14677","7","1592","6.6","7.8"
"Thomas","2020-09-24","75","14752","7","1599","5.6","7.6"
"Thomas","2020-09-25","100","14852","6","1605","5.2","7.8"
"Thomas","2020-09-26","13","14865","1","1606","6.1","7.3"
"Thomas","2020-09-27","15","14880","1","1607","6.7","7.4"
"Thomas","2020-09-28","101","14981","2","1609","6","6.8"
"Thomas","2020-09-29","58","15039","0","1609","5.1","6"
"Thomas","2020-09-30","55","15094","5","1614","5.8","6.2"
"Thomas","2020-10-01","89","15183","5","1619","5.3","5.4"
"Thomas","2020-10-02","132","15315","5","1624","5","5.1"
"Thomas","2020-10-03","38","15353","3","1627","5","5.6"
"Thomas","2020-10-04","25","15378","2","1629","5.2","5.9"
"Thomas","2020-10-05","124","15502","11","1640","6.2","6.1"
"Thomas","2020-10-06","116","15618","4","1644","6.7","5.9"
"Thomas","2020-10-07","177","15795","10","1654","6.2","6"
"Thomas","2020-10-08","78","15873","3","1657","5.9","5.6"
"Thomas","2020-10-09","59","15932","4","1661","6.4","5.7"
"Thomas","2020-10-10","112","16044","6","1667","6","5.5"
"Thomas","2020-10-11","12","16056","1","1668","6","5.6"
"Thomas","2020-10-12","74","16130","9","1677","6.5","6.3"
"Thomas","2020-10-13","40","16170","4","1681","7.4","7.1"
"Thomas","2020-10-14","158","16328","9","1690","7.5","6.8"
"Thomas","2020-10-15","71","16399","4","1694","7.7","6.8"
"Thomas","2020-10-16","66","16465","2","1696","7.2","6.8"
"Thomas","2020-10-17","29","16494","1","1697","6.9","6.4"
"Thomas","2020-10-18","5","16499","0","1697","5.7","5.9"
"Thomas","2020-10-19","96","16595","5","1702","4.7","5.6"
"Thomas","2020-10-20","29","16624","1","1703","3.8","5.6"
"Thomas","2020-10-21","105","16729","8","1711","4.1","5.8"
"Thomas","2020-10-22","50","16779","2","1713","3.8","5.8"
"Thomas","2020-10-23","120","16899","6","1719","4.1","5.6"
"Thomas","2020-10-24","22","16921","3","1722","5.6","6.2"
"Thomas","2020-10-25","20","16941","3","1725","7.7","6.7"
"Thomas","2020-10-26","144","17085","11","1736","8","6.4"
"Thomas","2020-10-27","41","17126","2","1738","8.3","6"
"Thomas","2020-10-28","120","17246","5","1743","7.8","5.9"
"Thomas","2020-10-29","42","17288","6","1749","9.2","6.5"
"Thomas","2020-10-30","106","17394","4","1753","9.1","6.6"
"Thomas","2020-10-31","22","17416","1","1754","7.8","6.7"
"Thomas","2020-11-01","10","17426","2","1756","8.5","8.1"
"Thomas","2020-11-02","102","17528","9","1765","8.6","8.3"
"Thomas","2020-11-03","103","17631","3","1768","8.4","8.3"
"Thomas","2020-11-04","92","17723","2","1770","8.1","7.9"
"Thomas","2020-11-05","58","17781","2","1772","6.5","7.9"
"Thomas","2020-11-06","67","17848","6","1778","7.3","8.2"
"Thomas","2020-11-07","27","17875","1","1779","7.1","7.5"
"Thomas","2020-11-08","16","17891","3","1782","7","7.7"
"Thomas","2020-11-09","89","17980","14","1796","8","8.3"
"Thomas","2020-11-10","64","18044","6","1802","8.9","8.6"
"Thomas","2020-11-11","134","18178","9","1811","9.5","8.8"
"Thomas","2020-11-12","63","18241","7","1818","10.6","8.6"
"Thomas","2020-11-13","108","18349","7","1825","10.3","8.8"
"Thomas","2020-11-14","20","18369","1","1826","10.5","8.8"
"Thomas","2020-11-15","9","18378","0","1826","7.8","7.4"
"Thomas","2020-11-16","117","18495","11","1837","6.9","7.4"
"Thomas","2020-11-17","116","18611","3","1840","5.9","7.4"
"Thomas","2020-11-18","63","18674","3","1843","5.6","7.6"
"Thomas","2020-11-19","68","18742","6","1849","5.3","8"
"Thomas","2020-11-20","95","18837","9","1858","5.7","8"
"Thomas","2020-11-21","128","18965","7","1865","5.8","8.1"
"Thomas","2020-11-22","25","18990","5","1870","8.6","8.2"
"Thomas","2020-11-23","146","19136","15","1885","8.8","7.8"
"Thomas","2020-11-24","77","19213","4","1889","9.1","7.5"
"Thomas","2020-11-25","99","19312","11","1900","10","7.8"
"Thomas","2020-11-26","31","19343","3","1903","10.2","7.7"
"Thomas","2020-11-27","51","19394","6","1909","10.5","8.1"
"Thomas","2020-11-28","26","19420","5","1914","12.5","9.1"
"Thomas","2020-11-29","25","19445","5","1919","12.5","10.6"
"Thomas","2020-11-30","215","19660","19","1938","12.3","10.5"
"Thomas","2020-12-01","123","19783","14","1952","13.1","11.1"
"Thomas","2020-12-02","142","19925","9","1961","12.5","11.3"
"Thomas","2020-12-03","188","20113","22","1983","12.8","11.5"
"Thomas","2020-12-04","85","20198","16","1999","13.8","12.1"
"Thomas","2020-12-05","52","20250","13","2012","14.6","13.5"
"Thomas","2020-12-06","28","20278","4","2016","13.8","13.1"
"Thomas","2020-12-07","197","20475","34","2050","15","13.6"
"Thomas","2020-12-08","170","20645","21","2071","15.1","14.1"
"Thomas","2020-12-09","79","20724","15","2086","16.9","14.7"
"Thomas","2020-12-10","282","21006","25","2111","16.5","14.6"
"Thomas","2020-12-11","196","21202","20","2131","15.3","14.5"
"Thomas","2020-12-12","33","21235","11","2142","16.5","15.5"
"Thomas","2020-12-13","21","21256","6","2148","18.5","16.1"
"Thomas","2020-12-14","365","21621","52","2200","18.1","16.5"
"Thomas","2020-12-15","167","21788","12","2212","17.3","16.2"
"Thomas","2020-12-16","316","22104","52","2264","17","16.9"
"Thomas","2020-12-17","360","22464","44","2308","17.5","17"
"Thomas","2020-12-18","107","22571","15","2323","18","16.6"
"Thomas","2020-12-19","95","22666","5","2328","14","15.2"
"Thomas","2020-12-20","27","22693","5","2333","12.6","15.5"
"Thomas","2020-12-21","364","23057","59","2392","12.8","15.5"
"Thomas","2020-12-22","287","23344","47","2439","14.2","15.7"
"Thomas","2020-12-23","117","23461","12","2451","13.3","15.1"
"Thomas","2020-12-24","125","23586","9","2460","12.5","15"
"Thomas","2020-12-25","16","23602","6","2466","15.9","17"
"Thomas","2020-12-26","220","23822","28","2494","17","15.5"
"Thomas","2020-12-27","43","23865","13","2507","18.6","15.6"
"Thomas","2020-12-28","272","24137","50","2557","19","15.9"
"Thomas","2020-12-29","109","24246","23","2580","19.6","16.9"
"Thomas","2020-12-30","477","24723","46","2626","19.5","16.4"
"Thomas","2020-12-31","427","25150","55","2681","20.4","16.5"
"Thomas","2021-01-01","198","25348","13","2694","15.9","15.9"
"Thomas","2021-01-02","31","25379","11","2705","19.2","18.1"
"Thomas","2021-01-03","40","25419","13","2718","19.5","19.1"
"Thomas","2021-01-04","393","25812","74","2792","19.6","19.3"
"Thomas","2021-01-05","181","25993","61","2853","21.4","20.5"
"Thomas","2021-01-06","263","26256","64","2917","23.5","21.5"
"Thomas","2021-01-07","338","26594","78","2995","24.9","22.6"
"Thomas","2021-01-08","313","26907","47","3042","26.1","21"
"Thomas","2021-01-09","83","26990","16","3058","23.8","21.5"
"Thomas","2021-01-10","45","27035","9","3067","22","20.8"
"Thomas","2021-01-11","374","27409","72","3139","22.1","20.8"
"Thomas","2021-01-12","186","27595","32","3171","19.7","20.6"
"Thomas","2021-01-13","158","27753","23","3194","18.3","20.9"
"Thomas","2021-01-14","382","28135","46","3240","16.8","20.8"
"Thomas","2021-01-15","174","28309","33","3273","17.3","21.7"
"Thomas","2021-01-16","62","28371","13","3286","17.6","20.7"
"Thomas","2021-01-17","39","28410","12","3298","19.1","20.6"
"Thomas","2021-01-18","302","28712","48","3346","18.6","20.4"
"Thomas","2021-01-19","151","28863","22","3368","18.3","19"
"Thomas","2021-01-20","206","29069","21","3389","17.6","18"
"Thomas","2021-01-21","336","29405","34","3423","17.4","17.1"
"Thomas","2021-01-22","325","29730","40","3463","16.4","16.9"
"Thomas","2021-01-23","30","29760","5","3468","15.8","16.7"
"Thomas","2021-01-24","23","29783","8","3476","16.4","17.7"
"Thomas","2021-01-25","281","30064","46","3522","16.4","17.5"
"Thomas","2021-01-26","137","30201","24","3546","16.9","17.6"
"Thomas","2021-01-27","124","30325","19","3565","17.6","17.6"
"Thomas","2021-01-28","298","30623","29","3594","17.5","17.4"
"Thomas","2021-01-29","68","30691","10","3604","17.9","17.1"
"Thomas","2021-01-30","54","30745","7","3611","17.3","16.6"
"Thomas","2021-01-31","20","30765","2","3613","13.8","15.1"
"Thomas","2021-02-01","242","31007","24","3637","12.9","14.7"
"Thomas","2021-02-02","212","31219","7","3644","10.8","13.9"
"Thomas","2021-02-03","239","31458","20","3664","9.9","13.7"
"Thomas","2021-02-04","177","31635","10","3674","9.3","13.4"
"Thomas","2021-02-05","76","31711","11","3685","9.2","13.6"
"Thomas","2021-02-06","17","31728","2","3687","9.1","13.2"
"Thomas","2021-02-07","5","31733","1","3688","10.5","12.1"
"Thomas","2021-02-08","0","31733","0","3688","9.1","11"
"Tift","2020-02-01","0","0","0","0",".","."
"Tift","2020-02-02","0","0","0","0",".","."
"Tift","2020-02-03","0","0","0","0",".","."
"Tift","2020-02-04","0","0","0","0",".","."
"Tift","2020-02-05","0","0","0","0",".","."
"Tift","2020-02-06","0","0","0","0",".","."
"Tift","2020-02-07","0","0","0","0","0","."
"Tift","2020-02-08","0","0","0","0","0","."
"Tift","2020-02-09","0","0","0","0","0","."
"Tift","2020-02-10","0","0","0","0","0","."
"Tift","2020-02-11","0","0","0","0","0","."
"Tift","2020-02-12","0","0","0","0","0","."
"Tift","2020-02-13","0","0","0","0","0","."
"Tift","2020-02-14","0","0","0","0","0","0"
"Tift","2020-02-15","0","0","0","0","0","0"
"Tift","2020-02-16","0","0","0","0","0","0"
"Tift","2020-02-17","0","0","0","0","0","0"
"Tift","2020-02-18","0","0","0","0","0","0"
"Tift","2020-02-19","0","0","0","0","0","0"
"Tift","2020-02-20","0","0","0","0","0","0"
"Tift","2020-02-21","0","0","0","0","0","0"
"Tift","2020-02-22","0","0","0","0","0","0"
"Tift","2020-02-23","0","0","0","0","0","0"
"Tift","2020-02-24","0","0","0","0","0","0"
"Tift","2020-02-25","0","0","0","0","0","0"
"Tift","2020-02-26","0","0","0","0","0","0"
"Tift","2020-02-27","0","0","0","0","0","0"
"Tift","2020-02-28","0","0","0","0","0","0"
"Tift","2020-02-29","0","0","0","0","0","0"
"Tift","2020-03-01","0","0","0","0","0","0"
"Tift","2020-03-02","0","0","0","0","0","0"
"Tift","2020-03-03","0","0","0","0","0","0"
"Tift","2020-03-04","0","0","0","0","0","0"
"Tift","2020-03-05","0","0","0","0","0","0"
"Tift","2020-03-06","0","0","0","0","0","0"
"Tift","2020-03-07","0","0","0","0","0","0"
"Tift","2020-03-08","0","0","0","0","0","0"
"Tift","2020-03-09","0","0","0","0","0","0"
"Tift","2020-03-10","0","0","0","0","0","0"
"Tift","2020-03-11","0","0","0","0","0","0"
"Tift","2020-03-12","4","4","0","0","0","0"
"Tift","2020-03-13","2","6","0","0","0","0"
"Tift","2020-03-14","1","7","0","0","0","0"
"Tift","2020-03-15","0","7","0","0","0","0"
"Tift","2020-03-16","3","10","0","0","0","0"
"Tift","2020-03-17","2","12","0","0","0","0"
"Tift","2020-03-18","2","14","0","0","0","0"
"Tift","2020-03-19","2","16","0","0","0","0"
"Tift","2020-03-20","0","16","0","0","0","0"
"Tift","2020-03-21","0","16","0","0","0","0"
"Tift","2020-03-22","0","16","0","0","0","0"
"Tift","2020-03-23","6","22","1","1","2.4","1.2"
"Tift","2020-03-24","6","28","1","2","4.8","2.4"
"Tift","2020-03-25","2","30","2","4","19","9.5"
"Tift","2020-03-26","3","33","0","4","19","9.5"
"Tift","2020-03-27","6","39","0","4","19","9.5"
"Tift","2020-03-28","0","39","0","4","19","9.5"
"Tift","2020-03-29","0","39","0","4","19","9.5"
"Tift","2020-03-30","5","44","1","5","19.5","11"
"Tift","2020-03-31","1","45","1","6","31.4","18.1"
"Tift","2020-04-01","1","46","0","6","17.1","18.1"
"Tift","2020-04-02","43","89","8","14","19.8","19.4"
"Tift","2020-04-03","32","121","6","20","22.5","20.8"
"Tift","2020-04-04","2","123","1","21","29.6","24.3"
"Tift","2020-04-05","0","123","0","21","29.6","24.3"
"Tift","2020-04-06","4","127","0","21","26.8","23.1"
"Tift","2020-04-07","9","136","3","24","17.2","24.3"
"Tift","2020-04-08","76","212","18","42","20.6","18.9"
"Tift","2020-04-09","49","261","8","50","20.3","20"
"Tift","2020-04-10","83","344","20","70","21.1","21.8"
"Tift","2020-04-11","54","398","11","81","16.8","23.2"
"Tift","2020-04-12","0","398","0","81","16.8","23.2"
"Tift","2020-04-13","6","404","0","81","16.8","21.8"
"Tift","2020-04-14","126","530","25","106","14.9","16.1"
"Tift","2020-04-15","51","581","8","114","13.8","17.2"
"Tift","2020-04-16","57","638","8","122","13.4","16.9"
"Tift","2020-04-17","53","691","15","137","14","17.5"
"Tift","2020-04-18","75","766","18","155","14.6","15.7"
"Tift","2020-04-19","4","770","1","156","18.1","17.5"
"Tift","2020-04-20","29","799","6","162","21.1","19"
"Tift","2020-04-21","97","896","14","176","20.3","17.6"
"Tift","2020-04-22","56","952","13","189","21.4","17.6"
"Tift","2020-04-23","77","1029","21","210","23.3","18.4"
"Tift","2020-04-24","47","1076","13","223","23.2","18.6"
"Tift","2020-04-25","40","1116","8","231","22.6","18.6"
"Tift","2020-04-26","4","1120","3","234","29.8","23.9"
"Tift","2020-04-27","15","1135","6","240","32.5","26.8"
"Tift","2020-04-28","132","1267","4","244","30.9","25.6"
"Tift","2020-04-29","92","1359","12","256","29.4","25.4"
"Tift","2020-04-30","56","1415","12","268","28.6","25.9"
"Tift","2020-05-01","82","1497","20","288","28.1","25.7"
"Tift","2020-05-02","75","1572","10","298","27.2","24.9"
"Tift","2020-05-03","5","1577","2","300","22.2","26"
"Tift","2020-05-04","59","1636","11","311","19.1","25.8"
"Tift","2020-05-05","78","1714","7","318","20","25.4"
"Tift","2020-05-06","85","1799","13","331","20.3","24.9"
"Tift","2020-05-07","91","1890","22","353","20.7","24.6"
"Tift","2020-05-08","88","1978","13","366","19.3","23.7"
"Tift","2020-05-09","80","2058","14","380","19.9","23.5"
"Tift","2020-05-10","3","2061","1","381","19","20.6"
"Tift","2020-05-11","77","2138","8","389","17.8","18.5"
"Tift","2020-05-12","121","2259","12","401","17.9","18.9"
"Tift","2020-05-13","99","2358","14","415","17.7","19"
"Tift","2020-05-14","77","2435","12","427","16.5","18.6"
"Tift","2020-05-15","100","2535","13","440","16.3","17.8"
"Tift","2020-05-16","122","2657","7","447","14.6","17.2"
"Tift","2020-05-17","4","2661","3","450","20.5","19.7"
"Tift","2020-05-18","75","2736","7","457","20.4","19.1"
"Tift","2020-05-19","112","2848","17","474","21.1","19.5"
"Tift","2020-05-20","122","2970","19","493","21.3","19.5"
"Tift","2020-05-21","158","3128","14","507","20.4","18.5"
"Tift","2020-05-22","80","3208","9","516","20.1","18.2"
"Tift","2020-05-23","10","3218","2","518","22.2","18.4"
"Tift","2020-05-24","1","3219","1","519","25.7","23.1"
"Tift","2020-05-25","9","3228","3","522","29.2","24.8"
"Tift","2020-05-26","82","3310","8","530","28.4","24.8"
"Tift","2020-05-27","143","3453","20","550","28.2","24.8"
"Tift","2020-05-28","151","3604","17","567","28.5","24.4"
"Tift","2020-05-29","102","3706","12","579","28.6","24.4"
"Tift","2020-05-30","90","3796","8","587","27","24.6"
"Tift","2020-05-31","2","3798","1","588","19.9","22.8"
"Tift","2020-06-01","99","3897","19","607","17.8","23.5"
"Tift","2020-06-02","61","3958","6","613","17.8","23.1"
"Tift","2020-06-03","98","4056","10","623","17.3","22.7"
"Tift","2020-06-04","192","4248","38","661","18.5","23.5"
"Tift","2020-06-05","154","4402","17","678","18.4","23.5"
"Tift","2020-06-06","113","4515","12","690","18.7","22.8"
"Tift","2020-06-07","15","4530","4","694","15.3","17.6"
"Tift","2020-06-08","194","4724","41","735","15.6","16.7"
"Tift","2020-06-09","94","4818","17","752","16.8","17.3"
"Tift","2020-06-10","291","5109","50","802","17.8","17.5"
"Tift","2020-06-11","218","5327","42","844","17.7","18.1"
"Tift","2020-06-12","186","5513","13","857","17.1","17.8"
"Tift","2020-06-13","7","5520","1","858","17.7","18.2"
"Tift","2020-06-14","7","5527","3","861","20","17.7"
"Tift","2020-06-15","138","5665","12","873","18.2","16.9"
"Tift","2020-06-16","324","5989","58","931","18.2","17.5"
"Tift","2020-06-17","258","6247","60","991","19","18.4"
"Tift","2020-06-18","261","6508","44","1035","18.7","18.2"
"Tift","2020-06-19","267","6775","44","1079","20","18.6"
"Tift","2020-06-20","221","6996","27","1106","19.8","18.7"
"Tift","2020-06-21","14","7010","3","1109","16.7","18.3"
"Tift","2020-06-22","379","7389","69","1178","18","18.1"
"Tift","2020-06-23","362","7751","82","1260","18.7","18.4"
"Tift","2020-06-24","357","8108","66","1326","18","18.5"
"Tift","2020-06-25","413","8521","46","1372","17.2","18"
"Tift","2020-06-26","379","8900","33","1405","16.1","18.1"
"Tift","2020-06-27","79","8979","14","1419","16.9","18.3"
"Tift","2020-06-28","30","9009","9","1428","18.1","17.4"
"Tift","2020-06-29","319","9328","32","1460","17","17.5"
"Tift","2020-06-30","115","9443","20","1480","16.2","17.5"
"Tift","2020-07-01","253","9696","34","1514","15.5","16.8"
"Tift","2020-07-02","273","9969","38","1552","15.9","16.6"
"Tift","2020-07-03","92","10061","19","1571","17.6","16.9"
"Tift","2020-07-04","98","10159","19","1590","17.8","17.4"
"Tift","2020-07-05","23","10182","6","1596","17.3","17.7"
"Tift","2020-07-06","230","10412","34","1630","18","17.5"
"Tift","2020-07-07","134","10546","13","1643","16.9","16.5"
"Tift","2020-07-08","306","10852","63","1706","17.9","16.7"
"Tift","2020-07-09","149","11001","15","1721","17.3","16.6"
"Tift","2020-07-10","307","11308","32","1753","15.9","16.7"
"Tift","2020-07-11","118","11426","14","1767","14.8","16.3"
"Tift","2020-07-12","19","11445","2","1769","12.6","14.9"
"Tift","2020-07-13","126","11571","5","1774","11","14.5"
"Tift","2020-07-14","281","11852","43","1817","11.8","14.3"
"Tift","2020-07-15","214","12066","24","1841","10.5","14.2"
"Tift","2020-07-16","215","12281","16","1857","10.1","13.7"
"Tift","2020-07-17","237","12518","35","1892","10.7","13.3"
"Tift","2020-07-18","135","12653","11","1903","10.2","12.5"
"Tift","2020-07-19","14","12667","3","1906","11.8","12.2"
"Tift","2020-07-20","143","12810","8","1914","12","11.5"
"Tift","2020-07-21","266","13076","48","1962","12.4","12.1"
"Tift","2020-07-22","234","13310","33","1995","12.8","11.6"
"Tift","2020-07-23","187","13497","33","2028","14.2","12.2"
"Tift","2020-07-24","182","13679","20","2048","13.7","12.2"
"Tift","2020-07-25","117","13796","23","2071","15.4","12.8"
"Tift","2020-07-26","20","13816","4","2075","15.1","13.5"
"Tift","2020-07-27","170","13986","25","2100","16.4","14.2"
"Tift","2020-07-28","220","14206","43","2143","16.7","14.5"
"Tift","2020-07-29","152","14358","18","2161","16.3","14.6"
"Tift","2020-07-30","178","14536","24","2185","15.7","15"
"Tift","2020-07-31","149","14685","14","2199","15.5","14.6"
"Tift","2020-08-01","106","14791","15","2214","14.7","15"
"Tift","2020-08-02","11","14802","3","2217","15.8","15.5"
"Tift","2020-08-03","153","14955","15","2232","15.1","15.8"
"Tift","2020-08-04","132","15087","24","2256","14.9","15.8"
"Tift","2020-08-05","126","15213","6","2262","13.9","15.1"
"Tift","2020-08-06","75","15288","9","2271","13.7","14.7"
"Tift","2020-08-07","137","15425","5","2276","12.8","14.2"
"Tift","2020-08-08","39","15464","6","2282","13","13.9"
"Tift","2020-08-09","24","15488","4","2286","11.5","13.6"
"Tift","2020-08-10","116","15604","6","2292","10.8","13"
"Tift","2020-08-11","98","15702","7","2299","9.3","12.1"
"Tift","2020-08-12","120","15822","11","2310","9.9","11.9"
"Tift","2020-08-13","134","15956","7","2317","8.9","11.3"
"Tift","2020-08-14","99","16055","7","2324","9.4","11.1"
"Tift","2020-08-15","42","16097","4","2328","8.6","10.8"
"Tift","2020-08-16","36","16133","1","2329","6.6","9"
"Tift","2020-08-17","72","16205","7","2336","7.2","9"
"Tift","2020-08-18","108","16313","10","2346","7.5","8.4"
"Tift","2020-08-19","105","16418","8","2354","7.3","8.6"
"Tift","2020-08-20","84","16502","9","2363","8.1","8.5"
"Tift","2020-08-21","74","16576","5","2368","8.1","8.7"
"Tift","2020-08-22","14","16590","2","2370","8.7","8.7"
"Tift","2020-08-23","12","16602","3","2373","11.9","9.2"
"Tift","2020-08-24","99","16701","9","2382","11.8","9.5"
"Tift","2020-08-25","98","16799","15","2397","12.7","10.1"
"Tift","2020-08-26","128","16927","12","2409","12.9","10.1"
"Tift","2020-08-27","129","17056","6","2415","12.1","10.1"
"Tift","2020-08-28","94","17150","9","2424","12.5","10.3"
"Tift","2020-08-29","21","17171","1","2425","11.1","9.9"
"Tift","2020-08-30","14","17185","7","2432","14.7","13.3"
"Tift","2020-08-31","117","17302","17","2449","15.5","13.6"
"Tift","2020-09-01","98","17400","19","2468","16","14.4"
"Tift","2020-09-02","89","17489","8","2476","16","14.5"
"Tift","2020-09-03","95","17584","14","2490","17.4","14.7"
"Tift","2020-09-04","73","17657","10","2500","18","15.2"
"Tift","2020-09-05","17","17674","1","2501","18.2","14.6"
"Tift","2020-09-06","15","17689","5","2506","15.8","15.2"
"Tift","2020-09-07","41","17730","9","2515","16.9","16.2"
"Tift","2020-09-08","93","17823","9","2524","15.5","15.8"
"Tift","2020-09-09","118","17941","14","2538","15.9","15.9"
"Tift","2020-09-10","73","18014","4","2542","14.6","16"
"Tift","2020-09-11","81","18095","11","2553","14.5","16.3"
"Tift","2020-09-12","28","18123","6","2559","16.8","17.5"
"Tift","2020-09-13","63","18186","6","2565","13.4","14.6"
"Tift","2020-09-14","110","18296","10","2575","11.5","14.2"
"Tift","2020-09-15","74","18370","12","2587","12.5","14"
"Tift","2020-09-16","106","18476","15","2602","12.8","14.3"
"Tift","2020-09-17","80","18556","16","2618","14.9","14.7"
"Tift","2020-09-18","160","18716","11","2629","13.9","14.2"
"Tift","2020-09-19","31","18747","7","2636","14.1","15.4"
"Tift","2020-09-20","33","18780","10","2646","17","15.2"
"Tift","2020-09-21","117","18897","18","2664","17.9","14.7"
"Tift","2020-09-22","76","18973","5","2669","16.6","14.5"
"Tift","2020-09-23","89","19062","7","2676","15.7","14.2"
"Tift","2020-09-24","78","19140","11","2687","14.8","14.8"
"Tift","2020-09-25","78","19218","11","2698","15.8","14.9"
"Tift","2020-09-26","16","19234","1","2699","13.5","13.8"
"Tift","2020-09-27","13","19247","2","2701","11.4","14.2"
"Tift","2020-09-28","112","19359","25","2726","12.4","15.2"
"Tift","2020-09-29","89","19448","3","2729","11.9","14.2"
"Tift","2020-09-30","66","19514","7","2736","12.3","14"
"Tift","2020-10-01","87","19601","11","2747","12.1","13.5"
"Tift","2020-10-02","131","19732","7","2754","10.8","13.3"
"Tift","2020-10-03","70","19802","1","2755","10.2","11.8"
"Tift","2020-10-04","43","19845","3","2758","9","10.2"
"Tift","2020-10-05","116","19961","8","2766","6.8","9.6"
"Tift","2020-10-06","74","20035","6","2772","7.4","9.7"
"Tift","2020-10-07","104","20139","7","2779","6.9","9.6"
"Tift","2020-10-08","74","20213","7","2786","6.4","9.3"
"Tift","2020-10-09","148","20361","7","2793","6.3","8.6"
"Tift","2020-10-10","53","20414","5","2798","7.5","8.8"
"Tift","2020-10-11","62","20476","3","2801","7.2","8.1"
"Tift","2020-10-12","60","20536","5","2806","7.4","7.1"
"Tift","2020-10-13","71","20607","4","2810","7","7.2"
"Tift","2020-10-14","81","20688","5","2815","6.9","6.9"
"Tift","2020-10-15","101","20789","7","2822","6.6","6.5"
"Tift","2020-10-16","73","20862","6","2828","7.1","6.7"
"Tift","2020-10-17","54","20916","0","2828","5.7","6.6"
"Tift","2020-10-18","24","20940","6","2834","8.6","7.9"
"Tift","2020-10-19","70","21010","6","2840","8.6","8"
"Tift","2020-10-20","64","21074","3","2843","8.5","7.8"
"Tift","2020-10-21","71","21145","6","2849","8.8","7.9"
"Tift","2020-10-22","80","21225","6","2855","8.9","7.8"
"Tift","2020-10-23","116","21341","12","2867","9.2","8.2"
"Tift","2020-10-24","53","21394","6","2873","10.8","8.3"
"Tift","2020-10-25","17","21411","4","2877","10.6","9.6"
"Tift","2020-10-26","96","21507","12","2889","11.2","9.9"
"Tift","2020-10-27","83","21590","2","2891","10.9","9.7"
"Tift","2020-10-28","79","21669","6","2897","10.7","9.8"
"Tift","2020-10-29","67","21736","6","2903","11","9.9"
"Tift","2020-10-30","108","21844","5","2908","10.1","9.7"
"Tift","2020-10-31","43","21887","6","2914","10.5","10.7"
"Tift","2020-11-01","53","21940","5","2919","8.5","9.6"
"Tift","2020-11-02","85","22025","9","2928","8.2","9.7"
"Tift","2020-11-03","78","22103","1","2929","8.1","9.5"
"Tift","2020-11-04","159","22262","5","2934","7.4","9.1"
"Tift","2020-11-05","85","22347","4","2938","6.8","8.9"
"Tift","2020-11-06","70","22417","4","2942","7","8.6"
"Tift","2020-11-07","53","22470","1","2943","5.3","7.9"
"Tift","2020-11-08","16","22486","4","2947","7.5","8"
"Tift","2020-11-09","95","22581","7","2954","7","7.6"
"Tift","2020-11-10","111","22692","15","2969","8.8","8.4"
"Tift","2020-11-11","56","22748","13","2982","11.6","9.5"
"Tift","2020-11-12","181","22929","13","2995","12","9.4"
"Tift","2020-11-13","130","23059","12","3007","12.5","9.7"
"Tift","2020-11-14","90","23149","6","3013","13.2","9.2"
"Tift","2020-11-15","42","23191","10","3023","13","10.2"
"Tift","2020-11-16","131","23322","16","3039","13.7","10.4"
"Tift","2020-11-17","133","23455","22","3061","14.1","11.4"
"Tift","2020-11-18","128","23583","13","3074","12.3","11.9"
"Tift","2020-11-19","173","23756","15","3089","12.5","12.2"
"Tift","2020-11-20","159","23915","13","3102","12.3","12.4"
"Tift","2020-11-21","44","23959","10","3112","14.6","13.9"
"Tift","2020-11-22","31","23990","8","3120","14.9","13.9"
"Tift","2020-11-23","154","24144","23","3143","15.3","14.5"
"Tift","2020-11-24","132","24276","24","3167","15.5","14.8"
"Tift","2020-11-25","150","24426","31","3198","17","14.6"
"Tift","2020-11-26","96","24522","6","3204","16.7","14.6"
"Tift","2020-11-27","77","24599","16","3220","18.5","15.4"
"Tift","2020-11-28","41","24640","7","3227","17.7","16.1"
"Tift","2020-11-29","28","24668","8","3235","18.1","16.5"
"Tift","2020-11-30","174","24842","34","3269","18.7","17"
"Tift","2020-12-01","123","24965","24","3293","18.9","17.2"
"Tift","2020-12-02","167","25132","20","3313","17.7","17.3"
"Tift","2020-12-03","144","25276","25","3338","19.3","18"
"Tift","2020-12-04","176","25452","20","3358","17.9","18.2"
"Tift","2020-12-05","83","25535","5","3363","16.3","17"
"Tift","2020-12-06","53","25588","10","3373","14.9","16.5"
"Tift","2020-12-07","160","25748","28","3401","14.7","16.7"
"Tift","2020-12-08","174","25922","23","3424","13.8","16.3"
"Tift","2020-12-09","132","26054","21","3445","14.3","16"
"Tift","2020-12-10","206","26260","16","3461","13","16.1"
"Tift","2020-12-11","155","26415","19","3480","13.1","15.5"
"Tift","2020-12-12","50","26465","9","3489","14.8","15.6"
"Tift","2020-12-13","25","26490","9","3498","17.2","16.1"
"Tift","2020-12-14","178","26668","36","3534","17.6","16.1"
"Tift","2020-12-15","143","26811","22","3556","17.9","15.8"
"Tift","2020-12-16","147","26958","18","3574","17.4","15.9"
"Tift","2020-12-17","191","27149","19","3593","17.7","15.3"
"Tift","2020-12-18","131","27280","16","3609","17.7","15.4"
"Tift","2020-12-19","92","27372","4","3613","15.8","15.3"
"Tift","2020-12-20","47","27419","13","3626","14.6","15.9"
"Tift","2020-12-21","142","27561","24","3650","14.1","15.9"
"Tift","2020-12-22","135","27696","26","3676","14.7","16.3"
"Tift","2020-12-23","158","27854","34","3710","16","16.7"
"Tift","2020-12-24","117","27971","17","3727","16.6","17.2"
"Tift","2020-12-25","13","27984","4","3731","19.3","18.5"
"Tift","2020-12-26","68","28052","16","3747","22","18.9"
"Tift","2020-12-27","51","28103","15","3762","22.3","18.4"
"Tift","2020-12-28","94","28197","22","3784","23.2","18.7"
"Tift","2020-12-29","101","28298","23","3807","23.7","19.2"
"Tift","2020-12-30","232","28530","27","3834","22.3","19.1"
"Tift","2020-12-31","117","28647","15","3849","22","19.3"
"Tift","2021-01-01","21","28668","5","3854","21.1","20.2"
"Tift","2021-01-02","33","28701","8","3862","21.2","21.6"
"Tift","2021-01-03","77","28778","8","3870","18.4","20.4"
"Tift","2021-01-04","106","28884","27","3897","18.7","21"
"Tift","2021-01-05","113","28997","23","3920","18.4","21"
"Tift","2021-01-06","179","29176","29","3949","19","20.7"
"Tift","2021-01-07","195","29371","17","3966","18.5","20.3"
"Tift","2021-01-08","117","29488","16","3982","17","19"
"Tift","2021-01-09","60","29548","7","3989","15.2","18.2"
"Tift","2021-01-10","29","29577","8","3997","17.7","18.1"
"Tift","2021-01-11","85","29662","18","4015","17.1","17.9"
"Tift","2021-01-12","96","29758","8","4023","15.3","16.9"
"Tift","2021-01-13","153","29911","17","4040","14.6","16.8"
"Tift","2021-01-14","92","30003","15","4055","15.7","17.1"
"Tift","2021-01-15","89","30092","14","4069","16","16.5"
"Tift","2021-01-16","78","30170","6","4075","15.4","15.3"
"Tift","2021-01-17","25","30195","3","4078","13.2","15.4"
"Tift","2021-01-18","73","30268","15","4093","13.1","15.1"
"Tift","2021-01-19","74","30342","10","4103","13.8","14.6"
"Tift","2021-01-20","78","30420","15","4118","15","14.8"
"Tift","2021-01-21","175","30595","14","4132","13.8","14.8"
"Tift","2021-01-22","101","30696","12","4144","13.3","14.6"
"Tift","2021-01-23","61","30757","6","4150","13.6","14.5"
"Tift","2021-01-24","22","30779","6","4156","15.8","14.5"
"Tift","2021-01-25","81","30860","14","4170","15.3","14.2"
"Tift","2021-01-26","83","30943","10","4180","15.1","14.5"
"Tift","2021-01-27","98","31041","8","4188","13.5","14.3"
"Tift","2021-01-28","133","31174","15","4203","14","13.9"
"Tift","2021-01-29","136","31310","8","4211","13.1","13.2"
"Tift","2021-01-30","16","31326","2","4213","13.5","13.5"
"Tift","2021-01-31","18","31344","3","4216","12","13.9"
"Tift","2021-02-01","62","31406","6","4222","10.9","13.1"
"Tift","2021-02-02","47","31453","5","4227","10.7","12.9"
"Tift","2021-02-03","104","31557","2","4229","9.8","11.6"
"Tift","2021-02-04","126","31683","5","4234","8.8","11.4"
"Tift","2021-02-05","64","31747","1","4235","8.1","10.6"
"Tift","2021-02-06","23","31770","0","4235","6.3","9.9"
"Tift","2021-02-07","6","31776","0","4235","4","8"
"Tift","2021-02-08","0","31776","0","4235","2.6","6.7"
"Toombs","2020-02-01","0","0","0","0",".","."
"Toombs","2020-02-02","0","0","0","0",".","."
"Toombs","2020-02-03","0","0","0","0",".","."
"Toombs","2020-02-04","0","0","0","0",".","."
"Toombs","2020-02-05","0","0","0","0",".","."
"Toombs","2020-02-06","0","0","0","0",".","."
"Toombs","2020-02-07","0","0","0","0","0","."
"Toombs","2020-02-08","0","0","0","0","0","."
"Toombs","2020-02-09","0","0","0","0","0","."
"Toombs","2020-02-10","0","0","0","0","0","."
"Toombs","2020-02-11","0","0","0","0","0","."
"Toombs","2020-02-12","0","0","0","0","0","."
"Toombs","2020-02-13","0","0","0","0","0","."
"Toombs","2020-02-14","0","0","0","0","0","0"
"Toombs","2020-02-15","0","0","0","0","0","0"
"Toombs","2020-02-16","0","0","0","0","0","0"
"Toombs","2020-02-17","0","0","0","0","0","0"
"Toombs","2020-02-18","0","0","0","0","0","0"
"Toombs","2020-02-19","0","0","0","0","0","0"
"Toombs","2020-02-20","0","0","0","0","0","0"
"Toombs","2020-02-21","0","0","0","0","0","0"
"Toombs","2020-02-22","0","0","0","0","0","0"
"Toombs","2020-02-23","0","0","0","0","0","0"
"Toombs","2020-02-24","0","0","0","0","0","0"
"Toombs","2020-02-25","0","0","0","0","0","0"
"Toombs","2020-02-26","0","0","0","0","0","0"
"Toombs","2020-02-27","0","0","0","0","0","0"
"Toombs","2020-02-28","0","0","0","0","0","0"
"Toombs","2020-02-29","0","0","0","0","0","0"
"Toombs","2020-03-01","0","0","0","0","0","0"
"Toombs","2020-03-02","0","0","0","0","0","0"
"Toombs","2020-03-03","0","0","0","0","0","0"
"Toombs","2020-03-04","0","0","0","0","0","0"
"Toombs","2020-03-05","0","0","0","0","0","0"
"Toombs","2020-03-06","0","0","0","0","0","0"
"Toombs","2020-03-07","0","0","0","0","0","0"
"Toombs","2020-03-08","0","0","0","0","0","0"
"Toombs","2020-03-09","0","0","0","0","0","0"
"Toombs","2020-03-10","0","0","0","0","0","0"
"Toombs","2020-03-11","0","0","0","0","0","0"
"Toombs","2020-03-12","0","0","0","0","0","0"
"Toombs","2020-03-13","1","1","0","0","0","0"
"Toombs","2020-03-14","0","1","0","0","0","0"
"Toombs","2020-03-15","0","1","0","0","0","0"
"Toombs","2020-03-16","1","2","0","0","0","0"
"Toombs","2020-03-17","1","3","0","0","0","0"
"Toombs","2020-03-18","3","6","0","0","0","0"
"Toombs","2020-03-19","7","13","0","0","0","0"
"Toombs","2020-03-20","5","18","0","0","0","0"
"Toombs","2020-03-21","3","21","1","1","4.8","2.4"
"Toombs","2020-03-22","4","25","0","1","4.8","2.4"
"Toombs","2020-03-23","7","32","1","2","6.8","3.4"
"Toombs","2020-03-24","8","40","2","4","10.4","5.2"
"Toombs","2020-03-25","2","42","0","4","10.4","5.2"
"Toombs","2020-03-26","3","45","0","4","10.4","5.2"
"Toombs","2020-03-27","4","49","0","4","10.4","5.2"
"Toombs","2020-03-28","0","49","0","4","5.6","5.2"
"Toombs","2020-03-29","0","49","0","4","5.6","5.2"
"Toombs","2020-03-30","1","50","0","4","3.6","5.2"
"Toombs","2020-03-31","6","56","1","5","2.4","6.4"
"Toombs","2020-04-01","3","59","1","6","7.1","8.8"
"Toombs","2020-04-02","3","62","0","6","7.1","8.8"
"Toombs","2020-04-03","1","63","0","6","7.1","8.8"
"Toombs","2020-04-04","1","64","0","6","7.1","6.4"
"Toombs","2020-04-05","1","65","0","6","7.1","6.4"
"Toombs","2020-04-06","9","74","2","8","10.3","6.9"
"Toombs","2020-04-07","4","78","0","8","7.9","5.2"
"Toombs","2020-04-08","8","86","1","9","5","6.1"
"Toombs","2020-04-09","2","88","0","9","5","6.1"
"Toombs","2020-04-10","1","89","1","10","19.2","13.2"
"Toombs","2020-04-11","1","90","0","10","19.2","13.2"
"Toombs","2020-04-12","0","90","0","10","19.2","13.2"
"Toombs","2020-04-13","4","94","1","11","19.6","15"
"Toombs","2020-04-14","4","98","2","13","26.8","17.4"
"Toombs","2020-04-15","2","100","1","14","32.1","18.6"
"Toombs","2020-04-16","2","102","1","15","39.3","22.1"
"Toombs","2020-04-17","7","109","1","16","27","23.1"
"Toombs","2020-04-18","4","113","0","16","27","23.1"
"Toombs","2020-04-19","1","114","0","16","27","23.1"
"Toombs","2020-04-20","47","161","1","17","23.8","21.7"
"Toombs","2020-04-21","19","180","3","20","18.9","22.8"
"Toombs","2020-04-22","9","189","0","20","11.7","21.9"
"Toombs","2020-04-23","9","198","2","22","7.8","23.5"
"Toombs","2020-04-24","7","205","0","22","5.7","16.4"
"Toombs","2020-04-25","3","208","1","23","10.5","18.8"
"Toombs","2020-04-26","4","212","0","23","10.5","18.8"
"Toombs","2020-04-27","8","220","1","24","12","17.9"
"Toombs","2020-04-28","5","225","1","25","12.6","15.7"
"Toombs","2020-04-29","11","236","1","26","13.9","12.8"
"Toombs","2020-04-30","8","244","1","27","12.5","10.1"
"Toombs","2020-05-01","3","247","0","27","12.5","9.1"
"Toombs","2020-05-02","5","252","1","28","10.6","10.5"
"Toombs","2020-05-03","3","255","1","29","15.3","12.9"
"Toombs","2020-05-04","7","262","1","30","15.6","13.8"
"Toombs","2020-05-05","9","271","0","30","12.7","12.7"
"Toombs","2020-05-06","6","277","2","32","16.2","15"
"Toombs","2020-05-07","7","284","1","33","16.5","14.5"
"Toombs","2020-05-08","5","289","1","34","19.3","15.9"
"Toombs","2020-05-09","0","289","0","34","16.5","13.5"
"Toombs","2020-05-10","1","290","0","34","11.7","13.5"
"Toombs","2020-05-11","9","299","1","35","11.2","13.4"
"Toombs","2020-05-12","4","303","0","35","11.2","12"
"Toombs","2020-05-13","6","309","0","35","6.5","11.3"
"Toombs","2020-05-14","11","320","0","35","4.4","10.5"
"Toombs","2020-05-15","5","325","1","36","4.4","11.9"
"Toombs","2020-05-16","2","327","0","36","4.4","10.5"
"Toombs","2020-05-17","2","329","0","36","4.4","8.1"
"Toombs","2020-05-18","10","339","1","37","4.3","7.8"
"Toombs","2020-05-19","18","357","1","38","5.1","8.2"
"Toombs","2020-05-20","11","368","1","39","6.4","6.4"
"Toombs","2020-05-21","17","385","0","39","6.4","5.4"
"Toombs","2020-05-22","10","395","0","39","3.5","4"
"Toombs","2020-05-23","0","395","0","39","3.5","4"
"Toombs","2020-05-24","2","397","0","39","3.5","4"
"Toombs","2020-05-25","0","397","0","39","2.1","3.2"
"Toombs","2020-05-26","12","409","0","39","1.3","3.2"
"Toombs","2020-05-27","13","422","2","41","2.2","4.3"
"Toombs","2020-05-28","7","429","0","41","2.2","4.3"
"Toombs","2020-05-29","19","448","2","43","3.7","3.6"
"Toombs","2020-05-30","6","454","0","43","3.7","3.6"
"Toombs","2020-05-31","1","455","0","43","3.7","3.6"
"Toombs","2020-06-01","36","491","2","45","4.5","3.3"
"Toombs","2020-06-02","11","502","0","45","4.5","2.9"
"Toombs","2020-06-03","23","525","3","48","4.2","3.2"
"Toombs","2020-06-04","19","544","9","57","10.9","6.6"
"Toombs","2020-06-05","18","562","6","63","14.2","8.9"
"Toombs","2020-06-06","9","571","2","65","17.4","10.5"
"Toombs","2020-06-07","1","572","0","65","17.4","10.5"
"Toombs","2020-06-08","36","608","6","71","18.9","11.7"
"Toombs","2020-06-09","18","626","1","72","19.7","12.1"
"Toombs","2020-06-10","34","660","9","81","21.7","12.9"
"Toombs","2020-06-11","23","683","0","81","14.9","12.9"
"Toombs","2020-06-12","25","708","4","85","12.4","13.3"
"Toombs","2020-06-13","9","717","2","87","12.4","14.9"
"Toombs","2020-06-14","6","723","2","89","17.2","17.3"
"Toombs","2020-06-15","25","748","3","92","16.5","17.7"
"Toombs","2020-06-16","44","792","5","97","17.3","18.5"
"Toombs","2020-06-17","26","818","4","101","15.8","18.7"
"Toombs","2020-06-18","54","872","4","105","16.8","15.9"
"Toombs","2020-06-19","20","892","2","107","16","14.2"
"Toombs","2020-06-20","10","902","0","107","12.8","12.6"
"Toombs","2020-06-21","14","916","5","112","13.1","15.2"
"Toombs","2020-06-22","38","954","11","123","15.5","16"
"Toombs","2020-06-23","35","989","11","134","18.4","17.9"
"Toombs","2020-06-24","34","1023","11","145","20.8","18.3"
"Toombs","2020-06-25","34","1057","7","152","22.7","19.8"
"Toombs","2020-06-26","34","1091","5","157","23.4","19.7"
"Toombs","2020-06-27","7","1098","4","161","31.6","22.2"
"Toombs","2020-06-28","8","1106","0","161","26.5","19.8"
"Toombs","2020-06-29","43","1149","4","165","23.6","19.6"
"Toombs","2020-06-30","42","1191","5","170","20.9","19.6"
"Toombs","2020-07-01","36","1227","5","175","18.2","19.5"
"Toombs","2020-07-02","19","1246","2","177","16.8","19.8"
"Toombs","2020-07-03","18","1264","3","180","17.1","20.2"
"Toombs","2020-07-04","3","1267","2","182","18.4","25"
"Toombs","2020-07-05","21","1288","8","190","23.9","25.2"
"Toombs","2020-07-06","50","1338","16","206","27.1","25.4"
"Toombs","2020-07-07","48","1386","8","214","27.8","24.3"
"Toombs","2020-07-08","52","1438","6","220","27.5","22.8"
"Toombs","2020-07-09","40","1478","7","227","28.4","22.6"
"Toombs","2020-07-10","61","1539","8","235","27.9","22.5"
"Toombs","2020-07-11","26","1565","3","238","20.1","19.2"
"Toombs","2020-07-12","20","1585","4","242","17.5","20.7"
"Toombs","2020-07-13","59","1644","13","255","16.1","21.6"
"Toombs","2020-07-14","68","1712","14","269","16.6","22.2"
"Toombs","2020-07-15","64","1776","21","290","19.7","23.6"
"Toombs","2020-07-16","63","1839","10","300","19.4","23.9"
"Toombs","2020-07-17","44","1883","12","312","21.4","24.7"
"Toombs","2020-07-18","17","1900","2","314","21.5","20.8"
"Toombs","2020-07-19","12","1912","2","316","21","19.2"
"Toombs","2020-07-20","49","1961","12","328","21.4","18.7"
"Toombs","2020-07-21","46","2007","14","342","22.8","19.7"
"Toombs","2020-07-22","63","2070","14","356","21.2","20.5"
"Toombs","2020-07-23","68","2138","12","368","21.5","20.5"
"Toombs","2020-07-24","48","2186","5","373","19.1","20.3"
"Toombs","2020-07-25","30","2216","13","386","23.6","22.5"
"Toombs","2020-07-26","15","2231","4","390","25","23"
"Toombs","2020-07-27","58","2289","15","405","25.2","23.3"
"Toombs","2020-07-28","74","2363","16","421","24","23.4"
"Toombs","2020-07-29","74","2437","12","433","23.1","22.2"
"Toombs","2020-07-30","66","2503","24","457","25.8","23.6"
"Toombs","2020-07-31","98","2601","33","490","29.1","24.1"
"Toombs","2020-08-01","25","2626","9","499","28.1","25.8"
"Toombs","2020-08-02","23","2649","6","505","28","26.5"
"Toombs","2020-08-03","49","2698","16","521","28.9","27.1"
"Toombs","2020-08-04","44","2742","10","531","29.1","26.5"
"Toombs","2020-08-05","106","2848","24","555","30","26.6"
"Toombs","2020-08-06","47","2895","16","571","29.7","27.7"
"Toombs","2020-08-07","67","2962","9","580","26.8","28"
"Toombs","2020-08-08","21","2983","5","585","25.1","26.6"
"Toombs","2020-08-09","37","3020","11","596","25.6","26.8"
"Toombs","2020-08-10","56","3076","5","601","22.2","25.6"
"Toombs","2020-08-11","75","3151","20","621","22.8","25.9"
"Toombs","2020-08-12","89","3240","31","652","24.5","27.3"
"Toombs","2020-08-13","70","3310","17","669","23.1","26.4"
"Toombs","2020-08-14","42","3352","11","680","24.9","25.9"
"Toombs","2020-08-15","25","3377","10","690","27.2","26.1"
"Toombs","2020-08-16","24","3401","3","693","24.8","25.2"
"Toombs","2020-08-17","45","3446","9","702","26.4","24.3"
"Toombs","2020-08-18","59","3505","17","719","26.7","24.7"
"Toombs","2020-08-19","111","3616","28","747","25.3","24.9"
"Toombs","2020-08-20","37","3653","9","756","25.3","24.2"
"Toombs","2020-08-21","40","3693","4","760","23","24"
"Toombs","2020-08-22","56","3749","10","770","19.8","23.5"
"Toombs","2020-08-23","13","3762","4","774","22.4","23.6"
"Toombs","2020-08-24","74","3836","9","783","21.3","23.8"
"Toombs","2020-08-25","57","3893","14","797","20.7","23.7"
"Toombs","2020-08-26","34","3927","4","801","18.8","22"
"Toombs","2020-08-27","61","3988","14","815","18.6","21.9"
"Toombs","2020-08-28","33","4021","5","820","19.3","21.1"
"Toombs","2020-08-29","48","4069","14","834","20.9","20.4"
"Toombs","2020-08-30","18","4087","5","839","20.5","21.5"
"Toombs","2020-08-31","79","4166","9","848","20.4","20.9"
"Toombs","2020-09-01","51","4217","9","857","19.4","20.1"
"Toombs","2020-09-02","66","4283","16","873","21.2","20"
"Toombs","2020-09-03","47","4330","4","877","19.1","18.9"
"Toombs","2020-09-04","54","4384","11","888","19.9","19.6"
"Toombs","2020-09-05","24","4408","10","898","21.7","21.3"
"Toombs","2020-09-06","16","4424","4","902","21.3","20.9"
"Toombs","2020-09-07","17","4441","3","905","22.2","21.3"
"Toombs","2020-09-08","39","4480","15","920","25.1","22.3"
"Toombs","2020-09-09","47","4527","11","931","25","23.1"
"Toombs","2020-09-10","50","4577","8","939","26.1","22.6"
"Toombs","2020-09-11","27","4604","4","943","25.3","22.6"
"Toombs","2020-09-12","23","4627","9","952","24.9","23.3"
"Toombs","2020-09-13","16","4643","5","957","25.8","23.5"
"Toombs","2020-09-14","42","4685","5","962","25","23.6"
"Toombs","2020-09-15","54","4739","15","977","23.5","24.3"
"Toombs","2020-09-16","53","4792","8","985","22.3","23.6"
"Toombs","2020-09-17","44","4836","6","991","21.9","24"
"Toombs","2020-09-18","43","4879","8","999","22.5","23.9"
"Toombs","2020-09-19","24","4903","5","1004","19.9","22.4"
"Toombs","2020-09-20","5","4908","1","1005","18.3","22"
"Toombs","2020-09-21","38","4946","9","1014","19.9","22.5"
"Toombs","2020-09-22","28","4974","6","1020","19","21.3"
"Toombs","2020-09-23","18","4992","2","1022","18.5","20.4"
"Toombs","2020-09-24","36","5028","7","1029","19.3","20.6"
"Toombs","2020-09-25","36","5064","2","1031","17.4","20"
"Toombs","2020-09-26","7","5071","3","1034","20.6","20.2"
"Toombs","2020-09-27","6","5077","1","1035","20.1","19.2"
"Toombs","2020-09-28","36","5113","6","1041","19.1","19.5"
"Toombs","2020-09-29","22","5135","1","1042","16.7","17.9"
"Toombs","2020-09-30","34","5169","9","1051","18.9","18.7"
"Toombs","2020-10-01","35","5204","6","1057","18.6","18.9"
"Toombs","2020-10-02","72","5276","3","1060","18.4","17.9"
"Toombs","2020-10-03","36","5312","4","1064","13.8","17.2"
"Toombs","2020-10-04","18","5330","8","1072","17.8","18.9"
"Toombs","2020-10-05","34","5364","7","1079","18.4","18.7"
"Toombs","2020-10-06","31","5395","3","1082","19.1","17.9"
"Toombs","2020-10-07","60","5455","10","1092","17.7","18.3"
"Toombs","2020-10-08","39","5494","4","1096","16.7","17.6"
"Toombs","2020-10-09","35","5529","2","1098","16.9","17.6"
"Toombs","2020-10-10","17","5546","4","1102","18.7","16.3"
"Toombs","2020-10-11","8","5554","0","1102","12.3","15.1"
"Toombs","2020-10-12","34","5588","4","1106","11.1","14.7"
"Toombs","2020-10-13","48","5636","5","1111","11.2","15.1"
"Toombs","2020-10-14","32","5668","3","1114","10.2","13.9"
"Toombs","2020-10-15","31","5699","5","1119","11","13.8"
"Toombs","2020-10-16","31","5730","6","1125","12.9","14.9"
"Toombs","2020-10-17","62","5792","7","1132","11.2","14.9"
"Toombs","2020-10-18","9","5801","1","1133","12.8","12.6"
"Toombs","2020-10-19","30","5831","6","1139","14","12.5"
"Toombs","2020-10-20","30","5861","8","1147","16.3","13.7"
"Toombs","2020-10-21","59","5920","7","1154","16.6","13.4"
"Toombs","2020-10-22","21","5941","3","1157","16.4","13.7"
"Toombs","2020-10-23","14","5955","3","1160","16.7","14.8"
"Toombs","2020-10-24","55","6010","2","1162","15.6","13.4"
"Toombs","2020-10-25","13","6023","1","1163","15.1","13.9"
"Toombs","2020-10-26","21","6044","3","1166","14.3","14.1"
"Toombs","2020-10-27","32","6076","7","1173","13.6","14.9"
"Toombs","2020-10-28","14","6090","1","1174","12.9","14.8"
"Toombs","2020-10-29","38","6128","8","1182","13.9","15.1"
"Toombs","2020-10-30","15","6143","1","1183","11.8","14.2"
"Toombs","2020-10-31","23","6166","1","1184","11.9","13.7"
"Toombs","2020-11-01","12","6178","2","1186","13.1","14.1"
"Toombs","2020-11-02","30","6208","6","1192","14","14.1"
"Toombs","2020-11-03","37","6245","2","1194","11.6","12.6"
"Toombs","2020-11-04","36","6281","3","1197","11.8","12.3"
"Toombs","2020-11-05","32","6313","2","1199","9.7","11.8"
"Toombs","2020-11-06","32","6345","4","1203","10.5","11.1"
"Toombs","2020-11-07","18","6363","3","1206","12.3","12.1"
"Toombs","2020-11-08","21","6384","3","1209","11.9","12.5"
"Toombs","2020-11-09","41","6425","3","1212","10.1","12"
"Toombs","2020-11-10","47","6472","5","1217","10.9","11.2"
"Toombs","2020-11-11","34","6506","3","1220","10.9","11.4"
"Toombs","2020-11-12","35","6541","6","1226","12.5","11.1"
"Toombs","2020-11-13","48","6589","6","1232","12.5","11.5"
"Toombs","2020-11-14","20","6609","0","1232","10.1","11.2"
"Toombs","2020-11-15","25","6634","4","1236","10.3","11.1"
"Toombs","2020-11-16","51","6685","6","1242","11","10.5"
"Toombs","2020-11-17","51","6736","8","1250","11.7","11.3"
"Toombs","2020-11-18","44","6780","7","1257","12.7","11.8"
"Toombs","2020-11-19","67","6847","5","1262","11.3","11.9"
"Toombs","2020-11-20","58","6905","7","1269","11.3","11.9"
"Toombs","2020-11-21","18","6923","4","1273","14.4","12.3"
"Toombs","2020-11-22","26","6949","4","1277","14.4","12.4"
"Toombs","2020-11-23","37","6986","7","1284","15.4","13.2"
"Toombs","2020-11-24","28","7014","4","1288","15.2","13.4"
"Toombs","2020-11-25","25","7039","4","1292","15.2","14"
"Toombs","2020-11-26","6","7045","0","1292","14.1","12.7"
"Toombs","2020-11-27","40","7085","8","1300","15.3","13.3"
"Toombs","2020-11-28","34","7119","3","1303","13.3","13.9"
"Toombs","2020-11-29","20","7139","3","1306","13.3","13.8"
"Toombs","2020-11-30","63","7202","8","1314","12.4","13.9"
"Toombs","2020-12-01","56","7258","6","1320","11.9","13.5"
"Toombs","2020-12-02","56","7314","11","1331","12.4","13.8"
"Toombs","2020-12-03","40","7354","4","1335","13.8","14"
"Toombs","2020-12-04","47","7401","8","1343","13.4","14.3"
"Toombs","2020-12-05","29","7430","2","1345","13.1","13.2"
"Toombs","2020-12-06","23","7453","9","1354","16.6","14.9"
"Toombs","2020-12-07","42","7495","6","1360","16.8","14.6"
"Toombs","2020-12-08","47","7542","12","1372","18.9","15.4"
"Toombs","2020-12-09","57","7599","9","1381","18.4","15.4"
"Toombs","2020-12-10","67","7666","6","1387","18.2","16"
"Toombs","2020-12-11","47","7713","10","1397","18.8","16.1"
"Toombs","2020-12-12","39","7752","6","1403","20.1","16.6"
"Toombs","2020-12-13","21","7773","5","1408","17.9","17.2"
"Toombs","2020-12-14","111","7884","14","1422","17.6","17.2"
"Toombs","2020-12-15","65","7949","20","1442","18.4","18.7"
"Toombs","2020-12-16","56","8005","16","1458","20.2","19.3"
"Toombs","2020-12-17","67","8072","21","1479","23.4","20.8"
"Toombs","2020-12-18","57","8129","13","1492","23.6","21.2"
"Toombs","2020-12-19","68","8197","10","1502","23.5","21.8"
"Toombs","2020-12-20","37","8234","12","1514","24.7","21.3"
"Toombs","2020-12-21","88","8322","32","1546","28.1","22.9"
"Toombs","2020-12-22","73","8395","22","1568","28.1","23.2"
"Toombs","2020-12-23","73","8468","20","1588","27.9","24"
"Toombs","2020-12-24","60","8528","11","1599","26","24.7"
"Toombs","2020-12-25","9","8537","4","1603","29.1","26.4"
"Toombs","2020-12-26","26","8563","14","1617","34.7","29.1"
"Toombs","2020-12-27","26","8589","12","1629","36.7","30.7"
"Toombs","2020-12-28","63","8652","26","1655","37.4","32.8"
"Toombs","2020-12-29","76","8728","29","1684","38.5","33.3"
"Toombs","2020-12-30","84","8812","25","1709","38.9","33.4"
"Toombs","2020-12-31","86","8898","28","1737","40.9","33.5"
"Toombs","2021-01-01","11","8909","6","1743","42.3","35.7"
"Toombs","2021-01-02","35","8944","13","1756","39.9","37.3"
"Toombs","2021-01-03","39","8983","22","1778","41.4","39"
"Toombs","2021-01-04","82","9065","32","1810","41.1","39.2"
"Toombs","2021-01-05","104","9169","38","1848","40.9","39.7"
"Toombs","2021-01-06","70","9239","19","1867","40.5","39.7"
"Toombs","2021-01-07","119","9358","40","1907","40.6","40.8"
"Toombs","2021-01-08","42","9400","9","1916","35.9","39.1"
"Toombs","2021-01-09","44","9444","13","1929","34.8","37.4"
"Toombs","2021-01-10","33","9477","8","1937","30.2","35.8"
"Toombs","2021-01-11","63","9540","20","1957","29.2","35.1"
"Toombs","2021-01-12","81","9621","18","1975","27.1","34"
"Toombs","2021-01-13","47","9668","9","1984","26","33.2"
"Toombs","2021-01-14","51","9719","16","2000","25.7","33.2"
"Toombs","2021-01-15","50","9769","12","2012","26","31"
"Toombs","2021-01-16","24","9793","3","2015","23.6","29.2"
"Toombs","2021-01-17","17","9810","4","2019","23.5","26.9"
"Toombs","2021-01-18","52","9862","13","2032","22.5","25.9"
"Toombs","2021-01-19","58","9920","9","2041","21.6","24.4"
"Toombs","2021-01-20","37","9957","7","2048","21.5","23.8"
"Toombs","2021-01-21","51","10008","9","2057","19.6","22.6"
"Toombs","2021-01-22","62","10070","13","2070","19.2","22.6"
"Toombs","2021-01-23","45","10115","11","2081","20.9","22.2"
"Toombs","2021-01-24","17","10132","6","2087","22.5","23"
"Toombs","2021-01-25","39","10171","8","2095","21.9","22.2"
"Toombs","2021-01-26","54","10225","7","2102","21.5","21.6"
"Toombs","2021-01-27","48","10273","15","2117","23.3","22.4"
"Toombs","2021-01-28","49","10322","6","2123","22.5","21.1"
"Toombs","2021-01-29","43","10365","8","2131","22.2","20.7"
"Toombs","2021-01-30","29","10394","6","2137","21.7","21.3"
"Toombs","2021-01-31","18","10412","2","2139","18.2","20.4"
"Toombs","2021-02-01","46","10458","8","2147","17.8","19.8"
"Toombs","2021-02-02","46","10504","5","2152","17.5","19.5"
"Toombs","2021-02-03","36","10540","3","2155","14.2","18.7"
"Toombs","2021-02-04","50","10590","6","2161","14.1","18.3"
"Toombs","2021-02-05","48","10638","5","2166","13","17.6"
"Toombs","2021-02-06","6","10644","0","2166","10","15.8"
"Toombs","2021-02-07","8","10652","3","2169","13.8","16"
"Toombs","2021-02-08","0","10652","0","2169","11.3","14.5"
"Towns","2020-02-01","0","0","0","0",".","."
"Towns","2020-02-02","0","0","0","0",".","."
"Towns","2020-02-03","0","0","0","0",".","."
"Towns","2020-02-04","0","0","0","0",".","."
"Towns","2020-02-05","0","0","0","0",".","."
"Towns","2020-02-06","0","0","0","0",".","."
"Towns","2020-02-07","0","0","0","0","0","."
"Towns","2020-02-08","0","0","0","0","0","."
"Towns","2020-02-09","0","0","0","0","0","."
"Towns","2020-02-10","0","0","0","0","0","."
"Towns","2020-02-11","0","0","0","0","0","."
"Towns","2020-02-12","0","0","0","0","0","."
"Towns","2020-02-13","0","0","0","0","0","."
"Towns","2020-02-14","0","0","0","0","0","0"
"Towns","2020-02-15","0","0","0","0","0","0"
"Towns","2020-02-16","0","0","0","0","0","0"
"Towns","2020-02-17","0","0","0","0","0","0"
"Towns","2020-02-18","0","0","0","0","0","0"
"Towns","2020-02-19","0","0","0","0","0","0"
"Towns","2020-02-20","0","0","0","0","0","0"
"Towns","2020-02-21","0","0","0","0","0","0"
"Towns","2020-02-22","0","0","0","0","0","0"
"Towns","2020-02-23","0","0","0","0","0","0"
"Towns","2020-02-24","0","0","0","0","0","0"
"Towns","2020-02-25","0","0","0","0","0","0"
"Towns","2020-02-26","0","0","0","0","0","0"
"Towns","2020-02-27","0","0","0","0","0","0"
"Towns","2020-02-28","0","0","0","0","0","0"
"Towns","2020-02-29","0","0","0","0","0","0"
"Towns","2020-03-01","0","0","0","0","0","0"
"Towns","2020-03-02","0","0","0","0","0","0"
"Towns","2020-03-03","0","0","0","0","0","0"
"Towns","2020-03-04","0","0","0","0","0","0"
"Towns","2020-03-05","0","0","0","0","0","0"
"Towns","2020-03-06","0","0","0","0","0","0"
"Towns","2020-03-07","0","0","0","0","0","0"
"Towns","2020-03-08","0","0","0","0","0","0"
"Towns","2020-03-09","0","0","0","0","0","0"
"Towns","2020-03-10","0","0","0","0","0","0"
"Towns","2020-03-11","2","2","0","0","0","0"
"Towns","2020-03-12","0","2","0","0","0","0"
"Towns","2020-03-13","0","2","0","0","0","0"
"Towns","2020-03-14","0","2","0","0","0","0"
"Towns","2020-03-15","0","2","0","0","0","0"
"Towns","2020-03-16","0","2","0","0","0","0"
"Towns","2020-03-17","1","3","0","0","0","0"
"Towns","2020-03-18","1","4","0","0","0","0"
"Towns","2020-03-19","2","6","0","0","0","0"
"Towns","2020-03-20","2","8","0","0","0","0"
"Towns","2020-03-21","2","10","0","0","0","0"
"Towns","2020-03-22","4","14","0","0","0","0"
"Towns","2020-03-23","0","14","0","0","0","0"
"Towns","2020-03-24","3","17","0","0","0","0"
"Towns","2020-03-25","2","19","0","0","0","0"
"Towns","2020-03-26","0","19","0","0","0","0"
"Towns","2020-03-27","1","20","0","0","0","0"
"Towns","2020-03-28","0","20","0","0","0","0"
"Towns","2020-03-29","0","20","0","0","0","0"
"Towns","2020-03-30","2","22","2","2","14.3","7.1"
"Towns","2020-03-31","1","23","0","2","14.3","7.1"
"Towns","2020-04-01","0","23","0","2","14.3","7.1"
"Towns","2020-04-02","7","30","0","2","14.3","7.1"
"Towns","2020-04-03","4","34","0","2","14.3","7.1"
"Towns","2020-04-04","0","34","0","2","14.3","7.1"
"Towns","2020-04-05","0","34","0","2","14.3","7.1"
"Towns","2020-04-06","0","34","0","2","0","7.1"
"Towns","2020-04-07","1","35","0","2","0","7.1"
"Towns","2020-04-08","0","35","0","2","0","7.1"
"Towns","2020-04-09","3","38","0","2","0","7.1"
"Towns","2020-04-10","0","38","0","2","0","7.1"
"Towns","2020-04-11","0","38","0","2","0","7.1"
"Towns","2020-04-12","0","38","0","2","0","7.1"
"Towns","2020-04-13","2","40","0","2","0","0"
"Towns","2020-04-14","3","43","0","2","0","0"
"Towns","2020-04-15","0","43","0","2","0","0"
"Towns","2020-04-16","1","44","0","2","0","0"
"Towns","2020-04-17","15","59","0","2","0","0"
"Towns","2020-04-18","2","61","0","2","0","0"
"Towns","2020-04-19","0","61","0","2","0","0"
"Towns","2020-04-20","1","62","0","2","0","0"
"Towns","2020-04-21","2","64","0","2","0","0"
"Towns","2020-04-22","2","66","0","2","0","0"
"Towns","2020-04-23","3","69","0","2","0","0"
"Towns","2020-04-24","20","89","0","2","0","0"
"Towns","2020-04-25","0","89","0","2","0","0"
"Towns","2020-04-26","0","89","0","2","0","0"
"Towns","2020-04-27","2","91","0","2","0","0"
"Towns","2020-04-28","25","116","0","2","0","0"
"Towns","2020-04-29","4","120","0","2","0","0"
"Towns","2020-04-30","2","122","0","2","0","0"
"Towns","2020-05-01","20","142","1","3","0.7","0.4"
"Towns","2020-05-02","0","142","0","3","0.7","0.4"
"Towns","2020-05-03","0","142","0","3","0.7","0.4"
"Towns","2020-05-04","1","143","0","3","0.7","0.4"
"Towns","2020-05-05","10","153","0","3","0.7","0.4"
"Towns","2020-05-06","4","157","0","3","0.7","0.4"
"Towns","2020-05-07","2","159","0","3","0.7","0.4"
"Towns","2020-05-08","47","206","0","3","0","0.4"
"Towns","2020-05-09","0","206","0","3","0","0.4"
"Towns","2020-05-10","0","206","0","3","0","0.4"
"Towns","2020-05-11","3","209","0","3","0","0.4"
"Towns","2020-05-12","56","265","0","3","0","0.4"
"Towns","2020-05-13","2","267","0","3","0","0.4"
"Towns","2020-05-14","1","268","0","3","0","0.4"
"Towns","2020-05-15","61","329","5","8","1.2","0.6"
"Towns","2020-05-16","4","333","1","9","4.7","2.4"
"Towns","2020-05-17","0","333","0","9","4.7","2.4"
"Towns","2020-05-18","5","338","1","10","7.6","3.8"
"Towns","2020-05-19","15","353","0","10","7.6","3.8"
"Towns","2020-05-20","2","355","1","11","14.7","7.4"
"Towns","2020-05-21","3","358","0","11","14.7","7.4"
"Towns","2020-05-22","40","398","1","12","13.9","7.5"
"Towns","2020-05-23","1","399","0","12","10.4","7.5"
"Towns","2020-05-24","1","400","0","12","10.4","7.5"
"Towns","2020-05-25","1","401","0","12","7.5","7.5"
"Towns","2020-05-26","26","427","0","12","7.5","7.5"
"Towns","2020-05-27","7","434","0","12","0.4","7.5"
"Towns","2020-05-28","31","465","1","13","0.8","7.8"
"Towns","2020-05-29","5","470","0","13","0.5","7.2"
"Towns","2020-05-30","0","470","0","13","0.5","5.4"
"Towns","2020-05-31","1","471","0","13","0.5","5.4"
"Towns","2020-06-01","7","478","0","13","0.5","4"
"Towns","2020-06-02","35","513","2","15","1.3","4.4"
"Towns","2020-06-03","3","516","0","15","1.3","0.8"
"Towns","2020-06-04","5","521","0","15","0.8","0.8"
"Towns","2020-06-05","47","568","1","16","1.1","0.8"
"Towns","2020-06-06","0","568","0","16","1.1","0.8"
"Towns","2020-06-07","1","569","0","16","1.1","0.8"
"Towns","2020-06-08","8","577","1","17","2.9","1.7"
"Towns","2020-06-09","34","611","1","18","2.5","1.9"
"Towns","2020-06-10","2","613","0","18","2.5","1.9"
"Towns","2020-06-11","5","618","0","18","2.5","1.7"
"Towns","2020-06-12","43","661","0","18","2.2","1.7"
"Towns","2020-06-13","0","661","0","18","2.2","1.7"
"Towns","2020-06-14","0","661","0","18","2.2","1.7"
"Towns","2020-06-15","11","672","0","18","0.4","1.7"
"Towns","2020-06-16","1","673","0","18","0","1.3"
"Towns","2020-06-17","2","675","1","19","7.1","4.8"
"Towns","2020-06-18","4","679","0","19","7.1","4.8"
"Towns","2020-06-19","64","743","0","19","7.1","4.7"
"Towns","2020-06-20","0","743","0","19","7.1","4.7"
"Towns","2020-06-21","0","743","0","19","7.1","4.7"
"Towns","2020-06-22","5","748","0","19","7.1","3.8"
"Towns","2020-06-23","4","752","0","19","7.1","3.6"
"Towns","2020-06-24","5","757","0","19","0","3.6"
"Towns","2020-06-25","9","766","0","19","0","3.6"
"Towns","2020-06-26","112","878","9","28","1.1","4.1"
"Towns","2020-06-27","1","879","0","28","1.1","4.1"
"Towns","2020-06-28","0","879","0","28","1.1","4.1"
"Towns","2020-06-29","109","988","7","35","2.1","4.6"
"Towns","2020-06-30","9","997","1","36","3.7","5.4"
"Towns","2020-07-01","4","1001","1","37","7.2","3.6"
"Towns","2020-07-02","111","1112","9","46","8.4","4.2"
"Towns","2020-07-03","11","1123","0","46","7.2","4.2"
"Towns","2020-07-04","0","1123","0","46","7.2","4.2"
"Towns","2020-07-05","1","1124","0","46","7.2","4.2"
"Towns","2020-07-06","113","1237","14","60","8.1","5.1"
"Towns","2020-07-07","9","1246","0","60","6.5","5.1"
"Towns","2020-07-08","10","1256","4","64","8.6","7.9"
"Towns","2020-07-09","21","1277","1","65","8.2","8.3"
"Towns","2020-07-10","139","1416","4","69","8.6","7.9"
"Towns","2020-07-11","2","1418","0","69","8.6","7.9"
"Towns","2020-07-12","13","1431","1","70","9.7","8.5"
"Towns","2020-07-13","60","1491","3","73","8.6","8.4"
"Towns","2020-07-14","8","1499","3","76","14","10.2"
"Towns","2020-07-15","17","1516","1","77","9.1","8.9"
"Towns","2020-07-16","14","1530","1","78","9.4","8.8"
"Towns","2020-07-17","154","1684","2","80","9.2","8.9"
"Towns","2020-07-18","1","1685","0","80","9.2","8.9"
"Towns","2020-07-19","14","1699","3","83","11.2","10.4"
"Towns","2020-07-20","12","1711","2","85","12.8","10.7"
"Towns","2020-07-21","11","1722","6","91","15.3","14.6"
"Towns","2020-07-22","21","1743","5","96","17.8","13.5"
"Towns","2020-07-23","19","1762","3","99","19.1","14.3"
"Towns","2020-07-24","23","1785","5","104","22","15.6"
"Towns","2020-07-25","11","1796","2","106","24.6","16.9"
"Towns","2020-07-26","8","1804","3","109","26.9","19"
"Towns","2020-07-27","13","1817","4","113","28.9","20.9"
"Towns","2020-07-28","8","1825","3","116","26.5","20.9"
"Towns","2020-07-29","19","1844","1","117","23.8","20.8"
"Towns","2020-07-30","13","1857","1","118","22.7","20.9"
"Towns","2020-07-31","151","2008","9","127","20.4","21.2"
"Towns","2020-08-01","7","2015","3","130","23.9","24.3"
"Towns","2020-08-02","5","2020","1","131","21.4","24.2"
"Towns","2020-08-03","5","2025","1","132","19.9","24.4"
"Towns","2020-08-04","154","2179","3","135","14.8","20.6"
"Towns","2020-08-05","23","2202","8","143","19","21.4"
"Towns","2020-08-06","4","2206","1","144","21.5","22.1"
"Towns","2020-08-07","130","2336","11","155","21.9","21.1"
"Towns","2020-08-08","0","2336","0","155","15.7","19.8"
"Towns","2020-08-09","6","2342","2","157","17.6","19.5"
"Towns","2020-08-10","26","2368","6","163","18.1","19"
"Towns","2020-08-11","141","2509","2","165","18","16.4"
"Towns","2020-08-12","31","2540","5","170","15.3","17.2"
"Towns","2020-08-13","9","2549","2","172","14.9","18.2"
"Towns","2020-08-14","132","2681","15","187","15.4","18.6"
"Towns","2020-08-15","2","2683","0","187","15.4","15.6"
"Towns","2020-08-16","24","2707","3","190","12.4","15"
"Towns","2020-08-17","13","2720","0","190","9.1","13.6"
"Towns","2020-08-18","134","2854","4","194","9.3","13.7"
"Towns","2020-08-19","10","2864","0","194","7","11.2"
"Towns","2020-08-20","89","2953","14","208","6.1","10.5"
"Towns","2020-08-21","17","2970","2","210","6.1","10.8"
"Towns","2020-08-22","13","2983","2","212","8.3","11.9"
"Towns","2020-08-23","5","2988","1","213","9.4","10.9"
"Towns","2020-08-24","6","2994","3","216","16.6","12.8"
"Towns","2020-08-25","71","3065","4","220","16.9","13.1"
"Towns","2020-08-26","14","3079","3","223","20","13.5"
"Towns","2020-08-27","7","3086","1","224","19.8","12.9"
"Towns","2020-08-28","97","3183","9","233","19.4","12.8"
"Towns","2020-08-29","1","3184","0","233","17.2","12.8"
"Towns","2020-08-30","17","3201","4","237","17.7","13.6"
"Towns","2020-08-31","6","3207","2","239","15.4","16"
"Towns","2020-09-01","5","3212","0","239","14.6","15.7"
"Towns","2020-09-02","17","3229","0","239","11.5","15.7"
"Towns","2020-09-03","11","3240","1","240","10.7","15.3"
"Towns","2020-09-04","116","3356","22","262","12.1","15.8"
"Towns","2020-09-05","8","3364","4","266","19.3","18.3"
"Towns","2020-09-06","9","3373","3","269","20.7","19.2"
"Towns","2020-09-07","1","3374","0","269","15.9","15.6"
"Towns","2020-09-08","46","3420","1","270","16.2","15.4"
"Towns","2020-09-09","9","3429","1","271","17.8","14.7"
"Towns","2020-09-10","10","3439","0","271","16.5","13.6"
"Towns","2020-09-11","23","3462","5","276","16.9","14.5"
"Towns","2020-09-12","12","3474","0","276","9.8","14.5"
"Towns","2020-09-13","12","3486","0","276","5","12.8"
"Towns","2020-09-14","12","3498","2","278","7.4","11.6"
"Towns","2020-09-15","3","3501","0","278","7.1","11.6"
"Towns","2020-09-16","7","3508","1","279","7.5","12.7"
"Towns","2020-09-17","13","3521","3","282","10.8","13.7"
"Towns","2020-09-18","122","3643","3","285","8.1","12.5"
"Towns","2020-09-19","4","3647","0","285","8.1","8.9"
"Towns","2020-09-20","1","3648","0","285","8.1","6.5"
"Towns","2020-09-21","9","3657","2","287","8.9","8.1"
"Towns","2020-09-22","39","3696","1","288","9.2","8.2"
"Towns","2020-09-23","16","3712","3","291","9.9","8.7"
"Towns","2020-09-24","9","3721","0","291","6.6","8.7"
"Towns","2020-09-25","12","3733","5","296","12.2","10.1"
"Towns","2020-09-26","14","3747","3","299","15.2","11.7"
"Towns","2020-09-27","0","3747","0","299","15.2","11.7"
"Towns","2020-09-28","12","3759","0","299","12.1","10.5"
"Towns","2020-09-29","6","3765","0","299","11.7","10.5"
"Towns","2020-09-30","17","3782","1","300","9.9","9.9"
"Towns","2020-10-01","6","3788","0","300","9.9","8.2"
"Towns","2020-10-02","92","3880","0","300","3.9","8"
"Towns","2020-10-03","8","3888","1","301","2.6","8.9"
"Towns","2020-10-04","4","3892","2","303","9.8","12.5"
"Towns","2020-10-05","18","3910","5","308","13.7","12.9"
"Towns","2020-10-06","9","3919","1","309","15.3","13.5"
"Towns","2020-10-07","6","3925","0","309","14.5","12.2"
"Towns","2020-10-08","7","3932","0","309","14.5","12.2"
"Towns","2020-10-09","3","3935","0","309","14.5","9.2"
"Towns","2020-10-10","1","3936","0","309","12.7","7.7"
"Towns","2020-10-11","3","3939","1","310","10.3","10"
"Towns","2020-10-12","11","3950","1","311","7.6","10.7"
"Towns","2020-10-13","6","3956","0","311","6.1","10.7"
"Towns","2020-10-14","8","3964","0","311","6.1","10.3"
"Towns","2020-10-15","5","3969","0","311","6.1","10.3"
"Towns","2020-10-16","88","4057","5","316","6.9","10.7"
"Towns","2020-10-17","2","4059","0","316","6.9","9.8"
"Towns","2020-10-18","1","4060","0","316","2.1","6.2"
"Towns","2020-10-19","8","4068","1","317","2.6","5.1"
"Towns","2020-10-20","4","4072","0","317","2.6","4.3"
"Towns","2020-10-21","5","4077","1","318","5.5","5.8"
"Towns","2020-10-22","22","4099","7","325","10","8"
"Towns","2020-10-23","4","4103","0","325","9.2","8"
"Towns","2020-10-24","4","4107","0","325","9.2","8"
"Towns","2020-10-25","1","4108","1","326","23.5","12.8"
"Towns","2020-10-26","9","4117","3","329","26.5","14.5"
"Towns","2020-10-27","8","4125","1","330","28.2","15.4"
"Towns","2020-10-28","7","4132","0","330","25.4","15.4"
"Towns","2020-10-29","4","4136","0","330","20.8","15.4"
"Towns","2020-10-30","79","4215","7","337","22.1","15.6"
"Towns","2020-10-31","1","4216","0","337","22.1","15.6"
"Towns","2020-11-01","2","4218","2","339","22.1","22.8"
"Towns","2020-11-02","6","4224","0","339","17.3","21.9"
"Towns","2020-11-03","3","4227","0","339","15.6","21.9"
"Towns","2020-11-04","6","4233","1","340","17.9","21.7"
"Towns","2020-11-05","10","4243","1","341","19.4","20.1"
"Towns","2020-11-06","6","4249","1","342","20.5","21.3"
"Towns","2020-11-07","2","4251","0","342","20.5","21.3"
"Towns","2020-11-08","4","4255","1","343","9.8","15.9"
"Towns","2020-11-09","8","4263","0","343","9.8","13.5"
"Towns","2020-11-10","7","4270","1","344","11.8","13.7"
"Towns","2020-11-11","8","4278","0","344","9.4","13.7"
"Towns","2020-11-12","12","4290","2","346","10.4","14.9"
"Towns","2020-11-13","82","4372","9","355","9.6","15"
"Towns","2020-11-14","1","4373","0","355","9.6","15"
"Towns","2020-11-15","4","4377","0","355","6","7.9"
"Towns","2020-11-16","8","4385","0","355","6","7.9"
"Towns","2020-11-17","9","4394","1","356","5.5","8.7"
"Towns","2020-11-18","11","4405","1","357","6.8","8.1"
"Towns","2020-11-19","19","4424","1","358","5.2","7.8"
"Towns","2020-11-20","85","4509","13","371","5.8","7.7"
"Towns","2020-11-21","5","4514","0","371","5.8","7.7"
"Towns","2020-11-22","1","4515","0","371","5.8","5.9"
"Towns","2020-11-23","14","4529","3","374","8.9","7.4"
"Towns","2020-11-24","8","4537","0","374","7.3","6.4"
"Towns","2020-11-25","18","4555","7","381","11.6","9.2"
"Towns","2020-11-26","1","4556","0","381","10.8","8"
"Towns","2020-11-27","11","4567","3","384","12.5","9.2"
"Towns","2020-11-28","24","4591","5","389","15.5","10.7"
"Towns","2020-11-29","9","4600","3","392","20.3","13"
"Towns","2020-11-30","15","4615","6","398","22.9","15.9"
"Towns","2020-12-01","23","4638","3","401","24.8","16"
"Towns","2020-12-02","18","4656","5","406","23.2","17.4"
"Towns","2020-12-03","28","4684","5","411","25.7","18.3"
"Towns","2020-12-04","28","4712","5","416","24.4","18.4"
"Towns","2020-12-05","21","4733","4","420","24.1","19.8"
"Towns","2020-12-06","1","4734","0","420","19.4","19.8"
"Towns","2020-12-07","29","4763","2","422","14.6","18.8"
"Towns","2020-12-08","18","4781","5","427","16.7","20.8"
"Towns","2020-12-09","23","4804","0","427","12.8","18"
"Towns","2020-12-10","31","4835","6","433","13","19.4"
"Towns","2020-12-11","24","4859","2","435","11.6","18"
"Towns","2020-12-12","22","4881","3","438","10.9","17.5"
"Towns","2020-12-13","7","4888","2","440","14.9","17.2"
"Towns","2020-12-14","30","4918","1","441","14.4","14.5"
"Towns","2020-12-15","34","4952","2","443","11.3","14"
"Towns","2020-12-16","59","5011","11","454","14","13.4"
"Towns","2020-12-17","34","5045","5","459","13.3","13.1"
"Towns","2020-12-18","24","5069","3","462","13.9","12.8"
"Towns","2020-12-19","14","5083","4","466","16","13.4"
"Towns","2020-12-20","10","5093","2","468","14.8","14.9"
"Towns","2020-12-21","27","5120","4","472","16.4","15.4"
"Towns","2020-12-22","27","5147","5","477","18.3","14.8"
"Towns","2020-12-23","35","5182","6","483","18","16"
"Towns","2020-12-24","26","5208","5","488","18.7","16"
"Towns","2020-12-25","2","5210","0","488","16.9","15.4"
"Towns","2020-12-26","6","5216","3","491","20","18"
"Towns","2020-12-27","15","5231","8","499","24.7","19.8"
"Towns","2020-12-28","19","5250","5","504","26.4","21.4"
"Towns","2020-12-29","43","5293","11","515","27.4","22.8"
"Towns","2020-12-30","51","5344","15","530","29.1","23.6"
"Towns","2020-12-31","47","5391","10","540","29.4","24"
"Towns","2021-01-01","18","5409","8","548","35.8","26.3"
"Towns","2021-01-02","19","5428","4","552","31.6","25.8"
"Towns","2021-01-03","5","5433","1","553","26.9","25.8"
"Towns","2021-01-04","33","5466","8","561","26.6","26.5"
"Towns","2021-01-05","54","5520","9","570","25.3","26.3"
"Towns","2021-01-06","42","5562","12","582","25.2","27.2"
"Towns","2021-01-07","46","5608","7","589","24.3","26.9"
"Towns","2021-01-08","50","5658","15","604","22.3","29"
"Towns","2021-01-09","13","5671","3","607","22.5","27.1"
"Towns","2021-01-10","16","5687","3","610","22.4","24.6"
"Towns","2021-01-11","13","5700","2","612","21.1","23.8"
"Towns","2021-01-12","20","5720","1","613","19.4","22.4"
"Towns","2021-01-13","21","5741","4","617","18.1","21.6"
"Towns","2021-01-14","12","5753","1","618","17.1","20.7"
"Towns","2021-01-15","27","5780","10","628","18.1","20.2"
"Towns","2021-01-16","22","5802","7","635","19.3","20.9"
"Towns","2021-01-17","4","5806","0","635","16.7","19.5"
"Towns","2021-01-18","5","5811","1","636","17.3","19.2"
"Towns","2021-01-19","10","5821","2","638","19.5","19.4"
"Towns","2021-01-20","17","5838","1","639","17.6","17.8"
"Towns","2021-01-21","23","5861","1","640","17","17"
"Towns","2021-01-22","19","5880","6","646","16.2","17.2"
"Towns","2021-01-23","8","5888","0","646","11.7","15.5"
"Towns","2021-01-24","25","5913","3","649","13.4","15"
"Towns","2021-01-25","15","5928","3","652","13.4","15.4"
"Towns","2021-01-26","19","5947","1","653","11.3","15.4"
"Towns","2021-01-27","24","5971","7","660","14.6","16.1"
"Towns","2021-01-28","20","5991","5","665","17.6","17.3"
"Towns","2021-01-29","19","6010","5","670","16.8","16.5"
"Towns","2021-01-30","6","6016","0","670","16.8","14.3"
"Towns","2021-01-31","8","6024","2","672","18.7","16"
"Towns","2021-02-01","4","6028","3","675","26.5","20"
"Towns","2021-02-02","8","6036","0","675","25.8","18.5"
"Towns","2021-02-03","28","6064","8","683","25.7","20.2"
"Towns","2021-02-04","6","6070","2","685","26.9","22.2"
"Towns","2021-02-05","4","6074","0","685","23.1","20"
"Towns","2021-02-06","1","6075","0","685","23.1","20"
"Towns","2021-02-07","0","6075","0","685","19.6","19.1"
"Towns","2021-02-08","0","6075","0","685","8.8","17.7"
"Treutlen","2020-02-01","0","0","0","0",".","."
"Treutlen","2020-02-02","0","0","0","0",".","."
"Treutlen","2020-02-03","0","0","0","0",".","."
"Treutlen","2020-02-04","0","0","0","0",".","."
"Treutlen","2020-02-05","0","0","0","0",".","."
"Treutlen","2020-02-06","0","0","0","0",".","."
"Treutlen","2020-02-07","0","0","0","0","0","."
"Treutlen","2020-02-08","0","0","0","0","0","."
"Treutlen","2020-02-09","0","0","0","0","0","."
"Treutlen","2020-02-10","0","0","0","0","0","."
"Treutlen","2020-02-11","0","0","0","0","0","."
"Treutlen","2020-02-12","0","0","0","0","0","."
"Treutlen","2020-02-13","0","0","0","0","0","."
"Treutlen","2020-02-14","0","0","0","0","0","0"
"Treutlen","2020-02-15","0","0","0","0","0","0"
"Treutlen","2020-02-16","0","0","0","0","0","0"
"Treutlen","2020-02-17","0","0","0","0","0","0"
"Treutlen","2020-02-18","0","0","0","0","0","0"
"Treutlen","2020-02-19","0","0","0","0","0","0"
"Treutlen","2020-02-20","0","0","0","0","0","0"
"Treutlen","2020-02-21","0","0","0","0","0","0"
"Treutlen","2020-02-22","0","0","0","0","0","0"
"Treutlen","2020-02-23","0","0","0","0","0","0"
"Treutlen","2020-02-24","0","0","0","0","0","0"
"Treutlen","2020-02-25","0","0","0","0","0","0"
"Treutlen","2020-02-26","0","0","0","0","0","0"
"Treutlen","2020-02-27","0","0","0","0","0","0"
"Treutlen","2020-02-28","0","0","0","0","0","0"
"Treutlen","2020-02-29","0","0","0","0","0","0"
"Treutlen","2020-03-01","0","0","0","0","0","0"
"Treutlen","2020-03-02","0","0","0","0","0","0"
"Treutlen","2020-03-03","0","0","0","0","0","0"
"Treutlen","2020-03-04","0","0","0","0","0","0"
"Treutlen","2020-03-05","0","0","0","0","0","0"
"Treutlen","2020-03-06","0","0","0","0","0","0"
"Treutlen","2020-03-07","0","0","0","0","0","0"
"Treutlen","2020-03-08","0","0","0","0","0","0"
"Treutlen","2020-03-09","0","0","0","0","0","0"
"Treutlen","2020-03-10","0","0","0","0","0","0"
"Treutlen","2020-03-11","1","1","0","0","0","0"
"Treutlen","2020-03-12","1","2","0","0","0","0"
"Treutlen","2020-03-13","0","2","0","0","0","0"
"Treutlen","2020-03-14","0","2","0","0","0","0"
"Treutlen","2020-03-15","0","2","0","0","0","0"
"Treutlen","2020-03-16","0","2","0","0","0","0"
"Treutlen","2020-03-17","0","2","0","0","0","0"
"Treutlen","2020-03-18","0","2","0","0","0","0"
"Treutlen","2020-03-19","1","3","0","0","0","0"
"Treutlen","2020-03-20","0","3","0","0","0","0"
"Treutlen","2020-03-21","3","6","0","0","0","0"
"Treutlen","2020-03-22","3","9","0","0","0","0"
"Treutlen","2020-03-23","2","11","0","0","0","0"
"Treutlen","2020-03-24","1","12","0","0","0","0"
"Treutlen","2020-03-25","2","14","0","0","0","0"
"Treutlen","2020-03-26","1","15","0","0","0","0"
"Treutlen","2020-03-27","0","15","0","0","0","0"
"Treutlen","2020-03-28","0","15","0","0","0","0"
"Treutlen","2020-03-29","0","15","0","0","0","0"
"Treutlen","2020-03-30","1","16","0","0","0","0"
"Treutlen","2020-03-31","0","16","0","0","0","0"
"Treutlen","2020-04-01","2","18","0","0","0","0"
"Treutlen","2020-04-02","0","18","0","0","0","0"
"Treutlen","2020-04-03","4","22","0","0","0","0"
"Treutlen","2020-04-04","2","24","0","0","0","0"
"Treutlen","2020-04-05","0","24","0","0","0","0"
"Treutlen","2020-04-06","2","26","0","0","0","0"
"Treutlen","2020-04-07","0","26","0","0","0","0"
"Treutlen","2020-04-08","1","27","0","0","0","0"
"Treutlen","2020-04-09","0","27","0","0","0","0"
"Treutlen","2020-04-10","0","27","0","0","0","0"
"Treutlen","2020-04-11","0","27","0","0","0","0"
"Treutlen","2020-04-12","1","28","0","0","0","0"
"Treutlen","2020-04-13","2","30","0","0","0","0"
"Treutlen","2020-04-14","1","31","0","0","0","0"
"Treutlen","2020-04-15","2","33","0","0","0","0"
"Treutlen","2020-04-16","3","36","2","2","9.5","4.8"
"Treutlen","2020-04-17","0","36","0","2","9.5","4.8"
"Treutlen","2020-04-18","0","36","0","2","9.5","4.8"
"Treutlen","2020-04-19","0","36","0","2","9.5","4.8"
"Treutlen","2020-04-20","3","39","0","2","9.5","4.8"
"Treutlen","2020-04-21","7","46","0","2","9.5","4.8"
"Treutlen","2020-04-22","0","46","0","2","9.5","4.8"
"Treutlen","2020-04-23","2","48","0","2","0","4.8"
"Treutlen","2020-04-24","2","50","1","3","7.1","8.3"
"Treutlen","2020-04-25","2","52","0","3","7.1","8.3"
"Treutlen","2020-04-26","0","52","0","3","7.1","8.3"
"Treutlen","2020-04-27","0","52","0","3","7.1","8.3"
"Treutlen","2020-04-28","4","56","0","3","7.1","8.3"
"Treutlen","2020-04-29","4","60","0","3","7.1","8.3"
"Treutlen","2020-04-30","3","63","0","3","7.1","3.6"
"Treutlen","2020-05-01","2","65","0","3","0","3.6"
"Treutlen","2020-05-02","0","65","0","3","0","3.6"
"Treutlen","2020-05-03","4","69","1","4","3.6","5.4"
"Treutlen","2020-05-04","1","70","0","4","3.6","5.4"
"Treutlen","2020-05-05","1","71","0","4","3.6","5.4"
"Treutlen","2020-05-06","0","71","0","4","3.6","5.4"
"Treutlen","2020-05-07","0","71","0","4","3.6","5.4"
"Treutlen","2020-05-08","0","71","0","4","3.6","1.8"
"Treutlen","2020-05-09","0","71","0","4","3.6","1.8"
"Treutlen","2020-05-10","1","72","0","4","0","1.8"
"Treutlen","2020-05-11","0","72","0","4","0","1.8"
"Treutlen","2020-05-12","1","73","0","4","0","1.8"
"Treutlen","2020-05-13","2","75","0","4","0","1.8"
"Treutlen","2020-05-14","1","76","0","4","0","1.8"
"Treutlen","2020-05-15","0","76","0","4","0","1.8"
"Treutlen","2020-05-16","1","77","0","4","0","1.8"
"Treutlen","2020-05-17","0","77","0","4","0","0"
"Treutlen","2020-05-18","2","79","0","4","0","0"
"Treutlen","2020-05-19","3","82","0","4","0","0"
"Treutlen","2020-05-20","2","84","0","4","0","0"
"Treutlen","2020-05-21","7","91","0","4","0","0"
"Treutlen","2020-05-22","1","92","0","4","0","0"
"Treutlen","2020-05-23","0","92","0","4","0","0"
"Treutlen","2020-05-24","0","92","0","4","0","0"
"Treutlen","2020-05-25","1","93","0","4","0","0"
"Treutlen","2020-05-26","1","94","0","4","0","0"
"Treutlen","2020-05-27","65","159","1","5","0.2","0.1"
"Treutlen","2020-05-28","5","164","0","5","0.2","0.1"
"Treutlen","2020-05-29","8","172","2","7","3.8","1.9"
"Treutlen","2020-05-30","5","177","2","9","9.5","4.8"
"Treutlen","2020-05-31","2","179","0","9","9.5","4.8"
"Treutlen","2020-06-01","4","183","0","9","9.5","4.8"
"Treutlen","2020-06-02","5","188","0","9","9.5","4.8"
"Treutlen","2020-06-03","6","194","0","9","9.3","4.8"
"Treutlen","2020-06-04","2","196","0","9","9.3","4.8"
"Treutlen","2020-06-05","4","200","0","9","5.7","4.8"
"Treutlen","2020-06-06","2","202","0","9","0","4.8"
"Treutlen","2020-06-07","1","203","0","9","0","4.8"
"Treutlen","2020-06-08","4","207","0","9","0","4.8"
"Treutlen","2020-06-09","4","211","0","9","0","4.8"
"Treutlen","2020-06-10","12","223","0","9","0","4.6"
"Treutlen","2020-06-11","8","231","0","9","0","4.6"
"Treutlen","2020-06-12","4","235","0","9","0","2.9"
"Treutlen","2020-06-13","6","241","0","9","0","0"
"Treutlen","2020-06-14","0","241","0","9","0","0"
"Treutlen","2020-06-15","2","243","0","9","0","0"
"Treutlen","2020-06-16","2","245","0","9","0","0"
"Treutlen","2020-06-17","3","248","0","9","0","0"
"Treutlen","2020-06-18","2","250","0","9","0","0"
"Treutlen","2020-06-19","3","253","0","9","0","0"
"Treutlen","2020-06-20","0","253","0","9","0","0"
"Treutlen","2020-06-21","1","254","1","10","14.3","7.1"
"Treutlen","2020-06-22","3","257","1","11","19","9.5"
"Treutlen","2020-06-23","1","258","0","11","19","9.5"
"Treutlen","2020-06-24","3","261","1","12","23.8","11.9"
"Treutlen","2020-06-25","1","262","0","12","23.8","11.9"
"Treutlen","2020-06-26","2","264","0","12","23.8","11.9"
"Treutlen","2020-06-27","1","265","0","12","23.8","11.9"
"Treutlen","2020-06-28","2","267","0","12","9.5","11.9"
"Treutlen","2020-06-29","8","275","0","12","4.8","11.9"
"Treutlen","2020-06-30","6","281","1","13","7.1","13.1"
"Treutlen","2020-07-01","3","284","0","13","2.4","13.1"
"Treutlen","2020-07-02","8","292","1","14","4.2","14"
"Treutlen","2020-07-03","3","295","1","15","8.9","16.4"
"Treutlen","2020-07-04","2","297","1","16","16.1","19.9"
"Treutlen","2020-07-05","4","301","0","16","16.1","12.8"
"Treutlen","2020-07-06","11","312","2","18","18.7","11.7"
"Treutlen","2020-07-07","15","327","3","21","19.1","13.1"
"Treutlen","2020-07-08","3","330","0","21","19.1","10.8"
"Treutlen","2020-07-09","6","336","2","23","22.1","13.1"
"Treutlen","2020-07-10","3","339","0","23","17.4","13.1"
"Treutlen","2020-07-11","3","342","1","24","15","15.5"
"Treutlen","2020-07-12","3","345","0","24","15","15.5"
"Treutlen","2020-07-13","5","350","0","24","12.4","15.5"
"Treutlen","2020-07-14","9","359","2","26","12.7","15.9"
"Treutlen","2020-07-15","12","371","1","27","13.9","16.5"
"Treutlen","2020-07-16","6","377","3","30","16.3","19.2"
"Treutlen","2020-07-17","8","385","1","31","18.1","17.7"
"Treutlen","2020-07-18","2","387","0","31","13.3","14.1"
"Treutlen","2020-07-19","3","390","0","31","13.3","14.1"
"Treutlen","2020-07-20","3","393","0","31","13.3","12.8"
"Treutlen","2020-07-21","4","397","0","31","10.1","11.4"
"Treutlen","2020-07-22","8","405","0","31","8.9","11.4"
"Treutlen","2020-07-23","10","415","1","32","3.2","9.7"
"Treutlen","2020-07-24","3","418","0","32","1.4","9.7"
"Treutlen","2020-07-25","3","421","1","33","6.2","9.7"
"Treutlen","2020-07-26","0","421","0","33","6.2","9.7"
"Treutlen","2020-07-27","7","428","2","35","10.3","11.8"
"Treutlen","2020-07-28","4","432","1","36","13.8","12"
"Treutlen","2020-07-29","14","446","6","42","20","14.4"
"Treutlen","2020-07-30","6","452","1","43","20.9","12.1"
"Treutlen","2020-07-31","8","460","3","46","26.3","13.9"
"Treutlen","2020-08-01","2","462","0","46","21.5","13.9"
"Treutlen","2020-08-02","6","468","1","47","23.9","15"
"Treutlen","2020-08-03","11","479","6","53","27.6","18.9"
"Treutlen","2020-08-04","3","482","2","55","33.6","23.7"
"Treutlen","2020-08-05","5","487","2","57","33.1","26.6"
"Treutlen","2020-08-06","4","491","1","58","34.3","27.6"
"Treutlen","2020-08-07","4","495","1","59","32.6","29.4"
"Treutlen","2020-08-08","6","501","2","61","37.3","29.4"
"Treutlen","2020-08-09","2","503","0","61","34.9","29.4"
"Treutlen","2020-08-10","4","507","0","61","27.1","27.4"
"Treutlen","2020-08-11","13","520","7","68","25.3","29.4"
"Treutlen","2020-08-12","4","524","1","69","23.2","28.2"
"Treutlen","2020-08-13","2","526","0","69","19.6","27"
"Treutlen","2020-08-14","4","530","0","69","16","24.3"
"Treutlen","2020-08-15","7","537","0","69","11.3","24.3"
"Treutlen","2020-08-16","2","539","2","71","25.5","30.2"
"Treutlen","2020-08-17","9","548","0","71","25.5","26.3"
"Treutlen","2020-08-18","8","556","6","77","28.6","26.9"
"Treutlen","2020-08-19","10","566","1","78","26.4","24.8"
"Treutlen","2020-08-20","5","571","1","79","29.3","24.4"
"Treutlen","2020-08-21","7","578","1","80","31.3","23.7"
"Treutlen","2020-08-22","5","583","2","82","37","24.2"
"Treutlen","2020-08-23","5","588","2","84","28.5","27"
"Treutlen","2020-08-24","7","595","1","85","30.5","28"
"Treutlen","2020-08-25","8","603","1","86","21.6","25.1"
"Treutlen","2020-08-26","15","618","5","91","24.9","25.7"
"Treutlen","2020-08-27","12","630","3","94","25.6","27.5"
"Treutlen","2020-08-28","6","636","3","97","30.7","31"
"Treutlen","2020-08-29","27","663","3","100","26.6","31.8"
"Treutlen","2020-08-30","3","666","1","101","25.7","27.1"
"Treutlen","2020-08-31","6","672","0","101","23.6","27.1"
"Treutlen","2020-09-01","7","679","3","104","27.9","24.8"
"Treutlen","2020-09-02","7","686","0","104","23.2","24.1"
"Treutlen","2020-09-03","5","691","3","107","28.2","26.9"
"Treutlen","2020-09-04","4","695","0","107","21","25.9"
"Treutlen","2020-09-05","15","710","0","107","19.5","23"
"Treutlen","2020-09-06","16","726","0","107","14.7","20.2"
"Treutlen","2020-09-07","2","728","2","109","29","26.3"
"Treutlen","2020-09-08","32","760","3","112","24.2","26.1"
"Treutlen","2020-09-09","3","763","0","112","24.2","23.7"
"Treutlen","2020-09-10","11","774","1","113","16.9","22.6"
"Treutlen","2020-09-11","3","777","0","113","16.9","19"
"Treutlen","2020-09-12","4","781","1","114","20.5","20"
"Treutlen","2020-09-13","1","782","0","114","20.5","17.6"
"Treutlen","2020-09-14","29","811","5","119","8.7","18.8"
"Treutlen","2020-09-15","6","817","0","119","7.3","15.8"
"Treutlen","2020-09-16","3","820","0","119","7.3","15.8"
"Treutlen","2020-09-17","40","860","0","119","6","11.5"
"Treutlen","2020-09-18","3","863","0","119","6","11.5"
"Treutlen","2020-09-19","2","865","0","119","2.5","11.5"
"Treutlen","2020-09-20","2","867","1","120","9.6","15.1"
"Treutlen","2020-09-21","31","898","4","124","9","8.8"
"Treutlen","2020-09-22","3","901","0","124","9","8.2"
"Treutlen","2020-09-23","16","917","0","124","9","8.2"
"Treutlen","2020-09-24","4","921","0","124","9","7.5"
"Treutlen","2020-09-25","4","925","0","124","9","7.5"
"Treutlen","2020-09-26","1","926","0","124","9","5.7"
"Treutlen","2020-09-27","3","929","0","124","1.8","5.7"
"Treutlen","2020-09-28","33","962","6","130","2.6","5.8"
"Treutlen","2020-09-29","6","968","1","131","5","7"
"Treutlen","2020-09-30","10","978","1","132","6.4","7.7"
"Treutlen","2020-10-01","7","985","1","133","8.4","8.7"
"Treutlen","2020-10-02","5","990","0","133","8.4","8.7"
"Treutlen","2020-10-03","2","992","0","133","8.4","8.7"
"Treutlen","2020-10-04","3","995","1","134","13.2","7.5"
"Treutlen","2020-10-05","49","1044","5","139","12.1","7.3"
"Treutlen","2020-10-06","23","1067","1","140","10.3","7.6"
"Treutlen","2020-10-07","11","1078","0","140","8.9","7.6"
"Treutlen","2020-10-08","9","1087","2","142","10","9.2"
"Treutlen","2020-10-09","3","1090","2","144","19.5","14"
"Treutlen","2020-10-10","21","1111","0","144","19.5","14"
"Treutlen","2020-10-11","3","1114","0","144","14.8","14"
"Treutlen","2020-10-12","2","1116","0","144","13.3","12.7"
"Treutlen","2020-10-13","1","1117","0","144","12.7","11.5"
"Treutlen","2020-10-14","5","1122","2","146","18.4","13.6"
"Treutlen","2020-10-15","2","1124","1","147","22.4","16.2"
"Treutlen","2020-10-16","21","1145","2","149","14.2","16.9"
"Treutlen","2020-10-17","3","1148","1","150","19","19.3"
"Treutlen","2020-10-18","3","1151","1","151","23.7","19.3"
"Treutlen","2020-10-19","34","1185","7","158","26.7","20"
"Treutlen","2020-10-20","8","1193","0","158","26.7","19.7"
"Treutlen","2020-10-21","5","1198","1","159","23.8","21.1"
"Treutlen","2020-10-22","3","1201","0","159","16.7","19.5"
"Treutlen","2020-10-23","3","1204","1","160","20.1","17.2"
"Treutlen","2020-10-24","21","1225","0","160","15.3","17.2"
"Treutlen","2020-10-25","1","1226","0","160","10.6","17.2"
"Treutlen","2020-10-26","36","1262","3","163","8.8","17.7"
"Treutlen","2020-10-27","4","1266","1","164","12.4","19.5"
"Treutlen","2020-10-28","10","1276","3","167","13.8","18.8"
"Treutlen","2020-10-29","6","1282","0","167","13.8","15.2"
"Treutlen","2020-10-30","2","1284","0","167","9","14.6"
"Treutlen","2020-10-31","1","1285","1","168","23.3","19.3"
"Treutlen","2020-11-01","0","1285","0","168","23.3","16.9"
"Treutlen","2020-11-02","16","1301","5","173","26.6","17.7"
"Treutlen","2020-11-03","2","1303","0","173","23","17.7"
"Treutlen","2020-11-04","3","1306","2","175","28.3","21"
"Treutlen","2020-11-05","2","1308","0","175","28.3","21"
"Treutlen","2020-11-06","61","1369","0","175","28.3","18.7"
"Treutlen","2020-11-07","4","1373","0","175","14","18.7"
"Treutlen","2020-11-08","1","1374","0","175","14","18.7"
"Treutlen","2020-11-09","25","1399","1","176","10.1","18.4"
"Treutlen","2020-11-10","4","1403","0","176","10.1","16.6"
"Treutlen","2020-11-11","5","1408","0","176","0.6","14.4"
"Treutlen","2020-11-12","3","1411","1","177","5.3","16.8"
"Treutlen","2020-11-13","7","1418","3","180","11.5","19.9"
"Treutlen","2020-11-14","1","1419","0","180","11.5","12.7"
"Treutlen","2020-11-15","1","1420","0","180","11.5","12.7"
"Treutlen","2020-11-16","5","1425","1","181","13.7","11.9"
"Treutlen","2020-11-17","3","1428","1","182","18.5","14.3"
"Treutlen","2020-11-18","6","1434","0","182","18.5","9.5"
"Treutlen","2020-11-19","3","1437","1","183","18.5","11.9"
"Treutlen","2020-11-20","5","1442","1","184","15.2","13.3"
"Treutlen","2020-11-21","2","1444","0","184","15.2","13.3"
"Treutlen","2020-11-22","1","1445","0","184","15.2","13.3"
"Treutlen","2020-11-23","17","1462","1","185","13.2","13.5"
"Treutlen","2020-11-24","4","1466","0","185","8.5","13.5"
"Treutlen","2020-11-25","5","1471","0","185","8.5","13.5"
"Treutlen","2020-11-26","1","1472","0","185","3.7","11.1"
"Treutlen","2020-11-27","1","1473","1","186","15.1","15.2"
"Treutlen","2020-11-28","4","1477","1","187","18.7","17"
"Treutlen","2020-11-29","10","1487","1","188","20.1","17.7"
"Treutlen","2020-11-30","16","1503","1","189","20.2","16.7"
"Treutlen","2020-12-01","13","1516","1","190","21.3","14.9"
"Treutlen","2020-12-02","6","1522","0","190","21.3","14.9"
"Treutlen","2020-12-03","6","1528","0","190","21.3","12.5"
"Treutlen","2020-12-04","2","1530","1","191","14.1","14.6"
"Treutlen","2020-12-05","3","1533","0","191","10.6","14.6"
"Treutlen","2020-12-06","0","1533","0","191","9.1","14.6"
"Treutlen","2020-12-07","32","1565","2","193","9.1","14.7"
"Treutlen","2020-12-08","6","1571","1","194","10.4","15.8"
"Treutlen","2020-12-09","7","1578","1","195","12.5","16.9"
"Treutlen","2020-12-10","5","1583","1","196","15.3","18.3"
"Treutlen","2020-12-11","4","1587","2","198","15.3","14.7"
"Treutlen","2020-12-12","1","1588","0","198","15.3","12.9"
"Treutlen","2020-12-13","1","1589","0","198","15.3","12.2"
"Treutlen","2020-12-14","24","1613","9","207","19.8","14.5"
"Treutlen","2020-12-15","7","1620","3","210","23.5","17"
"Treutlen","2020-12-16","14","1634","2","212","23.5","18"
"Treutlen","2020-12-17","3","1637","0","212","20.7","18"
"Treutlen","2020-12-18","9","1646","1","213","15.1","15.2"
"Treutlen","2020-12-19","1","1647","0","213","15.1","15.2"
"Treutlen","2020-12-20","3","1650","1","214","19.9","17.6"
"Treutlen","2020-12-21","72","1722","13","227","17.1","18.4"
"Treutlen","2020-12-22","6","1728","1","228","13.4","18.4"
"Treutlen","2020-12-23","5","1733","2","230","17","20.3"
"Treutlen","2020-12-24","0","1733","0","230","17","18.8"
"Treutlen","2020-12-25","2","1735","0","230","15.4","15.3"
"Treutlen","2020-12-26","5","1740","1","231","18.3","16.7"
"Treutlen","2020-12-27","7","1747","1","232","15.6","17.7"
"Treutlen","2020-12-28","69","1816","19","251","16.9","17"
"Treutlen","2020-12-29","11","1827","3","254","18.4","15.9"
"Treutlen","2020-12-30","16","1843","3","257","15.4","16.2"
"Treutlen","2020-12-31","8","1851","4","261","22.5","19.8"
"Treutlen","2021-01-01","4","1855","2","263","29.7","22.6"
"Treutlen","2021-01-02","7","1862","6","269","39.1","28.7"
"Treutlen","2021-01-03","3","1865","2","271","46.6","31.1"
"Treutlen","2021-01-04","170","2035","48","319","46.7","31.8"
"Treutlen","2021-01-05","16","2051","7","326","49","33.7"
"Treutlen","2021-01-06","16","2067","3","329","49","32.2"
"Treutlen","2021-01-07","5","2072","2","331","47.6","35.1"
"Treutlen","2021-01-08","9","2081","4","335","46.8","38.2"
"Treutlen","2021-01-09","8","2089","4","339","41.7","40.4"
"Treutlen","2021-01-10","4","2093","2","341","39.3","42.9"
"Treutlen","2021-01-11","86","2179","22","363","38.9","42.8"
"Treutlen","2021-01-12","50","2229","17","380","37.5","43.3"
"Treutlen","2021-01-13","11","2240","4","384","40.1","44.5"
"Treutlen","2021-01-14","33","2273","13","397","40","43.8"
"Treutlen","2021-01-15","9","2282","1","398","35.2","41"
"Treutlen","2021-01-16","2","2284","0","398","28.1","34.9"
"Treutlen","2021-01-17","4","2288","1","399","24.5","31.9"
"Treutlen","2021-01-18","5","2293","1","400","23.7","31.3"
"Treutlen","2021-01-19","12","2305","1","401","20","28.8"
"Treutlen","2021-01-20","11","2316","1","402","16.1","28.1"
"Treutlen","2021-01-21","44","2360","13","415","14.7","27.3"
"Treutlen","2021-01-22","9","2369","3","418","17.9","26.6"
"Treutlen","2021-01-23","2","2371","1","419","25","26.6"
"Treutlen","2021-01-24","4","2375","2","421","28.6","26.6"
"Treutlen","2021-01-25","42","2417","11","432","29.5","26.6"
"Treutlen","2021-01-26","8","2425","1","433","30.1","25.1"
"Treutlen","2021-01-27","12","2437","2","435","31.2","23.7"
"Treutlen","2021-01-28","50","2487","11","446","30.1","22.4"
"Treutlen","2021-01-29","6","2493","0","446","25.3","21.6"
"Treutlen","2021-01-30","1","2494","0","446","18.2","21.6"
"Treutlen","2021-01-31","2","2496","0","446","11.1","19.8"
"Treutlen","2021-02-01","14","2510","1","447","8.3","18.9"
"Treutlen","2021-02-02","9","2519","2","449","9.7","19.9"
"Treutlen","2021-02-03","4","2523","3","452","18.1","24.6"
"Treutlen","2021-02-04","5","2528","2","454","20.6","25.4"
"Treutlen","2021-02-05","3","2531","0","454","20.6","23"
"Treutlen","2021-02-06","3","2534","2","456","30.1","24.2"
"Treutlen","2021-02-07","1","2535","0","456","30.1","20.6"
"Treutlen","2021-02-08","0","2535","0","456","29.1","18.7"
"Troup","2020-02-01","0","0","0","0",".","."
"Troup","2020-02-02","0","0","0","0",".","."
"Troup","2020-02-03","0","0","0","0",".","."
"Troup","2020-02-04","0","0","0","0",".","."
"Troup","2020-02-05","0","0","0","0",".","."
"Troup","2020-02-06","0","0","0","0",".","."
"Troup","2020-02-07","0","0","0","0","0","."
"Troup","2020-02-08","0","0","0","0","0","."
"Troup","2020-02-09","0","0","0","0","0","."
"Troup","2020-02-10","0","0","0","0","0","."
"Troup","2020-02-11","0","0","0","0","0","."
"Troup","2020-02-12","0","0","0","0","0","."
"Troup","2020-02-13","0","0","0","0","0","."
"Troup","2020-02-14","0","0","0","0","0","0"
"Troup","2020-02-15","0","0","0","0","0","0"
"Troup","2020-02-16","0","0","0","0","0","0"
"Troup","2020-02-17","0","0","0","0","0","0"
"Troup","2020-02-18","0","0","0","0","0","0"
"Troup","2020-02-19","0","0","0","0","0","0"
"Troup","2020-02-20","0","0","0","0","0","0"
"Troup","2020-02-21","0","0","0","0","0","0"
"Troup","2020-02-22","0","0","0","0","0","0"
"Troup","2020-02-23","0","0","0","0","0","0"
"Troup","2020-02-24","0","0","0","0","0","0"
"Troup","2020-02-25","0","0","0","0","0","0"
"Troup","2020-02-26","0","0","0","0","0","0"
"Troup","2020-02-27","0","0","0","0","0","0"
"Troup","2020-02-28","0","0","0","0","0","0"
"Troup","2020-02-29","0","0","0","0","0","0"
"Troup","2020-03-01","0","0","0","0","0","0"
"Troup","2020-03-02","0","0","0","0","0","0"
"Troup","2020-03-03","0","0","0","0","0","0"
"Troup","2020-03-04","0","0","0","0","0","0"
"Troup","2020-03-05","0","0","0","0","0","0"
"Troup","2020-03-06","0","0","0","0","0","0"
"Troup","2020-03-07","0","0","0","0","0","0"
"Troup","2020-03-08","0","0","0","0","0","0"
"Troup","2020-03-09","0","0","0","0","0","0"
"Troup","2020-03-10","2","2","0","0","0","0"
"Troup","2020-03-11","0","2","0","0","0","0"
"Troup","2020-03-12","0","2","0","0","0","0"
"Troup","2020-03-13","3","5","1","1","4.8","2.4"
"Troup","2020-03-14","2","7","2","3","19","9.5"
"Troup","2020-03-15","3","10","1","4","23.8","11.9"
"Troup","2020-03-16","8","18","0","4","23.8","11.9"
"Troup","2020-03-17","11","29","1","5","25.1","12.6"
"Troup","2020-03-18","16","45","2","7","26.9","13.4"
"Troup","2020-03-19","10","55","3","10","31.2","15.6"
"Troup","2020-03-20","24","79","1","11","27","15.9"
"Troup","2020-03-21","2","81","0","11","12.7","15.9"
"Troup","2020-03-22","4","85","3","14","18.7","21.2"
"Troup","2020-03-23","34","119","3","17","19.9","21.9"
"Troup","2020-03-24","47","166","5","22","20.2","22.6"
"Troup","2020-03-25","40","206","9","31","21.6","24.2"
"Troup","2020-03-26","42","248","6","37","19.3","25.3"
"Troup","2020-03-27","35","283","8","45","22","24.5"
"Troup","2020-03-28","12","295","3","48","25.6","19.2"
"Troup","2020-03-29","10","305","2","50","17.7","18.2"
"Troup","2020-03-30","44","349","11","61","20","20"
"Troup","2020-03-31","38","387","9","70","21.9","21"
"Troup","2020-04-01","64","451","11","81","21.1","21.4"
"Troup","2020-04-02","25","476","0","81","19.1","19.2"
"Troup","2020-04-03","37","513","5","86","17.8","19.9"
"Troup","2020-04-04","18","531","3","89","16.6","21.1"
"Troup","2020-04-05","5","536","1","90","16.6","17.2"
"Troup","2020-04-06","33","569","4","94","14.7","17.4"
"Troup","2020-04-07","141","710","8","102","12.2","17"
"Troup","2020-04-08","26","736","3","105","11.4","16.3"
"Troup","2020-04-09","33","769","8","113","14.8","17"
"Troup","2020-04-10","394","1163","145","258","18.1","18"
"Troup","2020-04-11","7","1170","0","258","15.8","16.2"
"Troup","2020-04-12","1","1171","0","258","12.9","14.7"
"Troup","2020-04-13","37","1208","14","272","16.6","15.7"
"Troup","2020-04-14","51","1259","31","303","24.5","18.3"
"Troup","2020-04-15","14","1273","1","304","23.8","17.6"
"Troup","2020-04-16","12","1285","0","304","20.4","17.6"
"Troup","2020-04-17","21","1306","7","311","19.9","19"
"Troup","2020-04-18","10","1316","0","311","19.9","17.8"
"Troup","2020-04-19","6","1322","2","313","24.6","18.8"
"Troup","2020-04-20","19","1341","1","314","20","18.3"
"Troup","2020-04-21","30","1371","2","316","12.2","18.4"
"Troup","2020-04-22","28","1399","2","318","12.2","18"
"Troup","2020-04-23","18","1417","1","319","13","16.7"
"Troup","2020-04-24","30","1447","1","320","8.8","14.3"
"Troup","2020-04-25","12","1459","1","321","9.9","14.9"
"Troup","2020-04-26","8","1467","0","321","5.2","14.9"
"Troup","2020-04-27","22","1489","0","321","4.4","12.2"
"Troup","2020-04-28","28","1517","1","322","4","8.1"
"Troup","2020-04-29","30","1547","0","322","3","7.6"
"Troup","2020-04-30","33","1580","2","324","3","8"
"Troup","2020-05-01","24","1604","3","327","4.4","6.6"
"Troup","2020-05-02","10","1614","0","327","3.2","6.6"
"Troup","2020-05-03","6","1620","2","329","7.9","6.6"
"Troup","2020-05-04","21","1641","0","329","7.9","6.2"
"Troup","2020-05-05","32","1673","1","330","7.9","5.9"
"Troup","2020-05-06","83","1756","1","331","8","5.5"
"Troup","2020-05-07","19","1775","1","332","7.9","5.5"
"Troup","2020-05-08","16","1791","1","333","7","5.7"
"Troup","2020-05-09","9","1800","0","333","7","5.1"
"Troup","2020-05-10","5","1805","2","335","8","8"
"Troup","2020-05-11","228","2033","1","336","8","8"
"Troup","2020-05-12","24","2057","2","338","8.8","8.3"
"Troup","2020-05-13","36","2093","2","340","9.4","8.7"
"Troup","2020-05-14","42","2135","7","347","11","9.5"
"Troup","2020-05-15","64","2199","5","352","11.3","9.1"
"Troup","2020-05-16","35","2234","2","354","12.1","9.5"
"Troup","2020-05-17","34","2268","3","357","7.6","7.8"
"Troup","2020-05-18","58","2326","5","362","8.8","8.4"
"Troup","2020-05-19","61","2387","7","369","9.2","9"
"Troup","2020-05-20","67","2454","10","379","10.6","10"
"Troup","2020-05-21","45","2499","4","383","9.5","10.3"
"Troup","2020-05-22","21","2520","3","386","10.4","10.8"
"Troup","2020-05-23","74","2594","7","393","10.9","11.5"
"Troup","2020-05-24","7","2601","0","393","9.7","8.6"
"Troup","2020-05-25","16","2617","1","394","9.3","9.1"
"Troup","2020-05-26","176","2793","45","439","11.3","10.3"
"Troup","2020-05-27","52","2845","4","443","10.3","10.4"
"Troup","2020-05-28","46","2891","5","448","10.6","10"
"Troup","2020-05-29","38","2929","0","448","8.5","9.5"
"Troup","2020-05-30","19","2948","3","451","9.5","10.2"
"Troup","2020-05-31","58","3006","6","457","10.9","10.3"
"Troup","2020-06-01","51","3057","7","464","12","10.7"
"Troup","2020-06-02","99","3156","18","482","10.9","11.1"
"Troup","2020-06-03","92","3248","16","498","12.3","11.3"
"Troup","2020-06-04","85","3333","21","519","14.3","12.4"
"Troup","2020-06-05","164","3497","48","567","18.5","13.5"
"Troup","2020-06-06","47","3544","12","579","19.9","14.7"
"Troup","2020-06-07","27","3571","7","586","22.1","16.5"
"Troup","2020-06-08","242","3813","40","626","22.5","17.3"
"Troup","2020-06-09","172","3985","21","647","21.7","16.3"
"Troup","2020-06-10","171","4156","26","673","21.3","16.8"
"Troup","2020-06-11","128","4284","23","696","20.4","17.3"
"Troup","2020-06-12","198","4482","22","718","17.8","18.1"
"Troup","2020-06-13","59","4541","18","736","18.5","19.2"
"Troup","2020-06-14","33","4574","12","748","20","21"
"Troup","2020-06-15","176","4750","38","786","20.7","21.6"
"Troup","2020-06-16","150","4900","33","819","22.1","21.9"
"Troup","2020-06-17","218","5118","40","859","22.6","21.9"
"Troup","2020-06-18","185","5303","37","896","22.8","21.6"
"Troup","2020-06-19","228","5531","35","931","23.5","20.6"
"Troup","2020-06-20","419","5950","73","1004","21.6","20"
"Troup","2020-06-21","38","5988","6","1010","18.6","19.3"
"Troup","2020-06-22","392","6380","53","1063","17.5","19.1"
"Troup","2020-06-23","263","6643","25","1088","15.7","18.9"
"Troup","2020-06-24","274","6917","27","1115","14.5","18.5"
"Troup","2020-06-25","170","7087","28","1143","14","18.4"
"Troup","2020-06-26","207","7294","34","1177","14.1","18.8"
"Troup","2020-06-27","74","7368","11","1188","13.8","17.7"
"Troup","2020-06-28","43","7411","10","1198","14.8","16.7"
"Troup","2020-06-29","209","7620","27","1225","14.8","16.1"
"Troup","2020-06-30","335","7955","37","1262","15","15.3"
"Troup","2020-07-01","305","8260","36","1298","15.3","14.9"
"Troup","2020-07-02","425","8685","41","1339","14.3","14.1"
"Troup","2020-07-03","183","8868","25","1364","13.9","14"
"Troup","2020-07-04","44","8912","5","1369","13.4","13.6"
"Troup","2020-07-05","61","8973","7","1376","11.7","13.3"
"Troup","2020-07-06","358","9331","60","1436","12.3","13.5"
"Troup","2020-07-07","412","9743","56","1492","12.6","13.8"
"Troup","2020-07-08","502","10245","54","1546","12.5","13.9"
"Troup","2020-07-09","455","10700","52","1598","12.7","13.5"
"Troup","2020-07-10","455","11155","40","1638","12","13"
"Troup","2020-07-11","59","11214","8","1646","12.3","12.9"
"Troup","2020-07-12","27","11241","4","1650","12.8","12.3"
"Troup","2020-07-13","391","11632","58","1708","12.5","12.4"
"Troup","2020-07-14","383","12015","52","1760","12.5","12.6"
"Troup","2020-07-15","375","12390","49","1809","12.9","12.7"
"Troup","2020-07-16","452","12842","56","1865","13","12.9"
"Troup","2020-07-17","400","13242","61","1926","13.9","13"
"Troup","2020-07-18","63","13305","13","1939","14.9","13.6"
"Troup","2020-07-19","34","13339","2","1941","13.7","13.2"
"Troup","2020-07-20","461","13800","52","1993","13.2","12.8"
"Troup","2020-07-21","271","14071","45","2038","13.6","13.1"
"Troup","2020-07-22","322","14393","50","2088","13.9","13.4"
"Troup","2020-07-23","298","14691","56","2144","14.9","13.9"
"Troup","2020-07-24","321","15012","57","2201","15.2","14.6"
"Troup","2020-07-25","47","15059","6","2207","14.1","14.5"
"Troup","2020-07-26","29","15088","0","2207","13.2","13.5"
"Troup","2020-07-27","842","15930","69","2276","12.8","13"
"Troup","2020-07-28","205","16135","33","2309","12.7","13.2"
"Troup","2020-07-29","323","16458","50","2359","12.7","13.3"
"Troup","2020-07-30","353","16811","68","2427","12.8","13.8"
"Troup","2020-07-31","492","17303","66","2493","12.2","13.7"
"Troup","2020-08-01","100","17403","5","2498","11.1","12.6"
"Troup","2020-08-02","23","17426","4","2502","13.5","13.4"
"Troup","2020-08-03","426","17852","31","2533","13.4","13.1"
"Troup","2020-08-04","311","18163","69","2602","14.3","13.5"
"Troup","2020-08-05","489","18652","72","2674","14.2","13.5"
"Troup","2020-08-06","470","19122","75","2749","13.7","13.3"
"Troup","2020-08-07","370","19492","51","2800","13.8","13"
"Troup","2020-08-08","155","19647","21","2821","15","13"
"Troup","2020-08-09","24","19671","2","2823","13.7","13.6"
"Troup","2020-08-10","494","20165","77","2900","14.9","14.1"
"Troup","2020-08-11","108","20273","18","2918","14.1","14.2"
"Troup","2020-08-12","101","20374","13","2931","13.8","14"
"Troup","2020-08-13","106","20480","16","2947","13.7","13.7"
"Troup","2020-08-14","95","20575","4","2951","12.3","13"
"Troup","2020-08-15","44","20619","7","2958","12.7","13.8"
"Troup","2020-08-16","36","20655","0","2958","11.5","12.6"
"Troup","2020-08-17","126","20781","13","2971","10.7","12.8"
"Troup","2020-08-18","131","20912","11","2982","9.5","11.8"
"Troup","2020-08-19","91","21003","10","2992","9.3","11.5"
"Troup","2020-08-20","92","21095","11","3003","8.8","11.3"
"Troup","2020-08-21","110","21205","9","3012","9.4","10.9"
"Troup","2020-08-22","58","21263","2","3014","7.6","10.1"
"Troup","2020-08-23","44","21307","1","3015","7.9","9.7"
"Troup","2020-08-24","192","21499","12","3027","7.4","9"
"Troup","2020-08-25","113","21612","7","3034","7","8.3"
"Troup","2020-08-26","172","21784","4","3038","5.8","7.5"
"Troup","2020-08-27","125","21909","8","3046","5","6.9"
"Troup","2020-08-28","181","22090","6","3052","4.3","6.9"
"Troup","2020-08-29","63","22153","10","3062","6.1","6.9"
"Troup","2020-08-30","34","22187","1","3063","6.2","7.1"
"Troup","2020-08-31","153","22340","15","3078","6.7","7"
"Troup","2020-09-01","108","22448","6","3084","6.6","6.8"
"Troup","2020-09-02","106","22554","5","3089","6.9","6.4"
"Troup","2020-09-03","92","22646","7","3096","7.1","6.1"
"Troup","2020-09-04","89","22735","10","3106","8.2","6.3"
"Troup","2020-09-05","47","22782","7","3113","8.1","7.1"
"Troup","2020-09-06","40","22822","1","3114","8","7.1"
"Troup","2020-09-07","63","22885","3","3117","7.3","7"
"Troup","2020-09-08","87","22972","9","3126","8","7.3"
"Troup","2020-09-09","161","23133","6","3132","7.9","7.4"
"Troup","2020-09-10","199","23332","11","3143","7.6","7.3"
"Troup","2020-09-11","89","23421","6","3149","6.9","7.6"
"Troup","2020-09-12","50","23471","3","3152","5.7","6.9"
"Troup","2020-09-13","26","23497","1","3153","5.8","6.9"
"Troup","2020-09-14","156","23653","14","3167","6.5","6.9"
"Troup","2020-09-15","120","23773","6","3173","5.7","6.8"
"Troup","2020-09-16","110","23883","9","3182","6.3","7.1"
"Troup","2020-09-17","65","23948","3","3185","6.2","6.9"
"Troup","2020-09-18","71","24019","4","3189","6","6.5"
"Troup","2020-09-19","60","24079","2","3191","5.7","5.7"
"Troup","2020-09-20","40","24119","1","3192","5.5","5.7"
"Troup","2020-09-21","130","24249","8","3200","5.1","5.8"
"Troup","2020-09-22","89","24338","9","3209","5.8","5.7"
"Troup","2020-09-23","66","24404","10","3219","6.8","6.6"
"Troup","2020-09-24","90","24494","3","3222","6.6","6.4"
"Troup","2020-09-25","68","24562","6","3228","7.1","6.5"
"Troup","2020-09-26","32","24594","4","3232","8.4","7"
"Troup","2020-09-27","28","24622","3","3235","9.5","7.5"
"Troup","2020-09-28","130","24752","5","3240","9.2","7.1"
"Troup","2020-09-29","83","24835","8","3248","9.1","7.5"
"Troup","2020-09-30","54","24889","1","3249","7.2","7"
"Troup","2020-10-01","69","24958","4","3253","7.6","7.1"
"Troup","2020-10-02","68","25026","9","3262","8.2","7.6"
"Troup","2020-10-03","40","25066","4","3266","7.9","8.1"
"Troup","2020-10-04","30","25096","1","3267","6.8","8.2"
"Troup","2020-10-05","116","25212","5","3272","6.9","8"
"Troup","2020-10-06","97","25309","8","3280","6.7","7.9"
"Troup","2020-10-07","74","25383","4","3284","7.2","7.2"
"Troup","2020-10-08","84","25467","4","3288","7","7.3"
"Troup","2020-10-09","87","25554","7","3295","6.3","7.3"
"Troup","2020-10-10","36","25590","4","3299","6.5","7.2"
"Troup","2020-10-11","45","25635","4","3303","7.3","7"
"Troup","2020-10-12","82","25717","10","3313","8.4","7.6"
"Troup","2020-10-13","73","25790","5","3318","8.2","7.4"
"Troup","2020-10-14","77","25867","6","3324","8.5","7.9"
"Troup","2020-10-15","69","25936","4","3328","8.7","7.9"
"Troup","2020-10-16","85","26021","7","3335","8.7","7.5"
"Troup","2020-10-17","62","26083","6","3341","8.5","7.5"
"Troup","2020-10-18","35","26118","2","3343","8","7.6"
"Troup","2020-10-19","121","26239","3","3346","6.6","7.5"
"Troup","2020-10-20","120","26359","14","3360","7.3","7.8"
"Troup","2020-10-21","116","26475","7","3367","7.1","7.8"
"Troup","2020-10-22","87","26562","7","3374","7.4","8"
"Troup","2020-10-23","123","26685","26","3400","9.3","9"
"Troup","2020-10-24","47","26732","4","3404","9.1","8.8"
"Troup","2020-10-25","42","26774","8","3412","11","9.5"
"Troup","2020-10-26","151","26925","15","3427","12.1","9.4"
"Troup","2020-10-27","91","27016","11","3438","12.1","9.7"
"Troup","2020-10-28","100","27116","4","3442","11.8","9.5"
"Troup","2020-10-29","91","27207","7","3449","11.8","9.6"
"Troup","2020-10-30","64","27271","2","3451","9.2","9.2"
"Troup","2020-10-31","45","27316","5","3456","9.6","9.3"
"Troup","2020-11-01","22","27338","3","3459","8.8","9.9"
"Troup","2020-11-02","135","27473","9","3468","8.3","10.2"
"Troup","2020-11-03","78","27551","3","3471","7.2","9.6"
"Troup","2020-11-04","80","27631","10","3481","8.4","10.1"
"Troup","2020-11-05","84","27715","6","3487","8.3","10"
"Troup","2020-11-06","99","27814","6","3493","8.7","9"
"Troup","2020-11-07","44","27858","0","3493","7.1","8.3"
"Troup","2020-11-08","33","27891","1","3494","5.6","7.2"
"Troup","2020-11-09","126","28017","10","3504","5.8","7.1"
"Troup","2020-11-10","84","28101","9","3513","6.8","7"
"Troup","2020-11-11","115","28216","15","3528","6.8","7.6"
"Troup","2020-11-12","284","28500","73","3601","9.5","8.9"
"Troup","2020-11-13","104","28604","16","3617","10.8","9.8"
"Troup","2020-11-14","66","28670","11","3628","13.2","10.2"
"Troup","2020-11-15","26","28696","2","3630","13.9","9.7"
"Troup","2020-11-16","113","28809","18","3648","15","10.4"
"Troup","2020-11-17","106","28915","9","3657","14.7","10.7"
"Troup","2020-11-18","77","28992","4","3661","13.6","10.2"
"Troup","2020-11-19","80","29072","1","3662","10.1","9.8"
"Troup","2020-11-20","147","29219","10","3672","8.9","9.8"
"Troup","2020-11-21","41","29260","3","3675","7.5","10.4"
"Troup","2020-11-22","31","29291","4","3679","8.3","11.1"
"Troup","2020-11-23","175","29466","13","3692","7.1","11"
"Troup","2020-11-24","70","29536","7","3699","7.3","11"
"Troup","2020-11-25","84","29620","10","3709","8.2","10.9"
"Troup","2020-11-26","16","29636","1","3710","8.9","9.5"
"Troup","2020-11-27","73","29709","9","3719","9.7","9.3"
"Troup","2020-11-28","29","29738","5","3724","11.2","9.3"
"Troup","2020-11-29","42","29780","5","3729","11","9.6"
"Troup","2020-11-30","184","29964","20","3749","11.5","9.3"
"Troup","2020-12-01","89","30053","9","3758","11.5","9.4"
"Troup","2020-12-02","98","30151","18","3776","12.4","10.3"
"Troup","2020-12-03","105","30256","19","3795","14.1","11.5"
"Troup","2020-12-04","110","30366","21","3816","15.1","12.4"
"Troup","2020-12-05","48","30414","10","3826","15.6","13.4"
"Troup","2020-12-06","24","30438","6","3832","17.5","14.2"
"Troup","2020-12-07","216","30654","27","3859","17.7","14.6"
"Troup","2020-12-08","140","30794","12","3871","17.5","14.5"
"Troup","2020-12-09","128","30922","19","3890","17","14.7"
"Troup","2020-12-10","137","31059","22","3912","16.7","15.4"
"Troup","2020-12-11","145","31204","26","3938","16.5","15.8"
"Troup","2020-12-12","108","31312","13","3951","15.3","15.4"
"Troup","2020-12-13","67","31379","11","3962","14.1","15.8"
"Troup","2020-12-14","301","31680","44","4006","14.4","16"
"Troup","2020-12-15","202","31882","35","4041","15.6","16.5"
"Troup","2020-12-16","172","32054","26","4067","15.6","16.3"
"Troup","2020-12-17","198","32252","47","4114","16.7","16.7"
"Troup","2020-12-18","138","32390","30","4144","17.3","16.9"
"Troup","2020-12-19","89","32479","18","4162","18.5","16.9"
"Troup","2020-12-20","53","32532","10","4172","18.8","16.4"
"Troup","2020-12-21","278","32810","47","4219","19.1","16.7"
"Troup","2020-12-22","120","32930","21","4240","19.2","17.4"
"Troup","2020-12-23","123","33053","25","4265","19.9","17.8"
"Troup","2020-12-24","72","33125","16","4281","19.7","18.2"
"Troup","2020-12-25","16","33141","4","4285","20.1","18.7"
"Troup","2020-12-26","74","33215","25","4310","22.1","20.3"
"Troup","2020-12-27","63","33278","10","4320","21.7","20.2"
"Troup","2020-12-28","264","33542","36","4356","21.2","20.2"
"Troup","2020-12-29","169","33711","43","4399","22.3","20.7"
"Troup","2020-12-30","165","33876","38","4437","22.7","21.3"
"Troup","2020-12-31","139","34015","33","4470","22.9","21.3"
"Troup","2021-01-01","40","34055","10","4480","22.9","21.5"
"Troup","2021-01-02","51","34106","13","4493","21.7","21.9"
"Troup","2021-01-03","47","34153","8","4501","21.9","21.8"
"Troup","2021-01-04","467","34620","120","4621","23.6","22.4"
"Troup","2021-01-05","180","34800","43","4664","23.4","22.9"
"Troup","2021-01-06","188","34988","43","4707","23.4","23"
"Troup","2021-01-07","181","35169","46","4753","23.6","23.3"
"Troup","2021-01-08","200","35369","53","4806","23.8","23.4"
"Troup","2021-01-09","124","35493","31","4837","23.8","22.8"
"Troup","2021-01-10","70","35563","15","4852","24.4","23.2"
"Troup","2021-01-11","288","35851","37","4889","22.6","23.1"
"Troup","2021-01-12","212","36063","48","4937","22.4","22.9"
"Troup","2021-01-13","192","36255","35","4972","21.7","22.6"
"Troup","2021-01-14","153","36408","25","4997","20.4","22"
"Troup","2021-01-15","205","36613","48","5045","20","21.9"
"Troup","2021-01-16","144","36757","46","5091","21","22.4"
"Troup","2021-01-17","82","36839","24","5115","22.1","23.2"
"Troup","2021-01-18","188","37027","46","5161","23.8","23.2"
"Troup","2021-01-19","236","37263","39","5200","22.9","22.6"
"Troup","2021-01-20","214","37477","35","5235","22.6","22.2"
"Troup","2021-01-21","212","37689","27","5262","22.1","21.3"
"Troup","2021-01-22","206","37895","29","5291","20.8","20.4"
"Troup","2021-01-23","110","38005","16","5307","18.3","19.6"
"Troup","2021-01-24","82","38087","18","5325","17.2","19.7"
"Troup","2021-01-25","282","38369","34","5359","15.5","19.6"
"Troup","2021-01-26","205","38574","23","5382","14.7","18.8"
"Troup","2021-01-27","234","38808","25","5407","13.9","18.3"
"Troup","2021-01-28","255","39063","22","5429","13.3","17.7"
"Troup","2021-01-29","189","39252","12","5441","12.2","16.5"
"Troup","2021-01-30","144","39396","15","5456","11.6","14.9"
"Troup","2021-01-31","69","39465","14","5470","11.4","14.3"
"Troup","2021-02-01","251","39716","26","5496","11.1","13.3"
"Troup","2021-02-02","220","39936","23","5519","11","12.9"
"Troup","2021-02-03","150","40086","14","5533","10.8","12.4"
"Troup","2021-02-04","146","40232","17","5550","11.3","12.3"
"Troup","2021-02-05","134","40366","17","5567","12.2","12.2"
"Troup","2021-02-06","49","40415","10","5577","13.6","12.6"
"Troup","2021-02-07","22","40437","2","5579","12","11.7"
"Troup","2021-02-08","0","40437","0","5579","10.5","10.8"
"Turner","2020-02-01","0","0","0","0",".","."
"Turner","2020-02-02","0","0","0","0",".","."
"Turner","2020-02-03","0","0","0","0",".","."
"Turner","2020-02-04","0","0","0","0",".","."
"Turner","2020-02-05","0","0","0","0",".","."
"Turner","2020-02-06","0","0","0","0",".","."
"Turner","2020-02-07","0","0","0","0","0","."
"Turner","2020-02-08","0","0","0","0","0","."
"Turner","2020-02-09","0","0","0","0","0","."
"Turner","2020-02-10","0","0","0","0","0","."
"Turner","2020-02-11","0","0","0","0","0","."
"Turner","2020-02-12","0","0","0","0","0","."
"Turner","2020-02-13","0","0","0","0","0","."
"Turner","2020-02-14","0","0","0","0","0","0"
"Turner","2020-02-15","0","0","0","0","0","0"
"Turner","2020-02-16","0","0","0","0","0","0"
"Turner","2020-02-17","0","0","0","0","0","0"
"Turner","2020-02-18","0","0","0","0","0","0"
"Turner","2020-02-19","0","0","0","0","0","0"
"Turner","2020-02-20","0","0","0","0","0","0"
"Turner","2020-02-21","0","0","0","0","0","0"
"Turner","2020-02-22","0","0","0","0","0","0"
"Turner","2020-02-23","0","0","0","0","0","0"
"Turner","2020-02-24","0","0","0","0","0","0"
"Turner","2020-02-25","0","0","0","0","0","0"
"Turner","2020-02-26","0","0","0","0","0","0"
"Turner","2020-02-27","0","0","0","0","0","0"
"Turner","2020-02-28","0","0","0","0","0","0"
"Turner","2020-02-29","0","0","0","0","0","0"
"Turner","2020-03-01","0","0","0","0","0","0"
"Turner","2020-03-02","0","0","0","0","0","0"
"Turner","2020-03-03","0","0","0","0","0","0"
"Turner","2020-03-04","0","0","0","0","0","0"
"Turner","2020-03-05","0","0","0","0","0","0"
"Turner","2020-03-06","0","0","0","0","0","0"
"Turner","2020-03-07","0","0","0","0","0","0"
"Turner","2020-03-08","0","0","0","0","0","0"
"Turner","2020-03-09","0","0","0","0","0","0"
"Turner","2020-03-10","0","0","0","0","0","0"
"Turner","2020-03-11","1","1","1","1","14.3","7.1"
"Turner","2020-03-12","1","2","0","1","14.3","7.1"
"Turner","2020-03-13","0","2","0","1","14.3","7.1"
"Turner","2020-03-14","0","2","0","1","14.3","7.1"
"Turner","2020-03-15","0","2","0","1","14.3","7.1"
"Turner","2020-03-16","1","3","0","1","14.3","7.1"
"Turner","2020-03-17","1","4","1","2","28.6","14.3"
"Turner","2020-03-18","0","4","0","2","14.3","14.3"
"Turner","2020-03-19","1","5","0","2","14.3","14.3"
"Turner","2020-03-20","0","5","0","2","14.3","14.3"
"Turner","2020-03-21","2","7","1","3","21.4","17.9"
"Turner","2020-03-22","1","8","0","3","21.4","17.9"
"Turner","2020-03-23","5","13","0","3","21.4","17.9"
"Turner","2020-03-24","1","14","0","3","7.1","17.9"
"Turner","2020-03-25","3","17","1","4","11.9","13.1"
"Turner","2020-03-26","1","18","0","4","11.9","13.1"
"Turner","2020-03-27","1","19","0","4","11.9","13.1"
"Turner","2020-03-28","1","20","0","4","4.8","13.1"
"Turner","2020-03-29","1","21","1","5","19","20.2"
"Turner","2020-03-30","4","25","0","5","19","20.2"
"Turner","2020-03-31","2","27","0","5","19","13.1"
"Turner","2020-04-01","3","30","3","8","28.6","20.2"
"Turner","2020-04-02","5","35","1","9","31.4","21.7"
"Turner","2020-04-03","2","37","0","9","31.4","21.7"
"Turner","2020-04-04","1","38","1","10","45.7","25.2"
"Turner","2020-04-05","1","39","0","10","31.4","25.2"
"Turner","2020-04-06","2","41","2","12","45.7","32.4"
"Turner","2020-04-07","1","42","0","12","45.7","32.4"
"Turner","2020-04-08","1","43","0","12","31.4","30"
"Turner","2020-04-09","2","45","1","13","35.7","33.6"
"Turner","2020-04-10","0","45","0","13","35.7","33.6"
"Turner","2020-04-11","0","45","0","13","21.4","33.6"
"Turner","2020-04-12","1","46","1","14","35.7","33.6"
"Turner","2020-04-13","1","47","1","15","35.7","40.7"
"Turner","2020-04-14","1","48","0","15","35.7","40.7"
"Turner","2020-04-15","2","50","0","15","35.7","33.6"
"Turner","2020-04-16","3","53","1","16","33.3","34.5"
"Turner","2020-04-17","4","57","0","16","33.3","34.5"
"Turner","2020-04-18","0","57","0","16","33.3","27.4"
"Turner","2020-04-19","0","57","0","16","19","27.4"
"Turner","2020-04-20","9","66","1","17","6.3","21"
"Turner","2020-04-21","15","81","6","23","12.1","23.9"
"Turner","2020-04-22","17","98","9","32","19.6","27.7"
"Turner","2020-04-23","6","104","1","33","17.2","25.3"
"Turner","2020-04-24","18","122","2","35","18.8","26.1"
"Turner","2020-04-25","6","128","1","36","21.2","27.3"
"Turner","2020-04-26","1","129","1","37","35.5","27.3"
"Turner","2020-04-27","14","143","1","38","34.9","20.6"
"Turner","2020-04-28","28","171","0","38","29.2","20.6"
"Turner","2020-04-29","19","190","0","38","21.7","20.6"
"Turner","2020-04-30","4","194","1","39","22.8","20"
"Turner","2020-05-01","13","207","4","43","25.7","22.2"
"Turner","2020-05-02","1","208","1","44","37.6","29.4"
"Turner","2020-05-03","1","209","1","45","37.6","36.5"
"Turner","2020-05-04","2","211","0","45","36.5","35.7"
"Turner","2020-05-05","3","214","1","46","41.3","35.3"
"Turner","2020-05-06","13","227","5","51","46.8","34.2"
"Turner","2020-05-07","12","239","1","52","44.4","33.6"
"Turner","2020-05-08","11","250","1","53","41.3","33.5"
"Turner","2020-05-09","0","250","0","53","27","32.3"
"Turner","2020-05-10","0","250","0","53","12.7","25.2"
"Turner","2020-05-11","18","268","3","56","15.1","25.8"
"Turner","2020-05-12","5","273","1","57","13.2","27.3"
"Turner","2020-05-13","14","287","0","57","7.7","27.3"
"Turner","2020-05-14","9","296","3","60","11.3","27.9"
"Turner","2020-05-15","10","306","1","61","11.4","26.4"
"Turner","2020-05-16","5","311","1","62","14.3","20.7"
"Turner","2020-05-17","0","311","0","62","14.3","13.5"
"Turner","2020-05-18","18","329","5","67","15.9","15.5"
"Turner","2020-05-19","10","339","3","70","17.3","15.3"
"Turner","2020-05-20","21","360","6","76","21.4","14.6"
"Turner","2020-05-21","26","386","7","83","20.5","15.9"
"Turner","2020-05-22","11","397","1","84","20.3","15.9"
"Turner","2020-05-23","2","399","0","84","17.5","15.9"
"Turner","2020-05-24","0","399","0","84","17.5","15.9"
"Turner","2020-05-25","4","403","1","85","17.1","16.5"
"Turner","2020-05-26","24","427","6","91","16.4","16.8"
"Turner","2020-05-27","26","453","3","94","13.9","17.7"
"Turner","2020-05-28","18","471","6","100","14.9","17.7"
"Turner","2020-05-29","9","480","4","104","19.9","20.1"
"Turner","2020-05-30","4","484","4","108","34.2","25.8"
"Turner","2020-05-31","0","484","0","108","34.2","25.8"
"Turner","2020-06-01","33","517","5","113","32.8","24.9"
"Turner","2020-06-02","42","559","2","115","29.9","23.1"
"Turner","2020-06-03","25","584","2","117","29.4","21.7"
"Turner","2020-06-04","13","597","1","118","25.7","20.3"
"Turner","2020-06-05","23","620","2","120","20.6","20.3"
"Turner","2020-06-06","2","622","1","121","13.5","23.8"
"Turner","2020-06-07","2","624","1","122","20.6","27.4"
"Turner","2020-06-08","40","664","4","126","19.9","26.3"
"Turner","2020-06-09","19","683","3","129","21.5","25.7"
"Turner","2020-06-10","20","703","2","131","21.7","25.6"
"Turner","2020-06-11","28","731","2","133","21.7","23.7"
"Turner","2020-06-12","23","754","0","133","20.4","20.5"
"Turner","2020-06-13","3","757","1","134","18","15.8"
"Turner","2020-06-14","3","760","0","134","10.9","15.8"
"Turner","2020-06-15","43","803","1","135","9.8","14.8"
"Turner","2020-06-16","10","813","0","135","7.5","14.5"
"Turner","2020-06-17","26","839","5","140","8.9","15.3"
"Turner","2020-06-18","41","880","1","141","8.2","14.9"
"Turner","2020-06-19","23","903","2","143","9.4","14.9"
"Turner","2020-06-20","2","905","1","144","11.8","14.9"
"Turner","2020-06-21","5","910","0","144","11.8","11.4"
"Turner","2020-06-22","38","948","1","145","11.9","10.8"
"Turner","2020-06-23","23","971","1","146","12.5","10"
"Turner","2020-06-24","40","1011","4","150","11.2","10"
"Turner","2020-06-25","24","1035","3","153","12.6","10.4"
"Turner","2020-06-26","21","1056","1","154","12","10.7"
"Turner","2020-06-27","5","1061","0","154","4.9","8.4"
"Turner","2020-06-28","1","1062","0","154","4.9","8.4"
"Turner","2020-06-29","39","1101","1","155","4.9","8.4"
"Turner","2020-06-30","37","1138","0","155","4.3","8.4"
"Turner","2020-07-01","32","1170","4","159","4.6","7.9"
"Turner","2020-07-02","18","1188","1","160","3.6","8.1"
"Turner","2020-07-03","3","1191","0","160","2.9","7.5"
"Turner","2020-07-04","1","1192","0","160","2.9","3.9"
"Turner","2020-07-05","1","1193","1","161","17.2","11.1"
"Turner","2020-07-06","19","1212","1","162","17.6","11.2"
"Turner","2020-07-07","12","1224","0","162","17.6","10.9"
"Turner","2020-07-08","34","1258","0","162","15.8","10.2"
"Turner","2020-07-09","47","1305","2","164","15.6","9.6"
"Turner","2020-07-10","10","1315","0","164","15.6","9.3"
"Turner","2020-07-11","5","1320","0","164","15.6","9.3"
"Turner","2020-07-12","4","1324","0","164","1.4","9.3"
"Turner","2020-07-13","30","1354","2","166","1.6","9.6"
"Turner","2020-07-14","11","1365","0","166","1.6","9.6"
"Turner","2020-07-15","35","1400","4","170","3.2","9.5"
"Turner","2020-07-16","33","1433","0","170","2.6","9.1"
"Turner","2020-07-17","9","1442","0","170","2.6","9.1"
"Turner","2020-07-18","1","1443","0","170","2.6","9.1"
"Turner","2020-07-19","3","1446","0","170","2.6","2"
"Turner","2020-07-20","33","1479","3","173","2.9","2.2"
"Turner","2020-07-21","15","1494","10","183","12.5","7"
"Turner","2020-07-22","27","1521","3","186","12.4","7.8"
"Turner","2020-07-23","13","1534","2","188","14.6","8.6"
"Turner","2020-07-24","4","1538","0","188","14.6","8.6"
"Turner","2020-07-25","4","1542","0","188","14.6","8.6"
"Turner","2020-07-26","6","1548","1","189","17","9.8"
"Turner","2020-07-27","36","1584","4","193","17.3","10.1"
"Turner","2020-07-28","34","1618","20","213","16.2","14.3"
"Turner","2020-07-29","34","1652","3","216","15.8","14.1"
"Turner","2020-07-30","17","1669","3","219","16.2","15.4"
"Turner","2020-07-31","8","1677","3","222","21.5","18.1"
"Turner","2020-08-01","1","1678","0","222","21.5","18.1"
"Turner","2020-08-02","1","1679","0","222","19.1","18.1"
"Turner","2020-08-03","23","1702","3","225","19.4","18.3"
"Turner","2020-08-04","30","1732","3","228","12.4","14.3"
"Turner","2020-08-05","38","1770","6","234","13.4","14.6"
"Turner","2020-08-06","12","1782","0","234","10.9","13.5"
"Turner","2020-08-07","8","1790","0","234","5.5","13.5"
"Turner","2020-08-08","9","1799","0","234","5.5","13.5"
"Turner","2020-08-09","2","1801","1","235","12.7","15.9"
"Turner","2020-08-10","46","1847","3","238","11.8","15.6"
"Turner","2020-08-11","9","1856","4","242","16.7","14.6"
"Turner","2020-08-12","32","1888","2","244","15.3","14.4"
"Turner","2020-08-13","6","1894","1","245","17.7","14.3"
"Turner","2020-08-14","33","1927","0","245","17.7","11.6"
"Turner","2020-08-15","27","1954","1","246","18.2","11.9"
"Turner","2020-08-16","37","1991","1","247","11.5","12.1"
"Turner","2020-08-17","11","2002","2","249","13.1","12.4"
"Turner","2020-08-18","14","2016","1","250","7.8","12.2"
"Turner","2020-08-19","39","2055","3","253","8","11.7"
"Turner","2020-08-20","26","2081","0","253","5.6","11.7"
"Turner","2020-08-21","89","2170","0","253","5.6","11.7"
"Turner","2020-08-22","6","2176","0","253","5.1","11.7"
"Turner","2020-08-23","2","2178","1","254","11.9","11.7"
"Turner","2020-08-24","6","2184","0","254","9.3","11.2"
"Turner","2020-08-25","5","2189","0","254","8.2","8"
"Turner","2020-08-26","42","2231","1","255","7.5","7.7"
"Turner","2020-08-27","24","2255","0","255","7.5","6.6"
"Turner","2020-08-28","56","2311","1","256","7.7","6.7"
"Turner","2020-08-29","23","2334","0","256","7.7","6.4"
"Turner","2020-08-30","3","2337","0","256","0.6","6.2"
"Turner","2020-08-31","13","2350","3","259","3.9","6.6"
"Turner","2020-09-01","12","2362","0","259","3.9","6.1"
"Turner","2020-09-02","25","2387","0","259","3.6","5.5"
"Turner","2020-09-03","22","2409","4","263","6.1","6.8"
"Turner","2020-09-04","12","2421","0","263","5.9","6.8"
"Turner","2020-09-05","5","2426","4","267","17.3","12.5"
"Turner","2020-09-06","0","2426","0","267","17.3","9"
"Turner","2020-09-07","2","2428","1","268","21.2","12.5"
"Turner","2020-09-08","12","2440","1","269","22.4","13.1"
"Turner","2020-09-09","37","2477","0","269","22.4","13"
"Turner","2020-09-10","17","2494","0","269","19.8","13"
"Turner","2020-09-11","10","2504","0","269","19.8","12.8"
"Turner","2020-09-12","5","2509","0","269","8.3","12.8"
"Turner","2020-09-13","4","2513","1","270","11.9","14.6"
"Turner","2020-09-14","8","2521","1","271","6.5","13.9"
"Turner","2020-09-15","7","2528","0","271","5.4","13.9"
"Turner","2020-09-16","21","2549","1","272","6","14.2"
"Turner","2020-09-17","19","2568","1","273","6.8","13.3"
"Turner","2020-09-18","8","2576","1","274","8.6","14.2"
"Turner","2020-09-19","3","2579","0","274","8.6","8.5"
"Turner","2020-09-20","4","2583","0","274","5","8.5"
"Turner","2020-09-21","11","2594","0","274","3.2","4.9"
"Turner","2020-09-22","8","2602","1","275","5","5.2"
"Turner","2020-09-23","30","2632","1","276","4.8","5.4"
"Turner","2020-09-24","31","2663","6","282","6.8","6.8"
"Turner","2020-09-25","5","2668","0","282","5","6.8"
"Turner","2020-09-26","7","2675","0","282","5","6.8"
"Turner","2020-09-27","3","2678","1","283","9.8","7.4"
"Turner","2020-09-28","20","2698","1","284","10.5","6.9"
"Turner","2020-09-29","10","2708","0","284","8.7","6.9"
"Turner","2020-09-30","12","2720","3","287","11.8","8.3"
"Turner","2020-10-01","12","2732","2","289","11.4","9.1"
"Turner","2020-10-02","54","2786","3","292","12.2","8.6"
"Turner","2020-10-03","19","2805","1","293","13","9"
"Turner","2020-10-04","4","2809","0","293","8.2","9"
"Turner","2020-10-05","25","2834","3","296","9.2","9.9"
"Turner","2020-10-06","10","2844","1","297","10.6","9.7"
"Turner","2020-10-07","71","2915","1","298","7.3","9.5"
"Turner","2020-10-08","32","2947","2","300","5.8","8.6"
"Turner","2020-10-09","36","2983","1","301","5.4","8.8"
"Turner","2020-10-10","5","2988","0","301","4.6","8.8"
"Turner","2020-10-11","11","2999","0","301","4.6","6.4"
"Turner","2020-10-12","16","3015","2","303","4.7","7"
"Turner","2020-10-13","24","3039","3","306","5.1","7.9"
"Turner","2020-10-14","41","3080","1","307","5.2","6.2"
"Turner","2020-10-15","22","3102","0","307","4.3","5"
"Turner","2020-10-16","19","3121","1","308","4.7","5"
"Turner","2020-10-17","4","3125","1","309","8.2","6.4"
"Turner","2020-10-18","1","3126","0","309","8.2","6.4"
"Turner","2020-10-19","31","3157","1","310","6.9","5.8"
"Turner","2020-10-20","32","3189","1","311","5.6","5.3"
"Turner","2020-10-21","40","3229","0","311","5.2","5.2"
"Turner","2020-10-22","12","3241","1","312","6.4","5.4"
"Turner","2020-10-23","6","3247","0","312","5.7","5.2"
"Turner","2020-10-24","4","3251","0","312","2.1","5.2"
"Turner","2020-10-25","4","3255","0","312","2.1","5.2"
"Turner","2020-10-26","11","3266","1","313","2.9","4.9"
"Turner","2020-10-27","7","3273","0","313","2.5","4"
"Turner","2020-10-28","35","3308","1","314","2.9","4.1"
"Turner","2020-10-29","31","3339","1","315","2.2","4.3"
"Turner","2020-10-30","7","3346","0","315","2.2","3.9"
"Turner","2020-10-31","2","3348","1","316","9.3","5.7"
"Turner","2020-11-01","0","3348","0","316","9.3","5.7"
"Turner","2020-11-02","10","3358","0","316","8","5.5"
"Turner","2020-11-03","14","3372","1","317","9","5.8"
"Turner","2020-11-04","15","3387","1","318","9.6","6.2"
"Turner","2020-11-05","26","3413","10","328","14.6","8.4"
"Turner","2020-11-06","17","3430","1","329","15.5","8.8"
"Turner","2020-11-07","1","3431","0","329","8.3","8.8"
"Turner","2020-11-08","0","3431","0","329","8.3","8.8"
"Turner","2020-11-09","22","3453","1","330","9","8.5"
"Turner","2020-11-10","18","3471","0","330","7.9","8.5"
"Turner","2020-11-11","4","3475","1","331","10.6","10.1"
"Turner","2020-11-12","19","3494","0","331","5.1","9.8"
"Turner","2020-11-13","11","3505","1","332","5.5","10.5"
"Turner","2020-11-14","4","3509","0","332","5.5","6.9"
"Turner","2020-11-15","2","3511","0","332","5.5","6.9"
"Turner","2020-11-16","25","3536","2","334","6","7.5"
"Turner","2020-11-17","19","3555","1","335","6.8","7.4"
"Turner","2020-11-18","15","3570","2","337","5.1","7.8"
"Turner","2020-11-19","28","3598","4","341","7.1","6.1"
"Turner","2020-11-20","26","3624","1","342","6.4","6"
"Turner","2020-11-21","7","3631","1","343","8.4","7"
"Turner","2020-11-22","7","3638","1","344","10.5","8"
"Turner","2020-11-23","26","3664","3","347","11","8.5"
"Turner","2020-11-24","14","3678","0","347","10.2","8.5"
"Turner","2020-11-25","10","3688","0","347","8.3","6.7"
"Turner","2020-11-26","4","3692","1","348","9.9","8.5"
"Turner","2020-11-27","11","3703","4","352","14.5","10.4"
"Turner","2020-11-28","3","3706","0","352","12.5","10.4"
"Turner","2020-11-29","8","3714","0","352","10.4","10.4"
"Turner","2020-11-30","21","3735","3","355","10.8","10.9"
"Turner","2020-12-01","16","3751","2","357","12.6","11.4"
"Turner","2020-12-02","16","3767","0","357","12.6","10.5"
"Turner","2020-12-03","13","3780","1","358","10.1","10"
"Turner","2020-12-04","12","3792","0","358","4.9","9.7"
"Turner","2020-12-05","7","3799","4","362","13.1","12.8"
"Turner","2020-12-06","2","3801","1","363","20.2","15.3"
"Turner","2020-12-07","18","3819","3","366","20.6","15.7"
"Turner","2020-12-08","55","3874","8","374","20.9","16.7"
"Turner","2020-12-09","16","3890","0","374","20.9","16.7"
"Turner","2020-12-10","19","3909","2","376","21.3","15.7"
"Turner","2020-12-11","11","3920","1","377","22.6","13.7"
"Turner","2020-12-12","12","3932","1","378","15.6","14.3"
"Turner","2020-12-13","8","3940","3","381","13.8","17"
"Turner","2020-12-14","51","3991","14","395","15.3","18"
"Turner","2020-12-15","19","4010","1","396","14","17.4"
"Turner","2020-12-16","23","4033","4","400","16.5","18.7"
"Turner","2020-12-17","24","4057","1","401","15.6","18.4"
"Turner","2020-12-18","14","4071","4","405","18.4","20.5"
"Turner","2020-12-19","10","4081","1","406","18.6","17.1"
"Turner","2020-12-20","5","4086","0","406","13.3","13.5"
"Turner","2020-12-21","108","4194","3","409","9.7","12.5"
"Turner","2020-12-22","65","4259","7","416","10.5","12.3"
"Turner","2020-12-23","10","4269","0","416","8","12.3"
"Turner","2020-12-24","9","4278","1","417","9","12.3"
"Turner","2020-12-25","3","4281","1","418","9.7","14"
"Turner","2020-12-26","3","4284","3","421","22.6","20.6"
"Turner","2020-12-27","6","4290","2","423","27.3","20.3"
"Turner","2020-12-28","13","4303","0","423","26.9","18.3"
"Turner","2020-12-29","73","4376","7","430","26.8","18.6"
"Turner","2020-12-30","12","4388","5","435","32.7","20.4"
"Turner","2020-12-31","18","4406","5","440","35.1","22.1"
"Turner","2021-01-01","3","4409","0","440","30.3","20"
"Turner","2021-01-02","0","4409","0","440","16.1","19.3"
"Turner","2021-01-03","8","4417","5","445","20.2","23.8"
"Turner","2021-01-04","22","4439","7","452","24.8","25.8"
"Turner","2021-01-05","145","4584","9","461","24.3","25.5"
"Turner","2021-01-06","67","4651","8","469","20","26.4"
"Turner","2021-01-07","34","4685","4","473","17.7","26.4"
"Turner","2021-01-08","33","4718","4","477","19.5","24.9"
"Turner","2021-01-09","9","4727","2","479","22.7","19.4"
"Turner","2021-01-10","2","4729","0","479","13.7","17"
"Turner","2021-01-11","17","4746","3","482","11.7","18.2"
"Turner","2021-01-12","31","4777","5","487","13.1","18.7"
"Turner","2021-01-13","44","4821","2","489","12.1","16"
"Turner","2021-01-14","50","4871","1","490","10.7","14.2"
"Turner","2021-01-15","11","4882","4","494","14.1","16.8"
"Turner","2021-01-16","9","4891","5","499","18.9","20.8"
"Turner","2021-01-17","4","4895","2","501","26","19.9"
"Turner","2021-01-18","19","4914","9","510","30.3","21"
"Turner","2021-01-19","20","4934","6","516","32.3","22.7"
"Turner","2021-01-20","9","4943","3","519","36.4","24.2"
"Turner","2021-01-21","21","4964","4","523","38.8","24.7"
"Turner","2021-01-22","14","4978","5","528","38.7","26.4"
"Turner","2021-01-23","0","4978","0","528","30.8","24.8"
"Turner","2021-01-24","5","4983","0","528","23.6","24.8"
"Turner","2021-01-25","23","5006","5","533","20","25.1"
"Turner","2021-01-26","60","5066","4","537","16.6","24.5"
"Turner","2021-01-27","22","5088","3","540","13.8","25.1"
"Turner","2021-01-28","10","5098","0","540","11.1","25"
"Turner","2021-01-29","13","5111","4","544","10.4","24.6"
"Turner","2021-01-30","3","5114","0","544","10.4","20.6"
"Turner","2021-01-31","3","5117","0","544","10.4","17"
"Turner","2021-02-01","11","5128","1","545","8.6","14.3"
"Turner","2021-02-02","4","5132","1","546","11.2","13.9"
"Turner","2021-02-03","4","5136","0","546","9.3","11.5"
"Turner","2021-02-04","6","5142","0","546","9.3","10.2"
"Turner","2021-02-05","2","5144","1","547","12","11.2"
"Turner","2021-02-06","3","5147","0","547","12","11.2"
"Turner","2021-02-07","2","5149","0","547","12","11.2"
"Turner","2021-02-08","0","5149","0","547","10.7","9.7"
"Twiggs","2020-02-01","0","0","0","0",".","."
"Twiggs","2020-02-02","0","0","0","0",".","."
"Twiggs","2020-02-03","0","0","0","0",".","."
"Twiggs","2020-02-04","0","0","0","0",".","."
"Twiggs","2020-02-05","0","0","0","0",".","."
"Twiggs","2020-02-06","0","0","0","0",".","."
"Twiggs","2020-02-07","0","0","0","0","0","."
"Twiggs","2020-02-08","0","0","0","0","0","."
"Twiggs","2020-02-09","0","0","0","0","0","."
"Twiggs","2020-02-10","0","0","0","0","0","."
"Twiggs","2020-02-11","0","0","0","0","0","."
"Twiggs","2020-02-12","0","0","0","0","0","."
"Twiggs","2020-02-13","0","0","0","0","0","."
"Twiggs","2020-02-14","0","0","0","0","0","0"
"Twiggs","2020-02-15","0","0","0","0","0","0"
"Twiggs","2020-02-16","0","0","0","0","0","0"
"Twiggs","2020-02-17","0","0","0","0","0","0"
"Twiggs","2020-02-18","0","0","0","0","0","0"
"Twiggs","2020-02-19","0","0","0","0","0","0"
"Twiggs","2020-02-20","0","0","0","0","0","0"
"Twiggs","2020-02-21","0","0","0","0","0","0"
"Twiggs","2020-02-22","0","0","0","0","0","0"
"Twiggs","2020-02-23","0","0","0","0","0","0"
"Twiggs","2020-02-24","0","0","0","0","0","0"
"Twiggs","2020-02-25","0","0","0","0","0","0"
"Twiggs","2020-02-26","0","0","0","0","0","0"
"Twiggs","2020-02-27","0","0","0","0","0","0"
"Twiggs","2020-02-28","0","0","0","0","0","0"
"Twiggs","2020-02-29","0","0","0","0","0","0"
"Twiggs","2020-03-01","0","0","0","0","0","0"
"Twiggs","2020-03-02","0","0","0","0","0","0"
"Twiggs","2020-03-03","0","0","0","0","0","0"
"Twiggs","2020-03-04","0","0","0","0","0","0"
"Twiggs","2020-03-05","0","0","0","0","0","0"
"Twiggs","2020-03-06","0","0","0","0","0","0"
"Twiggs","2020-03-07","0","0","0","0","0","0"
"Twiggs","2020-03-08","0","0","0","0","0","0"
"Twiggs","2020-03-09","0","0","0","0","0","0"
"Twiggs","2020-03-10","0","0","0","0","0","0"
"Twiggs","2020-03-11","0","0","0","0","0","0"
"Twiggs","2020-03-12","0","0","0","0","0","0"
"Twiggs","2020-03-13","3","3","0","0","0","0"
"Twiggs","2020-03-14","2","5","0","0","0","0"
"Twiggs","2020-03-15","0","5","0","0","0","0"
"Twiggs","2020-03-16","0","5","0","0","0","0"
"Twiggs","2020-03-17","0","5","0","0","0","0"
"Twiggs","2020-03-18","1","6","0","0","0","0"
"Twiggs","2020-03-19","2","8","0","0","0","0"
"Twiggs","2020-03-20","4","12","1","1","3.6","1.8"
"Twiggs","2020-03-21","2","14","0","1","3.6","1.8"
"Twiggs","2020-03-22","4","18","3","4","14.3","7.1"
"Twiggs","2020-03-23","2","20","0","4","14.3","7.1"
"Twiggs","2020-03-24","3","23","0","4","14.3","7.1"
"Twiggs","2020-03-25","6","29","0","4","14.3","7.1"
"Twiggs","2020-03-26","0","29","0","4","14.3","7.1"
"Twiggs","2020-03-27","5","34","0","4","10.7","7.1"
"Twiggs","2020-03-28","1","35","0","4","10.7","7.1"
"Twiggs","2020-03-29","0","35","0","4","0","7.1"
"Twiggs","2020-03-30","1","36","0","4","0","7.1"
"Twiggs","2020-03-31","0","36","0","4","0","7.1"
"Twiggs","2020-04-01","2","38","0","4","0","7.1"
"Twiggs","2020-04-02","1","39","0","4","0","7.1"
"Twiggs","2020-04-03","1","40","0","4","0","5.4"
"Twiggs","2020-04-04","0","40","0","4","0","5.4"
"Twiggs","2020-04-05","0","40","0","4","0","0"
"Twiggs","2020-04-06","1","41","0","4","0","0"
"Twiggs","2020-04-07","3","44","1","5","4.8","2.4"
"Twiggs","2020-04-08","2","46","0","5","4.8","2.4"
"Twiggs","2020-04-09","6","52","4","9","14.3","7.1"
"Twiggs","2020-04-10","6","58","2","11","19","9.5"
"Twiggs","2020-04-11","6","64","0","11","19","9.5"
"Twiggs","2020-04-12","1","65","1","12","33.3","16.7"
"Twiggs","2020-04-13","6","71","1","13","35.7","17.9"
"Twiggs","2020-04-14","13","84","3","16","34.2","19.5"
"Twiggs","2020-04-15","4","88","1","17","37.8","21.3"
"Twiggs","2020-04-16","5","93","0","17","28.3","21.3"
"Twiggs","2020-04-17","0","93","0","17","23.5","21.3"
"Twiggs","2020-04-18","0","93","0","17","23.5","21.3"
"Twiggs","2020-04-19","0","93","0","17","9.2","21.3"
"Twiggs","2020-04-20","2","95","0","17","6.9","21.3"
"Twiggs","2020-04-21","4","99","3","20","14.3","24.3"
"Twiggs","2020-04-22","2","101","0","20","10.7","24.3"
"Twiggs","2020-04-23","1","102","1","21","25","26.6"
"Twiggs","2020-04-24","5","107","4","25","36.4","30"
"Twiggs","2020-04-25","1","108","1","26","50.7","37.1"
"Twiggs","2020-04-26","0","108","0","26","50.7","30"
"Twiggs","2020-04-27","6","114","0","26","50.7","28.8"
"Twiggs","2020-04-28","1","115","0","26","40","27.1"
"Twiggs","2020-04-29","0","115","0","26","40","25.4"
"Twiggs","2020-04-30","5","120","0","26","25.7","25.4"
"Twiggs","2020-05-01","6","126","1","27","16.7","26.5"
"Twiggs","2020-05-02","4","130","0","27","2.4","26.5"
"Twiggs","2020-05-03","6","136","0","27","2.4","26.5"
"Twiggs","2020-05-04","9","145","2","29","5.6","28.1"
"Twiggs","2020-05-05","4","149","0","29","5.6","22.8"
"Twiggs","2020-05-06","5","154","1","30","8.4","24.2"
"Twiggs","2020-05-07","4","158","0","30","8.4","17.1"
"Twiggs","2020-05-08","0","158","0","30","6","11.3"
"Twiggs","2020-05-09","6","164","0","30","6","4.2"
"Twiggs","2020-05-10","2","166","0","30","6","4.2"
"Twiggs","2020-05-11","8","174","1","31","4.6","5.1"
"Twiggs","2020-05-12","3","177","0","31","4.6","5.1"
"Twiggs","2020-05-13","8","185","0","31","1.8","5.1"
"Twiggs","2020-05-14","8","193","0","31","1.8","5.1"
"Twiggs","2020-05-15","4","197","1","32","5.4","5.7"
"Twiggs","2020-05-16","4","201","0","32","5.4","5.7"
"Twiggs","2020-05-17","5","206","2","34","11.1","8.6"
"Twiggs","2020-05-18","3","209","0","34","9.3","7"
"Twiggs","2020-05-19","5","214","2","36","15","9.8"
"Twiggs","2020-05-20","4","218","0","36","15","8.4"
"Twiggs","2020-05-21","6","224","0","36","15","8.4"
"Twiggs","2020-05-22","9","233","2","38","14.6","10"
"Twiggs","2020-05-23","0","233","0","38","14.6","10"
"Twiggs","2020-05-24","3","236","0","38","8.9","10"
"Twiggs","2020-05-25","5","241","0","38","8.9","9.1"
"Twiggs","2020-05-26","13","254","3","41","6.5","10.7"
"Twiggs","2020-05-27","2","256","0","41","6.5","10.7"
"Twiggs","2020-05-28","5","261","1","42","9.3","12.2"
"Twiggs","2020-05-29","4","265","1","43","9.7","12.2"
"Twiggs","2020-05-30","0","265","0","43","9.7","12.2"
"Twiggs","2020-05-31","1","266","0","43","9.7","9.3"
"Twiggs","2020-06-01","7","273","0","43","9.7","9.3"
"Twiggs","2020-06-02","6","279","1","44","8.8","7.6"
"Twiggs","2020-06-03","4","283","2","46","16","11.2"
"Twiggs","2020-06-04","8","291","1","47","14.9","12.1"
"Twiggs","2020-06-05","6","297","0","47","11.3","10.5"
"Twiggs","2020-06-06","3","300","0","47","11.3","10.5"
"Twiggs","2020-06-07","1","301","0","47","11.3","10.5"
"Twiggs","2020-06-08","4","305","1","48","14.9","12.3"
"Twiggs","2020-06-09","3","308","0","48","12.5","10.7"
"Twiggs","2020-06-10","6","314","2","50","10.1","13"
"Twiggs","2020-06-11","15","329","0","50","8.3","11.6"
"Twiggs","2020-06-12","7","336","0","50","8.3","9.8"
"Twiggs","2020-06-13","3","339","1","51","13.1","12.2"
"Twiggs","2020-06-14","1","340","0","51","13.1","12.2"
"Twiggs","2020-06-15","3","343","0","51","9.5","12.2"
"Twiggs","2020-06-16","5","348","0","51","9.5","11"
"Twiggs","2020-06-17","4","352","1","52","8.3","9.2"
"Twiggs","2020-06-18","5","357","0","52","8.3","8.3"
"Twiggs","2020-06-19","2","359","0","52","8.3","8.3"
"Twiggs","2020-06-20","1","360","0","52","3.6","8.3"
"Twiggs","2020-06-21","1","361","0","52","3.6","8.3"
"Twiggs","2020-06-22","14","375","1","53","4.6","7.1"
"Twiggs","2020-06-23","7","382","0","53","4.6","7.1"
"Twiggs","2020-06-24","6","388","0","53","1","4.7"
"Twiggs","2020-06-25","14","402","2","55","3.1","5.7"
"Twiggs","2020-06-26","7","409","1","56","5.1","6.7"
"Twiggs","2020-06-27","7","416","3","59","11.2","7.4"
"Twiggs","2020-06-28","6","422","1","60","13.6","8.6"
"Twiggs","2020-06-29","12","434","8","68","22.1","13.4"
"Twiggs","2020-06-30","10","444","0","68","22.1","13.4"
"Twiggs","2020-07-01","22","466","1","69","22.8","11.9"
"Twiggs","2020-07-02","26","492","3","72","22.4","12.7"
"Twiggs","2020-07-03","10","502","3","75","24.6","14.9"
"Twiggs","2020-07-04","1","503","0","75","18.5","14.9"
"Twiggs","2020-07-05","11","514","5","80","22.6","18.1"
"Twiggs","2020-07-06","17","531","1","81","13.9","18"
"Twiggs","2020-07-07","16","547","1","82","14.8","18.5"
"Twiggs","2020-07-08","23","570","2","84","15.4","19.1"
"Twiggs","2020-07-09","32","602","7","91","16.9","19.6"
"Twiggs","2020-07-10","9","611","0","91","12.6","18.6"
"Twiggs","2020-07-11","6","617","0","91","12.6","15.5"
"Twiggs","2020-07-12","13","630","2","93","8.3","15.4"
"Twiggs","2020-07-13","20","650","1","94","8.2","11"
"Twiggs","2020-07-14","19","669","0","94","7.3","11"
"Twiggs","2020-07-15","11","680","4","98","11.2","13.3"
"Twiggs","2020-07-16","33","713","10","108","12.4","14.7"
"Twiggs","2020-07-17","14","727","2","110","14.5","13.5"
"Twiggs","2020-07-18","12","739","7","117","22.8","17.7"
"Twiggs","2020-07-19","14","753","1","118","21.6","15"
"Twiggs","2020-07-20","29","782","7","125","24.4","16.3"
"Twiggs","2020-07-21","10","792","3","128","28.7","18"
"Twiggs","2020-07-22","10","802","4","132","29.2","20.2"
"Twiggs","2020-07-23","35","837","6","138","27.3","19.9"
"Twiggs","2020-07-24","11","848","2","140","27.8","21.2"
"Twiggs","2020-07-25","7","855","2","142","23.6","23.2"
"Twiggs","2020-07-26","6","861","3","145","29.7","25.7"
"Twiggs","2020-07-27","19","880","4","149","29.3","26.8"
"Twiggs","2020-07-28","14","894","3","152","28.1","28.4"
"Twiggs","2020-07-29","19","913","2","154","23.8","26.5"
"Twiggs","2020-07-30","53","966","8","162","23.6","25.4"
"Twiggs","2020-07-31","18","984","2","164","22.5","25.2"
"Twiggs","2020-08-01","4","988","1","165","22","22.8"
"Twiggs","2020-08-02","5","993","1","166","17.7","23.7"
"Twiggs","2020-08-03","16","1009","4","170","18.3","23.8"
"Twiggs","2020-08-04","9","1018","3","173","20","24"
"Twiggs","2020-08-05","16","1034","6","179","23.9","23.9"
"Twiggs","2020-08-06","41","1075","4","183","23.1","23.3"
"Twiggs","2020-08-07","21","1096","4","187","24.2","23.4"
"Twiggs","2020-08-08","11","1107","4","191","25.9","23.9"
"Twiggs","2020-08-09","3","1110","0","191","23","20.4"
"Twiggs","2020-08-10","17","1127","6","197","24.5","21.4"
"Twiggs","2020-08-11","10","1137","3","200","24","22"
"Twiggs","2020-08-12","5","1142","1","201","21.5","22.7"
"Twiggs","2020-08-13","23","1165","8","209","25.1","24.1"
"Twiggs","2020-08-14","7","1172","0","209","22.3","23.3"
"Twiggs","2020-08-15","6","1178","3","212","24.3","25.1"
"Twiggs","2020-08-16","4","1182","1","213","27.9","25.4"
"Twiggs","2020-08-17","11","1193","3","216","26.7","25.6"
"Twiggs","2020-08-18","21","1214","3","219","24.5","24.2"
"Twiggs","2020-08-19","10","1224","2","221","24.5","23"
"Twiggs","2020-08-20","25","1249","3","224","21.2","23.1"
"Twiggs","2020-08-21","4","1253","1","225","24.8","23.6"
"Twiggs","2020-08-22","13","1266","1","226","18.8","21.5"
"Twiggs","2020-08-23","4","1270","0","226","15.2","21.5"
"Twiggs","2020-08-24","19","1289","3","229","13.5","20.1"
"Twiggs","2020-08-25","12","1301","1","230","12.7","18.6"
"Twiggs","2020-08-26","5","1306","0","230","9.8","17.2"
"Twiggs","2020-08-27","27","1333","3","233","9.7","15.5"
"Twiggs","2020-08-28","9","1342","0","233","6.1","15.5"
"Twiggs","2020-08-29","4","1346","1","234","8.6","13.7"
"Twiggs","2020-08-30","9","1355","1","235","10.2","12.7"
"Twiggs","2020-08-31","4","1359","0","235","7.9","10.7"
"Twiggs","2020-09-01","6","1365","2","237","11.5","12.1"
"Twiggs","2020-09-02","10","1375","1","238","12.9","11.4"
"Twiggs","2020-09-03","15","1390","3","241","14.2","12"
"Twiggs","2020-09-04","6","1396","1","242","16.6","11.4"
"Twiggs","2020-09-05","6","1402","0","242","13","10.8"
"Twiggs","2020-09-06","2","1404","0","242","11.4","10.8"
"Twiggs","2020-09-07","3","1407","2","244","21","14.4"
"Twiggs","2020-09-08","6","1413","1","245","18.6","15"
"Twiggs","2020-09-09","10","1423","1","246","18.6","15.8"
"Twiggs","2020-09-10","14","1437","0","246","15.7","15"
"Twiggs","2020-09-11","7","1444","2","248","17.4","17"
"Twiggs","2020-09-12","0","1444","0","248","17.4","15.2"
"Twiggs","2020-09-13","3","1447","0","248","17.4","14.4"
"Twiggs","2020-09-14","10","1457","1","249","9.3","15.1"
"Twiggs","2020-09-15","4","1461","1","250","10.5","14.5"
"Twiggs","2020-09-16","6","1467","1","251","11.5","15"
"Twiggs","2020-09-17","12","1479","2","253","13.8","14.8"
"Twiggs","2020-09-18","7","1486","0","253","9.8","13.6"
"Twiggs","2020-09-19","4","1490","0","253","9.8","13.6"
"Twiggs","2020-09-20","7","1497","1","254","11.8","14.6"
"Twiggs","2020-09-21","13","1510","2","256","12.6","10.9"
"Twiggs","2020-09-22","8","1518","1","257","10.8","10.6"
"Twiggs","2020-09-23","6","1524","1","258","10.8","11.1"
"Twiggs","2020-09-24","9","1533","2","260","11.6","12.7"
"Twiggs","2020-09-25","12","1545","3","263","15.2","12.5"
"Twiggs","2020-09-26","6","1551","2","265","19.9","14.8"
"Twiggs","2020-09-27","5","1556","4","269","29.3","20.6"
"Twiggs","2020-09-28","14","1570","3","272","30.2","21.4"
"Twiggs","2020-09-29","6","1576","0","272","28.4","19.6"
"Twiggs","2020-09-30","7","1583","1","273","28","19.4"
"Twiggs","2020-10-01","23","1606","1","274","25.5","18.5"
"Twiggs","2020-10-02","9","1615","1","275","23.5","19.3"
"Twiggs","2020-10-03","6","1621","1","276","21.1","20.5"
"Twiggs","2020-10-04","3","1624","0","276","9.7","19.5"
"Twiggs","2020-10-05","4","1628","1","277","10.2","20.2"
"Twiggs","2020-10-06","8","1636","2","279","13.8","21.1"
"Twiggs","2020-10-07","13","1649","3","282","15","21.5"
"Twiggs","2020-10-08","8","1657","2","284","18","21.7"
"Twiggs","2020-10-09","12","1669","3","287","20","21.7"
"Twiggs","2020-10-10","6","1675","0","287","17.6","19.4"
"Twiggs","2020-10-11","3","1678","1","288","22.3","16"
"Twiggs","2020-10-12","12","1690","1","289","20","15.1"
"Twiggs","2020-10-13","11","1701","2","291","19","16.4"
"Twiggs","2020-10-14","8","1709","3","294","21","18"
"Twiggs","2020-10-15","13","1722","1","295","18.6","18.3"
"Twiggs","2020-10-16","12","1734","1","296","16.2","18.1"
"Twiggs","2020-10-17","4","1738","1","297","19.8","18.7"
"Twiggs","2020-10-18","5","1743","2","299","20.7","21.5"
"Twiggs","2020-10-19","10","1753","2","301","22.4","21.2"
"Twiggs","2020-10-20","11","1764","1","302","21.1","20"
"Twiggs","2020-10-21","11","1775","1","303","17","19"
"Twiggs","2020-10-22","20","1795","2","305","17.4","18"
"Twiggs","2020-10-23","11","1806","1","306","17.5","16.8"
"Twiggs","2020-10-24","7","1813","0","306","13.9","16.8"
"Twiggs","2020-10-25","3","1816","1","307","12.9","16.8"
"Twiggs","2020-10-26","16","1832","3","310","12.8","17.6"
"Twiggs","2020-10-27","14","1846","1","311","12.5","16.8"
"Twiggs","2020-10-28","11","1857","1","312","12.5","14.8"
"Twiggs","2020-10-29","12","1869","3","315","14.6","16"
"Twiggs","2020-10-30","13","1882","1","316","14.4","15.9"
"Twiggs","2020-10-31","4","1886","3","319","25.1","19.5"
"Twiggs","2020-11-01","2","1888","1","320","27.5","20.2"
"Twiggs","2020-11-02","18","1906","2","322","26.4","19.6"
"Twiggs","2020-11-03","6","1912","3","325","32.6","22.5"
"Twiggs","2020-11-04","9","1921","0","325","31.3","21.9"
"Twiggs","2020-11-05","11","1932","2","327","30.3","22.5"
"Twiggs","2020-11-06","6","1938","0","327","29.2","21.8"
"Twiggs","2020-11-07","4","1942","0","327","18.5","21.8"
"Twiggs","2020-11-08","2","1944","0","327","11.3","19.4"
"Twiggs","2020-11-09","10","1954","0","327","9.7","18.1"
"Twiggs","2020-11-10","6","1960","1","328","5","18.8"
"Twiggs","2020-11-11","3","1963","0","328","5","18.1"
"Twiggs","2020-11-12","15","1978","0","328","2.4","16.3"
"Twiggs","2020-11-13","16","1994","0","328","2.4","15.8"
"Twiggs","2020-11-14","4","1998","0","328","2.4","10.4"
"Twiggs","2020-11-15","6","2004","0","328","2.4","6.9"
"Twiggs","2020-11-16","14","2018","1","329","3.4","6.6"
"Twiggs","2020-11-17","14","2032","2","331","3.1","4"
"Twiggs","2020-11-18","10","2042","1","332","4.5","4.7"
"Twiggs","2020-11-19","28","2070","2","334","5.5","3.9"
"Twiggs","2020-11-20","12","2082","4","338","10.3","6.3"
"Twiggs","2020-11-21","7","2089","2","340","14.4","8.4"
"Twiggs","2020-11-22","1","2090","0","340","14.4","8.4"
"Twiggs","2020-11-23","11","2101","0","340","13.3","8.4"
"Twiggs","2020-11-24","5","2106","0","340","11.3","7.2"
"Twiggs","2020-11-25","10","2116","1","341","11.3","7.9"
"Twiggs","2020-11-26","2","2118","0","341","10.3","7.9"
"Twiggs","2020-11-27","10","2128","4","345","11.2","10.7"
"Twiggs","2020-11-28","3","2131","0","345","7.1","10.7"
"Twiggs","2020-11-29","7","2138","2","347","11.2","12.8"
"Twiggs","2020-11-30","17","2155","2","349","12.9","13.1"
"Twiggs","2020-12-01","9","2164","1","350","14.5","12.9"
"Twiggs","2020-12-02","12","2176","1","351","14.3","12.8"
"Twiggs","2020-12-03","17","2193","3","354","16.8","13.5"
"Twiggs","2020-12-04","18","2211","2","356","12.6","11.9"
"Twiggs","2020-12-05","13","2224","1","357","13.7","10.4"
"Twiggs","2020-12-06","4","2228","0","357","9.7","10.4"
"Twiggs","2020-12-07","18","2246","1","358","8.8","10.8"
"Twiggs","2020-12-08","9","2255","2","360","10.4","12.4"
"Twiggs","2020-12-09","20","2275","5","365","12.7","13.5"
"Twiggs","2020-12-10","12","2287","2","367","12.6","14.7"
"Twiggs","2020-12-11","14","2301","5","372","16.1","14.4"
"Twiggs","2020-12-12","8","2309","3","375","20.4","17.1"
"Twiggs","2020-12-13","4","2313","3","378","31.1","20.4"
"Twiggs","2020-12-14","16","2329","5","383","34.8","21.8"
"Twiggs","2020-12-15","15","2344","2","385","33.5","21.9"
"Twiggs","2020-12-16","12","2356","8","393","39.4","26.1"
"Twiggs","2020-12-17","25","2381","6","399","40.5","26.6"
"Twiggs","2020-12-18","21","2402","2","401","36.8","26.4"
"Twiggs","2020-12-19","11","2413","7","408","40.5","30.4"
"Twiggs","2020-12-20","9","2422","2","410","32.9","32"
"Twiggs","2020-12-21","18","2440","2","412","30.1","32.4"
"Twiggs","2020-12-22","13","2453","6","418","34.8","34.1"
"Twiggs","2020-12-23","20","2473","8","426","30.9","35.2"
"Twiggs","2020-12-24","7","2480","4","430","35.7","38.1"
"Twiggs","2020-12-25","5","2485","1","431","37.2","37"
"Twiggs","2020-12-26","9","2494","5","436","36","38.3"
"Twiggs","2020-12-27","16","2510","8","444","40","36.5"
"Twiggs","2020-12-28","18","2528","7","451","44","37"
"Twiggs","2020-12-29","24","2552","11","462","43.9","39.3"
"Twiggs","2020-12-30","50","2602","21","483","44.2","37.6"
"Twiggs","2020-12-31","34","2636","9","492","39.8","37.8"
"Twiggs","2021-01-01","7","2643","3","495","43.1","40.1"
"Twiggs","2021-01-02","11","2654","2","497","37.7","36.9"
"Twiggs","2021-01-03","20","2674","7","504","35.6","37.8"
"Twiggs","2021-01-04","40","2714","11","515","34","39"
"Twiggs","2021-01-05","26","2740","10","525","32.9","38.4"
"Twiggs","2021-01-06","30","2770","2","527","27.9","36"
"Twiggs","2021-01-07","43","2813","8","535","26.8","33.3"
"Twiggs","2021-01-08","19","2832","6","541","25.1","34.1"
"Twiggs","2021-01-09","13","2845","6","547","29.1","33.4"
"Twiggs","2021-01-10","19","2864","4","551","27.1","31.4"
"Twiggs","2021-01-11","29","2893","1","552","23.7","28.8"
"Twiggs","2021-01-12","28","2921","8","560","22.3","27.6"
"Twiggs","2021-01-13","16","2937","0","560","21.3","24.6"
"Twiggs","2021-01-14","38","2975","6","566","20.9","23.8"
"Twiggs","2021-01-15","13","2988","3","569","19.7","22.4"
"Twiggs","2021-01-16","9","2997","3","572","17.9","23.5"
"Twiggs","2021-01-17","6","3003","3","575","22","24.6"
"Twiggs","2021-01-18","18","3021","1","576","22.3","23"
"Twiggs","2021-01-19","15","3036","5","581","23","22.7"
"Twiggs","2021-01-20","8","3044","1","582","24.8","23.1"
"Twiggs","2021-01-21","21","3065","2","584","23.9","22.4"
"Twiggs","2021-01-22","14","3079","1","585","21.6","20.7"
"Twiggs","2021-01-23","10","3089","3","588","21.2","19.5"
"Twiggs","2021-01-24","6","3095","2","590","18.8","20.4"
"Twiggs","2021-01-25","16","3111","1","591","18.9","20.6"
"Twiggs","2021-01-26","14","3125","1","592","15.1","19.1"
"Twiggs","2021-01-27","11","3136","0","592","13.3","19.1"
"Twiggs","2021-01-28","22","3158","4","596","14.6","19.2"
"Twiggs","2021-01-29","11","3169","2","598","16.2","18.9"
"Twiggs","2021-01-30","4","3173","2","600","19","20.1"
"Twiggs","2021-01-31","5","3178","1","601","17.1","17.9"
"Twiggs","2021-02-01","22","3200","0","601","16.2","17.5"
"Twiggs","2021-02-02","11","3211","2","603","17.8","16.5"
"Twiggs","2021-02-03","10","3221","1","604","19.2","16.3"
"Twiggs","2021-02-04","21","3242","2","606","18","16.3"
"Twiggs","2021-02-05","14","3256","3","609","18.4","17.3"
"Twiggs","2021-02-06","1","3257","0","609","11.3","15.2"
"Twiggs","2021-02-07","0","3257","0","609","8.4","12.8"
"Twiggs","2021-02-08","0","3257","0","609","8.4","12.3"
"Union","2020-02-01","0","0","0","0",".","."
"Union","2020-02-02","0","0","0","0",".","."
"Union","2020-02-03","0","0","0","0",".","."
"Union","2020-02-04","0","0","0","0",".","."
"Union","2020-02-05","0","0","0","0",".","."
"Union","2020-02-06","0","0","0","0",".","."
"Union","2020-02-07","0","0","0","0","0","."
"Union","2020-02-08","0","0","0","0","0","."
"Union","2020-02-09","0","0","0","0","0","."
"Union","2020-02-10","0","0","0","0","0","."
"Union","2020-02-11","0","0","0","0","0","."
"Union","2020-02-12","0","0","0","0","0","."
"Union","2020-02-13","0","0","0","0","0","."
"Union","2020-02-14","0","0","0","0","0","0"
"Union","2020-02-15","0","0","0","0","0","0"
"Union","2020-02-16","0","0","0","0","0","0"
"Union","2020-02-17","0","0","0","0","0","0"
"Union","2020-02-18","0","0","0","0","0","0"
"Union","2020-02-19","0","0","0","0","0","0"
"Union","2020-02-20","0","0","0","0","0","0"
"Union","2020-02-21","0","0","0","0","0","0"
"Union","2020-02-22","0","0","0","0","0","0"
"Union","2020-02-23","0","0","0","0","0","0"
"Union","2020-02-24","0","0","0","0","0","0"
"Union","2020-02-25","0","0","0","0","0","0"
"Union","2020-02-26","0","0","0","0","0","0"
"Union","2020-02-27","0","0","0","0","0","0"
"Union","2020-02-28","0","0","0","0","0","0"
"Union","2020-02-29","0","0","0","0","0","0"
"Union","2020-03-01","0","0","0","0","0","0"
"Union","2020-03-02","0","0","0","0","0","0"
"Union","2020-03-03","0","0","0","0","0","0"
"Union","2020-03-04","0","0","0","0","0","0"
"Union","2020-03-05","0","0","0","0","0","0"
"Union","2020-03-06","0","0","0","0","0","0"
"Union","2020-03-07","0","0","0","0","0","0"
"Union","2020-03-08","0","0","0","0","0","0"
"Union","2020-03-09","0","0","0","0","0","0"
"Union","2020-03-10","0","0","0","0","0","0"
"Union","2020-03-11","0","0","0","0","0","0"
"Union","2020-03-12","1","1","0","0","0","0"
"Union","2020-03-13","0","1","0","0","0","0"
"Union","2020-03-14","1","2","0","0","0","0"
"Union","2020-03-15","1","3","1","1","14.3","7.1"
"Union","2020-03-16","0","3","0","1","14.3","7.1"
"Union","2020-03-17","5","8","0","1","14.3","7.1"
"Union","2020-03-18","1","9","0","1","14.3","7.1"
"Union","2020-03-19","1","10","0","1","14.3","7.1"
"Union","2020-03-20","2","12","0","1","14.3","7.1"
"Union","2020-03-21","3","15","0","1","14.3","7.1"
"Union","2020-03-22","5","20","0","1","0","7.1"
"Union","2020-03-23","3","23","0","1","0","7.1"
"Union","2020-03-24","3","26","0","1","0","7.1"
"Union","2020-03-25","1","27","0","1","0","7.1"
"Union","2020-03-26","10","37","0","1","0","7.1"
"Union","2020-03-27","6","43","0","1","0","7.1"
"Union","2020-03-28","2","45","0","1","0","7.1"
"Union","2020-03-29","2","47","0","1","0","0"
"Union","2020-03-30","7","54","1","2","2","1"
"Union","2020-03-31","0","54","0","2","2","1"
"Union","2020-04-01","1","55","0","2","2","1"
"Union","2020-04-02","7","62","0","2","2","1"
"Union","2020-04-03","5","67","0","2","2","1"
"Union","2020-04-04","6","73","0","2","2","1"
"Union","2020-04-05","2","75","0","2","2","1"
"Union","2020-04-06","4","79","0","2","0","1"
"Union","2020-04-07","5","84","0","2","0","1"
"Union","2020-04-08","3","87","0","2","0","1"
"Union","2020-04-09","3","90","0","2","0","1"
"Union","2020-04-10","4","94","0","2","0","1"
"Union","2020-04-11","1","95","0","2","0","1"
"Union","2020-04-12","0","95","0","2","0","1"
"Union","2020-04-13","0","95","0","2","0","0"
"Union","2020-04-14","3","98","1","3","4.8","2.4"
"Union","2020-04-15","0","98","0","3","4.8","2.4"
"Union","2020-04-16","4","102","0","3","4.8","2.4"
"Union","2020-04-17","9","111","0","3","4.8","2.4"
"Union","2020-04-18","3","114","0","3","4.8","2.4"
"Union","2020-04-19","1","115","0","3","4.8","2.4"
"Union","2020-04-20","2","117","0","3","4.8","2.4"
"Union","2020-04-21","2","119","0","3","0","2.4"
"Union","2020-04-22","6","125","0","3","0","2.4"
"Union","2020-04-23","8","133","0","3","0","2.4"
"Union","2020-04-24","4","137","0","3","0","2.4"
"Union","2020-04-25","2","139","0","3","0","2.4"
"Union","2020-04-26","2","141","1","4","7.1","6"
"Union","2020-04-27","6","147","0","4","7.1","6"
"Union","2020-04-28","5","152","0","4","7.1","3.6"
"Union","2020-04-29","4","156","0","4","7.1","3.6"
"Union","2020-04-30","5","161","0","4","7.1","3.6"
"Union","2020-05-01","6","167","0","4","7.1","3.6"
"Union","2020-05-02","1","168","0","4","7.1","3.6"
"Union","2020-05-03","2","170","0","4","0","3.6"
"Union","2020-05-04","4","174","0","4","0","3.6"
"Union","2020-05-05","3","177","0","4","0","3.6"
"Union","2020-05-06","7","184","0","4","0","3.6"
"Union","2020-05-07","4","188","0","4","0","3.6"
"Union","2020-05-08","10","198","0","4","0","3.6"
"Union","2020-05-09","3","201","0","4","0","3.6"
"Union","2020-05-10","0","201","0","4","0","0"
"Union","2020-05-11","10","211","0","4","0","0"
"Union","2020-05-12","10","221","0","4","0","0"
"Union","2020-05-13","13","234","0","4","0","0"
"Union","2020-05-14","10","244","0","4","0","0"
"Union","2020-05-15","8","252","0","4","0","0"
"Union","2020-05-16","17","269","1","5","0.8","0.4"
"Union","2020-05-17","13","282","2","7","3","1.5"
"Union","2020-05-18","6","288","0","7","3","1.5"
"Union","2020-05-19","9","297","0","7","3","1.5"
"Union","2020-05-20","13","310","0","7","3","1.5"
"Union","2020-05-21","6","316","0","7","3","1.5"
"Union","2020-05-22","8","324","0","7","3","1.5"
"Union","2020-05-23","41","365","4","11","3.6","2.2"
"Union","2020-05-24","1","366","1","12","15.7","9.4"
"Union","2020-05-25","1","367","0","12","15.7","9.4"
"Union","2020-05-26","13","380","0","12","15.7","9.4"
"Union","2020-05-27","48","428","0","12","15.7","9.4"
"Union","2020-05-28","13","441","1","13","16.8","9.9"
"Union","2020-05-29","8","449","0","13","16.8","9.9"
"Union","2020-05-30","28","477","3","16","16.9","10.3"
"Union","2020-05-31","4","481","0","16","2.6","9.2"
"Union","2020-06-01","7","488","0","16","2.6","9.2"
"Union","2020-06-02","9","497","1","17","4.2","9.9"
"Union","2020-06-03","41","538","6","23","6.3","11"
"Union","2020-06-04","15","553","0","23","5.2","11"
"Union","2020-06-05","10","563","1","24","6.6","11.7"
"Union","2020-06-06","19","582","1","25","5.9","11.4"
"Union","2020-06-07","4","586","2","27","13","7.8"
"Union","2020-06-08","13","599","1","28","14.1","8.4"
"Union","2020-06-09","10","609","1","29","13.9","9.1"
"Union","2020-06-10","51","660","3","32","12.7","9.5"
"Union","2020-06-11","9","669","0","32","12.7","8.9"
"Union","2020-06-12","16","685","5","37","15.7","11.2"
"Union","2020-06-13","49","734","2","39","15.6","10.7"
"Union","2020-06-14","2","736","0","39","8.4","10.7"
"Union","2020-06-15","27","763","0","39","7.3","10.7"
"Union","2020-06-16","6","769","1","40","8.3","11.1"
"Union","2020-06-17","44","813","2","42","8.1","10.4"
"Union","2020-06-18","12","825","0","42","8.1","10.4"
"Union","2020-06-19","9","834","2","44","6.8","11.3"
"Union","2020-06-20","34","868","1","45","6.6","11.1"
"Union","2020-06-21","1","869","0","45","6.6","7.5"
"Union","2020-06-22","15","884","4","49","10.4","8.9"
"Union","2020-06-23","8","892","0","49","8.1","8.2"
"Union","2020-06-24","64","956","7","56","9","8.5"
"Union","2020-06-25","14","970","5","61","14.1","11.1"
"Union","2020-06-26","17","987","7","68","16.8","11.8"
"Union","2020-06-27","36","1023","5","73","18.3","12.5"
"Union","2020-06-28","8","1031","4","77","25.5","16.1"
"Union","2020-06-29","18","1049","4","81","24.8","17.6"
"Union","2020-06-30","16","1065","4","85","28.4","18.2"
"Union","2020-07-01","137","1202","9","94","27.8","18.4"
"Union","2020-07-02","8","1210","0","94","22.7","18.4"
"Union","2020-07-03","73","1283","13","107","19.4","18.1"
"Union","2020-07-04","4","1287","1","108","20.9","19.6"
"Union","2020-07-05","2","1289","0","108","13.8","19.6"
"Union","2020-07-06","35","1324","15","123","16.7","20.8"
"Union","2020-07-07","35","1359","4","127","14.8","21.6"
"Union","2020-07-08","162","1521","25","152","16.1","21.9"
"Union","2020-07-09","46","1567","4","156","17.3","20"
"Union","2020-07-10","66","1633","29","185","21.1","20.2"
"Union","2020-07-11","92","1725","7","192","18.6","19.8"
"Union","2020-07-12","62","1787","12","204","21.3","17.6"
"Union","2020-07-13","28","1815","9","213","19.8","18.3"
"Union","2020-07-14","65","1880","25","238","23.7","19.2"
"Union","2020-07-15","45","1925","12","250","25.3","20.7"
"Union","2020-07-16","42","1967","5","255","25.7","21.5"
"Union","2020-07-17","65","2032","7","262","21","21"
"Union","2020-07-18","73","2105","4","266","20.7","19.6"
"Union","2020-07-19","3","2108","0","266","17.9","19.6"
"Union","2020-07-20","72","2180","13","279","15.9","17.9"
"Union","2020-07-21","77","2257","17","296","13.6","18.6"
"Union","2020-07-22","142","2399","21","317","11.9","18.6"
"Union","2020-07-23","55","2454","18","335","14.8","20.3"
"Union","2020-07-24","75","2529","17","352","16.5","18.8"
"Union","2020-07-25","115","2644","13","365","17.4","19"
"Union","2020-07-26","28","2672","6","371","20.4","19.2"
"Union","2020-07-27","34","2706","8","379","21.2","18.6"
"Union","2020-07-28","62","2768","13","392","21.1","17.3"
"Union","2020-07-29","171","2939","14","406","20.1","16"
"Union","2020-07-30","60","2999","15","421","19","16.9"
"Union","2020-07-31","86","3085","25","446","19.9","18.2"
"Union","2020-08-01","116","3201","21","467","20.9","19.1"
"Union","2020-08-02","30","3231","11","478","23.1","21.8"
"Union","2020-08-03","19","3250","0","478","19.7","20.5"
"Union","2020-08-04","23","3273","4","482","19.2","20.1"
"Union","2020-08-05","213","3486","38","520","20.6","20.3"
"Union","2020-08-06","76","3562","30","550","22.6","20.8"
"Union","2020-08-07","21","3583","4","554","21.2","20.6"
"Union","2020-08-08","79","3662","4","558","19.4","20.1"
"Union","2020-08-09","61","3723","20","578","18.8","20.9"
"Union","2020-08-10","88","3811","29","607","23.5","21.6"
"Union","2020-08-11","62","3873","16","623","24.7","22"
"Union","2020-08-12","261","4134","37","660","24.2","22.4"
"Union","2020-08-13","49","4183","3","663","19.4","21"
"Union","2020-08-14","69","4252","10","673","18.8","20"
"Union","2020-08-15","104","4356","12","685","19.7","19.5"
"Union","2020-08-16","122","4478","23","708","17.7","18.3"
"Union","2020-08-17","20","4498","8","716","18.7","21.1"
"Union","2020-08-18","61","4559","13","729","18.1","21.4"
"Union","2020-08-19","62","4621","11","740","18.6","21.4"
"Union","2020-08-20","74","4695","18","758","21.2","20.3"
"Union","2020-08-21","21","4716","6","764","23.2","21"
"Union","2020-08-22","83","4799","9","773","23.1","21.4"
"Union","2020-08-23","75","4874","30","803","26.1","21.9"
"Union","2020-08-24","27","4901","9","812","25.2","21.9"
"Union","2020-08-25","13","4914","2","814","24.3","21.2"
"Union","2020-08-26","144","5058","32","846","25","21.8"
"Union","2020-08-27","50","5108","4","850","22.6","21.9"
"Union","2020-08-28","68","5176","19","869","22.5","22.9"
"Union","2020-08-29","21","5197","0","869","21","22"
"Union","2020-08-30","65","5262","13","882","18.1","22.1"
"Union","2020-08-31","23","5285","6","888","17.1","21.1"
"Union","2020-09-01","44","5329","13","901","19.1","21.7"
"Union","2020-09-02","70","5399","10","911","18","21.5"
"Union","2020-09-03","33","5432","8","919","20.3","21.5"
"Union","2020-09-04","10","5442","0","919","16.3","19.4"
"Union","2020-09-05","7","5449","0","919","16.3","18.6"
"Union","2020-09-06","38","5487","17","936","19.8","19"
"Union","2020-09-07","2","5489","0","936","16.1","16.6"
"Union","2020-09-08","30","5519","8","944","15.7","17.4"
"Union","2020-09-09","113","5632","48","992","19.7","18.9"
"Union","2020-09-10","86","5718","9","1001","17.8","19"
"Union","2020-09-11","76","5794","18","1019","21.1","18.7"
"Union","2020-09-12","63","5857","2","1021","21.6","19"
"Union","2020-09-13","37","5894","6","1027","17.5","18.7"
"Union","2020-09-14","36","5930","15","1042","23.5","19.8"
"Union","2020-09-15","40","5970","18","1060","26.1","20.9"
"Union","2020-09-16","148","6118","12","1072","21.2","20.5"
"Union","2020-09-17","50","6168","5","1077","21.1","19.4"
"Union","2020-09-18","57","6225","9","1086","20","20.6"
"Union","2020-09-19","96","6321","17","1103","22.1","21.8"
"Union","2020-09-20","22","6343","6","1109","23.6","20.6"
"Union","2020-09-21","41","6384","13","1122","22.2","22.9"
"Union","2020-09-22","31","6415","9","1131","19.9","23"
"Union","2020-09-23","133","6548","38","1169","22.9","22"
"Union","2020-09-24","6","6554","0","1169","21.4","21.3"
"Union","2020-09-25","132","6686","28","1197","22.2","21.1"
"Union","2020-09-26","83","6769","19","1216","23","22.5"
"Union","2020-09-27","0","6769","0","1216","19.1","21.4"
"Union","2020-09-28","59","6828","11","1227","17.2","19.7"
"Union","2020-09-29","31","6859","10","1237","17.7","18.8"
"Union","2020-09-30","103","6962","7","1244","14.5","18.7"
"Union","2020-10-01","89","7051","31","1275","19.5","20.5"
"Union","2020-10-02","52","7103","19","1294","21.7","22"
"Union","2020-10-03","36","7139","11","1305","22.8","22.9"
"Union","2020-10-04","3","7142","0","1305","22.8","20.9"
"Union","2020-10-05","89","7231","25","1330","24.2","20.7"
"Union","2020-10-06","36","7267","15","1345","25.5","21.6"
"Union","2020-10-07","14","7281","2","1347","26.6","20.6"
"Union","2020-10-08","13","7294","0","1347","21.6","20.6"
"Union","2020-10-09","10","7304","1","1348","17.8","19.8"
"Union","2020-10-10","5","7309","1","1349","16.3","19.5"
"Union","2020-10-11","5","7314","0","1349","16.3","19.5"
"Union","2020-10-12","24","7338","0","1349","12.3","18.2"
"Union","2020-10-13","14","7352","0","1349","6.3","15.9"
"Union","2020-10-14","15","7367","0","1349","4.3","15.4"
"Union","2020-10-15","10","7377","2","1351","7.1","14.4"
"Union","2020-10-16","12","7389","0","1351","5.7","11.8"
"Union","2020-10-17","3","7392","1","1352","7.6","12"
"Union","2020-10-18","3","7395","0","1352","7.6","12"
"Union","2020-10-19","16","7411","0","1352","7.6","9.9"
"Union","2020-10-20","9","7420","2","1354","10.8","8.6"
"Union","2020-10-21","25","7445","1","1355","11.4","7.8"
"Union","2020-10-22","18","7463","1","1356","9.3","8.2"
"Union","2020-10-23","15","7478","3","1359","12.2","8.9"
"Union","2020-10-24","1","7479","0","1359","7.4","7.5"
"Union","2020-10-25","3","7482","0","1359","7.4","7.5"
"Union","2020-10-26","18","7500","1","1360","8.2","7.9"
"Union","2020-10-27","17","7517","0","1360","5","7.9"
"Union","2020-10-28","10","7527","0","1360","4.4","7.9"
"Union","2020-10-29","13","7540","3","1363","6.9","8.1"
"Union","2020-10-30","17","7557","2","1365","5.8","9"
"Union","2020-10-31","7","7564","2","1367","9.9","8.6"
"Union","2020-11-01","5","7569","1","1368","12.7","10.1"
"Union","2020-11-02","26","7595","2","1370","13","10.6"
"Union","2020-11-03","15","7610","0","1370","13","9"
"Union","2020-11-04","19","7629","2","1372","14.5","9.5"
"Union","2020-11-05","20","7649","0","1372","11.2","9.1"
"Union","2020-11-06","15","7664","1","1373","10.5","8.1"
"Union","2020-11-07","71","7735","11","1384","8.6","9.2"
"Union","2020-11-08","6","7741","2","1386","10.5","11.6"
"Union","2020-11-09","15","7756","2","1388","11.3","12.2"
"Union","2020-11-10","28","7784","5","1393","13.9","13.5"
"Union","2020-11-11","17","7801","5","1398","16.6","15.6"
"Union","2020-11-12","24","7825","1","1399","17.2","14.2"
"Union","2020-11-13","26","7851","1","1400","16.8","13.6"
"Union","2020-11-14","74","7925","11","1411","16.7","12.7"
"Union","2020-11-15","3","7928","1","1412","16.7","13.6"
"Union","2020-11-16","19","7947","0","1412","14.8","13.1"
"Union","2020-11-17","38","7985","5","1417","14.1","14"
"Union","2020-11-18","32","8017","5","1422","12.1","14.4"
"Union","2020-11-19","33","8050","3","1425","12.8","15"
"Union","2020-11-20","24","8074","5","1430","15.3","16"
"Union","2020-11-21","156","8230","15","1445","14.5","15.6"
"Union","2020-11-22","8","8238","0","1445","9.8","13.2"
"Union","2020-11-23","32","8270","3","1448","11.1","12.9"
"Union","2020-11-24","36","8306","12","1460","14","14"
"Union","2020-11-25","48","8354","8","1468","14.1","13.1"
"Union","2020-11-26","5","8359","4","1472","24.3","18.6"
"Union","2020-11-27","61","8420","8","1480","23.2","19.2"
"Union","2020-11-28","56","8476","10","1490","24.3","19.4"
"Union","2020-11-29","13","8489","3","1493","27.6","18.7"
"Union","2020-11-30","27","8516","6","1499","29.5","20.3"
"Union","2020-12-01","75","8591","11","1510","26.8","20.4"
"Union","2020-12-02","62","8653","13","1523","27.4","20.8"
"Union","2020-12-03","96","8749","14","1537","18.1","21.2"
"Union","2020-12-04","78","8827","12","1549","18.4","20.8"
"Union","2020-12-05","156","8983","33","1582","18.9","21.6"
"Union","2020-12-06","22","9005","5","1587","18.8","23.2"
"Union","2020-12-07","53","9058","8","1595","17.8","23.6"
"Union","2020-12-08","69","9127","15","1610","18.8","22.8"
"Union","2020-12-09","53","9180","6","1616","17.4","22.4"
"Union","2020-12-10","125","9305","22","1638","17.9","18"
"Union","2020-12-11","48","9353","5","1643","17.2","17.8"
"Union","2020-12-12","202","9555","23","1666","15.8","17.3"
"Union","2020-12-13","36","9591","7","1673","15.3","17.1"
"Union","2020-12-14","42","9633","10","1683","16.5","17.2"
"Union","2020-12-15","105","9738","15","1698","15.5","17.1"
"Union","2020-12-16","128","9866","13","1711","15.3","16.4"
"Union","2020-12-17","89","9955","17","1728","15.5","16.7"
"Union","2020-12-18","101","10056","14","1742","16","16.6"
"Union","2020-12-19","203","10259","48","1790","17.8","16.8"
"Union","2020-12-20","33","10292","8","1798","18.4","16.9"
"Union","2020-12-21","60","10352","15","1813","18.6","17.6"
"Union","2020-12-22","90","10442","18","1831","19.4","17.4"
"Union","2020-12-23","105","10547","22","1853","21","18.1"
"Union","2020-12-24","101","10648","16","1869","20.5","18"
"Union","2020-12-25","1","10649","1","1870","32.8","24.4"
"Union","2020-12-26","15","10664","3","1873","32.3","25"
"Union","2020-12-27","35","10699","11","1884","33.3","25.9"
"Union","2020-12-28","80","10779","20","1904","33.3","26"
"Union","2020-12-29","105","10884","37","1941","35.5","27.5"
"Union","2020-12-30","126","11010","33","1974","36.2","28.6"
"Union","2020-12-31","141","11151","34","2008","37.4","29"
"Union","2021-01-01","33","11184","10","2018","27.5","30.1"
"Union","2021-01-02","76","11260","27","2045","29.7","31"
"Union","2021-01-03","44","11304","27","2072","34","33.6"
"Union","2021-01-04","54","11358","18","2090","35.2","34.2"
"Union","2021-01-05","92","11450","19","2109","33.1","34.3"
"Union","2021-01-06","221","11671","71","2180","33.9","35.1"
"Union","2021-01-07","119","11790","31","2211","34.2","35.8"
"Union","2021-01-08","95","11885","20","2231","32.9","30.2"
"Union","2021-01-09","60","11945","26","2257","34","31.8"
"Union","2021-01-10","50","11995","18","2275","30.4","32.2"
"Union","2021-01-11","67","12062","6","2281","26.9","31"
"Union","2021-01-12","77","12139","19","2300","27.5","30.3"
"Union","2021-01-13","75","12214","13","2313","25.3","29.6"
"Union","2021-01-14","37","12251","9","2322","25.1","29.6"
"Union","2021-01-15","117","12368","27","2349","25.4","29.1"
"Union","2021-01-16","78","12446","22","2371","23.2","28.6"
"Union","2021-01-17","17","12463","6","2377","23.1","26.7"
"Union","2021-01-18","24","12487","6","2383","25.4","26.1"
"Union","2021-01-19","59","12546","8","2391","23.8","25.6"
"Union","2021-01-20","86","12632","19","2410","24.5","24.9"
"Union","2021-01-21","53","12685","8","2418","23.2","24.1"
"Union","2021-01-22","68","12753","12","2430","22.4","23.9"
"Union","2021-01-23","8","12761","3","2433","23.7","23.5"
"Union","2021-01-24","77","12838","19","2452","22.2","22.7"
"Union","2021-01-25","72","12910","7","2459","20","22.7"
"Union","2021-01-26","54","12964","9","2468","20.5","22.2"
"Union","2021-01-27","91","13055","13","2481","19.4","21.9"
"Union","2021-01-28","72","13127","6","2487","18.4","20.8"
"Union","2021-01-29","54","13181","4","2491","16.9","19.7"
"Union","2021-01-30","15","13196","4","2495","15.4","19.6"
"Union","2021-01-31","69","13265","10","2505","13.9","18.1"
"Union","2021-02-01","30","13295","10","2515","17.3","18.7"
"Union","2021-02-02","72","13367","9","2524","16.7","18.6"
"Union","2021-02-03","82","13449","8","2532","16.1","17.7"
"Union","2021-02-04","68","13517","9","2541","16.8","17.6"
"Union","2021-02-05","16","13533","1","2542","16.6","16.8"
"Union","2021-02-06","1","13534","0","2542","12.8","14.1"
"Union","2021-02-07","0","13534","0","2542","10.7","12.3"
"Union","2021-02-08","0","13534","0","2542","6","11.6"
"Unknown","2020-02-01","0","0","0","0",".","."
"Unknown","2020-02-02","0","0","0","0",".","."
"Unknown","2020-02-03","0","0","0","0",".","."
"Unknown","2020-02-04","0","0","0","0",".","."
"Unknown","2020-02-05","0","0","0","0",".","."
"Unknown","2020-02-06","0","0","0","0",".","."
"Unknown","2020-02-07","0","0","0","0","0","."
"Unknown","2020-02-08","0","0","0","0","0","."
"Unknown","2020-02-09","0","0","0","0","0","."
"Unknown","2020-02-10","0","0","0","0","0","."
"Unknown","2020-02-11","0","0","0","0","0","."
"Unknown","2020-02-12","0","0","0","0","0","."
"Unknown","2020-02-13","0","0","0","0","0","."
"Unknown","2020-02-14","0","0","0","0","0","0"
"Unknown","2020-02-15","0","0","0","0","0","0"
"Unknown","2020-02-16","0","0","0","0","0","0"
"Unknown","2020-02-17","0","0","0","0","0","0"
"Unknown","2020-02-18","0","0","0","0","0","0"
"Unknown","2020-02-19","0","0","0","0","0","0"
"Unknown","2020-02-20","0","0","0","0","0","0"
"Unknown","2020-02-21","0","0","0","0","0","0"
"Unknown","2020-02-22","0","0","0","0","0","0"
"Unknown","2020-02-23","0","0","0","0","0","0"
"Unknown","2020-02-24","0","0","0","0","0","0"
"Unknown","2020-02-25","0","0","0","0","0","0"
"Unknown","2020-02-26","0","0","0","0","0","0"
"Unknown","2020-02-27","0","0","0","0","0","0"
"Unknown","2020-02-28","0","0","0","0","0","0"
"Unknown","2020-02-29","0","0","0","0","0","0"
"Unknown","2020-03-01","0","0","0","0","0","0"
"Unknown","2020-03-02","0","0","0","0","0","0"
"Unknown","2020-03-03","0","0","0","0","0","0"
"Unknown","2020-03-04","0","0","0","0","0","0"
"Unknown","2020-03-05","0","0","0","0","0","0"
"Unknown","2020-03-06","0","0","0","0","0","0"
"Unknown","2020-03-07","0","0","0","0","0","0"
"Unknown","2020-03-08","0","0","0","0","0","0"
"Unknown","2020-03-09","0","0","0","0","0","0"
"Unknown","2020-03-10","0","0","0","0","0","0"
"Unknown","2020-03-11","0","0","0","0","0","0"
"Unknown","2020-03-12","2","2","0","0","0","0"
"Unknown","2020-03-13","4","6","0","0","0","0"
"Unknown","2020-03-14","3","9","1","1","4.8","2.4"
"Unknown","2020-03-15","0","9","0","1","4.8","2.4"
"Unknown","2020-03-16","7","16","0","1","4.8","2.4"
"Unknown","2020-03-17","9","25","0","1","4.8","2.4"
"Unknown","2020-03-18","1","26","0","1","4.8","2.4"
"Unknown","2020-03-19","3","29","1","2","9.5","4.8"
"Unknown","2020-03-20","11","40","1","3","10.8","5.4"
"Unknown","2020-03-21","3","43","0","3","6.1","5.4"
"Unknown","2020-03-22","2","45","0","3","6.1","5.4"
"Unknown","2020-03-23","11","56","4","7","11.3","8"
"Unknown","2020-03-24","6","62","2","9","16","10.4"
"Unknown","2020-03-25","8","70","2","11","19.6","12.2"
"Unknown","2020-03-26","5","75","1","12","17.7","13.6"
"Unknown","2020-03-27","7","82","2","14","20.5","15.6"
"Unknown","2020-03-28","3","85","0","14","20.5","13.3"
"Unknown","2020-03-29","1","86","0","14","20.5","13.3"
"Unknown","2020-03-30","8","94","2","16","18.8","15"
"Unknown","2020-03-31","20","114","4","20","16.9","16.5"
"Unknown","2020-04-01","17","131","2","22","15","17.3"
"Unknown","2020-04-02","12","143","1","23","13.4","15.5"
"Unknown","2020-04-03","18","161","3","26","11.7","16.1"
"Unknown","2020-04-04","10","171","2","28","14.5","17.5"
"Unknown","2020-04-05","3","174","0","28","14.5","17.5"
"Unknown","2020-04-06","22","196","0","28","11","14.9"
"Unknown","2020-04-07","31","227","3","31","9.5","13.2"
"Unknown","2020-04-08","39","266","10","41","11.5","13.3"
"Unknown","2020-04-09","25","291","2","43","11.4","12.4"
"Unknown","2020-04-10","13","304","0","43","9","10.4"
"Unknown","2020-04-11","7","311","0","43","6.2","10.4"
"Unknown","2020-04-12","12","323","4","47","11","12.7"
"Unknown","2020-04-13","27","350","7","54","14.7","12.8"
"Unknown","2020-04-14","29","379","5","59","15.7","12.6"
"Unknown","2020-04-15","35","414","6","65","14.5","13"
"Unknown","2020-04-16","43","457","12","77","17.4","14.4"
"Unknown","2020-04-17","22","479","6","83","21.3","15.2"
"Unknown","2020-04-18","30","509","3","86","22.7","14.4"
"Unknown","2020-04-19","33","542","7","93","21","16"
"Unknown","2020-04-20","40","582","3","96","18.3","16.5"
"Unknown","2020-04-21","50","632","17","113","20.7","18.2"
"Unknown","2020-04-22","60","692","14","127","21.6","18.1"
"Unknown","2020-04-23","60","752","14","141","21","19.2"
"Unknown","2020-04-24","66","818","5","146","18.1","19.7"
"Unknown","2020-04-25","66","884","11","157","19.1","20.9"
"Unknown","2020-04-26","45","929","19","176","22.1","21.5"
"Unknown","2020-04-27","64","993","14","190","24.1","21.2"
"Unknown","2020-04-28","152","1145","106","296","29.2","25"
"Unknown","2020-04-29","94","1239","54","350","34.1","27.9"
"Unknown","2020-04-30","74","1313","33","383","37.2","29.1"
"Unknown","2020-05-01","75","1388","48","431","45.2","31.7"
"Unknown","2020-05-02","65","1453","48","479","53.4","36.2"
"Unknown","2020-05-03","53","1506","29","508","55.2","38.6"
"Unknown","2020-05-04","124","1630","81","589","61.4","42.8"
"Unknown","2020-05-05","41","1671","2","591","52.1","40.7"
"Unknown","2020-05-06","52","1723","9","600","46.4","40.3"
"Unknown","2020-05-07","66","1789","29","629","46.3","41.7"
"Unknown","2020-05-08","181","1970","154","783","49.3","47.3"
"Unknown","2020-05-09","66","2036","45","828","48.5","50.9"
"Unknown","2020-05-10","43","2079","28","856","50","52.6"
"Unknown","2020-05-11","60","2139","18","874","44.9","53.2"
"Unknown","2020-05-12","47","2186","16","890","49.1","50.6"
"Unknown","2020-05-13","44","2230","14","904","51.2","48.8"
"Unknown","2020-05-14","65","2295","2","906","45.3","45.8"
"Unknown","2020-05-15","56","2351","6","912","34.7","42"
"Unknown","2020-05-16","44","2395","5","917","26.6","37.5"
"Unknown","2020-05-17","34","2429","5","922","19.4","34.7"
"Unknown","2020-05-18","96","2525","15","937","17.3","31.1"
"Unknown","2020-05-19","62","2587","9","946","14.5","31.8"
"Unknown","2020-05-20","57","2644","6","952","11.5","31.3"
"Unknown","2020-05-21","42","2686","3","955","12.1","28.7"
"Unknown","2020-05-22","59","2745","1","956","10.8","22.8"
"Unknown","2020-05-23","13","2758","0","956","9.2","17.9"
"Unknown","2020-05-24","13","2771","3","959","10.4","14.9"
"Unknown","2020-05-25","14","2785","0","959","8.1","12.7"
"Unknown","2020-05-26","50","2835","3","962","6.9","10.7"
"Unknown","2020-05-27","23","2858","1","963","6","8.8"
"Unknown","2020-05-28","46","2904","0","963","5","8.6"
"Unknown","2020-05-29","52","2956","9","972","7.2","9"
"Unknown","2020-05-30","26","2982","1","973","7.8","8.5"
"Unknown","2020-05-31","17","2999","0","973","4.5","7.4"
"Unknown","2020-06-01","63","3062","5","978","5.6","6.9"
"Unknown","2020-06-02","67","3129","7","985","6.3","6.6"
"Unknown","2020-06-03","90","3219","5","990","6.4","6.2"
"Unknown","2020-06-04","40","3259","2","992","7.2","6.1"
"Unknown","2020-06-05","58","3317","5","997","5.9","6.6"
"Unknown","2020-06-06","29","3346","0","997","5.4","6.6"
"Unknown","2020-06-07","19","3365","3","1000","7.6","6.1"
"Unknown","2020-06-08","43","3408","4","1004","7.8","6.7"
"Unknown","2020-06-09","52","3460","7","1011","8.2","7.3"
"Unknown","2020-06-10","38","3498","2","1013","8.2","7.3"
"Unknown","2020-06-11","38","3536","3","1016","8.6","7.9"
"Unknown","2020-06-12","39","3575","4","1020","8.9","7.4"
"Unknown","2020-06-13","24","3599","0","1020","8.9","7.1"
"Unknown","2020-06-14","9","3608","1","1021","8.2","7.9"
"Unknown","2020-06-15","48","3656","6","1027","8.6","8.2"
"Unknown","2020-06-16","52","3708","3","1030","7.5","7.9"
"Unknown","2020-06-17","32","3740","4","1034","8.6","8.4"
"Unknown","2020-06-18","48","3788","2","1036","8","8.3"
"Unknown","2020-06-19","51","3839","6","1042","8.3","8.6"
"Unknown","2020-06-20","9","3848","0","1042","8.3","8.6"
"Unknown","2020-06-21","4","3852","0","1042","6.7","7.4"
"Unknown","2020-06-22","118","3970","11","1053","6.2","7.4"
"Unknown","2020-06-23","79","4049","6","1059","6.5","7"
"Unknown","2020-06-24","130","4179","24","1083","7.3","8"
"Unknown","2020-06-25","75","4254","1","1084","6.9","7.5"
"Unknown","2020-06-26","62","4316","10","1094","7.5","7.9"
"Unknown","2020-06-27","36","4352","13","1107","12.7","10.5"
"Unknown","2020-06-28","19","4371","4","1111","15.7","11.2"
"Unknown","2020-06-29","85","4456","10","1121","16.1","11.1"
"Unknown","2020-06-30","130","4586","13","1134","16.4","11.4"
"Unknown","2020-07-01","126","4712","7","1141","14.6","10.9"
"Unknown","2020-07-02","115","4827","13","1154","16","11.5"
"Unknown","2020-07-03","155","4982","17","1171","15.3","11.4"
"Unknown","2020-07-04","40","5022","2","1173","10.8","11.8"
"Unknown","2020-07-05","32","5054","4","1177","9.6","12.6"
"Unknown","2020-07-06","100","5154","14","1191","9.9","13"
"Unknown","2020-07-07","79","5233","18","1209","11.7","14.1"
"Unknown","2020-07-08","93","5326","19","1228","13.9","14.2"
"Unknown","2020-07-09","91","5417","17","1245","14.9","15.4"
"Unknown","2020-07-10","65","5482","7","1252","14.9","15.1"
"Unknown","2020-07-11","39","5521","5","1257","16","13.4"
"Unknown","2020-07-12","46","5567","21","1278","20.7","15.2"
"Unknown","2020-07-13","91","5658","12","1290","20.6","15.3"
"Unknown","2020-07-14","292","5950","23","1313","18.5","15.1"
"Unknown","2020-07-15","196","6146","16","1329","16.7","15.3"
"Unknown","2020-07-16","344","6490","22","1351","15","14.9"
"Unknown","2020-07-17","377","6867","29","1380","14.5","14.7"
"Unknown","2020-07-18","325","7192","29","1409","14","15"
"Unknown","2020-07-19","28","7220","8","1417","11.5","16.1"
"Unknown","2020-07-20","167","7387","25","1442","11.8","16.2"
"Unknown","2020-07-21","86","7473","10","1452","12.3","15.4"
"Unknown","2020-07-22","77","7550","16","1468","14.1","15.4"
"Unknown","2020-07-23","227","7777","14","1482","14.1","14.5"
"Unknown","2020-07-24","197","7974","30","1512","15.2","14.9"
"Unknown","2020-07-25","150","8124","13","1525","15.1","14.6"
"Unknown","2020-07-26","52","8176","11","1536","14.1","12.8"
"Unknown","2020-07-27","99","8275","14","1550","14","12.9"
"Unknown","2020-07-28","324","8599","25","1575","13.4","12.9"
"Unknown","2020-07-29","408","9007","19","1594","11.1","12.6"
"Unknown","2020-07-30","348","9355","29","1623","11.4","12.8"
"Unknown","2020-07-31","795","10150","22","1645","9.6","12.4"
"Unknown","2020-08-01","165","10315","6","1651","8.9","12"
"Unknown","2020-08-02","195","10510","3","1654","6.1","10.1"
"Unknown","2020-08-03","290","10800","17","1671","4.9","9.4"
"Unknown","2020-08-04","302","11102","15","1686","4.5","9"
"Unknown","2020-08-05","797","11899","27","1713","4.4","7.7"
"Unknown","2020-08-06","368","12267","21","1734","4","7.7"
"Unknown","2020-08-07","400","12667","18","1752","4.2","6.9"
"Unknown","2020-08-08","441","13108","7","1759","3.9","6.4"
"Unknown","2020-08-09","26","13134","6","1765","7","6.6"
"Unknown","2020-08-10","480","13614","16","1781","6.7","5.8"
"Unknown","2020-08-11","317","13931","12","1793","6.5","5.5"
"Unknown","2020-08-12","214","14145","12","1805","6.8","5.6"
"Unknown","2020-08-13","264","14409","6","1811","6.3","5.1"
"Unknown","2020-08-14","231","14640","11","1822","6.3","5.3"
"Unknown","2020-08-15","131","14771","10","1832","7.2","5.6"
"Unknown","2020-08-16","36","14807","2","1834","4.7","5.9"
"Unknown","2020-08-17","225","15032","7","1841","4.7","5.7"
"Unknown","2020-08-18","382","15414","14","1855","4.7","5.6"
"Unknown","2020-08-19","397","15811","7","1862","4.1","5.5"
"Unknown","2020-08-20","232","16043","13","1875","4.6","5.4"
"Unknown","2020-08-21","472","16515","15","1890","4.4","5.4"
"Unknown","2020-08-22","752","17267","13","1903","3.5","5.4"
"Unknown","2020-08-23","55","17322","7","1910","4.5","4.6"
"Unknown","2020-08-24","228","17550","18","1928","5.2","4.9"
"Unknown","2020-08-25","256","17806","12","1940","5.4","5"
"Unknown","2020-08-26","2152","19958","59","1999","5.5","4.8"
"Unknown","2020-08-27","729","20687","26","2025","5.2","4.9"
"Unknown","2020-08-28","1219","21906","11","2036","4.9","4.6"
"Unknown","2020-08-29","448","22354","5","2041","4.8","4.2"
"Unknown","2020-08-30","17","22371","2","2043","4.7","4.6"
"Unknown","2020-08-31","95","22466","1","2044","3.7","4.5"
"Unknown","2020-09-01","272","22738","6","2050","3.3","4.4"
"Unknown","2020-09-02","256","22994","5","2055","3.2","4.4"
"Unknown","2020-09-03","389","23383","19","2074","3.4","4.3"
"Unknown","2020-09-04","179","23562","4","2078","3.6","4.2"
"Unknown","2020-09-05","67","23629","6","2084","4.7","4.8"
"Unknown","2020-09-06","4","23633","2","2086","10.2","7.4"
"Unknown","2020-09-07","61","23694","2","2088","10.5","7.1"
"Unknown","2020-09-08","168","23862","7","2095","10.8","7.1"
"Unknown","2020-09-09","222","24084","6","2101","10.9","7.1"
"Unknown","2020-09-10","336","24420","11","2112","10.7","7"
"Unknown","2020-09-11","175","24595","7","2119","10.9","7.3"
"Unknown","2020-09-12","95","24690","5","2124","10.4","7.6"
"Unknown","2020-09-13","184","24874","23","2147","5","7.6"
"Unknown","2020-09-14","209","25083","6","2153","5","7.7"
"Unknown","2020-09-15","216","25299","8","2161","4.9","7.8"
"Unknown","2020-09-16","355","25654","15","2176","5.1","8"
"Unknown","2020-09-17","290","25944","9","2185","5.1","7.9"
"Unknown","2020-09-18","193","26137","2","2187","4.7","7.8"
"Unknown","2020-09-19","54","26191","1","2188","4.2","7.3"
"Unknown","2020-09-20","59","26250","14","2202","5.8","5.4"
"Unknown","2020-09-21","260","26510","23","2225","6.6","5.8"
"Unknown","2020-09-22","44","26554","2","2227","6.8","5.8"
"Unknown","2020-09-23","44","26598","4","2231","7.5","6.3"
"Unknown","2020-09-24","132","26730","5","2236","7.6","6.3"
"Unknown","2020-09-25","110","26840","5","2241","8.1","6.4"
"Unknown","2020-09-26","8","26848","0","2241","7.8","6"
"Unknown","2020-09-27","16","26864","2","2243","6.2","6"
"Unknown","2020-09-28","97","26961","2","2245","5.2","5.9"
"Unknown","2020-09-29","30","26991","0","2245","4.6","5.7"
"Unknown","2020-09-30","561","27552","37","2282","4.2","5.8"
"Unknown","2020-10-01","798","28350","11","2293","3.9","5.7"
"Unknown","2020-10-02","270","28620","4","2297","3.4","5.7"
"Unknown","2020-10-03","82","28702","6","2303","4.5","6.1"
"Unknown","2020-10-04","12","28714","0","2303","2.7","4.4"
"Unknown","2020-10-05","902","29616","2","2305","2.4","3.8"
"Unknown","2020-10-06","631","30247","4","2309","2.5","3.5"
"Unknown","2020-10-07","236","30483","6","2315","1.9","3.1"
"Unknown","2020-10-08","314","30797","10","2325","2.2","3"
"Unknown","2020-10-09","153","30950","6","2331","2.5","3"
"Unknown","2020-10-10","61","31011","4","2335","2.4","3.5"
"Unknown","2020-10-11","8","31019","2","2337","6","4.3"
"Unknown","2020-10-12","115","31134","3","2340","6.3","4.4"
"Unknown","2020-10-13","184","31318","4","2344","6.6","4.5"
"Unknown","2020-10-14","149","31467","10","2354","7.2","4.6"
"Unknown","2020-10-15","220","31687","2","2356","6.8","4.5"
"Unknown","2020-10-16","107","31794","3","2359","6.7","4.6"
"Unknown","2020-10-17","240","32034","4","2363","6","4.2"
"Unknown","2020-10-18","7","32041","1","2364","4.5","5.2"
"Unknown","2020-10-19","141","32182","4","2368","4.5","5.4"
"Unknown","2020-10-20","184","32366","5","2373","4.6","5.6"
"Unknown","2020-10-21","184","32550","6","2379","4.1","5.6"
"Unknown","2020-10-22","37","32587","4","2383","5.5","6.2"
"Unknown","2020-10-23","26","32613","3","2386","6.7","6.7"
"Unknown","2020-10-24","91","32704","4","2390","7.1","6.6"
"Unknown","2020-10-25","9","32713","1","2391","6.7","5.6"
"Unknown","2020-10-26","50","32763","6","2397","8","6.2"
"Unknown","2020-10-27","262","33025","4","2401","7.8","6.2"
"Unknown","2020-10-28","341","33366","12","2413","7.8","6"
"Unknown","2020-10-29","65","33431","6","2419","7.6","6.6"
"Unknown","2020-10-30","213","33644","3","2422","6.2","6.5"
"Unknown","2020-10-31","401","34045","36","2458","6.8","7"
"Unknown","2020-11-01","14","34059","3","2461","8.3","7.5"
"Unknown","2020-11-02","163","34222","8","2469","7.3","7.6"
"Unknown","2020-11-03","221","34443","2","2471","7.2","7.5"
"Unknown","2020-11-04","181","34624","2","2473","6.9","7.3"
"Unknown","2020-11-05","146","34770","6","2479","6.1","6.9"
"Unknown","2020-11-06","207","34977","12","2491","6.7","6.5"
"Unknown","2020-11-07","78","35055","2","2493","5.8","6.3"
"Unknown","2020-11-08","33","35088","3","2496","4.1","6.2"
"Unknown","2020-11-09","137","35225","7","2503","4.1","5.7"
"Unknown","2020-11-10","276","35501","7","2510","4.3","5.8"
"Unknown","2020-11-11","155","35656","16","2526","5.6","6.2"
"Unknown","2020-11-12","202","35858","11","2537","5.8","6"
"Unknown","2020-11-13","178","36036","9","2546","5.7","6.2"
"Unknown","2020-11-14","91","36127","6","2552","6.3","6.1"
"Unknown","2020-11-15","4","36131","1","2553","8.6","6.3"
"Unknown","2020-11-16","111","36242","8","2561","8.9","6.5"
"Unknown","2020-11-17","282","36524","25","2586","9.8","7.1"
"Unknown","2020-11-18","155","36679","13","2599","9.5","7.6"
"Unknown","2020-11-19","221","36900","10","2609","9.4","7.6"
"Unknown","2020-11-20","113","37013","9","2618","9.8","7.8"
"Unknown","2020-11-21","79","37092","7","2625","10.1","8.2"
"Unknown","2020-11-22","11","37103","2","2627","9.1","8.9"
"Unknown","2020-11-23","176","37279","10","2637","8.9","8.9"
"Unknown","2020-11-24","307","37586","8","2645","8","8.9"
"Unknown","2020-11-25","185","37771","15","2660","8","8.7"
"Unknown","2020-11-26","19","37790","1","2661","8.1","8.7"
"Unknown","2020-11-27","71","37861","11","2672","9.2","9.5"
"Unknown","2020-11-28","98","37959","13","2685","9.8","10"
"Unknown","2020-11-29","7","37966","1","2686","9.2","9.2"
"Unknown","2020-11-30","219","38185","17","2703","9.5","9.2"
"Unknown","2020-12-01","206","38391","31","2734","11.3","9.7"
"Unknown","2020-12-02","261","38652","12","2746","10.8","9.4"
"Unknown","2020-12-03","207","38859","21","2767","11.5","9.8"
"Unknown","2020-12-04","158","39017","12","2779","10.4","9.8"
"Unknown","2020-12-05","404","39421","28","2807","9.5","9.6"
"Unknown","2020-12-06","5","39426","1","2808","10.3","9.8"
"Unknown","2020-12-07","95","39521","4","2812","9.8","9.7"
"Unknown","2020-12-08","259","39780","18","2830","8.6","10"
"Unknown","2020-12-09","419","40199","20","2850","8.7","9.7"
"Unknown","2020-12-10","277","40476","11","2861","7.8","9.6"
"Unknown","2020-12-11","110","40586","14","2875","8.5","9.4"
"Unknown","2020-12-12","402","40988","21","2896","8.3","8.9"
"Unknown","2020-12-13","16","41004","7","2903","11.7","11"
"Unknown","2020-12-14","282","41286","24","2927","12.3","11"
"Unknown","2020-12-15","399","41685","36","2963","12.6","10.6"
"Unknown","2020-12-16","319","42004","27","2990","13.1","10.9"
"Unknown","2020-12-17","686","42690","50","3040","13.6","10.7"
"Unknown","2020-12-18","674","43364","65","3105","13.1","10.8"
"Unknown","2020-12-19","410","43774","23","3128","13.2","10.7"
"Unknown","2020-12-20","102","43876","8","3136","8.1","9.9"
"Unknown","2020-12-21","167","44043","17","3153","8.3","10.3"
"Unknown","2020-12-22","412","44455","33","3186","8.1","10.4"
"Unknown","2020-12-23","649","45104","65","3251","8.4","10.7"
"Unknown","2020-12-24","769","45873","53","3304","8.3","10.9"
"Unknown","2020-12-25","48","45921","9","3313","9.6","11.4"
"Unknown","2020-12-26","308","46229","28","3341","10.1","11.6"
"Unknown","2020-12-27","37","46266","5","3346","10.9","9.5"
"Unknown","2020-12-28","265","46531","50","3396","12.2","10.2"
"Unknown","2020-12-29","234","46765","34","3430","13.1","10.6"
"Unknown","2020-12-30","658","47423","45","3475","12.6","10.5"
"Unknown","2020-12-31","664","48087","64","3539","13","10.7"
"Unknown","2021-01-01","8","48095","2","3541","13.9","11.8"
"Unknown","2021-01-02","121","48216","23","3564","15.3","12.7"
"Unknown","2021-01-03","73","48289","4","3568","14.2","12.6"
"Unknown","2021-01-04","210","48499","19","3587","12.8","12.5"
"Unknown","2021-01-05","390","48889","55","3642","12.7","12.9"
"Unknown","2021-01-06","700","49589","74","3716","13.3","13"
"Unknown","2021-01-07","840","50429","54","3770","12.8","12.9"
"Unknown","2021-01-08","376","50805","59","3829","11.5","12.7"
"Unknown","2021-01-09","247","51052","14","3843","9.6","12.5"
"Unknown","2021-01-10","36","51088","12","3855","13.5","13.9"
"Unknown","2021-01-11","162","51250","17","3872","13.8","13.3"
"Unknown","2021-01-12","491","51741","46","3918","13.1","12.9"
"Unknown","2021-01-13","535","52276","49","3967","12.9","13.1"
"Unknown","2021-01-14","444","52720","47","4014","13.5","13.1"
"Unknown","2021-01-15","370","53090","41","4055","12.8","12.1"
"Unknown","2021-01-16","215","53305","20","4075","13.3","11.5"
"Unknown","2021-01-17","28","53333","9","4084","13.2","13.4"
"Unknown","2021-01-18","316","53649","14","4098","12.3","13"
"Unknown","2021-01-19","275","53924","17","4115","11.8","12.5"
"Unknown","2021-01-20","466","54390","49","4164","12","12.5"
"Unknown","2021-01-21","525","54915","30","4194","11.3","12.4"
"Unknown","2021-01-22","354","55269","16","4210","10.4","11.6"
"Unknown","2021-01-23","482","55751","30","4240","10","11.6"
"Unknown","2021-01-24","29","55780","12","4252","11.3","12.2"
"Unknown","2021-01-25","203","55983","16","4268","11.8","12"
"Unknown","2021-01-26","408","56391","41","4309","12.3","12.1"
"Unknown","2021-01-27","342","56733","29","4338","12","12"
"Unknown","2021-01-28","614","57347","37","4375","12.1","11.7"
"Unknown","2021-01-29","345","57692","14","4389","12","11.2"
"Unknown","2021-01-30","276","57968","18","4407","12.1","11"
"Unknown","2021-01-31","38","58006","5","4412","8","9.7"
"Unknown","2021-02-01","168","58174","6","4418","7.4","9.6"
"Unknown","2021-02-02","287","58461","23","4441","7.1","9.7"
"Unknown","2021-02-03","229","58690","11","4452","6.6","9.3"
"Unknown","2021-02-04","144","58834","15","4467","7.2","9.7"
"Unknown","2021-02-05","23","58857","3","4470","8.5","10.3"
"Unknown","2021-02-06","6","58863","0","4470","7.6","9.8"
"Unknown","2021-02-07","3","58866","1","4471","10.5","9.2"
"Unknown","2021-02-08","0","58866","0","4471","9.9","8.7"
"Upson","2020-02-01","0","0","0","0",".","."
"Upson","2020-02-02","0","0","0","0",".","."
"Upson","2020-02-03","0","0","0","0",".","."
"Upson","2020-02-04","0","0","0","0",".","."
"Upson","2020-02-05","0","0","0","0",".","."
"Upson","2020-02-06","0","0","0","0",".","."
"Upson","2020-02-07","0","0","0","0","0","."
"Upson","2020-02-08","0","0","0","0","0","."
"Upson","2020-02-09","0","0","0","0","0","."
"Upson","2020-02-10","0","0","0","0","0","."
"Upson","2020-02-11","0","0","0","0","0","."
"Upson","2020-02-12","0","0","0","0","0","."
"Upson","2020-02-13","0","0","0","0","0","."
"Upson","2020-02-14","0","0","0","0","0","0"
"Upson","2020-02-15","0","0","0","0","0","0"
"Upson","2020-02-16","0","0","0","0","0","0"
"Upson","2020-02-17","0","0","0","0","0","0"
"Upson","2020-02-18","0","0","0","0","0","0"
"Upson","2020-02-19","0","0","0","0","0","0"
"Upson","2020-02-20","0","0","0","0","0","0"
"Upson","2020-02-21","0","0","0","0","0","0"
"Upson","2020-02-22","0","0","0","0","0","0"
"Upson","2020-02-23","0","0","0","0","0","0"
"Upson","2020-02-24","0","0","0","0","0","0"
"Upson","2020-02-25","0","0","0","0","0","0"
"Upson","2020-02-26","0","0","0","0","0","0"
"Upson","2020-02-27","0","0","0","0","0","0"
"Upson","2020-02-28","0","0","0","0","0","0"
"Upson","2020-02-29","0","0","0","0","0","0"
"Upson","2020-03-01","0","0","0","0","0","0"
"Upson","2020-03-02","0","0","0","0","0","0"
"Upson","2020-03-03","0","0","0","0","0","0"
"Upson","2020-03-04","0","0","0","0","0","0"
"Upson","2020-03-05","0","0","0","0","0","0"
"Upson","2020-03-06","0","0","0","0","0","0"
"Upson","2020-03-07","0","0","0","0","0","0"
"Upson","2020-03-08","0","0","0","0","0","0"
"Upson","2020-03-09","0","0","0","0","0","0"
"Upson","2020-03-10","4","4","0","0","0","0"
"Upson","2020-03-11","12","16","0","0","0","0"
"Upson","2020-03-12","14","30","0","0","0","0"
"Upson","2020-03-13","8","38","0","0","0","0"
"Upson","2020-03-14","0","38","0","0","0","0"
"Upson","2020-03-15","0","38","0","0","0","0"
"Upson","2020-03-16","12","50","2","2","2.4","1.2"
"Upson","2020-03-17","7","57","0","2","2.4","1.2"
"Upson","2020-03-18","11","68","2","4","5","2.5"
"Upson","2020-03-19","11","79","0","4","5","2.5"
"Upson","2020-03-20","5","84","0","4","5","2.5"
"Upson","2020-03-21","4","88","0","4","5","2.5"
"Upson","2020-03-22","3","91","0","4","5","2.5"
"Upson","2020-03-23","14","105","2","6","4.6","3.5"
"Upson","2020-03-24","8","113","2","8","8.2","5.3"
"Upson","2020-03-25","12","125","3","11","9.2","7.1"
"Upson","2020-03-26","11","136","5","16","15.7","10.3"
"Upson","2020-03-27","6","142","1","17","18.1","11.5"
"Upson","2020-03-28","14","156","3","20","21.1","13"
"Upson","2020-03-29","3","159","0","20","21.1","13"
"Upson","2020-03-30","7","166","2","22","23.2","13.9"
"Upson","2020-03-31","16","182","3","25","22.3","15.2"
"Upson","2020-04-01","14","196","3","28","21.8","15.5"
"Upson","2020-04-02","31","227","9","37","19.4","17.5"
"Upson","2020-04-03","37","264","8","45","20.1","19.1"
"Upson","2020-04-04","49","313","19","64","22.6","21.9"
"Upson","2020-04-05","4","317","0","64","22.6","21.9"
"Upson","2020-04-06","19","336","4","68","21.5","22.3"
"Upson","2020-04-07","69","405","16","84","22.2","22.2"
"Upson","2020-04-08","48","453","11","95","22.4","22.1"
"Upson","2020-04-09","49","502","13","108","22","20.7"
"Upson","2020-04-10","40","542","9","117","22.1","21.1"
"Upson","2020-04-11","25","567","5","122","19.5","21"
"Upson","2020-04-12","8","575","3","125","24.8","23.7"
"Upson","2020-04-13","36","611","10","135","25.8","23.6"
"Upson","2020-04-14","48","659","18","153","27.8","25"
"Upson","2020-04-15","99","758","37","190","29.9","26.1"
"Upson","2020-04-16","51","809","14","204","30","26"
"Upson","2020-04-17","39","848","9","213","30.1","26.1"
"Upson","2020-04-18","30","878","7","220","30.6","25"
"Upson","2020-04-19","6","884","1","221","27.6","26.2"
"Upson","2020-04-20","110","994","15","236","25.6","25.7"
"Upson","2020-04-21","143","1137","16","252","21.8","24.8"
"Upson","2020-04-22","122","1259","11","263","17.8","23.8"
"Upson","2020-04-23","69","1328","6","269","15.1","22.6"
"Upson","2020-04-24","113","1441","11","280","13.2","21.6"
"Upson","2020-04-25","30","1471","4","284","11.8","21.2"
"Upson","2020-04-26","22","1493","6","290","13.3","20.4"
"Upson","2020-04-27","73","1566","8","298","12.9","19.2"
"Upson","2020-04-28","60","1626","1","299","11.5","16.7"
"Upson","2020-04-29","111","1737","19","318","12.7","15.2"
"Upson","2020-04-30","77","1814","10","328","13.3","14.2"
"Upson","2020-05-01","45","1859","8","336","14.4","13.8"
"Upson","2020-05-02","27","1886","7","343","16.2","14"
"Upson","2020-05-03","7","1893","0","343","12.3","12.8"
"Upson","2020-05-04","57","1950","9","352","13","13"
"Upson","2020-05-05","92","2042","10","362","14.4","12.9"
"Upson","2020-05-06","30","2072","2","364","12.9","12.8"
"Upson","2020-05-07","108","2180","2","366","11.3","12.3"
"Upson","2020-05-08","27","2207","2","368","9.8","12.1"
"Upson","2020-05-09","62","2269","2","370","6.5","11.4"
"Upson","2020-05-10","5","2274","1","371","9.4","10.9"
"Upson","2020-05-11","39","2313","2","373","7.9","10.5"
"Upson","2020-05-12","220","2533","10","383","7","10.7"
"Upson","2020-05-13","63","2596","4","387","6.9","9.9"
"Upson","2020-05-14","207","2803","9","396","7.3","9.3"
"Upson","2020-05-15","110","2913","13","409","7.9","8.9"
"Upson","2020-05-16","77","2990","3","412","8","7.3"
"Upson","2020-05-17","4","2994","1","413","8.7","9.1"
"Upson","2020-05-18","25","3019","2","415","9.1","8.5"
"Upson","2020-05-19","125","3144","6","421","9.2","8.1"
"Upson","2020-05-20","38","3182","2","423","9","8"
"Upson","2020-05-21","155","3337","11","434","9.4","8.3"
"Upson","2020-05-22","39","3376","4","438","9.2","8.6"
"Upson","2020-05-23","12","3388","0","438","8.6","8.3"
"Upson","2020-05-24","7","3395","0","438","5.1","6.9"
"Upson","2020-05-25","4","3399","1","439","7.5","8.3"
"Upson","2020-05-26","101","3500","1","440","6.9","8.1"
"Upson","2020-05-27","51","3551","2","442","6.8","7.9"
"Upson","2020-05-28","115","3666","4","446","6.2","7.8"
"Upson","2020-05-29","85","3751","5","451","5.6","7.4"
"Upson","2020-05-30","31","3782","4","455","7.5","8"
"Upson","2020-05-31","4","3786","0","455","7.5","6.3"
"Upson","2020-06-01","24","3810","1","456","4.5","6"
"Upson","2020-06-02","116","3926","3","459","4.7","5.8"
"Upson","2020-06-03","61","3987","3","462","4.8","5.8"
"Upson","2020-06-04","92","4079","1","463","4.5","5.4"
"Upson","2020-06-05","30","4109","2","465","4.6","5.1"
"Upson","2020-06-06","21","4130","2","467","4.1","5.8"
"Upson","2020-06-07","6","4136","0","467","4.1","5.8"
"Upson","2020-06-08","27","4163","4","471","5.7","5.1"
"Upson","2020-06-09","72","4235","5","476","6.3","5.5"
"Upson","2020-06-10","34","4269","1","477","6","5.4"
"Upson","2020-06-11","93","4362","6","483","6.8","5.6"
"Upson","2020-06-12","30","4392","2","485","6.8","5.7"
"Upson","2020-06-13","8","4400","2","487","9","6.6"
"Upson","2020-06-14","4","4404","0","487","9","6.6"
"Upson","2020-06-15","41","4445","3","490","7.9","6.8"
"Upson","2020-06-16","97","4542","13","503","8.8","7.6"
"Upson","2020-06-17","48","4590","7","510","10.5","8.2"
"Upson","2020-06-18","114","4704","11","521","10.9","8.9"
"Upson","2020-06-19","25","4729","2","523","11.1","8.9"
"Upson","2020-06-20","26","4755","2","525","8.7","8.8"
"Upson","2020-06-21","9","4764","1","526","10.3","9.6"
"Upson","2020-06-22","41","4805","5","531","10.9","9.4"
"Upson","2020-06-23","108","4913","5","536","9.7","9.3"
"Upson","2020-06-24","40","4953","5","541","9.4","9.9"
"Upson","2020-06-25","35","4988","2","543","8.8","9.9"
"Upson","2020-06-26","157","5145","9","552","8.5","9.8"
"Upson","2020-06-27","45","5190","6","558","9.3","9"
"Upson","2020-06-28","5","5195","0","558","7.7","9"
"Upson","2020-06-29","41","5236","2","560","6.7","8.8"
"Upson","2020-06-30","53","5289","5","565","7.4","8.5"
"Upson","2020-07-01","129","5418","7","572","6.4","7.9"
"Upson","2020-07-02","35","5453","1","573","6","7.4"
"Upson","2020-07-03","22","5475","0","573","5.1","6.8"
"Upson","2020-07-04","10","5485","0","573","3.2","6.3"
"Upson","2020-07-05","12","5497","2","575","5.6","6.7"
"Upson","2020-07-06","27","5524","1","576","5.4","6.1"
"Upson","2020-07-07","46","5570","0","576","4.1","5.7"
"Upson","2020-07-08","95","5665","4","580","3.9","5.1"
"Upson","2020-07-09","50","5715","1","581","3.8","4.9"
"Upson","2020-07-10","21","5736","1","582","4.5","4.8"
"Upson","2020-07-11","23","5759","3","585","6.3","4.8"
"Upson","2020-07-12","18","5777","4","589","7.1","6.4"
"Upson","2020-07-13","47","5824","2","591","7.2","6.3"
"Upson","2020-07-14","40","5864","3","594","8.3","6.2"
"Upson","2020-07-15","158","6022","5","599","8.1","6"
"Upson","2020-07-16","34","6056","4","603","9.5","6.7"
"Upson","2020-07-17","34","6090","8","611","12.2","8.3"
"Upson","2020-07-18","24","6114","4","615","12.7","9.5"
"Upson","2020-07-19","15","6129","6","621","15.3","11.2"
"Upson","2020-07-20","138","6267","5","626","15.2","11.2"
"Upson","2020-07-21","23","6290","0","626","14.1","11.2"
"Upson","2020-07-22","156","6446","6","632","14.2","11.2"
"Upson","2020-07-23","43","6489","4","636","13.9","11.7"
"Upson","2020-07-24","38","6527","7","643","13.1","12.7"
"Upson","2020-07-25","136","6663","11","654","11.9","12.3"
"Upson","2020-07-26","19","6682","2","656","7.7","11.5"
"Upson","2020-07-27","53","6735","3","659","8","11.6"
"Upson","2020-07-28","41","6776","2","661","8.7","11.4"
"Upson","2020-07-29","151","6927","6","667","8.7","11.4"
"Upson","2020-07-30","41","6968","5","672","9.1","11.5"
"Upson","2020-07-31","42","7010","9","681","9.5","11.3"
"Upson","2020-08-01","40","7050","2","683","9.1","10.5"
"Upson","2020-08-02","23","7073","3","686","9.5","8.6"
"Upson","2020-08-03","70","7143","4","690","9.5","8.7"
"Upson","2020-08-04","71","7214","6","696","10","9.3"
"Upson","2020-08-05","163","7377","14","710","10.6","9.7"
"Upson","2020-08-06","41","7418","5","715","10.6","9.9"
"Upson","2020-08-07","60","7478","3","718","8.3","8.9"
"Upson","2020-08-08","30","7508","4","722","9.5","9.3"
"Upson","2020-08-09","36","7544","18","740","14.8","12.1"
"Upson","2020-08-10","38","7582","8","748","16.9","13.2"
"Upson","2020-08-11","33","7615","2","750","16.6","13.3"
"Upson","2020-08-12","139","7754","13","763","16.7","13.7"
"Upson","2020-08-13","32","7786","3","766","16.3","13.5"
"Upson","2020-08-14","30","7816","1","767","16.1","12.2"
"Upson","2020-08-15","36","7852","4","771","15.8","12.6"
"Upson","2020-08-16","28","7880","8","779","12.7","13.7"
"Upson","2020-08-17","29","7909","5","784","12.1","14.5"
"Upson","2020-08-18","42","7951","3","787","12.3","14.5"
"Upson","2020-08-19","102","8053","10","797","12.4","14.5"
"Upson","2020-08-20","38","8091","0","797","11","13.7"
"Upson","2020-08-21","34","8125","4","801","12.2","14.2"
"Upson","2020-08-22","38","8163","8","809","13.7","14.7"
"Upson","2020-08-23","19","8182","6","815","14.1","13.4"
"Upson","2020-08-24","41","8223","5","820","13.4","12.8"
"Upson","2020-08-25","30","8253","2","822","13.3","12.8"
"Upson","2020-08-26","98","8351","6","828","12.8","12.6"
"Upson","2020-08-27","31","8382","5","833","15.1","13.1"
"Upson","2020-08-28","48","8430","10","843","16.4","14.3"
"Upson","2020-08-29","22","8452","5","848","16.6","15.1"
"Upson","2020-08-30","16","8468","2","850","13.9","14"
"Upson","2020-08-31","34","8502","3","853","13.4","13.4"
"Upson","2020-09-01","54","8556","4","857","13.5","13.4"
"Upson","2020-09-02","104","8660","8","865","13.7","13.2"
"Upson","2020-09-03","44","8704","3","868","12.4","13.7"
"Upson","2020-09-04","31","8735","8","876","13.1","14.7"
"Upson","2020-09-05","34","8769","4","880","11.5","14.1"
"Upson","2020-09-06","10","8779","0","880","9.8","11.8"
"Upson","2020-09-07","36","8815","2","882","9.3","11.3"
"Upson","2020-09-08","29","8844","5","887","10.7","12.1"
"Upson","2020-09-09","80","8924","3","890","10.1","11.9"
"Upson","2020-09-10","53","8977","5","895","10.5","11.5"
"Upson","2020-09-11","37","9014","2","897","7.6","10.4"
"Upson","2020-09-12","16","9030","2","899","7.7","9.6"
"Upson","2020-09-13","16","9046","5","904","12.2","11"
"Upson","2020-09-14","37","9083","2","906","12.1","10.7"
"Upson","2020-09-15","51","9134","1","907","10","10.3"
"Upson","2020-09-16","80","9214","3","910","10","10"
"Upson","2020-09-17","25","9239","2","912","9.8","10.1"
"Upson","2020-09-18","27","9266","2","914","10","8.8"
"Upson","2020-09-19","22","9288","6","920","12.1","9.9"
"Upson","2020-09-20","5","9293","1","921","10.5","11.4"
"Upson","2020-09-21","28","9321","2","923","10.8","11.5"
"Upson","2020-09-22","29","9350","4","927","12.5","11.2"
"Upson","2020-09-23","92","9442","4","931","12.6","11.3"
"Upson","2020-09-24","19","9461","1","932","12.2","11"
"Upson","2020-09-25","20","9481","3","935","13.3","11.6"
"Upson","2020-09-26","30","9511","5","940","11.7","11.9"
"Upson","2020-09-27","11","9522","5","945","15.4","13"
"Upson","2020-09-28","25","9547","3","948","16.1","13.4"
"Upson","2020-09-29","27","9574","4","952","16.2","14.4"
"Upson","2020-09-30","71","9645","2","954","16","14.3"
"Upson","2020-10-01","23","9668","1","955","15.9","14"
"Upson","2020-10-02","70","9738","3","958","14.3","13.8"
"Upson","2020-10-03","57","9795","0","958","12","11.9"
"Upson","2020-10-04","67","9862","1","959","5.7","10.5"
"Upson","2020-10-05","23","9885","1","960","4.6","10.3"
"Upson","2020-10-06","51","9936","1","961","2.8","9.5"
"Upson","2020-10-07","62","9998","1","962","2.6","9.3"
"Upson","2020-10-08","50","10048","1","963","2.2","9.1"
"Upson","2020-10-09","33","10081","0","963","1.6","8"
"Upson","2020-10-10","31","10112","1","964","2.1","7"
"Upson","2020-10-11","30","10142","4","968","3.8","4.7"
"Upson","2020-10-12","20","10162","4","972","6","5.3"
"Upson","2020-10-13","20","10182","0","972","5.7","4.2"
"Upson","2020-10-14","52","10234","4","976","6.6","4.6"
"Upson","2020-10-15","26","10260","0","976","6.3","4.3"
"Upson","2020-10-16","17","10277","1","977","7.2","4.4"
"Upson","2020-10-17","79","10356","0","977","6.7","4.4"
"Upson","2020-10-18","12","10368","3","980","8.4","6.1"
"Upson","2020-10-19","48","10416","1","981","5.8","5.9"
"Upson","2020-10-20","56","10472","2","983","6.3","6"
"Upson","2020-10-21","62","10534","1","984","5.5","6"
"Upson","2020-10-22","35","10569","1","985","5.9","6.1"
"Upson","2020-10-23","27","10596","0","985","5","6.1"
"Upson","2020-10-24","48","10644","0","985","5","5.9"
"Upson","2020-10-25","18","10662","0","985","1.4","4.9"
"Upson","2020-10-26","32","10694","2","987","2","3.9"
"Upson","2020-10-27","36","10730","4","991","3.1","4.7"
"Upson","2020-10-28","79","10809","4","995","3.6","4.5"
"Upson","2020-10-29","34","10843","3","998","4.5","5.2"
"Upson","2020-10-30","40","10883","0","998","4.5","4.7"
"Upson","2020-10-31","50","10933","1","999","4.7","4.9"
"Upson","2020-11-01","13","10946","2","1001","6.9","4.2"
"Upson","2020-11-02","28","10974","2","1003","7.1","4.6"
"Upson","2020-11-03","20","10994","1","1004","6.2","4.7"
"Upson","2020-11-04","90","11084","6","1010","6.4","5"
"Upson","2020-11-05","38","11122","1","1011","5.5","5"
"Upson","2020-11-06","43","11165","0","1011","5.5","5"
"Upson","2020-11-07","38","11203","7","1018","7.9","6.3"
"Upson","2020-11-08","22","11225","6","1024","9.6","8.3"
"Upson","2020-11-09","39","11264","2","1026","9.3","8.2"
"Upson","2020-11-10","45","11309","6","1032","10.5","8.3"
"Upson","2020-11-11","38","11347","1","1033","9.9","8.2"
"Upson","2020-11-12","38","11385","5","1038","11.4","8.5"
"Upson","2020-11-13","36","11421","2","1040","12.2","8.9"
"Upson","2020-11-14","28","11449","9","1049","14.2","11"
"Upson","2020-11-15","24","11473","4","1053","12.7","11.1"
"Upson","2020-11-16","36","11509","3","1056","13.1","11.2"
"Upson","2020-11-17","35","11544","1","1057","11.6","11.1"
"Upson","2020-11-18","79","11623","6","1063","12.3","11.1"
"Upson","2020-11-19","45","11668","0","1063","10.5","10.9"
"Upson","2020-11-20","28","11696","4","1067","11.7","12"
"Upson","2020-11-21","34","11730","7","1074","10","12.1"
"Upson","2020-11-22","22","11752","6","1080","11.6","12.1"
"Upson","2020-11-23","26","11778","2","1082","11.5","12.3"
"Upson","2020-11-24","25","11803","5","1087","13.9","12.8"
"Upson","2020-11-25","85","11888","13","1100","15","13.7"
"Upson","2020-11-26","7","11895","1","1101","17.1","13.8"
"Upson","2020-11-27","20","11915","5","1106","18.6","15.1"
"Upson","2020-11-28","26","11941","5","1111","18.4","14.2"
"Upson","2020-11-29","7","11948","0","1111","14.5","13"
"Upson","2020-11-30","32","11980","4","1115","15.2","13.3"
"Upson","2020-12-01","28","12008","4","1119","14.4","14.1"
"Upson","2020-12-02","103","12111","4","1123","12.7","13.9"
"Upson","2020-12-03","27","12138","3","1126","12.3","14.7"
"Upson","2020-12-04","38","12176","3","1129","9.8","14.2"
"Upson","2020-12-05","18","12194","1","1130","7.9","13.1"
"Upson","2020-12-06","15","12209","1","1131","8.8","11.7"
"Upson","2020-12-07","29","12238","3","1134","8.5","11.9"
"Upson","2020-12-08","33","12271","5","1139","8.7","11.5"
"Upson","2020-12-09","132","12403","15","1154","9.7","11.2"
"Upson","2020-12-10","31","12434","1","1155","8.6","10.4"
"Upson","2020-12-11","38","12472","3","1158","8.6","9.2"
"Upson","2020-12-12","36","12508","5","1163","9.8","8.8"
"Upson","2020-12-13","24","12532","3","1166","10.6","9.7"
"Upson","2020-12-14","37","12569","3","1169","10.3","9.4"
"Upson","2020-12-15","76","12645","15","1184","11","9.8"
"Upson","2020-12-16","159","12804","26","1210","11.7","10.7"
"Upson","2020-12-17","43","12847","5","1215","12.9","10.7"
"Upson","2020-12-18","37","12884","7","1222","14.4","11.5"
"Upson","2020-12-19","28","12912","5","1227","15","12.4"
"Upson","2020-12-20","17","12929","2","1229","14.9","12.8"
"Upson","2020-12-21","51","12980","15","1244","18","14.1"
"Upson","2020-12-22","58","13038","7","1251","16.9","13.9"
"Upson","2020-12-23","195","13233","28","1279","16.6","14.1"
"Upson","2020-12-24","47","13280","14","1293","19.2","16"
"Upson","2020-12-25","22","13302","9","1302","22.3","18.4"
"Upson","2020-12-26","50","13352","17","1319","24.6","19.8"
"Upson","2020-12-27","32","13384","14","1333","29.2","22"
"Upson","2020-12-28","62","13446","13","1346","28","23"
"Upson","2020-12-29","104","13550","27","1373","30","23.4"
"Upson","2020-12-30","315","13865","66","1439","30.9","23.7"
"Upson","2020-12-31","98","13963","24","1463","30.1","24.7"
"Upson","2021-01-01","32","13995","16","1479","31.4","26.9"
"Upson","2021-01-02","36","14031","12","1491","31.4","28"
"Upson","2021-01-03","19","14050","9","1500","31.9","30.5"
"Upson","2021-01-04","25","14075","3","1503","30.6","29.3"
"Upson","2021-01-05","83","14158","13","1516","29.1","29.5"
"Upson","2021-01-06","276","14434","50","1566","28.7","29.8"
"Upson","2021-01-07","56","14490","18","1584","29.8","30"
"Upson","2021-01-08","41","14531","10","1594","26.1","28.8"
"Upson","2021-01-09","33","14564","13","1607","27","29.2"
"Upson","2021-01-10","27","14591","5","1612","22.9","27.4"
"Upson","2021-01-11","54","14645","8","1620","23.3","26.9"
"Upson","2021-01-12","74","14719","14","1634","23.8","26.4"
"Upson","2021-01-13","213","14932","45","1679","24.2","26.4"
"Upson","2021-01-14","88","15020","21","1700","23","26.4"
"Upson","2021-01-15","69","15089","13","1713","22.2","24.2"
"Upson","2021-01-16","29","15118","6","1719","19.5","23.3"
"Upson","2021-01-17","27","15145","3","1722","18.5","20.7"
"Upson","2021-01-18","59","15204","11","1733","19","21.2"
"Upson","2021-01-19","56","15260","10","1743","18.9","21.3"
"Upson","2021-01-20","175","15435","22","1765","17.7","20.9"
"Upson","2021-01-21","66","15501","10","1775","16.4","19.7"
"Upson","2021-01-22","52","15553","11","1786","16.7","19.5"
"Upson","2021-01-23","54","15607","13","1799","17.2","18.4"
"Upson","2021-01-24","28","15635","7","1806","19.2","18.8"
"Upson","2021-01-25","64","15699","10","1816","18.8","18.9"
"Upson","2021-01-26","66","15765","5","1821","17.3","18.1"
"Upson","2021-01-27","122","15887","12","1833","16.9","17.3"
"Upson","2021-01-28","57","15944","10","1843","17.3","16.8"
"Upson","2021-01-29","53","15997","5","1848","15.6","16.2"
"Upson","2021-01-30","32","16029","10","1858","16.6","16.9"
"Upson","2021-01-31","21","16050","3","1861","15.1","17.1"
"Upson","2021-02-01","45","16095","6","1867","14.8","16.8"
"Upson","2021-02-02","51","16146","5","1872","15.1","16.2"
"Upson","2021-02-03","114","16260","6","1878","14.4","15.7"
"Upson","2021-02-04","42","16302","4","1882","13.3","15.3"
"Upson","2021-02-05","39","16341","2","1884","12.7","14.1"
"Upson","2021-02-06","30","16371","4","1888","10.1","13.4"
"Upson","2021-02-07","3","16374","0","1888","8.1","11.6"
"Upson","2021-02-08","0","16374","0","1888","6.2","10.5"
"Walker","2020-02-01","0","0","0","0",".","."
"Walker","2020-02-02","0","0","0","0",".","."
"Walker","2020-02-03","0","0","0","0",".","."
"Walker","2020-02-04","0","0","0","0",".","."
"Walker","2020-02-05","0","0","0","0",".","."
"Walker","2020-02-06","0","0","0","0",".","."
"Walker","2020-02-07","0","0","0","0","0","."
"Walker","2020-02-08","0","0","0","0","0","."
"Walker","2020-02-09","0","0","0","0","0","."
"Walker","2020-02-10","0","0","0","0","0","."
"Walker","2020-02-11","0","0","0","0","0","."
"Walker","2020-02-12","0","0","0","0","0","."
"Walker","2020-02-13","0","0","0","0","0","."
"Walker","2020-02-14","0","0","0","0","0","0"
"Walker","2020-02-15","0","0","0","0","0","0"
"Walker","2020-02-16","0","0","0","0","0","0"
"Walker","2020-02-17","0","0","0","0","0","0"
"Walker","2020-02-18","0","0","0","0","0","0"
"Walker","2020-02-19","0","0","0","0","0","0"
"Walker","2020-02-20","0","0","0","0","0","0"
"Walker","2020-02-21","0","0","0","0","0","0"
"Walker","2020-02-22","0","0","0","0","0","0"
"Walker","2020-02-23","0","0","0","0","0","0"
"Walker","2020-02-24","0","0","0","0","0","0"
"Walker","2020-02-25","0","0","0","0","0","0"
"Walker","2020-02-26","0","0","0","0","0","0"
"Walker","2020-02-27","0","0","0","0","0","0"
"Walker","2020-02-28","0","0","0","0","0","0"
"Walker","2020-02-29","0","0","0","0","0","0"
"Walker","2020-03-01","0","0","0","0","0","0"
"Walker","2020-03-02","0","0","0","0","0","0"
"Walker","2020-03-03","0","0","0","0","0","0"
"Walker","2020-03-04","0","0","0","0","0","0"
"Walker","2020-03-05","0","0","0","0","0","0"
"Walker","2020-03-06","0","0","0","0","0","0"
"Walker","2020-03-07","0","0","0","0","0","0"
"Walker","2020-03-08","0","0","0","0","0","0"
"Walker","2020-03-09","0","0","0","0","0","0"
"Walker","2020-03-10","1","1","0","0","0","0"
"Walker","2020-03-11","1","2","0","0","0","0"
"Walker","2020-03-12","2","4","0","0","0","0"
"Walker","2020-03-13","12","16","0","0","0","0"
"Walker","2020-03-14","2","18","0","0","0","0"
"Walker","2020-03-15","3","21","0","0","0","0"
"Walker","2020-03-16","16","37","0","0","0","0"
"Walker","2020-03-17","23","60","0","0","0","0"
"Walker","2020-03-18","24","84","0","0","0","0"
"Walker","2020-03-19","20","104","0","0","0","0"
"Walker","2020-03-20","14","118","1","1","1","0.5"
"Walker","2020-03-21","6","124","0","1","1","0.5"
"Walker","2020-03-22","0","124","0","1","1","0.5"
"Walker","2020-03-23","14","138","0","1","1","0.5"
"Walker","2020-03-24","12","150","0","1","1","0.5"
"Walker","2020-03-25","15","165","0","1","1","0.5"
"Walker","2020-03-26","15","180","2","3","2.9","1.5"
"Walker","2020-03-27","20","200","0","3","1.9","1.5"
"Walker","2020-03-28","0","200","0","3","1.9","1.5"
"Walker","2020-03-29","1","201","0","3","1.9","1.5"
"Walker","2020-03-30","6","207","1","4","4.3","2.7"
"Walker","2020-03-31","7","214","0","4","4.3","2.7"
"Walker","2020-04-01","11","225","0","4","4.3","2.7"
"Walker","2020-04-02","3","228","0","4","2.4","2.7"
"Walker","2020-04-03","8","236","0","4","2.4","2.1"
"Walker","2020-04-04","0","236","0","4","2.4","2.1"
"Walker","2020-04-05","0","236","0","4","2.4","2.1"
"Walker","2020-04-06","11","247","1","5","1.3","2.8"
"Walker","2020-04-07","16","263","1","6","2.2","3.2"
"Walker","2020-04-08","14","277","0","6","2.2","3.2"
"Walker","2020-04-09","13","290","0","6","2.2","2.3"
"Walker","2020-04-10","22","312","0","6","2.2","2.3"
"Walker","2020-04-11","1","313","0","6","2.2","2.3"
"Walker","2020-04-12","0","313","0","6","2.2","2.3"
"Walker","2020-04-13","0","313","0","6","0.9","1.1"
"Walker","2020-04-14","16","329","0","6","0","1.1"
"Walker","2020-04-15","15","344","1","7","1","1.6"
"Walker","2020-04-16","11","355","0","7","1","1.6"
"Walker","2020-04-17","11","366","0","7","1","1.6"
"Walker","2020-04-18","2","368","0","7","1","1.6"
"Walker","2020-04-19","3","371","0","7","1","1.6"
"Walker","2020-04-20","45","416","0","7","1","0.9"
"Walker","2020-04-21","61","477","0","7","1","0.5"
"Walker","2020-04-22","36","513","0","7","0","0.5"
"Walker","2020-04-23","14","527","0","7","0","0.5"
"Walker","2020-04-24","73","600","1","8","0.2","0.6"
"Walker","2020-04-25","24","624","0","8","0.2","0.6"
"Walker","2020-04-26","1","625","0","8","0.2","0.6"
"Walker","2020-04-27","32","657","0","8","0.2","0.6"
"Walker","2020-04-28","39","696","0","8","0.2","0.6"
"Walker","2020-04-29","13","709","0","8","0.2","0.1"
"Walker","2020-04-30","65","774","0","8","0.2","0.1"
"Walker","2020-05-01","33","807","2","10","0.9","0.5"
"Walker","2020-05-02","25","832","0","10","0.9","0.5"
"Walker","2020-05-03","0","832","0","10","0.9","0.5"
"Walker","2020-05-04","9","841","0","10","0.9","0.5"
"Walker","2020-05-05","25","866","0","10","0.9","0.5"
"Walker","2020-05-06","59","925","4","14","1.8","1"
"Walker","2020-05-07","62","987","1","15","2.1","1.1"
"Walker","2020-05-08","230","1217","3","18","1.4","1.1"
"Walker","2020-05-09","80","1297","0","18","1.4","1.1"
"Walker","2020-05-10","2","1299","0","18","1.4","1.1"
"Walker","2020-05-11","43","1342","1","19","1.7","1.3"
"Walker","2020-05-12","223","1565","5","24","2","1.5"
"Walker","2020-05-13","119","1684","10","34","2.3","2.1"
"Walker","2020-05-14","69","1753","1","35","2.2","2.2"
"Walker","2020-05-15","311","2064","20","55","3","2.2"
"Walker","2020-05-16","102","2166","6","61","3.8","2.6"
"Walker","2020-05-17","1","2167","0","61","3.8","2.6"
"Walker","2020-05-18","19","2186","0","61","3.5","2.6"
"Walker","2020-05-19","25","2211","0","61","3.2","2.6"
"Walker","2020-05-20","28","2239","0","61","2","2.1"
"Walker","2020-05-21","9","2248","0","61","1.8","2"
"Walker","2020-05-22","18","2266","0","61","0.8","1.9"
"Walker","2020-05-23","1","2267","0","61","0","1.9"
"Walker","2020-05-24","0","2267","0","61","0","1.9"
"Walker","2020-05-25","1","2268","0","61","0","1.7"
"Walker","2020-05-26","75","2343","3","64","0.6","1.9"
"Walker","2020-05-27","61","2404","3","67","1.3","1.6"
"Walker","2020-05-28","83","2487","4","71","2","1.9"
"Walker","2020-05-29","55","2542","4","75","3","1.9"
"Walker","2020-05-30","29","2571","0","75","3","1.5"
"Walker","2020-05-31","5","2576","0","75","3","1.5"
"Walker","2020-06-01","54","2630","6","81","4.6","2.3"
"Walker","2020-06-02","45","2675","3","84","5","2.8"
"Walker","2020-06-03","35","2710","2","86","5.1","3.2"
"Walker","2020-06-04","48","2758","0","86","4.4","3.2"
"Walker","2020-06-05","33","2791","0","86","3.4","3.2"
"Walker","2020-06-06","18","2809","0","86","3.4","3.2"
"Walker","2020-06-07","2","2811","0","86","3.4","3.2"
"Walker","2020-06-08","53","2864","3","89","2.6","3.6"
"Walker","2020-06-09","50","2914","3","92","2.5","3.7"
"Walker","2020-06-10","84","2998","4","96","2.3","3.7"
"Walker","2020-06-11","69","3067","8","104","4","4.2"
"Walker","2020-06-12","56","3123","2","106","4.5","3.9"
"Walker","2020-06-13","41","3164","3","109","5.6","4.5"
"Walker","2020-06-14","2","3166","0","109","5.6","4.5"
"Walker","2020-06-15","66","3232","7","116","6.3","4.4"
"Walker","2020-06-16","68","3300","8","124","7.1","4.8"
"Walker","2020-06-17","57","3357","4","128","7.4","4.9"
"Walker","2020-06-18","62","3419","4","132","6.7","5.3"
"Walker","2020-06-19","54","3473","2","134","6.7","5.6"
"Walker","2020-06-20","24","3497","1","135","6.2","5.9"
"Walker","2020-06-21","4","3501","0","135","6.2","5.9"
"Walker","2020-06-22","68","3569","2","137","5.1","5.7"
"Walker","2020-06-23","71","3640","2","139","3.9","5.5"
"Walker","2020-06-24","90","3730","3","142","3.3","5.4"
"Walker","2020-06-25","74","3804","7","149","3.8","5.2"
"Walker","2020-06-26","54","3858","4","153","4.3","5.5"
"Walker","2020-06-27","40","3898","3","156","4.8","5.5"
"Walker","2020-06-28","2","3900","0","156","4.8","5.5"
"Walker","2020-06-29","88","3988","7","163","5.5","5.3"
"Walker","2020-06-30","82","4070","4","167","5.8","4.8"
"Walker","2020-07-01","113","4183","5","172","5.9","4.6"
"Walker","2020-07-02","91","4274","3","175","5.1","4.4"
"Walker","2020-07-03","12","4286","1","176","5.2","4.8"
"Walker","2020-07-04","1","4287","0","176","4.1","4.5"
"Walker","2020-07-05","7","4294","1","177","6.2","5.5"
"Walker","2020-07-06","128","4422","3","180","5.4","5.4"
"Walker","2020-07-07","145","4567","8","188","5.5","5.6"
"Walker","2020-07-08","120","4687","8","196","5.8","5.9"
"Walker","2020-07-09","130","4817","7","203","6.1","5.6"
"Walker","2020-07-10","84","4901","4","207","5.6","5.4"
"Walker","2020-07-11","32","4933","4","211","7.4","5.7"
"Walker","2020-07-12","7","4940","0","211","5.3","5.7"
"Walker","2020-07-13","83","5023","6","217","6","5.7"
"Walker","2020-07-14","81","5104","4","221","5.9","5.7"
"Walker","2020-07-15","80","5184","7","228","6.2","6"
"Walker","2020-07-16","112","5296","12","240","7","6.5"
"Walker","2020-07-17","67","5363","6","246","7.6","6.6"
"Walker","2020-07-18","7","5370","0","246","5.8","6.6"
"Walker","2020-07-19","3","5373","0","246","5.8","5.6"
"Walker","2020-07-20","96","5469","5","251","5.5","5.8"
"Walker","2020-07-21","102","5571","9","260","6.1","6"
"Walker","2020-07-22","73","5644","8","268","6.4","6.3"
"Walker","2020-07-23","73","5717","9","277","6.6","6.8"
"Walker","2020-07-24","85","5802","8","285","6.7","7.1"
"Walker","2020-07-25","70","5872","2","287","7.1","6.4"
"Walker","2020-07-26","2","5874","1","288","14.2","10"
"Walker","2020-07-27","114","5988","11","299","14.9","10.2"
"Walker","2020-07-28","107","6095","9","308","14.8","10.4"
"Walker","2020-07-29","88","6183","10","318","14.9","10.6"
"Walker","2020-07-30","99","6282","4","322","13.7","10.1"
"Walker","2020-07-31","98","6380","5","327","13.1","9.9"
"Walker","2020-08-01","39","6419","3","330","13.8","10.4"
"Walker","2020-08-02","5","6424","0","330","6.6","10.4"
"Walker","2020-08-03","115","6539","11","341","6.6","10.7"
"Walker","2020-08-04","113","6652","4","345","5.9","10.4"
"Walker","2020-08-05","87","6739","10","355","5.9","10.4"
"Walker","2020-08-06","92","6831","7","362","6.4","10.1"
"Walker","2020-08-07","97","6928","5","367","6.4","9.7"
"Walker","2020-08-08","59","6987","3","370","6.1","9.9"
"Walker","2020-08-09","8","6995","0","370","6.1","6.3"
"Walker","2020-08-10","121","7116","11","381","6","6.3"
"Walker","2020-08-11","96","7212","9","390","6.8","6.4"
"Walker","2020-08-12","125","7337","6","396","5.9","5.9"
"Walker","2020-08-13","140","7477","4","400","5.2","5.8"
"Walker","2020-08-14","134","7611","8","408","5.3","5.9"
"Walker","2020-08-15","7","7618","1","409","6.6","6.3"
"Walker","2020-08-16","41","7659","1","410","7","6.5"
"Walker","2020-08-17","20","7679","1","411","6.4","6.2"
"Walker","2020-08-18","108","7787","8","419","6.1","6.5"
"Walker","2020-08-19","162","7949","6","425","6","5.9"
"Walker","2020-08-20","73","8022","7","432","6.9","6.1"
"Walker","2020-08-21","115","8137","4","436","6.6","5.9"
"Walker","2020-08-22","53","8190","3","439","5.3","6"
"Walker","2020-08-23","10","8200","0","439","5","6"
"Walker","2020-08-24","140","8340","14","453","5.7","6"
"Walker","2020-08-25","249","8589","33","486","6.5","6.3"
"Walker","2020-08-26","162","8751","22","508","7.9","6.9"
"Walker","2020-08-27","195","8946","13","521","7.5","7.2"
"Walker","2020-08-28","132","9078","7","528","7.8","7.2"
"Walker","2020-08-29","17","9095","1","529","7.8","6.6"
"Walker","2020-08-30","66","9161","3","532","8.5","6.7"
"Walker","2020-08-31","159","9320","11","543","8","6.9"
"Walker","2020-09-01","65","9385","0","543","6.1","6.3"
"Walker","2020-09-02","140","9525","4","547","4.6","6.3"
"Walker","2020-09-03","341","9866","20","567","4.5","6"
"Walker","2020-09-04","189","10055","10","577","4.5","6.1"
"Walker","2020-09-05","71","10126","1","578","3.8","5.8"
"Walker","2020-09-06","12","10138","2","580","5.6","7"
"Walker","2020-09-07","9","10147","2","582","7.8","7.9"
"Walker","2020-09-08","31","10178","5","587","10.1","8.1"
"Walker","2020-09-09","48","10226","9","596","12.3","8.5"
"Walker","2020-09-10","263","10489","46","642","14","9.2"
"Walker","2020-09-11","232","10721","21","663","14.5","9.5"
"Walker","2020-09-12","50","10771","4","667","15.5","9.7"
"Walker","2020-09-13","9","10780","1","668","14.7","10.1"
"Walker","2020-09-14","23","10803","1","669","12.1","9.9"
"Walker","2020-09-15","89","10892","2","671","10.1","10.1"
"Walker","2020-09-16","34","10926","0","671","7.5","9.9"
"Walker","2020-09-17","42","10968","2","673","5.6","9.8"
"Walker","2020-09-18","320","11288","43","716","6.3","10.4"
"Walker","2020-09-19","12","11300","2","718","7.5","11.5"
"Walker","2020-09-20","1","11301","0","718","5.9","10.3"
"Walker","2020-09-21","18","11319","0","718","5.3","8.7"
"Walker","2020-09-22","28","11347","1","719","5.5","7.8"
"Walker","2020-09-23","13","11360","1","720","6.6","7"
"Walker","2020-09-24","79","11439","7","727","7.2","6.4"
"Walker","2020-09-25","69","11508","2","729","5.7","6"
"Walker","2020-09-26","27","11535","2","731","4.3","5.9"
"Walker","2020-09-27","26","11561","2","733","5.4","5.7"
"Walker","2020-09-28","15","11576","1","734","6.4","5.9"
"Walker","2020-09-29","30","11606","3","737","7.3","6.4"
"Walker","2020-09-30","6","11612","0","737","6.2","6.4"
"Walker","2020-10-01","199","11811","8","745","5.5","6.4"
"Walker","2020-10-02","106","11917","3","748","5.5","5.6"
"Walker","2020-10-03","63","11980","1","749","4.7","4.5"
"Walker","2020-10-04","48","12028","0","749","3.6","4.5"
"Walker","2020-10-05","16","12044","1","750","3.5","5"
"Walker","2020-10-06","47","12091","2","752","2.7","5"
"Walker","2020-10-07","146","12237","6","758","3.3","4.8"
"Walker","2020-10-08","105","12342","2","760","3","4.3"
"Walker","2020-10-09","215","12557","11","771","3.3","4.4"
"Walker","2020-10-10","80","12637","2","773","3.4","4.1"
"Walker","2020-10-11","33","12670","0","773","3.4","3.5"
"Walker","2020-10-12","48","12718","10","783","5.5","4.5"
"Walker","2020-10-13","42","12760","1","784","5.3","4"
"Walker","2020-10-14","54","12814","2","786","5.2","4.2"
"Walker","2020-10-15","211","13025","20","806","6.3","4.6"
"Walker","2020-10-16","123","13148","19","825","7.8","5.5"
"Walker","2020-10-17","82","13230","5","830","8.3","5.9"
"Walker","2020-10-18","1","13231","0","830","8.3","5.9"
"Walker","2020-10-19","65","13296","1","831","5.5","5.5"
"Walker","2020-10-20","78","13374","17","848","8.3","6.8"
"Walker","2020-10-21","58","13432","6","854","9.2","7.2"
"Walker","2020-10-22","107","13539","14","868","9.8","8"
"Walker","2020-10-23","100","13639","3","871","8","7.9"
"Walker","2020-10-24","33","13672","2","873","8","8.1"
"Walker","2020-10-25","9","13681","0","873","8","8.1"
"Walker","2020-10-26","48","13729","5","878","9.2","7.4"
"Walker","2020-10-27","31","13760","5","883","8.4","8.4"
"Walker","2020-10-28","37","13797","3","886","8.1","8.7"
"Walker","2020-10-29","42","13839","7","893","8.6","9.2"
"Walker","2020-10-30","170","14009","11","904","9.1","8.6"
"Walker","2020-10-31","19","14028","3","907","10.5","9.2"
"Walker","2020-11-01","9","14037","1","908","12.1","10"
"Walker","2020-11-02","47","14084","5","913","12.1","10.7"
"Walker","2020-11-03","29","14113","5","918","12.3","10.4"
"Walker","2020-11-04","41","14154","11","929","15","11.5"
"Walker","2020-11-05","177","14331","8","937","13.2","10.9"
"Walker","2020-11-06","159","14490","17","954","13.8","11.5"
"Walker","2020-11-07","32","14522","1","955","12","11.3"
"Walker","2020-11-08","4","14526","2","957","17.6","14.8"
"Walker","2020-11-09","83","14609","6","963","17.1","14.6"
"Walker","2020-11-10","65","14674","8","971","16.4","14.3"
"Walker","2020-11-11","122","14796","7","978","13.4","14.2"
"Walker","2020-11-12","329","15125","39","1017","14.4","13.8"
"Walker","2020-11-13","272","15397","29","1046","14.4","14.1"
"Walker","2020-11-14","32","15429","8","1054","17.5","14.8"
"Walker","2020-11-15","32","15461","2","1056","11.3","14.4"
"Walker","2020-11-16","70","15531","12","1068","12.7","14.9"
"Walker","2020-11-17","112","15643","4","1072","11.5","13.9"
"Walker","2020-11-18","68","15711","9","1081","12.5","13"
"Walker","2020-11-19","279","15990","36","1117","12.7","13.6"
"Walker","2020-11-20","214","16204","29","1146","13.1","13.8"
"Walker","2020-11-21","17","16221","0","1146","9.5","13.5"
"Walker","2020-11-22","10","16231","2","1148","11.5","11.4"
"Walker","2020-11-23","72","16303","9","1157","10.8","11.8"
"Walker","2020-11-24","60","16363","14","1171","13.6","12.6"
"Walker","2020-11-25","34","16397","5","1176","13.9","13.2"
"Walker","2020-11-26","9","16406","0","1176","12","12.3"
"Walker","2020-11-27","25","16431","4","1180","12.4","12.7"
"Walker","2020-11-28","33","16464","13","1193","18","13.8"
"Walker","2020-11-29","13","16477","4","1197","19.5","15.5"
"Walker","2020-11-30","99","16576","9","1206","19","14.9"
"Walker","2020-12-01","53","16629","6","1212","17.3","15.5"
"Walker","2020-12-02","141","16770","15","1227","16.7","15.3"
"Walker","2020-12-03","209","16979","37","1264","19.3","15.6"
"Walker","2020-12-04","176","17155","30","1294","19.4","15.9"
"Walker","2020-12-05","40","17195","8","1302","16.7","17.3"
"Walker","2020-12-06","15","17210","4","1306","16.1","17.8"
"Walker","2020-12-07","84","17294","6","1312","15.8","17.4"
"Walker","2020-12-08","53","17347","9","1321","16.6","17"
"Walker","2020-12-09","110","17457","21","1342","17.8","17.3"
"Walker","2020-12-10","181","17638","23","1365","17.1","18.2"
"Walker","2020-12-11","147","17785","30","1395","17.6","18.5"
"Walker","2020-12-12","28","17813","8","1403","18.8","17.7"
"Walker","2020-12-13","19","17832","5","1408","18.7","17.4"
"Walker","2020-12-14","75","17907","8","1416","19.2","17.5"
"Walker","2020-12-15","74","17981","11","1427","18.9","17.8"
"Walker","2020-12-16","151","18132","26","1453","18.7","18.2"
"Walker","2020-12-17","238","18370","35","1488","19","18"
"Walker","2020-12-18","232","18602","36","1524","18.3","17.9"
"Walker","2020-12-19","35","18637","3","1527","15.4","17.1"
"Walker","2020-12-20","17","18654","5","1532","15.9","17.3"
"Walker","2020-12-21","67","18721","9","1541","16.2","17.7"
"Walker","2020-12-22","91","18812","13","1554","16.2","17.6"
"Walker","2020-12-23","194","19006","32","1586","16.1","17.4"
"Walker","2020-12-24","42","19048","17","1603","19.7","19.4"
"Walker","2020-12-25","0","19048","0","1603","17.5","17.9"
"Walker","2020-12-26","31","19079","11","1614","21.4","18.4"
"Walker","2020-12-27","27","19106","6","1620","20.3","18.1"
"Walker","2020-12-28","73","19179","9","1629","20.2","18.2"
"Walker","2020-12-29","96","19275","23","1652","21.6","18.9"
"Walker","2020-12-30","314","19589","39","1691","21","18.5"
"Walker","2020-12-31","259","19848","60","1751","18.5","19.1"
"Walker","2021-01-01","3","19851","0","1751","18.5","18"
"Walker","2021-01-02","12","19863","4","1755","18.2","19.8"
"Walker","2021-01-03","28","19891","8","1763","19.1","19.7"
"Walker","2021-01-04","74","19965","13","1776","19.9","20"
"Walker","2021-01-05","94","20059","18","1794","19.2","20.4"
"Walker","2021-01-06","176","20235","32","1826","20","20.5"
"Walker","2021-01-07","266","20501","36","1862","18.6","18.6"
"Walker","2021-01-08","225","20726","44","1906","21.4","20"
"Walker","2021-01-09","31","20757","3","1909","18","18.1"
"Walker","2021-01-10","25","20782","5","1914","16.8","18"
"Walker","2021-01-11","93","20875","21","1935","17.5","18.7"
"Walker","2021-01-12","88","20963","10","1945","16.4","17.8"
"Walker","2021-01-13","217","21180","26","1971","15.5","17.8"
"Walker","2021-01-14","202","21382","27","1998","15.5","17.1"
"Walker","2021-01-15","148","21530","13","2011","14","17.7"
"Walker","2021-01-16","29","21559","3","2014","14.1","16"
"Walker","2021-01-17","11","21570","0","2014","11.2","14"
"Walker","2021-01-18","75","21645","15","2029","10.8","14.2"
"Walker","2021-01-19","66","21711","5","2034","10.3","13.4"
"Walker","2021-01-20","69","21780","4","2038","9.4","12.5"
"Walker","2021-01-21","67","21847","8","2046","9.2","12.4"
"Walker","2021-01-22","204","22051","10","2056","8.7","11.3"
"Walker","2021-01-23","35","22086","2","2058","8","11"
"Walker","2021-01-24","26","22112","2","2060","9.1","10.1"
"Walker","2021-01-25","87","22199","6","2066","7.2","9"
"Walker","2021-01-26","64","22263","6","2072","7.5","8.9"
"Walker","2021-01-27","72","22335","4","2076","7.4","8.4"
"Walker","2021-01-28","57","22392","4","2080","6.7","8"
"Walker","2021-01-29","58","22450","3","2083","6.8","7.7"
"Walker","2021-01-30","20","22470","1","2084","6.7","7.3"
"Walker","2021-01-31","11","22481","0","2084","5.6","7.3"
"Walker","2021-02-01","50","22531","7","2091","6.6","6.9"
"Walker","2021-02-02","85","22616","5","2096","6.1","6.8"
"Walker","2021-02-03","60","22676","4","2100","6.2","6.8"
"Walker","2021-02-04","155","22831","12","2112","6.4","6.5"
"Walker","2021-02-05","39","22870","1","2113","6","6.4"
"Walker","2021-02-06","0","22870","0","2113","5.3","6"
"Walker","2021-02-07","0","22870","0","2113","5.3","5.4"
"Walker","2021-02-08","0","22870","0","2113","3.3","4.9"
"Walton","2020-02-01","0","0","0","0",".","."
"Walton","2020-02-02","0","0","0","0",".","."
"Walton","2020-02-03","0","0","0","0",".","."
"Walton","2020-02-04","0","0","0","0",".","."
"Walton","2020-02-05","0","0","0","0",".","."
"Walton","2020-02-06","0","0","0","0",".","."
"Walton","2020-02-07","0","0","0","0","0","."
"Walton","2020-02-08","0","0","0","0","0","."
"Walton","2020-02-09","0","0","0","0","0","."
"Walton","2020-02-10","0","0","0","0","0","."
"Walton","2020-02-11","0","0","0","0","0","."
"Walton","2020-02-12","0","0","0","0","0","."
"Walton","2020-02-13","0","0","0","0","0","."
"Walton","2020-02-14","0","0","0","0","0","0"
"Walton","2020-02-15","0","0","0","0","0","0"
"Walton","2020-02-16","0","0","0","0","0","0"
"Walton","2020-02-17","0","0","0","0","0","0"
"Walton","2020-02-18","0","0","0","0","0","0"
"Walton","2020-02-19","0","0","0","0","0","0"
"Walton","2020-02-20","0","0","0","0","0","0"
"Walton","2020-02-21","0","0","0","0","0","0"
"Walton","2020-02-22","0","0","0","0","0","0"
"Walton","2020-02-23","0","0","0","0","0","0"
"Walton","2020-02-24","0","0","0","0","0","0"
"Walton","2020-02-25","0","0","0","0","0","0"
"Walton","2020-02-26","0","0","0","0","0","0"
"Walton","2020-02-27","0","0","0","0","0","0"
"Walton","2020-02-28","0","0","0","0","0","0"
"Walton","2020-02-29","0","0","0","0","0","0"
"Walton","2020-03-01","0","0","0","0","0","0"
"Walton","2020-03-02","0","0","0","0","0","0"
"Walton","2020-03-03","0","0","0","0","0","0"
"Walton","2020-03-04","0","0","0","0","0","0"
"Walton","2020-03-05","0","0","0","0","0","0"
"Walton","2020-03-06","2","2","0","0","0","0"
"Walton","2020-03-07","0","2","0","0","0","0"
"Walton","2020-03-08","0","2","0","0","0","0"
"Walton","2020-03-09","0","2","0","0","0","0"
"Walton","2020-03-10","0","2","0","0","0","0"
"Walton","2020-03-11","2","4","0","0","0","0"
"Walton","2020-03-12","0","4","0","0","0","0"
"Walton","2020-03-13","7","11","0","0","0","0"
"Walton","2020-03-14","0","11","0","0","0","0"
"Walton","2020-03-15","3","14","0","0","0","0"
"Walton","2020-03-16","12","26","0","0","0","0"
"Walton","2020-03-17","24","50","0","0","0","0"
"Walton","2020-03-18","21","71","0","0","0","0"
"Walton","2020-03-19","17","88","3","3","2.5","1.3"
"Walton","2020-03-20","19","107","1","4","3.3","1.6"
"Walton","2020-03-21","8","115","0","4","3.3","1.6"
"Walton","2020-03-22","1","116","0","4","3.3","1.6"
"Walton","2020-03-23","24","140","7","11","7.4","3.7"
"Walton","2020-03-24","39","179","5","16","9.3","4.6"
"Walton","2020-03-25","29","208","4","20","11.2","5.6"
"Walton","2020-03-26","35","243","4","24","10.4","6.4"
"Walton","2020-03-27","18","261","3","27","12","7.6"
"Walton","2020-03-28","0","261","0","27","12","7.6"
"Walton","2020-03-29","2","263","0","27","12","7.6"
"Walton","2020-03-30","38","301","3","30","8.9","8.2"
"Walton","2020-03-31","13","314","1","31","8.2","8.7"
"Walton","2020-04-01","17","331","1","32","7.1","9.2"
"Walton","2020-04-02","35","366","1","33","5.9","8.1"
"Walton","2020-04-03","18","384","0","33","3.5","7.7"
"Walton","2020-04-04","4","388","2","35","10.6","11.3"
"Walton","2020-04-05","8","396","0","35","10.6","11.3"
"Walton","2020-04-06","29","425","5","40","12","10.4"
"Walton","2020-04-07","23","448","2","42","12.1","10.2"
"Walton","2020-04-08","35","483","3","45","12.5","9.8"
"Walton","2020-04-09","31","514","3","48","13.5","9.7"
"Walton","2020-04-10","28","542","3","51","15","9.2"
"Walton","2020-04-11","17","559","1","52","8.7","9.7"
"Walton","2020-04-12","3","562","0","52","8.7","9.7"
"Walton","2020-04-13","34","596","2","54","7.1","9.5"
"Walton","2020-04-14","55","651","8","62","7.9","10"
"Walton","2020-04-15","38","689","2","64","7.4","10"
"Walton","2020-04-16","61","750","2","66","6.5","10"
"Walton","2020-04-17","41","791","2","68","5.7","10.3"
"Walton","2020-04-18","34","825","0","68","4.8","6.8"
"Walton","2020-04-19","5","830","0","68","4.8","6.8"
"Walton","2020-04-20","65","895","3","71","4.7","5.9"
"Walton","2020-04-21","64","959","5","76","3.7","5.8"
"Walton","2020-04-22","78","1037","6","82","4","5.7"
"Walton","2020-04-23","72","1109","6","88","4.8","5.6"
"Walton","2020-04-24","82","1191","3","91","4.6","5.1"
"Walton","2020-04-25","21","1212","2","93","5.9","5.4"
"Walton","2020-04-26","13","1225","3","96","9.2","7"
"Walton","2020-04-27","90","1315","5","101","9.4","7"
"Walton","2020-04-28","76","1391","0","101","8.3","6"
"Walton","2020-04-29","64","1455","1","102","7.4","5.7"
"Walton","2020-04-30","68","1523","3","105","6.8","5.8"
"Walton","2020-05-01","87","1610","1","106","6.5","5.5"
"Walton","2020-05-02","42","1652","0","106","5.1","5.5"
"Walton","2020-05-03","24","1676","2","108","3","6.1"
"Walton","2020-05-04","63","1739","4","112","3.1","6.2"
"Walton","2020-05-05","72","1811","3","115","3.7","6"
"Walton","2020-05-06","68","1879","3","118","4.1","5.8"
"Walton","2020-05-07","60","1939","2","120","4","5.4"
"Walton","2020-05-08","64","2003","3","123","4.5","5.5"
"Walton","2020-05-09","31","2034","5","128","6.8","5.9"
"Walton","2020-05-10","22","2056","3","131","7.5","5.3"
"Walton","2020-05-11","75","2131","7","138","8","5.5"
"Walton","2020-05-12","84","2215","7","145","8.6","6.1"
"Walton","2020-05-13","68","2283","2","147","8.3","6.2"
"Walton","2020-05-14","118","2401","7","154","8.7","6.3"
"Walton","2020-05-15","83","2484","4","158","8.7","6.6"
"Walton","2020-05-16","48","2532","8","166","8.8","7.8"
"Walton","2020-05-17","26","2558","5","171","9.6","8.6"
"Walton","2020-05-18","86","2644","7","178","9.4","8.7"
"Walton","2020-05-19","99","2743","13","191","10.1","9.3"
"Walton","2020-05-20","85","2828","4","195","10.4","9.4"
"Walton","2020-05-21","60","2888","3","198","10.2","9.5"
"Walton","2020-05-22","119","3007","15","213","11.4","10"
"Walton","2020-05-23","33","3040","1","214","9.4","9.1"
"Walton","2020-05-24","34","3074","0","214","6.7","8.1"
"Walton","2020-05-25","23","3097","3","217","7.4","8.4"
"Walton","2020-05-26","81","3178","7","224","6.7","8.4"
"Walton","2020-05-27","102","3280","7","231","7","8.7"
"Walton","2020-05-28","101","3381","9","240","7.6","8.9"
"Walton","2020-05-29","54","3435","5","245","7.1","9.2"
"Walton","2020-05-30","37","3472","7","252","9.4","9.4"
"Walton","2020-05-31","26","3498","2","254","10.5","8.6"
"Walton","2020-06-01","88","3586","2","256","8.9","8.1"
"Walton","2020-06-02","85","3671","3","259","8.2","7.5"
"Walton","2020-06-03","101","3772","4","263","7.8","7.4"
"Walton","2020-06-04","79","3851","6","269","7.6","7.6"
"Walton","2020-06-05","71","3922","2","271","6.7","6.9"
"Walton","2020-06-06","50","3972","3","274","4.8","7.1"
"Walton","2020-06-07","28","4000","1","275","4.2","7.4"
"Walton","2020-06-08","98","4098","5","280","4.7","6.8"
"Walton","2020-06-09","79","4177","3","283","4.7","6.4"
"Walton","2020-06-10","92","4269","4","287","4.7","6.3"
"Walton","2020-06-11","88","4357","1","288","3.8","5.7"
"Walton","2020-06-12","74","4431","4","292","4.2","5.4"
"Walton","2020-06-13","27","4458","3","295","4.9","4.9"
"Walton","2020-06-14","35","4493","3","298","5.6","4.9"
"Walton","2020-06-15","116","4609","4","302","5.4","5"
"Walton","2020-06-16","109","4718","3","305","5.3","5"
"Walton","2020-06-17","121","4839","3","308","5","4.9"
"Walton","2020-06-18","88","4927","4","312","5.5","4.6"
"Walton","2020-06-19","108","5035","3","315","5.1","4.6"
"Walton","2020-06-20","69","5104","11","326","5.8","5.4"
"Walton","2020-06-21","32","5136","6","332","7.2","6.4"
"Walton","2020-06-22","179","5315","22","354","8.5","7"
"Walton","2020-06-23","136","5451","20","374","10.2","7.7"
"Walton","2020-06-24","149","5600","13","387","11.1","8"
"Walton","2020-06-25","181","5781","21","408","12.1","8.8"
"Walton","2020-06-26","159","5940","17","425","13.2","9.2"
"Walton","2020-06-27","95","6035","13","438","12.9","9.4"
"Walton","2020-06-28","58","6093","11","449","13","10.1"
"Walton","2020-06-29","212","6305","27","476","13","10.8"
"Walton","2020-06-30","236","6541","30","506","12.7","11.5"
"Walton","2020-07-01","209","6750","30","536","13.5","12.3"
"Walton","2020-07-02","188","6938","18","554","13.2","12.7"
"Walton","2020-07-03","117","7055","21","575","14.3","13.8"
"Walton","2020-07-04","35","7090","7","582","15.2","14.1"
"Walton","2020-07-05","51","7141","7","589","14.4","13.7"
"Walton","2020-07-06","249","7390","36","625","14.7","13.8"
"Walton","2020-07-07","179","7569","14","639","14","13.4"
"Walton","2020-07-08","199","7768","23","662","13.6","13.6"
"Walton","2020-07-09","337","8105","38","700","13.8","13.5"
"Walton","2020-07-10","215","8320","23","723","12.8","13.5"
"Walton","2020-07-11","127","8447","13","736","11.4","13.3"
"Walton","2020-07-12","81","8528","12","748","11.6","13"
"Walton","2020-07-13","150","8678","26","774","12","13.3"
"Walton","2020-07-14","142","8820","21","795","13","13.5"
"Walton","2020-07-15","145","8965","19","814","13.2","13.4"
"Walton","2020-07-16","125","9090","19","833","13.7","13.8"
"Walton","2020-07-17","156","9246","19","852","14","13.4"
"Walton","2020-07-18","110","9356","18","870","14.8","13.1"
"Walton","2020-07-19","71","9427","14","884","15.5","13.5"
"Walton","2020-07-20","257","9684","41","925","15.3","13.6"
"Walton","2020-07-21","192","9876","32","957","15.6","14.3"
"Walton","2020-07-22","139","10015","19","976","15.7","14.4"
"Walton","2020-07-23","189","10204","23","999","15.2","14.5"
"Walton","2020-07-24","239","10443","32","1031","15.4","14.7"
"Walton","2020-07-25","119","10562","23","1054","15.8","15.3"
"Walton","2020-07-26","42","10604","15","1069","18.1","16.8"
"Walton","2020-07-27","197","10801","36","1105","18.5","16.9"
"Walton","2020-07-28","166","10967","24","1129","18.1","16.9"
"Walton","2020-07-29","145","11112","22","1151","18.4","17"
"Walton","2020-07-30","133","11245","21","1172","18.9","17.1"
"Walton","2020-07-31","163","11408","19","1191","18.6","17"
"Walton","2020-08-01","84","11492","8","1199","17.2","16.5"
"Walton","2020-08-02","43","11535","8","1207","14.8","16.5"
"Walton","2020-08-03","158","11693","17","1224","13.7","16.1"
"Walton","2020-08-04","194","11887","25","1249","13.5","15.8"
"Walton","2020-08-05","134","12021","21","1270","13.6","16"
"Walton","2020-08-06","159","12180","24","1294","13.5","16.2"
"Walton","2020-08-07","172","12352","22","1316","13.6","16.1"
"Walton","2020-08-08","64","12416","9","1325","14.3","15.7"
"Walton","2020-08-09","45","12461","6","1331","13.5","14.1"
"Walton","2020-08-10","192","12653","19","1350","13.4","13.5"
"Walton","2020-08-11","195","12848","18","1368","12.9","13.2"
"Walton","2020-08-12","155","13003","18","1386","12.3","12.9"
"Walton","2020-08-13","199","13202","20","1406","11.6","12.5"
"Walton","2020-08-14","216","13418","24","1430","11.3","12.5"
"Walton","2020-08-15","92","13510","7","1437","10.4","12.3"
"Walton","2020-08-16","32","13542","8","1445","12.1","12.8"
"Walton","2020-08-17","164","13706","12","1457","11.7","12.5"
"Walton","2020-08-18","154","13860","19","1476","12.1","12.5"
"Walton","2020-08-19","143","14003","15","1491","12","12.1"
"Walton","2020-08-20","163","14166","12","1503","11.6","11.6"
"Walton","2020-08-21","212","14378","16","1519","11.1","11.2"
"Walton","2020-08-22","96","14474","11","1530","11.6","11"
"Walton","2020-08-23","32","14506","5","1535","10.3","11.2"
"Walton","2020-08-24","219","14725","19","1554","10.5","11.1"
"Walton","2020-08-25","153","14878","15","1569","10.1","11.1"
"Walton","2020-08-26","159","15037","15","1584","10","11"
"Walton","2020-08-27","141","15178","12","1596","10.2","10.9"
"Walton","2020-08-28","205","15383","22","1618","10.6","10.9"
"Walton","2020-08-29","98","15481","12","1630","10.7","11.2"
"Walton","2020-08-30","47","15528","4","1634","9.7","10"
"Walton","2020-08-31","187","15715","16","1650","9.7","10.1"
"Walton","2020-09-01","134","15849","14","1664","9.8","10"
"Walton","2020-09-02","142","15991","17","1681","10.1","10.1"
"Walton","2020-09-03","127","16118","12","1693","10.3","10.2"
"Walton","2020-09-04","146","16264","14","1707","10.1","10.4"
"Walton","2020-09-05","75","16339","5","1712","9.3","10"
"Walton","2020-09-06","27","16366","3","1715","9.7","9.7"
"Walton","2020-09-07","46","16412","5","1720","10","9.8"
"Walton","2020-09-08","121","16533","10","1730","9.7","9.7"
"Walton","2020-09-09","139","16672","10","1740","9","9.6"
"Walton","2020-09-10","113","16785","9","1749","8.8","9.5"
"Walton","2020-09-11","150","16935","14","1763","8.8","9.4"
"Walton","2020-09-12","39","16974","7","1770","10.4","9.8"
"Walton","2020-09-13","36","17010","3","1773","10","9.8"
"Walton","2020-09-14","145","17155","5","1778","8.9","9.5"
"Walton","2020-09-15","153","17308","12","1790","8.9","9.3"
"Walton","2020-09-16","98","17406","8","1798","9","9"
"Walton","2020-09-17","122","17528","10","1808","9","8.9"
"Walton","2020-09-18","148","17676","10","1818","8.7","8.7"
"Walton","2020-09-19","60","17736","6","1824","7.5","9"
"Walton","2020-09-20","34","17770","8","1832","9.7","9.8"
"Walton","2020-09-21","166","17936","9","1841","10","9.5"
"Walton","2020-09-22","105","18041","9","1850","10.1","9.5"
"Walton","2020-09-23","111","18152","7","1857","9.8","9.4"
"Walton","2020-09-24","101","18253","9","1866","9.9","9.5"
"Walton","2020-09-25","166","18419","16","1882","10.3","9.5"
"Walton","2020-09-26","46","18465","3","1885","9.8","8.7"
"Walton","2020-09-27","36","18501","4","1889","8.1","8.9"
"Walton","2020-09-28","131","18632","9","1898","8.3","9.1"
"Walton","2020-09-29","111","18743","3","1901","7.4","8.8"
"Walton","2020-09-30","137","18880","7","1908","7.3","8.5"
"Walton","2020-10-01","94","18974","5","1913","6.8","8.3"
"Walton","2020-10-02","140","19114","10","1923","6.4","8.4"
"Walton","2020-10-03","91","19205","5","1928","6.3","8"
"Walton","2020-10-04","43","19248","6","1934","6.7","7.4"
"Walton","2020-10-05","195","19443","20","1954","7.1","7.7"
"Walton","2020-10-06","152","19595","16","1970","8.3","7.8"
"Walton","2020-10-07","170","19765","8","1978","8.2","7.7"
"Walton","2020-10-08","161","19926","15","1993","8.8","7.8"
"Walton","2020-10-09","178","20104","13","2006","8.8","7.6"
"Walton","2020-10-10","85","20189","9","2015","9.5","7.9"
"Walton","2020-10-11","46","20235","4","2019","8.8","7.7"
"Walton","2020-10-12","116","20351","4","2023","7.8","7.5"
"Walton","2020-10-13","177","20528","19","2042","7.8","8"
"Walton","2020-10-14","141","20669","12","2054","8.4","8.3"
"Walton","2020-10-15","143","20812","13","2067","8.3","8.6"
"Walton","2020-10-16","148","20960","14","2081","8.6","8.7"
"Walton","2020-10-17","97","21057","8","2089","8.3","8.9"
"Walton","2020-10-18","29","21086","3","2092","8.5","8.7"
"Walton","2020-10-19","176","21262","11","2103","8.9","8.4"
"Walton","2020-10-20","119","21381","10","2113","8.6","8.2"
"Walton","2020-10-21","177","21558","13","2126","8.4","8.4"
"Walton","2020-10-22","146","21704","8","2134","7.9","8.1"
"Walton","2020-10-23","175","21879","15","2149","7.8","8.2"
"Walton","2020-10-24","58","21937","11","2160","9.3","8.8"
"Walton","2020-10-25","38","21975","5","2165","9.7","9.1"
"Walton","2020-10-26","192","22167","15","2180","10","9.5"
"Walton","2020-10-27","146","22313","10","2190","9.7","9.2"
"Walton","2020-10-28","134","22447","11","2201","9.9","9.2"
"Walton","2020-10-29","108","22555","11","2212","10.5","9.2"
"Walton","2020-10-30","157","22712","11","2223","10.3","9.1"
"Walton","2020-10-31","99","22811","7","2230","8.6","9"
"Walton","2020-11-01","61","22872","9","2239","8.8","9.3"
"Walton","2020-11-02","203","23075","18","2257","9","9.5"
"Walton","2020-11-03","122","23197","10","2267","9.2","9.5"
"Walton","2020-11-04","136","23333","16","2283","9.7","9.8"
"Walton","2020-11-05","145","23478","6","2289","8.8","9.7"
"Walton","2020-11-06","215","23693","15","2304","8.8","9.6"
"Walton","2020-11-07","78","23771","13","2317","10.2","9.4"
"Walton","2020-11-08","97","23868","8","2325","9.3","9.1"
"Walton","2020-11-09","191","24059","17","2342","9.3","9.1"
"Walton","2020-11-10","242","24301","17","2359","9.1","9.1"
"Walton","2020-11-11","158","24459","15","2374","8.8","9.2"
"Walton","2020-11-12","168","24627","14","2388","9.4","9.1"
"Walton","2020-11-13","213","24840","21","2409","9.8","9.3"
"Walton","2020-11-14","137","24977","19","2428","9.4","9.8"
"Walton","2020-11-15","110","25087","7","2435","9.1","9.2"
"Walton","2020-11-16","230","25317","22","2457","9.2","9.2"
"Walton","2020-11-17","199","25516","24","2481","9.9","9.5"
"Walton","2020-11-18","265","25781","28","2509","10.1","9.4"
"Walton","2020-11-19","251","26032","22","2531","10.1","9.8"
"Walton","2020-11-20","257","26289","31","2562","10.5","10.1"
"Walton","2020-11-21","164","26453","19","2581","10.1","9.8"
"Walton","2020-11-22","93","26546","12","2593","11.1","10.1"
"Walton","2020-11-23","247","26793","34","2627","11.7","10.4"
"Walton","2020-11-24","196","26989","39","2666","12.8","11.4"
"Walton","2020-11-25","267","27256","53","2719","14.1","12.1"
"Walton","2020-11-26","46","27302","7","2726","15","12.6"
"Walton","2020-11-27","222","27524","35","2761","15.6","13"
"Walton","2020-11-28","126","27650","35","2796","17.9","14"
"Walton","2020-11-29","108","27758","26","2822","19.5","15.3"
"Walton","2020-11-30","320","28078","41","2863","19.3","15.5"
"Walton","2020-12-01","246","28324","54","2917","19.6","16.2"
"Walton","2020-12-02","364","28688","69","2986","19.5","16.8"
"Walton","2020-12-03","317","29005","62","3048","20.1","17.6"
"Walton","2020-12-04","355","29360","47","3095","19.8","17.7"
"Walton","2020-12-05","144","29504","29","3124","18.7","18.3"
"Walton","2020-12-06","144","29648","28","3152","18","18.7"
"Walton","2020-12-07","307","29955","48","3200","18.4","18.9"
"Walton","2020-12-08","308","30263","56","3256","17.9","18.8"
"Walton","2020-12-09","298","30561","48","3304","17.5","18.5"
"Walton","2020-12-10","341","30902","63","3367","17.3","18.7"
"Walton","2020-12-11","455","31357","63","3430","17.4","18.6"
"Walton","2020-12-12","271","31628","51","3481","17.2","17.9"
"Walton","2020-12-13","103","31731","30","3511","18.6","18.3"
"Walton","2020-12-14","411","32142","74","3585","18.9","18.7"
"Walton","2020-12-15","307","32449","45","3630","18.4","18.2"
"Walton","2020-12-16","344","32793","84","3714","19.6","18.5"
"Walton","2020-12-17","338","33131","91","3805","20.8","19.1"
"Walton","2020-12-18","376","33507","73","3878","21.6","19.5"
"Walton","2020-12-19","203","33710","44","3922","22","19.6"
"Walton","2020-12-20","134","33844","33","3955","21.4","20"
"Walton","2020-12-21","411","34255","127","4082","23.2","21.1"
"Walton","2020-12-22","411","34666","137","4219","25.9","22.2"
"Walton","2020-12-23","435","35101","126","4345","26.5","23.1"
"Walton","2020-12-24","408","35509","80","4425","25.5","23.2"
"Walton","2020-12-25","34","35543","15","4440","29","25.3"
"Walton","2020-12-26","161","35704","50","4490","30.4","26.2"
"Walton","2020-12-27","155","35859","63","4553","32.7","27"
"Walton","2020-12-28","451","36310","142","4695","32.7","28"
"Walton","2020-12-29","370","36680","142","4837","33.5","29.7"
"Walton","2020-12-30","421","37101","151","4988","34.5","30.5"
"Walton","2020-12-31","398","37499","126","5114","36.2","30.8"
"Walton","2021-01-01","97","37596","36","5150","35.2","32.1"
"Walton","2021-01-02","136","37732","41","5191","35","32.7"
"Walton","2021-01-03","200","37932","31","5222","31.4","32.1"
"Walton","2021-01-04","409","38341","113","5335","30.9","31.8"
"Walton","2021-01-05","447","38788","138","5473","29.8","31.6"
"Walton","2021-01-06","415","39203","126","5599","29","31.7"
"Walton","2021-01-07","516","39719","130","5729","28.1","32.1"
"Walton","2021-01-08","410","40129","95","5824","26.1","30.6"
"Walton","2021-01-09","236","40365","61","5885","25.5","30.3"
"Walton","2021-01-10","124","40489","41","5926","28","29.7"
"Walton","2021-01-11","386","40875","84","6010","27.2","29"
"Walton","2021-01-12","413","41288","105","6115","26.4","28.1"
"Walton","2021-01-13","422","41710","111","6226","25.8","27.4"
"Walton","2021-01-14","341","42051","86","6312","25.8","27"
"Walton","2021-01-15","432","42483","100","6412","25.8","26"
"Walton","2021-01-16","227","42710","37","6449","24.5","25"
"Walton","2021-01-17","130","42840","40","6489","24.1","26.1"
"Walton","2021-01-18","300","43140","81","6570","24.9","26"
"Walton","2021-01-19","320","43460","64","6634","24.1","25.3"
"Walton","2021-01-20","270","43730","56","6690","23.3","24.6"
"Walton","2021-01-21","327","44057","60","6750","22.3","24.1"
"Walton","2021-01-22","318","44375","42","6792","20.9","23.4"
"Walton","2021-01-23","201","44576","36","6828","21.1","22.8"
"Walton","2021-01-24","118","44694","28","6856","20.1","22.1"
"Walton","2021-01-25","328","45022","67","6923","19.2","22"
"Walton","2021-01-26","284","45306","49","6972","18.8","21.5"
"Walton","2021-01-27","295","45601","62","7034","18.8","21.1"
"Walton","2021-01-28","331","45932","60","7094","18.8","20.6"
"Walton","2021-01-29","283","46215","34","7128","18.6","19.8"
"Walton","2021-01-30","124","46339","20","7148","18.4","19.8"
"Walton","2021-01-31","90","46429","14","7162","17.2","18.7"
"Walton","2021-02-01","258","46687","41","7203","16.6","17.9"
"Walton","2021-02-02","244","46931","42","7245","16.6","17.7"
"Walton","2021-02-03","286","47217","30","7275","15.1","17"
"Walton","2021-02-04","239","47456","29","7304","14.2","16.5"
"Walton","2021-02-05","192","47648","20","7324","14","16.3"
"Walton","2021-02-06","26","47674","3","7327","13.3","15.9"
"Walton","2021-02-07","4","47678","1","7328","14.7","15.9"
"Walton","2021-02-08","0","47678","0","7328","12.4","14.5"
"Ware","2020-02-01","0","0","0","0",".","."
"Ware","2020-02-02","0","0","0","0",".","."
"Ware","2020-02-03","0","0","0","0",".","."
"Ware","2020-02-04","0","0","0","0",".","."
"Ware","2020-02-05","0","0","0","0",".","."
"Ware","2020-02-06","0","0","0","0",".","."
"Ware","2020-02-07","0","0","0","0","0","."
"Ware","2020-02-08","0","0","0","0","0","."
"Ware","2020-02-09","0","0","0","0","0","."
"Ware","2020-02-10","0","0","0","0","0","."
"Ware","2020-02-11","0","0","0","0","0","."
"Ware","2020-02-12","0","0","0","0","0","."
"Ware","2020-02-13","0","0","0","0","0","."
"Ware","2020-02-14","0","0","0","0","0","0"
"Ware","2020-02-15","0","0","0","0","0","0"
"Ware","2020-02-16","0","0","0","0","0","0"
"Ware","2020-02-17","0","0","0","0","0","0"
"Ware","2020-02-18","0","0","0","0","0","0"
"Ware","2020-02-19","0","0","0","0","0","0"
"Ware","2020-02-20","0","0","0","0","0","0"
"Ware","2020-02-21","0","0","0","0","0","0"
"Ware","2020-02-22","0","0","0","0","0","0"
"Ware","2020-02-23","0","0","0","0","0","0"
"Ware","2020-02-24","0","0","0","0","0","0"
"Ware","2020-02-25","0","0","0","0","0","0"
"Ware","2020-02-26","0","0","0","0","0","0"
"Ware","2020-02-27","0","0","0","0","0","0"
"Ware","2020-02-28","0","0","0","0","0","0"
"Ware","2020-02-29","0","0","0","0","0","0"
"Ware","2020-03-01","0","0","0","0","0","0"
"Ware","2020-03-02","0","0","0","0","0","0"
"Ware","2020-03-03","0","0","0","0","0","0"
"Ware","2020-03-04","0","0","0","0","0","0"
"Ware","2020-03-05","0","0","0","0","0","0"
"Ware","2020-03-06","0","0","0","0","0","0"
"Ware","2020-03-07","0","0","0","0","0","0"
"Ware","2020-03-08","0","0","0","0","0","0"
"Ware","2020-03-09","0","0","0","0","0","0"
"Ware","2020-03-10","0","0","0","0","0","0"
"Ware","2020-03-11","1","1","0","0","0","0"
"Ware","2020-03-12","0","1","0","0","0","0"
"Ware","2020-03-13","19","20","0","0","0","0"
"Ware","2020-03-14","1","21","0","0","0","0"
"Ware","2020-03-15","1","22","0","0","0","0"
"Ware","2020-03-16","1","23","0","0","0","0"
"Ware","2020-03-17","7","30","0","0","0","0"
"Ware","2020-03-18","10","40","2","2","2.9","1.4"
"Ware","2020-03-19","8","48","0","2","2.9","1.4"
"Ware","2020-03-20","24","72","0","2","2.9","1.4"
"Ware","2020-03-21","5","77","0","2","2.9","1.4"
"Ware","2020-03-22","3","80","0","2","2.9","1.4"
"Ware","2020-03-23","39","119","1","3","3.2","1.6"
"Ware","2020-03-24","40","159","4","7","4.7","2.3"
"Ware","2020-03-25","43","202","0","7","1.8","2.3"
"Ware","2020-03-26","38","240","3","10","2.9","2.9"
"Ware","2020-03-27","27","267","4","14","5","3.9"
"Ware","2020-03-28","2","269","0","14","5","3.9"
"Ware","2020-03-29","0","269","0","14","5","3.9"
"Ware","2020-03-30","43","312","8","22","7.3","5.3"
"Ware","2020-03-31","39","351","8","30","8.8","6.7"
"Ware","2020-04-01","33","384","7","37","11.9","6.8"
"Ware","2020-04-02","49","433","7","44","12.8","7.8"
"Ware","2020-04-03","50","483","7","51","12.7","8.8"
"Ware","2020-04-04","14","497","1","52","13.7","9.4"
"Ware","2020-04-05","0","497","0","52","13.7","9.4"
"Ware","2020-04-06","53","550","9","61","13.4","10.4"
"Ware","2020-04-07","79","629","9","70","12.1","10.5"
"Ware","2020-04-08","60","689","15","85","12.7","12.3"
"Ware","2020-04-09","51","740","10","95","13.4","13.1"
"Ware","2020-04-10","51","791","9","104","14","13.3"
"Ware","2020-04-11","18","809","4","108","16.1","14.9"
"Ware","2020-04-12","4","813","2","110","23.3","18.5"
"Ware","2020-04-13","22","835","2","112","22.1","17.8"
"Ware","2020-04-14","27","862","1","113","21","16.6"
"Ware","2020-04-15","28","890","7","120","21","16.9"
"Ware","2020-04-16","56","946","7","127","20","16.7"
"Ware","2020-04-17","41","987","4","131","18.9","16.4"
"Ware","2020-04-18","17","1004","3","134","18.2","17.2"
"Ware","2020-04-19","14","1018","4","138","15.2","19.2"
"Ware","2020-04-20","42","1060","11","149","17.6","19.9"
"Ware","2020-04-21","36","1096","1","150","17.5","19.3"
"Ware","2020-04-22","23","1119","2","152","15.2","18.1"
"Ware","2020-04-23","19","1138","3","155","15.6","17.8"
"Ware","2020-04-24","26","1164","2","157","15.3","17.1"
"Ware","2020-04-25","15","1179","2","159","14.7","16.5"
"Ware","2020-04-26","7","1186","0","159","10.6","12.9"
"Ware","2020-04-27","22","1208","1","160","7.5","12.6"
"Ware","2020-04-28","44","1252","9","169","10.1","13.8"
"Ware","2020-04-29","30","1282","2","171","9.8","12.5"
"Ware","2020-04-30","36","1318","6","177","9.9","12.8"
"Ware","2020-05-01","18","1336","0","177","8.8","12.1"
"Ware","2020-05-02","12","1348","1","178","8.1","11.4"
"Ware","2020-05-03","9","1357","2","180","11.3","11"
"Ware","2020-05-04","143","1500","6","186","11.2","9.4"
"Ware","2020-05-05","125","1625","9","195","9.3","9.7"
"Ware","2020-05-06","112","1737","2","197","8.6","9.2"
"Ware","2020-05-07","90","1827","9","206","7.7","8.8"
"Ware","2020-05-08","19","1846","2","208","9.2","9"
"Ware","2020-05-09","6","1852","1","209","10.4","9.2"
"Ware","2020-05-10","2","1854","0","209","7.2","9.2"
"Ware","2020-05-11","122","1976","14","223","8.2","9.7"
"Ware","2020-05-12","117","2093","4","227","7.7","8.5"
"Ware","2020-05-13","49","2142","2","229","8","8.3"
"Ware","2020-05-14","13","2155","1","230","7.7","7.7"
"Ware","2020-05-15","27","2182","5","235","8.8","9"
"Ware","2020-05-16","15","2197","1","236","7.4","8.9"
"Ware","2020-05-17","10","2207","0","236","7.4","7.3"
"Ware","2020-05-18","60","2267","6","242","7.2","7.7"
"Ware","2020-05-19","86","2353","5","247","7.5","7.6"
"Ware","2020-05-20","45","2398","3","250","7.9","8"
"Ware","2020-05-21","128","2526","9","259","7.8","7.8"
"Ware","2020-05-22","96","2622","1","260","5.3","7.1"
"Ware","2020-05-23","11","2633","0","260","4.4","5.9"
"Ware","2020-05-24","54","2687","3","263","5.2","6.3"
"Ware","2020-05-25","19","2706","2","265","5.2","6.2"
"Ware","2020-05-26","203","2909","12","277","5.2","6.4"
"Ware","2020-05-27","129","3038","5","282","4.8","6.4"
"Ware","2020-05-28","227","3265","4","286","4.1","6"
"Ware","2020-05-29","53","3318","2","288","4.5","4.9"
"Ware","2020-05-30","2","3320","1","289","11.6","8"
"Ware","2020-05-31","1","3321","0","289","10.8","8"
"Ware","2020-06-01","71","3392","2","291","9.7","7.5"
"Ware","2020-06-02","57","3449","5","296","10.1","7.7"
"Ware","2020-06-03","153","3602","4","300","10","7.4"
"Ware","2020-06-04","45","3647","0","300","9.7","6.9"
"Ware","2020-06-05","120","3767","4","304","9.6","7.1"
"Ware","2020-06-06","13","3780","2","306","4.7","8.2"
"Ware","2020-06-07","10","3790","0","306","4.7","7.8"
"Ware","2020-06-08","196","3986","19","325","5.7","7.7"
"Ware","2020-06-09","211","4197","6","331","4.8","7.5"
"Ware","2020-06-10","157","4354","0","331","4.5","7.2"
"Ware","2020-06-11","146","4500","7","338","5.1","7.4"
"Ware","2020-06-12","101","4601","6","344","5.5","7.6"
"Ware","2020-06-13","9","4610","2","346","6.5","5.6"
"Ware","2020-06-14","5","4615","1","347","9.4","7"
"Ware","2020-06-15","134","4749","17","364","9.8","7.7"
"Ware","2020-06-16","149","4898","14","378","10.7","7.8"
"Ware","2020-06-17","139","5037","19","397","12.7","8.6"
"Ware","2020-06-18","178","5215","12","409","13","9.1"
"Ware","2020-06-19","155","5370","16","425","13.6","9.5"
"Ware","2020-06-20","60","5430","3","428","11.1","8.8"
"Ware","2020-06-21","9","5439","2","430","11.4","10.4"
"Ware","2020-06-22","129","5568","27","457","12.6","11.2"
"Ware","2020-06-23","248","5816","36","493","13.3","12"
"Ware","2020-06-24","90","5906","10","503","13","12.8"
"Ware","2020-06-25","333","6239","24","527","13","13"
"Ware","2020-06-26","197","6436","6","533","12","12.8"
"Ware","2020-06-27","22","6458","4","537","13.9","12.5"
"Ware","2020-06-28","18","6476","4","541","13.9","12.7"
"Ware","2020-06-29","220","6696","22","563","12.3","12.5"
"Ware","2020-06-30","227","6923","23","586","11.7","12.5"
"Ware","2020-07-01","140","7063","10","596","11.1","12.1"
"Ware","2020-07-02","307","7370","24","620","11.2","12.1"
"Ware","2020-07-03","112","7482","11","631","12.2","12.1"
"Ware","2020-07-04","35","7517","7","638","12.4","13.2"
"Ware","2020-07-05","14","7531","6","644","15.4","14.6"
"Ware","2020-07-06","111","7642","17","661","16.2","14.2"
"Ware","2020-07-07","178","7820","39","700","17.8","14.8"
"Ware","2020-07-08","80","7900","10","710","18.6","14.9"
"Ware","2020-07-09","244","8144","23","733","18.8","15"
"Ware","2020-07-10","60","8204","12","745","20.3","16.2"
"Ware","2020-07-11","40","8244","10","755","21","16.7"
"Ware","2020-07-12","18","8262","3","758","17.3","16.3"
"Ware","2020-07-13","181","8443","18","776","16.5","16.3"
"Ware","2020-07-14","46","8489","9","785","16.2","17"
"Ware","2020-07-15","153","8642","23","808","16.5","17.6"
"Ware","2020-07-16","215","8857","26","834","16.9","17.9"
"Ware","2020-07-17","71","8928","8","842","15.7","18"
"Ware","2020-07-18","30","8958","5","847","14.5","17.7"
"Ware","2020-07-19","10","8968","2","849","14.9","16.1"
"Ware","2020-07-20","134","9102","14","863","15","15.8"
"Ware","2020-07-21","80","9182","17","880","15.3","15.7"
"Ware","2020-07-22","167","9349","14","894","14.3","15.4"
"Ware","2020-07-23","132","9481","15","909","14.2","15.5"
"Ware","2020-07-24","50","9531","5","914","14","14.8"
"Ware","2020-07-25","19","9550","1","915","12.4","13.4"
"Ware","2020-07-26","22","9572","2","917","10.8","12.9"
"Ware","2020-07-27","280","9852","11","928","9.9","12.5"
"Ware","2020-07-28","178","10030","13","941","7.9","11.6"
"Ware","2020-07-29","110","10140","6","947","7.5","10.9"
"Ware","2020-07-30","155","10295","5","952","6.3","10.3"
"Ware","2020-07-31","44","10339","1","953","5.2","9.6"
"Ware","2020-08-01","62","10401","16","969","8.2","10.3"
"Ware","2020-08-02","24","10425","4","973","9.2","10"
"Ware","2020-08-03","279","10704","11","984","9.2","9.6"
"Ware","2020-08-04","109","10813","12","996","9.8","8.8"
"Ware","2020-08-05","151","10964","9","1005","9.8","8.7"
"Ware","2020-08-06","185","11149","16","1021","10.6","8.5"
"Ware","2020-08-07","101","11250","14","1035","12.3","8.7"
"Ware","2020-08-08","12","11262","5","1040","14.5","11.3"
"Ware","2020-08-09","24","11286","14","1054","20.5","14.9"
"Ware","2020-08-10","283","11569","5","1059","20.2","14.7"
"Ware","2020-08-11","114","11683","10","1069","19.9","14.8"
"Ware","2020-08-12","127","11810","9","1078","20","14.9"
"Ware","2020-08-13","81","11891","5","1083","19.7","15.1"
"Ware","2020-08-14","46","11937","16","1099","22.7","17.5"
"Ware","2020-08-15","20","11957","5","1104","20.3","17.4"
"Ware","2020-08-16","8","11965","1","1105","13.7","17.1"
"Ware","2020-08-17","259","12224","12","1117","14.1","17.2"
"Ware","2020-08-18","137","12361","11","1128","14","16.9"
"Ware","2020-08-19","130","12491","7","1135","13.8","16.9"
"Ware","2020-08-20","73","12564","5","1140","13.9","16.8"
"Ware","2020-08-21","40","12604","7","1147","11.4","17"
"Ware","2020-08-22","19","12623","1","1148","8.6","14.4"
"Ware","2020-08-23","11","12634","0","1148","6.8","10.3"
"Ware","2020-08-24","274","12908","5","1153","6.4","10.3"
"Ware","2020-08-25","131","13039","5","1158","5.8","9.9"
"Ware","2020-08-26","115","13154","9","1167","6.2","10"
"Ware","2020-08-27","84","13238","4","1171","5.9","9.9"
"Ware","2020-08-28","42","13280","4","1175","4.7","8.1"
"Ware","2020-08-29","30","13310","2","1177","4.9","6.8"
"Ware","2020-08-30","81","13391","5","1182","5.8","6.3"
"Ware","2020-08-31","302","13693","8","1190","5.9","6.2"
"Ware","2020-09-01","274","13967","19","1209","6.4","6.1"
"Ware","2020-09-02","168","14135","17","1226","6.7","6.4"
"Ware","2020-09-03","69","14204","2","1228","6.4","6.1"
"Ware","2020-09-04","135","14339","5","1233","5.6","5.2"
"Ware","2020-09-05","22","14361","2","1235","5.9","5.4"
"Ware","2020-09-06","20","14381","2","1237","6.5","6.1"
"Ware","2020-09-07","200","14581","6","1243","6.5","6.2"
"Ware","2020-09-08","155","14736","8","1251","6.3","6.3"
"Ware","2020-09-09","210","14946","13","1264","5.7","6.2"
"Ware","2020-09-10","208","15154","12","1276","6.1","6.3"
"Ware","2020-09-11","71","15225","4","1280","6.4","6"
"Ware","2020-09-12","12","15237","1","1281","6.3","6.1"
"Ware","2020-09-13","49","15286","27","1308","12.7","9.6"
"Ware","2020-09-14","282","15568","9","1317","12.8","9.7"
"Ware","2020-09-15","129","15697","6","1323","12.7","9.5"
"Ware","2020-09-16","229","15926","5","1328","12.1","8.9"
"Ware","2020-09-17","138","16064","4","1332","11.7","8.9"
"Ware","2020-09-18","41","16105","1","1333","11.3","8.8"
"Ware","2020-09-19","15","16120","0","1333","10.1","8.2"
"Ware","2020-09-20","21","16141","0","1333","2.2","7.5"
"Ware","2020-09-21","268","16409","3","1336","1.9","7.3"
"Ware","2020-09-22","148","16557","3","1339","1.5","7.1"
"Ware","2020-09-23","117","16674","8","1347","2.2","7.2"
"Ware","2020-09-24","48","16722","3","1350","2.7","7.2"
"Ware","2020-09-25","33","16755","2","1352","3.2","7.2"
"Ware","2020-09-26","27","16782","1","1353","3.7","6.9"
"Ware","2020-09-27","20","16802","0","1353","3.7","3"
"Ware","2020-09-28","274","17076","6","1359","3.9","2.9"
"Ware","2020-09-29","176","17252","5","1364","4","2.8"
"Ware","2020-09-30","87","17339","2","1366","3.3","2.8"
"Ware","2020-10-01","79","17418","1","1367","2.6","2.6"
"Ware","2020-10-02","52","17470","2","1369","2.3","2.7"
"Ware","2020-10-03","35","17505","0","1369","1.8","2.7"
"Ware","2020-10-04","16","17521","0","1369","1.8","2.7"
"Ware","2020-10-05","280","17801","37","1406","3.4","3.6"
"Ware","2020-10-06","178","17979","34","1440","5.7","4.8"
"Ware","2020-10-07","115","18094","0","1440","5.3","4.3"
"Ware","2020-10-08","153","18247","8","1448","5.9","4.3"
"Ware","2020-10-09","57","18304","1","1449","5.6","4"
"Ware","2020-10-10","21","18325","0","1449","5.6","3.7"
"Ware","2020-10-11","82","18407","7","1456","6.8","4.3"
"Ware","2020-10-12","385","18792","62","1518","7.2","5.3"
"Ware","2020-10-13","193","18985","10","1528","5.3","5.5"
"Ware","2020-10-14","170","19155","13","1541","6.4","5.8"
"Ware","2020-10-15","97","19252","2","1543","5.9","5.9"
"Ware","2020-10-16","58","19310","15","1558","9.3","7.5"
"Ware","2020-10-17","13","19323","1","1559","10.4","8"
"Ware","2020-10-18","12","19335","0","1559","9.2","8"
"Ware","2020-10-19","339","19674","12","1571","7.4","7.3"
"Ware","2020-10-20","178","19852","16","1587","8","6.6"
"Ware","2020-10-21","117","19969","2","1589","7.1","6.7"
"Ware","2020-10-22","90","20059","4","1593","7.5","6.7"
"Ware","2020-10-23","83","20142","4","1597","4.5","6.9"
"Ware","2020-10-24","29","20171","2","1599","4.3","7.4"
"Ware","2020-10-25","15","20186","4","1603","8.2","8.7"
"Ware","2020-10-26","358","20544","10","1613","8","7.7"
"Ware","2020-10-27","117","20661","9","1622","7.9","7.9"
"Ware","2020-10-28","182","20843","8","1630","8.2","7.7"
"Ware","2020-10-29","84","20927","7","1637","8.8","8.1"
"Ware","2020-10-30","55","20982","2","1639","8.6","6.5"
"Ware","2020-10-31","30","21012","5","1644","10","7.2"
"Ware","2020-11-01","20","21032","2","1646","7.6","7.9"
"Ware","2020-11-02","305","21337","5","1651","7.5","7.8"
"Ware","2020-11-03","137","21474","8","1659","7.2","7.5"
"Ware","2020-11-04","100","21574","7","1666","7.6","7.9"
"Ware","2020-11-05","86","21660","6","1672","7.4","8.1"
"Ware","2020-11-06","81","21741","10","1682","8.6","8.6"
"Ware","2020-11-07","37","21778","8","1690","9.3","9.7"
"Ware","2020-11-08","10","21788","1","1691","9.3","8.5"
"Ware","2020-11-09","320","22108","8","1699","9.5","8.5"
"Ware","2020-11-10","91","22199","2","1701","8.9","8.1"
"Ware","2020-11-11","134","22333","8","1709","8.8","8.2"
"Ware","2020-11-12","233","22566","8","1717","8.3","7.8"
"Ware","2020-11-13","84","22650","11","1728","8.4","8.5"
"Ware","2020-11-14","31","22681","5","1733","7.6","8.5"
"Ware","2020-11-15","15","22696","0","1733","6.2","7.8"
"Ware","2020-11-16","340","23036","11","1744","6.3","7.9"
"Ware","2020-11-17","98","23134","3","1747","6.4","7.7"
"Ware","2020-11-18","220","23354","16","1763","6.6","7.7"
"Ware","2020-11-19","235","23589","4","1767","6.4","7.3"
"Ware","2020-11-20","64","23653","5","1772","5.6","7"
"Ware","2020-11-21","24","23677","0","1772","3.3","5.5"
"Ware","2020-11-22","14","23691","2","1774","5.3","5.8"
"Ware","2020-11-23","375","24066","7","1781","5.1","5.7"
"Ware","2020-11-24","87","24153","3","1784","5.2","5.8"
"Ware","2020-11-25","92","24245","2","1786","4.5","5.5"
"Ware","2020-11-26","55","24300","2","1788","4.7","5.6"
"Ware","2020-11-27","38","24338","3","1791","4.8","5.2"
"Ware","2020-11-28","45","24383","2","1793","5.4","4.3"
"Ware","2020-11-29","20","24403","0","1793","3.4","4.3"
"Ware","2020-11-30","341","24744","6","1799","3.3","4.2"
"Ware","2020-12-01","102","24846","3","1802","3.3","4.2"
"Ware","2020-12-02","151","24997","4","1806","3.3","3.9"
"Ware","2020-12-03","33","25030","0","1806","2.8","3.8"
"Ware","2020-12-04","117","25147","3","1809","2.1","3.4"
"Ware","2020-12-05","52","25199","0","1809","1.4","3.4"
"Ware","2020-12-06","21","25220","5","1814","4.8","4.1"
"Ware","2020-12-07","356","25576","11","1825","5","4.2"
"Ware","2020-12-08","157","25733","2","1827","4.8","4"
"Ware","2020-12-09","83","25816","9","1836","5.9","4.6"
"Ware","2020-12-10","75","25891","8","1844","7.5","5.1"
"Ware","2020-12-11","156","26047","10","1854","8","5"
"Ware","2020-12-12","38","26085","5","1859","9.9","5.7"
"Ware","2020-12-13","30","26115","6","1865","9.3","7.1"
"Ware","2020-12-14","370","26485","17","1882","9.6","7.3"
"Ware","2020-12-15","126","26611","15","1897","11.1","7.9"
"Ware","2020-12-16","188","26799","18","1915","10.9","8.4"
"Ware","2020-12-17","102","26901","8","1923","10.5","9"
"Ware","2020-12-18","138","27039","10","1933","10.6","9.3"
"Ware","2020-12-19","40","27079","8","1941","11.6","10.7"
"Ware","2020-12-20","35","27114","6","1947","11.2","10.3"
"Ware","2020-12-21","388","27502","18","1965","11.2","10.4"
"Ware","2020-12-22","190","27692","15","1980","10.6","10.9"
"Ware","2020-12-23","150","27842","20","2000","11.2","11"
"Ware","2020-12-24","40","27882","14","2014","15","12.8"
"Ware","2020-12-25","18","27900","8","2022","20.4","15.5"
"Ware","2020-12-26","71","27971","12","2034","19.9","15.8"
"Ware","2020-12-27","48","28019","8","2042","19.8","15.5"
"Ware","2020-12-28","407","28426","31","2073","20.3","15.7"
"Ware","2020-12-29","153","28579","22","2095","21.2","15.9"
"Ware","2020-12-30","225","28804","46","2141","22.2","16.7"
"Ware","2020-12-31","77","28881","29","2170","22.6","18.8"
"Ware","2021-01-01","28","28909","11","2181","21.9","21.1"
"Ware","2021-01-02","57","28966","13","2194","22.7","21.3"
"Ware","2021-01-03","69","29035","25","2219","25.5","22.7"
"Ware","2021-01-04","410","29445","39","2258","25.8","23"
"Ware","2021-01-05","240","29685","29","2287","25.4","23.3"
"Ware","2021-01-06","199","29884","19","2306","23.9","23"
"Ware","2021-01-07","210","30094","26","2332","20.3","21.4"
"Ware","2021-01-08","147","30241","24","2356","17","19.4"
"Ware","2021-01-09","55","30296","9","2365","16.1","19.4"
"Ware","2021-01-10","25","30321","7","2372","14.9","20.2"
"Ware","2021-01-11","459","30780","59","2431","15.4","20.6"
"Ware","2021-01-12","247","31027","47","2478","16.4","20.9"
"Ware","2021-01-13","132","31159","23","2501","17.5","20.7"
"Ware","2021-01-14","186","31345","27","2528","17.8","19"
"Ware","2021-01-15","166","31511","21","2549","17.3","17.1"
"Ware","2021-01-16","38","31549","8","2557","17.9","17"
"Ware","2021-01-17","36","31585","6","2563","16.3","15.6"
"Ware","2021-01-18","392","31977","52","2615","16.4","15.9"
"Ware","2021-01-19","203","32180","14","2629","14.6","15.5"
"Ware","2021-01-20","169","32349","27","2656","14.4","16"
"Ware","2021-01-21","164","32513","19","2675","14","15.9"
"Ware","2021-01-22","204","32717","13","2688","13.1","15.2"
"Ware","2021-01-23","132","32849","6","2694","10.8","14.3"
"Ware","2021-01-24","16","32865","1","2695","9.3","12.8"
"Ware","2021-01-25","356","33221","49","2744","9.3","12.9"
"Ware","2021-01-26","211","33432","14","2758","9.3","12"
"Ware","2021-01-27","110","33542","13","2771","8.7","11.6"
"Ware","2021-01-28","171","33713","13","2784","8.1","11.1"
"Ware","2021-01-29","173","33886","10","2794","8.1","10.6"
"Ware","2021-01-30","99","33985","13","2807","9.3","10"
"Ware","2021-01-31","20","34005","6","2813","12.7","11"
"Ware","2021-02-01","348","34353","27","2840","11.8","10.6"
"Ware","2021-02-02","144","34497","8","2848","11.7","10.5"
"Ware","2021-02-03","69","34566","4","2852","10.8","9.8"
"Ware","2021-02-04","158","34724","7","2859","10.4","9.2"
"Ware","2021-02-05","132","34856","9","2868","10.5","9.3"
"Ware","2021-02-06","10","34866","3","2871","12.9","11.1"
"Ware","2021-02-07","4","34870","1","2872","12.2","12.4"
"Ware","2021-02-08","0","34870","0","2872","11.1","11.5"
"Warren","2020-02-01","0","0","0","0",".","."
"Warren","2020-02-02","0","0","0","0",".","."
"Warren","2020-02-03","0","0","0","0",".","."
"Warren","2020-02-04","0","0","0","0",".","."
"Warren","2020-02-05","0","0","0","0",".","."
"Warren","2020-02-06","0","0","0","0",".","."
"Warren","2020-02-07","0","0","0","0","0","."
"Warren","2020-02-08","0","0","0","0","0","."
"Warren","2020-02-09","0","0","0","0","0","."
"Warren","2020-02-10","0","0","0","0","0","."
"Warren","2020-02-11","0","0","0","0","0","."
"Warren","2020-02-12","0","0","0","0","0","."
"Warren","2020-02-13","0","0","0","0","0","."
"Warren","2020-02-14","0","0","0","0","0","0"
"Warren","2020-02-15","0","0","0","0","0","0"
"Warren","2020-02-16","0","0","0","0","0","0"
"Warren","2020-02-17","0","0","0","0","0","0"
"Warren","2020-02-18","0","0","0","0","0","0"
"Warren","2020-02-19","0","0","0","0","0","0"
"Warren","2020-02-20","0","0","0","0","0","0"
"Warren","2020-02-21","0","0","0","0","0","0"
"Warren","2020-02-22","0","0","0","0","0","0"
"Warren","2020-02-23","0","0","0","0","0","0"
"Warren","2020-02-24","0","0","0","0","0","0"
"Warren","2020-02-25","0","0","0","0","0","0"
"Warren","2020-02-26","0","0","0","0","0","0"
"Warren","2020-02-27","0","0","0","0","0","0"
"Warren","2020-02-28","0","0","0","0","0","0"
"Warren","2020-02-29","0","0","0","0","0","0"
"Warren","2020-03-01","0","0","0","0","0","0"
"Warren","2020-03-02","0","0","0","0","0","0"
"Warren","2020-03-03","0","0","0","0","0","0"
"Warren","2020-03-04","0","0","0","0","0","0"
"Warren","2020-03-05","0","0","0","0","0","0"
"Warren","2020-03-06","0","0","0","0","0","0"
"Warren","2020-03-07","0","0","0","0","0","0"
"Warren","2020-03-08","0","0","0","0","0","0"
"Warren","2020-03-09","0","0","0","0","0","0"
"Warren","2020-03-10","0","0","0","0","0","0"
"Warren","2020-03-11","0","0","0","0","0","0"
"Warren","2020-03-12","0","0","0","0","0","0"
"Warren","2020-03-13","0","0","0","0","0","0"
"Warren","2020-03-14","0","0","0","0","0","0"
"Warren","2020-03-15","0","0","0","0","0","0"
"Warren","2020-03-16","0","0","0","0","0","0"
"Warren","2020-03-17","1","1","0","0","0","0"
"Warren","2020-03-18","0","1","0","0","0","0"
"Warren","2020-03-19","1","2","1","1","14.3","7.1"
"Warren","2020-03-20","0","2","0","1","14.3","7.1"
"Warren","2020-03-21","0","2","0","1","14.3","7.1"
"Warren","2020-03-22","0","2","0","1","14.3","7.1"
"Warren","2020-03-23","0","2","0","1","14.3","7.1"
"Warren","2020-03-24","0","2","0","1","14.3","7.1"
"Warren","2020-03-25","0","2","0","1","14.3","7.1"
"Warren","2020-03-26","0","2","0","1","0","7.1"
"Warren","2020-03-27","0","2","0","1","0","7.1"
"Warren","2020-03-28","0","2","0","1","0","7.1"
"Warren","2020-03-29","0","2","0","1","0","7.1"
"Warren","2020-03-30","0","2","0","1","0","7.1"
"Warren","2020-03-31","0","2","0","1","0","7.1"
"Warren","2020-04-01","0","2","0","1","0","7.1"
"Warren","2020-04-02","2","4","0","1","0","0"
"Warren","2020-04-03","0","4","0","1","0","0"
"Warren","2020-04-04","1","5","0","1","0","0"
"Warren","2020-04-05","1","6","0","1","0","0"
"Warren","2020-04-06","0","6","0","1","0","0"
"Warren","2020-04-07","3","9","1","2","4.8","2.4"
"Warren","2020-04-08","1","10","0","2","4.8","2.4"
"Warren","2020-04-09","1","11","0","2","4.8","2.4"
"Warren","2020-04-10","4","15","0","2","4.8","2.4"
"Warren","2020-04-11","4","19","1","3","8.3","4.2"
"Warren","2020-04-12","0","19","0","3","8.3","4.2"
"Warren","2020-04-13","2","21","2","5","22.6","11.3"
"Warren","2020-04-14","0","21","0","5","17.9","11.3"
"Warren","2020-04-15","2","23","1","6","25","14.9"
"Warren","2020-04-16","2","25","0","6","25","14.9"
"Warren","2020-04-17","2","27","0","6","25","14.9"
"Warren","2020-04-18","0","27","0","6","21.4","14.9"
"Warren","2020-04-19","0","27","0","6","21.4","14.9"
"Warren","2020-04-20","2","29","0","6","7.1","14.9"
"Warren","2020-04-21","4","33","0","6","7.1","12.5"
"Warren","2020-04-22","5","38","2","8","5.7","15.4"
"Warren","2020-04-23","3","41","0","8","5.7","15.4"
"Warren","2020-04-24","1","42","0","8","5.7","15.4"
"Warren","2020-04-25","2","44","1","9","12.9","17.1"
"Warren","2020-04-26","0","44","0","9","12.9","17.1"
"Warren","2020-04-27","3","47","1","10","17.6","12.4"
"Warren","2020-04-28","1","48","0","10","17.6","12.4"
"Warren","2020-04-29","2","50","2","12","26.2","16"
"Warren","2020-04-30","4","54","1","13","29.8","17.7"
"Warren","2020-05-01","3","57","1","14","34.5","20.1"
"Warren","2020-05-02","0","57","0","14","27.4","20.1"
"Warren","2020-05-03","2","59","0","14","27.4","20.1"
"Warren","2020-05-04","4","63","0","14","22.6","20.1"
"Warren","2020-05-05","9","72","0","14","22.6","20.1"
"Warren","2020-05-06","7","79","0","14","8.3","17.3"
"Warren","2020-05-07","9","88","3","17","9.5","19.6"
"Warren","2020-05-08","3","91","0","17","4.8","19.6"
"Warren","2020-05-09","0","91","0","17","4.8","16.1"
"Warren","2020-05-10","0","91","0","17","4.8","16.1"
"Warren","2020-05-11","0","91","0","17","4.8","13.7"
"Warren","2020-05-12","2","93","0","17","4.8","13.7"
"Warren","2020-05-13","2","95","0","17","4.8","6.5"
"Warren","2020-05-14","2","97","0","17","0","4.8"
"Warren","2020-05-15","0","97","0","17","0","2.4"
"Warren","2020-05-16","1","98","0","17","0","2.4"
"Warren","2020-05-17","2","100","0","17","0","2.4"
"Warren","2020-05-18","2","102","0","17","0","2.4"
"Warren","2020-05-19","4","106","0","17","0","2.4"
"Warren","2020-05-20","7","113","1","18","2","3.4"
"Warren","2020-05-21","1","114","0","18","2","1"
"Warren","2020-05-22","1","115","0","18","2","1"
"Warren","2020-05-23","0","115","0","18","2","1"
"Warren","2020-05-24","0","115","0","18","2","1"
"Warren","2020-05-25","0","115","0","18","2","1"
"Warren","2020-05-26","4","119","0","18","2","1"
"Warren","2020-05-27","1","120","0","18","0","1"
"Warren","2020-05-28","1","121","0","18","0","1"
"Warren","2020-05-29","1","122","0","18","0","1"
"Warren","2020-05-30","0","122","0","18","0","1"
"Warren","2020-05-31","4","126","0","18","0","1"
"Warren","2020-06-01","4","130","0","18","0","1"
"Warren","2020-06-02","4","134","0","18","0","1"
"Warren","2020-06-03","1","135","0","18","0","0"
"Warren","2020-06-04","1","136","0","18","0","0"
"Warren","2020-06-05","0","136","0","18","0","0"
"Warren","2020-06-06","0","136","0","18","0","0"
"Warren","2020-06-07","0","136","0","18","0","0"
"Warren","2020-06-08","1","137","0","18","0","0"
"Warren","2020-06-09","1","138","0","18","0","0"
"Warren","2020-06-10","3","141","0","18","0","0"
"Warren","2020-06-11","5","146","0","18","0","0"
"Warren","2020-06-12","4","150","0","18","0","0"
"Warren","2020-06-13","3","153","0","18","0","0"
"Warren","2020-06-14","1","154","0","18","0","0"
"Warren","2020-06-15","4","158","0","18","0","0"
"Warren","2020-06-16","1","159","0","18","0","0"
"Warren","2020-06-17","1","160","0","18","0","0"
"Warren","2020-06-18","1","161","0","18","0","0"
"Warren","2020-06-19","1","162","0","18","0","0"
"Warren","2020-06-20","0","162","0","18","0","0"
"Warren","2020-06-21","0","162","0","18","0","0"
"Warren","2020-06-22","5","167","0","18","0","0"
"Warren","2020-06-23","2","169","0","18","0","0"
"Warren","2020-06-24","6","175","1","19","2.4","1.2"
"Warren","2020-06-25","6","181","0","19","2.4","1.2"
"Warren","2020-06-26","1","182","0","19","2.4","1.2"
"Warren","2020-06-27","1","183","0","19","2.4","1.2"
"Warren","2020-06-28","2","185","0","19","2.4","1.2"
"Warren","2020-06-29","3","188","0","19","2.4","1.2"
"Warren","2020-06-30","8","196","0","19","2.4","1.2"
"Warren","2020-07-01","10","206","1","20","1.4","1.9"
"Warren","2020-07-02","14","220","0","20","1.4","1.9"
"Warren","2020-07-03","4","224","0","20","1.4","1.9"
"Warren","2020-07-04","4","228","1","21","5","3.7"
"Warren","2020-07-05","5","233","0","21","5","3.7"
"Warren","2020-07-06","6","239","1","22","7.4","4.9"
"Warren","2020-07-07","14","253","1","23","8.4","5.4"
"Warren","2020-07-08","9","262","0","23","7","4.2"
"Warren","2020-07-09","3","265","1","24","11.7","6.6"
"Warren","2020-07-10","9","274","2","26","14.9","8.2"
"Warren","2020-07-11","3","277","0","26","11.3","8.2"
"Warren","2020-07-12","3","280","0","26","11.3","8.2"
"Warren","2020-07-13","11","291","2","28","11.6","9.5"
"Warren","2020-07-14","11","302","2","30","13.1","10.8"
"Warren","2020-07-15","10","312","0","30","13.1","10.1"
"Warren","2020-07-16","11","323","1","31","9.7","10.7"
"Warren","2020-07-17","4","327","0","31","6.5","10.7"
"Warren","2020-07-18","3","330","1","32","11.3","11.3"
"Warren","2020-07-19","6","336","2","34","16","13.7"
"Warren","2020-07-20","5","341","0","34","13.4","12.5"
"Warren","2020-07-21","5","346","1","35","13.7","13.4"
"Warren","2020-07-22","5","351","0","35","13.7","13.4"
"Warren","2020-07-23","4","355","2","37","19.5","14.6"
"Warren","2020-07-24","10","365","3","40","23.8","15.2"
"Warren","2020-07-25","4","369","0","40","19","15.2"
"Warren","2020-07-26","2","371","0","40","14.3","15.2"
"Warren","2020-07-27","16","387","4","44","17.9","15.6"
"Warren","2020-07-28","15","402","3","47","17.9","15.8"
"Warren","2020-07-29","4","406","2","49","25","19.3"
"Warren","2020-07-30","4","410","1","50","21.4","20.5"
"Warren","2020-07-31","9","419","3","53","21.9","22.9"
"Warren","2020-08-01","4","423","2","55","29","24"
"Warren","2020-08-02","4","427","0","55","29","21.7"
"Warren","2020-08-03","11","438","4","59","30.7","24.3"
"Warren","2020-08-04","5","443","3","62","36.4","27.1"
"Warren","2020-08-05","12","455","5","67","35.2","30.1"
"Warren","2020-08-06","5","460","2","69","37.3","29.4"
"Warren","2020-08-07","6","466","3","72","39.7","30.8"
"Warren","2020-08-08","5","471","0","72","32.6","30.8"
"Warren","2020-08-09","4","475","0","72","32.6","30.8"
"Warren","2020-08-10","4","479","1","73","31","30.8"
"Warren","2020-08-11","7","486","0","73","22.4","29.4"
"Warren","2020-08-12","8","494","1","74","18.2","26.7"
"Warren","2020-08-13","8","502","0","74","12.5","24.9"
"Warren","2020-08-14","4","506","1","75","8.9","24.3"
"Warren","2020-08-15","5","511","1","76","11.8","22.2"
"Warren","2020-08-16","1","512","0","76","11.8","22.2"
"Warren","2020-08-17","6","518","0","76","8.2","19.6"
"Warren","2020-08-18","5","523","0","76","8.2","15.3"
"Warren","2020-08-19","4","527","0","76","6.4","12.3"
"Warren","2020-08-20","2","529","0","76","6.4","9.5"
"Warren","2020-08-21","5","534","0","76","2.9","5.9"
"Warren","2020-08-22","1","535","1","77","14.3","13"
"Warren","2020-08-23","3","538","0","77","14.3","13"
"Warren","2020-08-24","7","545","0","77","14.3","11.3"
"Warren","2020-08-25","4","549","1","78","17.9","13"
"Warren","2020-08-26","5","554","2","80","23.6","15"
"Warren","2020-08-27","6","560","0","80","23.6","15"
"Warren","2020-08-28","3","563","0","80","23.6","13.2"
"Warren","2020-08-29","1","564","0","80","9.3","11.8"
"Warren","2020-08-30","3","567","0","80","9.3","11.8"
"Warren","2020-08-31","5","572","2","82","15","14.6"
"Warren","2020-09-01","3","575","0","82","11.4","14.6"
"Warren","2020-09-02","5","580","0","82","5.7","14.6"
"Warren","2020-09-03","3","583","0","82","5.7","14.6"
"Warren","2020-09-04","4","587","0","82","5.7","14.6"
"Warren","2020-09-05","2","589","0","82","5.7","7.5"
"Warren","2020-09-06","1","590","0","82","5.7","7.5"
"Warren","2020-09-07","3","593","0","82","0","7.5"
"Warren","2020-09-08","6","599","0","82","0","5.7"
"Warren","2020-09-09","5","604","0","82","0","2.9"
"Warren","2020-09-10","1","605","0","82","0","2.9"
"Warren","2020-09-11","3","608","1","83","4.8","5.2"
"Warren","2020-09-12","4","612","1","84","8.3","7"
"Warren","2020-09-13","3","615","0","84","8.3","7"
"Warren","2020-09-14","8","623","0","84","8.3","4.2"
"Warren","2020-09-15","31","654","0","84","8.3","4.2"
"Warren","2020-09-16","4","658","1","85","11.9","6"
"Warren","2020-09-17","9","667","0","85","11.9","6"
"Warren","2020-09-18","8","675","2","87","10.7","7.7"
"Warren","2020-09-19","19","694","1","88","7.9","8.1"
"Warren","2020-09-20","3","697","1","89","12.7","10.5"
"Warren","2020-09-21","6","703","0","89","12.7","10.5"
"Warren","2020-09-22","5","708","0","89","12.7","10.5"
"Warren","2020-09-23","4","712","0","89","9.1","10.5"
"Warren","2020-09-24","13","725","8","97","17.9","14.9"
"Warren","2020-09-25","4","729","1","98","17.9","14.3"
"Warren","2020-09-26","1","730","0","98","17.1","12.5"
"Warren","2020-09-27","1","731","0","98","12.4","12.5"
"Warren","2020-09-28","8","739","0","98","12.4","12.5"
"Warren","2020-09-29","13","752","1","99","13.5","13.1"
"Warren","2020-09-30","7","759","1","100","15.5","12.3"
"Warren","2020-10-01","2","761","2","102","21","19.4"
"Warren","2020-10-02","7","768","0","102","17.4","17.7"
"Warren","2020-10-03","3","771","0","102","17.4","17.3"
"Warren","2020-10-04","6","777","1","103","19.8","16.1"
"Warren","2020-10-05","5","782","0","103","19.8","16.1"
"Warren","2020-10-06","8","790","0","103","18.7","16.1"
"Warren","2020-10-07","8","798","1","104","18.5","17"
"Warren","2020-10-08","2","800","0","104","4.2","12.6"
"Warren","2020-10-09","12","812","0","104","4.2","10.8"
"Warren","2020-10-10","5","817","0","104","4.2","10.8"
"Warren","2020-10-11","2","819","0","104","1.8","10.8"
"Warren","2020-10-12","7","826","2","106","5.9","12.8"
"Warren","2020-10-13","12","838","0","106","5.9","12.3"
"Warren","2020-10-14","6","844","0","106","4.1","11.3"
"Warren","2020-10-15","5","849","0","106","4.1","4.1"
"Warren","2020-10-16","5","854","0","106","4.1","4.1"
"Warren","2020-10-17","6","860","0","106","4.1","4.1"
"Warren","2020-10-18","1","861","0","106","4.1","2.9"
"Warren","2020-10-19","5","866","0","106","0","2.9"
"Warren","2020-10-20","5","871","1","107","2.9","4.4"
"Warren","2020-10-21","5","876","0","107","2.9","3.5"
"Warren","2020-10-22","6","882","0","107","2.9","3.5"
"Warren","2020-10-23","5","887","0","107","2.9","3.5"
"Warren","2020-10-24","5","892","0","107","2.9","3.5"
"Warren","2020-10-25","3","895","0","107","2.9","3.5"
"Warren","2020-10-26","4","899","0","107","2.9","1.4"
"Warren","2020-10-27","16","915","1","108","0.9","1.9"
"Warren","2020-10-28","3","918","1","109","5.7","4.3"
"Warren","2020-10-29","6","924","1","110","8","5.4"
"Warren","2020-10-30","3","927","0","110","8","5.4"
"Warren","2020-10-31","3","930","1","111","12.8","7.8"
"Warren","2020-11-01","5","935","0","111","12.8","7.8"
"Warren","2020-11-02","6","941","0","111","12.8","7.8"
"Warren","2020-11-03","6","947","0","111","11.9","6.4"
"Warren","2020-11-04","8","955","2","113","10.7","8.2"
"Warren","2020-11-05","4","959","0","113","8.3","8.2"
"Warren","2020-11-06","4","963","0","113","8.3","8.2"
"Warren","2020-11-07","6","969","0","113","3.6","8.2"
"Warren","2020-11-08","4","973","1","114","7.1","10"
"Warren","2020-11-09","8","981","0","114","7.1","10"
"Warren","2020-11-10","24","1005","3","117","8.9","10.4"
"Warren","2020-11-11","5","1010","0","117","5.4","8"
"Warren","2020-11-12","5","1015","0","117","5.4","6.8"
"Warren","2020-11-13","11","1026","2","119","8","8.1"
"Warren","2020-11-14","8","1034","0","119","8","5.8"
"Warren","2020-11-15","2","1036","0","119","4.4","5.8"
"Warren","2020-11-16","9","1045","3","122","9.1","8.1"
"Warren","2020-11-17","14","1059","1","123","8.4","8.7"
"Warren","2020-11-18","8","1067","0","123","8.4","6.9"
"Warren","2020-11-19","5","1072","0","123","8.4","6.9"
"Warren","2020-11-20","4","1076","0","123","5.8","6.9"
"Warren","2020-11-21","0","1076","0","123","5.8","6.9"
"Warren","2020-11-22","3","1079","1","124","10.5","7.5"
"Warren","2020-11-23","2","1081","0","124","5.8","7.5"
"Warren","2020-11-24","9","1090","3","127","9.5","9"
"Warren","2020-11-25","6","1096","0","127","9.5","9"
"Warren","2020-11-26","2","1098","0","127","9.5","9"
"Warren","2020-11-27","8","1106","0","127","9.5","7.7"
"Warren","2020-11-28","2","1108","0","127","9.5","7.7"
"Warren","2020-11-29","2","1110","0","127","4.8","7.7"
"Warren","2020-11-30","9","1119","0","127","4.8","5.3"
"Warren","2020-12-01","3","1122","0","127","0","4.8"
"Warren","2020-12-02","14","1136","5","132","5.1","7.3"
"Warren","2020-12-03","13","1149","1","133","6.2","7.9"
"Warren","2020-12-04","14","1163","0","133","6.2","7.9"
"Warren","2020-12-05","11","1174","0","133","6.2","7.9"
"Warren","2020-12-06","3","1177","0","133","6.2","5.5"
"Warren","2020-12-07","12","1189","1","134","7.4","6.1"
"Warren","2020-12-08","5","1194","2","136","13.1","6.6"
"Warren","2020-12-09","16","1210","5","141","12.5","8.8"
"Warren","2020-12-10","4","1214","0","141","11.4","8.8"
"Warren","2020-12-11","11","1225","0","141","11.4","8.8"
"Warren","2020-12-12","2","1227","0","141","11.4","8.8"
"Warren","2020-12-13","1","1228","0","141","11.4","8.8"
"Warren","2020-12-14","8","1236","2","143","13.8","10.6"
"Warren","2020-12-15","4","1240","2","145","15.2","14.1"
"Warren","2020-12-16","3","1243","0","145","10.7","11.6"
"Warren","2020-12-17","7","1250","2","147","14.8","13.1"
"Warren","2020-12-18","10","1260","0","147","14.8","13.1"
"Warren","2020-12-19","3","1263","1","148","19.6","15.5"
"Warren","2020-12-20","10","1273","2","150","22.4","16.9"
"Warren","2020-12-21","7","1280","1","151","20.9","17.3"
"Warren","2020-12-22","5","1285","1","152","16.6","15.9"
"Warren","2020-12-23","2","1287","0","152","16.6","13.7"
"Warren","2020-12-24","3","1290","1","153","17.3","16"
"Warren","2020-12-25","1","1291","0","153","17.3","16"
"Warren","2020-12-26","8","1299","5","158","21.4","20.5"
"Warren","2020-12-27","7","1306","4","162","26.8","24.6"
"Warren","2020-12-28","7","1313","0","162","24.7","22.8"
"Warren","2020-12-29","7","1320","1","163","23.9","20.2"
"Warren","2020-12-30","10","1330","1","164","25.3","21"
"Warren","2020-12-31","4","1334","0","164","20.6","18.9"
"Warren","2021-01-01","0","1334","0","164","20.6","18.9"
"Warren","2021-01-02","8","1342","0","164","11.6","16.5"
"Warren","2021-01-03","2","1344","1","165","10.6","18.7"
"Warren","2021-01-04","5","1349","2","167","16.3","20.5"
"Warren","2021-01-05","10","1359","2","169","17.1","20.5"
"Warren","2021-01-06","23","1382","8","177","20.7","23"
"Warren","2021-01-07","17","1399","8","185","27.4","24"
"Warren","2021-01-08","15","1414","4","189","31.2","25.9"
"Warren","2021-01-09","19","1433","6","195","35.7","23.7"
"Warren","2021-01-10","10","1443","2","197","31.4","21"
"Warren","2021-01-11","18","1461","8","205","32.1","24.2"
"Warren","2021-01-12","4","1465","1","206","32.8","25"
"Warren","2021-01-13","24","1489","10","216","33.8","27.2"
"Warren","2021-01-14","14","1503","6","222","33.2","30.3"
"Warren","2021-01-15","9","1512","4","226","35.7","33.5"
"Warren","2021-01-16","13","1525","4","230","35.6","35.7"
"Warren","2021-01-17","9","1534","3","233","37.5","34.5"
"Warren","2021-01-18","11","1545","2","235","33.8","32.9"
"Warren","2021-01-19","13","1558","3","238","33.5","33.1"
"Warren","2021-01-20","14","1572","4","242","31.6","32.7"
"Warren","2021-01-21","13","1585","1","243","26.6","29.9"
"Warren","2021-01-22","13","1598","2","245","22.4","29.1"
"Warren","2021-01-23","12","1610","5","250","24","29.8"
"Warren","2021-01-24","9","1619","4","254","25.6","31.5"
"Warren","2021-01-25","17","1636","1","255","23.8","28.8"
"Warren","2021-01-26","13","1649","2","257","22.7","28.1"
"Warren","2021-01-27","6","1655","2","259","23.4","27.5"
"Warren","2021-01-28","12","1667","6","265","29.4","28"
"Warren","2021-01-29","9","1676","0","265","27.2","24.8"
"Warren","2021-01-30","8","1684","4","269","28.4","26.2"
"Warren","2021-01-31","6","1690","2","271","26.8","26.2"
"Warren","2021-02-01","16","1706","2","273","27.8","25.8"
"Warren","2021-02-02","5","1711","1","274","28.5","25.6"
"Warren","2021-02-03","7","1718","1","275","25.7","24.6"
"Warren","2021-02-04","6","1724","1","276","21","25.2"
"Warren","2021-02-05","7","1731","0","276","21","24.1"
"Warren","2021-02-06","1","1732","0","276","13.8","21.1"
"Warren","2021-02-07","0","1732","0","276","9.1","18"
"Warren","2021-02-08","0","1732","0","276","7.3","17.5"
"Washington","2020-02-01","0","0","0","0",".","."
"Washington","2020-02-02","0","0","0","0",".","."
"Washington","2020-02-03","0","0","0","0",".","."
"Washington","2020-02-04","0","0","0","0",".","."
"Washington","2020-02-05","0","0","0","0",".","."
"Washington","2020-02-06","0","0","0","0",".","."
"Washington","2020-02-07","0","0","0","0","0","."
"Washington","2020-02-08","0","0","0","0","0","."
"Washington","2020-02-09","0","0","0","0","0","."
"Washington","2020-02-10","0","0","0","0","0","."
"Washington","2020-02-11","0","0","0","0","0","."
"Washington","2020-02-12","0","0","0","0","0","."
"Washington","2020-02-13","0","0","0","0","0","."
"Washington","2020-02-14","0","0","0","0","0","0"
"Washington","2020-02-15","0","0","0","0","0","0"
"Washington","2020-02-16","0","0","0","0","0","0"
"Washington","2020-02-17","0","0","0","0","0","0"
"Washington","2020-02-18","0","0","0","0","0","0"
"Washington","2020-02-19","0","0","0","0","0","0"
"Washington","2020-02-20","0","0","0","0","0","0"
"Washington","2020-02-21","0","0","0","0","0","0"
"Washington","2020-02-22","0","0","0","0","0","0"
"Washington","2020-02-23","0","0","0","0","0","0"
"Washington","2020-02-24","0","0","0","0","0","0"
"Washington","2020-02-25","0","0","0","0","0","0"
"Washington","2020-02-26","0","0","0","0","0","0"
"Washington","2020-02-27","0","0","0","0","0","0"
"Washington","2020-02-28","0","0","0","0","0","0"
"Washington","2020-02-29","0","0","0","0","0","0"
"Washington","2020-03-01","0","0","0","0","0","0"
"Washington","2020-03-02","0","0","0","0","0","0"
"Washington","2020-03-03","0","0","0","0","0","0"
"Washington","2020-03-04","0","0","0","0","0","0"
"Washington","2020-03-05","0","0","0","0","0","0"
"Washington","2020-03-06","1","1","0","0","0","0"
"Washington","2020-03-07","0","1","0","0","0","0"
"Washington","2020-03-08","0","1","0","0","0","0"
"Washington","2020-03-09","0","1","0","0","0","0"
"Washington","2020-03-10","0","1","0","0","0","0"
"Washington","2020-03-11","0","1","0","0","0","0"
"Washington","2020-03-12","0","1","0","0","0","0"
"Washington","2020-03-13","0","1","0","0","0","0"
"Washington","2020-03-14","0","1","0","0","0","0"
"Washington","2020-03-15","0","1","0","0","0","0"
"Washington","2020-03-16","0","1","0","0","0","0"
"Washington","2020-03-17","0","1","0","0","0","0"
"Washington","2020-03-18","0","1","0","0","0","0"
"Washington","2020-03-19","2","3","0","0","0","0"
"Washington","2020-03-20","8","11","1","1","1.8","0.9"
"Washington","2020-03-21","2","13","0","1","1.8","0.9"
"Washington","2020-03-22","1","14","0","1","1.8","0.9"
"Washington","2020-03-23","4","18","0","1","1.8","0.9"
"Washington","2020-03-24","7","25","0","1","1.8","0.9"
"Washington","2020-03-25","7","32","0","1","1.8","0.9"
"Washington","2020-03-26","7","39","0","1","1.8","0.9"
"Washington","2020-03-27","5","44","0","1","0","0.9"
"Washington","2020-03-28","1","45","0","1","0","0.9"
"Washington","2020-03-29","3","48","2","3","9.5","5.7"
"Washington","2020-03-30","2","50","0","3","9.5","5.7"
"Washington","2020-03-31","1","51","0","3","9.5","5.7"
"Washington","2020-04-01","1","52","0","3","9.5","5.7"
"Washington","2020-04-02","3","55","0","3","9.5","5.7"
"Washington","2020-04-03","2","57","0","3","9.5","4.8"
"Washington","2020-04-04","2","59","0","3","9.5","4.8"
"Washington","2020-04-05","3","62","0","3","0","4.8"
"Washington","2020-04-06","1","63","0","3","0","4.8"
"Washington","2020-04-07","3","66","0","3","0","4.8"
"Washington","2020-04-08","5","71","0","3","0","4.8"
"Washington","2020-04-09","3","74","0","3","0","4.8"
"Washington","2020-04-10","7","81","3","6","6.1","7.8"
"Washington","2020-04-11","1","82","0","6","6.1","7.8"
"Washington","2020-04-12","0","82","0","6","6.1","3.1"
"Washington","2020-04-13","7","89","0","6","6.1","3.1"
"Washington","2020-04-14","5","94","0","6","6.1","3.1"
"Washington","2020-04-15","8","102","0","6","6.1","3.1"
"Washington","2020-04-16","10","112","0","6","6.1","3.1"
"Washington","2020-04-17","1","113","0","6","0","3.1"
"Washington","2020-04-18","4","117","0","6","0","3.1"
"Washington","2020-04-19","1","118","0","6","0","3.1"
"Washington","2020-04-20","6","124","3","9","7.1","6.6"
"Washington","2020-04-21","3","127","0","9","7.1","6.6"
"Washington","2020-04-22","6","133","0","9","7.1","6.6"
"Washington","2020-04-23","8","141","1","10","8.9","7.5"
"Washington","2020-04-24","9","150","0","10","8.9","4.5"
"Washington","2020-04-25","5","155","0","10","8.9","4.5"
"Washington","2020-04-26","4","159","0","10","8.9","4.5"
"Washington","2020-04-27","8","167","0","10","1.8","4.5"
"Washington","2020-04-28","20","187","2","12","3.2","5.2"
"Washington","2020-04-29","9","196","0","12","3.2","5.2"
"Washington","2020-04-30","15","211","2","14","3.3","6.1"
"Washington","2020-05-01","5","216","1","15","6.2","7.6"
"Washington","2020-05-02","3","219","2","17","15.7","12.3"
"Washington","2020-05-03","5","224","0","17","15.7","12.3"
"Washington","2020-05-04","5","229","1","18","18.6","10.2"
"Washington","2020-05-05","19","248","3","21","19.4","11.3"
"Washington","2020-05-06","11","259","0","21","19.4","11.3"
"Washington","2020-05-07","14","273","1","22","18.5","10.9"
"Washington","2020-05-08","10","283","1","23","17.1","11.6"
"Washington","2020-05-09","3","286","0","23","7.6","11.6"
"Washington","2020-05-10","2","288","1","24","14.7","15.2"
"Washington","2020-05-11","12","300","3","27","15.4","17"
"Washington","2020-05-12","13","313","1","28","14.3","16.8"
"Washington","2020-05-13","9","322","1","29","15.8","17.6"
"Washington","2020-05-14","8","330","0","29","14.8","16.7"
"Washington","2020-05-15","5","335","1","30","16.3","16.7"
"Washington","2020-05-16","2","337","1","31","23.4","15.5"
"Washington","2020-05-17","5","342","0","31","16.3","15.5"
"Washington","2020-05-18","14","356","0","31","12.7","14.1"
"Washington","2020-05-19","13","369","0","31","11.6","12.9"
"Washington","2020-05-20","10","379","0","31","10","12.9"
"Washington","2020-05-21","17","396","0","31","10","12.4"
"Washington","2020-05-22","14","410","1","32","8.2","12.2"
"Washington","2020-05-23","4","414","1","33","4.6","14"
"Washington","2020-05-24","2","416","0","33","4.6","10.4"
"Washington","2020-05-25","3","419","0","33","4.6","8.6"
"Washington","2020-05-26","13","432","1","34","5.7","8.6"
"Washington","2020-05-27","5","437","0","34","5.7","7.8"
"Washington","2020-05-28","7","444","0","34","5.7","7.8"
"Washington","2020-05-29","4","448","0","34","4.7","6.4"
"Washington","2020-05-30","0","448","0","34","1.1","2.8"
"Washington","2020-05-31","1","449","0","34","1.1","2.8"
"Washington","2020-06-01","8","457","1","35","2.9","3.7"
"Washington","2020-06-02","10","467","0","35","1.8","3.7"
"Washington","2020-06-03","9","476","0","35","1.8","3.7"
"Washington","2020-06-04","51","527","0","35","1.8","3.7"
"Washington","2020-06-05","5","532","0","35","1.8","3.2"
"Washington","2020-06-06","0","532","0","35","1.8","1.4"
"Washington","2020-06-07","2","534","0","35","1.8","1.4"
"Washington","2020-06-08","6","540","0","35","0","1.4"
"Washington","2020-06-09","2","542","0","35","0","0.9"
"Washington","2020-06-10","7","549","0","35","0","0.9"
"Washington","2020-06-11","10","559","0","35","0","0.9"
"Washington","2020-06-12","10","569","0","35","0","0.9"
"Washington","2020-06-13","8","577","0","35","0","0.9"
"Washington","2020-06-14","3","580","0","35","0","0.9"
"Washington","2020-06-15","12","592","1","36","1.2","0.6"
"Washington","2020-06-16","4","596","1","37","4.8","2.4"
"Washington","2020-06-17","7","603","2","39","8.8","4.4"
"Washington","2020-06-18","7","610","4","43","17","8.5"
"Washington","2020-06-19","15","625","2","45","18.9","9.5"
"Washington","2020-06-20","4","629","0","45","18.9","9.5"
"Washington","2020-06-21","5","634","0","45","18.9","9.5"
"Washington","2020-06-22","19","653","6","51","22.2","11.7"
"Washington","2020-06-23","9","662","1","52","20.2","12.5"
"Washington","2020-06-24","10","672","1","53","17.6","13.2"
"Washington","2020-06-25","15","687","1","54","10.4","13.7"
"Washington","2020-06-26","22","709","3","57","10.4","14.7"
"Washington","2020-06-27","4","713","1","58","14","16.5"
"Washington","2020-06-28","5","718","3","61","22.6","20.7"
"Washington","2020-06-29","24","742","7","68","22.2","22.2"
"Washington","2020-06-30","20","762","6","74","24.9","22.6"
"Washington","2020-07-01","11","773","3","77","27.4","22.5"
"Washington","2020-07-02","22","795","5","82","29.7","20"
"Washington","2020-07-03","8","803","2","84","31.3","20.9"
"Washington","2020-07-04","2","805","0","84","27.7","20.9"
"Washington","2020-07-05","9","814","2","86","22.3","22.5"
"Washington","2020-07-06","23","837","3","89","20","21.1"
"Washington","2020-07-07","18","855","3","92","18.1","21.5"
"Washington","2020-07-08","25","880","3","95","16","21.7"
"Washington","2020-07-09","11","891","2","97","15.3","22.5"
"Washington","2020-07-10","22","913","12","109","19.5","25.4"
"Washington","2020-07-11","5","918","1","110","22.4","25.1"
"Washington","2020-07-12","2","920","0","110","19.2","20.8"
"Washington","2020-07-13","19","939","4","114","20.3","20.2"
"Washington","2020-07-14","14","953","3","117","21","19.6"
"Washington","2020-07-15","22","975","5","122","22.6","19.3"
"Washington","2020-07-16","16","991","6","128","25.3","20.3"
"Washington","2020-07-17","17","1008","4","132","20.9","20.2"
"Washington","2020-07-18","10","1018","1","133","19.5","20.9"
"Washington","2020-07-19","7","1025","0","133","19.5","19.3"
"Washington","2020-07-20","17","1042","5","138","20.7","20.5"
"Washington","2020-07-21","13","1055","5","143","23.1","22.1"
"Washington","2020-07-22","13","1068","4","147","24.2","23.4"
"Washington","2020-07-23","11","1079","2","149","21.5","23.4"
"Washington","2020-07-24","26","1105","7","156","22","21.4"
"Washington","2020-07-25","20","1125","4","160","23.4","21.4"
"Washington","2020-07-26","5","1130","1","161","26.2","22.9"
"Washington","2020-07-27","11","1141","1","162","23.3","22"
"Washington","2020-07-28","24","1165","7","169","22","22.6"
"Washington","2020-07-29","14","1179","7","176","24.8","24.5"
"Washington","2020-07-30","12","1191","4","180","26.9","24.2"
"Washington","2020-07-31","25","1216","4","184","25.4","23.7"
"Washington","2020-08-01","14","1230","4","188","26.6","25"
"Washington","2020-08-02","8","1238","2","190","27.3","26.8"
"Washington","2020-08-03","8","1246","0","190","26","24.7"
"Washington","2020-08-04","15","1261","5","195","26.6","24.3"
"Washington","2020-08-05","9","1270","5","200","27.4","26.1"
"Washington","2020-08-06","10","1280","3","203","26.9","26.9"
"Washington","2020-08-07","18","1298","2","205","26.2","25.8"
"Washington","2020-08-08","14","1312","2","207","24.2","25.4"
"Washington","2020-08-09","11","1323","3","210","24.5","25.9"
"Washington","2020-08-10","17","1340","3","213","27","26.5"
"Washington","2020-08-11","5","1345","1","214","25.1","25.9"
"Washington","2020-08-12","11","1356","2","216","19.8","23.6"
"Washington","2020-08-13","12","1368","0","216","15.5","21.2"
"Washington","2020-08-14","14","1382","1","217","14.9","20.6"
"Washington","2020-08-15","18","1400","6","223","17.7","20.9"
"Washington","2020-08-16","13","1413","2","225","16","20.2"
"Washington","2020-08-17","18","1431","2","227","15","21"
"Washington","2020-08-18","17","1448","4","231","15.5","20.3"
"Washington","2020-08-19","18","1466","4","235","16.1","17.9"
"Washington","2020-08-20","9","1475","0","235","16.1","15.8"
"Washington","2020-08-21","17","1492","1","236","15.9","15.4"
"Washington","2020-08-22","6","1498","0","236","11.2","14.4"
"Washington","2020-08-23","5","1503","2","238","14.7","15.3"
"Washington","2020-08-24","21","1524","2","240","14.5","14.7"
"Washington","2020-08-25","11","1535","2","242","13.7","14.6"
"Washington","2020-08-26","8","1543","0","242","10.5","13.3"
"Washington","2020-08-27","13","1556","3","245","13.8","15"
"Washington","2020-08-28","18","1574","6","251","17.7","16.8"
"Washington","2020-08-29","3","1577","1","252","22.5","16.8"
"Washington","2020-08-30","8","1585","0","252","16.8","15.7"
"Washington","2020-08-31","27","1612","1","253","15.9","15.2"
"Washington","2020-09-01","12","1624","1","254","14.5","14.1"
"Washington","2020-09-02","13","1637","1","255","15.6","13.1"
"Washington","2020-09-03","13","1650","0","255","12.3","13.1"
"Washington","2020-09-04","8","1658","0","255","7.6","12.7"
"Washington","2020-09-05","14","1672","1","256","3.8","13.2"
"Washington","2020-09-06","7","1679","0","256","3.8","10.3"
"Washington","2020-09-07","7","1686","2","258","7.4","11.7"
"Washington","2020-09-08","17","1703","3","261","8.7","11.6"
"Washington","2020-09-09","9","1712","0","261","7.6","11.6"
"Washington","2020-09-10","12","1724","0","261","7.6","10"
"Washington","2020-09-11","16","1740","0","261","7.6","7.6"
"Washington","2020-09-12","13","1753","0","261","6.6","5.2"
"Washington","2020-09-13","5","1758","1","262","9.5","6.6"
"Washington","2020-09-14","11","1769","0","262","5.4","6.4"
"Washington","2020-09-15","11","1780","0","262","2.9","5.8"
"Washington","2020-09-16","14","1794","0","262","2.9","5.2"
"Washington","2020-09-17","8","1802","0","262","2.9","5.2"
"Washington","2020-09-18","22","1824","2","264","4.2","5.9"
"Washington","2020-09-19","12","1836","0","264","4.2","5.4"
"Washington","2020-09-20","3","1839","1","265","6.1","7.8"
"Washington","2020-09-21","15","1854","2","267","8","6.7"
"Washington","2020-09-22","12","1866","2","269","10.3","6.6"
"Washington","2020-09-23","12","1878","2","271","12.7","7.8"
"Washington","2020-09-24","13","1891","0","271","12.7","7.8"
"Washington","2020-09-25","24","1915","0","271","11.4","7.8"
"Washington","2020-09-26","6","1921","0","271","11.4","7.8"
"Washington","2020-09-27","6","1927","0","271","6.7","6.4"
"Washington","2020-09-28","17","1944","1","272","5.6","6.8"
"Washington","2020-09-29","10","1954","0","272","3.2","6.8"
"Washington","2020-09-30","10","1964","1","273","2.3","7.5"
"Washington","2020-10-01","12","1976","2","275","4.6","8.7"
"Washington","2020-10-02","16","1992","2","277","6.4","8.9"
"Washington","2020-10-03","23","2015","1","278","7.1","9.2"
"Washington","2020-10-04","4","2019","0","278","7.1","6.9"
"Washington","2020-10-05","19","2038","0","278","6.2","5.9"
"Washington","2020-10-06","14","2052","0","278","6.2","4.7"
"Washington","2020-10-07","11","2063","0","278","4.8","3.5"
"Washington","2020-10-08","13","2076","3","281","5.7","5.2"
"Washington","2020-10-09","23","2099","1","282","4.5","5.5"
"Washington","2020-10-10","7","2106","1","283","6","6.5"
"Washington","2020-10-11","2","2108","1","284","13.1","10.1"
"Washington","2020-10-12","13","2121","1","285","14.2","10.2"
"Washington","2020-10-13","18","2139","4","289","17.4","11.8"
"Washington","2020-10-14","20","2159","0","289","17.4","11.1"
"Washington","2020-10-15","21","2180","2","291","15.4","10.6"
"Washington","2020-10-16","15","2195","0","291","14.8","9.7"
"Washington","2020-10-17","13","2208","0","291","12.8","9.4"
"Washington","2020-10-18","5","2213","0","291","5.6","9.4"
"Washington","2020-10-19","22","2235","3","294","6.5","10.3"
"Washington","2020-10-20","45","2280","5","299","4.9","11.1"
"Washington","2020-10-21","27","2307","4","303","7","12.2"
"Washington","2020-10-22","17","2324","3","306","8.2","11.8"
"Washington","2020-10-23","25","2349","1","307","8.7","11.8"
"Washington","2020-10-24","65","2414","3","310","9.4","11.1"
"Washington","2020-10-25","11","2425","3","313","13.3","9.5"
"Washington","2020-10-26","20","2445","5","318","14.9","10.7"
"Washington","2020-10-27","31","2476","3","321","14.7","9.8"
"Washington","2020-10-28","73","2549","6","327","13.8","10.4"
"Washington","2020-10-29","22","2571","9","336","17.1","12.6"
"Washington","2020-10-30","25","2596","1","337","17.1","12.9"
"Washington","2020-10-31","18","2614","2","339","18","13.7"
"Washington","2020-11-01","15","2629","1","340","15.1","14.2"
"Washington","2020-11-02","163","2792","4","344","11.9","13.4"
"Washington","2020-11-03","14","2806","2","346","12.5","13.6"
"Washington","2020-11-04","17","2823","3","349","13.9","13.8"
"Washington","2020-11-05","136","2959","2","351","8.2","12.7"
"Washington","2020-11-06","30","2989","1","352","8.1","12.6"
"Washington","2020-11-07","10","2999","0","352","6.6","12.3"
"Washington","2020-11-08","7","3006","1","353","7.6","11.4"
"Washington","2020-11-09","27","3033","2","355","8.3","10.1"
"Washington","2020-11-10","22","3055","0","355","6.3","9.4"
"Washington","2020-11-11","21","3076","7","362","8.5","11.2"
"Washington","2020-11-12","14","3090","0","362","8.3","8.3"
"Washington","2020-11-13","23","3113","1","363","8.5","8.3"
"Washington","2020-11-14","11","3124","4","367","13.7","10.1"
"Washington","2020-11-15","7","3131","1","368","13.7","10.7"
"Washington","2020-11-16","27","3158","3","371","14.2","11.3"
"Washington","2020-11-17","32","3190","3","374","15.5","10.9"
"Washington","2020-11-18","29","3219","4","378","12.8","10.7"
"Washington","2020-11-19","27","3246","4","382","14.9","11.6"
"Washington","2020-11-20","24","3270","4","386","16.6","12.6"
"Washington","2020-11-21","19","3289","4","390","14.4","14.1"
"Washington","2020-11-22","11","3300","1","391","13.7","13.7"
"Washington","2020-11-23","31","3331","6","397","14.9","14.5"
"Washington","2020-11-24","19","3350","4","401","16.5","16"
"Washington","2020-11-25","28","3378","3","404","16.1","14.4"
"Washington","2020-11-26","5","3383","0","404","14","14.4"
"Washington","2020-11-27","31","3414","7","411","14.8","15.7"
"Washington","2020-11-28","15","3429","4","415","15.6","15"
"Washington","2020-11-29","11","3440","1","416","15.6","14.7"
"Washington","2020-11-30","138","3578","4","420","13.3","14.1"
"Washington","2020-12-01","31","3609","2","422","11.2","13.9"
"Washington","2020-12-02","25","3634","4","426","12","14"
"Washington","2020-12-03","109","3743","5","431","12.6","13.3"
"Washington","2020-12-04","27","3770","6","437","12.6","13.7"
"Washington","2020-12-05","20","3790","6","443","13","14.3"
"Washington","2020-12-06","15","3805","5","448","16.5","16.1"
"Washington","2020-12-07","38","3843","6","454","18.3","15.8"
"Washington","2020-12-08","36","3879","8","462","20.6","15.9"
"Washington","2020-12-09","14","3893","2","464","20.3","16.2"
"Washington","2020-12-10","31","3924","3","467","21.1","16.8"
"Washington","2020-12-11","34","3958","5","472","20","16.3"
"Washington","2020-12-12","21","3979","5","477","19.1","16.1"
"Washington","2020-12-13","10","3989","0","477","14.4","15.4"
"Washington","2020-12-14","25","4014","3","480","13.8","16.1"
"Washington","2020-12-15","31","4045","7","487","13.9","17.2"
"Washington","2020-12-16","34","4079","6","493","14.3","17.3"
"Washington","2020-12-17","32","4111","5","498","15.2","18.1"
"Washington","2020-12-18","37","4148","5","503","15","17.5"
"Washington","2020-12-19","17","4165","2","505","13.3","16.2"
"Washington","2020-12-20","20","4185","5","510","16.9","15.6"
"Washington","2020-12-21","37","4222","2","512","15.9","14.9"
"Washington","2020-12-22","30","4252","1","513","13.2","13.5"
"Washington","2020-12-23","28","4280","3","516","12.2","13.3"
"Washington","2020-12-24","27","4307","10","526","15.3","15.2"
"Washington","2020-12-25","2","4309","0","526","13.3","14.2"
"Washington","2020-12-26","30","4339","12","538","17.4","15.3"
"Washington","2020-12-27","25","4364","7","545","17.8","17.3"
"Washington","2020-12-28","30","4394","6","551","19.9","17.9"
"Washington","2020-12-29","37","4431","6","557","21.7","17.4"
"Washington","2020-12-30","44","4475","14","571","24.7","18.5"
"Washington","2020-12-31","54","4529","12","583","22.6","18.9"
"Washington","2021-01-01","5","4534","1","584","25.5","19.4"
"Washington","2021-01-02","24","4558","10","594","25.7","21.5"
"Washington","2021-01-03","3","4561","2","596","31.2","24.5"
"Washington","2021-01-04","43","4604","11","607","32","25.9"
"Washington","2021-01-05","65","4669","19","626","33.9","27.8"
"Washington","2021-01-06","48","4717","15","641","33.8","29.3"
"Washington","2021-01-07","41","4758","13","654","35.2","28.9"
"Washington","2021-01-08","47","4805","12","666","35.9","30.7"
"Washington","2021-01-09","46","4851","14","680","34.3","30"
"Washington","2021-01-10","25","4876","7","687","28.8","30"
"Washington","2021-01-11","35","4911","12","699","30.1","31"
"Washington","2021-01-12","68","4979","7","706","27.4","30.6"
"Washington","2021-01-13","40","5019","6","712","25","29.4"
"Washington","2021-01-14","47","5066","10","722","23.5","29.4"
"Washington","2021-01-15","51","5117","9","731","22.4","29.2"
"Washington","2021-01-16","29","5146","8","739","22","28.2"
"Washington","2021-01-17","14","5160","1","740","19","23.9"
"Washington","2021-01-18","36","5196","9","749","17.7","23.9"
"Washington","2021-01-19","50","5246","13","762","20","23.7"
"Washington","2021-01-20","42","5288","5","767","19.5","22.3"
"Washington","2021-01-21","45","5333","7","774","18.7","21.1"
"Washington","2021-01-22","44","5377","6","780","18.1","20.3"
"Washington","2021-01-23","34","5411","8","788","17.5","19.8"
"Washington","2021-01-24","17","5428","5","793","20.7","19.9"
"Washington","2021-01-25","37","5465","4","797","18.7","18.2"
"Washington","2021-01-26","61","5526","9","806","17.1","18.5"
"Washington","2021-01-27","36","5562","7","813","18.2","18.8"
"Washington","2021-01-28","55","5617","5","818","17.2","18"
"Washington","2021-01-29","33","5650","9","827","19.2","18.7"
"Washington","2021-01-30","14","5664","3","830","18.9","18.2"
"Washington","2021-01-31","14","5678","2","832","16.7","18.7"
"Washington","2021-02-01","29","5707","5","837","17.6","18.2"
"Washington","2021-02-02","42","5749","1","838","15.9","16.5"
"Washington","2021-02-03","30","5779","6","844","16","17.1"
"Washington","2021-02-04","32","5811","8","852","18.2","17.7"
"Washington","2021-02-05","37","5848","9","861","17.8","18.5"
"Washington","2021-02-06","5","5853","0","861","14.7","16.8"
"Washington","2021-02-07","0","5853","0","861","12.7","14.7"
"Washington","2021-02-08","0","5853","0","861","10.2","13.9"
"Wayne","2020-02-01","0","0","0","0",".","."
"Wayne","2020-02-02","0","0","0","0",".","."
"Wayne","2020-02-03","0","0","0","0",".","."
"Wayne","2020-02-04","0","0","0","0",".","."
"Wayne","2020-02-05","0","0","0","0",".","."
"Wayne","2020-02-06","0","0","0","0",".","."
"Wayne","2020-02-07","0","0","0","0","0","."
"Wayne","2020-02-08","0","0","0","0","0","."
"Wayne","2020-02-09","0","0","0","0","0","."
"Wayne","2020-02-10","0","0","0","0","0","."
"Wayne","2020-02-11","0","0","0","0","0","."
"Wayne","2020-02-12","0","0","0","0","0","."
"Wayne","2020-02-13","0","0","0","0","0","."
"Wayne","2020-02-14","0","0","0","0","0","0"
"Wayne","2020-02-15","0","0","0","0","0","0"
"Wayne","2020-02-16","0","0","0","0","0","0"
"Wayne","2020-02-17","0","0","0","0","0","0"
"Wayne","2020-02-18","0","0","0","0","0","0"
"Wayne","2020-02-19","0","0","0","0","0","0"
"Wayne","2020-02-20","0","0","0","0","0","0"
"Wayne","2020-02-21","0","0","0","0","0","0"
"Wayne","2020-02-22","0","0","0","0","0","0"
"Wayne","2020-02-23","0","0","0","0","0","0"
"Wayne","2020-02-24","0","0","0","0","0","0"
"Wayne","2020-02-25","0","0","0","0","0","0"
"Wayne","2020-02-26","0","0","0","0","0","0"
"Wayne","2020-02-27","0","0","0","0","0","0"
"Wayne","2020-02-28","0","0","0","0","0","0"
"Wayne","2020-02-29","0","0","0","0","0","0"
"Wayne","2020-03-01","0","0","0","0","0","0"
"Wayne","2020-03-02","0","0","0","0","0","0"
"Wayne","2020-03-03","0","0","0","0","0","0"
"Wayne","2020-03-04","0","0","0","0","0","0"
"Wayne","2020-03-05","0","0","0","0","0","0"
"Wayne","2020-03-06","0","0","0","0","0","0"
"Wayne","2020-03-07","0","0","0","0","0","0"
"Wayne","2020-03-08","0","0","0","0","0","0"
"Wayne","2020-03-09","0","0","0","0","0","0"
"Wayne","2020-03-10","0","0","0","0","0","0"
"Wayne","2020-03-11","0","0","0","0","0","0"
"Wayne","2020-03-12","1","1","0","0","0","0"
"Wayne","2020-03-13","0","1","0","0","0","0"
"Wayne","2020-03-14","0","1","0","0","0","0"
"Wayne","2020-03-15","4","5","0","0","0","0"
"Wayne","2020-03-16","0","5","0","0","0","0"
"Wayne","2020-03-17","6","11","0","0","0","0"
"Wayne","2020-03-18","4","15","0","0","0","0"
"Wayne","2020-03-19","8","23","0","0","0","0"
"Wayne","2020-03-20","12","35","0","0","0","0"
"Wayne","2020-03-21","2","37","0","0","0","0"
"Wayne","2020-03-22","0","37","0","0","0","0"
"Wayne","2020-03-23","17","54","0","0","0","0"
"Wayne","2020-03-24","15","69","1","1","1","0.5"
"Wayne","2020-03-25","6","75","0","1","1","0.5"
"Wayne","2020-03-26","9","84","0","1","1","0.5"
"Wayne","2020-03-27","9","93","0","1","1","0.5"
"Wayne","2020-03-28","2","95","0","1","1","0.5"
"Wayne","2020-03-29","5","100","1","2","3.8","1.9"
"Wayne","2020-03-30","13","113","1","3","4.9","2.5"
"Wayne","2020-03-31","13","126","1","4","5.1","3"
"Wayne","2020-04-01","7","133","0","4","5.1","3"
"Wayne","2020-04-02","16","149","0","4","5.1","3"
"Wayne","2020-04-03","9","158","0","4","5.1","3"
"Wayne","2020-04-04","13","171","0","4","5.1","3"
"Wayne","2020-04-05","4","175","1","5","5.8","4.8"
"Wayne","2020-04-06","18","193","0","5","4.7","4.8"
"Wayne","2020-04-07","18","211","0","5","3.6","4.3"
"Wayne","2020-04-08","18","229","0","5","3.6","4.3"
"Wayne","2020-04-09","20","249","0","5","3.6","4.3"
"Wayne","2020-04-10","10","259","2","7","6.4","5.7"
"Wayne","2020-04-11","4","263","0","7","6.4","5.7"
"Wayne","2020-04-12","2","265","0","7","2.9","4.3"
"Wayne","2020-04-13","7","272","0","7","2.9","3.8"
"Wayne","2020-04-14","11","283","2","9","5.5","4.5"
"Wayne","2020-04-15","15","298","1","10","6.4","5"
"Wayne","2020-04-16","21","319","0","10","6.4","5"
"Wayne","2020-04-17","17","336","1","11","4.4","5.4"
"Wayne","2020-04-18","14","350","0","11","4.4","5.4"
"Wayne","2020-04-19","9","359","1","12","6","4.4"
"Wayne","2020-04-20","5","364","0","12","6","4.4"
"Wayne","2020-04-21","10","374","0","12","3.4","4.4"
"Wayne","2020-04-22","10","384","0","12","2.4","4.4"
"Wayne","2020-04-23","15","399","0","12","2.4","4.4"
"Wayne","2020-04-24","7","406","1","13","3.6","4"
"Wayne","2020-04-25","4","410","0","13","3.6","4"
"Wayne","2020-04-26","4","414","0","13","2","4"
"Wayne","2020-04-27","19","433","1","14","2.8","4.4"
"Wayne","2020-04-28","10","443","0","14","2.8","3.1"
"Wayne","2020-04-29","20","463","0","14","2.8","2.6"
"Wayne","2020-04-30","20","483","0","14","2.8","2.6"
"Wayne","2020-05-01","17","500","0","14","0.8","2.2"
"Wayne","2020-05-02","10","510","0","14","0.8","2.2"
"Wayne","2020-05-03","5","515","0","14","0.8","1.4"
"Wayne","2020-05-04","19","534","0","14","0","1.4"
"Wayne","2020-05-05","17","551","0","14","0","1.4"
"Wayne","2020-05-06","18","569","0","14","0","1.4"
"Wayne","2020-05-07","20","589","0","14","0","1.4"
"Wayne","2020-05-08","11","600","0","14","0","0.4"
"Wayne","2020-05-09","3","603","0","14","0","0.4"
"Wayne","2020-05-10","6","609","0","14","0","0.4"
"Wayne","2020-05-11","91","700","0","14","0","0"
"Wayne","2020-05-12","10","710","0","14","0","0"
"Wayne","2020-05-13","9","719","0","14","0","0"
"Wayne","2020-05-14","23","742","1","15","0.6","0.3"
"Wayne","2020-05-15","13","755","0","15","0.6","0.3"
"Wayne","2020-05-16","7","762","1","16","2.7","1.3"
"Wayne","2020-05-17","4","766","0","16","2.7","1.3"
"Wayne","2020-05-18","24","790","0","16","2.7","1.3"
"Wayne","2020-05-19","13","803","0","16","2.7","1.3"
"Wayne","2020-05-20","20","823","0","16","2.7","1.3"
"Wayne","2020-05-21","16","839","0","16","2","1.3"
"Wayne","2020-05-22","7","846","0","16","2","1.3"
"Wayne","2020-05-23","4","850","0","16","0","1.3"
"Wayne","2020-05-24","5","855","0","16","0","1.3"
"Wayne","2020-05-25","7","862","0","16","0","1.3"
"Wayne","2020-05-26","13","875","1","17","1.1","1.9"
"Wayne","2020-05-27","8","883","0","17","1.1","1.9"
"Wayne","2020-05-28","20","903","0","17","1.1","1.6"
"Wayne","2020-05-29","13","916","0","17","1.1","1.6"
"Wayne","2020-05-30","3","919","0","17","1.1","0.5"
"Wayne","2020-05-31","2","921","0","17","1.1","0.5"
"Wayne","2020-06-01","25","946","1","18","1.7","0.8"
"Wayne","2020-06-02","21","967","0","18","0.6","0.8"
"Wayne","2020-06-03","17","984","0","18","0.6","0.8"
"Wayne","2020-06-04","23","1007","0","18","0.6","0.8"
"Wayne","2020-06-05","10","1017","0","18","0.6","0.8"
"Wayne","2020-06-06","2","1019","0","18","0.6","0.8"
"Wayne","2020-06-07","3","1022","1","19","5.3","3.2"
"Wayne","2020-06-08","21","1043","0","19","4.8","3.2"
"Wayne","2020-06-09","21","1064","3","22","6.8","3.7"
"Wayne","2020-06-10","22","1086","0","22","6.8","3.7"
"Wayne","2020-06-11","29","1115","0","22","6.8","3.7"
"Wayne","2020-06-12","11","1126","1","23","8.1","4.3"
"Wayne","2020-06-13","11","1137","0","23","8.1","4.3"
"Wayne","2020-06-14","1","1138","0","23","3.3","4.3"
"Wayne","2020-06-15","111","1249","3","26","3.7","4.2"
"Wayne","2020-06-16","113","1362","2","28","1.9","4.4"
"Wayne","2020-06-17","108","1470","1","29","2.1","4.4"
"Wayne","2020-06-18","37","1507","1","30","2.5","4.6"
"Wayne","2020-06-19","36","1543","4","34","2.7","5.4"
"Wayne","2020-06-20","8","1551","2","36","6.3","7.2"
"Wayne","2020-06-21","16","1567","4","40","9.9","6.6"
"Wayne","2020-06-22","118","1685","14","54","11.2","7.5"
"Wayne","2020-06-23","53","1738","7","61","12.8","7.4"
"Wayne","2020-06-24","49","1787","3","64","13.6","7.8"
"Wayne","2020-06-25","48","1835","9","73","15.9","9.2"
"Wayne","2020-06-26","70","1905","5","78","15.3","9"
"Wayne","2020-06-27","71","1976","6","84","12.9","9.6"
"Wayne","2020-06-28","15","1991","1","85","10.3","10.1"
"Wayne","2020-06-29","63","2054","8","93","10.4","10.8"
"Wayne","2020-06-30","49","2103","4","97","9.7","11.3"
"Wayne","2020-07-01","113","2216","8","105","9.9","11.7"
"Wayne","2020-07-02","50","2266","6","111","8.9","12.4"
"Wayne","2020-07-03","60","2326","10","121","10.2","12.8"
"Wayne","2020-07-04","41","2367","9","130","12.2","12.6"
"Wayne","2020-07-05","21","2388","5","135","14.6","12.5"
"Wayne","2020-07-06","83","2471","18","153","15.9","13.2"
"Wayne","2020-07-07","106","2577","19","172","17.3","13.5"
"Wayne","2020-07-08","84","2661","15","187","18.8","14.3"
"Wayne","2020-07-09","123","2784","11","198","18.4","13.6"
"Wayne","2020-07-10","77","2861","19","217","19.5","14.9"
"Wayne","2020-07-11","37","2898","9","226","19.9","16"
"Wayne","2020-07-12","29","2927","8","234","20.4","17.5"
"Wayne","2020-07-13","97","3024","27","261","21.3","18.6"
"Wayne","2020-07-14","123","3147","40","301","23.4","20.3"
"Wayne","2020-07-15","159","3306","76","377","27.7","23.3"
"Wayne","2020-07-16","210","3516","76","453","31.6","25"
"Wayne","2020-07-17","127","3643","49","502","33.5","26.5"
"Wayne","2020-07-18","42","3685","9","511","33.1","26.5"
"Wayne","2020-07-19","27","3712","2","513","30.3","25.3"
"Wayne","2020-07-20","81","3793","16","529","29.1","25.2"
"Wayne","2020-07-21","60","3853","13","542","27.5","25.5"
"Wayne","2020-07-22","74","3927","10","552","22.6","25.2"
"Wayne","2020-07-23","79","4006","22","574","21.5","26.5"
"Wayne","2020-07-24","48","4054","7","581","18","25.8"
"Wayne","2020-07-25","31","4085","3","584","16.3","24.7"
"Wayne","2020-07-26","13","4098","4","588","19.7","25"
"Wayne","2020-07-27","78","4176","15","603","19.6","24.4"
"Wayne","2020-07-28","99","4275","31","634","21","24.3"
"Wayne","2020-07-29","62","4337","10","644","21.4","22"
"Wayne","2020-07-30","93","4430","57","701","26.1","23.8"
"Wayne","2020-07-31","113","4543","42","743","29.4","23.7"
"Wayne","2020-08-01","105","4648","23","766","31.1","23.7"
"Wayne","2020-08-02","18","4666","2","768","28.3","24"
"Wayne","2020-08-03","48","4714","11","779","28.8","24.2"
"Wayne","2020-08-04","90","4804","14","793","26.6","23.8"
"Wayne","2020-08-05","64","4868","14","807","27.4","24.4"
"Wayne","2020-08-06","91","4959","24","831","22.4","24.3"
"Wayne","2020-08-07","146","5105","68","899","23.8","26.6"
"Wayne","2020-08-08","44","5149","11","910","24.2","27.7"
"Wayne","2020-08-09","21","5170","5","915","26","27.2"
"Wayne","2020-08-10","182","5352","72","987","28.4","28.6"
"Wayne","2020-08-11","88","5440","21","1008","29.6","28.1"
"Wayne","2020-08-12","56","5496","13","1021","29.8","28.6"
"Wayne","2020-08-13","59","5555","5","1026","27.2","24.8"
"Wayne","2020-08-14","53","5608","11","1037","23.5","23.6"
"Wayne","2020-08-15","34","5642","8","1045","23.3","23.8"
"Wayne","2020-08-16","16","5658","1","1046","20.8","23.4"
"Wayne","2020-08-17","111","5769","12","1058","16.7","22.5"
"Wayne","2020-08-18","86","5855","17","1075","16.1","22.8"
"Wayne","2020-08-19","71","5926","24","1099","17.6","23.7"
"Wayne","2020-08-20","89","6015","30","1129","21.2","24.2"
"Wayne","2020-08-21","51","6066","9","1138","20.8","22.2"
"Wayne","2020-08-22","38","6104","4","1142","18.9","21.1"
"Wayne","2020-08-23","36","6140","4","1146","19.6","20.2"
"Wayne","2020-08-24","56","6196","9","1155","20.4","18.5"
"Wayne","2020-08-25","53","6249","4","1159","18.6","17.4"
"Wayne","2020-08-26","55","6304","9","1168","16.1","16.9"
"Wayne","2020-08-27","49","6353","5","1173","12.8","17"
"Wayne","2020-08-28","70","6423","15","1188","13.3","17.1"
"Wayne","2020-08-29","42","6465","3","1191","12.8","15.9"
"Wayne","2020-08-30","32","6497","7","1198","14.4","17"
"Wayne","2020-08-31","67","6564","12","1210","14.6","17.5"
"Wayne","2020-09-01","82","6646","15","1225","16.2","17.4"
"Wayne","2020-09-02","89","6735","8","1233","15.1","15.6"
"Wayne","2020-09-03","57","6792","10","1243","16.2","14.5"
"Wayne","2020-09-04","109","6901","15","1258","15.1","14.2"
"Wayne","2020-09-05","27","6928","4","1262","16.2","14.5"
"Wayne","2020-09-06","24","6952","6","1268","16.6","15.5"
"Wayne","2020-09-07","35","6987","4","1272","15.7","15.2"
"Wayne","2020-09-08","95","7082","17","1289","15.6","15.9"
"Wayne","2020-09-09","72","7154","8","1297","15.9","15.5"
"Wayne","2020-09-10","76","7230","7","1304","14.7","15.5"
"Wayne","2020-09-11","36","7266","6","1310","15.2","15.1"
"Wayne","2020-09-12","43","7309","0","1310","13","14.6"
"Wayne","2020-09-13","33","7342","7","1317","12.5","14.6"
"Wayne","2020-09-14","95","7437","3","1320","11.3","13.5"
"Wayne","2020-09-15","75","7512","15","1335","11.6","13.6"
"Wayne","2020-09-16","44","7556","7","1342","12.3","14.1"
"Wayne","2020-09-17","79","7635","6","1348","12.1","13.4"
"Wayne","2020-09-18","58","7693","4","1352","10.7","12.9"
"Wayne","2020-09-19","24","7717","4","1356","13.1","13.1"
"Wayne","2020-09-20","20","7737","2","1358","11.5","12"
"Wayne","2020-09-21","54","7791","8","1366","13.1","12.2"
"Wayne","2020-09-22","60","7851","10","1376","12.6","12.1"
"Wayne","2020-09-23","61","7912","5","1381","11.5","11.9"
"Wayne","2020-09-24","87","7999","7","1388","11.6","11.8"
"Wayne","2020-09-25","26","8025","3","1391","12.3","11.5"
"Wayne","2020-09-26","24","8049","1","1392","10.5","11.8"
"Wayne","2020-09-27","25","8074","6","1398","12.5","12"
"Wayne","2020-09-28","51","8125","7","1405","12.3","12.7"
"Wayne","2020-09-29","52","8177","3","1408","10.8","11.7"
"Wayne","2020-09-30","61","8238","4","1412","10.5","11"
"Wayne","2020-10-01","87","8325","4","1416","10.1","10.8"
"Wayne","2020-10-02","31","8356","3","1419","9.8","11"
"Wayne","2020-10-03","20","8376","4","1423","12","11.3"
"Wayne","2020-10-04","18","8394","2","1425","10.2","11.3"
"Wayne","2020-10-05","48","8442","2","1427","8.8","10.6"
"Wayne","2020-10-06","90","8532","5","1432","8.8","9.8"
"Wayne","2020-10-07","44","8576","3","1435","8.8","9.7"
"Wayne","2020-10-08","94","8670","3","1438","8.6","9.3"
"Wayne","2020-10-09","44","8714","6","1444","9.2","9.5"
"Wayne","2020-10-10","20","8734","2","1446","7.8","9.9"
"Wayne","2020-10-11","12","8746","0","1446","6.2","8.2"
"Wayne","2020-10-12","54","8800","2","1448","6.1","7.5"
"Wayne","2020-10-13","57","8857","2","1450","5.8","7.3"
"Wayne","2020-10-14","36","8893","4","1454","6.5","7.6"
"Wayne","2020-10-15","105","8998","4","1458","6.5","7.6"
"Wayne","2020-10-16","38","9036","2","1460","5.3","7.3"
"Wayne","2020-10-17","18","9054","1","1461","4.7","6.2"
"Wayne","2020-10-18","18","9072","3","1464","7.1","6.6"
"Wayne","2020-10-19","88","9160","5","1469","7.4","6.8"
"Wayne","2020-10-20","73","9233","7","1476","8.2","7"
"Wayne","2020-10-21","39","9272","6","1482","8.9","7.7"
"Wayne","2020-10-22","75","9347","5","1487","9.3","7.9"
"Wayne","2020-10-23","138","9485","8","1495","9.3","7.3"
"Wayne","2020-10-24","23","9508","4","1499","11","7.9"
"Wayne","2020-10-25","19","9527","3","1502","10.9","9"
"Wayne","2020-10-26","50","9577","12","1514","13.5","10.4"
"Wayne","2020-10-27","66","9643","9","1523","14.1","11.2"
"Wayne","2020-10-28","51","9694","2","1525","12.5","10.7"
"Wayne","2020-10-29","67","9761","10","1535","13.6","11.4"
"Wayne","2020-10-30","159","9920","2","1537","13","11.2"
"Wayne","2020-10-31","31","9951","1","1538","11","11"
"Wayne","2020-11-01","15","9966","1","1539","9.7","10.3"
"Wayne","2020-11-02","46","10012","4","1543","7.5","10.5"
"Wayne","2020-11-03","36","10048","4","1547","7.1","10.6"
"Wayne","2020-11-04","50","10098","6","1553","8.3","10.4"
"Wayne","2020-11-05","47","10145","5","1558","7.7","10.6"
"Wayne","2020-11-06","84","10229","4","1562","8.2","10.6"
"Wayne","2020-11-07","21","10250","1","1563","8.4","9.7"
"Wayne","2020-11-08","22","10272","6","1569","11.3","10.5"
"Wayne","2020-11-09","40","10312","4","1573","11.5","9.5"
"Wayne","2020-11-10","53","10365","5","1578","11.3","9.2"
"Wayne","2020-11-11","48","10413","8","1586","11.9","10.1"
"Wayne","2020-11-12","61","10474","6","1592","11.8","9.7"
"Wayne","2020-11-13","32","10506","4","1596","12.9","10.5"
"Wayne","2020-11-14","21","10527","0","1596","12.2","10.3"
"Wayne","2020-11-15","17","10544","4","1600","11.7","11.5"
"Wayne","2020-11-16","61","10605","6","1606","11.7","11.6"
"Wayne","2020-11-17","147","10752","66","1672","16.8","14"
"Wayne","2020-11-18","54","10806","2","1674","14.9","13.4"
"Wayne","2020-11-19","155","10961","15","1689","14.9","13.3"
"Wayne","2020-11-20","33","10994","3","1692","14.4","13.7"
"Wayne","2020-11-21","17","11011","2","1694","16.1","14.2"
"Wayne","2020-11-22","17","11028","2","1696","14.4","13.1"
"Wayne","2020-11-23","84","11112","23","1719","16.9","14.3"
"Wayne","2020-11-24","59","11171","6","1725","11.9","14.3"
"Wayne","2020-11-25","43","11214","5","1730","13.1","14"
"Wayne","2020-11-26","24","11238","2","1732","12.9","13.9"
"Wayne","2020-11-27","59","11297","7","1739","13.3","13.8"
"Wayne","2020-11-28","41","11338","7","1746","14","15.1"
"Wayne","2020-11-29","24","11362","0","1746","12.3","13.4"
"Wayne","2020-11-30","44","11406","6","1752","10.4","13.6"
"Wayne","2020-12-01","161","11567","36","1788","12.1","12"
"Wayne","2020-12-02","66","11633","11","1799","12.8","13"
"Wayne","2020-12-03","60","11693","12","1811","14.5","13.7"
"Wayne","2020-12-04","52","11745","10","1821","15.6","14.4"
"Wayne","2020-12-05","19","11764","3","1824","15.4","14.7"
"Wayne","2020-12-06","14","11778","3","1827","18.4","15.4"
"Wayne","2020-12-07","53","11831","5","1832","17.8","14.1"
"Wayne","2020-12-08","83","11914","5","1837","15.5","13.8"
"Wayne","2020-12-09","63","11977","16","1853","16.8","14.8"
"Wayne","2020-12-10","41","12018","6","1859","16","15.3"
"Wayne","2020-12-11","54","12072","8","1867","15.4","15.5"
"Wayne","2020-12-12","44","12116","6","1873","15.1","15.2"
"Wayne","2020-12-13","32","12148","9","1882","16","17.2"
"Wayne","2020-12-14","91","12239","25","1907","18.6","18.2"
"Wayne","2020-12-15","96","12335","22","1929","21","18.3"
"Wayne","2020-12-16","68","12403","21","1950","21.8","19.3"
"Wayne","2020-12-17","74","12477","11","1961","21.8","18.9"
"Wayne","2020-12-18","79","12556","13","1974","22.1","18.7"
"Wayne","2020-12-19","55","12611","24","1998","26.3","20.7"
"Wayne","2020-12-20","25","12636","9","2007","27.5","21.7"
"Wayne","2020-12-21","66","12702","17","2024","27.2","22.9"
"Wayne","2020-12-22","59","12761","15","2039","27.6","24.3"
"Wayne","2020-12-23","119","12880","23","2062","25.9","23.9"
"Wayne","2020-12-24","34","12914","15","2077","30.1","26"
"Wayne","2020-12-25","14","12928","4","2081","31.8","26.9"
"Wayne","2020-12-26","31","12959","11","2092","30.7","28.5"
"Wayne","2020-12-27","28","12987","11","2103","31.1","29.3"
"Wayne","2020-12-28","85","13072","26","2129","31.8","29.5"
"Wayne","2020-12-29","101","13173","35","2164","33.1","30.4"
"Wayne","2020-12-30","80","13253","21","2185","34.1","30"
"Wayne","2020-12-31","100","13353","26","2211","31.5","30.8"
"Wayne","2021-01-01","16","13369","10","2221","36.4","34.1"
"Wayne","2021-01-02","40","13409","16","2237","37","33.9"
"Wayne","2021-01-03","25","13434","12","2249","38.3","34.7"
"Wayne","2021-01-04","151","13585","68","2317","40.3","36.1"
"Wayne","2021-01-05","163","13748","38","2355","38.7","35.9"
"Wayne","2021-01-06","137","13885","48","2403","40","37.1"
"Wayne","2021-01-07","78","13963","13","2416","38.6","35.1"
"Wayne","2021-01-08","69","14032","14","2430","32.6","34.5"
"Wayne","2021-01-09","61","14093","10","2440","29.2","33.1"
"Wayne","2021-01-10","27","14120","4","2444","24.5","31.4"
"Wayne","2021-01-11","101","14221","34","2478","22.9","31.6"
"Wayne","2021-01-12","115","14336","25","2503","22.7","30.7"
"Wayne","2021-01-13","81","14417","17","2520","20.7","30.3"
"Wayne","2021-01-14","94","14511","19","2539","21.2","29.9"
"Wayne","2021-01-15","54","14565","18","2557","23","27.8"
"Wayne","2021-01-16","41","14606","8","2565","23.5","26.4"
"Wayne","2021-01-17","25","14631","7","2572","25.3","24.9"
"Wayne","2021-01-18","59","14690","18","2590","24.9","23.9"
"Wayne","2021-01-19","79","14769","17","2607","24.9","23.8"
"Wayne","2021-01-20","85","14854","20","2627","25.2","22.9"
"Wayne","2021-01-21","82","14936","17","2644","25.3","23.2"
"Wayne","2021-01-22","61","14997","12","2656","23.4","23.2"
"Wayne","2021-01-23","31","15028","5","2661","22.9","23.2"
"Wayne","2021-01-24","21","15049","5","2666","22.3","23.8"
"Wayne","2021-01-25","101","15150","30","2696","22.2","23.5"
"Wayne","2021-01-26","126","15276","25","2721","21.9","23.4"
"Wayne","2021-01-27","84","15360","29","2750","23.5","24.4"
"Wayne","2021-01-28","84","15444","22","2772","24.3","24.8"
"Wayne","2021-01-29","69","15513","13","2785","24.1","23.8"
"Wayne","2021-01-30","37","15550","6","2791","24.2","23.5"
"Wayne","2021-01-31","25","15575","7","2798","24.8","23.5"
"Wayne","2021-02-01","63","15638","9","2807","22.6","22.4"
"Wayne","2021-02-02","59","15697","17","2824","23.8","22.9"
"Wayne","2021-02-03","68","15765","16","2840","22.3","22.9"
"Wayne","2021-02-04","75","15840","12","2852","20.8","22.5"
"Wayne","2021-02-05","40","15880","9","2861","21.3","22.7"
"Wayne","2021-02-06","3","15883","1","2862","23.8","24"
"Wayne","2021-02-07","0","15883","0","2862","19.8","22.3"
"Wayne","2021-02-08","0","15883","0","2862","17.7","20.1"
"Webster","2020-02-01","0","0","0","0",".","."
"Webster","2020-02-02","0","0","0","0",".","."
"Webster","2020-02-03","0","0","0","0",".","."
"Webster","2020-02-04","0","0","0","0",".","."
"Webster","2020-02-05","0","0","0","0",".","."
"Webster","2020-02-06","0","0","0","0",".","."
"Webster","2020-02-07","0","0","0","0","0","."
"Webster","2020-02-08","0","0","0","0","0","."
"Webster","2020-02-09","0","0","0","0","0","."
"Webster","2020-02-10","0","0","0","0","0","."
"Webster","2020-02-11","0","0","0","0","0","."
"Webster","2020-02-12","0","0","0","0","0","."
"Webster","2020-02-13","0","0","0","0","0","."
"Webster","2020-02-14","0","0","0","0","0","0"
"Webster","2020-02-15","0","0","0","0","0","0"
"Webster","2020-02-16","0","0","0","0","0","0"
"Webster","2020-02-17","0","0","0","0","0","0"
"Webster","2020-02-18","0","0","0","0","0","0"
"Webster","2020-02-19","0","0","0","0","0","0"
"Webster","2020-02-20","0","0","0","0","0","0"
"Webster","2020-02-21","0","0","0","0","0","0"
"Webster","2020-02-22","0","0","0","0","0","0"
"Webster","2020-02-23","0","0","0","0","0","0"
"Webster","2020-02-24","0","0","0","0","0","0"
"Webster","2020-02-25","0","0","0","0","0","0"
"Webster","2020-02-26","0","0","0","0","0","0"
"Webster","2020-02-27","0","0","0","0","0","0"
"Webster","2020-02-28","0","0","0","0","0","0"
"Webster","2020-02-29","0","0","0","0","0","0"
"Webster","2020-03-01","0","0","0","0","0","0"
"Webster","2020-03-02","0","0","0","0","0","0"
"Webster","2020-03-03","0","0","0","0","0","0"
"Webster","2020-03-04","0","0","0","0","0","0"
"Webster","2020-03-05","0","0","0","0","0","0"
"Webster","2020-03-06","0","0","0","0","0","0"
"Webster","2020-03-07","0","0","0","0","0","0"
"Webster","2020-03-08","0","0","0","0","0","0"
"Webster","2020-03-09","0","0","0","0","0","0"
"Webster","2020-03-10","0","0","0","0","0","0"
"Webster","2020-03-11","0","0","0","0","0","0"
"Webster","2020-03-12","0","0","0","0","0","0"
"Webster","2020-03-13","1","1","0","0","0","0"
"Webster","2020-03-14","2","3","0","0","0","0"
"Webster","2020-03-15","0","3","0","0","0","0"
"Webster","2020-03-16","0","3","0","0","0","0"
"Webster","2020-03-17","1","4","0","0","0","0"
"Webster","2020-03-18","1","5","1","1","14.3","7.1"
"Webster","2020-03-19","0","5","0","1","14.3","7.1"
"Webster","2020-03-20","0","5","0","1","14.3","7.1"
"Webster","2020-03-21","0","5","0","1","14.3","7.1"
"Webster","2020-03-22","0","5","0","1","14.3","7.1"
"Webster","2020-03-23","0","5","0","1","14.3","7.1"
"Webster","2020-03-24","1","6","0","1","14.3","7.1"
"Webster","2020-03-25","0","6","0","1","0","7.1"
"Webster","2020-03-26","0","6","0","1","0","7.1"
"Webster","2020-03-27","2","8","0","1","0","7.1"
"Webster","2020-03-28","1","9","1","2","14.3","14.3"
"Webster","2020-03-29","0","9","0","2","14.3","14.3"
"Webster","2020-03-30","1","10","0","2","14.3","14.3"
"Webster","2020-03-31","2","12","0","2","14.3","14.3"
"Webster","2020-04-01","1","13","0","2","14.3","7.1"
"Webster","2020-04-02","2","15","1","3","21.4","10.7"
"Webster","2020-04-03","0","15","0","3","21.4","10.7"
"Webster","2020-04-04","0","15","0","3","7.1","10.7"
"Webster","2020-04-05","0","15","0","3","7.1","10.7"
"Webster","2020-04-06","2","17","0","3","7.1","10.7"
"Webster","2020-04-07","3","20","0","3","7.1","10.7"
"Webster","2020-04-08","1","21","1","4","21.4","17.9"
"Webster","2020-04-09","1","22","0","4","14.3","17.9"
"Webster","2020-04-10","1","23","0","4","14.3","17.9"
"Webster","2020-04-11","2","25","0","4","14.3","10.7"
"Webster","2020-04-12","0","25","0","4","14.3","10.7"
"Webster","2020-04-13","0","25","0","4","14.3","10.7"
"Webster","2020-04-14","4","29","1","5","17.9","12.5"
"Webster","2020-04-15","4","33","1","6","7.1","14.3"
"Webster","2020-04-16","0","33","0","6","7.1","10.7"
"Webster","2020-04-17","1","34","1","7","21.4","17.9"
"Webster","2020-04-18","0","34","0","7","21.4","17.9"
"Webster","2020-04-19","0","34","0","7","21.4","17.9"
"Webster","2020-04-20","5","39","1","8","24.3","19.3"
"Webster","2020-04-21","0","39","0","8","20.7","19.3"
"Webster","2020-04-22","0","39","0","8","17.1","12.1"
"Webster","2020-04-23","0","39","0","8","17.1","12.1"
"Webster","2020-04-24","0","39","0","8","2.9","12.1"
"Webster","2020-04-25","4","43","1","9","6.4","13.9"
"Webster","2020-04-26","3","46","0","9","6.4","13.9"
"Webster","2020-04-27","0","46","0","9","3.6","13.9"
"Webster","2020-04-28","1","47","0","9","3.6","12.1"
"Webster","2020-04-29","4","51","0","9","3.6","10.4"
"Webster","2020-04-30","3","54","0","9","3.6","10.4"
"Webster","2020-05-01","1","55","0","9","3.6","3.2"
"Webster","2020-05-02","1","56","0","9","0","3.2"
"Webster","2020-05-03","0","56","0","9","0","3.2"
"Webster","2020-05-04","2","58","0","9","0","1.8"
"Webster","2020-05-05","5","63","1","10","2.9","3.2"
"Webster","2020-05-06","2","65","0","10","2.9","3.2"
"Webster","2020-05-07","0","65","0","10","2.9","3.2"
"Webster","2020-05-08","3","68","1","11","7.6","5.6"
"Webster","2020-05-09","2","70","0","11","7.6","3.8"
"Webster","2020-05-10","0","70","0","11","7.6","3.8"
"Webster","2020-05-11","4","74","0","11","7.6","3.8"
"Webster","2020-05-12","1","75","0","11","4.8","3.8"
"Webster","2020-05-13","6","81","0","11","4.8","3.8"
"Webster","2020-05-14","2","83","0","11","4.8","3.8"
"Webster","2020-05-15","2","85","0","11","0","3.8"
"Webster","2020-05-16","0","85","0","11","0","3.8"
"Webster","2020-05-17","1","86","0","11","0","3.8"
"Webster","2020-05-18","5","91","1","12","2.9","5.2"
"Webster","2020-05-19","4","95","0","12","2.9","3.8"
"Webster","2020-05-20","0","95","0","12","2.9","3.8"
"Webster","2020-05-21","3","98","0","12","2.9","3.8"
"Webster","2020-05-22","5","103","0","12","2.9","1.4"
"Webster","2020-05-23","0","103","0","12","2.9","1.4"
"Webster","2020-05-24","0","103","0","12","2.9","1.4"
"Webster","2020-05-25","0","103","0","12","0","1.4"
"Webster","2020-05-26","4","107","0","12","0","1.4"
"Webster","2020-05-27","0","107","0","12","0","1.4"
"Webster","2020-05-28","2","109","1","13","7.1","5"
"Webster","2020-05-29","9","118","0","13","7.1","5"
"Webster","2020-05-30","1","119","0","13","7.1","5"
"Webster","2020-05-31","0","119","0","13","7.1","5"
"Webster","2020-06-01","3","122","0","13","7.1","3.6"
"Webster","2020-06-02","0","122","0","13","7.1","3.6"
"Webster","2020-06-03","4","126","1","14","10.7","5.4"
"Webster","2020-06-04","5","131","0","14","3.6","5.4"
"Webster","2020-06-05","5","136","0","14","3.6","5.4"
"Webster","2020-06-06","4","140","0","14","3.6","5.4"
"Webster","2020-06-07","2","142","0","14","3.6","5.4"
"Webster","2020-06-08","2","144","0","14","3.6","5.4"
"Webster","2020-06-09","2","146","0","14","3.6","5.4"
"Webster","2020-06-10","1","147","0","14","0","5.4"
"Webster","2020-06-11","10","157","3","17","4.3","3.9"
"Webster","2020-06-12","11","168","3","20","8.2","5.9"
"Webster","2020-06-13","2","170","0","20","8.2","5.9"
"Webster","2020-06-14","0","170","0","20","8.2","5.9"
"Webster","2020-06-15","3","173","0","20","8.2","5.9"
"Webster","2020-06-16","2","175","0","20","8.2","5.9"
"Webster","2020-06-17","7","182","1","21","10.2","5.1"
"Webster","2020-06-18","4","186","0","21","5.9","5.1"
"Webster","2020-06-19","1","187","1","22","16.3","12.3"
"Webster","2020-06-20","3","190","2","24","25.9","17"
"Webster","2020-06-21","0","190","0","24","25.9","17"
"Webster","2020-06-22","9","199","3","27","30.6","19.4"
"Webster","2020-06-23","2","201","0","27","30.6","19.4"
"Webster","2020-06-24","1","202","0","27","28.6","19.4"
"Webster","2020-06-25","11","213","1","28","29.9","17.9"
"Webster","2020-06-26","6","219","0","28","15.6","16"
"Webster","2020-06-27","2","221","0","28","6.1","16"
"Webster","2020-06-28","2","223","0","28","6.1","16"
"Webster","2020-06-29","6","229","0","28","1.3","16"
"Webster","2020-06-30","0","229","0","28","1.3","16"
"Webster","2020-07-01","2","231","1","29","8.4","18.5"
"Webster","2020-07-02","17","248","4","33","10.5","20.2"
"Webster","2020-07-03","6","254","0","33","10.5","13"
"Webster","2020-07-04","1","255","0","33","10.5","8.3"
"Webster","2020-07-05","1","256","0","33","10.5","8.3"
"Webster","2020-07-06","5","261","0","33","10.5","5.9"
"Webster","2020-07-07","0","261","0","33","10.5","5.9"
"Webster","2020-07-08","3","264","0","33","3.4","5.9"
"Webster","2020-07-09","2","266","0","33","0","5.3"
"Webster","2020-07-10","6","272","0","33","0","5.3"
"Webster","2020-07-11","1","273","1","34","14.3","12.4"
"Webster","2020-07-12","1","274","0","34","14.3","12.4"
"Webster","2020-07-13","1","275","0","34","14.3","12.4"
"Webster","2020-07-14","3","278","0","34","14.3","12.4"
"Webster","2020-07-15","0","278","0","34","14.3","8.8"
"Webster","2020-07-16","3","281","0","34","14.3","7.1"
"Webster","2020-07-17","0","281","0","34","14.3","7.1"
"Webster","2020-07-18","1","282","0","34","0","7.1"
"Webster","2020-07-19","0","282","0","34","0","7.1"
"Webster","2020-07-20","8","290","1","35","1.8","8"
"Webster","2020-07-21","0","290","0","35","1.8","8"
"Webster","2020-07-22","3","293","0","35","1.8","8"
"Webster","2020-07-23","3","296","2","37","11.3","12.8"
"Webster","2020-07-24","3","299","0","37","11.3","12.8"
"Webster","2020-07-25","4","303","0","37","11.3","5.7"
"Webster","2020-07-26","1","304","0","37","11.3","5.7"
"Webster","2020-07-27","26","330","0","37","9.5","5.7"
"Webster","2020-07-28","6","336","1","38","11.9","6.8"
"Webster","2020-07-29","0","336","0","38","11.9","6.8"
"Webster","2020-07-30","2","338","0","38","2.4","6.8"
"Webster","2020-07-31","1","339","1","39","16.7","14"
"Webster","2020-08-01","3","342","1","40","21.4","16.4"
"Webster","2020-08-02","0","342","0","40","21.4","16.4"
"Webster","2020-08-03","7","349","0","40","21.4","15.5"
"Webster","2020-08-04","3","352","0","40","19","15.5"
"Webster","2020-08-05","2","354","0","40","19","15.5"
"Webster","2020-08-06","3","357","0","40","19","10.7"
"Webster","2020-08-07","5","362","1","41","7.6","12.1"
"Webster","2020-08-08","1","363","0","41","2.9","12.1"
"Webster","2020-08-09","0","363","0","41","2.9","12.1"
"Webster","2020-08-10","2","365","1","42","10","15.7"
"Webster","2020-08-11","0","365","0","42","10","14.5"
"Webster","2020-08-12","1","366","0","42","10","14.5"
"Webster","2020-08-13","2","368","0","42","10","14.5"
"Webster","2020-08-14","4","372","0","42","7.1","7.4"
"Webster","2020-08-15","0","372","0","42","7.1","5"
"Webster","2020-08-16","1","373","0","42","7.1","5"
"Webster","2020-08-17","2","375","0","42","0","5"
"Webster","2020-08-18","1","376","0","42","0","5"
"Webster","2020-08-19","1","377","0","42","0","5"
"Webster","2020-08-20","1","378","0","42","0","5"
"Webster","2020-08-21","4","382","0","42","0","3.6"
"Webster","2020-08-22","2","384","1","43","7.1","7.1"
"Webster","2020-08-23","0","384","0","43","7.1","7.1"
"Webster","2020-08-24","9","393","0","43","7.1","3.6"
"Webster","2020-08-25","0","393","0","43","7.1","3.6"
"Webster","2020-08-26","1","394","0","43","7.1","3.6"
"Webster","2020-08-27","4","398","0","43","7.1","3.6"
"Webster","2020-08-28","0","398","0","43","7.1","3.6"
"Webster","2020-08-29","0","398","0","43","0","3.6"
"Webster","2020-08-30","0","398","0","43","0","3.6"
"Webster","2020-08-31","11","409","1","44","1.3","4.2"
"Webster","2020-09-01","0","409","0","44","1.3","4.2"
"Webster","2020-09-02","0","409","0","44","1.3","4.2"
"Webster","2020-09-03","5","414","0","44","1.3","4.2"
"Webster","2020-09-04","5","419","0","44","1.3","4.2"
"Webster","2020-09-05","2","421","1","45","8.4","4.2"
"Webster","2020-09-06","0","421","0","45","8.4","4.2"
"Webster","2020-09-07","0","421","0","45","7.1","4.2"
"Webster","2020-09-08","1","422","0","45","7.1","4.2"
"Webster","2020-09-09","3","425","0","45","7.1","4.2"
"Webster","2020-09-10","2","427","0","45","7.1","4.2"
"Webster","2020-09-11","1","428","1","46","21.4","11.4"
"Webster","2020-09-12","1","429","0","46","14.3","11.4"
"Webster","2020-09-13","1","430","0","46","14.3","11.4"
"Webster","2020-09-14","3","433","0","46","14.3","10.7"
"Webster","2020-09-15","0","433","0","46","14.3","10.7"
"Webster","2020-09-16","1","434","0","46","14.3","10.7"
"Webster","2020-09-17","3","437","0","46","14.3","10.7"
"Webster","2020-09-18","5","442","0","46","0","10.7"
"Webster","2020-09-19","0","442","0","46","0","7.1"
"Webster","2020-09-20","0","442","0","46","0","7.1"
"Webster","2020-09-21","6","448","1","47","2.4","8.3"
"Webster","2020-09-22","1","449","0","47","2.4","8.3"
"Webster","2020-09-23","1","450","0","47","2.4","8.3"
"Webster","2020-09-24","0","450","0","47","2.4","8.3"
"Webster","2020-09-25","2","452","0","47","2.4","1.2"
"Webster","2020-09-26","1","453","0","47","2.4","1.2"
"Webster","2020-09-27","0","453","0","47","2.4","1.2"
"Webster","2020-09-28","9","462","1","48","1.6","2"
"Webster","2020-09-29","1","463","0","48","1.6","2"
"Webster","2020-09-30","2","465","0","48","1.6","2"
"Webster","2020-10-01","0","465","0","48","1.6","2"
"Webster","2020-10-02","2","467","0","48","1.6","2"
"Webster","2020-10-03","2","469","0","48","1.6","2"
"Webster","2020-10-04","0","469","0","48","1.6","2"
"Webster","2020-10-05","1","470","0","48","0","0.8"
"Webster","2020-10-06","0","470","0","48","0","0.8"
"Webster","2020-10-07","7","477","0","48","0","0.8"
"Webster","2020-10-08","0","477","0","48","0","0.8"
"Webster","2020-10-09","1","478","0","48","0","0.8"
"Webster","2020-10-10","1","479","0","48","0","0.8"
"Webster","2020-10-11","1","480","0","48","0","0.8"
"Webster","2020-10-12","1","481","0","48","0","0"
"Webster","2020-10-13","0","481","0","48","0","0"
"Webster","2020-10-14","3","484","0","48","0","0"
"Webster","2020-10-15","4","488","0","48","0","0"
"Webster","2020-10-16","3","491","0","48","0","0"
"Webster","2020-10-17","0","491","0","48","0","0"
"Webster","2020-10-18","1","492","0","48","0","0"
"Webster","2020-10-19","4","496","0","48","0","0"
"Webster","2020-10-20","2","498","0","48","0","0"
"Webster","2020-10-21","2","500","1","49","7.1","3.6"
"Webster","2020-10-22","1","501","0","49","7.1","3.6"
"Webster","2020-10-23","0","501","0","49","7.1","3.6"
"Webster","2020-10-24","0","501","0","49","7.1","3.6"
"Webster","2020-10-25","2","503","0","49","7.1","3.6"
"Webster","2020-10-26","0","503","0","49","7.1","3.6"
"Webster","2020-10-27","4","507","0","49","7.1","3.6"
"Webster","2020-10-28","2","509","0","49","0","3.6"
"Webster","2020-10-29","1","510","0","49","0","3.6"
"Webster","2020-10-30","1","511","0","49","0","3.6"
"Webster","2020-10-31","2","513","0","49","0","3.6"
"Webster","2020-11-01","1","514","0","49","0","3.6"
"Webster","2020-11-02","2","516","0","49","0","3.6"
"Webster","2020-11-03","3","519","0","49","0","3.6"
"Webster","2020-11-04","1","520","0","49","0","0"
"Webster","2020-11-05","1","521","0","49","0","0"
"Webster","2020-11-06","3","524","0","49","0","0"
"Webster","2020-11-07","0","524","0","49","0","0"
"Webster","2020-11-08","1","525","0","49","0","0"
"Webster","2020-11-09","7","532","0","49","0","0"
"Webster","2020-11-10","1","533","0","49","0","0"
"Webster","2020-11-11","5","538","0","49","0","0"
"Webster","2020-11-12","2","540","0","49","0","0"
"Webster","2020-11-13","2","542","0","49","0","0"
"Webster","2020-11-14","1","543","0","49","0","0"
"Webster","2020-11-15","1","544","0","49","0","0"
"Webster","2020-11-16","11","555","0","49","0","0"
"Webster","2020-11-17","1","556","0","49","0","0"
"Webster","2020-11-18","3","559","0","49","0","0"
"Webster","2020-11-19","0","559","0","49","0","0"
"Webster","2020-11-20","4","563","0","49","0","0"
"Webster","2020-11-21","0","563","0","49","0","0"
"Webster","2020-11-22","0","563","0","49","0","0"
"Webster","2020-11-23","5","568","1","50","2.9","1.4"
"Webster","2020-11-24","1","569","0","50","2.9","1.4"
"Webster","2020-11-25","1","570","0","50","2.9","1.4"
"Webster","2020-11-26","2","572","0","50","2.9","1.4"
"Webster","2020-11-27","0","572","0","50","2.9","1.4"
"Webster","2020-11-28","0","572","0","50","2.9","1.4"
"Webster","2020-11-29","1","573","0","50","2.9","1.4"
"Webster","2020-11-30","5","578","0","50","0","1.4"
"Webster","2020-12-01","1","579","0","50","0","1.4"
"Webster","2020-12-02","3","582","0","50","0","1.4"
"Webster","2020-12-03","3","585","0","50","0","1.4"
"Webster","2020-12-04","3","588","0","50","0","1.4"
"Webster","2020-12-05","0","588","0","50","0","1.4"
"Webster","2020-12-06","2","590","0","50","0","1.4"
"Webster","2020-12-07","13","603","1","51","1.1","0.5"
"Webster","2020-12-08","2","605","0","51","1.1","0.5"
"Webster","2020-12-09","3","608","0","51","1.1","0.5"
"Webster","2020-12-10","1","609","0","51","1.1","0.5"
"Webster","2020-12-11","4","613","0","51","1.1","0.5"
"Webster","2020-12-12","1","614","0","51","1.1","0.5"
"Webster","2020-12-13","2","616","0","51","1.1","0.5"
"Webster","2020-12-14","14","630","0","51","0","0.5"
"Webster","2020-12-15","1","631","0","51","0","0.5"
"Webster","2020-12-16","3","634","0","51","0","0.5"
"Webster","2020-12-17","5","639","1","52","2.9","2"
"Webster","2020-12-18","3","642","0","52","2.9","2"
"Webster","2020-12-19","1","643","1","53","17.1","9.1"
"Webster","2020-12-20","1","644","0","53","17.1","9.1"
"Webster","2020-12-21","19","663","2","55","18.6","9.3"
"Webster","2020-12-22","3","666","1","56","23.4","11.7"
"Webster","2020-12-23","4","670","0","56","23.4","11.7"
"Webster","2020-12-24","0","670","0","56","20.6","11.7"
"Webster","2020-12-25","0","670","0","56","20.6","11.7"
"Webster","2020-12-26","1","671","1","57","20.6","18.8"
"Webster","2020-12-27","2","673","0","57","20.6","18.8"
"Webster","2020-12-28","3","676","2","59","28.6","23.6"
"Webster","2020-12-29","2","678","0","59","23.8","23.6"
"Webster","2020-12-30","2","680","0","59","23.8","23.6"
"Webster","2020-12-31","2","682","1","60","31","25.8"
"Webster","2021-01-01","0","682","0","60","31","25.8"
"Webster","2021-01-02","0","682","0","60","16.7","18.6"
"Webster","2021-01-03","1","683","0","60","16.7","18.6"
"Webster","2021-01-04","20","703","4","64","10","19.3"
"Webster","2021-01-05","0","703","0","64","10","16.9"
"Webster","2021-01-06","2","705","0","64","10","16.9"
"Webster","2021-01-07","5","710","0","64","2.9","16.9"
"Webster","2021-01-08","0","710","0","64","2.9","16.9"
"Webster","2021-01-09","1","711","0","64","2.9","9.8"
"Webster","2021-01-10","0","711","0","64","2.9","9.8"
"Webster","2021-01-11","17","728","2","66","1.7","5.8"
"Webster","2021-01-12","2","730","0","66","1.7","5.8"
"Webster","2021-01-13","2","732","0","66","1.7","5.8"
"Webster","2021-01-14","4","736","1","67","5.3","4.1"
"Webster","2021-01-15","2","738","0","67","5.3","4.1"
"Webster","2021-01-16","1","739","1","68","19.5","11.2"
"Webster","2021-01-17","1","740","1","69","33.8","18.3"
"Webster","2021-01-18","2","742","0","69","32.1","16.9"
"Webster","2021-01-19","2","744","2","71","46.4","24.1"
"Webster","2021-01-20","1","745","0","71","46.4","24.1"
"Webster","2021-01-21","1","746","1","72","57.1","31.2"
"Webster","2021-01-22","5","751","1","73","60","32.6"
"Webster","2021-01-23","1","752","1","74","60","39.8"
"Webster","2021-01-24","2","754","0","74","45.7","39.8"
"Webster","2021-01-25","21","775","0","74","45.7","38.9"
"Webster","2021-01-26","2","777","2","76","45.7","46.1"
"Webster","2021-01-27","2","779","1","77","52.9","49.6"
"Webster","2021-01-28","2","781","0","77","38.6","47.9"
"Webster","2021-01-29","5","786","0","77","35.7","47.9"
"Webster","2021-01-30","1","787","1","78","35.7","47.9"
"Webster","2021-01-31","0","787","0","78","35.7","40.7"
"Webster","2021-02-01","24","811","3","81","37.5","41.6"
"Webster","2021-02-02","2","813","0","81","23.2","34.5"
"Webster","2021-02-03","2","815","2","83","30.4","41.6"
"Webster","2021-02-04","1","816","0","83","30.4","34.5"
"Webster","2021-02-05","2","818","0","83","30.4","33"
"Webster","2021-02-06","0","818","0","83","16.1","25.9"
"Webster","2021-02-07","0","818","0","83","16.1","25.9"
"Webster","2021-02-08","0","818","0","83","14.3","25.9"
"Wheeler","2020-02-01","0","0","0","0",".","."
"Wheeler","2020-02-02","0","0","0","0",".","."
"Wheeler","2020-02-03","0","0","0","0",".","."
"Wheeler","2020-02-04","0","0","0","0",".","."
"Wheeler","2020-02-05","0","0","0","0",".","."
"Wheeler","2020-02-06","0","0","0","0",".","."
"Wheeler","2020-02-07","0","0","0","0","0","."
"Wheeler","2020-02-08","0","0","0","0","0","."
"Wheeler","2020-02-09","0","0","0","0","0","."
"Wheeler","2020-02-10","0","0","0","0","0","."
"Wheeler","2020-02-11","0","0","0","0","0","."
"Wheeler","2020-02-12","0","0","0","0","0","."
"Wheeler","2020-02-13","0","0","0","0","0","."
"Wheeler","2020-02-14","0","0","0","0","0","0"
"Wheeler","2020-02-15","0","0","0","0","0","0"
"Wheeler","2020-02-16","0","0","0","0","0","0"
"Wheeler","2020-02-17","0","0","0","0","0","0"
"Wheeler","2020-02-18","0","0","0","0","0","0"
"Wheeler","2020-02-19","0","0","0","0","0","0"
"Wheeler","2020-02-20","0","0","0","0","0","0"
"Wheeler","2020-02-21","0","0","0","0","0","0"
"Wheeler","2020-02-22","0","0","0","0","0","0"
"Wheeler","2020-02-23","0","0","0","0","0","0"
"Wheeler","2020-02-24","0","0","0","0","0","0"
"Wheeler","2020-02-25","0","0","0","0","0","0"
"Wheeler","2020-02-26","0","0","0","0","0","0"
"Wheeler","2020-02-27","0","0","0","0","0","0"
"Wheeler","2020-02-28","0","0","0","0","0","0"
"Wheeler","2020-02-29","0","0","0","0","0","0"
"Wheeler","2020-03-01","0","0","0","0","0","0"
"Wheeler","2020-03-02","0","0","0","0","0","0"
"Wheeler","2020-03-03","0","0","0","0","0","0"
"Wheeler","2020-03-04","0","0","0","0","0","0"
"Wheeler","2020-03-05","0","0","0","0","0","0"
"Wheeler","2020-03-06","0","0","0","0","0","0"
"Wheeler","2020-03-07","0","0","0","0","0","0"
"Wheeler","2020-03-08","0","0","0","0","0","0"
"Wheeler","2020-03-09","0","0","0","0","0","0"
"Wheeler","2020-03-10","0","0","0","0","0","0"
"Wheeler","2020-03-11","0","0","0","0","0","0"
"Wheeler","2020-03-12","0","0","0","0","0","0"
"Wheeler","2020-03-13","0","0","0","0","0","0"
"Wheeler","2020-03-14","0","0","0","0","0","0"
"Wheeler","2020-03-15","0","0","0","0","0","0"
"Wheeler","2020-03-16","0","0","0","0","0","0"
"Wheeler","2020-03-17","0","0","0","0","0","0"
"Wheeler","2020-03-18","1","1","0","0","0","0"
"Wheeler","2020-03-19","1","2","0","0","0","0"
"Wheeler","2020-03-20","1","3","0","0","0","0"
"Wheeler","2020-03-21","0","3","0","0","0","0"
"Wheeler","2020-03-22","1","4","0","0","0","0"
"Wheeler","2020-03-23","1","5","0","0","0","0"
"Wheeler","2020-03-24","1","6","0","0","0","0"
"Wheeler","2020-03-25","1","7","0","0","0","0"
"Wheeler","2020-03-26","0","7","0","0","0","0"
"Wheeler","2020-03-27","2","9","1","1","7.1","3.6"
"Wheeler","2020-03-28","0","9","0","1","7.1","3.6"
"Wheeler","2020-03-29","0","9","0","1","7.1","3.6"
"Wheeler","2020-03-30","0","9","0","1","7.1","3.6"
"Wheeler","2020-03-31","2","11","0","1","7.1","3.6"
"Wheeler","2020-04-01","0","11","0","1","7.1","3.6"
"Wheeler","2020-04-02","0","11","0","1","7.1","3.6"
"Wheeler","2020-04-03","0","11","0","1","0","3.6"
"Wheeler","2020-04-04","2","13","0","1","0","3.6"
"Wheeler","2020-04-05","0","13","0","1","0","3.6"
"Wheeler","2020-04-06","0","13","0","1","0","3.6"
"Wheeler","2020-04-07","1","14","0","1","0","3.6"
"Wheeler","2020-04-08","1","15","1","2","14.3","10.7"
"Wheeler","2020-04-09","1","16","0","2","14.3","10.7"
"Wheeler","2020-04-10","0","16","0","2","14.3","7.1"
"Wheeler","2020-04-11","1","17","1","3","28.6","14.3"
"Wheeler","2020-04-12","0","17","0","3","28.6","14.3"
"Wheeler","2020-04-13","2","19","0","3","28.6","14.3"
"Wheeler","2020-04-14","1","20","0","3","28.6","14.3"
"Wheeler","2020-04-15","3","23","0","3","14.3","14.3"
"Wheeler","2020-04-16","0","23","0","3","14.3","14.3"
"Wheeler","2020-04-17","0","23","0","3","14.3","14.3"
"Wheeler","2020-04-18","0","23","0","3","0","14.3"
"Wheeler","2020-04-19","0","23","0","3","0","14.3"
"Wheeler","2020-04-20","0","23","0","3","0","14.3"
"Wheeler","2020-04-21","2","25","0","3","0","14.3"
"Wheeler","2020-04-22","1","26","0","3","0","7.1"
"Wheeler","2020-04-23","1","27","1","4","14.3","14.3"
"Wheeler","2020-04-24","0","27","0","4","14.3","14.3"
"Wheeler","2020-04-25","3","30","1","5","19","9.5"
"Wheeler","2020-04-26","1","31","0","5","19","9.5"
"Wheeler","2020-04-27","2","33","0","5","19","9.5"
"Wheeler","2020-04-28","1","34","0","5","19","9.5"
"Wheeler","2020-04-29","3","37","0","5","19","9.5"
"Wheeler","2020-04-30","1","38","0","5","4.8","9.5"
"Wheeler","2020-05-01","1","39","0","5","4.8","9.5"
"Wheeler","2020-05-02","0","39","0","5","0","9.5"
"Wheeler","2020-05-03","0","39","0","5","0","9.5"
"Wheeler","2020-05-04","0","39","0","5","0","9.5"
"Wheeler","2020-05-05","1","40","0","5","0","9.5"
"Wheeler","2020-05-06","0","40","0","5","0","9.5"
"Wheeler","2020-05-07","0","40","0","5","0","2.4"
"Wheeler","2020-05-08","0","40","0","5","0","2.4"
"Wheeler","2020-05-09","2","42","0","5","0","0"
"Wheeler","2020-05-10","0","42","0","5","0","0"
"Wheeler","2020-05-11","1","43","0","5","0","0"
"Wheeler","2020-05-12","1","44","0","5","0","0"
"Wheeler","2020-05-13","3","47","0","5","0","0"
"Wheeler","2020-05-14","2","49","0","5","0","0"
"Wheeler","2020-05-15","2","51","0","5","0","0"
"Wheeler","2020-05-16","2","53","1","6","7.1","3.6"
"Wheeler","2020-05-17","1","54","0","6","7.1","3.6"
"Wheeler","2020-05-18","0","54","0","6","7.1","3.6"
"Wheeler","2020-05-19","1","55","0","6","7.1","3.6"
"Wheeler","2020-05-20","2","57","0","6","7.1","3.6"
"Wheeler","2020-05-21","2","59","0","6","7.1","3.6"
"Wheeler","2020-05-22","1","60","0","6","7.1","3.6"
"Wheeler","2020-05-23","0","60","0","6","0","3.6"
"Wheeler","2020-05-24","0","60","0","6","0","3.6"
"Wheeler","2020-05-25","1","61","0","6","0","3.6"
"Wheeler","2020-05-26","1","62","0","6","0","3.6"
"Wheeler","2020-05-27","1","63","0","6","0","3.6"
"Wheeler","2020-05-28","1","64","0","6","0","3.6"
"Wheeler","2020-05-29","4","68","0","6","0","3.6"
"Wheeler","2020-05-30","0","68","0","6","0","0"
"Wheeler","2020-05-31","1","69","0","6","0","0"
"Wheeler","2020-06-01","26","95","0","6","0","0"
"Wheeler","2020-06-02","3","98","0","6","0","0"
"Wheeler","2020-06-03","0","98","0","6","0","0"
"Wheeler","2020-06-04","1","99","0","6","0","0"
"Wheeler","2020-06-05","2","101","0","6","0","0"
"Wheeler","2020-06-06","1","102","0","6","0","0"
"Wheeler","2020-06-07","0","102","0","6","0","0"
"Wheeler","2020-06-08","1","103","0","6","0","0"
"Wheeler","2020-06-09","5","108","0","6","0","0"
"Wheeler","2020-06-10","4","112","3","9","10.7","5.4"
"Wheeler","2020-06-11","0","112","0","9","10.7","5.4"
"Wheeler","2020-06-12","5","117","1","10","13.6","6.8"
"Wheeler","2020-06-13","7","124","6","16","25.8","12.9"
"Wheeler","2020-06-14","0","124","0","16","25.8","12.9"
"Wheeler","2020-06-15","1","125","0","16","25.8","12.9"
"Wheeler","2020-06-16","0","125","0","16","25.8","12.9"
"Wheeler","2020-06-17","1","126","1","17","29.4","20.1"
"Wheeler","2020-06-18","1","127","0","17","29.4","20.1"
"Wheeler","2020-06-19","2","129","0","17","26.5","20.1"
"Wheeler","2020-06-20","1","130","0","17","14.3","20.1"
"Wheeler","2020-06-21","1","131","0","17","14.3","20.1"
"Wheeler","2020-06-22","3","134","1","18","19","22.4"
"Wheeler","2020-06-23","3","137","0","18","19","22.4"
"Wheeler","2020-06-24","3","140","0","18","4.8","17.1"
"Wheeler","2020-06-25","6","146","2","20","9.5","19.5"
"Wheeler","2020-06-26","3","149","0","20","9.5","18"
"Wheeler","2020-06-27","1","150","0","20","9.5","11.9"
"Wheeler","2020-06-28","0","150","0","20","9.5","11.9"
"Wheeler","2020-06-29","5","155","0","20","4.8","11.9"
"Wheeler","2020-06-30","1","156","0","20","4.8","11.9"
"Wheeler","2020-07-01","4","160","1","21","8.3","6.5"
"Wheeler","2020-07-02","2","162","1","22","10.7","10.1"
"Wheeler","2020-07-03","33","195","1","23","11.1","10.3"
"Wheeler","2020-07-04","1","196","0","23","11.1","10.3"
"Wheeler","2020-07-05","0","196","0","23","11.1","10.3"
"Wheeler","2020-07-06","4","200","1","24","14.7","9.7"
"Wheeler","2020-07-07","1","201","0","24","14.7","9.7"
"Wheeler","2020-07-08","19","220","3","27","13.4","10.9"
"Wheeler","2020-07-09","1","221","0","27","6.3","8.5"
"Wheeler","2020-07-10","0","221","0","27","5.8","8.5"
"Wheeler","2020-07-11","1","222","1","28","20.1","15.6"
"Wheeler","2020-07-12","2","224","1","29","27.3","19.2"
"Wheeler","2020-07-13","5","229","0","29","23.7","19.2"
"Wheeler","2020-07-14","3","232","0","29","23.7","19.2"
"Wheeler","2020-07-15","2","234","0","29","21.4","17.4"
"Wheeler","2020-07-16","2","236","0","29","21.4","13.8"
"Wheeler","2020-07-17","3","239","1","30","26.2","16"
"Wheeler","2020-07-18","3","242","0","30","11.9","16"
"Wheeler","2020-07-19","0","242","0","30","4.8","16"
"Wheeler","2020-07-20","3","245","0","30","4.8","14.2"
"Wheeler","2020-07-21","2","247","0","30","4.8","14.2"
"Wheeler","2020-07-22","3","250","0","30","4.8","13.1"
"Wheeler","2020-07-23","1","251","0","30","4.8","13.1"
"Wheeler","2020-07-24","2","253","1","31","7.1","16.7"
"Wheeler","2020-07-25","3","256","0","31","7.1","9.5"
"Wheeler","2020-07-26","0","256","0","31","7.1","6"
"Wheeler","2020-07-27","3","259","1","32","11.9","8.3"
"Wheeler","2020-07-28","1","260","0","32","11.9","8.3"
"Wheeler","2020-07-29","3","263","1","33","16.7","10.7"
"Wheeler","2020-07-30","0","263","0","33","16.7","10.7"
"Wheeler","2020-07-31","9","272","2","35","12.7","9.9"
"Wheeler","2020-08-01","1","273","0","35","12.7","9.9"
"Wheeler","2020-08-02","3","276","1","36","17.5","12.3"
"Wheeler","2020-08-03","0","276","0","36","12.7","12.3"
"Wheeler","2020-08-04","2","278","2","38","27","19.4"
"Wheeler","2020-08-05","7","285","2","40","26.3","21.5"
"Wheeler","2020-08-06","2","287","1","41","33.4","25.1"
"Wheeler","2020-08-07","2","289","0","41","30.3","21.5"
"Wheeler","2020-08-08","2","291","0","41","30.3","21.5"
"Wheeler","2020-08-09","4","295","3","44","36.2","26.8"
"Wheeler","2020-08-10","5","300","1","45","39.1","25.9"
"Wheeler","2020-08-11","3","303","1","46","29.6","28.3"
"Wheeler","2020-08-12","2","305","0","46","25.5","25.9"
"Wheeler","2020-08-13","4","309","1","47","21.9","27.7"
"Wheeler","2020-08-14","1","310","1","48","36.2","33.2"
"Wheeler","2020-08-15","1","311","1","49","50.5","40.4"
"Wheeler","2020-08-16","2","313","1","50","46.9","41.6"
"Wheeler","2020-08-17","4","317","1","51","47.6","43.4"
"Wheeler","2020-08-18","6","323","0","51","42.9","36.2"
"Wheeler","2020-08-19","11","334","4","55","48.1","36.8"
"Wheeler","2020-08-20","4","338","1","56","48.1","35"
"Wheeler","2020-08-21","2","340","1","57","40.9","38.5"
"Wheeler","2020-08-22","2","342","2","59","40.9","45.7"
"Wheeler","2020-08-23","3","345","1","60","38.5","42.7"
"Wheeler","2020-08-24","5","350","4","64","46.4","47"
"Wheeler","2020-08-25","6","356","0","64","46.4","44.6"
"Wheeler","2020-08-26","2","358","2","66","55.5","51.8"
"Wheeler","2020-08-27","3","361","2","68","61.4","54.7"
"Wheeler","2020-08-28","2","363","0","68","54.3","47.6"
"Wheeler","2020-08-29","4","367","2","70","47.1","44"
"Wheeler","2020-08-30","1","368","1","71","56.7","47.6"
"Wheeler","2020-08-31","4","372","0","71","45.2","45.8"
"Wheeler","2020-09-01","54","426","5","76","46.6","46.5"
"Wheeler","2020-09-02","0","426","0","76","32.3","43.9"
"Wheeler","2020-09-03","3","429","0","76","22.8","42.1"
"Wheeler","2020-09-04","5","434","1","77","25.6","39.9"
"Wheeler","2020-09-05","1","435","0","77","18.5","32.8"
"Wheeler","2020-09-06","7","442","3","80","10.3","33.5"
"Wheeler","2020-09-07","0","442","0","80","10.3","27.8"
"Wheeler","2020-09-08","22","464","7","87","13.5","30"
"Wheeler","2020-09-09","2","466","1","88","20.7","26.5"
"Wheeler","2020-09-10","1","467","0","88","20.7","21.7"
"Wheeler","2020-09-11","2","469","0","88","17.8","21.7"
"Wheeler","2020-09-12","6","475","1","89","20.2","19.3"
"Wheeler","2020-09-13","0","475","0","89","14.1","12.2"
"Wheeler","2020-09-14","2","477","1","90","21.2","15.8"
"Wheeler","2020-09-15","33","510","3","93","18","15.7"
"Wheeler","2020-09-16","6","516","0","93","10.8","15.7"
"Wheeler","2020-09-17","6","522","1","94","13.2","16.9"
"Wheeler","2020-09-18","12","534","3","97","16.8","17.3"
"Wheeler","2020-09-19","2","536","0","97","14.4","17.3"
"Wheeler","2020-09-20","2","538","0","97","14.4","14.2"
"Wheeler","2020-09-21","6","544","0","97","7.3","14.2"
"Wheeler","2020-09-22","23","567","2","99","7.2","12.6"
"Wheeler","2020-09-23","6","573","0","99","7.2","9"
"Wheeler","2020-09-24","6","579","4","103","14.3","13.8"
"Wheeler","2020-09-25","0","579","0","103","10.8","13.8"
"Wheeler","2020-09-26","2","581","1","104","17.9","16.2"
"Wheeler","2020-09-27","2","583","0","104","17.9","16.2"
"Wheeler","2020-09-28","3","586","1","105","22.7","15"
"Wheeler","2020-09-29","51","637","5","110","22.8","15"
"Wheeler","2020-09-30","1","638","0","110","22.8","15"
"Wheeler","2020-10-01","5","643","0","110","13.3","13.8"
"Wheeler","2020-10-02","2","645","0","110","13.3","12"
"Wheeler","2020-10-03","2","647","0","110","6.2","12"
"Wheeler","2020-10-04","3","650","0","110","6.2","12"
"Wheeler","2020-10-05","6","656","1","111","3.8","13.2"
"Wheeler","2020-10-06","35","691","5","116","4.4","13.6"
"Wheeler","2020-10-07","3","694","0","116","4.4","13.6"
"Wheeler","2020-10-08","5","699","1","117","7.3","10.3"
"Wheeler","2020-10-09","7","706","0","117","7.3","10.3"
"Wheeler","2020-10-10","3","709","0","117","7.3","6.7"
"Wheeler","2020-10-11","3","712","0","117","7.3","6.7"
"Wheeler","2020-10-12","3","715","0","117","4.9","4.3"
"Wheeler","2020-10-13","27","742","5","122","5.5","5"
"Wheeler","2020-10-14","7","749","1","123","7.5","6"
"Wheeler","2020-10-15","2","751","0","123","4.7","6"
"Wheeler","2020-10-16","2","753","1","124","11.8","9.6"
"Wheeler","2020-10-17","3","756","0","124","11.8","9.6"
"Wheeler","2020-10-18","0","756","0","124","11.8","9.6"
"Wheeler","2020-10-19","2","758","1","125","19","11.9"
"Wheeler","2020-10-20","13","771","2","127","18.5","12"
"Wheeler","2020-10-21","5","776","1","128","19.3","13.4"
"Wheeler","2020-10-22","1","777","0","128","19.3","12"
"Wheeler","2020-10-23","0","777","0","128","12.2","12"
"Wheeler","2020-10-24","3","780","1","129","17","14.4"
"Wheeler","2020-10-25","3","783","0","129","17","14.4"
"Wheeler","2020-10-26","2","785","0","129","9.8","14.4"
"Wheeler","2020-10-27","18","803","0","129","7.6","13.1"
"Wheeler","2020-10-28","0","803","0","129","4.8","12.1"
"Wheeler","2020-10-29","3","806","0","129","4.8","12.1"
"Wheeler","2020-10-30","3","809","0","129","4.8","8.5"
"Wheeler","2020-10-31","1","810","0","129","0","8.5"
"Wheeler","2020-11-01","1","811","0","129","0","8.5"
"Wheeler","2020-11-02","0","811","0","129","0","4.9"
"Wheeler","2020-11-03","23","834","3","132","1.9","4.7"
"Wheeler","2020-11-04","1","835","0","132","1.9","3.3"
"Wheeler","2020-11-05","1","836","0","132","1.9","3.3"
"Wheeler","2020-11-06","0","836","0","132","1.9","3.3"
"Wheeler","2020-11-07","3","839","0","132","1.9","0.9"
"Wheeler","2020-11-08","0","839","0","132","1.9","0.9"
"Wheeler","2020-11-09","4","843","0","132","1.9","0.9"
"Wheeler","2020-11-10","17","860","0","132","0","0.9"
"Wheeler","2020-11-11","4","864","0","132","0","0.9"
"Wheeler","2020-11-12","3","867","0","132","0","0.9"
"Wheeler","2020-11-13","2","869","0","132","0","0.9"
"Wheeler","2020-11-14","0","869","0","132","0","0.9"
"Wheeler","2020-11-15","1","870","0","132","0","0.9"
"Wheeler","2020-11-16","4","874","0","132","0","0.9"
"Wheeler","2020-11-17","17","891","0","132","0","0"
"Wheeler","2020-11-18","0","891","0","132","0","0"
"Wheeler","2020-11-19","1","892","0","132","0","0"
"Wheeler","2020-11-20","3","895","0","132","0","0"
"Wheeler","2020-11-21","0","895","0","132","0","0"
"Wheeler","2020-11-22","2","897","0","132","0","0"
"Wheeler","2020-11-23","1","898","0","132","0","0"
"Wheeler","2020-11-24","13","911","2","134","2.2","1.1"
"Wheeler","2020-11-25","4","915","0","134","2.2","1.1"
"Wheeler","2020-11-26","1","916","0","134","2.2","1.1"
"Wheeler","2020-11-27","2","918","0","134","2.2","1.1"
"Wheeler","2020-11-28","1","919","0","134","2.2","1.1"
"Wheeler","2020-11-29","3","922","0","134","2.2","1.1"
"Wheeler","2020-11-30","3","925","0","134","2.2","1.1"
"Wheeler","2020-12-01","16","941","1","135","0.9","1.5"
"Wheeler","2020-12-02","5","946","1","136","3.8","3"
"Wheeler","2020-12-03","1","947","0","136","3.8","3"
"Wheeler","2020-12-04","5","952","0","136","3.8","3"
"Wheeler","2020-12-05","3","955","0","136","3.8","3"
"Wheeler","2020-12-06","1","956","0","136","3.8","3"
"Wheeler","2020-12-07","1","957","0","136","3.8","3"
"Wheeler","2020-12-08","15","972","4","140","6.7","3.8"
"Wheeler","2020-12-09","3","975","2","142","13.3","8.5"
"Wheeler","2020-12-10","2","977","0","142","13.3","8.5"
"Wheeler","2020-12-11","3","980","2","144","22.9","13.3"
"Wheeler","2020-12-12","1","981","0","144","22.9","13.3"
"Wheeler","2020-12-13","3","984","0","144","22.9","13.3"
"Wheeler","2020-12-14","9","993","0","144","22.9","13.3"
"Wheeler","2020-12-15","26","1019","2","146","20.1","13.4"
"Wheeler","2020-12-16","1","1020","0","146","10.6","12"
"Wheeler","2020-12-17","3","1023","1","147","15.4","14.4"
"Wheeler","2020-12-18","3","1026","0","147","5.9","14.4"
"Wheeler","2020-12-19","4","1030","0","147","5.9","14.4"
"Wheeler","2020-12-20","4","1034","0","147","5.9","14.4"
"Wheeler","2020-12-21","6","1040","0","147","5.9","14.4"
"Wheeler","2020-12-22","34","1074","7","154","7.7","13.9"
"Wheeler","2020-12-23","3","1077","1","155","12.5","11.5"
"Wheeler","2020-12-24","1","1078","1","156","22","18.7"
"Wheeler","2020-12-25","0","1078","0","156","22","13.9"
"Wheeler","2020-12-26","5","1083","2","158","27.7","16.8"
"Wheeler","2020-12-27","2","1085","1","159","34.8","20.4"
"Wheeler","2020-12-28","6","1091","1","160","37.2","21.5"
"Wheeler","2020-12-29","54","1145","13","173","37.7","22.7"
"Wheeler","2020-12-30","5","1150","2","175","38.7","25.6"
"Wheeler","2020-12-31","4","1154","1","176","28","25"
"Wheeler","2021-01-01","0","1154","0","176","28","25"
"Wheeler","2021-01-02","4","1158","0","176","22.2","25"
"Wheeler","2021-01-03","1","1159","0","176","15.1","25"
"Wheeler","2021-01-04","6","1165","3","179","19.9","28.5"
"Wheeler","2021-01-05","48","1213","11","190","19.7","28.7"
"Wheeler","2021-01-06","9","1222","4","194","20.3","29.5"
"Wheeler","2021-01-07","3","1225","1","195","21.5","24.7"
"Wheeler","2021-01-08","1","1226","0","195","21.5","24.7"
"Wheeler","2021-01-09","5","1231","0","195","21.5","21.9"
"Wheeler","2021-01-10","3","1234","1","196","26.3","20.7"
"Wheeler","2021-01-11","5","1239","0","196","19.1","19.5"
"Wheeler","2021-01-12","3","1242","0","196","15.9","17.8"
"Wheeler","2021-01-13","7","1249","1","197","11.6","16"
"Wheeler","2021-01-14","6","1255","2","199","11.6","16.5"
"Wheeler","2021-01-15","6","1261","1","200","13.9","17.7"
"Wheeler","2021-01-16","2","1263","0","200","13.9","17.7"
"Wheeler","2021-01-17","1","1264","1","201","23.5","24.9"
"Wheeler","2021-01-18","3","1267","0","201","23.5","21.3"
"Wheeler","2021-01-19","40","1307","8","209","26.3","21.1"
"Wheeler","2021-01-20","4","1311","0","209","24.3","17.9"
"Wheeler","2021-01-21","2","1313","0","209","19.5","15.5"
"Wheeler","2021-01-22","3","1316","0","209","17.1","15.5"
"Wheeler","2021-01-23","3","1319","1","210","21.9","17.9"
"Wheeler","2021-01-24","6","1325","4","214","17.1","20.3"
"Wheeler","2021-01-25","2","1327","0","214","17.1","20.3"
"Wheeler","2021-01-26","7","1334","1","215","16.3","21.3"
"Wheeler","2021-01-27","8","1342","0","215","16.3","20.3"
"Wheeler","2021-01-28","9","1351","1","216","17.9","18.7"
"Wheeler","2021-01-29","3","1354","0","216","17.9","17.5"
"Wheeler","2021-01-30","2","1356","0","216","13.2","17.5"
"Wheeler","2021-01-31","1","1357","0","216","3.6","10.4"
"Wheeler","2021-02-01","8","1365","1","217","5.4","11.3"
"Wheeler","2021-02-02","48","1413","3","220","4.3","10.3"
"Wheeler","2021-02-03","2","1415","0","220","4.3","10.3"
"Wheeler","2021-02-04","1","1416","0","220","2.7","10.3"
"Wheeler","2021-02-05","6","1422","0","220","2.7","10.3"
"Wheeler","2021-02-06","1","1423","0","220","2.7","7.9"
"Wheeler","2021-02-07","3","1426","2","222","12.2","7.9"
"Wheeler","2021-02-08","0","1426","0","222","10.4","7.9"
"White","2020-02-01","0","0","0","0",".","."
"White","2020-02-02","0","0","0","0",".","."
"White","2020-02-03","0","0","0","0",".","."
"White","2020-02-04","0","0","0","0",".","."
"White","2020-02-05","0","0","0","0",".","."
"White","2020-02-06","0","0","0","0",".","."
"White","2020-02-07","0","0","0","0","0","."
"White","2020-02-08","0","0","0","0","0","."
"White","2020-02-09","0","0","0","0","0","."
"White","2020-02-10","0","0","0","0","0","."
"White","2020-02-11","0","0","0","0","0","."
"White","2020-02-12","0","0","0","0","0","."
"White","2020-02-13","0","0","0","0","0","."
"White","2020-02-14","0","0","0","0","0","0"
"White","2020-02-15","0","0","0","0","0","0"
"White","2020-02-16","0","0","0","0","0","0"
"White","2020-02-17","0","0","0","0","0","0"
"White","2020-02-18","0","0","0","0","0","0"
"White","2020-02-19","0","0","0","0","0","0"
"White","2020-02-20","0","0","0","0","0","0"
"White","2020-02-21","0","0","0","0","0","0"
"White","2020-02-22","0","0","0","0","0","0"
"White","2020-02-23","0","0","0","0","0","0"
"White","2020-02-24","0","0","0","0","0","0"
"White","2020-02-25","0","0","0","0","0","0"
"White","2020-02-26","0","0","0","0","0","0"
"White","2020-02-27","0","0","0","0","0","0"
"White","2020-02-28","0","0","0","0","0","0"
"White","2020-02-29","0","0","0","0","0","0"
"White","2020-03-01","0","0","0","0","0","0"
"White","2020-03-02","0","0","0","0","0","0"
"White","2020-03-03","0","0","0","0","0","0"
"White","2020-03-04","0","0","0","0","0","0"
"White","2020-03-05","0","0","0","0","0","0"
"White","2020-03-06","0","0","0","0","0","0"
"White","2020-03-07","0","0","0","0","0","0"
"White","2020-03-08","0","0","0","0","0","0"
"White","2020-03-09","0","0","0","0","0","0"
"White","2020-03-10","0","0","0","0","0","0"
"White","2020-03-11","1","1","0","0","0","0"
"White","2020-03-12","0","1","0","0","0","0"
"White","2020-03-13","0","1","0","0","0","0"
"White","2020-03-14","0","1","0","0","0","0"
"White","2020-03-15","3","4","0","0","0","0"
"White","2020-03-16","7","11","0","0","0","0"
"White","2020-03-17","7","18","0","0","0","0"
"White","2020-03-18","6","24","0","0","0","0"
"White","2020-03-19","14","38","0","0","0","0"
"White","2020-03-20","5","43","0","0","0","0"
"White","2020-03-21","8","51","0","0","0","0"
"White","2020-03-22","7","58","1","1","2","1"
"White","2020-03-23","6","64","0","1","2","1"
"White","2020-03-24","9","73","0","1","2","1"
"White","2020-03-25","7","80","0","1","2","1"
"White","2020-03-26","0","80","0","1","2","1"
"White","2020-03-27","1","81","0","1","2","1"
"White","2020-03-28","0","81","0","1","2","1"
"White","2020-03-29","1","82","0","1","0","1"
"White","2020-03-30","1","83","0","1","0","1"
"White","2020-03-31","5","88","0","1","0","1"
"White","2020-04-01","1","89","0","1","0","1"
"White","2020-04-02","1","90","0","1","0","1"
"White","2020-04-03","1","91","0","1","0","1"
"White","2020-04-04","1","92","0","1","0","1"
"White","2020-04-05","0","92","0","1","0","0"
"White","2020-04-06","2","94","0","1","0","0"
"White","2020-04-07","3","97","0","1","0","0"
"White","2020-04-08","1","98","0","1","0","0"
"White","2020-04-09","2","100","1","2","7.1","3.6"
"White","2020-04-10","4","104","0","2","7.1","3.6"
"White","2020-04-11","0","104","0","2","7.1","3.6"
"White","2020-04-12","0","104","0","2","7.1","3.6"
"White","2020-04-13","3","107","0","2","7.1","3.6"
"White","2020-04-14","1","108","0","2","7.1","3.6"
"White","2020-04-15","7","115","0","2","7.1","3.6"
"White","2020-04-16","1","116","0","2","0","3.6"
"White","2020-04-17","5","121","0","2","0","3.6"
"White","2020-04-18","1","122","0","2","0","3.6"
"White","2020-04-19","0","122","0","2","0","3.6"
"White","2020-04-20","12","134","0","2","0","3.6"
"White","2020-04-21","7","141","1","3","2","4.6"
"White","2020-04-22","5","146","0","3","2","4.6"
"White","2020-04-23","5","151","0","3","2","1"
"White","2020-04-24","4","155","0","3","2","1"
"White","2020-04-25","4","159","0","3","2","1"
"White","2020-04-26","0","159","0","3","2","1"
"White","2020-04-27","5","164","0","3","2","1"
"White","2020-04-28","11","175","0","3","0","1"
"White","2020-04-29","26","201","0","3","0","1"
"White","2020-04-30","24","225","0","3","0","1"
"White","2020-05-01","17","242","1","4","0.8","1.4"
"White","2020-05-02","4","246","0","4","0.8","1.4"
"White","2020-05-03","2","248","0","4","0.8","1.4"
"White","2020-05-04","7","255","0","4","0.8","1.4"
"White","2020-05-05","10","265","1","5","2.3","1.1"
"White","2020-05-06","8","273","0","5","2.3","1.1"
"White","2020-05-07","2","275","0","5","2.3","1.1"
"White","2020-05-08","7","282","0","5","1.4","1.1"
"White","2020-05-09","2","284","0","5","1.4","1.1"
"White","2020-05-10","0","284","0","5","1.4","1.1"
"White","2020-05-11","6","290","0","5","1.4","1.1"
"White","2020-05-12","12","302","0","5","0","1.1"
"White","2020-05-13","8","310","0","5","0","1.1"
"White","2020-05-14","8","318","0","5","0","1.1"
"White","2020-05-15","11","329","1","6","1.3","1.4"
"White","2020-05-16","2","331","0","6","1.3","1.4"
"White","2020-05-17","4","335","0","6","1.3","1.4"
"White","2020-05-18","20","355","2","8","2.7","2.1"
"White","2020-05-19","12","367","0","8","2.7","1.4"
"White","2020-05-20","27","394","1","9","3.3","1.6"
"White","2020-05-21","3","397","0","9","3.3","1.6"
"White","2020-05-22","10","407","0","9","2","1.6"
"White","2020-05-23","4","411","0","9","2","1.6"
"White","2020-05-24","0","411","0","9","2","1.6"
"White","2020-05-25","0","411","0","9","0.5","1.6"
"White","2020-05-26","6","417","1","10","2.9","2.8"
"White","2020-05-27","10","427","0","10","2.4","2.8"
"White","2020-05-28","7","434","0","10","2.4","2.8"
"White","2020-05-29","11","445","0","10","2.4","2.2"
"White","2020-05-30","3","448","0","10","2.4","2.2"
"White","2020-05-31","3","451","0","10","2.4","2.2"
"White","2020-06-01","9","460","0","10","2.4","1.5"
"White","2020-06-02","6","466","0","10","0","1.5"
"White","2020-06-03","9","475","0","10","0","1.2"
"White","2020-06-04","9","484","1","11","1.6","2"
"White","2020-06-05","6","490","0","11","1.6","2"
"White","2020-06-06","6","496","0","11","1.6","2"
"White","2020-06-07","1","497","0","11","1.6","2"
"White","2020-06-08","9","506","0","11","1.6","2"
"White","2020-06-09","7","513","0","11","1.6","0.8"
"White","2020-06-10","4","517","0","11","1.6","0.8"
"White","2020-06-11","11","528","0","11","0","0.8"
"White","2020-06-12","9","537","0","11","0","0.8"
"White","2020-06-13","11","548","0","11","0","0.8"
"White","2020-06-14","0","548","0","11","0","0.8"
"White","2020-06-15","7","555","0","11","0","0.8"
"White","2020-06-16","11","566","0","11","0","0.8"
"White","2020-06-17","13","579","0","11","0","0.8"
"White","2020-06-18","10","589","0","11","0","0"
"White","2020-06-19","7","596","2","13","4.1","2"
"White","2020-06-20","5","601","0","13","4.1","2"
"White","2020-06-21","0","601","0","13","4.1","2"
"White","2020-06-22","7","608","0","13","4.1","2"
"White","2020-06-23","13","621","0","13","4.1","2"
"White","2020-06-24","16","637","0","13","4.1","2"
"White","2020-06-25","58","695","3","16","4.8","2.4"
"White","2020-06-26","22","717","0","16","0.7","2.4"
"White","2020-06-27","19","736","2","18","2.2","3.2"
"White","2020-06-28","3","739","0","18","2.2","3.2"
"White","2020-06-29","42","781","0","18","2.2","3.2"
"White","2020-06-30","34","815","2","20","3.1","3.6"
"White","2020-07-01","24","839","0","20","3.1","3.6"
"White","2020-07-02","48","887","2","22","2.9","3.9"
"White","2020-07-03","6","893","0","22","2.9","1.8"
"White","2020-07-04","22","915","0","22","1.4","1.8"
"White","2020-07-05","21","936","1","23","2.1","2.2"
"White","2020-07-06","19","955","2","25","3.6","2.9"
"White","2020-07-07","43","998","4","29","4.1","3.6"
"White","2020-07-08","32","1030","4","33","5.9","4.5"
"White","2020-07-09","49","1079","4","37","6.5","4.7"
"White","2020-07-10","25","1104","1","38","7","5"
"White","2020-07-11","13","1117","2","40","9.2","5.3"
"White","2020-07-12","48","1165","3","43","9.4","5.8"
"White","2020-07-13","22","1187","2","45","9.2","6.4"
"White","2020-07-14","24","1211","2","47","9.1","6.6"
"White","2020-07-15","77","1288","8","55","8.8","7.3"
"White","2020-07-16","45","1333","4","59","8.9","7.7"
"White","2020-07-17","57","1390","8","67","10.3","8.7"
"White","2020-07-18","12","1402","2","69","10.5","9.9"
"White","2020-07-19","34","1436","4","73","11.3","10.4"
"White","2020-07-20","31","1467","4","77","11.9","10.5"
"White","2020-07-21","31","1498","3","80","12","10.6"
"White","2020-07-22","31","1529","0","80","10.6","9.7"
"White","2020-07-23","44","1573","4","84","10.6","9.7"
"White","2020-07-24","26","1599","1","85","9.1","9.7"
"White","2020-07-25","28","1627","6","91","9.8","10.2"
"White","2020-07-26","28","1655","11","102","13.7","12.5"
"White","2020-07-27","21","1676","3","105","13.9","12.9"
"White","2020-07-28","26","1702","2","107","13.7","12.9"
"White","2020-07-29","58","1760","6","113","15.1","12.9"
"White","2020-07-30","46","1806","6","119","15.7","13.1"
"White","2020-07-31","43","1849","4","123","16.5","12.8"
"White","2020-08-01","16","1865","6","129","18.8","14.3"
"White","2020-08-02","23","1888","3","132","15","14.4"
"White","2020-08-03","24","1912","3","135","14.8","14.4"
"White","2020-08-04","15","1927","6","141","19.4","16.5"
"White","2020-08-05","28","1955","3","144","19.4","17.3"
"White","2020-08-06","18","1973","0","144","17.6","16.6"
"White","2020-08-07","9","1982","3","147","21","18.7"
"White","2020-08-08","10","1992","2","149","18.5","18.6"
"White","2020-08-09","5","1997","0","149","16.6","15.8"
"White","2020-08-10","13","2010","2","151","17.1","15.9"
"White","2020-08-11","9","2019","1","152","12.9","16.2"
"White","2020-08-12","11","2030","2","154","14","16.7"
"White","2020-08-13","21","2051","1","155","14.7","16.1"
"White","2020-08-14","12","2063","3","158","13.5","17.3"
"White","2020-08-15","6","2069","0","158","10.6","14.6"
"White","2020-08-16","4","2073","0","158","10.6","13.6"
"White","2020-08-17","12","2085","1","159","9.6","13.3"
"White","2020-08-18","11","2096","2","161","10.6","11.8"
"White","2020-08-19","15","2111","1","162","9","11.5"
"White","2020-08-20","5","2116","0","162","8.3","11.5"
"White","2020-08-21","24","2140","0","162","4.7","9.1"
"White","2020-08-22","12","2152","0","162","4.7","7.7"
"White","2020-08-23","3","2155","0","162","4.7","7.7"
"White","2020-08-24","6","2161","1","163","5.9","7.8"
"White","2020-08-25","8","2169","0","163","3.3","7"
"White","2020-08-26","23","2192","1","164","3","6"
"White","2020-08-27","22","2214","2","166","4.3","6.3"
"White","2020-08-28","11","2225","0","166","4.3","4.5"
"White","2020-08-29","9","2234","1","167","5.9","5.3"
"White","2020-08-30","13","2247","2","169","8.1","6.4"
"White","2020-08-31","22","2269","3","172","7.7","6.8"
"White","2020-09-01","14","2283","3","175","10.7","7"
"White","2020-09-02","26","2309","2","177","11.2","7.1"
"White","2020-09-03","18","2327","1","178","10.7","7.5"
"White","2020-09-04","29","2356","1","179","11.2","7.7"
"White","2020-09-05","20","2376","3","182","11.7","8.8"
"White","2020-09-06","4","2380","1","183","13.1","10.6"
"White","2020-09-07","3","2383","0","183","11.2","9.4"
"White","2020-09-08","14","2397","2","185","10.1","10.4"
"White","2020-09-09","13","2410","4","189","13.4","12.3"
"White","2020-09-10","26","2436","3","192","14.3","12.5"
"White","2020-09-11","14","2450","0","192","13.8","12.5"
"White","2020-09-12","10","2460","3","195","15.9","13.8"
"White","2020-09-13","3","2463","0","195","12.4","12.7"
"White","2020-09-14","19","2482","2","197","13.9","12.5"
"White","2020-09-15","18","2500","3","200","14.2","12.2"
"White","2020-09-16","14","2514","0","200","9.8","11.6"
"White","2020-09-17","23","2537","1","201","8.8","11.5"
"White","2020-09-18","14","2551","0","201","8.8","11.3"
"White","2020-09-19","9","2560","0","201","4.5","10.2"
"White","2020-09-20","0","2560","0","201","4.5","8.4"
"White","2020-09-21","17","2577","2","203","4.7","9.3"
"White","2020-09-22","24","2601","3","206","4.1","9.2"
"White","2020-09-23","14","2615","1","207","5.1","7.5"
"White","2020-09-24","17","2632","0","207","4.5","6.6"
"White","2020-09-25","9","2641","1","208","6.1","7.4"
"White","2020-09-26","3","2644","0","208","6.1","5.3"
"White","2020-09-27","3","2647","1","209","10.8","7.7"
"White","2020-09-28","18","2665","2","211","10.7","7.7"
"White","2020-09-29","22","2687","1","212","9.6","6.8"
"White","2020-09-30","19","2706","2","214","10.1","7.6"
"White","2020-10-01","18","2724","1","215","10.9","7.7"
"White","2020-10-02","16","2740","0","215","9.3","7.7"
"White","2020-10-03","8","2748","2","217","12.9","9.5"
"White","2020-10-04","3","2751","2","219","17.6","14.2"
"White","2020-10-05","11","2762","1","220","17.3","14"
"White","2020-10-06","16","2778","1","221","17.6","13.6"
"White","2020-10-07","25","2803","2","223","17.2","13.7"
"White","2020-10-08","21","2824","4","227","19.2","15"
"White","2020-10-09","24","2848","1","228","19.7","14.5"
"White","2020-10-10","14","2862","1","229","17.2","15"
"White","2020-10-11","4","2866","0","229","7.7","12.7"
"White","2020-10-12","17","2883","0","229","6.4","11.9"
"White","2020-10-13","20","2903","2","231","6.9","12.2"
"White","2020-10-14","23","2926","0","231","5.8","11.5"
"White","2020-10-15","26","2952","0","231","3","11.1"
"White","2020-10-16","21","2973","0","231","2.4","11.1"
"White","2020-10-17","10","2983","3","234","5.7","11.5"
"White","2020-10-18","2","2985","1","235","12.9","10.3"
"White","2020-10-19","23","3008","0","235","12.9","9.6"
"White","2020-10-20","15","3023","0","235","11.4","9.2"
"White","2020-10-21","25","3048","1","236","12","8.9"
"White","2020-10-22","14","3062","0","236","12","7.5"
"White","2020-10-23","14","3076","0","236","12","7.2"
"White","2020-10-24","18","3094","0","236","7.7","6.7"
"White","2020-10-25","6","3100","1","237","3","7.9"
"White","2020-10-26","14","3114","0","237","3","7.9"
"White","2020-10-27","18","3132","3","240","5.3","8.4"
"White","2020-10-28","22","3154","0","240","4.8","8.4"
"White","2020-10-29","11","3165","0","240","4.8","8.4"
"White","2020-10-30","18","3183","1","241","5.6","8.8"
"White","2020-10-31","14","3197","9","250","14.7","11.2"
"White","2020-11-01","7","3204","1","251","14.4","8.7"
"White","2020-11-02","11","3215","1","252","15.7","9.3"
"White","2020-11-03","19","3234","0","252","13.3","9.3"
"White","2020-11-04","17","3251","0","252","13.3","9"
"White","2020-11-05","25","3276","5","257","16.2","10.5"
"White","2020-11-06","28","3304","5","262","17.9","11.7"
"White","2020-11-07","11","3315","4","266","13.9","14.3"
"White","2020-11-08","4","3319","3","269","22.6","18.5"
"White","2020-11-09","15","3334","1","270","22.3","19"
"White","2020-11-10","23","3357","3","273","24.1","18.7"
"White","2020-11-11","25","3382","6","279","27.6","20.4"
"White","2020-11-12","26","3408","6","285","28","22.1"
"White","2020-11-13","37","3445","8","293","28.5","23.2"
"White","2020-11-14","7","3452","0","293","23.3","18.6"
"White","2020-11-15","6","3458","1","294","15","18.8"
"White","2020-11-16","28","3486","5","299","16.6","19.4"
"White","2020-11-17","58","3544","7","306","16.5","20.3"
"White","2020-11-18","45","3589","3","309","14","20.8"
"White","2020-11-19","60","3649","11","320","13.3","20.7"
"White","2020-11-20","36","3685","4","324","11.8","20.2"
"White","2020-11-21","12","3697","4","328","16.6","20"
"White","2020-11-22","9","3706","3","331","19","17"
"White","2020-11-23","43","3749","11","342","20.1","18.3"
"White","2020-11-24","34","3783","5","347","20.4","18.5"
"White","2020-11-25","39","3822","7","354","22","18"
"White","2020-11-26","3","3825","1","355","24.2","18.8"
"White","2020-11-27","44","3869","6","361","24.6","18.2"
"White","2020-11-28","24","3893","8","369","24.6","20.6"
"White","2020-11-29","19","3912","5","374","23.6","21.3"
"White","2020-11-30","49","3961","9","383","22.5","21.3"
"White","2020-12-01","35","3996","5","388","22.5","21.4"
"White","2020-12-02","42","4038","5","393","21.6","21.8"
"White","2020-12-03","46","4084","9","402","19.6","21.9"
"White","2020-12-04","46","4130","10","412","20.8","22.7"
"White","2020-12-05","22","4152","5","417","19.3","21.9"
"White","2020-12-06","17","4169","5","422","19.7","21.6"
"White","2020-12-07","66","4235","15","437","20.3","21.4"
"White","2020-12-08","63","4298","11","448","20.8","21.6"
"White","2020-12-09","46","4344","10","458","22.2","21.9"
"White","2020-12-10","57","4401","12","470","22.4","21"
"White","2020-12-11","54","4455","7","477","21.2","21"
"White","2020-12-12","39","4494","15","492","23.4","21.3"
"White","2020-12-13","18","4512","5","497","23.2","21.4"
"White","2020-12-14","66","4578","13","510","22.7","21.5"
"White","2020-12-15","73","4651","14","524","23","21.9"
"White","2020-12-16","69","4720","13","537","22.6","22.4"
"White","2020-12-17","57","4777","10","547","22.1","22.2"
"White","2020-12-18","63","4840","17","564","24.1","22.6"
"White","2020-12-19","23","4863","11","575","25.4","24.4"
"White","2020-12-20","27","4890","10","585","26.7","24.9"
"White","2020-12-21","63","4953","12","597","26.6","24.7"
"White","2020-12-22","64","5017","15","612","27.2","25.1"
"White","2020-12-23","50","5067","12","624","28","25.3"
"White","2020-12-24","26","5093","7","631","29.3","25.7"
"White","2020-12-25","6","5099","2","633","30.2","27.1"
"White","2020-12-26","40","5139","14","647","28.4","26.9"
"White","2020-12-27","24","5163","4","651","25.5","26.1"
"White","2020-12-28","88","5251","21","672","26.2","26.4"
"White","2020-12-29","50","5301","15","687","27.1","27.2"
"White","2020-12-30","52","5353","17","704","28.4","28.2"
"White","2020-12-31","51","5404","19","723","29.8","29.6"
"White","2021-01-01","9","5413","2","725","28.2","29.2"
"White","2021-01-02","17","5430","6","731","28.3","28.3"
"White","2021-01-03","23","5453","9","740","31.5","28.5"
"White","2021-01-04","77","5530","23","763","32.4","29.3"
"White","2021-01-05","89","5619","24","787","31.9","29.5"
"White","2021-01-06","63","5682","15","802","30.6","29.5"
"White","2021-01-07","59","5741","15","817","29","29.4"
"White","2021-01-08","44","5785","10","827","29","28.6"
"White","2021-01-09","25","5810","7","834","28","28.1"
"White","2021-01-10","25","5835","8","842","27","29.2"
"White","2021-01-11","46","5881","11","853","26.1","29.2"
"White","2021-01-12","43","5924","10","863","25.6","28.8"
"White","2021-01-13","46","5970","11","874","25.6","28.1"
"White","2021-01-14","50","6020","11","885","25.1","27"
"White","2021-01-15","47","6067","16","901","26.7","27.9"
"White","2021-01-16","16","6083","5","906","27.2","27.6"
"White","2021-01-17","13","6096","2","908","24.8","25.9"
"White","2021-01-18","45","6141","7","915","23.6","24.9"
"White","2021-01-19","59","6200","12","927","23.2","24.4"
"White","2021-01-20","44","6244","10","937","23","24.3"
"White","2021-01-21","38","6282","8","945","22.9","24"
"White","2021-01-22","44","6326","12","957","21.9","24.3"
"White","2021-01-23","25","6351","6","963","20.9","24.1"
"White","2021-01-24","17","6368","3","966","21.2","23"
"White","2021-01-25","46","6414","8","974","21.5","22.6"
"White","2021-01-26","38","6452","6","980","20.8","22"
"White","2021-01-27","58","6510","14","994","21","22"
"White","2021-01-28","37","6547","4","998","19.6","21.2"
"White","2021-01-29","48","6595","7","1005","17.8","19.9"
"White","2021-01-30","10","6605","2","1007","17.2","19"
"White","2021-01-31","11","6616","3","1010","18.6","19.9"
"White","2021-02-01","45","6661","2","1012","16.7","19.1"
"White","2021-02-02","35","6696","6","1018","16.9","18.9"
"White","2021-02-03","47","6743","4","1022","14.7","17.9"
"White","2021-02-04","33","6776","5","1027","15.3","17.4"
"White","2021-02-05","28","6804","3","1030","14.7","16.3"
"White","2021-02-06","10","6814","1","1031","13.3","15.3"
"White","2021-02-07","1","6815","0","1031","9.4","14"
"White","2021-02-08","0","6815","0","1031","8.8","12.8"
"Whitfield","2020-02-01","0","0","0","0",".","."
"Whitfield","2020-02-02","0","0","0","0",".","."
"Whitfield","2020-02-03","0","0","0","0",".","."
"Whitfield","2020-02-04","0","0","0","0",".","."
"Whitfield","2020-02-05","0","0","0","0",".","."
"Whitfield","2020-02-06","0","0","0","0",".","."
"Whitfield","2020-02-07","0","0","0","0","0","."
"Whitfield","2020-02-08","0","0","0","0","0","."
"Whitfield","2020-02-09","0","0","0","0","0","."
"Whitfield","2020-02-10","0","0","0","0","0","."
"Whitfield","2020-02-11","0","0","0","0","0","."
"Whitfield","2020-02-12","0","0","0","0","0","."
"Whitfield","2020-02-13","0","0","0","0","0","."
"Whitfield","2020-02-14","0","0","0","0","0","0"
"Whitfield","2020-02-15","0","0","0","0","0","0"
"Whitfield","2020-02-16","0","0","0","0","0","0"
"Whitfield","2020-02-17","0","0","0","0","0","0"
"Whitfield","2020-02-18","0","0","0","0","0","0"
"Whitfield","2020-02-19","0","0","0","0","0","0"
"Whitfield","2020-02-20","0","0","0","0","0","0"
"Whitfield","2020-02-21","0","0","0","0","0","0"
"Whitfield","2020-02-22","0","0","0","0","0","0"
"Whitfield","2020-02-23","0","0","0","0","0","0"
"Whitfield","2020-02-24","0","0","0","0","0","0"
"Whitfield","2020-02-25","0","0","0","0","0","0"
"Whitfield","2020-02-26","0","0","0","0","0","0"
"Whitfield","2020-02-27","0","0","0","0","0","0"
"Whitfield","2020-02-28","0","0","0","0","0","0"
"Whitfield","2020-02-29","0","0","0","0","0","0"
"Whitfield","2020-03-01","0","0","0","0","0","0"
"Whitfield","2020-03-02","0","0","0","0","0","0"
"Whitfield","2020-03-03","0","0","0","0","0","0"
"Whitfield","2020-03-04","0","0","0","0","0","0"
"Whitfield","2020-03-05","0","0","0","0","0","0"
"Whitfield","2020-03-06","0","0","0","0","0","0"
"Whitfield","2020-03-07","0","0","0","0","0","0"
"Whitfield","2020-03-08","0","0","0","0","0","0"
"Whitfield","2020-03-09","0","0","0","0","0","0"
"Whitfield","2020-03-10","1","1","0","0","0","0"
"Whitfield","2020-03-11","1","2","0","0","0","0"
"Whitfield","2020-03-12","9","11","0","0","0","0"
"Whitfield","2020-03-13","24","35","0","0","0","0"
"Whitfield","2020-03-14","8","43","4","4","7.1","3.6"
"Whitfield","2020-03-15","5","48","1","5","10","5"
"Whitfield","2020-03-16","20","68","0","5","10","5"
"Whitfield","2020-03-17","10","78","1","6","11.4","5.7"
"Whitfield","2020-03-18","15","93","0","6","11.4","5.7"
"Whitfield","2020-03-19","24","117","5","11","14.4","7.2"
"Whitfield","2020-03-20","19","136","4","15","17.4","8.7"
"Whitfield","2020-03-21","8","144","1","16","12.1","9.6"
"Whitfield","2020-03-22","9","153","0","16","9.2","9.6"
"Whitfield","2020-03-23","14","167","0","16","9.2","9.6"
"Whitfield","2020-03-24","15","182","5","21","12.5","12"
"Whitfield","2020-03-25","58","240","0","21","12.5","12"
"Whitfield","2020-03-26","12","252","1","22","10.7","12.6"
"Whitfield","2020-03-27","25","277","1","23","8.3","12.9"
"Whitfield","2020-03-28","5","282","4","27","18","15"
"Whitfield","2020-03-29","4","286","0","27","18","13.6"
"Whitfield","2020-03-30","26","312","2","29","19.1","14.1"
"Whitfield","2020-03-31","11","323","0","29","14.3","13.4"
"Whitfield","2020-04-01","43","366","5","34","16","14.2"
"Whitfield","2020-04-02","9","375","0","34","14.8","12.8"
"Whitfield","2020-04-03","49","424","8","42","16.5","12.4"
"Whitfield","2020-04-04","14","438","1","43","6.1","12"
"Whitfield","2020-04-05","6","444","0","43","6.1","12"
"Whitfield","2020-04-06","91","535","10","53","6.6","12.8"
"Whitfield","2020-04-07","73","608","14","67","9.3","11.8"
"Whitfield","2020-04-08","67","675","2","69","8.1","12"
"Whitfield","2020-04-09","20","695","3","72","10.2","12.5"
"Whitfield","2020-04-10","26","721","5","77","10.6","13.6"
"Whitfield","2020-04-11","9","730","2","79","12.8","9.5"
"Whitfield","2020-04-12","5","735","1","80","15.7","10.9"
"Whitfield","2020-04-13","29","764","6","86","17","11.8"
"Whitfield","2020-04-14","19","783","1","87","15.1","12.2"
"Whitfield","2020-04-15","79","862","11","98","16.6","12.4"
"Whitfield","2020-04-16","55","917","4","102","15.5","12.9"
"Whitfield","2020-04-17","80","997","1","103","12.9","11.8"
"Whitfield","2020-04-18","17","1014","0","103","9.8","11.3"
"Whitfield","2020-04-19","14","1028","4","107","11","13.3"
"Whitfield","2020-04-20","126","1154","13","120","9.5","13.3"
"Whitfield","2020-04-21","68","1222","8","128","10.4","12.7"
"Whitfield","2020-04-22","55","1277","6","134","10","13.3"
"Whitfield","2020-04-23","62","1339","9","143","11","13.3"
"Whitfield","2020-04-24","98","1437","5","148","11.6","12.3"
"Whitfield","2020-04-25","22","1459","2","150","12.9","11.3"
"Whitfield","2020-04-26","17","1476","1","151","9.7","10.3"
"Whitfield","2020-04-27","110","1586","11","162","9.6","9.6"
"Whitfield","2020-04-28","109","1695","10","172","9.2","9.8"
"Whitfield","2020-04-29","81","1776","7","179","8.9","9.5"
"Whitfield","2020-04-30","179","1955","6","185","7.3","9.2"
"Whitfield","2020-05-01","48","2003","10","195","9.6","10.6"
"Whitfield","2020-05-02","12","2015","0","195","8.3","10.6"
"Whitfield","2020-05-03","6","2021","1","196","9.8","9.7"
"Whitfield","2020-05-04","71","2092","4","200","9.2","9.4"
"Whitfield","2020-05-05","78","2170","2","202","8.2","8.7"
"Whitfield","2020-05-06","188","2358","14","216","8.1","8.5"
"Whitfield","2020-05-07","182","2540","24","240","9.5","8.4"
"Whitfield","2020-05-08","231","2771","9","249","7.1","8.3"
"Whitfield","2020-05-09","87","2858","1","250","7.2","7.7"
"Whitfield","2020-05-10","48","2906","0","250","4.8","7.3"
"Whitfield","2020-05-11","262","3168","10","260","4.6","6.9"
"Whitfield","2020-05-12","141","3309","5","265","4.7","6.5"
"Whitfield","2020-05-13","126","3435","4","269","4.1","6.1"
"Whitfield","2020-05-14","157","3592","4","273","2.6","6"
"Whitfield","2020-05-15","125","3717","11","284","3.3","5.2"
"Whitfield","2020-05-16","103","3820","12","296","4.8","6"
"Whitfield","2020-05-17","63","3883","12","308","7.5","6.2"
"Whitfield","2020-05-18","148","4031","20","328","8.9","6.7"
"Whitfield","2020-05-19","127","4158","23","351","11","7.8"
"Whitfield","2020-05-20","108","4266","7","358","11.5","7.8"
"Whitfield","2020-05-21","150","4416","6","364","11.7","7.1"
"Whitfield","2020-05-22","85","4501","6","370","11.4","7.3"
"Whitfield","2020-05-23","95","4596","20","390","12.8","8.8"
"Whitfield","2020-05-24","17","4613","8","398","16.8","12.1"
"Whitfield","2020-05-25","34","4647","1","399","15.2","12.1"
"Whitfield","2020-05-26","271","4918","31","430","14.3","12.6"
"Whitfield","2020-05-27","244","5162","18","448","14.4","12.9"
"Whitfield","2020-05-28","228","5390","23","471","15.3","13.5"
"Whitfield","2020-05-29","254","5644","26","497","15.7","13.6"
"Whitfield","2020-05-30","33","5677","4","501","14.5","13.6"
"Whitfield","2020-05-31","11","5688","1","502","9","12.9"
"Whitfield","2020-06-01","367","6055","28","530","9.7","12.5"
"Whitfield","2020-06-02","250","6305","35","565","10.1","12.2"
"Whitfield","2020-06-03","243","6548","27","592","10.6","12.5"
"Whitfield","2020-06-04","244","6792","17","609","10.2","12.7"
"Whitfield","2020-06-05","184","6976","30","639","11","13.4"
"Whitfield","2020-06-06","42","7018","4","643","10.7","12.6"
"Whitfield","2020-06-07","25","7043","3","646","11.1","10.1"
"Whitfield","2020-06-08","411","7454","30","676","11","10.4"
"Whitfield","2020-06-09","314","7768","35","711","10.6","10.3"
"Whitfield","2020-06-10","198","7966","34","745","11.5","11"
"Whitfield","2020-06-11","380","8346","25","770","11.4","10.8"
"Whitfield","2020-06-12","243","8589","29","799","10.8","10.9"
"Whitfield","2020-06-13","105","8694","31","830","13.7","12.2"
"Whitfield","2020-06-14","74","8768","12","842","14.3","12.7"
"Whitfield","2020-06-15","232","9000","38","880","15.6","13.3"
"Whitfield","2020-06-16","207","9207","19","899","15.3","13"
"Whitfield","2020-06-17","204","9411","34","933","15.2","13.3"
"Whitfield","2020-06-18","255","9666","43","976","16.7","14.1"
"Whitfield","2020-06-19","368","10034","33","1009","16.3","13.5"
"Whitfield","2020-06-20","153","10187","27","1036","14.6","14.1"
"Whitfield","2020-06-21","31","10218","8","1044","15.9","15.1"
"Whitfield","2020-06-22","290","10508","74","1118","17.2","16.4"
"Whitfield","2020-06-23","391","10899","55","1173","17.9","16.6"
"Whitfield","2020-06-24","335","11234","54","1227","17.9","16.5"
"Whitfield","2020-06-25","434","11668","77","1304","18","17.3"
"Whitfield","2020-06-26","412","12080","70","1374","19.1","17.7"
"Whitfield","2020-06-27","500","12580","98","1472","19.4","17"
"Whitfield","2020-06-28","60","12640","12","1484","18.6","17.3"
"Whitfield","2020-06-29","363","13003","65","1549","17.5","17.4"
"Whitfield","2020-06-30","426","13429","101","1650","18.9","18.4"
"Whitfield","2020-07-01","529","13958","116","1766","19.7","18.8"
"Whitfield","2020-07-02","756","14714","124","1890","19.5","18.7"
"Whitfield","2020-07-03","267","14981","86","1976","21.7","20.4"
"Whitfield","2020-07-04","46","15027","15","1991","23.5","21.5"
"Whitfield","2020-07-05","96","15123","46","2037","27.5","23.1"
"Whitfield","2020-07-06","810","15933","180","2217","28.1","22.8"
"Whitfield","2020-07-07","544","16477","105","2322","27.5","23.2"
"Whitfield","2020-07-08","605","17082","123","2445","27.3","23.5"
"Whitfield","2020-07-09","863","17945","128","2573","27.1","23.3"
"Whitfield","2020-07-10","693","18638","108","2681","24.7","23.2"
"Whitfield","2020-07-11","741","19379","126","2807","22.5","23"
"Whitfield","2020-07-12","69","19448","21","2828","20","23.7"
"Whitfield","2020-07-13","717","20165","161","2989","20","24.1"
"Whitfield","2020-07-14","482","20647","100","3089","20.2","23.9"
"Whitfield","2020-07-15","662","21309","94","3183","19.3","23.3"
"Whitfield","2020-07-16","827","22136","150","3333","19.8","23.4"
"Whitfield","2020-07-17","224","22360","45","3378","20.4","22.6"
"Whitfield","2020-07-18","246","22606","53","3431","21.1","21.8"
"Whitfield","2020-07-19","294","22900","44","3475","18.9","19.4"
"Whitfield","2020-07-20","534","23434","98","3573","18.3","19.1"
"Whitfield","2020-07-21","554","23988","82","3655","17.4","18.8"
"Whitfield","2020-07-22","751","24739","90","3745","17.1","18.2"
"Whitfield","2020-07-23","705","25444","92","3837","16.4","18.1"
"Whitfield","2020-07-24","577","26021","102","3939","16.1","18.2"
"Whitfield","2020-07-25","533","26554","95","4034","15.5","18.3"
"Whitfield","2020-07-26","125","26679","30","4064","16.8","17.8"
"Whitfield","2020-07-27","548","27227","99","4163","16.8","17.5"
"Whitfield","2020-07-28","488","27715","74","4237","16.8","17.1"
"Whitfield","2020-07-29","516","28231","65","4302","16.9","17"
"Whitfield","2020-07-30","406","28637","52","4354","16.9","16.6"
"Whitfield","2020-07-31","431","29068","48","4402","15.9","16"
"Whitfield","2020-08-01","278","29346","40","4442","15.5","15.5"
"Whitfield","2020-08-02","62","29408","16","4458","15.7","16.3"
"Whitfield","2020-08-03","329","29737","32","4490","14.5","15.6"
"Whitfield","2020-08-04","459","30196","48","4538","13.8","15.3"
"Whitfield","2020-08-05","445","30641","50","4588","13.7","15.3"
"Whitfield","2020-08-06","310","30951","49","4637","14.1","15.5"
"Whitfield","2020-08-07","534","31485","37","4674","13.5","14.7"
"Whitfield","2020-08-08","207","31692","27","4701","13.3","14.4"
"Whitfield","2020-08-09","64","31756","17","4718","13.4","14.6"
"Whitfield","2020-08-10","290","32046","43","4761","14.1","14.3"
"Whitfield","2020-08-11","555","32601","34","4795","13.5","13.7"
"Whitfield","2020-08-12","337","32938","31","4826","13.2","13.4"
"Whitfield","2020-08-13","248","33186","27","4853","12.5","13.3"
"Whitfield","2020-08-14","496","33682","18","4871","12","12.8"
"Whitfield","2020-08-15","76","33758","11","4882","12.2","12.8"
"Whitfield","2020-08-16","60","33818","5","4887","9.6","11.5"
"Whitfield","2020-08-17","108","33926","18","4905","9.9","12"
"Whitfield","2020-08-18","425","34351","26","4931","9.9","11.7"
"Whitfield","2020-08-19","269","34620","17","4948","9.5","11.4"
"Whitfield","2020-08-20","227","34847","15","4963","8.9","10.7"
"Whitfield","2020-08-21","273","35120","29","4992","9.9","11"
"Whitfield","2020-08-22","84","35204","15","5007","10.4","11.3"
"Whitfield","2020-08-23","55","35259","5","5012","10.5","10.1"
"Whitfield","2020-08-24","378","35637","35","5047","9.4","9.7"
"Whitfield","2020-08-25","387","36024","24","5071","9.4","9.7"
"Whitfield","2020-08-26","225","36249","26","5097","10.2","9.8"
"Whitfield","2020-08-27","251","36500","33","5130","11.1","10"
"Whitfield","2020-08-28","330","36830","28","5158","10.8","10.3"
"Whitfield","2020-08-29","69","36899","9","5167","10.1","10.2"
"Whitfield","2020-08-30","55","36954","6","5173","10.4","10.4"
"Whitfield","2020-08-31","373","37327","38","5211","10.5","10"
"Whitfield","2020-09-01","371","37698","25","5236","10.6","10"
"Whitfield","2020-09-02","377","38075","22","5258","9.8","10"
"Whitfield","2020-09-03","226","38301","25","5283","9.5","10.3"
"Whitfield","2020-09-04","280","38581","34","5317","10","10.4"
"Whitfield","2020-09-05","113","38694","14","5331","9.9","10"
"Whitfield","2020-09-06","90","38784","9","5340","9.8","10.1"
"Whitfield","2020-09-07","48","38832","8","5348","10.7","10.6"
"Whitfield","2020-09-08","336","39168","37","5385","11.3","10.9"
"Whitfield","2020-09-09","355","39523","43","5428","12.2","11"
"Whitfield","2020-09-10","281","39804","21","5449","11.7","10.6"
"Whitfield","2020-09-11","378","40182","17","5466","10.6","10.3"
"Whitfield","2020-09-12","78","40260","12","5478","11","10.5"
"Whitfield","2020-09-13","93","40353","14","5492","11.7","10.8"
"Whitfield","2020-09-14","371","40724","46","5538","11.1","10.9"
"Whitfield","2020-09-15","240","40964","22","5560","10.9","11.1"
"Whitfield","2020-09-16","311","41275","25","5585","10.3","11.2"
"Whitfield","2020-09-17","359","41634","29","5614","10.4","11"
"Whitfield","2020-09-18","329","41963","16","5630","10.4","10.5"
"Whitfield","2020-09-19","68","42031","8","5638","9.9","10.5"
"Whitfield","2020-09-20","96","42127","12","5650","9.5","10.6"
"Whitfield","2020-09-21","333","42460","33","5683","9.2","10.2"
"Whitfield","2020-09-22","384","42844","19","5702","8.6","9.7"
"Whitfield","2020-09-23","298","43142","27","5729","8.7","9.5"
"Whitfield","2020-09-24","418","43560","22","5751","8.3","9.4"
"Whitfield","2020-09-25","341","43901","28","5779","8.8","9.6"
"Whitfield","2020-09-26","73","43974","7","5786","8.5","9.2"
"Whitfield","2020-09-27","81","44055","12","5798","8.8","9.2"
"Whitfield","2020-09-28","298","44353","32","5830","8.9","9.1"
"Whitfield","2020-09-29","314","44667","22","5852","9.2","8.9"
"Whitfield","2020-09-30","331","44998","20","5872","8.8","8.8"
"Whitfield","2020-10-01","320","45318","12","5884","8.6","8.5"
"Whitfield","2020-10-02","377","45695","20","5904","8.2","8.5"
"Whitfield","2020-10-03","30","45725","5","5909","9.2","8.8"
"Whitfield","2020-10-04","37","45762","7","5916","9.8","9.3"
"Whitfield","2020-10-05","293","46055","29","5945","9.7","9.3"
"Whitfield","2020-10-06","393","46448","26","5971","9.6","9.4"
"Whitfield","2020-10-07","223","46671","15","5986","9.7","9.3"
"Whitfield","2020-10-08","315","46986","18","6004","10","9.3"
"Whitfield","2020-10-09","320","47306","25","6029","10.3","9.3"
"Whitfield","2020-10-10","64","47370","4","6033","8.8","9"
"Whitfield","2020-10-11","30","47400","4","6037","8","8.9"
"Whitfield","2020-10-12","82","47482","18","6055","9.8","9.7"
"Whitfield","2020-10-13","310","47792","39","6094","10.6","10.1"
"Whitfield","2020-10-14","238","48030","21","6115","10.9","10.3"
"Whitfield","2020-10-15","244","48274","28","6143","11.7","10.9"
"Whitfield","2020-10-16","320","48594","27","6170","11.8","11.1"
"Whitfield","2020-10-17","25","48619","2","6172","12.1","10.5"
"Whitfield","2020-10-18","43","48662","7","6179","12.5","10.3"
"Whitfield","2020-10-19","331","48993","45","6224","11.3","10.5"
"Whitfield","2020-10-20","248","49241","41","6265","11.9","11.3"
"Whitfield","2020-10-21","292","49533","47","6312","12.9","11.9"
"Whitfield","2020-10-22","299","49832","28","6340","12.6","12.2"
"Whitfield","2020-10-23","468","50300","33","6373","12.4","12.1"
"Whitfield","2020-10-24","146","50446","36","6409","14.8","13.4"
"Whitfield","2020-10-25","78","50524","21","6430","16.3","14.4"
"Whitfield","2020-10-26","490","51014","58","6488","16.1","13.7"
"Whitfield","2020-10-27","415","51429","48","6536","15.4","13.6"
"Whitfield","2020-10-28","394","51823","57","6593","15.1","14"
"Whitfield","2020-10-29","137","51960","24","6617","16.3","14.5"
"Whitfield","2020-10-30","682","52642","61","6678","16.6","14.5"
"Whitfield","2020-10-31","133","52775","22","6700","15.4","15.1"
"Whitfield","2020-11-01","136","52911","18","6718","13.4","14.9"
"Whitfield","2020-11-02","474","53385","100","6818","14.8","15.4"
"Whitfield","2020-11-03","413","53798","45","6863","14.7","15"
"Whitfield","2020-11-04","455","54253","61","6924","14.5","14.8"
"Whitfield","2020-11-05","563","54816","52","6976","13.3","14.8"
"Whitfield","2020-11-06","521","55337","44","7020","13.3","14.9"
"Whitfield","2020-11-07","199","55536","38","7058","13.6","14.5"
"Whitfield","2020-11-08","132","55668","26","7084","14.6","14"
"Whitfield","2020-11-09","689","56357","109","7193","13.8","14.3"
"Whitfield","2020-11-10","447","56804","50","7243","13.8","14.3"
"Whitfield","2020-11-11","375","57179","63","7306","14.3","14.4"
"Whitfield","2020-11-12","883","58062","87","7393","14.4","13.9"
"Whitfield","2020-11-13","703","58765","73","7466","14.7","14"
"Whitfield","2020-11-14","188","58953","22","7488","13.6","13.6"
"Whitfield","2020-11-15","135","59088","23","7511","13.3","13.9"
"Whitfield","2020-11-16","554","59642","79","7590","13","13.4"
"Whitfield","2020-11-17","540","60182","82","7672","13.6","13.7"
"Whitfield","2020-11-18","764","60946","79","7751","12.7","13.5"
"Whitfield","2020-11-19","798","61744","108","7859","13.2","13.8"
"Whitfield","2020-11-20","734","62478","61","7920","12.9","13.8"
"Whitfield","2020-11-21","290","62768","30","7950","12.7","13.2"
"Whitfield","2020-11-22","131","62899","19","7969","12.4","12.8"
"Whitfield","2020-11-23","516","63415","89","8058","12.8","12.9"
"Whitfield","2020-11-24","547","63962","68","8126","12.4","13"
"Whitfield","2020-11-25","687","64649","67","8193","12.3","12.5"
"Whitfield","2020-11-26","48","64697","8","8201","12.8","13"
"Whitfield","2020-11-27","137","64834","38","8239","15.5","14.2"
"Whitfield","2020-11-28","92","64926","23","8262","17.6","15.2"
"Whitfield","2020-11-29","111","65037","33","8295","19.8","16.1"
"Whitfield","2020-11-30","715","65752","130","8425","19.9","16.4"
"Whitfield","2020-12-01","657","66409","127","8552","20.9","16.7"
"Whitfield","2020-12-02","770","67179","130","8682","21.9","17.1"
"Whitfield","2020-12-03","665","67844","113","8795","22","17.4"
"Whitfield","2020-12-04","460","68304","47","8842","19.5","17.5"
"Whitfield","2020-12-05","269","68573","49","8891","18.5","18.1"
"Whitfield","2020-12-06","182","68755","51","8942","18.3","19"
"Whitfield","2020-12-07","623","69378","112","9054","18.2","19.1"
"Whitfield","2020-12-08","644","70022","107","9161","17.8","19.4"
"Whitfield","2020-12-09","691","70713","113","9274","17.8","19.9"
"Whitfield","2020-12-10","757","71470","132","9406","17.8","19.9"
"Whitfield","2020-12-11","488","71958","99","9505","19.3","19.4"
"Whitfield","2020-12-12","179","72137","47","9552","20.4","19.5"
"Whitfield","2020-12-13","167","72304","46","9598","20.4","19.3"
"Whitfield","2020-12-14","670","72974","114","9712","20.2","19.2"
"Whitfield","2020-12-15","604","73578","131","9843","20.9","19.4"
"Whitfield","2020-12-16","844","74422","143","9986","21","19.4"
"Whitfield","2020-12-17","815","75237","148","10134","21.1","19.5"
"Whitfield","2020-12-18","433","75670","57","10191","20.1","19.7"
"Whitfield","2020-12-19","249","75919","40","10231","18.7","19.5"
"Whitfield","2020-12-20","199","76118","50","10281","18.3","19.3"
"Whitfield","2020-12-21","631","76749","102","10383","18.2","19.2"
"Whitfield","2020-12-22","788","77537","117","10500","17.2","19.1"
"Whitfield","2020-12-23","685","78222","117","10617","17.2","19.1"
"Whitfield","2020-12-24","143","78365","42","10659","18.8","20"
"Whitfield","2020-12-25","46","78411","7","10666","19.1","19.6"
"Whitfield","2020-12-26","112","78523","36","10702","21.4","20"
"Whitfield","2020-12-27","223","78746","60","10762","21.7","20"
"Whitfield","2020-12-28","724","79470","160","10922","22.5","20.4"
"Whitfield","2020-12-29","788","80258","184","11106","23.7","20.5"
"Whitfield","2020-12-30","786","81044","122","11228","23.5","20.4"
"Whitfield","2020-12-31","421","81465","77","11305","21.9","20.4"
"Whitfield","2021-01-01","65","81530","19","11324","23.9","21.5"
"Whitfield","2021-01-02","88","81618","28","11352","23.9","22.7"
"Whitfield","2021-01-03","85","81703","29","11381","24.9","23.3"
"Whitfield","2021-01-04","417","82120","97","11478","25.1","23.8"
"Whitfield","2021-01-05","886","83006","212","11690","25.2","24.5"
"Whitfield","2021-01-06","844","83850","124","11814","25","24.3"
"Whitfield","2021-01-07","498","84348","108","11922","25.5","23.7"
"Whitfield","2021-01-08","459","84807","92","12014","24.2","24.1"
"Whitfield","2021-01-09","256","85063","66","12080","23.4","23.6"
"Whitfield","2021-01-10","250","85313","78","12158","22.9","23.9"
"Whitfield","2021-01-11","530","85843","97","12255","22.2","23.7"
"Whitfield","2021-01-12","411","86254","75","12330","21.4","23.3"
"Whitfield","2021-01-13","646","86900","73","12403","20.9","23"
"Whitfield","2021-01-14","383","87283","58","12461","20","22.8"
"Whitfield","2021-01-15","280","87563","56","12517","20","22.1"
"Whitfield","2021-01-16","122","87685","34","12551","20.3","21.8"
"Whitfield","2021-01-17","108","87793","39","12590","21","22"
"Whitfield","2021-01-18","396","88189","85","12675","21.4","21.8"
"Whitfield","2021-01-19","433","88622","61","12736","20.9","21.1"
"Whitfield","2021-01-20","592","89214","73","12809","21","21"
"Whitfield","2021-01-21","271","89485","39","12848","20.9","20.4"
"Whitfield","2021-01-22","238","89723","51","12899","21.1","20.5"
"Whitfield","2021-01-23","102","89825","14","12913","19.1","19.7"
"Whitfield","2021-01-24","80","89905","20","12933","17.5","19.2"
"Whitfield","2021-01-25","358","90263","64","12997","17","19.2"
"Whitfield","2021-01-26","273","90536","34","13031","16.7","18.8"
"Whitfield","2021-01-27","572","91108","86","13117","17.1","19.1"
"Whitfield","2021-01-28","267","91375","40","13157","17.2","19.1"
"Whitfield","2021-01-29","225","91600","57","13214","17.8","19.4"
"Whitfield","2021-01-30","69","91669","14","13228","18.7","18.9"
"Whitfield","2021-01-31","71","91740","15","13243","18.2","17.8"
"Whitfield","2021-02-01","341","92081","55","13298","17.9","17.4"
"Whitfield","2021-02-02","314","92395","37","13335","17.8","17.3"
"Whitfield","2021-02-03","420","92815","27","13362","16.6","16.9"
"Whitfield","2021-02-04","253","93068","33","13395","16.3","16.8"
"Whitfield","2021-02-05","172","93240","22","13417","14.5","16.1"
"Whitfield","2021-02-06","21","93261","2","13419","13","15.8"
"Whitfield","2021-02-07","5","93266","1","13420","12.8","15.5"
"Whitfield","2021-02-08","0","93266","0","13420","10.5","14.2"
"Wilcox","2020-02-01","0","0","0","0",".","."
"Wilcox","2020-02-02","0","0","0","0",".","."
"Wilcox","2020-02-03","0","0","0","0",".","."
"Wilcox","2020-02-04","0","0","0","0",".","."
"Wilcox","2020-02-05","0","0","0","0",".","."
"Wilcox","2020-02-06","0","0","0","0",".","."
"Wilcox","2020-02-07","0","0","0","0","0","."
"Wilcox","2020-02-08","0","0","0","0","0","."
"Wilcox","2020-02-09","0","0","0","0","0","."
"Wilcox","2020-02-10","0","0","0","0","0","."
"Wilcox","2020-02-11","0","0","0","0","0","."
"Wilcox","2020-02-12","0","0","0","0","0","."
"Wilcox","2020-02-13","0","0","0","0","0","."
"Wilcox","2020-02-14","0","0","0","0","0","0"
"Wilcox","2020-02-15","0","0","0","0","0","0"
"Wilcox","2020-02-16","0","0","0","0","0","0"
"Wilcox","2020-02-17","0","0","0","0","0","0"
"Wilcox","2020-02-18","0","0","0","0","0","0"
"Wilcox","2020-02-19","0","0","0","0","0","0"
"Wilcox","2020-02-20","0","0","0","0","0","0"
"Wilcox","2020-02-21","0","0","0","0","0","0"
"Wilcox","2020-02-22","0","0","0","0","0","0"
"Wilcox","2020-02-23","0","0","0","0","0","0"
"Wilcox","2020-02-24","0","0","0","0","0","0"
"Wilcox","2020-02-25","0","0","0","0","0","0"
"Wilcox","2020-02-26","0","0","0","0","0","0"
"Wilcox","2020-02-27","0","0","0","0","0","0"
"Wilcox","2020-02-28","0","0","0","0","0","0"
"Wilcox","2020-02-29","0","0","0","0","0","0"
"Wilcox","2020-03-01","0","0","0","0","0","0"
"Wilcox","2020-03-02","0","0","0","0","0","0"
"Wilcox","2020-03-03","0","0","0","0","0","0"
"Wilcox","2020-03-04","0","0","0","0","0","0"
"Wilcox","2020-03-05","0","0","0","0","0","0"
"Wilcox","2020-03-06","0","0","0","0","0","0"
"Wilcox","2020-03-07","0","0","0","0","0","0"
"Wilcox","2020-03-08","0","0","0","0","0","0"
"Wilcox","2020-03-09","0","0","0","0","0","0"
"Wilcox","2020-03-10","0","0","0","0","0","0"
"Wilcox","2020-03-11","0","0","0","0","0","0"
"Wilcox","2020-03-12","0","0","0","0","0","0"
"Wilcox","2020-03-13","0","0","0","0","0","0"
"Wilcox","2020-03-14","0","0","0","0","0","0"
"Wilcox","2020-03-15","0","0","0","0","0","0"
"Wilcox","2020-03-16","0","0","0","0","0","0"
"Wilcox","2020-03-17","1","1","0","0","0","0"
"Wilcox","2020-03-18","0","1","0","0","0","0"
"Wilcox","2020-03-19","2","3","0","0","0","0"
"Wilcox","2020-03-20","0","3","0","0","0","0"
"Wilcox","2020-03-21","0","3","0","0","0","0"
"Wilcox","2020-03-22","0","3","0","0","0","0"
"Wilcox","2020-03-23","3","6","0","0","0","0"
"Wilcox","2020-03-24","2","8","0","0","0","0"
"Wilcox","2020-03-25","1","9","0","0","0","0"
"Wilcox","2020-03-26","1","10","1","1","14.3","7.1"
"Wilcox","2020-03-27","1","11","0","1","14.3","7.1"
"Wilcox","2020-03-28","0","11","0","1","14.3","7.1"
"Wilcox","2020-03-29","1","12","0","1","14.3","7.1"
"Wilcox","2020-03-30","2","14","0","1","14.3","7.1"
"Wilcox","2020-03-31","1","15","0","1","14.3","7.1"
"Wilcox","2020-04-01","2","17","2","3","28.6","14.3"
"Wilcox","2020-04-02","1","18","0","3","14.3","14.3"
"Wilcox","2020-04-03","2","20","0","3","14.3","14.3"
"Wilcox","2020-04-04","0","20","0","3","14.3","14.3"
"Wilcox","2020-04-05","0","20","0","3","14.3","14.3"
"Wilcox","2020-04-06","4","24","3","6","25","19.6"
"Wilcox","2020-04-07","1","25","0","6","25","19.6"
"Wilcox","2020-04-08","3","28","1","7","15.5","22"
"Wilcox","2020-04-09","20","48","9","16","21.9","18.1"
"Wilcox","2020-04-10","4","52","4","20","36.2","25.2"
"Wilcox","2020-04-11","3","55","2","22","45.7","30"
"Wilcox","2020-04-12","11","66","11","33","60","37.1"
"Wilcox","2020-04-13","16","82","11","44","59.1","42.1"
"Wilcox","2020-04-14","6","88","2","46","63.9","44.4"
"Wilcox","2020-04-15","6","94","3","49","66.3","40.9"
"Wilcox","2020-04-16","2","96","0","49","59.8","40.9"
"Wilcox","2020-04-17","10","106","6","55","54.1","45.1"
"Wilcox","2020-04-18","6","112","3","58","51.7","48.7"
"Wilcox","2020-04-19","0","112","0","58","37.4","48.7"
"Wilcox","2020-04-20","5","117","1","59","30.5","44.8"
"Wilcox","2020-04-21","6","123","2","61","30.5","47.2"
"Wilcox","2020-04-22","23","146","14","75","32","49.1"
"Wilcox","2020-04-23","15","161","13","88","44.4","52.1"
"Wilcox","2020-04-24","1","162","0","88","35.8","45"
"Wilcox","2020-04-25","2","164","0","88","28.7","40.2"
"Wilcox","2020-04-26","65","229","1","89","28.9","33.2"
"Wilcox","2020-04-27","66","295","1","90","26.3","28.4"
"Wilcox","2020-04-28","6","301","1","91","23.9","27.2"
"Wilcox","2020-04-29","3","304","0","91","15.2","23.6"
"Wilcox","2020-04-30","0","304","0","91","2.8","23.6"
"Wilcox","2020-05-01","6","310","0","91","2.8","19.3"
"Wilcox","2020-05-02","0","310","0","91","2.8","15.8"
"Wilcox","2020-05-03","1","311","0","91","2.6","15.8"
"Wilcox","2020-05-04","6","317","0","91","2.4","14.3"
"Wilcox","2020-05-05","5","322","0","91","0","11.9"
"Wilcox","2020-05-06","5","327","0","91","0","7.6"
"Wilcox","2020-05-07","3","330","0","91","0","1.4"
"Wilcox","2020-05-08","5","335","0","91","0","1.4"
"Wilcox","2020-05-09","1","336","0","91","0","1.4"
"Wilcox","2020-05-10","0","336","0","91","0","1.3"
"Wilcox","2020-05-11","91","427","5","96","0.8","1.6"
"Wilcox","2020-05-12","1","428","0","96","0.8","0.4"
"Wilcox","2020-05-13","2","430","0","96","0.8","0.4"
"Wilcox","2020-05-14","3","433","0","96","0.8","0.4"
"Wilcox","2020-05-15","5","438","0","96","0.8","0.4"
"Wilcox","2020-05-16","34","472","2","98","1.6","0.8"
"Wilcox","2020-05-17","2","474","0","98","1.6","0.8"
"Wilcox","2020-05-18","88","562","4","102","1.5","1.1"
"Wilcox","2020-05-19","7","569","2","104","5.6","3.2"
"Wilcox","2020-05-20","8","577","0","104","5.6","3.2"
"Wilcox","2020-05-21","6","583","2","106","10.3","5.6"
"Wilcox","2020-05-22","4","587","1","107","13.9","7.3"
"Wilcox","2020-05-23","1","588","1","108","27.4","14.5"
"Wilcox","2020-05-24","2","590","1","109","34.5","18.1"
"Wilcox","2020-05-25","1","591","0","109","33.8","17.7"
"Wilcox","2020-05-26","12","603","2","111","32.1","18.9"
"Wilcox","2020-05-27","4","607","0","111","32.1","18.9"
"Wilcox","2020-05-28","8","615","1","112","29.2","19.7"
"Wilcox","2020-05-29","15","630","1","113","26.5","20.2"
"Wilcox","2020-05-30","0","630","0","113","12.3","19.8"
"Wilcox","2020-05-31","2","632","0","113","5.1","19.8"
"Wilcox","2020-06-01","3","635","0","113","5.1","19.5"
"Wilcox","2020-06-02","2","637","1","114","9.9","21"
"Wilcox","2020-06-03","4","641","0","114","9.9","21"
"Wilcox","2020-06-04","2","643","0","114","8.1","18.6"
"Wilcox","2020-06-05","2","645","0","114","7.1","16.8"
"Wilcox","2020-06-06","4","649","1","115","10.7","11.5"
"Wilcox","2020-06-07","1","650","0","115","10.7","7.9"
"Wilcox","2020-06-08","5","655","0","115","10.7","7.9"
"Wilcox","2020-06-09","4","659","2","117","10.7","10.3"
"Wilcox","2020-06-10","7","666","1","118","12.8","11.3"
"Wilcox","2020-06-11","8","674","1","119","14.5","11.3"
"Wilcox","2020-06-12","7","681","1","120","16.6","11.9"
"Wilcox","2020-06-13","2","683","0","120","13","11.9"
"Wilcox","2020-06-14","2","685","2","122","27.3","19"
"Wilcox","2020-06-15","3","688","0","122","27.3","19"
"Wilcox","2020-06-16","10","698","0","122","20.2","15.4"
"Wilcox","2020-06-17","18","716","0","122","18.1","15.4"
"Wilcox","2020-06-18","6","722","3","125","23.5","19"
"Wilcox","2020-06-19","4","726","0","125","21.4","19"
"Wilcox","2020-06-20","5","731","1","126","24.3","18.6"
"Wilcox","2020-06-21","7","738","0","126","10","18.6"
"Wilcox","2020-06-22","6","744","0","126","10","18.6"
"Wilcox","2020-06-23","3","747","1","127","14.8","17.5"
"Wilcox","2020-06-24","35","782","0","127","14.8","16.4"
"Wilcox","2020-06-25","8","790","0","127","7.6","15.5"
"Wilcox","2020-06-26","2","792","0","127","7.6","14.5"
"Wilcox","2020-06-27","2","794","0","127","4.8","14.5"
"Wilcox","2020-06-28","0","794","0","127","4.8","7.4"
"Wilcox","2020-06-29","6","800","0","127","4.8","7.4"
"Wilcox","2020-06-30","5","805","0","127","0","7.4"
"Wilcox","2020-07-01","39","844","0","127","0","7.4"
"Wilcox","2020-07-02","8","852","2","129","3.6","5.6"
"Wilcox","2020-07-03","0","852","0","129","3.6","5.6"
"Wilcox","2020-07-04","1","853","0","129","3.6","4.2"
"Wilcox","2020-07-05","4","857","1","130","7.1","6"
"Wilcox","2020-07-06","7","864","0","130","7.1","6"
"Wilcox","2020-07-07","5","869","0","130","7.1","3.6"
"Wilcox","2020-07-08","37","906","0","130","7.1","3.6"
"Wilcox","2020-07-09","3","909","2","132","13.1","8.3"
"Wilcox","2020-07-10","8","917","0","132","13.1","8.3"
"Wilcox","2020-07-11","3","920","0","132","13.1","8.3"
"Wilcox","2020-07-12","0","920","0","132","9.5","8.3"
"Wilcox","2020-07-13","7","927","1","133","11.6","9.4"
"Wilcox","2020-07-14","4","931","1","134","15.1","11.1"
"Wilcox","2020-07-15","33","964","0","134","15.1","11.1"
"Wilcox","2020-07-16","5","969","3","137","14.2","13.6"
"Wilcox","2020-07-17","7","976","1","138","16.2","14.7"
"Wilcox","2020-07-18","3","979","0","138","16.2","14.7"
"Wilcox","2020-07-19","5","984","1","139","19.1","14.3"
"Wilcox","2020-07-20","3","987","2","141","26.6","19.1"
"Wilcox","2020-07-21","7","994","1","142","25","20.1"
"Wilcox","2020-07-22","18","1012","0","142","25","20.1"
"Wilcox","2020-07-23","10","1022","5","147","23.6","18.9"
"Wilcox","2020-07-24","10","1032","1","148","23","19.6"
"Wilcox","2020-07-25","1","1033","0","148","23","19.6"
"Wilcox","2020-07-26","1","1034","0","148","20.1","19.6"
"Wilcox","2020-07-27","3","1037","2","150","20.1","23.4"
"Wilcox","2020-07-28","10","1047","2","152","21","23"
"Wilcox","2020-07-29","43","1090","4","156","22.3","23.7"
"Wilcox","2020-07-30","9","1099","2","158","18.3","21"
"Wilcox","2020-07-31","3","1102","3","161","31.2","27.1"
"Wilcox","2020-08-01","2","1104","0","161","31.2","27.1"
"Wilcox","2020-08-02","6","1110","2","163","35.9","28"
"Wilcox","2020-08-03","5","1115","1","164","29.3","24.7"
"Wilcox","2020-08-04","7","1122","3","167","32.5","26.7"
"Wilcox","2020-08-05","39","1161","2","169","31.9","27.1"
"Wilcox","2020-08-06","7","1168","0","169","28.8","23.5"
"Wilcox","2020-08-07","5","1173","0","169","14.5","22.8"
"Wilcox","2020-08-08","2","1175","0","169","14.5","22.8"
"Wilcox","2020-08-09","4","1179","2","171","16.9","26.4"
"Wilcox","2020-08-10","8","1187","2","173","17.6","23.4"
"Wilcox","2020-08-11","8","1195","2","175","15","23.8"
"Wilcox","2020-08-12","37","1232","3","178","15.4","23.7"
"Wilcox","2020-08-13","6","1238","1","179","17.8","23.3"
"Wilcox","2020-08-14","3","1241","1","180","22.6","18.5"
"Wilcox","2020-08-15","5","1246","0","180","22.6","18.5"
"Wilcox","2020-08-16","2","1248","2","182","29.7","23.3"
"Wilcox","2020-08-17","9","1257","0","182","26.2","21.9"
"Wilcox","2020-08-18","6","1263","1","183","25","20"
"Wilcox","2020-08-19","37","1300","6","189","26.1","20.8"
"Wilcox","2020-08-20","6","1306","1","190","26.1","22"
"Wilcox","2020-08-21","6","1312","1","191","23.7","23.2"
"Wilcox","2020-08-22","2","1314","0","191","23.7","23.2"
"Wilcox","2020-08-23","1","1315","0","191","9.5","19.6"
"Wilcox","2020-08-24","7","1322","0","191","9.5","17.8"
"Wilcox","2020-08-25","5","1327","2","193","12.8","18.9"
"Wilcox","2020-08-26","37","1364","4","197","12","19.1"
"Wilcox","2020-08-27","2","1366","0","197","9.6","17.9"
"Wilcox","2020-08-28","4","1370","1","198","10.8","17.3"
"Wilcox","2020-08-29","2","1372","0","198","10.8","17.3"
"Wilcox","2020-08-30","1","1373","0","198","10.8","10.1"
"Wilcox","2020-08-31","9","1382","1","199","12.4","10.9"
"Wilcox","2020-09-01","11","1393","1","200","8","10.4"
"Wilcox","2020-09-02","21","1414","1","201","7.1","9.6"
"Wilcox","2020-09-03","4","1418","1","202","10.7","10.2"
"Wilcox","2020-09-04","4","1422","0","202","7.1","9"
"Wilcox","2020-09-05","2","1424","0","202","7.1","9"
"Wilcox","2020-09-06","4","1428","1","203","10.7","10.8"
"Wilcox","2020-09-07","4","1432","0","203","9.1","10.8"
"Wilcox","2020-09-08","9","1441","1","204","9.4","8.7"
"Wilcox","2020-09-09","19","1460","1","205","9.5","8.3"
"Wilcox","2020-09-10","15","1475","1","206","6.9","8.8"
"Wilcox","2020-09-11","7","1482","2","208","10.9","9"
"Wilcox","2020-09-12","2","1484","1","209","18.1","12.6"
"Wilcox","2020-09-13","2","1486","0","209","14.5","12.6"
"Wilcox","2020-09-14","4","1490","0","209","14.5","11.8"
"Wilcox","2020-09-15","4","1494","2","211","20.1","14.7"
"Wilcox","2020-09-16","5","1499","0","211","19.3","14.4"
"Wilcox","2020-09-17","5","1504","0","211","18.4","12.6"
"Wilcox","2020-09-18","4","1508","0","211","14.3","12.6"
"Wilcox","2020-09-19","3","1511","1","212","11.9","15"
"Wilcox","2020-09-20","0","1511","0","212","11.9","13.2"
"Wilcox","2020-09-21","1","1512","0","212","11.9","13.2"
"Wilcox","2020-09-22","7","1519","1","213","6.8","13.4"
"Wilcox","2020-09-23","30","1549","1","214","7.3","13.3"
"Wilcox","2020-09-24","4","1553","0","214","7.3","12.8"
"Wilcox","2020-09-25","3","1556","0","214","7.3","10.8"
"Wilcox","2020-09-26","1","1557","0","214","2.5","7.2"
"Wilcox","2020-09-27","2","1559","0","214","2.5","7.2"
"Wilcox","2020-09-28","5","1564","0","214","2.5","7.2"
"Wilcox","2020-09-29","5","1569","1","215","3.3","5.1"
"Wilcox","2020-09-30","2","1571","0","215","2.9","5.1"
"Wilcox","2020-10-01","1","1572","0","215","2.9","5.1"
"Wilcox","2020-10-02","7","1579","0","215","2.9","5.1"
"Wilcox","2020-10-03","2","1581","0","215","2.9","2.7"
"Wilcox","2020-10-04","4","1585","0","215","2.9","2.7"
"Wilcox","2020-10-05","4","1589","0","215","2.9","2.7"
"Wilcox","2020-10-06","1","1590","0","215","0","1.7"
"Wilcox","2020-10-07","28","1618","0","215","0","1.4"
"Wilcox","2020-10-08","5","1623","1","216","2.9","2.9"
"Wilcox","2020-10-09","6","1629","0","216","2.9","2.9"
"Wilcox","2020-10-10","4","1633","0","216","2.9","2.9"
"Wilcox","2020-10-11","4","1637","0","216","2.9","2.9"
"Wilcox","2020-10-12","1","1638","0","216","2.9","2.9"
"Wilcox","2020-10-13","2","1640","0","216","2.9","1.4"
"Wilcox","2020-10-14","25","1665","1","217","3.4","1.7"
"Wilcox","2020-10-15","4","1669","0","217","0.6","1.7"
"Wilcox","2020-10-16","1","1670","0","217","0.6","1.7"
"Wilcox","2020-10-17","3","1673","0","217","0.6","1.7"
"Wilcox","2020-10-18","1","1674","0","217","0.6","1.7"
"Wilcox","2020-10-19","7","1681","0","217","0.6","1.7"
"Wilcox","2020-10-20","6","1687","0","217","0.6","1.7"
"Wilcox","2020-10-21","31","1718","3","220","1.4","2.4"
"Wilcox","2020-10-22","3","1721","0","220","1.4","1"
"Wilcox","2020-10-23","3","1724","0","220","1.4","1"
"Wilcox","2020-10-24","0","1724","0","220","1.4","1"
"Wilcox","2020-10-25","0","1724","0","220","1.4","1"
"Wilcox","2020-10-26","4","1728","0","220","1.4","1"
"Wilcox","2020-10-27","4","1732","0","220","1.4","1"
"Wilcox","2020-10-28","30","1762","0","220","0","0.7"
"Wilcox","2020-10-29","6","1768","1","221","2.4","1.9"
"Wilcox","2020-10-30","2","1770","0","221","2.4","1.9"
"Wilcox","2020-10-31","2","1772","0","221","2.4","1.9"
"Wilcox","2020-11-01","1","1773","0","221","2.4","1.9"
"Wilcox","2020-11-02","20","1793","0","221","2.4","1.9"
"Wilcox","2020-11-03","6","1799","0","221","2.4","1.9"
"Wilcox","2020-11-04","10","1809","1","222","3.8","1.9"
"Wilcox","2020-11-05","72","1881","0","222","1.4","1.9"
"Wilcox","2020-11-06","47","1928","0","222","1.4","1.9"
"Wilcox","2020-11-07","1","1929","0","222","1.4","1.9"
"Wilcox","2020-11-08","0","1929","0","222","1.4","1.9"
"Wilcox","2020-11-09","7","1936","0","222","1.4","1.9"
"Wilcox","2020-11-10","316","2252","3","225","1.6","2"
"Wilcox","2020-11-11","4","2256","0","225","0.1","2"
"Wilcox","2020-11-12","2","2258","0","225","0.1","0.8"
"Wilcox","2020-11-13","4","2262","1","226","3.7","2.6"
"Wilcox","2020-11-14","2","2264","0","226","3.7","2.6"
"Wilcox","2020-11-15","3","2267","0","226","3.7","2.6"
"Wilcox","2020-11-16","2","2269","0","226","3.7","2.6"
"Wilcox","2020-11-17","112","2381","2","228","3.8","2.7"
"Wilcox","2020-11-18","118","2499","4","232","4.3","2.2"
"Wilcox","2020-11-19","123","2622","2","234","4.5","2.3"
"Wilcox","2020-11-20","8","2630","0","234","1","2.3"
"Wilcox","2020-11-21","6","2636","3","237","8.1","5.9"
"Wilcox","2020-11-22","3","2639","1","238","12.9","8.3"
"Wilcox","2020-11-23","6","2645","0","238","12.9","8.3"
"Wilcox","2020-11-24","6","2651","1","239","15","9.4"
"Wilcox","2020-11-25","10","2661","1","240","15.9","10.1"
"Wilcox","2020-11-26","1","2662","0","240","15.7","10.1"
"Wilcox","2020-11-27","6","2668","3","243","22.9","11.9"
"Wilcox","2020-11-28","2","2670","2","245","30","19.1"
"Wilcox","2020-11-29","0","2670","0","245","25.2","19.1"
"Wilcox","2020-11-30","8","2678","0","245","25.2","19.1"
"Wilcox","2020-12-01","12","2690","2","247","25.2","20.1"
"Wilcox","2020-12-02","30","2720","2","249","24.8","20.4"
"Wilcox","2020-12-03","6","2726","0","249","24.8","20.2"
"Wilcox","2020-12-04","2","2728","0","249","17.6","20.2"
"Wilcox","2020-12-05","6","2734","5","254","15.2","22.6"
"Wilcox","2020-12-06","0","2734","0","254","15.2","20.2"
"Wilcox","2020-12-07","9","2743","0","254","15.2","20.2"
"Wilcox","2020-12-08","23","2766","0","254","12.9","19"
"Wilcox","2020-12-09","65","2831","4","258","12.8","18.8"
"Wilcox","2020-12-10","85","2916","3","261","13.3","19"
"Wilcox","2020-12-11","10","2926","0","261","13.3","15.5"
"Wilcox","2020-12-12","3","2929","0","261","1.4","8.3"
"Wilcox","2020-12-13","1","2930","0","261","1.4","8.3"
"Wilcox","2020-12-14","123","3053","22","283","3.9","9.6"
"Wilcox","2020-12-15","8","3061","1","284","5.7","9.3"
"Wilcox","2020-12-16","76","3137","0","284","4.8","8.8"
"Wilcox","2020-12-17","119","3256","0","284","4.3","8.8"
"Wilcox","2020-12-18","27","3283","1","285","4.9","9.1"
"Wilcox","2020-12-19","5","3288","0","285","4.9","3.1"
"Wilcox","2020-12-20","1","3289","0","285","4.9","3.1"
"Wilcox","2020-12-21","121","3410","0","285","2.3","3.1"
"Wilcox","2020-12-22","13","3423","1","286","1.6","3.7"
"Wilcox","2020-12-23","57","3480","4","290","2.6","3.7"
"Wilcox","2020-12-24","6","3486","2","292","7.4","5.9"
"Wilcox","2020-12-25","1","3487","1","293","21.1","13"
"Wilcox","2020-12-26","4","3491","2","295","28.3","16.6"
"Wilcox","2020-12-27","1","3492","1","296","42.6","23.7"
"Wilcox","2020-12-28","8","3500","2","298","46.1","24.2"
"Wilcox","2020-12-29","4","3504","0","298","45.1","23.3"
"Wilcox","2020-12-30","45","3549","5","303","45.6","24.1"
"Wilcox","2020-12-31","2","3551","0","303","40.9","24.1"
"Wilcox","2021-01-01","0","3551","0","303","26.6","23.9"
"Wilcox","2021-01-02","4","3555","0","303","19.4","23.9"
"Wilcox","2021-01-03","4","3559","0","303","5.2","23.9"
"Wilcox","2021-01-04","9","3568","0","303","1.6","23.9"
"Wilcox","2021-01-05","10","3578","0","303","1.6","23.3"
"Wilcox","2021-01-06","70","3648","12","315","2.4","24"
"Wilcox","2021-01-07","10","3658","4","319","8.2","24.5"
"Wilcox","2021-01-08","4","3662","0","319","8.2","17.4"
"Wilcox","2021-01-09","0","3662","0","319","8.2","13.8"
"Wilcox","2021-01-10","2","3664","1","320","15.3","10.2"
"Wilcox","2021-01-11","15","3679","1","321","16.3","8.9"
"Wilcox","2021-01-12","6","3685","0","321","16.3","8.9"
"Wilcox","2021-01-13","51","3736","7","328","15.8","9.1"
"Wilcox","2021-01-14","9","3745","0","328","10.1","9.1"
"Wilcox","2021-01-15","10","3755","3","331","14.3","11.3"
"Wilcox","2021-01-16","3","3758","0","331","14.3","11.3"
"Wilcox","2021-01-17","2","3760","1","332","14.3","14.8"
"Wilcox","2021-01-18","9","3769","1","333","15","15.6"
"Wilcox","2021-01-19","4","3773","0","333","15","15.6"
"Wilcox","2021-01-20","8","3781","1","334","14.8","15.3"
"Wilcox","2021-01-21","6","3787","1","335","17.2","13.6"
"Wilcox","2021-01-22","5","3792","0","335","12.9","13.6"
"Wilcox","2021-01-23","5","3797","4","339","24.3","19.3"
"Wilcox","2021-01-24","5","3802","0","339","17.2","15.8"
"Wilcox","2021-01-25","5","3807","0","339","15.6","15.3"
"Wilcox","2021-01-26","5","3812","2","341","21.3","18.1"
"Wilcox","2021-01-27","7","3819","1","342","21.6","18.2"
"Wilcox","2021-01-28","5","3824","0","342","19.2","18.2"
"Wilcox","2021-01-29","4","3828","1","343","22.8","17.8"
"Wilcox","2021-01-30","1","3829","0","343","11.3","17.8"
"Wilcox","2021-01-31","1","3830","0","343","11.3","14.3"
"Wilcox","2021-02-01","5","3835","0","343","11.3","13.5"
"Wilcox","2021-02-02","33","3868","0","343","5.6","13.5"
"Wilcox","2021-02-03","140","4008","1","344","3.7","12.6"
"Wilcox","2021-02-04","135","4143","2","346","3.9","11.5"
"Wilcox","2021-02-05","36","4179","0","346","0.3","11.5"
"Wilcox","2021-02-06","0","4179","0","346","0.3","5.8"
"Wilcox","2021-02-07","0","4179","0","346","0.3","5.8"
"Wilcox","2021-02-08","0","4179","0","346","0.3","5.8"
"Wilkes","2020-02-01","0","0","0","0",".","."
"Wilkes","2020-02-02","0","0","0","0",".","."
"Wilkes","2020-02-03","0","0","0","0",".","."
"Wilkes","2020-02-04","0","0","0","0",".","."
"Wilkes","2020-02-05","0","0","0","0",".","."
"Wilkes","2020-02-06","0","0","0","0",".","."
"Wilkes","2020-02-07","0","0","0","0","0","."
"Wilkes","2020-02-08","0","0","0","0","0","."
"Wilkes","2020-02-09","0","0","0","0","0","."
"Wilkes","2020-02-10","0","0","0","0","0","."
"Wilkes","2020-02-11","0","0","0","0","0","."
"Wilkes","2020-02-12","0","0","0","0","0","."
"Wilkes","2020-02-13","0","0","0","0","0","."
"Wilkes","2020-02-14","0","0","0","0","0","0"
"Wilkes","2020-02-15","0","0","0","0","0","0"
"Wilkes","2020-02-16","0","0","0","0","0","0"
"Wilkes","2020-02-17","0","0","0","0","0","0"
"Wilkes","2020-02-18","0","0","0","0","0","0"
"Wilkes","2020-02-19","0","0","0","0","0","0"
"Wilkes","2020-02-20","0","0","0","0","0","0"
"Wilkes","2020-02-21","0","0","0","0","0","0"
"Wilkes","2020-02-22","0","0","0","0","0","0"
"Wilkes","2020-02-23","0","0","0","0","0","0"
"Wilkes","2020-02-24","0","0","0","0","0","0"
"Wilkes","2020-02-25","0","0","0","0","0","0"
"Wilkes","2020-02-26","0","0","0","0","0","0"
"Wilkes","2020-02-27","0","0","0","0","0","0"
"Wilkes","2020-02-28","0","0","0","0","0","0"
"Wilkes","2020-02-29","0","0","0","0","0","0"
"Wilkes","2020-03-01","0","0","0","0","0","0"
"Wilkes","2020-03-02","0","0","0","0","0","0"
"Wilkes","2020-03-03","0","0","0","0","0","0"
"Wilkes","2020-03-04","0","0","0","0","0","0"
"Wilkes","2020-03-05","0","0","0","0","0","0"
"Wilkes","2020-03-06","0","0","0","0","0","0"
"Wilkes","2020-03-07","0","0","0","0","0","0"
"Wilkes","2020-03-08","0","0","0","0","0","0"
"Wilkes","2020-03-09","0","0","0","0","0","0"
"Wilkes","2020-03-10","0","0","0","0","0","0"
"Wilkes","2020-03-11","0","0","0","0","0","0"
"Wilkes","2020-03-12","0","0","0","0","0","0"
"Wilkes","2020-03-13","0","0","0","0","0","0"
"Wilkes","2020-03-14","0","0","0","0","0","0"
"Wilkes","2020-03-15","0","0","0","0","0","0"
"Wilkes","2020-03-16","1","1","0","0","0","0"
"Wilkes","2020-03-17","0","1","0","0","0","0"
"Wilkes","2020-03-18","2","3","0","0","0","0"
"Wilkes","2020-03-19","0","3","0","0","0","0"
"Wilkes","2020-03-20","1","4","1","1","14.3","7.1"
"Wilkes","2020-03-21","0","4","0","1","14.3","7.1"
"Wilkes","2020-03-22","1","5","1","2","28.6","14.3"
"Wilkes","2020-03-23","0","5","0","2","28.6","14.3"
"Wilkes","2020-03-24","0","5","0","2","28.6","14.3"
"Wilkes","2020-03-25","4","9","1","3","32.1","16.1"
"Wilkes","2020-03-26","0","9","0","3","32.1","16.1"
"Wilkes","2020-03-27","3","12","0","3","17.9","16.1"
"Wilkes","2020-03-28","0","12","0","3","17.9","16.1"
"Wilkes","2020-03-29","1","13","0","3","3.6","16.1"
"Wilkes","2020-03-30","3","16","0","3","3.6","16.1"
"Wilkes","2020-03-31","1","17","0","3","3.6","16.1"
"Wilkes","2020-04-01","2","19","0","3","0","16.1"
"Wilkes","2020-04-02","1","20","0","3","0","16.1"
"Wilkes","2020-04-03","5","25","3","6","8.6","13.2"
"Wilkes","2020-04-04","3","28","0","6","8.6","13.2"
"Wilkes","2020-04-05","1","29","0","6","8.6","6.1"
"Wilkes","2020-04-06","0","29","0","6","8.6","6.1"
"Wilkes","2020-04-07","5","34","0","6","8.6","6.1"
"Wilkes","2020-04-08","2","36","0","6","8.6","4.3"
"Wilkes","2020-04-09","2","38","0","6","8.6","4.3"
"Wilkes","2020-04-10","0","38","0","6","0","4.3"
"Wilkes","2020-04-11","3","41","0","6","0","4.3"
"Wilkes","2020-04-12","1","42","0","6","0","4.3"
"Wilkes","2020-04-13","3","45","2","8","9.5","9"
"Wilkes","2020-04-14","1","46","0","8","9.5","9"
"Wilkes","2020-04-15","0","46","0","8","9.5","9"
"Wilkes","2020-04-16","48","94","10","18","12.5","10.5"
"Wilkes","2020-04-17","24","118","1","19","13.1","6.5"
"Wilkes","2020-04-18","8","126","2","21","16.7","8.3"
"Wilkes","2020-04-19","0","126","0","21","16.7","8.3"
"Wilkes","2020-04-20","2","128","0","21","7.1","8.3"
"Wilkes","2020-04-21","12","140","2","23","9.5","9.5"
"Wilkes","2020-04-22","24","164","0","23","9.5","9.5"
"Wilkes","2020-04-23","9","173","0","23","6.5","9.5"
"Wilkes","2020-04-24","18","191","0","23","6","9.5"
"Wilkes","2020-04-25","3","194","0","23","2.4","9.5"
"Wilkes","2020-04-26","4","198","0","23","2.4","9.5"
"Wilkes","2020-04-27","2","200","1","24","9.5","8.3"
"Wilkes","2020-04-28","8","208","0","24","7.1","8.3"
"Wilkes","2020-04-29","12","220","3","27","10.7","10.1"
"Wilkes","2020-04-30","1","221","0","27","10.7","8.6"
"Wilkes","2020-05-01","5","226","0","27","10.7","8.3"
"Wilkes","2020-05-02","6","232","0","27","10.7","6.5"
"Wilkes","2020-05-03","0","232","0","27","10.7","6.5"
"Wilkes","2020-05-04","6","238","0","27","3.6","6.5"
"Wilkes","2020-05-05","7","245","0","27","3.6","5.4"
"Wilkes","2020-05-06","6","251","0","27","0","5.4"
"Wilkes","2020-05-07","4","255","0","27","0","5.4"
"Wilkes","2020-05-08","3","258","0","27","0","5.4"
"Wilkes","2020-05-09","7","265","0","27","0","5.4"
"Wilkes","2020-05-10","1","266","0","27","0","5.4"
"Wilkes","2020-05-11","3","269","0","27","0","1.8"
"Wilkes","2020-05-12","9","278","1","28","1.6","2.6"
"Wilkes","2020-05-13","4","282","0","28","1.6","0.8"
"Wilkes","2020-05-14","3","285","0","28","1.6","0.8"
"Wilkes","2020-05-15","8","293","1","29","3.4","1.7"
"Wilkes","2020-05-16","5","298","0","29","3.4","1.7"
"Wilkes","2020-05-17","0","298","0","29","3.4","1.7"
"Wilkes","2020-05-18","5","303","1","30","6.2","3.1"
"Wilkes","2020-05-19","7","310","0","30","4.6","3.1"
"Wilkes","2020-05-20","6","316","1","31","7","4.3"
"Wilkes","2020-05-21","8","324","0","31","7","4.3"
"Wilkes","2020-05-22","10","334","0","31","5.2","4.3"
"Wilkes","2020-05-23","4","338","0","31","5.2","4.3"
"Wilkes","2020-05-24","8","346","0","31","5.2","4.3"
"Wilkes","2020-05-25","0","346","0","31","2.4","4.3"
"Wilkes","2020-05-26","4","350","0","31","2.4","3.5"
"Wilkes","2020-05-27","6","356","0","31","0","3.5"
"Wilkes","2020-05-28","3","359","0","31","0","3.5"
"Wilkes","2020-05-29","5","364","0","31","0","2.6"
"Wilkes","2020-05-30","7","371","0","31","0","2.6"
"Wilkes","2020-05-31","1","372","0","31","0","2.6"
"Wilkes","2020-06-01","5","377","0","31","0","1.2"
"Wilkes","2020-06-02","10","387","0","31","0","1.2"
"Wilkes","2020-06-03","7","394","0","31","0","0"
"Wilkes","2020-06-04","7","401","0","31","0","0"
"Wilkes","2020-06-05","6","407","0","31","0","0"
"Wilkes","2020-06-06","1","408","0","31","0","0"
"Wilkes","2020-06-07","2","410","0","31","0","0"
"Wilkes","2020-06-08","2","412","0","31","0","0"
"Wilkes","2020-06-09","22","434","1","32","0.6","0.3"
"Wilkes","2020-06-10","9","443","1","33","2.2","1.1"
"Wilkes","2020-06-11","70","513","0","33","2.2","1.1"
"Wilkes","2020-06-12","11","524","0","33","2.2","1.1"
"Wilkes","2020-06-13","3","527","0","33","2.2","1.1"
"Wilkes","2020-06-14","1","528","0","33","2.2","1.1"
"Wilkes","2020-06-15","9","537","1","34","3.8","1.9"
"Wilkes","2020-06-16","13","550","0","34","3.2","1.9"
"Wilkes","2020-06-17","7","557","0","34","1.6","1.9"
"Wilkes","2020-06-18","7","564","0","34","1.6","1.9"
"Wilkes","2020-06-19","7","571","0","34","1.6","1.9"
"Wilkes","2020-06-20","3","574","0","34","1.6","1.9"
"Wilkes","2020-06-21","2","576","1","35","8.7","5.5"
"Wilkes","2020-06-22","10","586","0","35","7.1","5.5"
"Wilkes","2020-06-23","13","599","0","35","7.1","5.2"
"Wilkes","2020-06-24","9","608","2","37","10.3","6"
"Wilkes","2020-06-25","46","654","0","37","10.3","6"
"Wilkes","2020-06-26","9","663","0","37","10.3","6"
"Wilkes","2020-06-27","3","666","0","37","10.3","6"
"Wilkes","2020-06-28","2","668","0","37","3.2","6"
"Wilkes","2020-06-29","14","682","2","39","5.2","6.2"
"Wilkes","2020-06-30","8","690","1","40","7","7.1"
"Wilkes","2020-07-01","51","741","3","43","4.7","7.5"
"Wilkes","2020-07-02","13","754","5","48","10.2","10.2"
"Wilkes","2020-07-03","3","757","0","48","10.2","10.2"
"Wilkes","2020-07-04","5","762","1","49","13","11.7"
"Wilkes","2020-07-05","11","773","3","52","16.9","10"
"Wilkes","2020-07-06","6","779","0","52","14.9","10"
"Wilkes","2020-07-07","10","789","1","53","14.5","10.8"
"Wilkes","2020-07-08","11","800","1","54","15","9.8"
"Wilkes","2020-07-09","7","807","2","56","13.6","11.9"
"Wilkes","2020-07-10","10","817","2","58","16.4","13.3"
"Wilkes","2020-07-11","12","829","4","62","18.3","15.7"
"Wilkes","2020-07-12","10","839","1","63","15.9","16.4"
"Wilkes","2020-07-13","9","848","2","65","19","17"
"Wilkes","2020-07-14","7","855","0","65","17.6","16.1"
"Wilkes","2020-07-15","7","862","1","66","18.3","16.7"
"Wilkes","2020-07-16","10","872","2","68","17.1","15.3"
"Wilkes","2020-07-17","4","876","0","68","14.3","15.3"
"Wilkes","2020-07-18","12","888","1","69","10.7","14.5"
"Wilkes","2020-07-19","5","893","0","69","9.3","12.6"
"Wilkes","2020-07-20","7","900","2","71","10.2","14.6"
"Wilkes","2020-07-21","7","907","1","72","12.2","14.9"
"Wilkes","2020-07-22","8","915","0","72","10.2","14.3"
"Wilkes","2020-07-23","8","923","1","73","9.1","13.1"
"Wilkes","2020-07-24","15","938","1","74","10.1","12.2"
"Wilkes","2020-07-25","7","945","1","75","10.9","10.8"
"Wilkes","2020-07-26","9","954","0","75","10.9","10.1"
"Wilkes","2020-07-27","10","964","0","75","6.8","8.5"
"Wilkes","2020-07-28","11","975","1","76","6.1","9.1"
"Wilkes","2020-07-29","54","1029","0","76","6.1","8.1"
"Wilkes","2020-07-30","6","1035","2","78","9.1","9.1"
"Wilkes","2020-07-31","6","1041","0","78","8.1","9.1"
"Wilkes","2020-08-01","9","1050","0","78","6.1","8.5"
"Wilkes","2020-08-02","7","1057","1","79","8.1","9.5"
"Wilkes","2020-08-03","11","1068","0","79","8.1","7.5"
"Wilkes","2020-08-04","5","1073","1","80","9.7","7.9"
"Wilkes","2020-08-05","64","1137","2","82","10.1","8.1"
"Wilkes","2020-08-06","9","1146","0","82","5.3","7.2"
"Wilkes","2020-08-07","1","1147","0","82","5.3","6.7"
"Wilkes","2020-08-08","5","1152","0","82","5.3","5.7"
"Wilkes","2020-08-09","4","1156","0","82","3.3","5.7"
"Wilkes","2020-08-10","9","1165","1","83","4.9","6.5"
"Wilkes","2020-08-11","8","1173","0","83","2","5.8"
"Wilkes","2020-08-12","77","1250","0","83","1.6","5.8"
"Wilkes","2020-08-13","12","1262","0","83","1.6","3.5"
"Wilkes","2020-08-14","12","1274","2","85","4","4.7"
"Wilkes","2020-08-15","9","1283","1","86","5.6","5.4"
"Wilkes","2020-08-16","46","1329","0","86","5.6","4.4"
"Wilkes","2020-08-17","9","1338","0","86","4","4.4"
"Wilkes","2020-08-18","6","1344","0","86","4","3"
"Wilkes","2020-08-19","31","1375","1","87","4.4","3"
"Wilkes","2020-08-20","4","1379","1","88","8","4.8"
"Wilkes","2020-08-21","5","1384","2","90","11.3","7.7"
"Wilkes","2020-08-22","2","1386","0","90","9.7","7.7"
"Wilkes","2020-08-23","6","1392","0","90","9.7","7.7"
"Wilkes","2020-08-24","12","1404","0","90","9.7","6.9"
"Wilkes","2020-08-25","5","1409","0","90","9.7","6.9"
"Wilkes","2020-08-26","28","1437","3","93","10.8","7.6"
"Wilkes","2020-08-27","10","1447","1","94","8.7","8.3"
"Wilkes","2020-08-28","10","1457","2","96","5.8","8.6"
"Wilkes","2020-08-29","9","1466","0","96","5.8","7.8"
"Wilkes","2020-08-30","8","1474","0","96","5.8","7.8"
"Wilkes","2020-08-31","8","1482","0","96","5.8","7.8"
"Wilkes","2020-09-01","41","1523","1","97","6.2","8"
"Wilkes","2020-09-02","32","1555","2","99","5.5","8.2"
"Wilkes","2020-09-03","16","1571","1","100","5","6.8"
"Wilkes","2020-09-04","16","1587","2","102","3.9","4.9"
"Wilkes","2020-09-05","12","1599","0","102","3.9","4.9"
"Wilkes","2020-09-06","1","1600","0","102","3.9","4.9"
"Wilkes","2020-09-07","3","1603","0","102","3.9","4.9"
"Wilkes","2020-09-08","13","1616","1","103","4.7","5.4"
"Wilkes","2020-09-09","38","1654","2","105","4.5","5"
"Wilkes","2020-09-10","8","1662","0","105","3.6","4.3"
"Wilkes","2020-09-11","10","1672","1","106","3.3","3.6"
"Wilkes","2020-09-12","10","1682","1","107","4.7","4.3"
"Wilkes","2020-09-13","4","1686","0","107","4.7","4.3"
"Wilkes","2020-09-14","12","1698","0","107","4.7","4.3"
"Wilkes","2020-09-15","13","1711","0","107","3.6","4.1"
"Wilkes","2020-09-16","20","1731","0","107","2.9","3.7"
"Wilkes","2020-09-17","8","1739","0","107","2.9","3.2"
"Wilkes","2020-09-18","8","1747","1","108","3.2","3.2"
"Wilkes","2020-09-19","6","1753","0","108","1.8","3.2"
"Wilkes","2020-09-20","3","1756","0","108","1.8","3.2"
"Wilkes","2020-09-21","8","1764","0","108","1.8","3.2"
"Wilkes","2020-09-22","5","1769","1","109","4.6","4.1"
"Wilkes","2020-09-23","23","1792","1","110","5.3","4.1"
"Wilkes","2020-09-24","6","1798","1","111","7.6","5.3"
"Wilkes","2020-09-25","9","1807","0","111","5.9","4.5"
"Wilkes","2020-09-26","13","1820","1","112","7","4.4"
"Wilkes","2020-09-27","4","1824","0","112","7","4.4"
"Wilkes","2020-09-28","9","1833","0","112","7","4.4"
"Wilkes","2020-09-29","8","1841","0","112","4.1","4.4"
"Wilkes","2020-09-30","26","1867","0","112","3.5","4.4"
"Wilkes","2020-10-01","6","1873","0","112","1.1","4.4"
"Wilkes","2020-10-02","10","1883","0","112","1.1","3.5"
"Wilkes","2020-10-03","11","1894","1","113","1.3","4.1"
"Wilkes","2020-10-04","12","1906","1","114","2.5","4.7"
"Wilkes","2020-10-05","7","1913","1","115","4.5","5.7"
"Wilkes","2020-10-06","2","1915","0","115","4.5","4.3"
"Wilkes","2020-10-07","17","1932","2","117","6.2","4.8"
"Wilkes","2020-10-08","19","1951","0","117","6.2","3.7"
"Wilkes","2020-10-09","7","1958","0","117","6.2","3.7"
"Wilkes","2020-10-10","10","1968","0","117","4.9","3.1"
"Wilkes","2020-10-11","11","1979","0","117","3.7","3.1"
"Wilkes","2020-10-12","8","1987","0","117","1.7","3.1"
"Wilkes","2020-10-13","9","1996","1","118","3.3","3.9"
"Wilkes","2020-10-14","20","2016","0","118","1.6","3.9"
"Wilkes","2020-10-15","11","2027","2","120","4.2","5.2"
"Wilkes","2020-10-16","13","2040","2","122","6.4","6.3"
"Wilkes","2020-10-17","6","2046","0","122","6.4","5.6"
"Wilkes","2020-10-18","10","2056","1","123","7.8","5.8"
"Wilkes","2020-10-19","12","2068","0","123","7.8","4.7"
"Wilkes","2020-10-20","11","2079","0","123","6.2","4.7"
"Wilkes","2020-10-21","29","2108","2","125","7.2","4.4"
"Wilkes","2020-10-22","9","2117","3","128","9.4","6.8"
"Wilkes","2020-10-23","19","2136","2","130","8.7","7.5"
"Wilkes","2020-10-24","12","2148","3","133","12.3","9.3"
"Wilkes","2020-10-25","8","2156","1","134","12.6","10.2"
"Wilkes","2020-10-26","19","2175","0","134","12.6","10.2"
"Wilkes","2020-10-27","25","2200","7","141","16.6","11.4"
"Wilkes","2020-10-28","89","2289","9","150","17.1","12.1"
"Wilkes","2020-10-29","15","2304","3","153","15.2","12.3"
"Wilkes","2020-10-30","18","2322","2","155","15.2","12"
"Wilkes","2020-10-31","9","2331","1","156","13.3","12.8"
"Wilkes","2020-11-01","12","2343","2","158","13.9","13.2"
"Wilkes","2020-11-02","15","2358","1","159","14.8","13.7"
"Wilkes","2020-11-03","11","2369","3","162","14.7","15.7"
"Wilkes","2020-11-04","49","2418","5","167","14.7","15.9"
"Wilkes","2020-11-05","17","2435","0","167","11.9","13.5"
"Wilkes","2020-11-06","24","2459","4","171","12.7","14"
"Wilkes","2020-11-07","13","2472","2","173","13.3","13.3"
"Wilkes","2020-11-08","10","2482","1","174","12.3","13.1"
"Wilkes","2020-11-09","7","2489","2","176","15.4","15.1"
"Wilkes","2020-11-10","21","2510","6","182","15.6","15.2"
"Wilkes","2020-11-11","37","2547","2","184","14.9","14.8"
"Wilkes","2020-11-12","8","2555","1","185","16.7","14.3"
"Wilkes","2020-11-13","16","2571","3","188","17","14.8"
"Wilkes","2020-11-14","14","2585","3","191","17.9","15.6"
"Wilkes","2020-11-15","11","2596","1","192","17.8","15"
"Wilkes","2020-11-16","8","2604","3","195","19","17.2"
"Wilkes","2020-11-17","10","2614","1","196","16.4","16"
"Wilkes","2020-11-18","47","2661","2","198","16.2","15.6"
"Wilkes","2020-11-19","12","2673","2","200","16.8","16.8"
"Wilkes","2020-11-20","10","2683","0","200","14.1","15.6"
"Wilkes","2020-11-21","9","2692","0","200","11.1","14.5"
"Wilkes","2020-11-22","3","2695","0","200","9.8","13.8"
"Wilkes","2020-11-23","11","2706","3","203","8.3","13.7"
"Wilkes","2020-11-24","14","2720","2","205","8.9","12.7"
"Wilkes","2020-11-25","44","2764","6","211","10.3","13.2"
"Wilkes","2020-11-26","6","2770","1","212","10.3","13.5"
"Wilkes","2020-11-27","10","2780","2","214","13.1","13.6"
"Wilkes","2020-11-28","4","2784","0","214","13.1","12.1"
"Wilkes","2020-11-29","7","2791","3","217","19.2","14.5"
"Wilkes","2020-11-30","10","2801","1","218","16.8","12.5"
"Wilkes","2020-12-01","8","2809","2","220","18.3","13.6"
"Wilkes","2020-12-02","41","2850","7","227","18.8","14.5"
"Wilkes","2020-12-03","8","2858","1","228","18.2","14.2"
"Wilkes","2020-12-04","18","2876","4","232","18.5","15.8"
"Wilkes","2020-12-05","7","2883","2","234","22.6","17.9"
"Wilkes","2020-12-06","3","2886","1","235","21.2","20.2"
"Wilkes","2020-12-07","20","2906","5","240","23.4","20.1"
"Wilkes","2020-12-08","12","2918","1","241","21","19.7"
"Wilkes","2020-12-09","36","2954","3","244","19.8","19.3"
"Wilkes","2020-12-10","12","2966","1","245","19.2","18.7"
"Wilkes","2020-12-11","23","2989","2","247","17.2","17.9"
"Wilkes","2020-12-12","7","2996","2","249","17.2","19.9"
"Wilkes","2020-12-13","4","3000","3","252","23.2","22.2"
"Wilkes","2020-12-14","13","3013","1","253","20.7","22"
"Wilkes","2020-12-15","27","3040","7","260","23.2","22.1"
"Wilkes","2020-12-16","76","3116","14","274","24.7","22.2"
"Wilkes","2020-12-17","13","3129","2","276","25.7","22.4"
"Wilkes","2020-12-18","15","3144","2","278","26.3","21.8"
"Wilkes","2020-12-19","15","3159","6","284","28","22.6"
"Wilkes","2020-12-20","10","3169","0","284","17.3","20.2"
"Wilkes","2020-12-21","14","3183","2","286","18.2","19.5"
"Wilkes","2020-12-22","25","3208","3","289","16.2","19.7"
"Wilkes","2020-12-23","64","3272","8","297","15.4","20"
"Wilkes","2020-12-24","8","3280","1","298","14.9","20.3"
"Wilkes","2020-12-25","0","3280","0","298","13","19.7"
"Wilkes","2020-12-26","7","3287","1","299","9.4","18.7"
"Wilkes","2020-12-27","6","3293","2","301","14.1","15.7"
"Wilkes","2020-12-28","15","3308","2","303","14","16.1"
"Wilkes","2020-12-29","31","3339","2","305","13.2","14.7"
"Wilkes","2020-12-30","46","3385","12","317","15.1","15.2"
"Wilkes","2020-12-31","29","3414","9","326","17.8","16.4"
"Wilkes","2021-01-01","3","3417","0","326","17.8","15.4"
"Wilkes","2021-01-02","10","3427","2","328","18.6","14"
"Wilkes","2021-01-03","7","3434","2","330","17.9","16"
"Wilkes","2021-01-04","14","3448","4","334","20.1","17"
"Wilkes","2021-01-05","44","3492","13","347","23.4","18.3"
"Wilkes","2021-01-06","114","3606","22","369","22.4","18.8"
"Wilkes","2021-01-07","11","3617","2","371","20.6","19.2"
"Wilkes","2021-01-08","18","3635","4","375","23.8","20.8"
"Wilkes","2021-01-09","15","3650","2","377","22.8","20.7"
"Wilkes","2021-01-10","18","3668","7","384","24.3","21.1"
"Wilkes","2021-01-11","12","3680","3","387","23.8","21.9"
"Wilkes","2021-01-12","24","3704","7","394","23.7","23.6"
"Wilkes","2021-01-13","32","3736","12","406","26.3","24.4"
"Wilkes","2021-01-14","14","3750","3","409","26.8","23.7"
"Wilkes","2021-01-15","27","3777","8","417","27.8","25.8"
"Wilkes","2021-01-16","20","3797","10","427","33.1","28"
"Wilkes","2021-01-17","14","3811","2","429","29.6","26.9"
"Wilkes","2021-01-18","16","3827","4","433","29.6","26.7"
"Wilkes","2021-01-19","14","3841","4","437","29.5","26.6"
"Wilkes","2021-01-20","19","3860","3","440","26.4","26.4"
"Wilkes","2021-01-21","30","3890","7","447","26.7","26.7"
"Wilkes","2021-01-22","19","3909","9","456","29.2","28.5"
"Wilkes","2021-01-23","13","3922","4","460","26.4","29.8"
"Wilkes","2021-01-24","9","3931","2","462","27.6","28.6"
"Wilkes","2021-01-25","18","3949","4","466","27.2","28.4"
"Wilkes","2021-01-26","8","3957","2","468","26.7","28.1"
"Wilkes","2021-01-27","22","3979","5","473","27.7","27"
"Wilkes","2021-01-28","33","4012","4","477","26.1","26.4"
"Wilkes","2021-01-29","23","4035","3","480","21.2","25.2"
"Wilkes","2021-01-30","20","4055","1","481","17.5","22"
"Wilkes","2021-01-31","7","4062","0","481","14.3","20.9"
"Wilkes","2021-02-01","14","4076","2","483","13.2","20.2"
"Wilkes","2021-02-02","18","4094","6","489","14.4","20.5"
"Wilkes","2021-02-03","14","4108","0","489","11.1","19.4"
"Wilkes","2021-02-04","16","4124","2","491","11.2","18.6"
"Wilkes","2021-02-05","10","4134","1","492","10.7","15.9"
"Wilkes","2021-02-06","0","4134","0","492","10","13.7"
"Wilkes","2021-02-07","0","4134","0","492","10","12.2"
"Wilkes","2021-02-08","0","4134","0","492","8","10.6"
"Wilkinson","2020-02-01","0","0","0","0",".","."
"Wilkinson","2020-02-02","0","0","0","0",".","."
"Wilkinson","2020-02-03","0","0","0","0",".","."
"Wilkinson","2020-02-04","0","0","0","0",".","."
"Wilkinson","2020-02-05","0","0","0","0",".","."
"Wilkinson","2020-02-06","0","0","0","0",".","."
"Wilkinson","2020-02-07","0","0","0","0","0","."
"Wilkinson","2020-02-08","0","0","0","0","0","."
"Wilkinson","2020-02-09","0","0","0","0","0","."
"Wilkinson","2020-02-10","0","0","0","0","0","."
"Wilkinson","2020-02-11","0","0","0","0","0","."
"Wilkinson","2020-02-12","0","0","0","0","0","."
"Wilkinson","2020-02-13","0","0","0","0","0","."
"Wilkinson","2020-02-14","0","0","0","0","0","0"
"Wilkinson","2020-02-15","0","0","0","0","0","0"
"Wilkinson","2020-02-16","0","0","0","0","0","0"
"Wilkinson","2020-02-17","0","0","0","0","0","0"
"Wilkinson","2020-02-18","0","0","0","0","0","0"
"Wilkinson","2020-02-19","0","0","0","0","0","0"
"Wilkinson","2020-02-20","0","0","0","0","0","0"
"Wilkinson","2020-02-21","0","0","0","0","0","0"
"Wilkinson","2020-02-22","0","0","0","0","0","0"
"Wilkinson","2020-02-23","0","0","0","0","0","0"
"Wilkinson","2020-02-24","0","0","0","0","0","0"
"Wilkinson","2020-02-25","0","0","0","0","0","0"
"Wilkinson","2020-02-26","0","0","0","0","0","0"
"Wilkinson","2020-02-27","0","0","0","0","0","0"
"Wilkinson","2020-02-28","0","0","0","0","0","0"
"Wilkinson","2020-02-29","0","0","0","0","0","0"
"Wilkinson","2020-03-01","0","0","0","0","0","0"
"Wilkinson","2020-03-02","0","0","0","0","0","0"
"Wilkinson","2020-03-03","0","0","0","0","0","0"
"Wilkinson","2020-03-04","0","0","0","0","0","0"
"Wilkinson","2020-03-05","0","0","0","0","0","0"
"Wilkinson","2020-03-06","0","0","0","0","0","0"
"Wilkinson","2020-03-07","0","0","0","0","0","0"
"Wilkinson","2020-03-08","0","0","0","0","0","0"
"Wilkinson","2020-03-09","0","0","0","0","0","0"
"Wilkinson","2020-03-10","0","0","0","0","0","0"
"Wilkinson","2020-03-11","1","1","0","0","0","0"
"Wilkinson","2020-03-12","0","1","0","0","0","0"
"Wilkinson","2020-03-13","0","1","0","0","0","0"
"Wilkinson","2020-03-14","0","1","0","0","0","0"
"Wilkinson","2020-03-15","2","3","1","1","7.1","3.6"
"Wilkinson","2020-03-16","29","32","6","7","10.1","5"
"Wilkinson","2020-03-17","28","60","0","7","10.1","5"
"Wilkinson","2020-03-18","30","90","5","12","12.5","6.2"
"Wilkinson","2020-03-19","22","112","4","16","15.1","7.5"
"Wilkinson","2020-03-20","14","126","0","16","15.1","7.5"
"Wilkinson","2020-03-21","9","135","0","16","15.1","7.5"
"Wilkinson","2020-03-22","0","135","0","16","7.9","7.5"
"Wilkinson","2020-03-23","5","140","0","16","5","7.5"
"Wilkinson","2020-03-24","2","142","0","16","5","7.5"
"Wilkinson","2020-03-25","2","144","1","17","9.7","11.1"
"Wilkinson","2020-03-26","5","149","0","17","7.1","11.1"
"Wilkinson","2020-03-27","5","154","2","19","12.9","14"
"Wilkinson","2020-03-28","1","155","0","19","12.9","14"
"Wilkinson","2020-03-29","0","155","0","19","12.9","10.4"
"Wilkinson","2020-03-30","2","157","1","20","20","12.5"
"Wilkinson","2020-03-31","5","162","1","21","22.9","13.9"
"Wilkinson","2020-04-01","7","169","0","21","15.7","12.7"
"Wilkinson","2020-04-02","4","173","0","21","15.7","11.4"
"Wilkinson","2020-04-03","3","176","0","21","10","11.4"
"Wilkinson","2020-04-04","5","181","3","24","18.6","15.7"
"Wilkinson","2020-04-05","1","182","1","25","32.9","22.9"
"Wilkinson","2020-04-06","2","184","2","27","40","30"
"Wilkinson","2020-04-07","8","192","0","27","37.1","30"
"Wilkinson","2020-04-08","8","200","3","30","42.5","29.1"
"Wilkinson","2020-04-09","6","206","0","30","42.5","29.1"
"Wilkinson","2020-04-10","5","211","1","31","45.4","27.7"
"Wilkinson","2020-04-11","1","212","0","31","36.8","27.7"
"Wilkinson","2020-04-12","3","215","0","31","22.5","27.7"
"Wilkinson","2020-04-13","14","229","2","33","10.3","25.1"
"Wilkinson","2020-04-14","14","243","11","44","21.5","29.3"
"Wilkinson","2020-04-15","5","248","1","45","19","30.7"
"Wilkinson","2020-04-16","8","256","2","47","22.6","32.5"
"Wilkinson","2020-04-17","4","260","2","49","26.8","36.1"
"Wilkinson","2020-04-18","1","261","0","49","26.8","31.8"
"Wilkinson","2020-04-19","1","262","0","49","26.8","24.7"
"Wilkinson","2020-04-20","92","354","9","58","26.2","18.2"
"Wilkinson","2020-04-21","136","490","21","79","17.2","19.3"
"Wilkinson","2020-04-22","88","578","4","83","15","17"
"Wilkinson","2020-04-23","49","627","7","90","13.4","18"
"Wilkinson","2020-04-24","85","712","12","102","8.3","17.6"
"Wilkinson","2020-04-25","27","739","0","102","8.3","17.6"
"Wilkinson","2020-04-26","0","739","0","102","8.3","17.6"
"Wilkinson","2020-04-27","100","839","5","107","7.6","16.9"
"Wilkinson","2020-04-28","82","921","4","111","6.1","11.6"
"Wilkinson","2020-04-29","30","951","3","114","6.9","10.9"
"Wilkinson","2020-04-30","48","999","11","125","8.1","10.8"
"Wilkinson","2020-05-01","11","1010","3","128","10","9.2"
"Wilkinson","2020-05-02","19","1029","1","129","10.8","9.5"
"Wilkinson","2020-05-03","3","1032","0","129","10.8","9.5"
"Wilkinson","2020-05-04","494","1526","10","139","10.3","9"
"Wilkinson","2020-05-05","62","1588","3","142","10.3","8.2"
"Wilkinson","2020-05-06","99","1687","3","145","9.3","8.1"
"Wilkinson","2020-05-07","106","1793","2","147","6.3","7.2"
"Wilkinson","2020-05-08","111","1904","1","148","2.6","6.3"
"Wilkinson","2020-05-09","71","1975","3","151","2.4","6.6"
"Wilkinson","2020-05-10","16","1991","0","151","2.4","6.6"
"Wilkinson","2020-05-11","154","2145","6","157","2.7","6.5"
"Wilkinson","2020-05-12","259","2404","9","166","2.5","6.4"
"Wilkinson","2020-05-13","273","2677","4","170","2.3","5.8"
"Wilkinson","2020-05-14","164","2841","7","177","2.6","4.5"
"Wilkinson","2020-05-15","126","2967","10","187","3.6","3.1"
"Wilkinson","2020-05-16","17","2984","0","187","3","2.7"
"Wilkinson","2020-05-17","5","2989","0","187","3","2.7"
"Wilkinson","2020-05-18","84","3073","6","193","3.5","3.1"
"Wilkinson","2020-05-19","146","3219","1","194","3.1","2.8"
"Wilkinson","2020-05-20","18","3237","0","194","2.9","2.6"
"Wilkinson","2020-05-21","66","3303","3","197","2.9","2.8"
"Wilkinson","2020-05-22","37","3340","6","203","4.1","3.8"
"Wilkinson","2020-05-23","18","3358","3","206","6.5","4.7"
"Wilkinson","2020-05-24","10","3368","0","206","6.5","4.7"
"Wilkinson","2020-05-25","14","3382","2","208","7.5","5.5"
"Wilkinson","2020-05-26","112","3494","14","222","9.2","6.1"
"Wilkinson","2020-05-27","50","3544","2","224","9.7","6.3"
"Wilkinson","2020-05-28","179","3723","2","226","9.3","6.1"
"Wilkinson","2020-05-29","31","3754","0","226","6.9","5.5"
"Wilkinson","2020-05-30","150","3904","5","231","5","5.7"
"Wilkinson","2020-05-31","13","3917","1","232","6.1","6.3"
"Wilkinson","2020-06-01","165","4082","9","241","4.9","6.2"
"Wilkinson","2020-06-02","27","4109","0","241","3.1","6.1"
"Wilkinson","2020-06-03","103","4212","11","252","4","6.9"
"Wilkinson","2020-06-04","34","4246","1","253","4.3","6.8"
"Wilkinson","2020-06-05","84","4330","2","255","4.6","5.8"
"Wilkinson","2020-06-06","2","4332","0","255","4.2","4.6"
"Wilkinson","2020-06-07","52","4384","5","260","4.4","5.3"
"Wilkinson","2020-06-08","86","4470","10","270","5.3","5.1"
"Wilkinson","2020-06-09","52","4522","5","275","6.7","4.9"
"Wilkinson","2020-06-10","130","4652","8","283","6","5"
"Wilkinson","2020-06-11","67","4719","18","301","9.5","6.9"
"Wilkinson","2020-06-12","114","4833","17","318","11.3","7.9"
"Wilkinson","2020-06-13","117","4950","14","332","13","8.6"
"Wilkinson","2020-06-14","0","4950","0","332","11.6","8"
"Wilkinson","2020-06-15","144","5094","14","346","11.3","8.3"
"Wilkinson","2020-06-16","99","5193","5","351","10.7","8.7"
"Wilkinson","2020-06-17","182","5375","27","378","11.9","9"
"Wilkinson","2020-06-18","41","5416","2","380","8.8","9.1"
"Wilkinson","2020-06-19","155","5571","13","393","7.8","9.5"
"Wilkinson","2020-06-20","1","5572","0","393","6.1","9.5"
"Wilkinson","2020-06-21","66","5638","3","396","6.8","9.2"
"Wilkinson","2020-06-22","214","5852","23","419","6.9","9.1"
"Wilkinson","2020-06-23","262","6114","22","441","7.4","9"
"Wilkinson","2020-06-24","203","6317","12","453","6.1","9"
"Wilkinson","2020-06-25","325","6642","48","501","7.5","8.2"
"Wilkinson","2020-06-26","270","6912","21","522","7.4","7.6"
"Wilkinson","2020-06-27","93","7005","13","535","9.4","7.8"
"Wilkinson","2020-06-28","2","7007","0","535","8.8","7.8"
"Wilkinson","2020-06-29","253","7260","25","560","8.7","7.8"
"Wilkinson","2020-06-30","492","7752","45","605","8.8","8.1"
"Wilkinson","2020-07-01","235","7987","23","628","9.3","7.7"
"Wilkinson","2020-07-02","378","8365","50","678","9.1","8.3"
"Wilkinson","2020-07-03","8","8373","1","679","9.8","8.6"
"Wilkinson","2020-07-04","112","8485","9","688","8.9","9.2"
"Wilkinson","2020-07-05","2","8487","2","690","23.2","16"
"Wilkinson","2020-07-06","344","8831","35","725","23.3","16"
"Wilkinson","2020-07-07","288","9119","26","751","23.3","16"
"Wilkinson","2020-07-08","205","9324","13","764","22.8","16"
"Wilkinson","2020-07-09","147","9471","12","776","22","15.6"
"Wilkinson","2020-07-10","438","9909","50","826","21.9","15.8"
"Wilkinson","2020-07-11","69","9978","2","828","21.1","15"
"Wilkinson","2020-07-12","1","9979","0","828","6.9","15"
"Wilkinson","2020-07-13","319","10298","35","863","7","15.1"
"Wilkinson","2020-07-14","402","10700","24","887","6.5","14.9"
"Wilkinson","2020-07-15","378","11078","41","928","7.2","15"
"Wilkinson","2020-07-16","164","11242","12","940","7.1","14.5"
"Wilkinson","2020-07-17","303","11545","20","960","6.4","14.1"
"Wilkinson","2020-07-18","114","11659","7","967","6.8","14"
"Wilkinson","2020-07-19","6","11665","3","970","14","10.4"
"Wilkinson","2020-07-20","313","11978","12","982","13","10"
"Wilkinson","2020-07-21","244","12222","11","993","12.7","9.6"
"Wilkinson","2020-07-22","414","12636","34","1027","12.4","9.8"
"Wilkinson","2020-07-23","122","12758","8","1035","12.3","9.7"
"Wilkinson","2020-07-24","354","13112","16","1051","12","9.2"
"Wilkinson","2020-07-25","94","13206","7","1058","12.2","9.5"
"Wilkinson","2020-07-26","10","13216","2","1060","7.9","10.9"
"Wilkinson","2020-07-27","343","13559","18","1078","8.1","10.5"
"Wilkinson","2020-07-28","270","13829","14","1092","8.2","10.5"
"Wilkinson","2020-07-29","408","14237","34","1126","8.2","10.3"
"Wilkinson","2020-07-30","121","14358","6","1132","8","10.1"
"Wilkinson","2020-07-31","376","14734","30","1162","8.5","10.2"
"Wilkinson","2020-08-01","153","14887","9","1171","8.2","10.2"
"Wilkinson","2020-08-02","6","14893","1","1172","7.8","7.8"
"Wilkinson","2020-08-03","352","15245","40","1212","8.6","8.3"
"Wilkinson","2020-08-04","211","15456","11","1223","8.6","8.4"
"Wilkinson","2020-08-05","484","15940","58","1281","9.1","8.7"
"Wilkinson","2020-08-06","131","16071","10","1291","9.5","8.7"
"Wilkinson","2020-08-07","532","16603","44","1335","9.6","9"
"Wilkinson","2020-08-08","95","16698","15","1350","11","9.6"
"Wilkinson","2020-08-09","32","16730","3","1353","9.9","8.8"
"Wilkinson","2020-08-10","275","17005","43","1396","10.6","9.6"
"Wilkinson","2020-08-11","326","17331","17","1413","10.6","9.6"
"Wilkinson","2020-08-12","401","17732","18","1431","9.5","9.3"
"Wilkinson","2020-08-13","148","17880","14","1445","9.7","9.6"
"Wilkinson","2020-08-14","491","18371","31","1476","9.5","9.5"
"Wilkinson","2020-08-15","8","18379","1","1477","9","10"
"Wilkinson","2020-08-16","160","18539","9","1486","8.5","9.2"
"Wilkinson","2020-08-17","9","18548","1","1487","7.8","9.2"
"Wilkinson","2020-08-18","181","18729","3","1490","7.3","8.9"
"Wilkinson","2020-08-19","361","19090","33","1523","8","8.7"
"Wilkinson","2020-08-20","110","19200","12","1535","8.2","9"
"Wilkinson","2020-08-21","465","19665","37","1572","8.4","8.9"
"Wilkinson","2020-08-22","145","19810","19","1591","8.5","8.7"
"Wilkinson","2020-08-23","37","19847","2","1593","8.5","8.5"
"Wilkinson","2020-08-24","326","20173","65","1658","9.7","8.8"
"Wilkinson","2020-08-25","204","20377","14","1672","10.5","8.9"
"Wilkinson","2020-08-26","413","20790","114","1786","13.1","10.5"
"Wilkinson","2020-08-27","69","20859","1","1787","11.8","10"
"Wilkinson","2020-08-28","450","21309","107","1894","14","11.2"
"Wilkinson","2020-08-29","183","21492","54","1948","16.4","12.4"
"Wilkinson","2020-08-30","13","21505","0","1948","15.6","12"
"Wilkinson","2020-08-31","349","21854","36","1984","14.2","12"
"Wilkinson","2020-09-01","194","22048","6","1990","13.7","12.1"
"Wilkinson","2020-09-02","672","22720","75","2065","11.3","12.2"
"Wilkinson","2020-09-03","274","22994","12","2077","11.7","11.8"
"Wilkinson","2020-09-04","671","23665","58","2135","9.6","11.8"
"Wilkinson","2020-09-05","449","24114","45","2180","6.8","11.6"
"Wilkinson","2020-09-06","22","24136","1","2181","7.5","11.5"
"Wilkinson","2020-09-07","250","24386","24","2205","7.3","10.8"
"Wilkinson","2020-09-08","375","24761","23","2228","7.8","10.7"
"Wilkinson","2020-09-09","640","25401","44","2272","7.2","9.3"
"Wilkinson","2020-09-10","211","25612","7","2279","7","9.4"
"Wilkinson","2020-09-11","595","26207","40","2319","6.7","8.2"
"Wilkinson","2020-09-12","248","26455","18","2337","6.4","6.6"
"Wilkinson","2020-09-13","0","26455","0","2337","5.7","6.6"
"Wilkinson","2020-09-14","471","26926","21","2358","5","6.2"
"Wilkinson","2020-09-15","297","27223","8","2366","4.5","6.1"
"Wilkinson","2020-09-16","464","27687","11","2377","3.8","5.5"
"Wilkinson","2020-09-17","25","27712","1","2378","3.9","5.5"
"Wilkinson","2020-09-18","629","28341","24","2402","3.5","5.1"
"Wilkinson","2020-09-19","128","28469","11","2413","3.7","5"
"Wilkinson","2020-09-20","5","28474","0","2413","3.7","4.7"
"Wilkinson","2020-09-21","320","28794","22","2435","4","4.5"
"Wilkinson","2020-09-22","241","29035","11","2446","4.3","4.4"
"Wilkinson","2020-09-23","396","29431","14","2460","4.5","4.2"
"Wilkinson","2020-09-24","154","29585","6","2466","4.5","4.2"
"Wilkinson","2020-09-25","384","29969","17","2483","4.6","4"
"Wilkinson","2020-09-26","161","30130","6","2489","3.9","3.8"
"Wilkinson","2020-09-27","9","30139","2","2491","7","5.4"
"Wilkinson","2020-09-28","295","30434","16","2507","6.8","5.4"
"Wilkinson","2020-09-29","273","30707","20","2527","7.2","5.8"
"Wilkinson","2020-09-30","330","31037","21","2548","7.6","6.1"
"Wilkinson","2020-10-01","181","31218","7","2555","7.6","6"
"Wilkinson","2020-10-02","471","31689","24","2579","7.7","6.1"
"Wilkinson","2020-10-03","219","31908","10","2589","7.8","5.8"
"Wilkinson","2020-10-04","7","31915","1","2590","6.7","6.9"
"Wilkinson","2020-10-05","318","32233","22","2612","6.9","6.9"
"Wilkinson","2020-10-06","374","32607","9","2621","6.2","6.7"
"Wilkinson","2020-10-07","384","32991","14","2635","5.8","6.7"
"Wilkinson","2020-10-08","266","33257","30","2665","6.9","7.3"
"Wilkinson","2020-10-09","544","33801","28","2693","6.9","7.3"
"Wilkinson","2020-10-10","171","33972","17","2710","7.7","7.7"
"Wilkinson","2020-10-11","2","33974","0","2710","5.6","6.2"
"Wilkinson","2020-10-12","115","34089","6","2716","5.4","6.1"
"Wilkinson","2020-10-13","468","34557","28","2744","5.9","6.1"
"Wilkinson","2020-10-14","334","34891","11","2755","5.8","5.8"
"Wilkinson","2020-10-15","328","35219","14","2769","4.8","5.9"
"Wilkinson","2020-10-16","615","35834","44","2813","5.1","6"
"Wilkinson","2020-10-17","194","36028","12","2825","4.6","6.1"
"Wilkinson","2020-10-18","7","36035","1","2826","6.6","6.1"
"Wilkinson","2020-10-19","429","36464","26","2852","6.7","6.1"
"Wilkinson","2020-10-20","473","36937","21","2873","6.5","6.2"
"Wilkinson","2020-10-21","441","37378","33","2906","7.1","6.5"
"Wilkinson","2020-10-22","443","37821","34","2940","7.6","6.2"
"Wilkinson","2020-10-23","622","38443","47","2987","7.7","6.4"
"Wilkinson","2020-10-24","189","38632","12","2999","7.7","6.1"
"Wilkinson","2020-10-25","10","38642","0","2999","5.7","6.1"
"Wilkinson","2020-10-26","487","39129","46","3045","6.1","6.4"
"Wilkinson","2020-10-27","398","39527","15","3060","6","6.3"
"Wilkinson","2020-10-28","428","39955","20","3080","5.6","6.4"
"Wilkinson","2020-10-29","88","40043","3","3083","5","6.3"
"Wilkinson","2020-10-30","622","40665","35","3118","4.8","6.2"
"Wilkinson","2020-10-31","83","40748","4","3122","4.5","6.1"
"Wilkinson","2020-11-01","7","40755","0","3122","4.5","5.1"
"Wilkinson","2020-11-02","390","41145","29","3151","4.2","5.2"
"Wilkinson","2020-11-03","125","41270","8","3159","4.6","5.3"
"Wilkinson","2020-11-04","416","41686","23","3182","4.7","5.2"
"Wilkinson","2020-11-05","219","41905","10","3192","4.9","5"
"Wilkinson","2020-11-06","516","42421","35","3227","5.1","4.9"
"Wilkinson","2020-11-07","209","42630","10","3237","5.1","4.8"
"Wilkinson","2020-11-08","4","42634","0","3237","5.1","4.8"
"Wilkinson","2020-11-09","401","43035","39","3276","5.4","4.8"
"Wilkinson","2020-11-10","543","43578","42","3318","5.6","5.1"
"Wilkinson","2020-11-11","219","43797","10","3328","5.5","5.1"
"Wilkinson","2020-11-12","392","44189","29","3357","5.9","5.4"
"Wilkinson","2020-11-13","913","45102","58","3415","5.8","5.4"
"Wilkinson","2020-11-14","327","45429","22","3437","6.1","5.6"
"Wilkinson","2020-11-15","2","45431","0","3437","6.1","5.6"
"Wilkinson","2020-11-16","678","46109","61","3498","6","5.7"
"Wilkinson","2020-11-17","480","46589","33","3531","5.8","5.7"
"Wilkinson","2020-11-18","656","47245","35","3566","6","5.7"
"Wilkinson","2020-11-19","437","47682","24","3590","5.7","5.8"
"Wilkinson","2020-11-20","990","48672","48","3638","5.5","5.6"
"Wilkinson","2020-11-21","504","49176","10","3648","4.8","5.4"
"Wilkinson","2020-11-22","8","49184","0","3648","4.8","5.4"
"Wilkinson","2020-11-23","1028","50212","56","3704","4.3","5.1"
"Wilkinson","2020-11-24","842","51054","51","3755","4.2","5"
"Wilkinson","2020-11-25","507","51561","35","3790","4.4","5.2"
"Wilkinson","2020-11-26","3","51564","0","3790","3.6","4.6"
"Wilkinson","2020-11-27","16","51580","2","3792","4.7","5.1"
"Wilkinson","2020-11-28","280","51860","20","3812","5.4","5.1"
"Wilkinson","2020-11-29","3","51863","1","3813","10.2","7.5"
"Wilkinson","2020-11-30","136","51999","8","3821","10.3","7.3"
"Wilkinson","2020-12-01","46","52045","11","3832","12.8","8.5"
"Wilkinson","2020-12-02","155","52200","8","3840","12.6","8.5"
"Wilkinson","2020-12-03","109","52309","9","3849","13.7","8.7"
"Wilkinson","2020-12-04","476","52785","55","3904","13.6","9.2"
"Wilkinson","2020-12-05","9","52794","1","3905","14.2","9.8"
"Wilkinson","2020-12-06","6","52800","4","3909","18.9","14.6"
"Wilkinson","2020-12-07","165","52965","10","3919","19","14.6"
"Wilkinson","2020-12-08","115","53080","8","3927","16.5","14.7"
"Wilkinson","2020-12-09","262","53342","22","3949","17","14.8"
"Wilkinson","2020-12-10","73","53415","4","3953","16.6","15.2"
"Wilkinson","2020-12-11","257","53672","23","3976","16.2","14.9"
"Wilkinson","2020-12-12","35","53707","3","3979","15.9","15"
"Wilkinson","2020-12-13","5","53712","1","3980","9.2","14.1"
"Wilkinson","2020-12-14","236","53948","31","4011","10.2","14.6"
"Wilkinson","2020-12-15","198","54146","20","4031","10.7","13.6"
"Wilkinson","2020-12-16","292","54438","25","4056","10.7","13.8"
"Wilkinson","2020-12-17","106","54544","6","4062","10.7","13.7"
"Wilkinson","2020-12-18","730","55274","109","4171","11.6","13.9"
"Wilkinson","2020-12-19","33","55307","4","4175","12.1","14"
"Wilkinson","2020-12-20","7","55314","1","4176","11.3","10.2"
"Wilkinson","2020-12-21","261","55575","26","4202","10.8","10.5"
"Wilkinson","2020-12-22","252","55827","19","4221","10.4","10.5"
"Wilkinson","2020-12-23","405","56232","35","4256","10.4","10.6"
"Wilkinson","2020-12-24","17","56249","5","4261","13.8","12.3"
"Wilkinson","2020-12-25","9","56258","2","4263","14.9","13.2"
"Wilkinson","2020-12-26","175","56433","30","4293","15.6","13.8"
"Wilkinson","2020-12-27","12","56445","5","4298","19.5","15.4"
"Wilkinson","2020-12-28","234","56679","34","4332","20.2","15.5"
"Wilkinson","2020-12-29","272","56951","42","4374","21.3","15.9"
"Wilkinson","2020-12-30","341","57292","41","4415","21.8","16.1"
"Wilkinson","2020-12-31","135","57427","19","4434","19.6","16.7"
"Wilkinson","2021-01-01","8","57435","1","4435","18.2","16.5"
"Wilkinson","2021-01-02","170","57605","38","4473","18.9","17.3"
"Wilkinson","2021-01-03","15","57620","3","4476","15.8","17.7"
"Wilkinson","2021-01-04","373","57993","70","4546","16.5","18.3"
"Wilkinson","2021-01-05","565","58558","50","4596","15.5","18.4"
"Wilkinson","2021-01-06","402","58960","44","4640","15.4","18.6"
"Wilkinson","2021-01-07","187","59147","19","4659","14.8","17.2"
"Wilkinson","2021-01-08","462","59609","47","4706","14.5","16.3"
"Wilkinson","2021-01-09","22","59631","3","4709","13.2","16.1"
"Wilkinson","2021-01-10","17","59648","5","4714","14.6","15.2"
"Wilkinson","2021-01-11","125","59773","19","4733","14.1","15.3"
"Wilkinson","2021-01-12","211","59984","24","4757","14.4","15"
"Wilkinson","2021-01-13","48","60032","11","4768","16.1","15.7"
"Wilkinson","2021-01-14","132","60164","16","4784","16.4","15.6"
"Wilkinson","2021-01-15","167","60331","20","4804","16.7","15.6"
"Wilkinson","2021-01-16","16","60347","3","4807","17.4","15.3"
"Wilkinson","2021-01-17","7","60354","2","4809","17.3","15.9"
"Wilkinson","2021-01-18","144","60498","14","4823","16.5","15.3"
"Wilkinson","2021-01-19","142","60640","18","4841","16.7","15.5"
"Wilkinson","2021-01-20","69","60709","7","4848","14.9","15.5"
"Wilkinson","2021-01-21","21","60730","3","4851","15.2","15.8"
"Wilkinson","2021-01-22","117","60847","8","4859","14.4","15.5"
"Wilkinson","2021-01-23","13","60860","1","4860","12.8","15.1"
"Wilkinson","2021-01-24","10","60870","3","4863","13.1","15.2"
"Wilkinson","2021-01-25","37","60907","2","4865","12.4","14.5"
"Wilkinson","2021-01-26","154","61061","13","4878","11.8","14.3"
"Wilkinson","2021-01-27","47","61108","7","4885","12.5","13.7"
"Wilkinson","2021-01-28","94","61202","20","4905","13.5","14.3"
"Wilkinson","2021-01-29","128","61330","11","4916","13.8","14.1"
"Wilkinson","2021-01-30","9","61339","1","4917","14.2","13.5"
"Wilkinson","2021-01-31","6","61345","0","4917","10","11.5"
"Wilkinson","2021-02-01","37","61382","1","4918","9.6","11"
"Wilkinson","2021-02-02","117","61499","13","4931","10","10.9"
"Wilkinson","2021-02-03","60","61559","3","4934","8.5","10.5"
"Wilkinson","2021-02-04","9","61568","0","4934","5.5","9.5"
"Wilkinson","2021-02-05","119","61687","5","4939","4.9","9.3"
"Wilkinson","2021-02-06","8","61695","2","4941","6.9","10.6"
"Wilkinson","2021-02-07","0","61695","0","4941","6.9","8.4"
"Wilkinson","2021-02-08","0","61695","0","4941","6.5","8"
"Worth","2020-02-01","0","0","0","0",".","."
"Worth","2020-02-02","0","0","0","0",".","."
"Worth","2020-02-03","0","0","0","0",".","."
"Worth","2020-02-04","0","0","0","0",".","."
"Worth","2020-02-05","0","0","0","0",".","."
"Worth","2020-02-06","0","0","0","0",".","."
"Worth","2020-02-07","0","0","0","0","0","."
"Worth","2020-02-08","0","0","0","0","0","."
"Worth","2020-02-09","0","0","0","0","0","."
"Worth","2020-02-10","0","0","0","0","0","."
"Worth","2020-02-11","0","0","0","0","0","."
"Worth","2020-02-12","0","0","0","0","0","."
"Worth","2020-02-13","0","0","0","0","0","."
"Worth","2020-02-14","0","0","0","0","0","0"
"Worth","2020-02-15","0","0","0","0","0","0"
"Worth","2020-02-16","0","0","0","0","0","0"
"Worth","2020-02-17","0","0","0","0","0","0"
"Worth","2020-02-18","0","0","0","0","0","0"
"Worth","2020-02-19","0","0","0","0","0","0"
"Worth","2020-02-20","0","0","0","0","0","0"
"Worth","2020-02-21","0","0","0","0","0","0"
"Worth","2020-02-22","0","0","0","0","0","0"
"Worth","2020-02-23","0","0","0","0","0","0"
"Worth","2020-02-24","0","0","0","0","0","0"
"Worth","2020-02-25","0","0","0","0","0","0"
"Worth","2020-02-26","0","0","0","0","0","0"
"Worth","2020-02-27","0","0","0","0","0","0"
"Worth","2020-02-28","0","0","0","0","0","0"
"Worth","2020-02-29","0","0","0","0","0","0"
"Worth","2020-03-01","0","0","0","0","0","0"
"Worth","2020-03-02","0","0","0","0","0","0"
"Worth","2020-03-03","0","0","0","0","0","0"
"Worth","2020-03-04","0","0","0","0","0","0"
"Worth","2020-03-05","0","0","0","0","0","0"
"Worth","2020-03-06","0","0","0","0","0","0"
"Worth","2020-03-07","0","0","0","0","0","0"
"Worth","2020-03-08","0","0","0","0","0","0"
"Worth","2020-03-09","0","0","0","0","0","0"
"Worth","2020-03-10","0","0","0","0","0","0"
"Worth","2020-03-11","1","1","0","0","0","0"
"Worth","2020-03-12","4","5","0","0","0","0"
"Worth","2020-03-13","4","9","1","1","3.6","1.8"
"Worth","2020-03-14","2","11","0","1","3.6","1.8"
"Worth","2020-03-15","1","12","1","2","17.9","8.9"
"Worth","2020-03-16","7","19","0","2","17.9","8.9"
"Worth","2020-03-17","13","32","3","5","21.2","10.6"
"Worth","2020-03-18","8","40","3","8","26.5","13.3"
"Worth","2020-03-19","14","54","3","11","29.6","14.8"
"Worth","2020-03-20","13","67","1","12","27.1","15.3"
"Worth","2020-03-21","3","70","1","13","31.9","17.7"
"Worth","2020-03-22","5","75","3","16","26.1","22"
"Worth","2020-03-23","17","92","6","22","31.2","24.5"
"Worth","2020-03-24","31","123","2","24","28.8","25"
"Worth","2020-03-25","21","144","4","28","26.2","26.3"
"Worth","2020-03-26","17","161","2","30","24.8","27.2"
"Worth","2020-03-27","8","169","1","31","25.5","26.3"
"Worth","2020-03-28","8","177","2","33","24.3","28.1"
"Worth","2020-03-29","9","186","3","36","20.5","23.3"
"Worth","2020-03-30","15","201","5","41","20.2","25.7"
"Worth","2020-03-31","10","211","6","47","27.9","28.3"
"Worth","2020-04-01","16","227","8","55","32.3","29.2"
"Worth","2020-04-02","21","248","7","62","35.4","30.1"
"Worth","2020-04-03","21","269","4","66","36.3","30.9"
"Worth","2020-04-04","5","274","3","69","41.3","32.8"
"Worth","2020-04-05","6","280","1","70","38.9","29.7"
"Worth","2020-04-06","25","305","2","72","35.3","27.7"
"Worth","2020-04-07","22","327","4","76","29.3","28.6"
"Worth","2020-04-08","15","342","1","77","23.1","27.7"
"Worth","2020-04-09","12","354","4","81","23.1","29.2"
"Worth","2020-04-10","12","366","1","82","21.6","28.9"
"Worth","2020-04-11","19","385","2","84","14.5","27.9"
"Worth","2020-04-12","3","388","0","84","12.1","25.5"
"Worth","2020-04-13","41","429","4","88","12.4","23.8"
"Worth","2020-04-14","26","455","4","92","12","20.7"
"Worth","2020-04-15","21","476","4","96","13.8","18.4"
"Worth","2020-04-16","14","490","1","97","10","16.6"
"Worth","2020-04-17","21","511","0","97","8.8","15.2"
"Worth","2020-04-18","11","522","2","99","9.9","12.2"
"Worth","2020-04-19","3","525","2","101","19.5","15.8"
"Worth","2020-04-20","14","539","2","103","20.1","16.3"
"Worth","2020-04-21","19","558","1","104","18.7","15.3"
"Worth","2020-04-22","24","582","4","108","18.3","16"
"Worth","2020-04-23","16","598","0","108","17.3","13.7"
"Worth","2020-04-24","13","611","1","109","18.4","13.6"
"Worth","2020-04-25","14","625","0","109","15.8","12.9"
"Worth","2020-04-26","7","632","1","110","8.3","13.9"
"Worth","2020-04-27","23","655","4","114","8.8","14.4"
"Worth","2020-04-28","30","685","7","121","11.3","15"
"Worth","2020-04-29","27","712","4","125","11.1","14.7"
"Worth","2020-04-30","40","752","8","133","13.9","15.6"
"Worth","2020-05-01","39","791","3","136","13.9","16.2"
"Worth","2020-05-02","13","804","0","136","13.9","14.9"
"Worth","2020-05-03","3","807","1","137","16.7","12.5"
"Worth","2020-05-04","14","821","0","137","14.2","11.5"
"Worth","2020-05-05","20","841","2","139","12.3","11.8"
"Worth","2020-05-06","21","862","3","142","12.2","11.6"
"Worth","2020-05-07","5","867","2","144","15","14.5"
"Worth","2020-05-08","13","880","3","147","17.2","15.6"
"Worth","2020-05-09","6","886","2","149","22","18"
"Worth","2020-05-10","2","888","0","149","17.2","16.9"
"Worth","2020-05-11","22","910","4","153","19.8","17"
"Worth","2020-05-12","19","929","2","155","19.9","16.1"
"Worth","2020-05-13","36","965","3","158","19.1","15.6"
"Worth","2020-05-14","36","1001","2","160","14.1","14.6"
"Worth","2020-05-15","9","1010","2","162","14","15.6"
"Worth","2020-05-16","6","1016","0","162","9.3","15.6"
"Worth","2020-05-17","3","1019","1","163","14","15.6"
"Worth","2020-05-18","27","1046","3","166","13","16.4"
"Worth","2020-05-19","23","1069","3","169","13.4","16.6"
"Worth","2020-05-20","22","1091","2","171","13.5","16.3"
"Worth","2020-05-21","37","1128","3","174","13.8","14"
"Worth","2020-05-22","44","1172","2","176","11.3","12.7"
"Worth","2020-05-23","11","1183","1","177","12.6","10.9"
"Worth","2020-05-24","10","1193","1","178","9.3","11.7"
"Worth","2020-05-25","10","1203","1","179","9.1","11.1"
"Worth","2020-05-26","52","1255","1","180","7.5","10.5"
"Worth","2020-05-27","36","1291","2","182","7","10.3"
"Worth","2020-05-28","104","1395","7","189","6.8","10.3"
"Worth","2020-05-29","35","1430","3","192","7.4","9.4"
"Worth","2020-05-30","14","1444","3","195","9.2","10.9"
"Worth","2020-05-31","17","1461","1","196","8.6","8.9"
"Worth","2020-06-01","49","1510","1","197","7.4","8.3"
"Worth","2020-06-02","31","1541","1","198","7.6","7.6"
"Worth","2020-06-03","28","1569","1","199","7.4","7.2"
"Worth","2020-06-04","127","1696","6","205","7.1","6.9"
"Worth","2020-06-05","35","1731","0","205","5.8","6.6"
"Worth","2020-06-06","16","1747","2","207","4.6","6.9"
"Worth","2020-06-07","26","1773","1","208","4.3","6.4"
"Worth","2020-06-08","34","1807","3","211","5.2","6.3"
"Worth","2020-06-09","35","1842","2","213","5.6","6.6"
"Worth","2020-06-10","23","1865","4","217","7.6","7.5"
"Worth","2020-06-11","98","1963","11","228","8.5","7.8"
"Worth","2020-06-12","26","1989","3","231","10.1","8"
"Worth","2020-06-13","6","1995","2","233","13.1","8.8"
"Worth","2020-06-14","12","2007","0","233","12.6","8.4"
"Worth","2020-06-15","27","2034","3","236","12.9","9.1"
"Worth","2020-06-16","30","2064","3","239","13.5","9.6"
"Worth","2020-06-17","26","2090","1","240","11.6","9.6"
"Worth","2020-06-18","92","2182","11","251","11.7","10.1"
"Worth","2020-06-19","33","2215","5","256","12.2","11.2"
"Worth","2020-06-20","19","2234","2","258","8.9","11"
"Worth","2020-06-21","18","2252","3","261","11.3","11.9"
"Worth","2020-06-22","54","2306","2","263","10.3","11.6"
"Worth","2020-06-23","28","2334","1","264","9.3","11.4"
"Worth","2020-06-24","27","2361","0","264","8.8","10.2"
"Worth","2020-06-25","85","2446","14","278","9.4","10.6"
"Worth","2020-06-26","28","2474","0","278","7.3","9.7"
"Worth","2020-06-27","9","2483","2","280","8.9","8.9"
"Worth","2020-06-28","9","2492","1","281","8.2","9.7"
"Worth","2020-06-29","50","2542","4","285","8.8","9.5"
"Worth","2020-06-30","34","2576","2","287","9.1","9.2"
"Worth","2020-07-01","26","2602","4","291","11.3","10"
"Worth","2020-07-02","107","2709","5","296","9.6","9.5"
"Worth","2020-07-03","13","2722","3","299","12.9","10.1"
"Worth","2020-07-04","5","2727","1","300","12.6","10.8"
"Worth","2020-07-05","17","2744","1","301","11.8","10"
"Worth","2020-07-06","41","2785","6","307","12.8","10.8"
"Worth","2020-07-07","30","2815","5","312","14.3","11.7"
"Worth","2020-07-08","34","2849","2","314","13","12.1"
"Worth","2020-07-09","174","3023","7","321","12.9","11.2"
"Worth","2020-07-10","23","3046","2","323","10.8","11.9"
"Worth","2020-07-11","14","3060","0","323","8","10.3"
"Worth","2020-07-12","13","3073","0","323","7.1","9.5"
"Worth","2020-07-13","34","3107","4","327","6.7","9.8"
"Worth","2020-07-14","44","3151","3","330","5.3","9.8"
"Worth","2020-07-15","49","3200","6","336","6.2","9.6"
"Worth","2020-07-16","159","3359","4","340","6","9.4"
"Worth","2020-07-17","48","3407","4","344","6","8.4"
"Worth","2020-07-18","14","3421","2","346","8","8"
"Worth","2020-07-19","9","3430","2","348","11.2","9.1"
"Worth","2020-07-20","50","3480","4","352","10.6","8.7"
"Worth","2020-07-21","26","3506","2","354","10.8","8"
"Worth","2020-07-22","34","3540","3","357","10.3","8.2"
"Worth","2020-07-23","135","3675","8","365","10.8","8.4"
"Worth","2020-07-24","30","3705","5","370","11.9","8.9"
"Worth","2020-07-25","19","3724","2","372","11.4","9.7"
"Worth","2020-07-26","13","3737","2","374","10.4","10.8"
"Worth","2020-07-27","45","3782","13","387","13.4","12"
"Worth","2020-07-28","48","3830","5","392","13.8","12.3"
"Worth","2020-07-29","37","3867","4","396","14.1","12.2"
"Worth","2020-07-30","117","3984","6","402","14","12.4"
"Worth","2020-07-31","36","4020","6","408","14","13"
"Worth","2020-08-01","21","4041","0","408","12.5","11.9"
"Worth","2020-08-02","12","4053","1","409","11.5","10.9"
"Worth","2020-08-03","39","4092","8","417","10.3","11.8"
"Worth","2020-08-04","32","4124","1","418","9.2","11.5"
"Worth","2020-08-05","66","4190","6","424","9","11.5"
"Worth","2020-08-06","94","4284","3","427","8.7","11.3"
"Worth","2020-08-07","55","4339","4","431","7.4","10.7"
"Worth","2020-08-08","17","4356","3","434","9.9","11.2"
"Worth","2020-08-09","19","4375","2","436","10.2","10.8"
"Worth","2020-08-10","39","4414","4","440","8.7","9.5"
"Worth","2020-08-11","35","4449","2","442","9.1","9.2"
"Worth","2020-08-12","46","4495","4","446","9","9"
"Worth","2020-08-13","84","4579","5","451","9.4","9.1"
"Worth","2020-08-14","25","4604","1","452","9","8.2"
"Worth","2020-08-15","56","4660","1","453","6.7","8.3"
"Worth","2020-08-16","10","4670","0","453","5.2","7.7"
"Worth","2020-08-17","43","4713","4","457","5.1","6.9"
"Worth","2020-08-18","39","4752","3","460","5.3","7.2"
"Worth","2020-08-19","49","4801","4","464","5.3","7.2"
"Worth","2020-08-20","77","4878","7","471","5.7","7.6"
"Worth","2020-08-21","33","4911","0","471","5.1","7.1"
"Worth","2020-08-22","83","4994","0","471","4.9","5.8"
"Worth","2020-08-23","7","5001","1","472","6.9","6.1"
"Worth","2020-08-24","20","5021","5","477","9.2","7.1"
"Worth","2020-08-25","63","5084","5","482","9.2","7.3"
"Worth","2020-08-26","27","5111","2","484","9.1","7.2"
"Worth","2020-08-27","63","5174","4","488","8.7","7.2"
"Worth","2020-08-28","38","5212","2","490","9.5","7.3"
"Worth","2020-08-29","67","5279","0","490","9.5","7.2"
"Worth","2020-08-30","11","5290","0","490","7.4","7.2"
"Worth","2020-08-31","43","5333","4","494","5.2","7.2"
"Worth","2020-09-01","46","5379","0","494","4","6.6"
"Worth","2020-09-02","44","5423","1","495","3.3","6.2"
"Worth","2020-09-03","53","5476","1","496","2.7","5.7"
"Worth","2020-09-04","99","5575","2","498","2.2","5.8"
"Worth","2020-09-05","38","5613","1","499","2.6","6"
"Worth","2020-09-06","20","5633","1","500","3.3","5.4"
"Worth","2020-09-07","18","5651","0","500","2","3.6"
"Worth","2020-09-08","48","5699","4","504","3.2","3.6"
"Worth","2020-09-09","31","5730","0","504","2.8","3.1"
"Worth","2020-09-10","25","5755","2","506","3.7","3.2"
"Worth","2020-09-11","28","5783","1","507","3.9","3.1"
"Worth","2020-09-12","7","5790","0","507","3.6","3.1"
"Worth","2020-09-13","10","5800","0","507","2.8","3.1"
"Worth","2020-09-14","50","5850","1","508","3.1","2.6"
"Worth","2020-09-15","32","5882","2","510","2.8","3"
"Worth","2020-09-16","23","5905","3","513","4.7","3.8"
"Worth","2020-09-17","58","5963","3","516","4.3","4"
"Worth","2020-09-18","23","5986","1","517","4.4","4.2"
"Worth","2020-09-19","11","5997","2","519","7","5.3"
"Worth","2020-09-20","9","6006","1","520","8.6","5.7"
"Worth","2020-09-21","38","6044","3","523","9.4","6.3"
"Worth","2020-09-22","41","6085","6","529","10.6","6.7"
"Worth","2020-09-23","47","6132","1","530","9.1","6.9"
"Worth","2020-09-24","57","6189","3","533","9.1","6.7"
"Worth","2020-09-25","46","6235","2","535","9.1","6.7"
"Worth","2020-09-26","15","6250","1","536","7.4","7.2"
"Worth","2020-09-27","13","6263","1","537","6.9","7.8"
"Worth","2020-09-28","41","6304","2","539","6.5","8"
"Worth","2020-09-29","32","6336","2","541","5.3","8"
"Worth","2020-09-30","28","6364","5","546","7.6","8.3"
"Worth","2020-10-01","52","6416","2","548","7.4","8.2"
"Worth","2020-10-02","55","6471","6","554","8.3","8.7"
"Worth","2020-10-03","47","6518","5","559","8.9","8.2"
"Worth","2020-10-04","18","6536","1","560","8.6","7.8"
"Worth","2020-10-05","60","6596","6","566","9.3","7.9"
"Worth","2020-10-06","56","6652","6","572","9.9","7.6"
"Worth","2020-10-07","56","6708","5","577","8.7","8.1"
"Worth","2020-10-08","67","6775","3","580","8.7","8.1"
"Worth","2020-10-09","82","6857","2","582","7.5","7.9"
"Worth","2020-10-10","14","6871","2","584","8.1","8.5"
"Worth","2020-10-11","38","6909","2","586","8","8.3"
"Worth","2020-10-12","43","6952","6","592","8.6","8.9"
"Worth","2020-10-13","28","6980","1","593","7.6","8.7"
"Worth","2020-10-14","40","7020","4","597","7.7","8.2"
"Worth","2020-10-15","82","7102","2","599","7.4","8.1"
"Worth","2020-10-16","67","7169","4","603","7.9","7.7"
"Worth","2020-10-17","54","7223","2","605","6.4","7.2"
"Worth","2020-10-18","49","7272","8","613","8","8"
"Worth","2020-10-19","53","7325","1","614","6.3","7.4"
"Worth","2020-10-20","29","7354","0","614","5.8","6.7"
"Worth","2020-10-21","36","7390","1","615","4.7","6.2"
"Worth","2020-10-22","32","7422","0","615","4.4","5.9"
"Worth","2020-10-23","45","7467","2","617","4.2","6"
"Worth","2020-10-24","6","7473","0","617","3.6","5"
"Worth","2020-10-25","4","7477","1","618","4.9","6.4"
"Worth","2020-10-26","45","7522","3","621","5.6","5.9"
"Worth","2020-10-27","30","7552","2","623","6.5","6.1"
"Worth","2020-10-28","43","7595","0","623","6.1","5.4"
"Worth","2020-10-29","66","7661","1","624","6.3","5.4"
"Worth","2020-10-30","33","7694","1","625","6.1","5.1"
"Worth","2020-10-31","18","7712","1","626","6.9","5.3"
"Worth","2020-11-01","11","7723","0","626","3.3","4.1"
"Worth","2020-11-02","24","7747","1","627","3","4.3"
"Worth","2020-11-03","42","7789","3","630","3.1","4.8"
"Worth","2020-11-04","23","7812","0","630","3.1","4.6"
"Worth","2020-11-05","27","7839","2","632","3.9","5.1"
"Worth","2020-11-06","19","7858","1","633","4.2","5.2"
"Worth","2020-11-07","8","7866","1","634","5.2","6.1"
"Worth","2020-11-08","9","7875","0","634","5.2","4.3"
"Worth","2020-11-09","29","7904","0","634","4.6","3.8"
"Worth","2020-11-10","29","7933","1","635","4.1","3.6"
"Worth","2020-11-11","40","7973","4","639","5.5","4.3"
"Worth","2020-11-12","56","8029","5","644","5.7","4.8"
"Worth","2020-11-13","27","8056","1","645","5.5","4.9"
"Worth","2020-11-14","16","8072","0","645","3.7","4.5"
"Worth","2020-11-15","14","8086","1","646","4.7","5"
"Worth","2020-11-16","30","8116","2","648","5.7","5.2"
"Worth","2020-11-17","33","8149","0","648","5.2","4.6"
"Worth","2020-11-18","36","8185","1","649","4.2","4.8"
"Worth","2020-11-19","31","8216","1","650","3.4","4.5"
"Worth","2020-11-20","31","8247","0","650","2.8","4.2"
"Worth","2020-11-21","14","8261","2","652","4.9","4.3"
"Worth","2020-11-22","18","8279","2","654","5.4","5.1"
"Worth","2020-11-23","48","8327","7","661","6.6","6.1"
"Worth","2020-11-24","37","8364","5","666","8.5","6.9"
"Worth","2020-11-25","43","8407","1","667","8.4","6.3"
"Worth","2020-11-26","14","8421","0","667","8","5.7"
"Worth","2020-11-27","15","8436","2","669","9.9","6.4"
"Worth","2020-11-28","20","8456","5","674","11.4","8.1"
"Worth","2020-11-29","19","8475","3","677","12.1","8.8"
"Worth","2020-11-30","66","8541","8","685","11.7","9.1"
"Worth","2020-12-01","51","8592","6","691","11.5","10"
"Worth","2020-12-02","43","8635","4","695","12.5","10.5"
"Worth","2020-12-03","42","8677","4","699","13.8","10.9"
"Worth","2020-12-04","46","8723","3","702","12.9","11.4"
"Worth","2020-12-05","11","8734","3","705","13.2","12.3"
"Worth","2020-12-06","17","8751","4","709","14.3","13.2"
"Worth","2020-12-07","38","8789","1","710","12.9","12.3"
"Worth","2020-12-08","46","8835","6","716","13.1","12.3"
"Worth","2020-12-09","67","8902","12","728","14.3","13.4"
"Worth","2020-12-10","50","8952","9","737","15.6","14.7"
"Worth","2020-12-11","58","9010","7","744","16.4","14.6"
"Worth","2020-12-12","22","9032","5","749","15.7","14.4"
"Worth","2020-12-13","18","9050","7","756","17.9","16.1"
"Worth","2020-12-14","62","9112","9","765","19.6","16.3"
"Worth","2020-12-15","58","9170","13","778","20.9","17"
"Worth","2020-12-16","50","9220","5","783","19.8","17.1"
"Worth","2020-12-17","45","9265","13","796","21.4","18.5"
"Worth","2020-12-18","39","9304","8","804","22.6","19.5"
"Worth","2020-12-19","25","9329","4","808","21.6","18.7"
"Worth","2020-12-20","30","9359","10","818","20.8","19.4"
"Worth","2020-12-21","56","9415","16","834","22.8","21.2"
"Worth","2020-12-22","43","9458","7","841","21.9","21.4"
"Worth","2020-12-23","45","9503","9","850","23.4","21.6"
"Worth","2020-12-24","26","9529","7","857","23.1","22.2"
"Worth","2020-12-25","9","9538","6","863","29.7","26.1"
"Worth","2020-12-26","22","9560","6","869","31.3","26.4"
"Worth","2020-12-27","21","9581","8","877","32","26.4"
"Worth","2020-12-28","55","9636","13","890","31.3","27"
"Worth","2020-12-29","73","9709","15","905","31.9","26.9"
"Worth","2020-12-30","97","9806","21","926","32.1","27.7"
"Worth","2020-12-31","58","9864","8","934","30.2","26.7"
"Worth","2021-01-01","12","9876","4","938","25.5","27.6"
"Worth","2021-01-02","29","9905","8","946","25.5","28.4"
"Worth","2021-01-03","31","9936","11","957","25.1","28.6"
"Worth","2021-01-04","83","10019","27","984","26.4","28.8"
"Worth","2021-01-05","45","10064","10","994","26.7","29.3"
"Worth","2021-01-06","57","10121","19","1013","28.3","30.2"
"Worth","2021-01-07","61","10182","9","1022","28.5","29.4"
"Worth","2021-01-08","42","10224","12","1034","27.8","26.6"
"Worth","2021-01-09","24","10248","12","1046","31","28.3"
"Worth","2021-01-10","17","10265","5","1051","30.1","27.6"
"Worth","2021-01-11","63","10328","13","1064","28.4","27.4"
"Worth","2021-01-12","53","10381","14","1078","29","27.8"
"Worth","2021-01-13","53","10434","12","1090","27.5","27.9"
"Worth","2021-01-14","55","10489","7","1097","27.2","27.8"
"Worth","2021-01-15","39","10528","8","1105","26","26.9"
"Worth","2021-01-16","19","10547","4","1109","21.9","26.4"
"Worth","2021-01-17","14","10561","3","1112","20.8","25.4"
"Worth","2021-01-18","33","10594","7","1119","20.9","24.6"
"Worth","2021-01-19","34","10628","6","1125","19.6","24.3"
"Worth","2021-01-20","45","10673","6","1131","18.3","22.9"
"Worth","2021-01-21","35","10708","7","1138","19.3","23.3"
"Worth","2021-01-22","40","10748","9","1147","19.6","22.8"
"Worth","2021-01-23","10","10758","1","1148","18","20"
"Worth","2021-01-24","15","10773","2","1150","16.9","18.8"
"Worth","2021-01-25","32","10805","3","1153","15.2","18"
"Worth","2021-01-26","36","10841","6","1159","15","17.3"
"Worth","2021-01-27","32","10873","1","1160","13.6","15.9"
"Worth","2021-01-28","40","10913","2","1162","11.4","15.4"
"Worth","2021-01-29","22","10935","2","1164","9.5","14.6"
"Worth","2021-01-30","15","10950","4","1168","11.9","15"
"Worth","2021-01-31","8","10958","1","1169","11.8","14.3"
"Worth","2021-02-01","30","10988","1","1170","10.9","13"
"Worth","2021-02-02","38","11026","4","1174","10","12.5"
"Worth","2021-02-03","21","11047","5","1179","13","13.3"
"Worth","2021-02-04","21","11068","3","1182","14.3","12.9"
"Worth","2021-02-05","29","11097","1","1183","13.5","11.5"
"Worth","2021-02-06","4","11101","1","1184","13.3","12.6"
"Worth","2021-02-07","6","11107","2","1186","16.2","14"
"Worth","2021-02-08","0","11107","0","1186","15.8","13.3"
