"county","collection_dt","ALL PCR tests performed","Running total of all PCR tests","All PCR positive tests","Running total of all PCR tests","7 day percent positive","14 day percent positive"
"Georgia","2020-02-01","0","0","0","0",".","."
"Georgia","2020-02-02","0","0","0","0",".","."
"Georgia","2020-02-03","1","1","1","1",".","."
"Georgia","2020-02-04","1","2","0","1",".","."
"Georgia","2020-02-05","1","3","0","1",".","."
"Georgia","2020-02-06","1","4","0","1",".","."
"Georgia","2020-02-07","1","5","0","1","14.3","."
"Georgia","2020-02-08","0","5","0","1","14.3","."
"Georgia","2020-02-09","0","5","0","1","14.3","."
"Georgia","2020-02-10","2","7","0","1","0","."
"Georgia","2020-02-11","0","7","0","1","0","."
"Georgia","2020-02-12","0","7","0","1","0","."
"Georgia","2020-02-13","1","8","0","1","0","."
"Georgia","2020-02-14","1","9","0","1","0","7.1"
"Georgia","2020-02-15","1","10","0","1","0","7.1"
"Georgia","2020-02-16","0","10","0","1","0","7.1"
"Georgia","2020-02-17","0","10","0","1","0","0"
"Georgia","2020-02-18","1","11","1","2","14.3","7.1"
"Georgia","2020-02-19","1","12","0","2","14.3","7.1"
"Georgia","2020-02-20","1","13","0","2","14.3","7.1"
"Georgia","2020-02-21","0","13","0","2","14.3","7.1"
"Georgia","2020-02-22","0","13","0","2","14.3","7.1"
"Georgia","2020-02-23","0","13","0","2","14.3","7.1"
"Georgia","2020-02-24","0","13","0","2","14.3","7.1"
"Georgia","2020-02-25","2","15","0","2","0","7.1"
"Georgia","2020-02-26","0","15","0","2","0","7.1"
"Georgia","2020-02-27","3","18","1","3","4.8","9.5"
"Georgia","2020-02-28","0","18","0","3","4.8","9.5"
"Georgia","2020-02-29","1","19","0","3","4.8","9.5"
"Georgia","2020-03-01","1","20","0","3","4.8","9.5"
"Georgia","2020-03-02","4","24","2","5","11.9","13.1"
"Georgia","2020-03-03","6","30","2","7","16.7","8.3"
"Georgia","2020-03-04","16","46","2","9","18.5","9.2"
"Georgia","2020-03-05","26","72","4","13","15.9","10.3"
"Georgia","2020-03-06","52","124","4","17","17","10.9"
"Georgia","2020-03-07","28","152","5","22","19.5","12.2"
"Georgia","2020-03-08","54","206","11","33","22.4","13.6"
"Georgia","2020-03-09","187","393","9","42","16","13.9"
"Georgia","2020-03-10","265","658","19","61","12.3","14.5"
"Georgia","2020-03-11","389","1047","49","110","12.3","15.4"
"Georgia","2020-03-12","674","1721","72","182","11.6","13.7"
"Georgia","2020-03-13","776","2497","149","331","13.2","15.1"
"Georgia","2020-03-14","376","2873","83","414","13.8","16.7"
"Georgia","2020-03-15","545","3418","118","532","14","18.2"
"Georgia","2020-03-16","1654","5072","220","752","15.2","15.6"
"Georgia","2020-03-17","2098","7170","287","1039","16.2","14.2"
"Georgia","2020-03-18","1920","9090","283","1322","16.5","14.4"
"Georgia","2020-03-19","2120","11210","308","1630","17","14.3"
"Georgia","2020-03-20","2387","13597","389","2019","16.6","14.9"
"Georgia","2020-03-21","895","14492","187","2206","16.4","15.1"
"Georgia","2020-03-22","915","15407","218","2424","16.8","15.4"
"Georgia","2020-03-23","3014","18421","615","3039","17.8","16.5"
"Georgia","2020-03-24","3344","21765","649","3688","18.6","17.4"
"Georgia","2020-03-25","3335","25100","645","4333","19.2","17.9"
"Georgia","2020-03-26","3145","28245","609","4942","19.9","18.5"
"Georgia","2020-03-27","3031","31276","646","5588","20.6","18.6"
"Georgia","2020-03-28","1134","32410","340","5928","21.9","19.2"
"Georgia","2020-03-29","954","33364","308","6236","23.2","20"
"Georgia","2020-03-30","3407","36771","752","6988","23.4","20.6"
"Georgia","2020-03-31","2855","39626","615","7603","23.7","21.1"
"Georgia","2020-04-01","3340","42966","677","8280","23.8","21.5"
"Georgia","2020-04-02","3284","46250","554","8834","23.5","21.7"
"Georgia","2020-04-03","3458","49708","640","9474","23.1","21.9"
"Georgia","2020-04-04","1650","51358","297","9771","21.4","21.7"
"Georgia","2020-04-05","860","52218","173","9944","19.6","21.4"
"Georgia","2020-04-06","4066","56284","733","10677","19","21.2"
"Georgia","2020-04-07","4698","60982","664","11341","18","20.8"
"Georgia","2020-04-08","4865","65847","687","12028","17.1","20.5"
"Georgia","2020-04-09","4590","70437","774","12802","17.1","20.3"
"Georgia","2020-04-10","5204","75641","900","13702","16.9","20"
"Georgia","2020-04-11","2467","78108","341","14043","16.3","18.9"
"Georgia","2020-04-12","966","79074","224","14267","16.8","18.2"
"Georgia","2020-04-13","4689","83763","786","15053","16.6","17.8"
"Georgia","2020-04-14","5610","89373","801","15854","16.6","17.3"
"Georgia","2020-04-15","5436","94809","712","16566","16.5","16.8"
"Georgia","2020-04-16","6332","101141","793","17359","15.9","16.5"
"Georgia","2020-04-17","6870","108011","804","18163","15.1","16"
"Georgia","2020-04-18","3524","111535","449","18612","14.9","15.6"
"Georgia","2020-04-19","2087","113622","421","19033","14.5","15.6"
"Georgia","2020-04-20","7994","121616","889","19922","13.7","15.1"
"Georgia","2020-04-21","8929","130545","917","20839","13.1","14.9"
"Georgia","2020-04-22","8723","139268","870","21709","12.6","14.6"
"Georgia","2020-04-23","6547","145815","654","22363","12.3","14.1"
"Georgia","2020-04-24","9497","155312","720","23083","11.7","13.4"
"Georgia","2020-04-25","4848","160160","348","23431","10.9","12.9"
"Georgia","2020-04-26","2124","162284","260","23691","9.8","12.1"
"Georgia","2020-04-27","8473","170757","901","24592","9.7","11.7"
"Georgia","2020-04-28","10115","180872","906","25498","9.5","11.3"
"Georgia","2020-04-29","10790","191662","887","26385","9.3","11"
"Georgia","2020-04-30","11172","202834","807","27192","8.9","10.6"
"Georgia","2020-05-01","10714","213548","886","28078","9","10.3"
"Georgia","2020-05-02","5695","219243","452","28530","9.1","10"
"Georgia","2020-05-03","3544","222787","289","28819","8.5","9.1"
"Georgia","2020-05-04","10928","233715","962","29781","8.2","9"
"Georgia","2020-05-05","9676","243391","588","30369","7.8","8.7"
"Georgia","2020-05-06","11027","254418","590","30959","7.4","8.3"
"Georgia","2020-05-07","9173","263591","597","31556","7.3","8.1"
"Georgia","2020-05-08","11784","275375","754","32310","7","8"
"Georgia","2020-05-09","6468","281843","403","32713","6.8","7.9"
"Georgia","2020-05-10","2277","284120","254","32967","7.2","7.9"
"Georgia","2020-05-11","13579","297699","833","33800","6.8","7.5"
"Georgia","2020-05-12","13715","311414","710","34510","6.7","7.3"
"Georgia","2020-05-13","12727","324141","679","35189","6.7","7.1"
"Georgia","2020-05-14","13486","337627","792","35981","6.6","7"
"Georgia","2020-05-15","15216","352843","930","36911","6.6","6.8"
"Georgia","2020-05-16","7326","360169","551","37462","6.8","6.8"
"Georgia","2020-05-17","3707","363876","306","37768","6.3","6.8"
"Georgia","2020-05-18","12603","376479","922","38690","6.5","6.7"
"Georgia","2020-05-19","14795","391274","923","39613","6.7","6.7"
"Georgia","2020-05-20","14401","405675","768","40381","6.7","6.7"
"Georgia","2020-05-21","13232","418907","762","41143","6.6","6.6"
"Georgia","2020-05-22","12949","431856","751","41894","6.6","6.6"
"Georgia","2020-05-23","6391","438247","441","42335","6.5","6.6"
"Georgia","2020-05-24","3343","441590","265","42600","6.5","6.4"
"Georgia","2020-05-25","3165","444755","205","42805","6.3","6.4"
"Georgia","2020-05-26","15601","460356","1100","43905","6.5","6.6"
"Georgia","2020-05-27","15083","475439","801","44706","6.5","6.6"
"Georgia","2020-05-28","14348","489787","742","45448","6.4","6.5"
"Georgia","2020-05-29","13134","502921","746","46194","6.4","6.5"
"Georgia","2020-05-30","6389","509310","417","46611","6.3","6.4"
"Georgia","2020-05-31","3381","512691","231","46842","6.1","6.3"
"Georgia","2020-06-01","13575","526266","938","47780","6.2","6.3"
"Georgia","2020-06-02","14187","540453","913","48693","6.1","6.3"
"Georgia","2020-06-03","15086","555539","902","49595","6.2","6.3"
"Georgia","2020-06-04","14547","570086","878","50473","6.3","6.4"
"Georgia","2020-06-05","13148","583234","818","51291","6.4","6.4"
"Georgia","2020-06-06","7721","590955","515","51806","6.4","6.4"
"Georgia","2020-06-07","3524","594479","336","52142","6.8","6.5"
"Georgia","2020-06-08","14858","609337","1082","53224","6.9","6.5"
"Georgia","2020-06-09","14602","623939","907","54131","6.8","6.5"
"Georgia","2020-06-10","15319","639258","1157","55288","7.1","6.6"
"Georgia","2020-06-11","16680","655938","1174","56462","7.2","6.8"
"Georgia","2020-06-12","14469","670407","953","57415","7.3","6.8"
"Georgia","2020-06-13","7480","677887","658","58073","7.6","7"
"Georgia","2020-06-14","4043","681930","420","58493","7.7","7.3"
"Georgia","2020-06-15","17923","699853","1460","59953","7.8","7.3"
"Georgia","2020-06-16","18059","717912","1439","61392","8.1","7.5"
"Georgia","2020-06-17","16904","734816","1703","63095","8.4","7.8"
"Georgia","2020-06-18","17703","752519","1768","64863","8.8","8"
"Georgia","2020-06-19","18419","770938","1805","66668","9.3","8.3"
"Georgia","2020-06-20","9640","780578","1180","67848","9.8","8.7"
"Georgia","2020-06-21","3904","784482","562","68410","10.4","9"
"Georgia","2020-06-22","24444","808926","3109","71519","11","9.4"
"Georgia","2020-06-23","22435","831361","2584","74103","11.5","9.8"
"Georgia","2020-06-24","22983","854344","2769","76872","11.8","10.1"
"Georgia","2020-06-25","25411","879755","3195","80067","12.2","10.5"
"Georgia","2020-06-26","27949","907704","3122","83189","12.4","10.8"
"Georgia","2020-06-27","14126","921830","1896","85085","12.5","11.2"
"Georgia","2020-06-28","5816","927646","999","86084","12.9","11.7"
"Georgia","2020-06-29","32228","959874","4025","90109","12.9","12"
"Georgia","2020-06-30","33335","993209","4188","94297","13.1","12.3"
"Georgia","2020-07-01","31871","1025080","3915","98212","13.1","12.5"
"Georgia","2020-07-02","33775","1058855","4085","102297","13","12.6"
"Georgia","2020-07-03","14562","1073417","2166","104463","13.6","13"
"Georgia","2020-07-04","5479","1078896","904","105367","14","13.3"
"Georgia","2020-07-05","6325","1085221","1230","106597","14.3","13.6"
"Georgia","2020-07-06","35659","1120880","5426","112023","14.7","13.8"
"Georgia","2020-07-07","35780","1156660","4804","116827","14.8","13.9"
"Georgia","2020-07-08","35798","1192458","4764","121591","15","14"
"Georgia","2020-07-09","35578","1228036","4657","126248","15.1","14.1"
"Georgia","2020-07-10","34564","1262600","4514","130762","14.9","14.2"
"Georgia","2020-07-11","14636","1277236","2464","133226","14.9","14.5"
"Georgia","2020-07-12","7927","1285163","1471","134697","14.8","14.6"
"Georgia","2020-07-13","35179","1320342","5189","139886","14.7","14.7"
"Georgia","2020-07-14","34002","1354344","4714","144600","14.8","14.8"
"Georgia","2020-07-15","33877","1388221","4525","149125","14.8","14.9"
"Georgia","2020-07-16","36604","1424825","4698","153823","14.8","14.9"
"Georgia","2020-07-17","31201","1456026","3922","157745","14.7","14.8"
"Georgia","2020-07-18","14306","1470332","2092","159837","14.4","14.6"
"Georgia","2020-07-19","7481","1477813","1199","161036","14","14.4"
"Georgia","2020-07-20","33690","1511503","4746","165782","13.9","14.3"
"Georgia","2020-07-21","29601","1541104","3881","169663","13.8","14.3"
"Georgia","2020-07-22","31460","1572564","3919","173582","13.7","14.2"
"Georgia","2020-07-23","32283","1604847","3944","177526","13.6","14.2"
"Georgia","2020-07-24","30146","1634993","3815","181341","13.6","14.1"
"Georgia","2020-07-25","15405","1650398","2264","183605","13.6","14"
"Georgia","2020-07-26","6304","1656702","1068","184673","13.7","13.9"
"Georgia","2020-07-27","34221","1690923","4199","188872","13.5","13.7"
"Georgia","2020-07-28","29530","1720453","3638","192510","13.4","13.6"
"Georgia","2020-07-29","29888","1750341","3711","196221","13.4","13.5"
"Georgia","2020-07-30","29558","1779899","3665","199886","13.4","13.5"
"Georgia","2020-07-31","28885","1808784","3184","203070","13.2","13.4"
"Georgia","2020-08-01","14858","1823642","1966","205036","12.9","13.3"
"Georgia","2020-08-02","6399","1830041","996","206032","12.7","13.2"
"Georgia","2020-08-03","27877","1857918","2960","208992","12.5","13"
"Georgia","2020-08-04","28681","1886599","3330","212322","12.4","12.9"
"Georgia","2020-08-05","29959","1916558","3417","215739","12.3","12.8"
"Georgia","2020-08-06","28048","1944606","3029","218768","12","12.7"
"Georgia","2020-08-07","28037","1972643","2799","221567","11.9","12.5"
"Georgia","2020-08-08","14656","1987299","1456","223023","11.4","12.2"
"Georgia","2020-08-09","7352","1994651","1006","224029","11.1","11.9"
"Georgia","2020-08-10","29542","2024193","3107","227136","11.1","11.8"
"Georgia","2020-08-11","26794","2050987","2648","229784","10.9","11.6"
"Georgia","2020-08-12","26383","2077370","2493","232277","10.6","11.4"
"Georgia","2020-08-13","25505","2102875","2182","234459","10.3","11.2"
"Georgia","2020-08-14","27880","2130755","2282","236741","10","11"
"Georgia","2020-08-15","11633","2142388","1201","237942","10.1","10.8"
"Georgia","2020-08-16","9582","2151970","1055","238997","9.7","10.4"
"Georgia","2020-08-17","19753","2171723","1809","240806","9.5","10.3"
"Georgia","2020-08-18","24802","2196525","2219","243025","9.4","10.1"
"Georgia","2020-08-19","26918","2223443","2238","245263","9.2","9.9"
"Georgia","2020-08-20","24084","2247527","2008","247271","9.2","9.7"
"Georgia","2020-08-21","26312","2273839","2070","249341","9.1","9.6"
"Georgia","2020-08-22","12901","2286740","1096","250437","8.9","9.5"
"Georgia","2020-08-23","6448","2293188","710","251147","8.9","9.3"
"Georgia","2020-08-24","25421","2318609","2302","253449","8.9","9.2"
"Georgia","2020-08-25","23444","2342053","1955","255404","8.8","9.1"
"Georgia","2020-08-26","26438","2368491","2250","257654","8.8","9"
"Georgia","2020-08-27","24539","2393030","1941","259595","8.7","9"
"Georgia","2020-08-28","25122","2418152","2060","261655","8.8","9"
"Georgia","2020-08-29","12170","2430322","1041","262696","8.8","8.8"
"Georgia","2020-08-30","6774","2437096","788","263484","8.9","8.9"
"Georgia","2020-08-31","24651","2461747","2153","265637","8.8","8.9"
"Georgia","2020-09-01","24025","2485772","1949","267586","8.8","8.8"
"Georgia","2020-09-02","24731","2510503","1953","269539","8.7","8.8"
"Georgia","2020-09-03","23424","2533927","1842","271381","8.7","8.7"
"Georgia","2020-09-04","23551","2557478","1911","273292","8.7","8.7"
"Georgia","2020-09-05","11533","2569011","816","274108","8.5","8.6"
"Georgia","2020-09-06","5950","2574961","578","274686","8.2","8.6"
"Georgia","2020-09-07","7255","2582216","675","275361","8.3","8.6"
"Georgia","2020-09-08","26256","2608472","2102","277463","8.3","8.5"
"Georgia","2020-09-09","25487","2633959","1883","279346","8.2","8.5"
"Georgia","2020-09-10","25015","2658974","1765","281111","8.1","8.4"
"Georgia","2020-09-11","23723","2682697","1617","282728","7.9","8.3"
"Georgia","2020-09-12","10448","2693145","802","283530","8","8.2"
"Georgia","2020-09-13","5623","2698768","591","284121","8.1","8.2"
"Georgia","2020-09-14","25064","2723832","1740","285861","7.8","8"
"Georgia","2020-09-15","23104","2746936","1497","287358","7.6","7.9"
"Georgia","2020-09-16","23248","2770184","1275","288633","7.3","7.7"
"Georgia","2020-09-17","18987","2789171","1135","289768","7.1","7.6"
"Georgia","2020-09-18","23247","2812418","1354","291122","7","7.4"
"Georgia","2020-09-19","12048","2824466","774","291896","6.8","7.4"
"Georgia","2020-09-20","4879","2829345","417","292313","6.5","7.3"
"Georgia","2020-09-21","23224","2852569","1445","293758","6.4","7.1"
"Georgia","2020-09-22","21559","2874128","1272","295030","6.3","6.9"
"Georgia","2020-09-23","22698","2896826","1323","296353","6.4","6.8"
"Georgia","2020-09-24","21406","2918232","1198","297551","6.3","6.7"
"Georgia","2020-09-25","21658","2939890","1210","298761","6.3","6.6"
"Georgia","2020-09-26","8869","2948759","670","299431","6.5","6.6"
"Georgia","2020-09-27","4762","2953521","385","299816","6.4","6.5"
"Georgia","2020-09-28","22218","2975739","1294","301110","6.3","6.4"
"Georgia","2020-09-29","21346","2997085","1105","302215","6.2","6.3"
"Georgia","2020-09-30","22334","3019419","1236","303451","6.2","6.3"
"Georgia","2020-10-01","24016","3043435","1174","304625","6.1","6.2"
"Georgia","2020-10-02","22856","3066291","1209","305834","6.1","6.2"
"Georgia","2020-10-03","12334","3078625","714","306548","5.8","6.1"
"Georgia","2020-10-04","6114","3084739","434","306982","5.7","6"
"Georgia","2020-10-05","25843","3110582","1521","308503","5.7","6"
"Georgia","2020-10-06","27421","3138003","1326","309829","5.6","5.9"
"Georgia","2020-10-07","28354","3166357","1375","311204","5.5","5.9"
"Georgia","2020-10-08","24967","3191324","1385","312589","5.6","5.9"
"Georgia","2020-10-09","25198","3216522","1310","313899","5.6","5.8"
"Georgia","2020-10-10","11716","3228238","738","314637","5.7","5.7"
"Georgia","2020-10-11","5513","3233751","468","315105","5.9","5.8"
"Georgia","2020-10-12","19258","3253009","1232","316337","5.9","5.8"
"Georgia","2020-10-13","25901","3278910","1541","317878","6.1","5.9"
"Georgia","2020-10-14","23660","3302570","1351","319229","6.2","5.9"
"Georgia","2020-10-15","23743","3326313","1475","320704","6.3","6"
"Georgia","2020-10-16","23320","3349633","1459","322163","6.5","6"
"Georgia","2020-10-17","11370","3361003","743","322906","6.5","6.1"
"Georgia","2020-10-18","5257","3366260","469","323375","6.6","6.2"
"Georgia","2020-10-19","26120","3392380","1710","325085","6.6","6.3"
"Georgia","2020-10-20","24283","3416663","1529","326614","6.6","6.4"
"Georgia","2020-10-21","27246","3443909","1712","328326","6.7","6.5"
"Georgia","2020-10-22","23327","3467236","1658","329984","6.8","6.6"
"Georgia","2020-10-23","25154","3492390","1629","331613","6.9","6.7"
"Georgia","2020-10-24","12098","3504488","967","332580","7.1","6.8"
"Georgia","2020-10-25","7170","3511658","678","333258","7.2","6.9"
"Georgia","2020-10-26","27340","3538998","1958","335216","7.3","6.9"
"Georgia","2020-10-27","26210","3565208","1679","336895","7.3","7"
"Georgia","2020-10-28","27901","3593109","1817","338712","7.3","7"
"Georgia","2020-10-29","20019","3613128","1413","340125","7.3","7.1"
"Georgia","2020-10-30","26755","3639883","1754","341879","7.3","7.1"
"Georgia","2020-10-31","12644","3652527","1035","342914","7.3","7.2"
"Georgia","2020-11-01","6970","3659497","735","343649","7.5","7.3"
"Georgia","2020-11-02","29040","3688537","2178","345827","7.5","7.4"
"Georgia","2020-11-03","24447","3712984","1687","347514","7.6","7.4"
"Georgia","2020-11-04","26314","3739298","1863","349377","7.7","7.5"
"Georgia","2020-11-05","27730","3767028","1821","351198","7.6","7.5"
"Georgia","2020-11-06","27457","3794485","1905","353103","7.7","7.5"
"Georgia","2020-11-07","13983","3808468","1380","354483","7.9","7.6"
"Georgia","2020-11-08","7434","3815902","838","355321","8","7.8"
"Georgia","2020-11-09","30541","3846443","2737","358058","8.2","7.9"
"Georgia","2020-11-10","31302","3877745","2470","360528","8.4","8"
"Georgia","2020-11-11","25706","3903451","2068","362596","8.5","8.1"
"Georgia","2020-11-12","32709","3936160","2669","365265","8.7","8.2"
"Georgia","2020-11-13","33313","3969473","2508","367773","8.8","8.2"
"Georgia","2020-11-14","17226","3986699","1583","369356","8.7","8.3"
"Georgia","2020-11-15","8460","3995159","979","370335","8.8","8.4"
"Georgia","2020-11-16","36254","4031413","3090","373425","8.7","8.5"
"Georgia","2020-11-17","36277","4067690","2681","376106","8.6","8.5"
"Georgia","2020-11-18","39782","4107472","2669","378775","8.4","8.5"
"Georgia","2020-11-19","40052","4147524","2768","381543","8.3","8.5"
"Georgia","2020-11-20","40513","4188037","2734","384277","8.1","8.5"
"Georgia","2020-11-21","20988","4209025","1618","385895","7.9","8.3"
"Georgia","2020-11-22","10754","4219779","988","386883","7.6","8.2"
"Georgia","2020-11-23","42942","4262721","3277","390160","7.5","8.1"
"Georgia","2020-11-24","37351","4300072","3162","393322","7.6","8.1"
"Georgia","2020-11-25","33379","4333451","3197","396519","8","8.2"
"Georgia","2020-11-26","5597","4339048","459","396978","8.2","8.2"
"Georgia","2020-11-27","18625","4357673","2504","399482","9.2","8.7"
"Georgia","2020-11-28","14722","4372395","2267","401749","10.3","9.1"
"Georgia","2020-11-29","11036","4383431","1668","403417","11.1","9.4"
"Georgia","2020-11-30","41485","4424916","5169","408586","11.8","9.6"
"Georgia","2020-12-01","37930","4462846","4572","413158","12.3","10"
"Georgia","2020-12-02","39094","4501940","4506","417664","12.6","10.3"
"Georgia","2020-12-03","37292","4539232","4461","422125","13.1","10.7"
"Georgia","2020-12-04","37072","4576304","4290","426415","12.9","11"
"Georgia","2020-12-05","20341","4596645","2762","429177","12.6","11.4"
"Georgia","2020-12-06","10247","4606892","1640","430817","12.7","11.9"
"Georgia","2020-12-07","41340","4648232","5250","436067","12.8","12.3"
"Georgia","2020-12-08","40592","4688824","4982","441049","12.8","12.6"
"Georgia","2020-12-09","41787","4730611","4977","446026","12.9","12.7"
"Georgia","2020-12-10","40469","4771080","5190","451216","13","13.1"
"Georgia","2020-12-11","41462","4812542","5168","456384","13.1","13"
"Georgia","2020-12-12","22926","4835468","3404","459788","13.3","12.9"
"Georgia","2020-12-13","10943","4846411","2097","461885","13.7","13.2"
"Georgia","2020-12-14","48327","4894738","6784","468669","13.9","13.4"
"Georgia","2020-12-15","48159","4942897","6595","475264","14.1","13.5"
"Georgia","2020-12-16","46423","4989320","5973","481237","14.3","13.6"
"Georgia","2020-12-17","49316","5038636","6619","487856","14.4","13.7"
"Georgia","2020-12-18","47789","5086425","6256","494112","14.4","13.8"
"Georgia","2020-12-19","25794","5112219","3765","497877","14.4","13.8"
"Georgia","2020-12-20","13768","5125987","2586","500463","14.4","14"
"Georgia","2020-12-21","53255","5179242","7897","508360","14.5","14.2"
"Georgia","2020-12-22","50564","5229806","7560","515920","14.6","14.4"
"Georgia","2020-12-23","46987","5276793","6804","522724","14.9","14.6"
"Georgia","2020-12-24","22108","5298901","3839","526563","15.4","14.9"
"Georgia","2020-12-25","4027","5302928","813","527376","16.5","15.5"
"Georgia","2020-12-26","20068","5322996","4569","531945","17.6","16"
"Georgia","2020-12-27","13507","5336503","3390","535335","18.5","16.4"
"Georgia","2020-12-28","51958","5388461","9811","545146","19.1","16.8"
"Georgia","2020-12-29","48721","5437182","9695","554841","19.8","17.2"
"Georgia","2020-12-30","49540","5486722","8990","563831","20.3","17.6"
"Georgia","2020-12-31","35959","5522681","6436","570267","20.4","17.9"
"Georgia","2021-01-01","6685","5529366","1655","571922","21.1","18.8"
"Georgia","2021-01-02","20090","5549456","4422","576344","21","19.3"
"Georgia","2021-01-03","11531","5560987","2928","579272","21","19.8"
"Georgia","2021-01-04","49056","5610043","9981","589253","21.2","20.2"
"Georgia","2021-01-05","65418","5675461","12190","601443","21","20.4"
"Georgia","2021-01-06","52849","5728310","9279","610722","20.9","20.6"
"Georgia","2021-01-07","52144","5780454","9712","620434","21","20.7"
"Georgia","2021-01-08","43351","5823805","7517","627951","20","20.5"
"Georgia","2021-01-09","24602","5848407","4998","632949","19.7","20.4"
"Georgia","2021-01-10","13654","5862061","3061","636010","19.3","20.2"
"Georgia","2021-01-11","45448","5907509","7757","643767","18.9","20"
"Georgia","2021-01-12","48206","5955715","7587","651354","18.4","19.7"
"Georgia","2021-01-13","44597","6000312","6633","657987","18.1","19.5"
"Georgia","2021-01-14","44364","6044676","6741","664728","17.6","19.3"
"Georgia","2021-01-15","41264","6085940","6468","671196","17.3","18.7"
"Georgia","2021-01-16","22087","6108027","4206","675402","17.1","18.4"
"Georgia","2021-01-17","12646","6120673","2670","678072","17","18.1"
"Georgia","2021-01-18","32396","6153069","5165","683237","16.8","17.8"
"Georgia","2021-01-19","43996","6197065","6199","689436","16.6","17.5"
"Georgia","2021-01-20","41030","6238095","5469","694905","16.3","17.2"
"Georgia","2021-01-21","38859","6276954","5517","700422","16.2","16.9"
"Georgia","2021-01-22","37643","6314597","4976","705398","15.8","16.6"
"Georgia","2021-01-23","17613","6332210","3058","708456","15.6","16.4"
"Georgia","2021-01-24","8038","6340248","1626","710082","15.5","16.2"
"Georgia","2021-01-25","17034","6357282","2452","712534","15.3","16"
"Georgia","2021-01-26","1450","6358732","206","712740","15.3","15.9"
"Georgia","2021-01-27","0","6358732","0","712740","13.4","14.9"
"Appling","2020-02-01","0","0","0","0",".","."
"Appling","2020-02-02","0","0","0","0",".","."
"Appling","2020-02-03","0","0","0","0",".","."
"Appling","2020-02-04","0","0","0","0",".","."
"Appling","2020-02-05","0","0","0","0",".","."
"Appling","2020-02-06","0","0","0","0",".","."
"Appling","2020-02-07","0","0","0","0","0","."
"Appling","2020-02-08","0","0","0","0","0","."
"Appling","2020-02-09","0","0","0","0","0","."
"Appling","2020-02-10","0","0","0","0","0","."
"Appling","2020-02-11","0","0","0","0","0","."
"Appling","2020-02-12","0","0","0","0","0","."
"Appling","2020-02-13","0","0","0","0","0","."
"Appling","2020-02-14","0","0","0","0","0","0"
"Appling","2020-02-15","0","0","0","0","0","0"
"Appling","2020-02-16","0","0","0","0","0","0"
"Appling","2020-02-17","0","0","0","0","0","0"
"Appling","2020-02-18","0","0","0","0","0","0"
"Appling","2020-02-19","0","0","0","0","0","0"
"Appling","2020-02-20","0","0","0","0","0","0"
"Appling","2020-02-21","0","0","0","0","0","0"
"Appling","2020-02-22","0","0","0","0","0","0"
"Appling","2020-02-23","0","0","0","0","0","0"
"Appling","2020-02-24","0","0","0","0","0","0"
"Appling","2020-02-25","0","0","0","0","0","0"
"Appling","2020-02-26","0","0","0","0","0","0"
"Appling","2020-02-27","0","0","0","0","0","0"
"Appling","2020-02-28","0","0","0","0","0","0"
"Appling","2020-02-29","0","0","0","0","0","0"
"Appling","2020-03-01","0","0","0","0","0","0"
"Appling","2020-03-02","0","0","0","0","0","0"
"Appling","2020-03-03","0","0","0","0","0","0"
"Appling","2020-03-04","0","0","0","0","0","0"
"Appling","2020-03-05","0","0","0","0","0","0"
"Appling","2020-03-06","0","0","0","0","0","0"
"Appling","2020-03-07","0","0","0","0","0","0"
"Appling","2020-03-08","0","0","0","0","0","0"
"Appling","2020-03-09","0","0","0","0","0","0"
"Appling","2020-03-10","0","0","0","0","0","0"
"Appling","2020-03-11","0","0","0","0","0","0"
"Appling","2020-03-12","0","0","0","0","0","0"
"Appling","2020-03-13","1","1","0","0","0","0"
"Appling","2020-03-14","0","1","0","0","0","0"
"Appling","2020-03-15","0","1","0","0","0","0"
"Appling","2020-03-16","3","4","0","0","0","0"
"Appling","2020-03-17","3","7","0","0","0","0"
"Appling","2020-03-18","3","10","0","0","0","0"
"Appling","2020-03-19","3","13","0","0","0","0"
"Appling","2020-03-20","2","15","0","0","0","0"
"Appling","2020-03-21","1","16","0","0","0","0"
"Appling","2020-03-22","1","17","0","0","0","0"
"Appling","2020-03-23","1","18","0","0","0","0"
"Appling","2020-03-24","4","22","0","0","0","0"
"Appling","2020-03-25","6","28","0","0","0","0"
"Appling","2020-03-26","3","31","0","0","0","0"
"Appling","2020-03-27","2","33","1","1","7.1","3.6"
"Appling","2020-03-28","3","36","2","3","16.7","8.3"
"Appling","2020-03-29","0","36","0","3","16.7","8.3"
"Appling","2020-03-30","8","44","2","5","20.2","10.1"
"Appling","2020-03-31","5","49","1","6","23.1","11.5"
"Appling","2020-04-01","4","53","0","6","23.1","11.5"
"Appling","2020-04-02","3","56","0","6","23.1","11.5"
"Appling","2020-04-03","1","57","1","7","30.2","18.7"
"Appling","2020-04-04","0","57","0","7","20.7","18.7"
"Appling","2020-04-05","2","59","0","7","20.7","18.7"
"Appling","2020-04-06","7","66","1","8","19.2","19.7"
"Appling","2020-04-07","5","71","0","8","16.3","19.7"
"Appling","2020-04-08","5","76","2","10","22","22.6"
"Appling","2020-04-09","1","77","0","10","22","22.6"
"Appling","2020-04-10","1","78","0","10","7.8","19"
"Appling","2020-04-11","3","81","3","13","22","21.4"
"Appling","2020-04-12","0","81","0","13","22","21.4"
"Appling","2020-04-13","10","91","5","18","27.1","23.2"
"Appling","2020-04-14","3","94","1","19","31.9","24.1"
"Appling","2020-04-15","4","98","0","19","26.2","24.1"
"Appling","2020-04-16","4","102","0","19","26.2","24.1"
"Appling","2020-04-17","57","159","47","66","38","22.9"
"Appling","2020-04-18","1","160","0","66","23.7","22.9"
"Appling","2020-04-19","0","160","0","66","23.7","22.9"
"Appling","2020-04-20","5","165","1","67","19.4","23.3"
"Appling","2020-04-21","3","168","0","67","14.6","23.3"
"Appling","2020-04-22","54","222","12","79","17.8","22"
"Appling","2020-04-23","80","302","0","79","17.8","22"
"Appling","2020-04-24","2","304","1","80","13.2","25.6"
"Appling","2020-04-25","6","310","0","80","13.2","18.4"
"Appling","2020-04-26","1","311","0","80","13.2","18.4"
"Appling","2020-04-27","10","321","0","80","10.3","14.9"
"Appling","2020-04-28","5","326","1","81","13.2","13.9"
"Appling","2020-04-29","6","332","0","81","10","13.9"
"Appling","2020-04-30","13","345","1","82","11.1","14.5"
"Appling","2020-05-01","5","350","0","82","4","8.6"
"Appling","2020-05-02","2","352","0","82","4","8.6"
"Appling","2020-05-03","0","352","0","82","4","8.6"
"Appling","2020-05-04","8","360","0","82","4","7.1"
"Appling","2020-05-05","7","367","0","82","1.1","7.1"
"Appling","2020-05-06","4","371","0","82","1.1","5.5"
"Appling","2020-05-07","8","379","0","82","0","5.5"
"Appling","2020-05-08","7","386","2","84","4.1","4"
"Appling","2020-05-09","3","389","0","84","4.1","4"
"Appling","2020-05-10","1","390","1","85","18.4","11.2"
"Appling","2020-05-11","7","397","0","85","18.4","11.2"
"Appling","2020-05-12","7","404","0","85","18.4","9.7"
"Appling","2020-05-13","7","411","2","87","22.4","11.8"
"Appling","2020-05-14","8","419","0","87","22.4","11.2"
"Appling","2020-05-15","4","423","3","90","29.1","16.6"
"Appling","2020-05-16","1","424","0","90","29.1","16.6"
"Appling","2020-05-17","1","425","1","91","29.1","23.7"
"Appling","2020-05-18","5","430","1","92","31.9","25.2"
"Appling","2020-05-19","13","443","2","94","34.1","26.3"
"Appling","2020-05-20","11","454","2","96","32.7","27.6"
"Appling","2020-05-21","38","492","2","98","33.4","27.9"
"Appling","2020-05-22","30","522","1","99","23.2","26.1"
"Appling","2020-05-23","2","524","1","100","30.3","29.7"
"Appling","2020-05-24","4","528","0","100","16","22.6"
"Appling","2020-05-25","2","530","0","100","13.2","22.6"
"Appling","2020-05-26","28","558","5","105","13.5","23.8"
"Appling","2020-05-27","5","563","0","105","10.9","21.8"
"Appling","2020-05-28","10","573","1","106","11.6","22.5"
"Appling","2020-05-29","3","576","0","106","11.1","17.1"
"Appling","2020-05-30","2","578","1","107","11.1","20.7"
"Appling","2020-05-31","0","578","0","107","11.1","13.6"
"Appling","2020-06-01","23","601","5","112","14.2","13.7"
"Appling","2020-06-02","8","609","5","117","20.6","17.1"
"Appling","2020-06-03","5","614","3","120","29.2","20"
"Appling","2020-06-04","11","625","4","124","32.9","22.3"
"Appling","2020-06-05","5","630","0","124","32.9","22"
"Appling","2020-06-06","0","630","0","124","25.8","18.5"
"Appling","2020-06-07","2","632","0","124","25.8","18.5"
"Appling","2020-06-08","6","638","1","125","25.1","19.7"
"Appling","2020-06-09","6","644","2","127","20.9","20.8"
"Appling","2020-06-10","10","654","2","129","15.2","22.2"
"Appling","2020-06-11","12","666","1","130","11.2","22.1"
"Appling","2020-06-12","5","671","1","131","14","23.5"
"Appling","2020-06-13","2","673","0","131","14","19.9"
"Appling","2020-06-14","5","678","1","132","16.9","21.4"
"Appling","2020-06-15","14","692","3","135","17.6","21.3"
"Appling","2020-06-16","14","706","3","138","15.9","18.4"
"Appling","2020-06-17","7","713","1","139","15.1","15.1"
"Appling","2020-06-18","12","725","0","139","13.9","12.5"
"Appling","2020-06-19","9","734","2","141","14.2","14.1"
"Appling","2020-06-20","4","738","2","143","21.3","17.7"
"Appling","2020-06-21","1","739","1","144","32.8","24.8"
"Appling","2020-06-22","19","758","2","146","31.2","24.4"
"Appling","2020-06-23","11","769","3","149","32","24"
"Appling","2020-06-24","34","803","2","151","30.8","23"
"Appling","2020-06-25","22","825","3","154","32.8","23.3"
"Appling","2020-06-26","30","855","1","155","30.1","22.1"
"Appling","2020-06-27","13","868","2","157","25.1","23.2"
"Appling","2020-06-28","9","877","1","158","12.4","22.6"
"Appling","2020-06-29","40","917","5","163","12.7","22"
"Appling","2020-06-30","30","947","9","172","13.1","22.6"
"Appling","2020-07-01","31","978","7","179","15.5","23.2"
"Appling","2020-07-02","34","1012","3","182","14.8","23.8"
"Appling","2020-07-03","22","1034","5","187","17.6","23.8"
"Appling","2020-07-04","10","1044","1","188","16.8","21"
"Appling","2020-07-05","12","1056","3","191","18.8","15.6"
"Appling","2020-07-06","60","1116","14","205","20.4","16.5"
"Appling","2020-07-07","37","1153","10","215","19.9","16.5"
"Appling","2020-07-08","32","1185","6","221","19.4","17.4"
"Appling","2020-07-09","30","1215","10","231","22.9","18.9"
"Appling","2020-07-10","38","1253","8","239","22.6","20.1"
"Appling","2020-07-11","25","1278","4","243","23.5","20.2"
"Appling","2020-07-12","8","1286","2","245","23.5","21.2"
"Appling","2020-07-13","38","1324","7","252","22.8","21.6"
"Appling","2020-07-14","48","1372","14","266","23.1","21.5"
"Appling","2020-07-15","35","1407","6","272","22.9","21.1"
"Appling","2020-07-16","38","1445","7","279","20.7","21.8"
"Appling","2020-07-17","22","1467","2","281","19","20.8"
"Appling","2020-07-18","8","1475","3","284","22.1","22.8"
"Appling","2020-07-19","5","1480","2","286","24.2","23.9"
"Appling","2020-07-20","18","1498","5","291","25.6","24.2"
"Appling","2020-07-21","40","1538","6","297","23.6","23.3"
"Appling","2020-07-22","39","1577","9","306","24.4","23.6"
"Appling","2020-07-23","21","1598","8","314","27.2","24"
"Appling","2020-07-24","18","1616","3","317","28.3","23.7"
"Appling","2020-07-25","13","1629","2","319","25.1","23.6"
"Appling","2020-07-26","8","1637","2","321","23","23.6"
"Appling","2020-07-27","26","1663","9","330","24","24.8"
"Appling","2020-07-28","21","1684","5","335","25.2","24.4"
"Appling","2020-07-29","34","1718","5","340","24","24.2"
"Appling","2020-07-30","25","1743","3","343","20.3","23.8"
"Appling","2020-07-31","16","1759","4","347","21.5","24.9"
"Appling","2020-08-01","6","1765","1","348","21.7","23.4"
"Appling","2020-08-02","9","1774","1","349","19.7","21.4"
"Appling","2020-08-03","37","1811","7","356","17.5","20.7"
"Appling","2020-08-04","23","1834","4","360","16.5","20.9"
"Appling","2020-08-05","33","1867","10","370","18.8","21.4"
"Appling","2020-08-06","37","1904","11","381","21.3","20.8"
"Appling","2020-08-07","21","1925","4","385","20.5","21"
"Appling","2020-08-08","5","1930","1","386","20.9","21.3"
"Appling","2020-08-09","4","1934","0","386","19.3","19.5"
"Appling","2020-08-10","39","1973","9","395","19.9","18.7"
"Appling","2020-08-11","29","2002","9","404","21.9","19.2"
"Appling","2020-08-12","22","2024","4","408","20.2","19.5"
"Appling","2020-08-13","28","2052","5","413","18.5","19.9"
"Appling","2020-08-14","37","2089","5","418","17.7","19.1"
"Appling","2020-08-15","10","2099","2","420","17.7","19.3"
"Appling","2020-08-16","8","2107","3","423","23","21.2"
"Appling","2020-08-17","43","2150","8","431","22.4","21.2"
"Appling","2020-08-18","49","2199","6","437","19.7","20.8"
"Appling","2020-08-19","33","2232","5","442","19.3","19.7"
"Appling","2020-08-20","35","2267","5","447","18.8","18.6"
"Appling","2020-08-21","35","2302","4","451","18.5","18.1"
"Appling","2020-08-22","13","2315","0","451","15.6","16.6"
"Appling","2020-08-23","5","2320","0","451","10.2","16.6"
"Appling","2020-08-24","70","2390","9","460","9.4","15.9"
"Appling","2020-08-25","42","2432","5","465","9.4","14.5"
"Appling","2020-08-26","50","2482","5","470","8.6","14"
"Appling","2020-08-27","42","2524","3","473","7.6","13.2"
"Appling","2020-08-28","19","2543","3","476","8.2","13.4"
"Appling","2020-08-29","10","2553","1","477","9.7","12.6"
"Appling","2020-08-30","6","2559","0","477","9.7","10"
"Appling","2020-08-31","43","2602","8","485","10.5","10"
"Appling","2020-09-01","41","2643","6","491","10.9","10.1"
"Appling","2020-09-02","22","2665","4","495","12.1","10.3"
"Appling","2020-09-03","43","2708","3","498","12","9.8"
"Appling","2020-09-04","38","2746","5","503","11.7","9.9"
"Appling","2020-09-05","9","2755","1","504","11.8","10.7"
"Appling","2020-09-06","13","2768","0","504","11.8","10.7"
"Appling","2020-09-07","11","2779","2","506","11.7","11.1"
"Appling","2020-09-08","49","2828","1","507","10","10.4"
"Appling","2020-09-09","47","2875","5","512","8.9","10.5"
"Appling","2020-09-10","28","2903","1","513","8.4","10.2"
"Appling","2020-09-11","12","2915","2","515","8.9","10.3"
"Appling","2020-09-12","7","2922","0","515","7.3","9.6"
"Appling","2020-09-13","8","2930","3","518","12.7","12.2"
"Appling","2020-09-14","37","2967","7","525","12.8","12.3"
"Appling","2020-09-15","11","2978","0","525","12.5","11.2"
"Appling","2020-09-16","40","3018","2","527","11.7","10.3"
"Appling","2020-09-17","33","3051","2","529","12","10.2"
"Appling","2020-09-18","18","3069","2","531","11.2","10.1"
"Appling","2020-09-19","5","3074","1","532","14.1","10.7"
"Appling","2020-09-20","4","3078","1","533","12.3","12.5"
"Appling","2020-09-21","29","3107","3","536","11.1","11.9"
"Appling","2020-09-22","29","3136","3","539","12.6","12.5"
"Appling","2020-09-23","36","3172","2","541","12.6","12.1"
"Appling","2020-09-24","24","3196","7","548","15.9","14"
"Appling","2020-09-25","15","3211","1","549","15.3","13.3"
"Appling","2020-09-26","6","3217","1","550","14.8","14.5"
"Appling","2020-09-27","2","3219","1","551","18.4","15.3"
"Appling","2020-09-28","22","3241","4","555","19.5","15.3"
"Appling","2020-09-29","23","3264","4","559","20.5","16.5"
"Appling","2020-09-30","33","3297","7","566","22.8","17.7"
"Appling","2020-10-01","16","3313","4","570","22.2","19"
"Appling","2020-10-02","15","3328","5","575","26","20.6"
"Appling","2020-10-03","9","3337","4","579","29.9","22.4"
"Appling","2020-10-04","6","3343","1","580","25.2","21.8"
"Appling","2020-10-05","34","3377","5","585","24.7","22.1"
"Appling","2020-10-06","16","3393","1","586","23.1","21.8"
"Appling","2020-10-07","29","3422","4","590","22","22.4"
"Appling","2020-10-08","42","3464","14","604","23.2","22.7"
"Appling","2020-10-09","10","3474","1","605","19.9","22.9"
"Appling","2020-10-10","7","3481","2","607","17.6","23.8"
"Appling","2020-10-11","0","3481","0","607","15.2","20.2"
"Appling","2020-10-12","18","3499","3","610","15.5","20.1"
"Appling","2020-10-13","22","3521","4","614","17.2","20.2"
"Appling","2020-10-14","16","3537","0","614","15.3","18.6"
"Appling","2020-10-15","14","3551","0","614","10.5","16.9"
"Appling","2020-10-16","14","3565","5","619","14.2","17"
"Appling","2020-10-17","4","3569","1","620","13.7","15.6"
"Appling","2020-10-18","4","3573","2","622","20.8","18"
"Appling","2020-10-19","43","3616","6","628","20.4","18"
"Appling","2020-10-20","16","3632","0","628","17.8","17.5"
"Appling","2020-10-21","31","3663","2","630","18.7","17"
"Appling","2020-10-22","21","3684","2","632","20.1","15.3"
"Appling","2020-10-23","8","3692","0","632","15","14.6"
"Appling","2020-10-24","6","3698","1","633","13.8","13.7"
"Appling","2020-10-25","5","3703","1","634","9.5","15.2"
"Appling","2020-10-26","38","3741","4","638","9","14.7"
"Appling","2020-10-27","25","3766","5","643","11.9","14.8"
"Appling","2020-10-28","23","3789","1","644","11.6","15.2"
"Appling","2020-10-29","16","3805","1","645","11.1","15.6"
"Appling","2020-10-30","12","3817","2","647","13.5","14.2"
"Appling","2020-10-31","9","3826","3","650","15.9","14.8"
"Appling","2020-11-01","1","3827","0","650","13","11.3"
"Appling","2020-11-02","25","3852","4","654","13.8","11.4"
"Appling","2020-11-03","17","3869","0","654","10.9","11.4"
"Appling","2020-11-04","26","3895","0","654","10.3","11"
"Appling","2020-11-05","16","3911","1","655","10.3","10.7"
"Appling","2020-11-06","15","3926","1","656","8.9","11.2"
"Appling","2020-11-07","4","3930","0","656","4.1","10"
"Appling","2020-11-08","4","3934","0","656","4.1","8.6"
"Appling","2020-11-09","22","3956","1","657","2.5","8.1"
"Appling","2020-11-10","17","3973","1","658","3.3","7.1"
"Appling","2020-11-11","17","3990","3","661","5.9","8.1"
"Appling","2020-11-12","9","3999","1","662","6.6","8.4"
"Appling","2020-11-13","13","4012","1","663","6.7","7.8"
"Appling","2020-11-14","2","4014","0","663","6.7","5.4"
"Appling","2020-11-15","4","4018","0","663","6.7","5.4"
"Appling","2020-11-16","24","4042","2","665","7.2","4.9"
"Appling","2020-11-17","11","4053","1","666","7.7","5.5"
"Appling","2020-11-18","21","4074","0","666","5.2","5.5"
"Appling","2020-11-19","13","4087","1","667","4.7","5.6"
"Appling","2020-11-20","17","4104","4","671","6.9","6.8"
"Appling","2020-11-21","5","4109","1","672","9.8","8.3"
"Appling","2020-11-22","4","4113","0","672","9.8","8.3"
"Appling","2020-11-23","25","4138","1","673","9.2","8.2"
"Appling","2020-11-24","17","4155","1","674","8.7","8.2"
"Appling","2020-11-25","19","4174","1","675","9.5","7.3"
"Appling","2020-11-26","3","4177","0","675","8.4","6.5"
"Appling","2020-11-27","8","4185","2","677","8.6","7.8"
"Appling","2020-11-28","9","4194","0","677","5.7","7.8"
"Appling","2020-11-29","5","4199","0","677","5.7","7.8"
"Appling","2020-11-30","34","4233","4","681","6.8","8"
"Appling","2020-12-01","22","4255","2","683","7.3","8"
"Appling","2020-12-02","30","4285","4","687","8.5","9"
"Appling","2020-12-03","20","4305","0","687","8.5","8.4"
"Appling","2020-12-04","24","4329","1","688","5.5","7"
"Appling","2020-12-05","9","4338","0","688","5.5","5.6"
"Appling","2020-12-06","3","4341","0","688","5.5","5.6"
"Appling","2020-12-07","28","4369","2","690","4.8","5.8"
"Appling","2020-12-08","26","4395","5","695","6.3","6.8"
"Appling","2020-12-09","28","4423","4","699","6.4","7.4"
"Appling","2020-12-10","24","4447","6","705","10","9.2"
"Appling","2020-12-11","18","4465","2","707","11","8.2"
"Appling","2020-12-12","4","4469","1","708","14.5","10"
"Appling","2020-12-13","3","4472","1","709","19.3","12.4"
"Appling","2020-12-14","51","4523","11","720","21.4","13.1"
"Appling","2020-12-15","43","4566","12","732","22.6","14.4"
"Appling","2020-12-16","62","4628","16","748","24.2","15.3"
"Appling","2020-12-17","25","4653","6","754","24.1","17"
"Appling","2020-12-18","24","4677","4","758","24.9","17.9"
"Appling","2020-12-19","4","4681","0","758","21.3","17.9"
"Appling","2020-12-20","7","4688","1","759","18.6","19"
"Appling","2020-12-21","44","4732","7","766","17.8","19.6"
"Appling","2020-12-22","37","4769","9","775","17.3","19.9"
"Appling","2020-12-23","35","4804","8","783","16.9","20.6"
"Appling","2020-12-24","16","4820","4","787","17","20.6"
"Appling","2020-12-25","10","4830","2","789","17.5","21.2"
"Appling","2020-12-26","14","4844","8","797","25.6","23.5"
"Appling","2020-12-27","5","4849","2","799","29.3","24"
"Appling","2020-12-28","58","4907","11","810","29.8","23.8"
"Appling","2020-12-29","31","4938","8","818","30","23.6"
"Appling","2020-12-30","65","5003","13","831","29.6","23.2"
"Appling","2020-12-31","17","5020","3","834","28.5","22.8"
"Appling","2021-01-01","3","5023","0","834","25.7","21.6"
"Appling","2021-01-02","9","5032","2","836","20.7","23.2"
"Appling","2021-01-03","11","5043","2","838","17.5","23.4"
"Appling","2021-01-04","78","5121","23","861","19","24.4"
"Appling","2021-01-05","48","5169","12","873","18.9","24.5"
"Appling","2021-01-06","51","5220","7","880","18","23.8"
"Appling","2021-01-07","36","5256","2","882","16.3","22.4"
"Appling","2021-01-08","28","5284","2","884","17.3","21.5"
"Appling","2021-01-09","16","5300","5","889","18.6","19.6"
"Appling","2021-01-10","11","5311","3","892","19.9","18.7"
"Appling","2021-01-11","67","5378","11","903","18.1","18.6"
"Appling","2021-01-12","62","5440","7","910","16.1","17.5"
"Appling","2021-01-13","39","5479","9","919","17.4","17.7"
"Appling","2021-01-14","34","5513","5","924","18.7","17.5"
"Appling","2021-01-15","32","5545","4","928","19.5","18.4"
"Appling","2021-01-16","14","5559","5","933","20.1","19.4"
"Appling","2021-01-17","6","5565","0","933","16.2","18.1"
"Appling","2021-01-18","23","5588","5","938","17","17.5"
"Appling","2021-01-19","53","5641","5","943","16.7","16.4"
"Appling","2021-01-20","38","5679","6","949","15.7","16.6"
"Appling","2021-01-21","32","5711","5","954","15.8","17.3"
"Appling","2021-01-22","41","5752","9","963","17.2","18.3"
"Appling","2021-01-23","6","5758","3","966","19.2","19.7"
"Appling","2021-01-24","11","5769","2","968","21.8","19"
"Appling","2021-01-25","8","5777","0","968","18.7","17.9"
"Appling","2021-01-26","0","5777","0","968","17.4","17.1"
"Appling","2021-01-27","0","5777","0","968","15.1","15.4"
"Atkinson","2020-02-01","0","0","0","0",".","."
"Atkinson","2020-02-02","0","0","0","0",".","."
"Atkinson","2020-02-03","0","0","0","0",".","."
"Atkinson","2020-02-04","0","0","0","0",".","."
"Atkinson","2020-02-05","0","0","0","0",".","."
"Atkinson","2020-02-06","0","0","0","0",".","."
"Atkinson","2020-02-07","0","0","0","0","0","."
"Atkinson","2020-02-08","0","0","0","0","0","."
"Atkinson","2020-02-09","0","0","0","0","0","."
"Atkinson","2020-02-10","0","0","0","0","0","."
"Atkinson","2020-02-11","0","0","0","0","0","."
"Atkinson","2020-02-12","0","0","0","0","0","."
"Atkinson","2020-02-13","0","0","0","0","0","."
"Atkinson","2020-02-14","0","0","0","0","0","0"
"Atkinson","2020-02-15","0","0","0","0","0","0"
"Atkinson","2020-02-16","0","0","0","0","0","0"
"Atkinson","2020-02-17","0","0","0","0","0","0"
"Atkinson","2020-02-18","0","0","0","0","0","0"
"Atkinson","2020-02-19","0","0","0","0","0","0"
"Atkinson","2020-02-20","0","0","0","0","0","0"
"Atkinson","2020-02-21","0","0","0","0","0","0"
"Atkinson","2020-02-22","0","0","0","0","0","0"
"Atkinson","2020-02-23","0","0","0","0","0","0"
"Atkinson","2020-02-24","0","0","0","0","0","0"
"Atkinson","2020-02-25","0","0","0","0","0","0"
"Atkinson","2020-02-26","0","0","0","0","0","0"
"Atkinson","2020-02-27","0","0","0","0","0","0"
"Atkinson","2020-02-28","0","0","0","0","0","0"
"Atkinson","2020-02-29","0","0","0","0","0","0"
"Atkinson","2020-03-01","0","0","0","0","0","0"
"Atkinson","2020-03-02","0","0","0","0","0","0"
"Atkinson","2020-03-03","0","0","0","0","0","0"
"Atkinson","2020-03-04","0","0","0","0","0","0"
"Atkinson","2020-03-05","0","0","0","0","0","0"
"Atkinson","2020-03-06","0","0","0","0","0","0"
"Atkinson","2020-03-07","0","0","0","0","0","0"
"Atkinson","2020-03-08","0","0","0","0","0","0"
"Atkinson","2020-03-09","0","0","0","0","0","0"
"Atkinson","2020-03-10","0","0","0","0","0","0"
"Atkinson","2020-03-11","0","0","0","0","0","0"
"Atkinson","2020-03-12","0","0","0","0","0","0"
"Atkinson","2020-03-13","0","0","0","0","0","0"
"Atkinson","2020-03-14","0","0","0","0","0","0"
"Atkinson","2020-03-15","0","0","0","0","0","0"
"Atkinson","2020-03-16","0","0","0","0","0","0"
"Atkinson","2020-03-17","0","0","0","0","0","0"
"Atkinson","2020-03-18","0","0","0","0","0","0"
"Atkinson","2020-03-19","0","0","0","0","0","0"
"Atkinson","2020-03-20","0","0","0","0","0","0"
"Atkinson","2020-03-21","0","0","0","0","0","0"
"Atkinson","2020-03-22","0","0","0","0","0","0"
"Atkinson","2020-03-23","1","1","0","0","0","0"
"Atkinson","2020-03-24","4","5","0","0","0","0"
"Atkinson","2020-03-25","5","10","0","0","0","0"
"Atkinson","2020-03-26","1","11","0","0","0","0"
"Atkinson","2020-03-27","1","12","0","0","0","0"
"Atkinson","2020-03-28","0","12","0","0","0","0"
"Atkinson","2020-03-29","0","12","0","0","0","0"
"Atkinson","2020-03-30","1","13","0","0","0","0"
"Atkinson","2020-03-31","3","16","0","0","0","0"
"Atkinson","2020-04-01","0","16","0","0","0","0"
"Atkinson","2020-04-02","3","19","0","0","0","0"
"Atkinson","2020-04-03","4","23","1","1","3.6","1.8"
"Atkinson","2020-04-04","0","23","0","1","3.6","1.8"
"Atkinson","2020-04-05","0","23","0","1","3.6","1.8"
"Atkinson","2020-04-06","6","29","0","1","3.6","1.8"
"Atkinson","2020-04-07","4","33","0","1","3.6","1.8"
"Atkinson","2020-04-08","4","37","0","1","3.6","1.8"
"Atkinson","2020-04-09","2","39","0","1","3.6","1.8"
"Atkinson","2020-04-10","0","39","0","1","0","1.8"
"Atkinson","2020-04-11","0","39","0","1","0","1.8"
"Atkinson","2020-04-12","0","39","0","1","0","1.8"
"Atkinson","2020-04-13","2","41","0","1","0","1.8"
"Atkinson","2020-04-14","1","42","0","1","0","1.8"
"Atkinson","2020-04-15","3","45","0","1","0","1.8"
"Atkinson","2020-04-16","3","48","0","1","0","1.8"
"Atkinson","2020-04-17","0","48","0","1","0","0"
"Atkinson","2020-04-18","0","48","0","1","0","0"
"Atkinson","2020-04-19","0","48","0","1","0","0"
"Atkinson","2020-04-20","0","48","0","1","0","0"
"Atkinson","2020-04-21","2","50","2","3","14.3","7.1"
"Atkinson","2020-04-22","0","50","0","3","14.3","7.1"
"Atkinson","2020-04-23","4","54","1","4","17.9","8.9"
"Atkinson","2020-04-24","0","54","0","4","17.9","8.9"
"Atkinson","2020-04-25","0","54","0","4","17.9","8.9"
"Atkinson","2020-04-26","0","54","0","4","17.9","8.9"
"Atkinson","2020-04-27","1","55","0","4","17.9","8.9"
"Atkinson","2020-04-28","3","58","0","4","3.6","8.9"
"Atkinson","2020-04-29","2","60","0","4","3.6","8.9"
"Atkinson","2020-04-30","6","66","1","5","2.4","10.1"
"Atkinson","2020-05-01","0","66","0","5","2.4","10.1"
"Atkinson","2020-05-02","1","67","0","5","2.4","10.1"
"Atkinson","2020-05-03","0","67","0","5","2.4","10.1"
"Atkinson","2020-05-04","6","73","4","9","11.9","14.9"
"Atkinson","2020-05-05","4","77","1","10","15.5","9.5"
"Atkinson","2020-05-06","2","79","0","10","15.5","9.5"
"Atkinson","2020-05-07","3","82","0","10","13.1","7.7"
"Atkinson","2020-05-08","0","82","0","10","13.1","7.7"
"Atkinson","2020-05-09","0","82","0","10","13.1","7.7"
"Atkinson","2020-05-10","0","82","0","10","13.1","7.7"
"Atkinson","2020-05-11","3","85","0","10","3.6","7.7"
"Atkinson","2020-05-12","3","88","0","10","0","7.7"
"Atkinson","2020-05-13","0","88","0","10","0","7.7"
"Atkinson","2020-05-14","3","91","0","10","0","6.5"
"Atkinson","2020-05-15","3","94","0","10","0","6.5"
"Atkinson","2020-05-16","1","95","0","10","0","6.5"
"Atkinson","2020-05-17","2","97","0","10","0","6.5"
"Atkinson","2020-05-18","4","101","0","10","0","1.8"
"Atkinson","2020-05-19","3","104","3","13","14.3","7.1"
"Atkinson","2020-05-20","3","107","1","14","19","9.5"
"Atkinson","2020-05-21","11","118","0","14","19","9.5"
"Atkinson","2020-05-22","20","138","2","16","20.5","10.2"
"Atkinson","2020-05-23","10","148","1","17","21.9","11"
"Atkinson","2020-05-24","1","149","1","18","36.2","18.1"
"Atkinson","2020-05-25","1","150","1","19","50.5","25.2"
"Atkinson","2020-05-26","8","158","0","19","36.2","25.2"
"Atkinson","2020-05-27","0","158","0","19","31.4","25.2"
"Atkinson","2020-05-28","0","158","0","19","31.4","25.2"
"Atkinson","2020-05-29","2","160","1","20","37.1","28.8"
"Atkinson","2020-05-30","2","162","0","20","35.7","28.8"
"Atkinson","2020-05-31","1","163","0","20","21.4","28.8"
"Atkinson","2020-06-01","4","167","2","22","14.3","32.4"
"Atkinson","2020-06-02","1","168","0","22","14.3","25.2"
"Atkinson","2020-06-03","2","170","0","22","14.3","22.9"
"Atkinson","2020-06-04","4","174","1","23","17.9","24.6"
"Atkinson","2020-06-05","8","182","1","24","12.5","24.8"
"Atkinson","2020-06-06","1","183","0","24","12.5","24.1"
"Atkinson","2020-06-07","0","183","0","24","12.5","17"
"Atkinson","2020-06-08","7","190","1","25","7.4","10.8"
"Atkinson","2020-06-09","3","193","0","25","7.4","10.8"
"Atkinson","2020-06-10","3","196","1","26","12.2","13.2"
"Atkinson","2020-06-11","31","227","1","27","9","13.5"
"Atkinson","2020-06-12","2","229","0","27","7.3","9.9"
"Atkinson","2020-06-13","0","229","0","27","7.3","9.9"
"Atkinson","2020-06-14","0","229","0","27","7.3","9.9"
"Atkinson","2020-06-15","4","233","0","27","5.2","6.3"
"Atkinson","2020-06-16","7","240","1","28","7.3","7.3"
"Atkinson","2020-06-17","1","241","0","28","2.5","7.3"
"Atkinson","2020-06-18","6","247","2","30","6.8","7.9"
"Atkinson","2020-06-19","9","256","3","33","11.6","9.4"
"Atkinson","2020-06-20","1","257","0","33","11.6","9.4"
"Atkinson","2020-06-21","0","257","0","33","11.6","9.4"
"Atkinson","2020-06-22","5","262","2","35","17.3","11.3"
"Atkinson","2020-06-23","9","271","4","39","21.6","14.4"
"Atkinson","2020-06-24","4","275","2","41","28.7","15.6"
"Atkinson","2020-06-25","7","282","3","44","30.1","18.4"
"Atkinson","2020-06-26","5","287","1","45","28.2","19.9"
"Atkinson","2020-06-27","2","289","0","45","28.2","19.9"
"Atkinson","2020-06-28","0","289","0","45","28.2","19.9"
"Atkinson","2020-06-29","9","298","1","46","24.1","20.7"
"Atkinson","2020-06-30","9","307","3","49","22.5","22"
"Atkinson","2020-07-01","4","311","0","49","15.3","22"
"Atkinson","2020-07-02","10","321","1","50","10.6","20.4"
"Atkinson","2020-07-03","2","323","0","50","7.8","18"
"Atkinson","2020-07-04","4","327","2","52","14.9","21.6"
"Atkinson","2020-07-05","2","329","1","53","22.1","25.1"
"Atkinson","2020-07-06","8","337","0","53","20.5","22.3"
"Atkinson","2020-07-07","5","342","3","56","24.3","23.4"
"Atkinson","2020-07-08","3","345","3","59","38.6","27"
"Atkinson","2020-07-09","7","352","0","59","37.1","23.9"
"Atkinson","2020-07-10","4","356","2","61","44.3","26"
"Atkinson","2020-07-11","5","361","1","62","40","27.5"
"Atkinson","2020-07-12","5","366","1","63","35.7","28.9"
"Atkinson","2020-07-13","5","371","3","66","44.3","32.4"
"Atkinson","2020-07-14","4","375","1","67","39.3","31.8"
"Atkinson","2020-07-15","2","377","0","67","25","31.8"
"Atkinson","2020-07-16","9","386","0","67","25","31.1"
"Atkinson","2020-07-17","30","416","6","73","20.7","32.5"
"Atkinson","2020-07-18","0","416","0","73","17.9","28.9"
"Atkinson","2020-07-19","0","416","0","73","15","25.4"
"Atkinson","2020-07-20","2","418","0","73","6.4","25.4"
"Atkinson","2020-07-21","8","426","2","75","6.4","22.9"
"Atkinson","2020-07-22","5","431","0","75","6.4","15.7"
"Atkinson","2020-07-23","5","436","0","75","6.4","15.7"
"Atkinson","2020-07-24","2","438","0","75","3.6","12.1"
"Atkinson","2020-07-25","1","439","0","75","3.6","10.7"
"Atkinson","2020-07-26","0","439","0","75","3.6","9.3"
"Atkinson","2020-07-27","2","441","0","75","3.6","5"
"Atkinson","2020-07-28","3","444","0","75","0","3.2"
"Atkinson","2020-07-29","9","453","0","75","0","3.2"
"Atkinson","2020-07-30","4","457","2","77","7.1","6.8"
"Atkinson","2020-07-31","2","459","1","78","14.3","8.9"
"Atkinson","2020-08-01","1","460","0","78","14.3","8.9"
"Atkinson","2020-08-02","2","462","1","79","21.4","12.5"
"Atkinson","2020-08-03","6","468","5","84","33.3","18.5"
"Atkinson","2020-08-04","5","473","1","85","36.2","18.1"
"Atkinson","2020-08-05","4","477","0","85","36.2","18.1"
"Atkinson","2020-08-06","2","479","1","86","36.2","21.7"
"Atkinson","2020-08-07","2","481","0","86","29","21.7"
"Atkinson","2020-08-08","3","484","2","88","38.6","26.4"
"Atkinson","2020-08-09","0","484","0","88","31.4","26.4"
"Atkinson","2020-08-10","2","486","0","88","19.5","26.4"
"Atkinson","2020-08-11","7","493","0","88","16.7","26.4"
"Atkinson","2020-08-12","5","498","0","88","16.7","26.4"
"Atkinson","2020-08-13","8","506","1","89","11.3","23.8"
"Atkinson","2020-08-14","2","508","0","89","11.3","20.2"
"Atkinson","2020-08-15","1","509","0","89","1.8","20.2"
"Atkinson","2020-08-16","1","510","0","89","1.8","16.6"
"Atkinson","2020-08-17","3","513","0","89","1.8","10.7"
"Atkinson","2020-08-18","4","517","1","90","5.4","11"
"Atkinson","2020-08-19","4","521","0","90","5.4","11"
"Atkinson","2020-08-20","2","523","1","91","10.7","11"
"Atkinson","2020-08-21","9","532","0","91","10.7","11"
"Atkinson","2020-08-22","1","533","0","91","10.7","6.3"
"Atkinson","2020-08-23","3","536","1","92","15.5","8.6"
"Atkinson","2020-08-24","11","547","0","92","15.5","8.6"
"Atkinson","2020-08-25","9","556","0","92","11.9","8.6"
"Atkinson","2020-08-26","9","565","1","93","13.5","9.4"
"Atkinson","2020-08-27","8","573","2","95","9.9","10.3"
"Atkinson","2020-08-28","3","576","0","95","9.9","10.3"
"Atkinson","2020-08-29","1","577","0","95","9.9","10.3"
"Atkinson","2020-08-30","0","577","0","95","5.2","10.3"
"Atkinson","2020-08-31","6","583","0","95","5.2","10.3"
"Atkinson","2020-09-01","5","588","0","95","5.2","8.5"
"Atkinson","2020-09-02","26","614","0","95","3.6","8.5"
"Atkinson","2020-09-03","3","617","1","96","4.8","7.3"
"Atkinson","2020-09-04","2","619","1","97","11.9","10.9"
"Atkinson","2020-09-05","2","621","0","97","11.9","10.9"
"Atkinson","2020-09-06","1","622","1","98","26.2","15.7"
"Atkinson","2020-09-07","1","623","0","98","26.2","15.7"
"Atkinson","2020-09-08","7","630","2","100","30.3","17.7"
"Atkinson","2020-09-09","12","642","1","101","31.5","17.5"
"Atkinson","2020-09-10","8","650","0","101","26.7","15.7"
"Atkinson","2020-09-11","5","655","0","101","19.6","15.7"
"Atkinson","2020-09-12","3","658","1","102","24.3","18.1"
"Atkinson","2020-09-13","1","659","1","103","24.3","25.3"
"Atkinson","2020-09-14","7","666","0","103","24.3","25.3"
"Atkinson","2020-09-15","6","672","0","103","20.2","25.3"
"Atkinson","2020-09-16","2","674","0","103","19","25.3"
"Atkinson","2020-09-17","4","678","0","103","19","22.9"
"Atkinson","2020-09-18","2","680","0","103","19","19.3"
"Atkinson","2020-09-19","2","682","1","104","21.4","22.9"
"Atkinson","2020-09-20","1","683","0","104","7.1","15.7"
"Atkinson","2020-09-21","2","685","0","104","7.1","15.7"
"Atkinson","2020-09-22","5","690","0","104","7.1","13.7"
"Atkinson","2020-09-23","11","701","0","104","7.1","13.1"
"Atkinson","2020-09-24","6","707","0","104","7.1","13.1"
"Atkinson","2020-09-25","2","709","0","104","7.1","13.1"
"Atkinson","2020-09-26","1","710","0","104","0","10.7"
"Atkinson","2020-09-27","0","710","0","104","0","3.6"
"Atkinson","2020-09-28","7","717","0","104","0","3.6"
"Atkinson","2020-09-29","1","718","0","104","0","3.6"
"Atkinson","2020-09-30","9","727","0","104","0","3.6"
"Atkinson","2020-10-01","8","735","2","106","3.6","5.4"
"Atkinson","2020-10-02","4","739","0","106","3.6","5.4"
"Atkinson","2020-10-03","4","743","1","107","7.1","3.6"
"Atkinson","2020-10-04","1","744","0","107","7.1","3.6"
"Atkinson","2020-10-05","7","751","0","107","7.1","3.6"
"Atkinson","2020-10-06","8","759","1","108","8.9","4.5"
"Atkinson","2020-10-07","9","768","1","109","10.5","5.3"
"Atkinson","2020-10-08","2","770","0","109","6.9","5.3"
"Atkinson","2020-10-09","5","775","0","109","6.9","5.3"
"Atkinson","2020-10-10","1","776","1","110","17.7","12.4"
"Atkinson","2020-10-11","2","778","0","110","17.7","12.4"
"Atkinson","2020-10-12","6","784","0","110","17.7","12.4"
"Atkinson","2020-10-13","4","788","0","110","15.9","12.4"
"Atkinson","2020-10-14","5","793","2","112","20","15.3"
"Atkinson","2020-10-15","3","796","0","112","20","13.5"
"Atkinson","2020-10-16","2","798","0","112","20","13.5"
"Atkinson","2020-10-17","0","798","0","112","5.7","11.7"
"Atkinson","2020-10-18","2","800","0","112","5.7","11.7"
"Atkinson","2020-10-19","5","805","0","112","5.7","11.7"
"Atkinson","2020-10-20","5","810","0","112","5.7","10.8"
"Atkinson","2020-10-21","13","823","1","113","1.1","10.5"
"Atkinson","2020-10-22","5","828","1","114","4","12"
"Atkinson","2020-10-23","4","832","0","114","4","12"
"Atkinson","2020-10-24","2","834","0","114","4","4.8"
"Atkinson","2020-10-25","1","835","0","114","4","4.8"
"Atkinson","2020-10-26","10","845","1","115","5.4","5.5"
"Atkinson","2020-10-27","2","847","0","115","5.4","5.5"
"Atkinson","2020-10-28","8","855","2","117","7.9","4.5"
"Atkinson","2020-10-29","4","859","0","117","5","4.5"
"Atkinson","2020-10-30","2","861","0","117","5","4.5"
"Atkinson","2020-10-31","0","861","0","117","5","4.5"
"Atkinson","2020-11-01","0","861","0","117","5","4.5"
"Atkinson","2020-11-02","2","863","0","117","3.6","4.5"
"Atkinson","2020-11-03","4","867","0","117","3.6","4.5"
"Atkinson","2020-11-04","7","874","1","118","2","4.9"
"Atkinson","2020-11-05","0","874","0","118","2","3.5"
"Atkinson","2020-11-06","6","880","0","118","2","3.5"
"Atkinson","2020-11-07","1","881","0","118","2","3.5"
"Atkinson","2020-11-08","2","883","1","119","9.2","7.1"
"Atkinson","2020-11-09","3","886","0","119","9.2","6.4"
"Atkinson","2020-11-10","8","894","0","119","9.2","6.4"
"Atkinson","2020-11-11","5","899","0","119","7.1","4.6"
"Atkinson","2020-11-12","4","903","0","119","7.1","4.6"
"Atkinson","2020-11-13","4","907","0","119","7.1","4.6"
"Atkinson","2020-11-14","3","910","1","120","11.9","7"
"Atkinson","2020-11-15","2","912","1","121","11.9","10.5"
"Atkinson","2020-11-16","11","923","2","123","14.5","11.8"
"Atkinson","2020-11-17","2","925","0","123","14.5","11.8"
"Atkinson","2020-11-18","16","941","3","126","17.2","12.2"
"Atkinson","2020-11-19","4","945","0","126","17.2","12.2"
"Atkinson","2020-11-20","2","947","0","126","17.2","12.2"
"Atkinson","2020-11-21","0","947","0","126","12.4","12.2"
"Atkinson","2020-11-22","2","949","2","128","19.6","15.7"
"Atkinson","2020-11-23","3","952","1","129","21.7","18.1"
"Atkinson","2020-11-24","5","957","0","129","21.7","18.1"
"Atkinson","2020-11-25","9","966","2","131","22.2","19.7"
"Atkinson","2020-11-26","0","966","0","131","22.2","19.7"
"Atkinson","2020-11-27","2","968","1","132","29.4","23.3"
"Atkinson","2020-11-28","2","970","1","133","36.5","24.5"
"Atkinson","2020-11-29","7","977","2","135","26.3","22.9"
"Atkinson","2020-11-30","4","981","0","135","21.5","21.6"
"Atkinson","2020-12-01","3","984","0","135","21.5","21.6"
"Atkinson","2020-12-02","20","1004","3","138","20.5","21.4"
"Atkinson","2020-12-03","6","1010","1","139","22.9","22.6"
"Atkinson","2020-12-04","4","1014","0","139","15.7","22.6"
"Atkinson","2020-12-05","5","1019","2","141","14.3","25.4"
"Atkinson","2020-12-06","3","1022","0","141","10.2","18.3"
"Atkinson","2020-12-07","11","1033","1","142","11.5","16.5"
"Atkinson","2020-12-08","3","1036","2","144","21.1","21.3"
"Atkinson","2020-12-09","31","1067","7","151","22.1","21.3"
"Atkinson","2020-12-10","3","1070","0","151","19.8","21.3"
"Atkinson","2020-12-11","10","1080","3","154","24","19.9"
"Atkinson","2020-12-12","2","1082","0","154","18.3","16.3"
"Atkinson","2020-12-13","1","1083","0","154","18.3","14.3"
"Atkinson","2020-12-14","7","1090","1","155","19.1","15.3"
"Atkinson","2020-12-15","6","1096","2","157","14.3","17.7"
"Atkinson","2020-12-16","35","1131","8","165","14.4","18.2"
"Atkinson","2020-12-17","4","1135","1","166","17.9","18.8"
"Atkinson","2020-12-18","3","1138","1","167","18.4","21.2"
"Atkinson","2020-12-19","3","1141","2","169","27.9","23.1"
"Atkinson","2020-12-20","2","1143","2","171","42.2","30.3"
"Atkinson","2020-12-21","11","1154","6","177","48","33.5"
"Atkinson","2020-12-22","5","1159","2","179","48.9","31.6"
"Atkinson","2020-12-23","30","1189","11","190","50.9","32.6"
"Atkinson","2020-12-24","10","1199","8","198","58.7","38.3"
"Atkinson","2020-12-25","0","1199","0","198","54","36.2"
"Atkinson","2020-12-26","2","1201","2","200","58.7","43.3"
"Atkinson","2020-12-27","0","1201","0","200","44.5","43.3"
"Atkinson","2020-12-28","7","1208","1","201","38.7","43.3"
"Atkinson","2020-12-29","6","1214","1","202","35.4","42.1"
"Atkinson","2020-12-30","33","1247","7","209","33.2","42"
"Atkinson","2020-12-31","12","1259","3","212","25.3","42"
"Atkinson","2021-01-01","0","1259","0","212","25.3","39.6"
"Atkinson","2021-01-02","3","1262","2","214","20.5","39.6"
"Atkinson","2021-01-03","1","1263","1","215","34.8","39.6"
"Atkinson","2021-01-04","20","1283","8","223","38.5","38.6"
"Atkinson","2021-01-05","18","1301","4","227","39.3","37.3"
"Atkinson","2021-01-06","41","1342","7","234","38.7","35.9"
"Atkinson","2021-01-07","22","1364","2","236","36.4","30.9"
"Atkinson","2021-01-08","11","1375","0","236","36.4","30.9"
"Atkinson","2021-01-09","2","1377","0","236","26.9","23.7"
"Atkinson","2021-01-10","6","1383","3","239","19.8","27.3"
"Atkinson","2021-01-11","8","1391","3","242","19.4","29"
"Atkinson","2021-01-12","28","1419","3","245","17.8","28.5"
"Atkinson","2021-01-13","9","1428","4","249","21.7","30.2"
"Atkinson","2021-01-14","11","1439","1","250","21.7","29.1"
"Atkinson","2021-01-15","9","1448","2","252","24.9","30.6"
"Atkinson","2021-01-16","4","1452","3","255","35.6","31.2"
"Atkinson","2021-01-17","0","1452","0","255","28.4","24.1"
"Atkinson","2021-01-18","3","1455","0","255","23.1","21.2"
"Atkinson","2021-01-19","25","1480","4","259","23.8","20.8"
"Atkinson","2021-01-20","15","1495","3","262","20.3","21"
"Atkinson","2021-01-21","18","1513","1","263","19.8","20.8"
"Atkinson","2021-01-22","7","1520","1","264","18.7","21.8"
"Atkinson","2021-01-23","3","1523","0","264","8","21.8"
"Atkinson","2021-01-24","0","1523","0","264","8","18.2"
"Atkinson","2021-01-25","12","1535","3","267","11.5","17.3"
"Atkinson","2021-01-26","0","1535","0","267","9.3","16.5"
"Atkinson","2021-01-27","0","1535","0","267","6.4","13.4"
"Bacon","2020-02-01","0","0","0","0",".","."
"Bacon","2020-02-02","0","0","0","0",".","."
"Bacon","2020-02-03","0","0","0","0",".","."
"Bacon","2020-02-04","0","0","0","0",".","."
"Bacon","2020-02-05","0","0","0","0",".","."
"Bacon","2020-02-06","0","0","0","0",".","."
"Bacon","2020-02-07","0","0","0","0","0","."
"Bacon","2020-02-08","0","0","0","0","0","."
"Bacon","2020-02-09","0","0","0","0","0","."
"Bacon","2020-02-10","0","0","0","0","0","."
"Bacon","2020-02-11","0","0","0","0","0","."
"Bacon","2020-02-12","0","0","0","0","0","."
"Bacon","2020-02-13","0","0","0","0","0","."
"Bacon","2020-02-14","0","0","0","0","0","0"
"Bacon","2020-02-15","0","0","0","0","0","0"
"Bacon","2020-02-16","0","0","0","0","0","0"
"Bacon","2020-02-17","0","0","0","0","0","0"
"Bacon","2020-02-18","0","0","0","0","0","0"
"Bacon","2020-02-19","0","0","0","0","0","0"
"Bacon","2020-02-20","0","0","0","0","0","0"
"Bacon","2020-02-21","0","0","0","0","0","0"
"Bacon","2020-02-22","0","0","0","0","0","0"
"Bacon","2020-02-23","0","0","0","0","0","0"
"Bacon","2020-02-24","0","0","0","0","0","0"
"Bacon","2020-02-25","0","0","0","0","0","0"
"Bacon","2020-02-26","0","0","0","0","0","0"
"Bacon","2020-02-27","0","0","0","0","0","0"
"Bacon","2020-02-28","0","0","0","0","0","0"
"Bacon","2020-02-29","0","0","0","0","0","0"
"Bacon","2020-03-01","0","0","0","0","0","0"
"Bacon","2020-03-02","0","0","0","0","0","0"
"Bacon","2020-03-03","0","0","0","0","0","0"
"Bacon","2020-03-04","0","0","0","0","0","0"
"Bacon","2020-03-05","0","0","0","0","0","0"
"Bacon","2020-03-06","0","0","0","0","0","0"
"Bacon","2020-03-07","0","0","0","0","0","0"
"Bacon","2020-03-08","0","0","0","0","0","0"
"Bacon","2020-03-09","0","0","0","0","0","0"
"Bacon","2020-03-10","0","0","0","0","0","0"
"Bacon","2020-03-11","0","0","0","0","0","0"
"Bacon","2020-03-12","1","1","0","0","0","0"
"Bacon","2020-03-13","0","1","0","0","0","0"
"Bacon","2020-03-14","0","1","0","0","0","0"
"Bacon","2020-03-15","0","1","0","0","0","0"
"Bacon","2020-03-16","1","2","0","0","0","0"
"Bacon","2020-03-17","1","3","0","0","0","0"
"Bacon","2020-03-18","1","4","0","0","0","0"
"Bacon","2020-03-19","3","7","1","1","4.8","2.4"
"Bacon","2020-03-20","2","9","1","2","11.9","6"
"Bacon","2020-03-21","0","9","0","2","11.9","6"
"Bacon","2020-03-22","0","9","0","2","11.9","6"
"Bacon","2020-03-23","0","9","0","2","11.9","6"
"Bacon","2020-03-24","0","9","0","2","11.9","6"
"Bacon","2020-03-25","4","13","0","2","11.9","6"
"Bacon","2020-03-26","1","14","0","2","7.1","6"
"Bacon","2020-03-27","4","18","1","3","3.6","7.7"
"Bacon","2020-03-28","1","19","1","4","17.9","14.9"
"Bacon","2020-03-29","0","19","0","4","17.9","14.9"
"Bacon","2020-03-30","0","19","0","4","17.9","14.9"
"Bacon","2020-03-31","6","25","2","6","22.6","17.3"
"Bacon","2020-04-01","4","29","2","8","29.8","20.8"
"Bacon","2020-04-02","2","31","0","8","29.8","18.5"
"Bacon","2020-04-03","2","33","0","8","26.2","14.9"
"Bacon","2020-04-04","0","33","0","8","11.9","14.9"
"Bacon","2020-04-05","0","33","0","8","11.9","14.9"
"Bacon","2020-04-06","1","34","0","8","11.9","14.9"
"Bacon","2020-04-07","3","37","0","8","7.1","14.9"
"Bacon","2020-04-08","0","37","0","8","0","14.9"
"Bacon","2020-04-09","0","37","0","8","0","14.9"
"Bacon","2020-04-10","1","38","0","8","0","13.1"
"Bacon","2020-04-11","0","38","0","8","0","6"
"Bacon","2020-04-12","0","38","0","8","0","6"
"Bacon","2020-04-13","1","39","0","8","0","6"
"Bacon","2020-04-14","1","40","0","8","0","3.6"
"Bacon","2020-04-15","2","42","0","8","0","0"
"Bacon","2020-04-16","0","42","0","8","0","0"
"Bacon","2020-04-17","6","48","0","8","0","0"
"Bacon","2020-04-18","0","48","0","8","0","0"
"Bacon","2020-04-19","0","48","0","8","0","0"
"Bacon","2020-04-20","0","48","0","8","0","0"
"Bacon","2020-04-21","1","49","0","8","0","0"
"Bacon","2020-04-22","1","50","0","8","0","0"
"Bacon","2020-04-23","4","54","0","8","0","0"
"Bacon","2020-04-24","2","56","0","8","0","0"
"Bacon","2020-04-25","1","57","0","8","0","0"
"Bacon","2020-04-26","0","57","0","8","0","0"
"Bacon","2020-04-27","1","58","0","8","0","0"
"Bacon","2020-04-28","2","60","1","9","7.1","3.6"
"Bacon","2020-04-29","4","64","2","11","14.3","7.1"
"Bacon","2020-04-30","7","71","0","11","14.3","7.1"
"Bacon","2020-05-01","3","74","0","11","14.3","7.1"
"Bacon","2020-05-02","2","76","0","11","14.3","7.1"
"Bacon","2020-05-03","0","76","0","11","14.3","7.1"
"Bacon","2020-05-04","1","77","0","11","14.3","7.1"
"Bacon","2020-05-05","3","80","2","13","16.7","11.9"
"Bacon","2020-05-06","1","81","0","13","9.5","11.9"
"Bacon","2020-05-07","5","86","3","16","18.1","16.2"
"Bacon","2020-05-08","3","89","0","16","18.1","16.2"
"Bacon","2020-05-09","7","96","0","16","18.1","16.2"
"Bacon","2020-05-10","0","96","0","16","18.1","16.2"
"Bacon","2020-05-11","124","220","79","95","27.2","20.7"
"Bacon","2020-05-12","3","223","0","95","17.7","17.2"
"Bacon","2020-05-13","4","227","0","95","17.7","13.6"
"Bacon","2020-05-14","4","231","0","95","9.1","13.6"
"Bacon","2020-05-15","1","232","0","95","9.1","13.6"
"Bacon","2020-05-16","0","232","0","95","9.1","13.6"
"Bacon","2020-05-17","0","232","0","95","9.1","13.6"
"Bacon","2020-05-18","2","234","0","95","0","13.6"
"Bacon","2020-05-19","7","241","0","95","0","8.8"
"Bacon","2020-05-20","5","246","0","95","0","8.8"
"Bacon","2020-05-21","55","301","3","98","0.8","4.9"
"Bacon","2020-05-22","4","305","0","98","0.8","4.9"
"Bacon","2020-05-23","1","306","0","98","0.8","4.9"
"Bacon","2020-05-24","1","307","0","98","0.8","4.9"
"Bacon","2020-05-25","1","308","0","98","0.8","0.4"
"Bacon","2020-05-26","5","313","2","100","6.5","3.2"
"Bacon","2020-05-27","5","318","0","100","6.5","3.2"
"Bacon","2020-05-28","6","324","0","100","5.7","3.2"
"Bacon","2020-05-29","10","334","4","104","11.4","6.1"
"Bacon","2020-05-30","1","335","0","104","11.4","6.1"
"Bacon","2020-05-31","0","335","0","104","11.4","6.1"
"Bacon","2020-06-01","2","337","0","104","11.4","6.1"
"Bacon","2020-06-02","9","346","0","104","5.7","6.1"
"Bacon","2020-06-03","2","348","1","105","12.9","9.7"
"Bacon","2020-06-04","2","350","0","105","12.9","9.3"
"Bacon","2020-06-05","2","352","0","105","7.1","9.3"
"Bacon","2020-06-06","0","352","0","105","7.1","9.3"
"Bacon","2020-06-07","1","353","0","105","7.1","9.3"
"Bacon","2020-06-08","5","358","1","106","10","10.7"
"Bacon","2020-06-09","3","361","0","106","10","7.9"
"Bacon","2020-06-10","1","362","0","106","2.9","7.9"
"Bacon","2020-06-11","7","369","0","106","2.9","7.9"
"Bacon","2020-06-12","2","371","1","107","10","8.6"
"Bacon","2020-06-13","0","371","0","107","10","8.6"
"Bacon","2020-06-14","2","373","1","108","17.1","12.1"
"Bacon","2020-06-15","5","378","1","109","17.1","13.6"
"Bacon","2020-06-16","12","390","4","113","21.9","16"
"Bacon","2020-06-17","7","397","0","113","21.9","12.4"
"Bacon","2020-06-18","7","404","1","114","23.9","13.4"
"Bacon","2020-06-19","10","414","1","115","18.2","14.1"
"Bacon","2020-06-20","12","426","2","117","20.6","15.3"
"Bacon","2020-06-21","2","428","0","117","13.5","15.3"
"Bacon","2020-06-22","5","433","0","117","10.6","13.9"
"Bacon","2020-06-23","20","453","0","117","5.9","13.9"
"Bacon","2020-06-24","4","457","0","117","5.9","13.9"
"Bacon","2020-06-25","9","466","1","118","5.4","14.7"
"Bacon","2020-06-26","8","474","1","119","5.8","12"
"Bacon","2020-06-27","3","477","0","119","3.4","12"
"Bacon","2020-06-28","0","477","0","119","3.4","8.4"
"Bacon","2020-06-29","9","486","0","119","3.4","7"
"Bacon","2020-06-30","17","503","0","119","3.4","4.6"
"Bacon","2020-07-01","12","515","2","121","5.8","5.8"
"Bacon","2020-07-02","13","528","0","121","4.2","4.8"
"Bacon","2020-07-03","5","533","1","122","5.2","5.5"
"Bacon","2020-07-04","7","540","1","123","7.3","5.3"
"Bacon","2020-07-05","1","541","0","123","7.3","5.3"
"Bacon","2020-07-06","18","559","2","125","8.9","6.1"
"Bacon","2020-07-07","10","569","2","127","11.7","7.5"
"Bacon","2020-07-08","10","579","1","128","10.8","8.3"
"Bacon","2020-07-09","20","599","6","134","15.1","9.6"
"Bacon","2020-07-10","8","607","1","135","14","9.6"
"Bacon","2020-07-11","9","616","0","135","11.9","9.6"
"Bacon","2020-07-12","3","619","0","135","11.9","9.6"
"Bacon","2020-07-13","13","632","0","135","10.4","9.6"
"Bacon","2020-07-14","11","643","3","138","11.4","11.6"
"Bacon","2020-07-15","13","656","6","144","16.6","13.7"
"Bacon","2020-07-16","15","671","1","145","13.2","14.1"
"Bacon","2020-07-17","12","683","2","147","13.8","13.9"
"Bacon","2020-07-18","8","691","3","150","19.2","15.6"
"Bacon","2020-07-19","1","692","0","150","19.2","15.6"
"Bacon","2020-07-20","3","695","1","151","23.9","17.1"
"Bacon","2020-07-21","13","708","4","155","24.4","17.9"
"Bacon","2020-07-22","3","711","1","156","22.6","19.6"
"Bacon","2020-07-23","10","721","1","157","23.1","18.2"
"Bacon","2020-07-24","9","730","0","157","20.7","17.3"
"Bacon","2020-07-25","2","732","0","157","15.3","17.3"
"Bacon","2020-07-26","0","732","0","157","15.3","17.3"
"Bacon","2020-07-27","7","739","2","159","14.7","19.3"
"Bacon","2020-07-28","12","751","1","160","11.5","18"
"Bacon","2020-07-29","3","754","0","160","6.7","14.7"
"Bacon","2020-07-30","9","763","0","160","5.3","14.2"
"Bacon","2020-07-31","8","771","0","160","5.3","13"
"Bacon","2020-08-01","1","772","0","160","5.3","10.3"
"Bacon","2020-08-02","1","773","0","160","5.3","10.3"
"Bacon","2020-08-03","6","779","1","161","3.6","9.1"
"Bacon","2020-08-04","7","786","0","161","2.4","6.9"
"Bacon","2020-08-05","8","794","1","162","4.2","5.4"
"Bacon","2020-08-06","16","810","1","163","5.1","5.2"
"Bacon","2020-08-07","4","814","1","164","8.6","7"
"Bacon","2020-08-08","2","816","1","165","15.8","10.5"
"Bacon","2020-08-09","0","816","0","165","15.8","10.5"
"Bacon","2020-08-10","7","823","0","165","13.4","8.5"
"Bacon","2020-08-11","9","832","0","165","13.4","7.9"
"Bacon","2020-08-12","8","840","1","166","13.4","8.8"
"Bacon","2020-08-13","12","852","0","166","12.5","8.8"
"Bacon","2020-08-14","4","856","0","166","8.9","8.8"
"Bacon","2020-08-15","4","860","0","166","1.8","8.8"
"Bacon","2020-08-16","0","860","0","166","1.8","8.8"
"Bacon","2020-08-17","8","868","0","166","1.8","7.6"
"Bacon","2020-08-18","12","880","2","168","4.2","8.8"
"Bacon","2020-08-19","12","892","2","170","4.8","9.1"
"Bacon","2020-08-20","8","900","2","172","8.3","10.4"
"Bacon","2020-08-21","9","909","0","172","8.3","8.6"
"Bacon","2020-08-22","2","911","0","172","8.3","5.1"
"Bacon","2020-08-23","0","911","0","172","8.3","5.1"
"Bacon","2020-08-24","14","925","1","173","9.4","5.6"
"Bacon","2020-08-25","23","948","4","177","9.5","6.8"
"Bacon","2020-08-26","10","958","0","177","7.1","5.9"
"Bacon","2020-08-27","5","963","0","177","3.5","5.9"
"Bacon","2020-08-28","28","991","0","177","3.5","5.9"
"Bacon","2020-08-29","10","1001","0","177","3.5","5.9"
"Bacon","2020-08-30","1","1002","0","177","3.5","5.9"
"Bacon","2020-08-31","10","1012","0","177","2.5","5.9"
"Bacon","2020-09-01","14","1026","1","178","1","5.2"
"Bacon","2020-09-02","24","1050","1","179","1.6","4.3"
"Bacon","2020-09-03","9","1059","2","181","4.8","4.1"
"Bacon","2020-09-04","18","1077","0","181","4.8","4.1"
"Bacon","2020-09-05","1","1078","0","181","4.8","4.1"
"Bacon","2020-09-06","3","1081","1","182","9.6","6.5"
"Bacon","2020-09-07","1","1082","0","182","9.6","6"
"Bacon","2020-09-08","14","1096","3","185","11.6","6.3"
"Bacon","2020-09-09","11","1107","1","186","12.3","7"
"Bacon","2020-09-10","15","1122","2","188","11","7.9"
"Bacon","2020-09-11","8","1130","1","189","12.8","8.8"
"Bacon","2020-09-12","3","1133","1","190","17.6","11.2"
"Bacon","2020-09-13","1","1134","0","190","12.8","11.2"
"Bacon","2020-09-14","9","1143","2","192","16","12.8"
"Bacon","2020-09-15","14","1157","0","192","12.9","12.3"
"Bacon","2020-09-16","6","1163","2","194","16.4","14.3"
"Bacon","2020-09-17","11","1174","1","195","15.8","13.4"
"Bacon","2020-09-18","2","1176","0","195","14","13.4"
"Bacon","2020-09-19","1","1177","0","195","9.2","13.4"
"Bacon","2020-09-20","0","1177","0","195","9.2","11"
"Bacon","2020-09-21","5","1182","0","195","6.1","11"
"Bacon","2020-09-22","9","1191","0","195","6.1","9.5"
"Bacon","2020-09-23","9","1200","1","196","2.9","9.6"
"Bacon","2020-09-24","7","1207","0","196","1.6","8.7"
"Bacon","2020-09-25","10","1217","1","197","3","8.5"
"Bacon","2020-09-26","2","1219","1","198","10.2","9.7"
"Bacon","2020-09-27","2","1221","0","198","10.2","9.7"
"Bacon","2020-09-28","15","1236","1","199","11.1","8.6"
"Bacon","2020-09-29","9","1245","1","200","12.7","9.4"
"Bacon","2020-09-30","13","1258","0","200","11.1","7"
"Bacon","2020-10-01","12","1270","0","200","11.1","6.3"
"Bacon","2020-10-02","5","1275","0","200","9.7","6.3"
"Bacon","2020-10-03","2","1277","0","200","2.5","6.3"
"Bacon","2020-10-04","3","1280","0","200","2.5","6.3"
"Bacon","2020-10-05","12","1292","1","201","2.8","6.9"
"Bacon","2020-10-06","10","1302","0","201","1.2","6.9"
"Bacon","2020-10-07","14","1316","0","201","1.2","6.2"
"Bacon","2020-10-08","9","1325","1","202","2.8","6.9"
"Bacon","2020-10-09","9","1334","0","202","2.8","6.2"
"Bacon","2020-10-10","2","1336","0","202","2.8","2.7"
"Bacon","2020-10-11","2","1338","0","202","2.8","2.7"
"Bacon","2020-10-12","5","1343","0","202","1.6","2.2"
"Bacon","2020-10-13","9","1352","0","202","1.6","1.4"
"Bacon","2020-10-14","10","1362","0","202","1.6","1.4"
"Bacon","2020-10-15","6","1368","0","202","0","1.4"
"Bacon","2020-10-16","3","1371","0","202","0","1.4"
"Bacon","2020-10-17","0","1371","0","202","0","1.4"
"Bacon","2020-10-18","1","1372","0","202","0","1.4"
"Bacon","2020-10-19","2","1374","0","202","0","0.8"
"Bacon","2020-10-20","10","1384","0","202","0","0.8"
"Bacon","2020-10-21","8","1392","0","202","0","0.8"
"Bacon","2020-10-22","6","1398","0","202","0","0"
"Bacon","2020-10-23","3","1401","0","202","0","0"
"Bacon","2020-10-24","1","1402","1","203","14.3","7.1"
"Bacon","2020-10-25","0","1402","0","203","14.3","7.1"
"Bacon","2020-10-26","6","1408","0","203","14.3","7.1"
"Bacon","2020-10-27","7","1415","0","203","14.3","7.1"
"Bacon","2020-10-28","6","1421","0","203","14.3","7.1"
"Bacon","2020-10-29","12","1433","0","203","14.3","7.1"
"Bacon","2020-10-30","3","1436","0","203","14.3","7.1"
"Bacon","2020-10-31","3","1439","0","203","0","7.1"
"Bacon","2020-11-01","0","1439","0","203","0","7.1"
"Bacon","2020-11-02","9","1448","0","203","0","7.1"
"Bacon","2020-11-03","8","1456","1","204","1.8","8"
"Bacon","2020-11-04","5","1461","0","204","1.8","8"
"Bacon","2020-11-05","8","1469","1","205","3.6","8.9"
"Bacon","2020-11-06","9","1478","0","205","3.6","8.9"
"Bacon","2020-11-07","8","1486","0","205","3.6","1.8"
"Bacon","2020-11-08","6","1492","0","205","3.6","1.8"
"Bacon","2020-11-09","10","1502","1","206","5","2.5"
"Bacon","2020-11-10","12","1514","1","207","4.4","3.1"
"Bacon","2020-11-11","5","1519","0","207","4.4","3.1"
"Bacon","2020-11-12","9","1528","0","207","2.6","3.1"
"Bacon","2020-11-13","7","1535","0","207","2.6","3.1"
"Bacon","2020-11-14","2","1537","0","207","2.6","3.1"
"Bacon","2020-11-15","5","1542","0","207","2.6","3.1"
"Bacon","2020-11-16","7","1549","1","208","3.2","4.1"
"Bacon","2020-11-17","12","1561","0","208","2","3.2"
"Bacon","2020-11-18","7","1568","0","208","2","3.2"
"Bacon","2020-11-19","8","1576","0","208","2","2.3"
"Bacon","2020-11-20","10","1586","1","209","3.5","3"
"Bacon","2020-11-21","3","1589","0","209","3.5","3"
"Bacon","2020-11-22","5","1594","0","209","3.5","3"
"Bacon","2020-11-23","15","1609","1","210","2.4","2.8"
"Bacon","2020-11-24","8","1617","0","210","2.4","2.2"
"Bacon","2020-11-25","37","1654","1","211","2.8","2.4"
"Bacon","2020-11-26","2","1656","1","212","9.9","6"
"Bacon","2020-11-27","4","1660","0","212","8.5","6"
"Bacon","2020-11-28","2","1662","0","212","8.5","6"
"Bacon","2020-11-29","2","1664","0","212","8.5","6"
"Bacon","2020-11-30","17","1681","2","214","9.2","5.8"
"Bacon","2020-12-01","11","1692","2","216","11.8","7.1"
"Bacon","2020-12-02","11","1703","0","216","11.4","7.1"
"Bacon","2020-12-03","13","1716","0","216","4.3","7.1"
"Bacon","2020-12-04","6","1722","1","217","6.7","7.6"
"Bacon","2020-12-05","2","1724","1","218","13.8","11.1"
"Bacon","2020-12-06","3","1727","2","220","23.3","15.9"
"Bacon","2020-12-07","12","1739","5","225","27.6","18.4"
"Bacon","2020-12-08","13","1752","1","226","26.1","19"
"Bacon","2020-12-09","21","1773","2","228","27.5","19.4"
"Bacon","2020-12-10","14","1787","0","228","27.5","15.9"
"Bacon","2020-12-11","14","1801","1","229","26.1","16.4"
"Bacon","2020-12-12","3","1804","0","229","19","16.4"
"Bacon","2020-12-13","0","1804","0","229","9.4","16.4"
"Bacon","2020-12-14","19","1823","6","235","8","17.8"
"Bacon","2020-12-15","14","1837","0","235","6.9","16.5"
"Bacon","2020-12-16","26","1863","10","245","11","19.2"
"Bacon","2020-12-17","14","1877","2","247","13.1","20.3"
"Bacon","2020-12-18","13","1890","7","254","19.7","22.9"
"Bacon","2020-12-19","3","1893","2","256","29.3","24.1"
"Bacon","2020-12-20","1","1894","0","256","29.3","19.3"
"Bacon","2020-12-21","18","1912","3","259","27.1","17.6"
"Bacon","2020-12-22","56","1968","9","268","29.4","18.2"
"Bacon","2020-12-23","17","1985","4","272","27.3","19.2"
"Bacon","2020-12-24","3","1988","0","272","25.3","19.2"
"Bacon","2020-12-25","1","1989","0","272","17.6","18.7"
"Bacon","2020-12-26","8","1997","4","276","15.2","22.2"
"Bacon","2020-12-27","6","2003","0","276","15.2","22.2"
"Bacon","2020-12-28","40","2043","12","288","17.1","22.1"
"Bacon","2020-12-29","25","2068","8","296","19.4","24.4"
"Bacon","2020-12-30","15","2083","7","303","22.7","25"
"Bacon","2020-12-31","12","2095","2","305","25","25.2"
"Bacon","2021-01-01","3","2098","0","305","25","21.3"
"Bacon","2021-01-02","6","2104","2","307","22.7","18.9"
"Bacon","2021-01-03","5","2109","0","307","22.7","18.9"
"Bacon","2021-01-04","26","2135","11","318","24.4","20.8"
"Bacon","2021-01-05","44","2179","4","322","21.2","20.3"
"Bacon","2021-01-06","20","2199","1","323","15.2","18.9"
"Bacon","2021-01-07","23","2222","2","325","14.1","19.6"
"Bacon","2021-01-08","30","2252","4","329","16","20.5"
"Bacon","2021-01-09","6","2258","0","329","11.2","16.9"
"Bacon","2021-01-10","6","2264","3","332","18.3","20.5"
"Bacon","2021-01-11","16","2280","2","334","14.1","19.3"
"Bacon","2021-01-12","25","2305","1","335","13.4","17.3"
"Bacon","2021-01-13","10","2315","2","337","15.5","15.4"
"Bacon","2021-01-14","34","2349","3","340","15.5","14.8"
"Bacon","2021-01-15","8","2357","0","340","13.6","14.8"
"Bacon","2021-01-16","8","2365","2","342","17.2","14.2"
"Bacon","2021-01-17","3","2368","0","342","10","14.2"
"Bacon","2021-01-18","19","2387","2","344","9.8","11.9"
"Bacon","2021-01-19","12","2399","3","347","12.8","13.1"
"Bacon","2021-01-20","54","2453","24","371","16.3","15.9"
"Bacon","2021-01-21","32","2485","4","375","16.8","16.2"
"Bacon","2021-01-22","12","2497","1","376","18","15.8"
"Bacon","2021-01-23","2","2499","0","376","14.4","15.8"
"Bacon","2021-01-24","0","2499","0","376","14.4","12.2"
"Bacon","2021-01-25","6","2505","2","378","17.7","13.7"
"Bacon","2021-01-26","2","2507","0","378","14.1","13.4"
"Bacon","2021-01-27","0","2507","0","378","7.7","12"
"Baker","2020-02-01","0","0","0","0",".","."
"Baker","2020-02-02","0","0","0","0",".","."
"Baker","2020-02-03","0","0","0","0",".","."
"Baker","2020-02-04","0","0","0","0",".","."
"Baker","2020-02-05","0","0","0","0",".","."
"Baker","2020-02-06","0","0","0","0",".","."
"Baker","2020-02-07","0","0","0","0","0","."
"Baker","2020-02-08","0","0","0","0","0","."
"Baker","2020-02-09","0","0","0","0","0","."
"Baker","2020-02-10","0","0","0","0","0","."
"Baker","2020-02-11","0","0","0","0","0","."
"Baker","2020-02-12","0","0","0","0","0","."
"Baker","2020-02-13","0","0","0","0","0","."
"Baker","2020-02-14","0","0","0","0","0","0"
"Baker","2020-02-15","0","0","0","0","0","0"
"Baker","2020-02-16","0","0","0","0","0","0"
"Baker","2020-02-17","0","0","0","0","0","0"
"Baker","2020-02-18","0","0","0","0","0","0"
"Baker","2020-02-19","0","0","0","0","0","0"
"Baker","2020-02-20","0","0","0","0","0","0"
"Baker","2020-02-21","0","0","0","0","0","0"
"Baker","2020-02-22","0","0","0","0","0","0"
"Baker","2020-02-23","0","0","0","0","0","0"
"Baker","2020-02-24","0","0","0","0","0","0"
"Baker","2020-02-25","0","0","0","0","0","0"
"Baker","2020-02-26","0","0","0","0","0","0"
"Baker","2020-02-27","0","0","0","0","0","0"
"Baker","2020-02-28","0","0","0","0","0","0"
"Baker","2020-02-29","0","0","0","0","0","0"
"Baker","2020-03-01","0","0","0","0","0","0"
"Baker","2020-03-02","0","0","0","0","0","0"
"Baker","2020-03-03","0","0","0","0","0","0"
"Baker","2020-03-04","0","0","0","0","0","0"
"Baker","2020-03-05","0","0","0","0","0","0"
"Baker","2020-03-06","0","0","0","0","0","0"
"Baker","2020-03-07","0","0","0","0","0","0"
"Baker","2020-03-08","0","0","0","0","0","0"
"Baker","2020-03-09","0","0","0","0","0","0"
"Baker","2020-03-10","0","0","0","0","0","0"
"Baker","2020-03-11","0","0","0","0","0","0"
"Baker","2020-03-12","0","0","0","0","0","0"
"Baker","2020-03-13","1","1","0","0","0","0"
"Baker","2020-03-14","0","1","0","0","0","0"
"Baker","2020-03-15","1","2","1","1","14.3","7.1"
"Baker","2020-03-16","0","2","0","1","14.3","7.1"
"Baker","2020-03-17","2","4","0","1","14.3","7.1"
"Baker","2020-03-18","0","4","0","1","14.3","7.1"
"Baker","2020-03-19","0","4","0","1","14.3","7.1"
"Baker","2020-03-20","4","8","0","1","14.3","7.1"
"Baker","2020-03-21","0","8","0","1","14.3","7.1"
"Baker","2020-03-22","0","8","0","1","0","7.1"
"Baker","2020-03-23","5","13","0","1","0","7.1"
"Baker","2020-03-24","1","14","0","1","0","7.1"
"Baker","2020-03-25","2","16","0","1","0","7.1"
"Baker","2020-03-26","2","18","2","3","14.3","14.3"
"Baker","2020-03-27","0","18","0","3","14.3","14.3"
"Baker","2020-03-28","5","23","1","4","17.1","15.7"
"Baker","2020-03-29","1","24","1","5","31.4","15.7"
"Baker","2020-03-30","1","25","1","6","45.7","22.9"
"Baker","2020-03-31","2","27","2","8","60","30"
"Baker","2020-04-01","4","31","2","10","67.1","33.6"
"Baker","2020-04-02","0","31","0","10","52.9","33.6"
"Baker","2020-04-03","2","33","1","11","60","37.1"
"Baker","2020-04-04","1","34","0","11","57.1","37.1"
"Baker","2020-04-05","0","34","0","11","42.9","37.1"
"Baker","2020-04-06","3","37","2","13","38.1","41.9"
"Baker","2020-04-07","2","39","1","14","31","45.5"
"Baker","2020-04-08","0","39","0","14","23.8","45.5"
"Baker","2020-04-09","0","39","0","14","23.8","38.3"
"Baker","2020-04-10","6","45","2","16","21.4","40.7"
"Baker","2020-04-11","0","45","0","16","21.4","39.3"
"Baker","2020-04-12","0","45","0","16","21.4","32.1"
"Baker","2020-04-13","2","47","1","17","19","28.6"
"Baker","2020-04-14","8","55","0","17","11.9","21.4"
"Baker","2020-04-15","2","57","1","18","19","21.4"
"Baker","2020-04-16","4","61","1","19","22.6","23.2"
"Baker","2020-04-17","2","63","0","19","17.9","19.6"
"Baker","2020-04-18","2","65","0","19","17.9","19.6"
"Baker","2020-04-19","0","65","0","19","17.9","19.6"
"Baker","2020-04-20","3","68","0","19","10.7","14.9"
"Baker","2020-04-21","1","69","1","20","25","18.5"
"Baker","2020-04-22","0","69","0","20","17.9","18.5"
"Baker","2020-04-23","2","71","0","20","14.3","18.5"
"Baker","2020-04-24","2","73","0","20","14.3","16.1"
"Baker","2020-04-25","2","75","0","20","14.3","16.1"
"Baker","2020-04-26","2","77","1","21","21.4","19.6"
"Baker","2020-04-27","5","82","0","21","21.4","16.1"
"Baker","2020-04-28","1","83","0","21","7.1","16.1"
"Baker","2020-04-29","6","89","1","22","9.5","13.7"
"Baker","2020-04-30","0","89","0","22","9.5","11.9"
"Baker","2020-05-01","5","94","0","22","9.5","11.9"
"Baker","2020-05-02","0","94","0","22","9.5","11.9"
"Baker","2020-05-03","3","97","1","23","7.1","14.3"
"Baker","2020-05-04","4","101","1","24","10.7","16.1"
"Baker","2020-05-05","1","102","1","25","25","16.1"
"Baker","2020-05-06","3","105","1","26","27.4","18.5"
"Baker","2020-05-07","1","106","0","26","27.4","18.5"
"Baker","2020-05-08","0","106","0","26","27.4","18.5"
"Baker","2020-05-09","2","108","0","26","27.4","18.5"
"Baker","2020-05-10","0","108","0","26","22.6","14.9"
"Baker","2020-05-11","0","108","0","26","19","14.9"
"Baker","2020-05-12","1","109","0","26","4.8","14.9"
"Baker","2020-05-13","8","117","1","27","1.8","14.6"
"Baker","2020-05-14","5","122","0","27","1.8","14.6"
"Baker","2020-05-15","2","124","0","27","1.8","14.6"
"Baker","2020-05-16","2","126","0","27","1.8","14.6"
"Baker","2020-05-17","0","126","0","27","1.8","12.2"
"Baker","2020-05-18","5","131","0","27","1.8","10.4"
"Baker","2020-05-19","1","132","0","27","1.8","3.3"
"Baker","2020-05-20","2","134","2","29","14.3","8"
"Baker","2020-05-21","2","136","0","29","14.3","8"
"Baker","2020-05-22","7","143","0","29","14.3","8"
"Baker","2020-05-23","0","143","0","29","14.3","8"
"Baker","2020-05-24","0","143","0","29","14.3","8"
"Baker","2020-05-25","2","145","0","29","14.3","8"
"Baker","2020-05-26","2","147","0","29","14.3","8"
"Baker","2020-05-27","3","150","0","29","0","7.1"
"Baker","2020-05-28","2","152","0","29","0","7.1"
"Baker","2020-05-29","2","154","2","31","14.3","14.3"
"Baker","2020-05-30","0","154","0","31","14.3","14.3"
"Baker","2020-05-31","0","154","0","31","14.3","14.3"
"Baker","2020-06-01","1","155","0","31","14.3","14.3"
"Baker","2020-06-02","0","155","0","31","14.3","14.3"
"Baker","2020-06-03","0","155","0","31","14.3","7.1"
"Baker","2020-06-04","0","155","0","31","14.3","7.1"
"Baker","2020-06-05","2","157","0","31","0","7.1"
"Baker","2020-06-06","4","161","0","31","0","7.1"
"Baker","2020-06-07","0","161","0","31","0","7.1"
"Baker","2020-06-08","6","167","0","31","0","7.1"
"Baker","2020-06-09","1","168","0","31","0","7.1"
"Baker","2020-06-10","1","169","0","31","0","7.1"
"Baker","2020-06-11","3","172","0","31","0","7.1"
"Baker","2020-06-12","0","172","0","31","0","0"
"Baker","2020-06-13","0","172","0","31","0","0"
"Baker","2020-06-14","0","172","0","31","0","0"
"Baker","2020-06-15","2","174","0","31","0","0"
"Baker","2020-06-16","1","175","0","31","0","0"
"Baker","2020-06-17","3","178","0","31","0","0"
"Baker","2020-06-18","2","180","1","32","7.1","3.6"
"Baker","2020-06-19","0","180","0","32","7.1","3.6"
"Baker","2020-06-20","1","181","0","32","7.1","3.6"
"Baker","2020-06-21","0","181","0","32","7.1","3.6"
"Baker","2020-06-22","6","187","0","32","7.1","3.6"
"Baker","2020-06-23","0","187","0","32","7.1","3.6"
"Baker","2020-06-24","0","187","0","32","7.1","3.6"
"Baker","2020-06-25","2","189","0","32","0","3.6"
"Baker","2020-06-26","2","191","0","32","0","3.6"
"Baker","2020-06-27","1","192","0","32","0","3.6"
"Baker","2020-06-28","0","192","0","32","0","3.6"
"Baker","2020-06-29","1","193","0","32","0","3.6"
"Baker","2020-06-30","3","196","0","32","0","3.6"
"Baker","2020-07-01","4","200","0","32","0","3.6"
"Baker","2020-07-02","7","207","0","32","0","0"
"Baker","2020-07-03","0","207","0","32","0","0"
"Baker","2020-07-04","0","207","0","32","0","0"
"Baker","2020-07-05","0","207","0","32","0","0"
"Baker","2020-07-06","6","213","2","34","4.8","2.4"
"Baker","2020-07-07","4","217","0","34","4.8","2.4"
"Baker","2020-07-08","3","220","0","34","4.8","2.4"
"Baker","2020-07-09","2","222","0","34","4.8","2.4"
"Baker","2020-07-10","2","224","0","34","4.8","2.4"
"Baker","2020-07-11","0","224","0","34","4.8","2.4"
"Baker","2020-07-12","0","224","0","34","4.8","2.4"
"Baker","2020-07-13","8","232","0","34","0","2.4"
"Baker","2020-07-14","6","238","0","34","0","2.4"
"Baker","2020-07-15","2","240","0","34","0","2.4"
"Baker","2020-07-16","4","244","0","34","0","2.4"
"Baker","2020-07-17","1","245","0","34","0","2.4"
"Baker","2020-07-18","0","245","0","34","0","2.4"
"Baker","2020-07-19","3","248","0","34","0","2.4"
"Baker","2020-07-20","1","249","0","34","0","0"
"Baker","2020-07-21","9","258","0","34","0","0"
"Baker","2020-07-22","3","261","0","34","0","0"
"Baker","2020-07-23","6","267","1","35","2.4","1.2"
"Baker","2020-07-24","4","271","1","36","6","3"
"Baker","2020-07-25","3","274","1","37","10.7","5.4"
"Baker","2020-07-26","2","276","0","37","10.7","5.4"
"Baker","2020-07-27","3","279","2","39","20.2","10.1"
"Baker","2020-07-28","6","285","1","40","22.6","11.3"
"Baker","2020-07-29","9","294","0","40","22.6","11.3"
"Baker","2020-07-30","3","297","0","40","20.2","11.3"
"Baker","2020-07-31","4","301","1","41","20.2","13.1"
"Baker","2020-08-01","0","301","0","41","15.5","13.1"
"Baker","2020-08-02","0","301","0","41","15.5","13.1"
"Baker","2020-08-03","7","308","1","42","8","14.1"
"Baker","2020-08-04","4","312","0","42","5.6","14.1"
"Baker","2020-08-05","5","317","0","42","5.6","14.1"
"Baker","2020-08-06","4","321","0","42","5.6","12.9"
"Baker","2020-08-07","4","325","2","44","9.2","14.7"
"Baker","2020-08-08","1","326","0","44","9.2","12.3"
"Baker","2020-08-09","2","328","1","45","16.3","15.9"
"Baker","2020-08-10","2","330","0","45","14.3","11.1"
"Baker","2020-08-11","2","332","0","45","14.3","9.9"
"Baker","2020-08-12","3","335","1","46","19","12.3"
"Baker","2020-08-13","3","338","0","46","19","12.3"
"Baker","2020-08-14","4","342","0","46","11.9","10.5"
"Baker","2020-08-15","1","343","1","47","26.2","17.7"
"Baker","2020-08-16","0","343","0","47","19","17.7"
"Baker","2020-08-17","1","344","0","47","19","16.7"
"Baker","2020-08-18","4","348","0","47","19","16.7"
"Baker","2020-08-19","2","350","0","47","14.3","16.7"
"Baker","2020-08-20","4","354","1","48","17.9","18.5"
"Baker","2020-08-21","0","354","0","48","17.9","14.9"
"Baker","2020-08-22","1","355","0","48","3.6","14.9"
"Baker","2020-08-23","0","355","0","48","3.6","11.3"
"Baker","2020-08-24","3","358","0","48","3.6","11.3"
"Baker","2020-08-25","7","365","1","49","5.6","12.3"
"Baker","2020-08-26","3","368","0","49","5.6","9.9"
"Baker","2020-08-27","1","369","0","49","2","9.9"
"Baker","2020-08-28","2","371","0","49","2","9.9"
"Baker","2020-08-29","2","373","0","49","2","2.8"
"Baker","2020-08-30","0","373","0","49","2","2.8"
"Baker","2020-08-31","1","374","0","49","2","2.8"
"Baker","2020-09-01","6","380","0","49","0","2.8"
"Baker","2020-09-02","7","387","0","49","0","2.8"
"Baker","2020-09-03","1","388","0","49","0","1"
"Baker","2020-09-04","3","391","0","49","0","1"
"Baker","2020-09-05","1","392","0","49","0","1"
"Baker","2020-09-06","0","392","0","49","0","1"
"Baker","2020-09-07","0","392","0","49","0","1"
"Baker","2020-09-08","8","400","0","49","0","0"
"Baker","2020-09-09","5","405","1","50","2.9","1.4"
"Baker","2020-09-10","5","410","0","50","2.9","1.4"
"Baker","2020-09-11","1","411","0","50","2.9","1.4"
"Baker","2020-09-12","1","412","0","50","2.9","1.4"
"Baker","2020-09-13","3","415","0","50","2.9","1.4"
"Baker","2020-09-14","8","423","1","51","4.6","2.3"
"Baker","2020-09-15","8","431","0","51","4.6","2.3"
"Baker","2020-09-16","3","434","1","52","6.5","4.7"
"Baker","2020-09-17","4","438","0","52","6.5","4.7"
"Baker","2020-09-18","4","442","0","52","6.5","4.7"
"Baker","2020-09-19","1","443","0","52","6.5","4.7"
"Baker","2020-09-20","0","443","0","52","6.5","4.7"
"Baker","2020-09-21","5","448","1","53","7.6","6.1"
"Baker","2020-09-22","1","449","0","53","7.6","6.1"
"Baker","2020-09-23","1","450","0","53","2.9","4.7"
"Baker","2020-09-24","4","454","1","54","6.4","6.5"
"Baker","2020-09-25","2","456","0","54","6.4","6.5"
"Baker","2020-09-26","1","457","0","54","6.4","6.5"
"Baker","2020-09-27","0","457","0","54","6.4","6.5"
"Baker","2020-09-28","5","462","0","54","3.6","5.6"
"Baker","2020-09-29","5","467","0","54","3.6","5.6"
"Baker","2020-09-30","1","468","0","54","3.6","3.2"
"Baker","2020-10-01","4","472","0","54","0","3.2"
"Baker","2020-10-02","6","478","0","54","0","3.2"
"Baker","2020-10-03","0","478","0","54","0","3.2"
"Baker","2020-10-04","0","478","0","54","0","3.2"
"Baker","2020-10-05","1","479","0","54","0","1.8"
"Baker","2020-10-06","2","481","0","54","0","1.8"
"Baker","2020-10-07","3","484","0","54","0","1.8"
"Baker","2020-10-08","5","489","1","55","2.9","1.4"
"Baker","2020-10-09","2","491","0","55","2.9","1.4"
"Baker","2020-10-10","0","491","0","55","2.9","1.4"
"Baker","2020-10-11","1","492","0","55","2.9","1.4"
"Baker","2020-10-12","4","496","0","55","2.9","1.4"
"Baker","2020-10-13","3","499","0","55","2.9","1.4"
"Baker","2020-10-14","3","502","0","55","2.9","1.4"
"Baker","2020-10-15","4","506","0","55","0","1.4"
"Baker","2020-10-16","3","509","1","56","4.8","3.8"
"Baker","2020-10-17","0","509","0","56","4.8","3.8"
"Baker","2020-10-18","0","509","0","56","4.8","3.8"
"Baker","2020-10-19","2","511","0","56","4.8","3.8"
"Baker","2020-10-20","3","514","1","57","9.5","6.2"
"Baker","2020-10-21","3","517","0","57","9.5","6.2"
"Baker","2020-10-22","1","518","0","57","9.5","4.8"
"Baker","2020-10-23","4","522","0","57","4.8","4.8"
"Baker","2020-10-24","1","523","0","57","4.8","4.8"
"Baker","2020-10-25","0","523","0","57","4.8","4.8"
"Baker","2020-10-26","0","523","0","57","4.8","4.8"
"Baker","2020-10-27","2","525","0","57","0","4.8"
"Baker","2020-10-28","5","530","0","57","0","4.8"
"Baker","2020-10-29","2","532","0","57","0","4.8"
"Baker","2020-10-30","4","536","0","57","0","2.4"
"Baker","2020-10-31","0","536","0","57","0","2.4"
"Baker","2020-11-01","2","538","1","58","7.1","6"
"Baker","2020-11-02","4","542","0","58","7.1","6"
"Baker","2020-11-03","4","546","0","58","7.1","3.6"
"Baker","2020-11-04","1","547","1","59","21.4","10.7"
"Baker","2020-11-05","4","551","0","59","21.4","10.7"
"Baker","2020-11-06","1","552","1","60","35.7","17.9"
"Baker","2020-11-07","2","554","1","61","42.9","21.4"
"Baker","2020-11-08","3","557","0","61","35.7","21.4"
"Baker","2020-11-09","6","563","0","61","35.7","21.4"
"Baker","2020-11-10","8","571","3","64","41.1","24.1"
"Baker","2020-11-11","5","576","1","65","29.6","25.5"
"Baker","2020-11-12","2","578","0","65","29.6","25.5"
"Baker","2020-11-13","1","579","0","65","15.4","25.5"
"Baker","2020-11-14","3","582","0","65","8.2","25.5"
"Baker","2020-11-15","3","585","1","66","13","24.3"
"Baker","2020-11-16","1","586","0","66","13","24.3"
"Baker","2020-11-17","7","593","1","67","9.7","25.4"
"Baker","2020-11-18","0","593","0","67","6.8","18.2"
"Baker","2020-11-19","3","596","0","67","6.8","18.2"
"Baker","2020-11-20","1","597","0","67","6.8","11.1"
"Baker","2020-11-21","1","598","1","68","21.1","14.7"
"Baker","2020-11-22","0","598","0","68","16.3","14.7"
"Baker","2020-11-23","7","605","2","70","20.4","16.7"
"Baker","2020-11-24","4","609","0","70","18.4","14"
"Baker","2020-11-25","5","614","0","70","18.4","12.6"
"Baker","2020-11-26","0","614","0","70","18.4","12.6"
"Baker","2020-11-27","0","614","0","70","18.4","12.6"
"Baker","2020-11-28","2","616","0","70","4.1","12.6"
"Baker","2020-11-29","3","619","0","70","4.1","10.2"
"Baker","2020-11-30","4","623","1","71","3.6","12"
"Baker","2020-12-01","3","626","0","71","3.6","11"
"Baker","2020-12-02","2","628","0","71","3.6","11"
"Baker","2020-12-03","2","630","0","71","3.6","11"
"Baker","2020-12-04","3","633","2","73","13.1","15.7"
"Baker","2020-12-05","0","633","0","73","13.1","8.6"
"Baker","2020-12-06","0","633","0","73","13.1","8.6"
"Baker","2020-12-07","5","638","0","73","9.5","6.5"
"Baker","2020-12-08","7","645","2","75","13.6","8.6"
"Baker","2020-12-09","5","650","1","76","16.5","10"
"Baker","2020-12-10","6","656","1","77","18.8","11.2"
"Baker","2020-12-11","8","664","0","77","9.3","11.2"
"Baker","2020-12-12","1","665","0","77","9.3","11.2"
"Baker","2020-12-13","1","666","0","77","9.3","11.2"
"Baker","2020-12-14","4","670","2","79","16.5","13"
"Baker","2020-12-15","6","676","2","81","17.1","15.4"
"Baker","2020-12-16","8","684","4","85","21.4","18.9"
"Baker","2020-12-17","1","685","0","85","19","18.9"
"Baker","2020-12-18","7","692","0","85","19","14.2"
"Baker","2020-12-19","0","692","0","85","19","14.2"
"Baker","2020-12-20","2","694","1","86","26.2","17.8"
"Baker","2020-12-21","11","705","1","87","20.3","18.4"
"Baker","2020-12-22","14","719","4","91","19.7","18.4"
"Baker","2020-12-23","8","727","1","92","14.3","17.9"
"Baker","2020-12-24","1","728","0","92","14.3","16.7"
"Baker","2020-12-25","0","728","0","92","14.3","16.7"
"Baker","2020-12-26","0","728","0","92","14.3","16.7"
"Baker","2020-12-27","2","730","1","93","14.3","20.2"
"Baker","2020-12-28","7","737","1","94","15.1","17.7"
"Baker","2020-12-29","6","743","2","96","15.7","17.7"
"Baker","2020-12-30","7","750","0","96","13.9","14.1"
"Baker","2020-12-31","8","758","0","96","13.9","14.1"
"Baker","2021-01-01","0","758","0","96","13.9","14.1"
"Baker","2021-01-02","2","760","0","96","13.9","14.1"
"Baker","2021-01-03","1","761","0","96","6.8","10.6"
"Baker","2021-01-04","8","769","1","97","6.5","10.8"
"Baker","2021-01-05","9","778","0","97","1.8","8.8"
"Baker","2021-01-06","6","784","1","98","4.2","9.1"
"Baker","2021-01-07","3","787","0","98","4.2","9.1"
"Baker","2021-01-08","6","793","0","98","4.2","9.1"
"Baker","2021-01-09","1","794","0","98","4.2","9.1"
"Baker","2021-01-10","0","794","0","98","4.2","5.5"
"Baker","2021-01-11","5","799","1","99","5.2","5.9"
"Baker","2021-01-12","9","808","1","100","6.8","4.3"
"Baker","2021-01-13","9","817","1","101","6","5.1"
"Baker","2021-01-14","5","822","0","101","6","5.1"
"Baker","2021-01-15","4","826","1","102","9.6","6.9"
"Baker","2021-01-16","1","827","0","102","9.6","6.9"
"Baker","2021-01-17","3","830","1","103","14.4","9.3"
"Baker","2021-01-18","6","836","1","104","13.9","9.6"
"Baker","2021-01-19","5","841","0","104","12.3","9.6"
"Baker","2021-01-20","2","843","0","104","10.7","8.4"
"Baker","2021-01-21","7","850","1","105","12.8","9.4"
"Baker","2021-01-22","4","854","1","106","12.8","11.2"
"Baker","2021-01-23","3","857","0","106","12.8","11.2"
"Baker","2021-01-24","1","858","0","106","8","11.2"
"Baker","2021-01-25","2","860","0","106","5.6","9.8"
"Baker","2021-01-26","3","863","1","107","10.4","11.3"
"Baker","2021-01-27","0","863","0","107","10.4","10.5"
"Baldwin","2020-02-01","0","0","0","0",".","."
"Baldwin","2020-02-02","0","0","0","0",".","."
"Baldwin","2020-02-03","0","0","0","0",".","."
"Baldwin","2020-02-04","0","0","0","0",".","."
"Baldwin","2020-02-05","0","0","0","0",".","."
"Baldwin","2020-02-06","0","0","0","0",".","."
"Baldwin","2020-02-07","0","0","0","0","0","."
"Baldwin","2020-02-08","0","0","0","0","0","."
"Baldwin","2020-02-09","0","0","0","0","0","."
"Baldwin","2020-02-10","0","0","0","0","0","."
"Baldwin","2020-02-11","0","0","0","0","0","."
"Baldwin","2020-02-12","0","0","0","0","0","."
"Baldwin","2020-02-13","0","0","0","0","0","."
"Baldwin","2020-02-14","0","0","0","0","0","0"
"Baldwin","2020-02-15","0","0","0","0","0","0"
"Baldwin","2020-02-16","0","0","0","0","0","0"
"Baldwin","2020-02-17","0","0","0","0","0","0"
"Baldwin","2020-02-18","0","0","0","0","0","0"
"Baldwin","2020-02-19","0","0","0","0","0","0"
"Baldwin","2020-02-20","0","0","0","0","0","0"
"Baldwin","2020-02-21","0","0","0","0","0","0"
"Baldwin","2020-02-22","0","0","0","0","0","0"
"Baldwin","2020-02-23","0","0","0","0","0","0"
"Baldwin","2020-02-24","0","0","0","0","0","0"
"Baldwin","2020-02-25","0","0","0","0","0","0"
"Baldwin","2020-02-26","0","0","0","0","0","0"
"Baldwin","2020-02-27","0","0","0","0","0","0"
"Baldwin","2020-02-28","0","0","0","0","0","0"
"Baldwin","2020-02-29","0","0","0","0","0","0"
"Baldwin","2020-03-01","0","0","0","0","0","0"
"Baldwin","2020-03-02","0","0","0","0","0","0"
"Baldwin","2020-03-03","0","0","0","0","0","0"
"Baldwin","2020-03-04","0","0","0","0","0","0"
"Baldwin","2020-03-05","0","0","0","0","0","0"
"Baldwin","2020-03-06","0","0","0","0","0","0"
"Baldwin","2020-03-07","0","0","0","0","0","0"
"Baldwin","2020-03-08","3","3","0","0","0","0"
"Baldwin","2020-03-09","1","4","1","1","14.3","7.1"
"Baldwin","2020-03-10","0","4","0","1","14.3","7.1"
"Baldwin","2020-03-11","1","5","0","1","14.3","7.1"
"Baldwin","2020-03-12","1","6","0","1","14.3","7.1"
"Baldwin","2020-03-13","1","7","0","1","14.3","7.1"
"Baldwin","2020-03-14","2","9","0","1","14.3","7.1"
"Baldwin","2020-03-15","2","11","0","1","14.3","7.1"
"Baldwin","2020-03-16","1","12","0","1","0","7.1"
"Baldwin","2020-03-17","2","14","0","1","0","7.1"
"Baldwin","2020-03-18","1","15","0","1","0","7.1"
"Baldwin","2020-03-19","4","19","1","2","3.6","8.9"
"Baldwin","2020-03-20","7","26","3","5","9.7","12"
"Baldwin","2020-03-21","2","28","0","5","9.7","12"
"Baldwin","2020-03-22","5","33","1","6","12.6","13.4"
"Baldwin","2020-03-23","3","36","1","7","17.3","8.7"
"Baldwin","2020-03-24","6","42","0","7","17.3","8.7"
"Baldwin","2020-03-25","1","43","0","7","17.3","8.7"
"Baldwin","2020-03-26","9","52","2","9","16.9","10.2"
"Baldwin","2020-03-27","9","61","2","11","14","11.8"
"Baldwin","2020-03-28","6","67","1","12","16.3","13"
"Baldwin","2020-03-29","7","74","3","15","19.6","16.1"
"Baldwin","2020-03-30","8","82","1","16","16.6","17"
"Baldwin","2020-03-31","11","93","3","19","20.5","18.9"
"Baldwin","2020-04-01","20","113","8","27","26.2","21.8"
"Baldwin","2020-04-02","22","135","2","29","24.4","20.6"
"Baldwin","2020-04-03","17","152","5","34","25.4","19.7"
"Baldwin","2020-04-04","11","163","2","36","25.6","21"
"Baldwin","2020-04-05","2","165","1","37","26.6","23.1"
"Baldwin","2020-04-06","22","187","6","43","28.7","22.7"
"Baldwin","2020-04-07","24","211","10","53","30.8","25.7"
"Baldwin","2020-04-08","22","233","4","57","27.7","27"
"Baldwin","2020-04-09","13","246","2","59","28.6","26.5"
"Baldwin","2020-04-10","51","297","27","86","31.9","28.7"
"Baldwin","2020-04-11","23","320","11","97","36.2","30.9"
"Baldwin","2020-04-12","10","330","1","98","30.5","28.6"
"Baldwin","2020-04-13","32","362","7","105","29.7","29.2"
"Baldwin","2020-04-14","55","417","20","125","28.9","29.9"
"Baldwin","2020-04-15","36","453","16","141","32.7","30.2"
"Baldwin","2020-04-16","48","501","9","150","33.2","30.9"
"Baldwin","2020-04-17","39","540","8","158","28.5","30.2"
"Baldwin","2020-04-18","8","548","2","160","25.3","30.7"
"Baldwin","2020-04-19","5","553","2","162","29.6","30"
"Baldwin","2020-04-20","38","591","10","172","30.2","29.9"
"Baldwin","2020-04-21","41","632","7","179","27.4","28.2"
"Baldwin","2020-04-22","31","663","2","181","22","27.4"
"Baldwin","2020-04-23","22","685","5","186","22.6","27.9"
"Baldwin","2020-04-24","38","723","7","193","22.3","25.4"
"Baldwin","2020-04-25","96","819","4","197","19.3","22.3"
"Baldwin","2020-04-26","69","888","7","204","15","22.3"
"Baldwin","2020-04-27","93","981","9","213","12.7","21.4"
"Baldwin","2020-04-28","40","1021","6","219","12.4","19.9"
"Baldwin","2020-04-29","56","1077","7","226","13.2","17.6"
"Baldwin","2020-04-30","28","1105","3","229","11.5","17.1"
"Baldwin","2020-05-01","24","1129","6","235","12.5","17.4"
"Baldwin","2020-05-02","16","1145","3","238","14.5","16.9"
"Baldwin","2020-05-03","10","1155","2","240","15.9","15.5"
"Baldwin","2020-05-04","85","1240","12","252","16.6","14.6"
"Baldwin","2020-05-05","38","1278","5","257","16.3","14.3"
"Baldwin","2020-05-06","24","1302","4","261","16.9","15.1"
"Baldwin","2020-05-07","40","1342","7","268","17.9","14.7"
"Baldwin","2020-05-08","41","1383","8","276","17.1","14.8"
"Baldwin","2020-05-09","6","1389","1","277","16.8","15.7"
"Baldwin","2020-05-10","10","1399","1","278","15.4","15.7"
"Baldwin","2020-05-11","33","1432","7","285","16.4","16.5"
"Baldwin","2020-05-12","32","1464","6","291","17.2","16.8"
"Baldwin","2020-05-13","56","1520","11","302","17.6","17.3"
"Baldwin","2020-05-14","29","1549","4","306","17.1","17.5"
"Baldwin","2020-05-15","64","1613","6","312","15.6","16.4"
"Baldwin","2020-05-16","20","1633","2","314","14.7","15.7"
"Baldwin","2020-05-17","28","1661","2","316","14.3","14.8"
"Baldwin","2020-05-18","33","1694","6","322","13.8","15.1"
"Baldwin","2020-05-19","43","1737","3","325","12.2","14.7"
"Baldwin","2020-05-20","26","1763","3","328","11","14.3"
"Baldwin","2020-05-21","32","1795","5","333","11.3","14.2"
"Baldwin","2020-05-22","112","1907","5","338","10.6","13.1"
"Baldwin","2020-05-23","28","1935","2","340","10.2","12.4"
"Baldwin","2020-05-24","26","1961","1","341","9.7","12"
"Baldwin","2020-05-25","12","1973","2","343","9.5","11.7"
"Baldwin","2020-05-26","31","2004","4","347","10.3","11.2"
"Baldwin","2020-05-27","49","2053","4","351","9.8","10.4"
"Baldwin","2020-05-28","45","2098","2","353","8.2","9.7"
"Baldwin","2020-05-29","16","2114","1","354","8.5","9.5"
"Baldwin","2020-05-30","9","2123","1","355","9.1","9.6"
"Baldwin","2020-05-31","7","2130","4","359","16.7","13.2"
"Baldwin","2020-06-01","23","2153","2","361","15.5","12.5"
"Baldwin","2020-06-02","46","2199","5","366","15.2","12.8"
"Baldwin","2020-06-03","56","2255","6","372","15.6","12.7"
"Baldwin","2020-06-04","53","2308","7","379","16.9","12.5"
"Baldwin","2020-06-05","145","2453","11","390","17","12.8"
"Baldwin","2020-06-06","11","2464","1","391","16.8","12.9"
"Baldwin","2020-06-07","4","2468","0","391","8.6","12.6"
"Baldwin","2020-06-08","43","2511","7","398","9.7","12.6"
"Baldwin","2020-06-09","38","2549","7","405","10.8","13"
"Baldwin","2020-06-10","45","2594","5","410","10.8","13.2"
"Baldwin","2020-06-11","32","2626","2","412","9.8","13.3"
"Baldwin","2020-06-12","77","2703","4","416","9.5","13.3"
"Baldwin","2020-06-13","6","2709","0","416","8.2","12.5"
"Baldwin","2020-06-14","8","2717","0","416","8.2","8.4"
"Baldwin","2020-06-15","78","2795","9","425","7.5","8.6"
"Baldwin","2020-06-16","49","2844","3","428","5.7","8.3"
"Baldwin","2020-06-17","61","2905","11","439","6.7","8.8"
"Baldwin","2020-06-18","51","2956","4","443","7","8.4"
"Baldwin","2020-06-19","73","3029","10","453","8.2","8.8"
"Baldwin","2020-06-20","16","3045","4","457","11.7","10"
"Baldwin","2020-06-21","14","3059","2","459","13.8","11"
"Baldwin","2020-06-22","81","3140","9","468","13.7","10.6"
"Baldwin","2020-06-23","43","3183","6","474","14.8","10.3"
"Baldwin","2020-06-24","84","3267","7","481","13.5","10.1"
"Baldwin","2020-06-25","49","3316","4","485","13.5","10.2"
"Baldwin","2020-06-26","340","3656","19","504","12.3","10.3"
"Baldwin","2020-06-27","73","3729","11","515","10.9","11.3"
"Baldwin","2020-06-28","18","3747","5","520","12.9","13.3"
"Baldwin","2020-06-29","132","3879","11","531","12.5","13.1"
"Baldwin","2020-06-30","124","4003","13","544","12","13.4"
"Baldwin","2020-07-01","193","4196","27","571","12.8","13.1"
"Baldwin","2020-07-02","70","4266","11","582","13.9","13.7"
"Baldwin","2020-07-03","81","4347","9","591","14.6","13.5"
"Baldwin","2020-07-04","41","4388","5","596","14.2","12.6"
"Baldwin","2020-07-05","12","4400","1","597","11.5","12.2"
"Baldwin","2020-07-06","230","4630","20","617","11.5","12"
"Baldwin","2020-07-07","81","4711","9","626","11.6","11.8"
"Baldwin","2020-07-08","171","4882","17","643","11","11.9"
"Baldwin","2020-07-09","63","4945","9","652","10.8","12.3"
"Baldwin","2020-07-10","197","5142","12","664","10.1","12.4"
"Baldwin","2020-07-11","59","5201","11","675","11","12.6"
"Baldwin","2020-07-12","33","5234","10","685","14.2","12.8"
"Baldwin","2020-07-13","144","5378","11","696","14","12.8"
"Baldwin","2020-07-14","93","5471","9","705","13.8","12.7"
"Baldwin","2020-07-15","238","5709","16","721","13.3","12.2"
"Baldwin","2020-07-16","83","5792","8","729","12.7","11.7"
"Baldwin","2020-07-17","182","5974","15","744","13","11.5"
"Baldwin","2020-07-18","18","5992","4","748","13.5","12.3"
"Baldwin","2020-07-19","26","6018","9","757","14.1","14.1"
"Baldwin","2020-07-20","184","6202","21","778","14.6","14.3"
"Baldwin","2020-07-21","121","6323","23","801","16","14.9"
"Baldwin","2020-07-22","123","6446","11","812","16.3","14.8"
"Baldwin","2020-07-23","79","6525","18","830","18.2","15.4"
"Baldwin","2020-07-24","227","6752","27","857","18.7","15.8"
"Baldwin","2020-07-25","170","6922","18","875","17","15.3"
"Baldwin","2020-07-26","43","6965","8","883","14.7","14.4"
"Baldwin","2020-07-27","141","7106","29","912","16.1","15.4"
"Baldwin","2020-07-28","117","7223","20","932","15.8","15.9"
"Baldwin","2020-07-29","125","7348","14","946","16.1","16.2"
"Baldwin","2020-07-30","149","7497","13","959","14.1","16.1"
"Baldwin","2020-07-31","243","7740","28","987","14","16.4"
"Baldwin","2020-08-01","111","7851","7","994","13.4","15.2"
"Baldwin","2020-08-02","44","7895","6","1000","12.7","13.7"
"Baldwin","2020-08-03","135","8030","11","1011","10.9","13.5"
"Baldwin","2020-08-04","55","8085","8","1019","10.6","13.2"
"Baldwin","2020-08-05","154","8239","18","1037","10.7","13.4"
"Baldwin","2020-08-06","95","8334","14","1051","11.5","12.8"
"Baldwin","2020-08-07","199","8533","9","1060","10.5","12.3"
"Baldwin","2020-08-08","60","8593","8","1068","11.5","12.5"
"Baldwin","2020-08-09","35","8628","5","1073","11.6","12.2"
"Baldwin","2020-08-10","120","8748","11","1084","11.8","11.4"
"Baldwin","2020-08-11","53","8801","9","1093","12.1","11.3"
"Baldwin","2020-08-12","147","8948","10","1103","11.4","11"
"Baldwin","2020-08-13","58","9006","6","1109","10.8","11.1"
"Baldwin","2020-08-14","229","9235","11","1120","10.8","10.7"
"Baldwin","2020-08-15","78","9313","7","1127","10.2","10.9"
"Baldwin","2020-08-16","28","9341","4","1131","10.2","10.9"
"Baldwin","2020-08-17","82","9423","16","1147","11.7","11.7"
"Baldwin","2020-08-18","69","9492","8","1155","10.9","11.5"
"Baldwin","2020-08-19","162","9654","29","1184","12.5","11.9"
"Baldwin","2020-08-20","79","9733","19","1203","14.4","12.6"
"Baldwin","2020-08-21","421","10154","36","1239","15","12.9"
"Baldwin","2020-08-22","45","10199","10","1249","16.9","13.5"
"Baldwin","2020-08-23","41","10240","12","1261","19","14.6"
"Baldwin","2020-08-24","90","10330","10","1271","17.8","14.7"
"Baldwin","2020-08-25","106","10436","17","1288","18.4","14.7"
"Baldwin","2020-08-26","150","10586","18","1306","17.6","15"
"Baldwin","2020-08-27","83","10669","8","1314","15.5","15"
"Baldwin","2020-08-28","144","10813","10","1324","15.3","15.1"
"Baldwin","2020-08-29","22","10835","4","1328","14.7","15.8"
"Baldwin","2020-08-30","15","10850","3","1331","13.4","16.2"
"Baldwin","2020-08-31","328","11178","13","1344","12.4","15.1"
"Baldwin","2020-09-01","46","11224","8","1352","12.6","15.5"
"Baldwin","2020-09-02","104","11328","19","1371","13.5","15.5"
"Baldwin","2020-09-03","74","11402","7","1378","13.5","14.5"
"Baldwin","2020-09-04","138","11540","23","1401","14.8","15.1"
"Baldwin","2020-09-05","164","11704","5","1406","12.7","13.7"
"Baldwin","2020-09-06","71","11775","9","1415","11.6","12.5"
"Baldwin","2020-09-07","19","11794","4","1419","14.1","13.2"
"Baldwin","2020-09-08","65","11859","9","1428","13.6","13.1"
"Baldwin","2020-09-09","93","11952","19","1447","13.9","13.7"
"Baldwin","2020-09-10","53","12005","4","1451","13.6","13.5"
"Baldwin","2020-09-11","131","12136","13","1464","12.6","13.7"
"Baldwin","2020-09-12","23","12159","4","1468","14.7","13.7"
"Baldwin","2020-09-13","25","12184","7","1475","16.9","14.3"
"Baldwin","2020-09-14","110","12294","12","1487","15.4","14.8"
"Baldwin","2020-09-15","46","12340","5","1492","15","14.3"
"Baldwin","2020-09-16","201","12541","12","1504","12.9","13.4"
"Baldwin","2020-09-17","146","12687","9","1513","12.7","13.2"
"Baldwin","2020-09-18","81","12768","4","1517","12","12.3"
"Baldwin","2020-09-19","25","12793","3","1520","11.3","13"
"Baldwin","2020-09-20","20","12813","0","1520","7.3","12.1"
"Baldwin","2020-09-21","65","12878","11","1531","8.1","11.8"
"Baldwin","2020-09-22","63","12941","9","1540","8.6","11.8"
"Baldwin","2020-09-23","75","13016","5","1545","8.7","10.8"
"Baldwin","2020-09-24","49","13065","4","1549","9","10.9"
"Baldwin","2020-09-25","101","13166","1","1550","8.4","10.2"
"Baldwin","2020-09-26","36","13202","6","1556","9.1","10.2"
"Baldwin","2020-09-27","18","13220","2","1558","10.7","9"
"Baldwin","2020-09-28","77","13297","8","1566","9.8","8.9"
"Baldwin","2020-09-29","39","13336","1","1567","8.1","8.3"
"Baldwin","2020-09-30","107","13443","7","1574","8.1","8.4"
"Baldwin","2020-10-01","85","13528","3","1577","7.4","8.2"
"Baldwin","2020-10-02","159","13687","3","1580","7.5","8"
"Baldwin","2020-10-03","346","14033","1","1581","5.2","7.1"
"Baldwin","2020-10-04","14","14047","3","1584","6.7","8.7"
"Baldwin","2020-10-05","72","14119","3","1587","5.8","7.8"
"Baldwin","2020-10-06","63","14182","6","1593","6.8","7.4"
"Baldwin","2020-10-07","71","14253","9","1602","7.6","7.9"
"Baldwin","2020-10-08","41","14294","2","1604","7.8","7.6"
"Baldwin","2020-10-09","391","14685","5","1609","7.7","7.6"
"Baldwin","2020-10-10","26","14711","1","1610","8.3","6.7"
"Baldwin","2020-10-11","27","14738","1","1611","5.7","6.2"
"Baldwin","2020-10-12","76","14814","6","1617","6.3","6"
"Baldwin","2020-10-13","72","14886","9","1626","6.7","6.7"
"Baldwin","2020-10-14","108","14994","11","1637","6.3","7"
"Baldwin","2020-10-15","99","15093","6","1643","6.5","7.2"
"Baldwin","2020-10-16","252","15345","7","1650","6.7","7.2"
"Baldwin","2020-10-17","34","15379","1","1651","6.6","7.4"
"Baldwin","2020-10-18","18","15397","3","1654","8.4","7.1"
"Baldwin","2020-10-19","73","15470","7","1661","8.7","7.5"
"Baldwin","2020-10-20","51","15521","1","1662","7.2","6.9"
"Baldwin","2020-10-21","101","15622","10","1672","7.1","6.7"
"Baldwin","2020-10-22","70","15692","4","1676","7.1","6.8"
"Baldwin","2020-10-23","298","15990","2","1678","6.8","6.7"
"Baldwin","2020-10-24","37","16027","3","1681","7.5","7"
"Baldwin","2020-10-25","27","16054","2","1683","6.2","7.3"
"Baldwin","2020-10-26","94","16148","6","1689","5.7","7.2"
"Baldwin","2020-10-27","55","16203","7","1696","7.3","7.2"
"Baldwin","2020-10-28","93","16296","10","1706","7.4","7.3"
"Baldwin","2020-10-29","57","16353","3","1709","7.3","7.2"
"Baldwin","2020-10-30","120","16473","3","1712","7.6","7.2"
"Baldwin","2020-10-31","130","16603","0","1712","6.4","7"
"Baldwin","2020-11-01","19","16622","4","1716","8.4","7.3"
"Baldwin","2020-11-02","106","16728","14","1730","9.4","7.5"
"Baldwin","2020-11-03","51","16779","2","1732","8.1","7.7"
"Baldwin","2020-11-04","93","16872","5","1737","7.3","7.4"
"Baldwin","2020-11-05","174","17046","5","1742","7","7.2"
"Baldwin","2020-11-06","159","17205","8","1750","7.4","7.5"
"Baldwin","2020-11-07","68","17273","3","1753","8","7.2"
"Baldwin","2020-11-08","24","17297","1","1754","5.6","7"
"Baldwin","2020-11-09","75","17372","5","1759","4.6","7"
"Baldwin","2020-11-10","69","17441","7","1766","5.5","6.8"
"Baldwin","2020-11-11","69","17510","5","1771","5.8","6.6"
"Baldwin","2020-11-12","62","17572","1","1772","5.6","6.3"
"Baldwin","2020-11-13","272","17844","10","1782","5.4","6.4"
"Baldwin","2020-11-14","58","17902","6","1788","6.3","7.1"
"Baldwin","2020-11-15","48","17950","3","1791","6.6","6.1"
"Baldwin","2020-11-16","113","18063","6","1797","6.4","5.5"
"Baldwin","2020-11-17","72","18135","2","1799","5.3","5.4"
"Baldwin","2020-11-18","129","18264","14","1813","5.8","5.8"
"Baldwin","2020-11-19","93","18357","7","1820","6.7","6.1"
"Baldwin","2020-11-20","107","18464","8","1828","7.2","6.3"
"Baldwin","2020-11-21","56","18520","5","1833","7","6.6"
"Baldwin","2020-11-22","56","18576","5","1838","7.4","7"
"Baldwin","2020-11-23","99","18675","4","1842","7.2","6.8"
"Baldwin","2020-11-24","52","18727","4","1846","7.9","6.6"
"Baldwin","2020-11-25","153","18880","16","1862","7.9","6.8"
"Baldwin","2020-11-26","22","18902","5","1867","10","8.4"
"Baldwin","2020-11-27","167","19069","8","1875","9.7","8.4"
"Baldwin","2020-11-28","50","19119","8","1883","10.7","8.8"
"Baldwin","2020-11-29","73","19192","5","1888","10.4","8.9"
"Baldwin","2020-11-30","113","19305","11","1899","11.2","9.2"
"Baldwin","2020-12-01","72","19377","12","1911","12.5","10.2"
"Baldwin","2020-12-02","104","19481","13","1924","12.8","10.3"
"Baldwin","2020-12-03","86","19567","6","1930","10.5","10.3"
"Baldwin","2020-12-04","163","19730","7","1937","10.4","10"
"Baldwin","2020-12-05","84","19814","2","1939","8.5","9.6"
"Baldwin","2020-12-06","47","19861","8","1947","9.9","10.2"
"Baldwin","2020-12-07","118","19979","14","1961","10.2","10.7"
"Baldwin","2020-12-08","91","20070","6","1967","8.8","10.6"
"Baldwin","2020-12-09","112","20182","14","1981","8.8","10.8"
"Baldwin","2020-12-10","106","20288","5","1986","8.5","9.5"
"Baldwin","2020-12-11","154","20442","12","1998","9","9.7"
"Baldwin","2020-12-12","22","20464","3","2001","10.6","9.5"
"Baldwin","2020-12-13","46","20510","5","2006","9.7","9.8"
"Baldwin","2020-12-14","118","20628","12","2018","9.5","9.9"
"Baldwin","2020-12-15","102","20730","14","2032","10.5","9.6"
"Baldwin","2020-12-16","143","20873","29","2061","11.6","10.2"
"Baldwin","2020-12-17","122","20995","16","2077","12.8","10.6"
"Baldwin","2020-12-18","145","21140","22","2099","13.9","11.4"
"Baldwin","2020-12-19","133","21273","16","2115","13.6","12.1"
"Baldwin","2020-12-20","48","21321","19","2134","17.7","13.7"
"Baldwin","2020-12-21","113","21434","18","2152","18.5","14"
"Baldwin","2020-12-22","79","21513","10","2162","18.4","14.4"
"Baldwin","2020-12-23","210","21723","35","2197","17.9","14.7"
"Baldwin","2020-12-24","62","21785","12","2209","18.8","15.8"
"Baldwin","2020-12-25","15","21800","4","2213","20.4","17.1"
"Baldwin","2020-12-26","127","21927","18","2231","20.7","17.2"
"Baldwin","2020-12-27","43","21970","16","2247","20.4","19.1"
"Baldwin","2020-12-28","198","22168","31","2278","20.3","19.4"
"Baldwin","2020-12-29","93","22261","13","2291","20.5","19.5"
"Baldwin","2020-12-30","159","22420","38","2329","21.6","19.7"
"Baldwin","2020-12-31","173","22593","12","2341","19.8","19.3"
"Baldwin","2021-01-01","26","22619","9","2350","20.9","20.7"
"Baldwin","2021-01-02","74","22693","17","2367","22.2","21.5"
"Baldwin","2021-01-03","50","22743","7","2374","18.9","19.6"
"Baldwin","2021-01-04","100","22843","23","2397","19.9","20.1"
"Baldwin","2021-01-05","198","23041","27","2424","19.9","20.2"
"Baldwin","2021-01-06","196","23237","27","2451","18.4","20"
"Baldwin","2021-01-07","182","23419","25","2476","19.4","19.6"
"Baldwin","2021-01-08","101","23520","15","2491","16.6","18.7"
"Baldwin","2021-01-09","68","23588","15","2506","16.4","19.3"
"Baldwin","2021-01-10","56","23644","14","2520","18","18.4"
"Baldwin","2021-01-11","163","23807","29","2549","17.3","18.6"
"Baldwin","2021-01-12","172","23979","25","2574","17.4","18.6"
"Baldwin","2021-01-13","109","24088","19","2593","17.9","18.2"
"Baldwin","2021-01-14","173","24261","15","2608","17.2","18.3"
"Baldwin","2021-01-15","151","24412","17","2625","16.7","16.6"
"Baldwin","2021-01-16","52","24464","6","2631","15.2","15.8"
"Baldwin","2021-01-17","48","24512","8","2639","14","16"
"Baldwin","2021-01-18","119","24631","22","2661","14.1","15.7"
"Baldwin","2021-01-19","100","24731","9","2670","13.3","15.3"
"Baldwin","2021-01-20","153","24884","13","2683","12","15"
"Baldwin","2021-01-21","123","25007","16","2699","12.6","14.9"
"Baldwin","2021-01-22","184","25191","28","2727","13.2","14.9"
"Baldwin","2021-01-23","40","25231","13","2740","16.2","15.7"
"Baldwin","2021-01-24","35","25266","5","2745","15.9","14.9"
"Baldwin","2021-01-25","18","25284","4","2749","16.4","15.2"
"Baldwin","2021-01-26","5","25289","0","2749","15.1","14.2"
"Baldwin","2021-01-27","0","25289","0","2749","13.9","13"
"Banks","2020-02-01","0","0","0","0",".","."
"Banks","2020-02-02","0","0","0","0",".","."
"Banks","2020-02-03","0","0","0","0",".","."
"Banks","2020-02-04","0","0","0","0",".","."
"Banks","2020-02-05","0","0","0","0",".","."
"Banks","2020-02-06","0","0","0","0",".","."
"Banks","2020-02-07","0","0","0","0","0","."
"Banks","2020-02-08","0","0","0","0","0","."
"Banks","2020-02-09","0","0","0","0","0","."
"Banks","2020-02-10","0","0","0","0","0","."
"Banks","2020-02-11","0","0","0","0","0","."
"Banks","2020-02-12","0","0","0","0","0","."
"Banks","2020-02-13","0","0","0","0","0","."
"Banks","2020-02-14","0","0","0","0","0","0"
"Banks","2020-02-15","0","0","0","0","0","0"
"Banks","2020-02-16","0","0","0","0","0","0"
"Banks","2020-02-17","0","0","0","0","0","0"
"Banks","2020-02-18","0","0","0","0","0","0"
"Banks","2020-02-19","0","0","0","0","0","0"
"Banks","2020-02-20","0","0","0","0","0","0"
"Banks","2020-02-21","0","0","0","0","0","0"
"Banks","2020-02-22","0","0","0","0","0","0"
"Banks","2020-02-23","0","0","0","0","0","0"
"Banks","2020-02-24","0","0","0","0","0","0"
"Banks","2020-02-25","0","0","0","0","0","0"
"Banks","2020-02-26","0","0","0","0","0","0"
"Banks","2020-02-27","0","0","0","0","0","0"
"Banks","2020-02-28","0","0","0","0","0","0"
"Banks","2020-02-29","0","0","0","0","0","0"
"Banks","2020-03-01","0","0","0","0","0","0"
"Banks","2020-03-02","0","0","0","0","0","0"
"Banks","2020-03-03","0","0","0","0","0","0"
"Banks","2020-03-04","0","0","0","0","0","0"
"Banks","2020-03-05","0","0","0","0","0","0"
"Banks","2020-03-06","0","0","0","0","0","0"
"Banks","2020-03-07","0","0","0","0","0","0"
"Banks","2020-03-08","0","0","0","0","0","0"
"Banks","2020-03-09","0","0","0","0","0","0"
"Banks","2020-03-10","0","0","0","0","0","0"
"Banks","2020-03-11","0","0","0","0","0","0"
"Banks","2020-03-12","1","1","0","0","0","0"
"Banks","2020-03-13","0","1","0","0","0","0"
"Banks","2020-03-14","0","1","0","0","0","0"
"Banks","2020-03-15","0","1","0","0","0","0"
"Banks","2020-03-16","3","4","0","0","0","0"
"Banks","2020-03-17","3","7","0","0","0","0"
"Banks","2020-03-18","1","8","0","0","0","0"
"Banks","2020-03-19","3","11","0","0","0","0"
"Banks","2020-03-20","2","13","0","0","0","0"
"Banks","2020-03-21","2","15","0","0","0","0"
"Banks","2020-03-22","2","17","0","0","0","0"
"Banks","2020-03-23","1","18","0","0","0","0"
"Banks","2020-03-24","2","20","0","0","0","0"
"Banks","2020-03-25","4","24","0","0","0","0"
"Banks","2020-03-26","3","27","0","0","0","0"
"Banks","2020-03-27","4","31","0","0","0","0"
"Banks","2020-03-28","1","32","0","0","0","0"
"Banks","2020-03-29","1","33","0","0","0","0"
"Banks","2020-03-30","2","35","0","0","0","0"
"Banks","2020-03-31","3","38","0","0","0","0"
"Banks","2020-04-01","3","41","0","0","0","0"
"Banks","2020-04-02","0","41","0","0","0","0"
"Banks","2020-04-03","0","41","0","0","0","0"
"Banks","2020-04-04","2","43","0","0","0","0"
"Banks","2020-04-05","0","43","0","0","0","0"
"Banks","2020-04-06","1","44","0","0","0","0"
"Banks","2020-04-07","1","45","0","0","0","0"
"Banks","2020-04-08","1","46","0","0","0","0"
"Banks","2020-04-09","0","46","0","0","0","0"
"Banks","2020-04-10","4","50","2","2","7.1","3.6"
"Banks","2020-04-11","3","53","0","2","7.1","3.6"
"Banks","2020-04-12","0","53","0","2","7.1","3.6"
"Banks","2020-04-13","1","54","1","3","21.4","10.7"
"Banks","2020-04-14","4","58","0","3","21.4","10.7"
"Banks","2020-04-15","4","62","0","3","21.4","10.7"
"Banks","2020-04-16","1","63","1","4","35.7","17.9"
"Banks","2020-04-17","3","66","0","4","28.6","17.9"
"Banks","2020-04-18","2","68","0","4","28.6","17.9"
"Banks","2020-04-19","0","68","0","4","28.6","17.9"
"Banks","2020-04-20","6","74","3","7","21.4","21.4"
"Banks","2020-04-21","10","84","0","7","21.4","21.4"
"Banks","2020-04-22","4","88","1","8","25","23.2"
"Banks","2020-04-23","5","93","0","8","10.7","23.2"
"Banks","2020-04-24","9","102","0","8","10.7","19.6"
"Banks","2020-04-25","4","106","0","8","10.7","19.6"
"Banks","2020-04-26","0","106","0","8","10.7","19.6"
"Banks","2020-04-27","1","107","0","8","3.6","12.5"
"Banks","2020-04-28","8","115","1","9","5.4","13.4"
"Banks","2020-04-29","30","145","5","14","4.2","14.6"
"Banks","2020-04-30","30","175","5","19","6.5","8.6"
"Banks","2020-05-01","7","182","0","19","6.5","8.6"
"Banks","2020-05-02","4","186","0","19","6.5","8.6"
"Banks","2020-05-03","3","189","0","19","6.5","8.6"
"Banks","2020-05-04","7","196","0","19","6.5","5.1"
"Banks","2020-05-05","7","203","0","19","4.8","5.1"
"Banks","2020-05-06","4","207","1","20","6","5.1"
"Banks","2020-05-07","4","211","0","20","3.6","5.1"
"Banks","2020-05-08","6","217","0","20","3.6","5.1"
"Banks","2020-05-09","3","220","0","20","3.6","5.1"
"Banks","2020-05-10","1","221","0","20","3.6","5.1"
"Banks","2020-05-11","8","229","0","20","3.6","5.1"
"Banks","2020-05-12","9","238","0","20","3.6","4.2"
"Banks","2020-05-13","10","248","0","20","0","3"
"Banks","2020-05-14","2","250","0","20","0","1.8"
"Banks","2020-05-15","8","258","0","20","0","1.8"
"Banks","2020-05-16","32","290","17","37","7.6","5.6"
"Banks","2020-05-17","5","295","0","37","7.6","5.6"
"Banks","2020-05-18","57","352","18","55","12.1","7.8"
"Banks","2020-05-19","6","358","1","56","14.5","9"
"Banks","2020-05-20","8","366","1","57","16.3","8.1"
"Banks","2020-05-21","8","374","1","58","18.1","9"
"Banks","2020-05-22","7","381","1","59","20.1","10"
"Banks","2020-05-23","5","386","0","59","12.5","10"
"Banks","2020-05-24","0","386","0","59","12.5","10"
"Banks","2020-05-25","2","388","0","59","8","10"
"Banks","2020-05-26","8","396","1","60","7.4","10.9"
"Banks","2020-05-27","10","406","1","61","7","11.7"
"Banks","2020-05-28","5","411","0","61","5.3","11.7"
"Banks","2020-05-29","2","413","0","61","3.2","11.7"
"Banks","2020-05-30","10","423","0","61","3.2","7.9"
"Banks","2020-05-31","1","424","0","61","3.2","7.9"
"Banks","2020-06-01","7","431","0","61","3.2","5.6"
"Banks","2020-06-02","14","445","1","62","2.4","4.9"
"Banks","2020-06-03","9","454","2","64","4.2","5.6"
"Banks","2020-06-04","13","467","0","64","4.2","4.7"
"Banks","2020-06-05","40","507","2","66","4.9","4.1"
"Banks","2020-06-06","5","512","0","66","4.9","4.1"
"Banks","2020-06-07","1","513","0","66","4.9","4.1"
"Banks","2020-06-08","4","517","1","67","8.5","5.8"
"Banks","2020-06-09","13","530","0","67","7.5","5"
"Banks","2020-06-10","44","574","1","68","4.6","4.4"
"Banks","2020-06-11","10","584","0","68","4.6","4.4"
"Banks","2020-06-12","26","610","0","68","3.9","4.4"
"Banks","2020-06-13","14","624","1","69","4.9","4.9"
"Banks","2020-06-14","1","625","0","69","4.9","4.9"
"Banks","2020-06-15","13","638","0","69","1.3","4.9"
"Banks","2020-06-16","5","643","0","69","1.3","4.4"
"Banks","2020-06-17","9","652","1","70","2.6","3.6"
"Banks","2020-06-18","9","661","1","71","4.2","4.4"
"Banks","2020-06-19","8","669","2","73","7.8","5.8"
"Banks","2020-06-20","2","671","0","73","6.7","5.8"
"Banks","2020-06-21","2","673","2","75","21","13"
"Banks","2020-06-22","15","688","2","77","22.9","12.1"
"Banks","2020-06-23","10","698","6","83","31.5","16.4"
"Banks","2020-06-24","7","705","0","83","29.9","16.3"
"Banks","2020-06-25","24","729","3","86","30.1","17.2"
"Banks","2020-06-26","11","740","1","87","27.8","17.8"
"Banks","2020-06-27","26","766","1","88","28.4","17.6"
"Banks","2020-06-28","5","771","0","88","14.1","17.6"
"Banks","2020-06-29","22","793","0","88","12.2","17.6"
"Banks","2020-06-30","20","813","3","91","5.8","18.6"
"Banks","2020-07-01","18","831","2","93","7.4","18.6"
"Banks","2020-07-02","20","851","1","94","6.3","18.2"
"Banks","2020-07-03","6","857","1","95","7.4","17.6"
"Banks","2020-07-04","8","865","2","97","10.4","19.4"
"Banks","2020-07-05","8","873","2","99","14","14"
"Banks","2020-07-06","7","880","2","101","18","15.1"
"Banks","2020-07-07","14","894","4","105","20","12.9"
"Banks","2020-07-08","18","912","1","106","19.2","13.3"
"Banks","2020-07-09","20","932","7","113","23.5","14.9"
"Banks","2020-07-10","15","947","2","115","23","15.2"
"Banks","2020-07-11","4","951","3","118","30.1","20.3"
"Banks","2020-07-12","2","953","0","118","26.6","20.3"
"Banks","2020-07-13","14","967","0","118","22.5","20.3"
"Banks","2020-07-14","16","983","4","122","22","21"
"Banks","2020-07-15","21","1004","5","127","24.6","21.9"
"Banks","2020-07-16","10","1014","2","129","22.4","23"
"Banks","2020-07-17","20","1034","3","132","22.7","22.8"
"Banks","2020-07-18","4","1038","0","132","12","21.1"
"Banks","2020-07-19","7","1045","0","132","12","19.3"
"Banks","2020-07-20","18","1063","5","137","15.9","19.2"
"Banks","2020-07-21","11","1074","3","140","16.3","19.1"
"Banks","2020-07-22","16","1090","4","144","16.4","20.5"
"Banks","2020-07-23","19","1109","10","154","21.1","21.8"
"Banks","2020-07-24","23","1132","3","157","20.8","21.8"
"Banks","2020-07-25","10","1142","1","158","22.2","17.1"
"Banks","2020-07-26","3","1145","0","158","22.2","17.1"
"Banks","2020-07-27","12","1157","2","160","20.7","18.3"
"Banks","2020-07-28","19","1176","3","163","19","17.6"
"Banks","2020-07-29","63","1239","7","170","17","16.7"
"Banks","2020-07-30","12","1251","1","171","10.7","15.9"
"Banks","2020-07-31","12","1263","3","174","12.4","16.6"
"Banks","2020-08-01","4","1267","1","175","14.6","18.4"
"Banks","2020-08-02","8","1275","0","175","14.6","18.4"
"Banks","2020-08-03","16","1291","0","175","12.2","16.4"
"Banks","2020-08-04","53","1344","3","178","10.7","14.9"
"Banks","2020-08-05","20","1364","4","182","12","14.5"
"Banks","2020-08-06","61","1425","3","185","11.5","11.1"
"Banks","2020-08-07","22","1447","2","187","9.2","10.8"
"Banks","2020-08-08","10","1457","2","189","8.5","11.5"
"Banks","2020-08-09","5","1462","2","191","14.2","14.4"
"Banks","2020-08-10","12","1474","2","193","16.6","14.4"
"Banks","2020-08-11","13","1487","3","196","19.1","14.9"
"Banks","2020-08-12","14","1501","0","196","16.3","14.1"
"Banks","2020-08-13","16","1517","2","198","17.3","14.4"
"Banks","2020-08-14","17","1534","4","202","19.4","14.3"
"Banks","2020-08-15","6","1540","2","204","21.3","14.9"
"Banks","2020-08-16","3","1543","2","206","25.1","19.7"
"Banks","2020-08-17","16","1559","4","210","26.3","21.5"
"Banks","2020-08-18","14","1573","2","212","25","22.1"
"Banks","2020-08-19","26","1599","8","220","29.4","22.8"
"Banks","2020-08-20","16","1615","2","222","29.4","23.4"
"Banks","2020-08-21","22","1637","1","223","26.7","23.1"
"Banks","2020-08-22","15","1652","7","230","28.6","25"
"Banks","2020-08-23","7","1659","3","233","25.2","25.2"
"Banks","2020-08-24","17","1676","4","237","25","25.7"
"Banks","2020-08-25","28","1704","4","241","25","25"
"Banks","2020-08-26","27","1731","2","243","21.7","25.6"
"Banks","2020-08-27","16","1747","1","244","20.8","25.1"
"Banks","2020-08-28","26","1773","3","247","21.8","24.3"
"Banks","2020-08-29","23","1796","4","251","17.6","23.1"
"Banks","2020-08-30","8","1804","1","252","13.3","19.3"
"Banks","2020-08-31","16","1820","1","253","10.8","17.9"
"Banks","2020-09-01","18","1838","0","253","8.8","16.9"
"Banks","2020-09-02","12","1850","0","253","7.7","14.7"
"Banks","2020-09-03","20","1870","6","259","11.1","15.9"
"Banks","2020-09-04","20","1890","1","260","10.2","16"
"Banks","2020-09-05","13","1903","1","261","8.8","13.2"
"Banks","2020-09-06","5","1908","2","263","12.7","13"
"Banks","2020-09-07","7","1915","3","266","17.9","14.4"
"Banks","2020-09-08","18","1933","0","266","17.9","13.3"
"Banks","2020-09-09","21","1954","3","269","20","13.8"
"Banks","2020-09-10","64","2018","1","270","15.9","13.5"
"Banks","2020-09-11","23","2041","1","271","15.8","13"
"Banks","2020-09-12","10","2051","3","274","19","13.9"
"Banks","2020-09-13","1","2052","0","274","13.3","13"
"Banks","2020-09-14","22","2074","3","277","9.1","13.5"
"Banks","2020-09-15","14","2088","1","278","10.1","14"
"Banks","2020-09-16","56","2144","2","280","8.6","14.3"
"Banks","2020-09-17","25","2169","2","282","9.5","12.7"
"Banks","2020-09-18","20","2189","1","283","9.6","12.7"
"Banks","2020-09-19","9","2198","0","283","5.3","12.2"
"Banks","2020-09-20","7","2205","1","284","7.4","10.3"
"Banks","2020-09-21","12","2217","1","285","6.6","7.9"
"Banks","2020-09-22","13","2230","3","288","8.9","9.5"
"Banks","2020-09-23","18","2248","5","293","12.4","10.5"
"Banks","2020-09-24","19","2267","2","295","12.7","11.1"
"Banks","2020-09-25","28","2295","1","296","12.5","11.1"
"Banks","2020-09-26","7","2302","2","298","16.6","11"
"Banks","2020-09-27","88","2390","2","300","14.9","11.1"
"Banks","2020-09-28","81","2471","5","305","14.6","10.6"
"Banks","2020-09-29","12","2483","1","306","12.5","10.7"
"Banks","2020-09-30","13","2496","0","306","8.5","10.4"
"Banks","2020-10-01","11","2507","2","308","9.6","11.2"
"Banks","2020-10-02","11","2518","2","310","11.7","12.1"
"Banks","2020-10-03","4","2522","0","310","7.6","12.1"
"Banks","2020-10-04","3","2525","0","310","7.3","11.1"
"Banks","2020-10-05","22","2547","8","318","11.6","13.1"
"Banks","2020-10-06","16","2563","2","320","12.2","12.3"
"Banks","2020-10-07","17","2580","2","322","13.9","11.2"
"Banks","2020-10-08","26","2606","2","324","12.4","11"
"Banks","2020-10-09","27","2633","1","325","10.3","11"
"Banks","2020-10-10","18","2651","1","326","11.1","9.3"
"Banks","2020-10-11","4","2655","1","327","14.7","11"
"Banks","2020-10-12","11","2666","2","329","12.1","11.8"
"Banks","2020-10-13","19","2685","2","331","11.8","12"
"Banks","2020-10-14","23","2708","3","334","12","12.9"
"Banks","2020-10-15","30","2738","2","336","11.8","12.1"
"Banks","2020-10-16","22","2760","0","336","11.3","10.8"
"Banks","2020-10-17","6","2766","0","336","10.5","10.8"
"Banks","2020-10-18","2","2768","1","337","14.1","14.4"
"Banks","2020-10-19","13","2781","0","337","11.5","11.8"
"Banks","2020-10-20","23","2804","5","342","13.1","12.4"
"Banks","2020-10-21","19","2823","4","346","14.2","13.1"
"Banks","2020-10-22","15","2838","1","347","14.2","13"
"Banks","2020-10-23","26","2864","5","352","17","14.1"
"Banks","2020-10-24","11","2875","3","355","20.9","15.7"
"Banks","2020-10-25","4","2879","1","356","17.3","15.7"
"Banks","2020-10-26","19","2898","2","358","18.8","15.1"
"Banks","2020-10-27","25","2923","4","362","18","15.5"
"Banks","2020-10-28","18","2941","4","366","18.1","16.2"
"Banks","2020-10-29","16","2957","2","368","19","16.6"
"Banks","2020-10-30","21","2978","2","370","17.6","17.3"
"Banks","2020-10-31","11","2989","2","372","16.3","18.6"
"Banks","2020-11-01","11","3000","0","372","12.7","15"
"Banks","2020-11-02","20","3020","3","375","13.3","16.1"
"Banks","2020-11-03","25","3045","1","376","11.6","14.8"
"Banks","2020-11-04","14","3059","2","378","10.5","14.3"
"Banks","2020-11-05","54","3113","3","381","9.5","14.2"
"Banks","2020-11-06","29","3142","8","389","12.1","14.8"
"Banks","2020-11-07","11","3153","8","397","19.9","18.1"
"Banks","2020-11-08","13","3166","5","402","25.4","19"
"Banks","2020-11-09","27","3193","2","404","24.3","18.8"
"Banks","2020-11-10","32","3225","5","409","25.9","18.8"
"Banks","2020-11-11","31","3256","9","418","28.1","19.3"
"Banks","2020-11-12","28","3284","9","427","31.9","20.7"
"Banks","2020-11-13","35","3319","10","437","32","22"
"Banks","2020-11-14","21","3340","6","443","25.7","22.8"
"Banks","2020-11-15","18","3358","2","445","21.8","23.6"
"Banks","2020-11-16","49","3407","13","458","24.5","24.4"
"Banks","2020-11-17","48","3455","6","464","24.1","25"
"Banks","2020-11-18","30","3485","5","469","22.3","25.2"
"Banks","2020-11-19","31","3516","6","475","20.5","26.2"
"Banks","2020-11-20","29","3545","8","483","20.3","26.2"
"Banks","2020-11-21","24","3569","8","491","21","23.3"
"Banks","2020-11-22","20","3589","7","498","24.4","23.1"
"Banks","2020-11-23","41","3630","7","505","23.1","23.8"
"Banks","2020-11-24","23","3653","3","508","23.2","23.6"
"Banks","2020-11-25","25","3678","9","517","25.9","24.1"
"Banks","2020-11-26","2","3680","0","517","23.1","21.8"
"Banks","2020-11-27","18","3698","5","522","23.2","21.8"
"Banks","2020-11-28","17","3715","6","528","23.5","22.2"
"Banks","2020-11-29","21","3736","5","533","21.9","23.1"
"Banks","2020-11-30","49","3785","12","545","22.9","23"
"Banks","2020-12-01","52","3837","7","552","23","23.1"
"Banks","2020-12-02","48","3885","14","566","22","24"
"Banks","2020-12-03","52","3937","9","575","24.5","23.8"
"Banks","2020-12-04","50","3987","10","585","23.4","23.3"
"Banks","2020-12-05","22","4009","5","590","21.6","22.5"
"Banks","2020-12-06","12","4021","3","593","21.7","21.8"
"Banks","2020-12-07","77","4098","5","598","19.2","21"
"Banks","2020-12-08","42","4140","7","605","19.6","21.3"
"Banks","2020-12-09","77","4217","13","618","17.9","19.9"
"Banks","2020-12-10","56","4273","5","623","16.7","20.6"
"Banks","2020-12-11","51","4324","15","638","18","20.7"
"Banks","2020-12-12","20","4344","4","642","17.6","19.6"
"Banks","2020-12-13","13","4357","5","647","19.5","20.6"
"Banks","2020-12-14","76","4433","18","665","22","20.6"
"Banks","2020-12-15","75","4508","13","678","22.1","20.9"
"Banks","2020-12-16","132","4640","15","693","21.3","19.6"
"Banks","2020-12-17","121","4761","10","703","21.2","18.9"
"Banks","2020-12-18","63","4824","18","721","21.1","19.6"
"Banks","2020-12-19","17","4841","4","725","21.6","19.6"
"Banks","2020-12-20","19","4860","4","729","19.1","19.3"
"Banks","2020-12-21","53","4913","12","741","19","20.5"
"Banks","2020-12-22","51","4964","6","747","18.2","20.1"
"Banks","2020-12-23","44","5008","3","750","17.5","19.4"
"Banks","2020-12-24","24","5032","13","763","24.1","22.6"
"Banks","2020-12-25","2","5034","0","763","20","20.5"
"Banks","2020-12-26","24","5058","4","767","19","20.3"
"Banks","2020-12-27","19","5077","9","776","22.8","20.9"
"Banks","2020-12-28","61","5138","12","788","22.4","20.7"
"Banks","2020-12-29","69","5207","21","809","25","21.6"
"Banks","2020-12-30","62","5269","16","825","27.7","22.6"
"Banks","2020-12-31","51","5320","9","834","22.5","23.3"
"Banks","2021-01-01","9","5329","3","837","27.3","23.6"
"Banks","2021-01-02","23","5352","3","840","26.8","22.9"
"Banks","2021-01-03","27","5379","11","851","25.8","24.3"
"Banks","2021-01-04","80","5459","20","871","26.6","24.5"
"Banks","2021-01-05","74","5533","19","890","25.9","25.5"
"Banks","2021-01-06","129","5662","26","916","25.1","26.4"
"Banks","2021-01-07","75","5737","16","932","25.6","24.1"
"Banks","2021-01-08","55","5792","6","938","22.4","24.8"
"Banks","2021-01-09","34","5826","9","947","24.3","25.5"
"Banks","2021-01-10","27","5853","7","954","22.2","24"
"Banks","2021-01-11","45","5898","8","962","21.2","23.9"
"Banks","2021-01-12","34","5932","11","973","22.1","24"
"Banks","2021-01-13","52","5984","13","986","22.8","24"
"Banks","2021-01-14","50","6034","13","999","23.5","24.6"
"Banks","2021-01-15","40","6074","7","1006","24.4","23.4"
"Banks","2021-01-16","24","6098","3","1009","22.4","23.4"
"Banks","2021-01-17","27","6125","5","1014","21.4","21.8"
"Banks","2021-01-18","32","6157","4","1018","20.6","20.9"
"Banks","2021-01-19","31","6188","2","1020","16.9","19.5"
"Banks","2021-01-20","35","6223","5","1025","15.4","19.1"
"Banks","2021-01-21","31","6254","7","1032","14.9","19.2"
"Banks","2021-01-22","39","6293","6","1038","14.6","19.5"
"Banks","2021-01-23","10","6303","2","1040","15.7","19.1"
"Banks","2021-01-24","7","6310","3","1043","19.2","20.3"
"Banks","2021-01-25","10","6320","0","1043","17.4","19"
"Banks","2021-01-26","1","6321","1","1044","30.7","23.8"
"Banks","2021-01-27","0","6321","0","1044","28.7","22"
"Barrow","2020-02-01","0","0","0","0",".","."
"Barrow","2020-02-02","0","0","0","0",".","."
"Barrow","2020-02-03","0","0","0","0",".","."
"Barrow","2020-02-04","0","0","0","0",".","."
"Barrow","2020-02-05","0","0","0","0",".","."
"Barrow","2020-02-06","0","0","0","0",".","."
"Barrow","2020-02-07","0","0","0","0","0","."
"Barrow","2020-02-08","0","0","0","0","0","."
"Barrow","2020-02-09","0","0","0","0","0","."
"Barrow","2020-02-10","0","0","0","0","0","."
"Barrow","2020-02-11","0","0","0","0","0","."
"Barrow","2020-02-12","0","0","0","0","0","."
"Barrow","2020-02-13","0","0","0","0","0","."
"Barrow","2020-02-14","0","0","0","0","0","0"
"Barrow","2020-02-15","0","0","0","0","0","0"
"Barrow","2020-02-16","0","0","0","0","0","0"
"Barrow","2020-02-17","0","0","0","0","0","0"
"Barrow","2020-02-18","0","0","0","0","0","0"
"Barrow","2020-02-19","0","0","0","0","0","0"
"Barrow","2020-02-20","0","0","0","0","0","0"
"Barrow","2020-02-21","0","0","0","0","0","0"
"Barrow","2020-02-22","0","0","0","0","0","0"
"Barrow","2020-02-23","0","0","0","0","0","0"
"Barrow","2020-02-24","0","0","0","0","0","0"
"Barrow","2020-02-25","0","0","0","0","0","0"
"Barrow","2020-02-26","0","0","0","0","0","0"
"Barrow","2020-02-27","0","0","0","0","0","0"
"Barrow","2020-02-28","0","0","0","0","0","0"
"Barrow","2020-02-29","0","0","0","0","0","0"
"Barrow","2020-03-01","0","0","0","0","0","0"
"Barrow","2020-03-02","0","0","0","0","0","0"
"Barrow","2020-03-03","0","0","0","0","0","0"
"Barrow","2020-03-04","0","0","0","0","0","0"
"Barrow","2020-03-05","0","0","0","0","0","0"
"Barrow","2020-03-06","0","0","0","0","0","0"
"Barrow","2020-03-07","0","0","0","0","0","0"
"Barrow","2020-03-08","0","0","0","0","0","0"
"Barrow","2020-03-09","0","0","0","0","0","0"
"Barrow","2020-03-10","0","0","0","0","0","0"
"Barrow","2020-03-11","0","0","0","0","0","0"
"Barrow","2020-03-12","2","2","0","0","0","0"
"Barrow","2020-03-13","5","7","0","0","0","0"
"Barrow","2020-03-14","1","8","0","0","0","0"
"Barrow","2020-03-15","0","8","0","0","0","0"
"Barrow","2020-03-16","12","20","0","0","0","0"
"Barrow","2020-03-17","17","37","2","2","1.7","0.8"
"Barrow","2020-03-18","18","55","1","3","2.5","1.2"
"Barrow","2020-03-19","24","79","3","6","4.3","2.1"
"Barrow","2020-03-20","29","108","1","7","4.8","2.4"
"Barrow","2020-03-21","8","116","1","8","6.5","3.3"
"Barrow","2020-03-22","8","124","0","8","6.5","3.3"
"Barrow","2020-03-23","14","138","0","8","6.5","3.3"
"Barrow","2020-03-24","23","161","1","9","5.5","3.6"
"Barrow","2020-03-25","22","183","2","11","6","4.2"
"Barrow","2020-03-26","21","204","1","12","4.9","4.6"
"Barrow","2020-03-27","12","216","2","14","6.8","5.8"
"Barrow","2020-03-28","1","217","1","15","19.3","12.9"
"Barrow","2020-03-29","2","219","0","15","19.3","12.9"
"Barrow","2020-03-30","19","238","1","16","20","13.3"
"Barrow","2020-03-31","10","248","0","16","19.4","12.4"
"Barrow","2020-04-01","15","263","0","16","18.1","12"
"Barrow","2020-04-02","9","272","0","16","17.4","11.1"
"Barrow","2020-04-03","6","278","2","18","19.8","13.3"
"Barrow","2020-04-04","8","286","1","19","7.3","13.3"
"Barrow","2020-04-05","2","288","0","19","7.3","13.3"
"Barrow","2020-04-06","12","300","0","19","6.5","13.3"
"Barrow","2020-04-07","9","309","0","19","6.5","13"
"Barrow","2020-04-08","13","322","1","20","7.6","12.9"
"Barrow","2020-04-09","18","340","4","24","10.8","14.1"
"Barrow","2020-04-10","10","350","2","26","8.9","14.4"
"Barrow","2020-04-11","6","356","1","27","9.5","8.4"
"Barrow","2020-04-12","3","359","0","27","9.5","8.4"
"Barrow","2020-04-13","21","380","3","30","11.6","9.1"
"Barrow","2020-04-14","18","398","2","32","13.1","9.8"
"Barrow","2020-04-15","27","425","6","38","15.2","11.4"
"Barrow","2020-04-16","35","460","4","42","13.7","12.2"
"Barrow","2020-04-17","17","477","3","45","13.3","11.1"
"Barrow","2020-04-18","4","481","2","47","18.1","13.8"
"Barrow","2020-04-19","8","489","0","47","18.1","13.8"
"Barrow","2020-04-20","38","527","1","48","16.4","14"
"Barrow","2020-04-21","31","558","4","52","16.7","14.9"
"Barrow","2020-04-22","30","588","4","56","15.4","15.3"
"Barrow","2020-04-23","29","617","1","57","14.3","14"
"Barrow","2020-04-24","31","648","2","59","12.7","13"
"Barrow","2020-04-25","14","662","4","63","9.6","13.9"
"Barrow","2020-04-26","6","668","0","63","9.6","13.9"
"Barrow","2020-04-27","20","688","1","64","10","13.2"
"Barrow","2020-04-28","23","711","2","66","9.4","13"
"Barrow","2020-04-29","47","758","14","80","11.7","13.6"
"Barrow","2020-04-30","44","802","2","82","11.9","13.1"
"Barrow","2020-05-01","71","873","2","84","11.3","12"
"Barrow","2020-05-02","15","888","1","85","8.2","8.9"
"Barrow","2020-05-03","15","903","0","85","8.2","8.9"
"Barrow","2020-05-04","34","937","1","86","7.9","8.9"
"Barrow","2020-05-05","39","976","1","87","7","8.2"
"Barrow","2020-05-06","44","1020","3","90","3.8","7.7"
"Barrow","2020-05-07","34","1054","1","91","3.5","7.7"
"Barrow","2020-05-08","35","1089","2","93","3.9","7.6"
"Barrow","2020-05-09","15","1104","3","96","5.9","7"
"Barrow","2020-05-10","8","1112","1","97","7.6","7.9"
"Barrow","2020-05-11","35","1147","1","98","7.6","7.8"
"Barrow","2020-05-12","27","1174","0","98","7.3","7.2"
"Barrow","2020-05-13","34","1208","1","99","6.7","5.2"
"Barrow","2020-05-14","34","1242","1","100","6.7","5.1"
"Barrow","2020-05-15","45","1287","1","101","6.2","5.1"
"Barrow","2020-05-16","19","1306","1","102","4.1","5"
"Barrow","2020-05-17","10","1316","1","103","3.7","5.7"
"Barrow","2020-05-18","44","1360","3","106","4.3","6"
"Barrow","2020-05-19","70","1430","7","113","5.7","6.5"
"Barrow","2020-05-20","56","1486","0","113","5.3","6"
"Barrow","2020-05-21","89","1575","2","115","5.2","6"
"Barrow","2020-05-22","32","1607","3","118","6.2","6.2"
"Barrow","2020-05-23","15","1622","0","118","5.5","4.8"
"Barrow","2020-05-24","15","1637","1","119","5","4.4"
"Barrow","2020-05-25","12","1649","0","119","4","4.2"
"Barrow","2020-05-26","57","1706","3","122","3.4","4.6"
"Barrow","2020-05-27","60","1766","3","125","4.1","4.7"
"Barrow","2020-05-28","40","1806","1","126","4.1","4.7"
"Barrow","2020-05-29","39","1845","1","127","3.1","4.7"
"Barrow","2020-05-30","29","1874","0","127","3.1","4.3"
"Barrow","2020-05-31","16","1890","3","130","4.9","4.9"
"Barrow","2020-06-01","58","1948","4","134","5.9","4.9"
"Barrow","2020-06-02","69","2017","3","137","5.7","4.5"
"Barrow","2020-06-03","43","2060","4","141","6.3","5.2"
"Barrow","2020-06-04","66","2126","7","148","7.5","5.8"
"Barrow","2020-06-05","59","2185","4","152","8.1","5.6"
"Barrow","2020-06-06","28","2213","1","153","8.6","5.9"
"Barrow","2020-06-07","14","2227","3","156","9","6.9"
"Barrow","2020-06-08","51","2278","6","162","9.7","7.8"
"Barrow","2020-06-09","46","2324","4","166","10.3","8"
"Barrow","2020-06-10","54","2378","3","169","9.8","8.1"
"Barrow","2020-06-11","92","2470","4","173","8.9","8.2"
"Barrow","2020-06-12","47","2517","5","178","9.4","8.8"
"Barrow","2020-06-13","32","2549","2","180","9.8","9.2"
"Barrow","2020-06-14","25","2574","4","184","9","9"
"Barrow","2020-06-15","71","2645","6","190","8.6","9.1"
"Barrow","2020-06-16","84","2729","3","193","7.8","9.1"
"Barrow","2020-06-17","74","2803","9","202","8.8","9.3"
"Barrow","2020-06-18","70","2873","8","210","9.8","9.3"
"Barrow","2020-06-19","85","2958","2","212","8.6","9"
"Barrow","2020-06-20","85","3043","6","218","8.7","9.3"
"Barrow","2020-06-21","30","3073","3","221","7.9","8.4"
"Barrow","2020-06-22","87","3160","5","226","7.5","8"
"Barrow","2020-06-23","50","3210","8","234","9.2","8.5"
"Barrow","2020-06-24","189","3399","50","284","11.3","10"
"Barrow","2020-06-25","144","3543","13","297","10.9","10.4"
"Barrow","2020-06-26","107","3650","7","304","11.5","10.1"
"Barrow","2020-06-27","101","3751","7","311","11.5","10.1"
"Barrow","2020-06-28","25","3776","3","314","11.8","9.8"
"Barrow","2020-06-29","140","3916","18","332","12.8","10.2"
"Barrow","2020-06-30","121","4037","8","340","11.5","10.4"
"Barrow","2020-07-01","100","4137","14","354","9.7","10.5"
"Barrow","2020-07-02","109","4246","13","367","10.1","10.5"
"Barrow","2020-07-03","76","4322","7","374","10.5","11"
"Barrow","2020-07-04","43","4365","2","376","10.2","10.9"
"Barrow","2020-07-05","62","4427","7","383","10.1","10.9"
"Barrow","2020-07-06","190","4617","42","425","11.4","12.1"
"Barrow","2020-07-07","172","4789","25","450","12.5","12"
"Barrow","2020-07-08","144","4933","26","476","13.1","11.4"
"Barrow","2020-07-09","138","5071","21","497","13.6","11.9"
"Barrow","2020-07-10","153","5224","25","522","14.6","12.6"
"Barrow","2020-07-11","31","5255","3","525","15.3","12.7"
"Barrow","2020-07-12","20","5275","1","526","14.4","12.2"
"Barrow","2020-07-13","161","5436","31","557","14","12.7"
"Barrow","2020-07-14","119","5555","20","577","14.3","13.4"
"Barrow","2020-07-15","133","5688","20","597","13.9","13.5"
"Barrow","2020-07-16","105","5793","14","611","13.6","13.6"
"Barrow","2020-07-17","123","5916","18","629","13.4","14"
"Barrow","2020-07-18","56","5972","13","642","15.3","15.3"
"Barrow","2020-07-19","54","6026","6","648","16.2","15.3"
"Barrow","2020-07-20","113","6139","26","674","16.7","15.4"
"Barrow","2020-07-21","88","6227","13","687","16.4","15.4"
"Barrow","2020-07-22","81","6308","3","690","14.8","14.4"
"Barrow","2020-07-23","64","6372","6","696","14.3","13.9"
"Barrow","2020-07-24","124","6496","19","715","14.4","13.9"
"Barrow","2020-07-25","45","6541","10","725","14.2","14.8"
"Barrow","2020-07-26","37","6578","2","727","13.4","14.8"
"Barrow","2020-07-27","96","6674","18","745","12.8","14.8"
"Barrow","2020-07-28","116","6790","13","758","12.3","14.4"
"Barrow","2020-07-29","121","6911","25","783","14.7","14.8"
"Barrow","2020-07-30","90","7001","15","798","15.7","15"
"Barrow","2020-07-31","116","7117","24","822","16.5","15.4"
"Barrow","2020-08-01","64","7181","3","825","14","14.1"
"Barrow","2020-08-02","33","7214","5","830","15.4","14.4"
"Barrow","2020-08-03","108","7322","17","847","15","13.9"
"Barrow","2020-08-04","67","7389","8","855","15.1","13.7"
"Barrow","2020-08-05","109","7498","8","863","13.2","13.9"
"Barrow","2020-08-06","87","7585","11","874","12.6","14.2"
"Barrow","2020-08-07","106","7691","8","882","10.7","13.6"
"Barrow","2020-08-08","63","7754","10","892","12.3","13.2"
"Barrow","2020-08-09","34","7788","6","898","12.7","14"
"Barrow","2020-08-10","112","7900","19","917","12.9","13.9"
"Barrow","2020-08-11","92","7992","8","925","12.4","13.7"
"Barrow","2020-08-12","101","8093","14","939","13.3","13.2"
"Barrow","2020-08-13","82","8175","9","948","13.1","12.8"
"Barrow","2020-08-14","91","8266","6","954","12.9","11.8"
"Barrow","2020-08-15","56","8322","4","958","11.7","12"
"Barrow","2020-08-16","37","8359","4","962","10.7","11.7"
"Barrow","2020-08-17","106","8465","10","972","9.6","11.2"
"Barrow","2020-08-18","103","8568","18","990","10.9","11.6"
"Barrow","2020-08-19","83","8651","17","1007","11.8","12.6"
"Barrow","2020-08-20","74","8725","8","1015","11.8","12.5"
"Barrow","2020-08-21","91","8816","8","1023","12.1","12.5"
"Barrow","2020-08-22","42","8858","8","1031","13.8","12.8"
"Barrow","2020-08-23","35","8893","3","1034","13.5","12.1"
"Barrow","2020-08-24","97","8990","16","1050","14.5","12.1"
"Barrow","2020-08-25","75","9065","4","1054","12.8","11.8"
"Barrow","2020-08-26","71","9136","5","1059","10.9","11.4"
"Barrow","2020-08-27","81","9217","14","1073","11.8","11.8"
"Barrow","2020-08-28","84","9301","6","1079","11.6","11.8"
"Barrow","2020-08-29","51","9352","8","1087","11.1","12.5"
"Barrow","2020-08-30","32","9384","5","1092","12.1","12.8"
"Barrow","2020-08-31","67","9451","10","1102","11.9","13.2"
"Barrow","2020-09-01","93","9544","20","1122","14.2","13.5"
"Barrow","2020-09-02","73","9617","7","1129","14.5","12.7"
"Barrow","2020-09-03","117","9734","4","1133","12.6","12.2"
"Barrow","2020-09-04","133","9867","9","1142","12.5","12"
"Barrow","2020-09-05","47","9914","6","1148","12.1","11.6"
"Barrow","2020-09-06","37","9951","9","1157","13.3","12.7"
"Barrow","2020-09-07","30","9981","1","1158","11.7","11.8"
"Barrow","2020-09-08","137","10118","8","1166","9.4","11.8"
"Barrow","2020-09-09","109","10227","11","1177","9.5","12"
"Barrow","2020-09-10","131","10358","13","1190","10.4","11.5"
"Barrow","2020-09-11","90","10448","3","1193","9.9","11.2"
"Barrow","2020-09-12","37","10485","6","1199","10.4","11.3"
"Barrow","2020-09-13","33","10518","3","1202","8.3","10.8"
"Barrow","2020-09-14","107","10625","7","1209","8.7","10.2"
"Barrow","2020-09-15","106","10731","10","1219","9.2","9.3"
"Barrow","2020-09-16","122","10853","8","1227","8.7","9.1"
"Barrow","2020-09-17","93","10946","4","1231","7.9","9.2"
"Barrow","2020-09-18","94","11040","5","1236","8.2","9.1"
"Barrow","2020-09-19","59","11099","9","1245","8.1","9.3"
"Barrow","2020-09-20","43","11142","4","1249","8.1","8.2"
"Barrow","2020-09-21","102","11244","7","1256","8.1","8.4"
"Barrow","2020-09-22","91","11335","7","1263","7.9","8.6"
"Barrow","2020-09-23","108","11443","5","1268","7.6","8.2"
"Barrow","2020-09-24","93","11536","7","1275","8.1","8"
"Barrow","2020-09-25","129","11665","15","1290","9","8.6"
"Barrow","2020-09-26","41","11706","0","1290","6.8","7.4"
"Barrow","2020-09-27","42","11748","3","1293","6.5","7.3"
"Barrow","2020-09-28","120","11868","7","1300","6.4","7.2"
"Barrow","2020-09-29","114","11982","7","1307","6.1","7"
"Barrow","2020-09-30","107","12089","5","1312","6.1","6.9"
"Barrow","2020-10-01","101","12190","8","1320","6.2","7.1"
"Barrow","2020-10-02","112","12302","8","1328","5.6","7.3"
"Barrow","2020-10-03","50","12352","5","1333","7","6.9"
"Barrow","2020-10-04","51","12403","2","1335","6.5","6.5"
"Barrow","2020-10-05","132","12535","11","1346","6.9","6.6"
"Barrow","2020-10-06","117","12652","2","1348","6.2","6.2"
"Barrow","2020-10-07","153","12805","6","1354","6.1","6.1"
"Barrow","2020-10-08","125","12930","10","1364","6.1","6.2"
"Barrow","2020-10-09","127","13057","9","1373","6.1","5.8"
"Barrow","2020-10-10","70","13127","4","1377","5.5","6.3"
"Barrow","2020-10-11","49","13176","5","1382","6.4","6.5"
"Barrow","2020-10-12","127","13303","19","1401","7.4","7.1"
"Barrow","2020-10-13","148","13451","8","1409","7.9","7.1"
"Barrow","2020-10-14","136","13587","6","1415","8","7.1"
"Barrow","2020-10-15","115","13702","18","1433","9.1","7.6"
"Barrow","2020-10-16","92","13794","9","1442","9.4","7.8"
"Barrow","2020-10-17","61","13855","5","1447","9.8","7.7"
"Barrow","2020-10-18","40","13895","8","1455","11.2","8.8"
"Barrow","2020-10-19","137","14032","12","1467","10.3","8.8"
"Barrow","2020-10-20","103","14135","13","1480","11.3","9.6"
"Barrow","2020-10-21","149","14284","9","1489","11.6","9.8"
"Barrow","2020-10-22","157","14441","13","1502","10.5","9.8"
"Barrow","2020-10-23","96","14537","11","1513","10.8","10.1"
"Barrow","2020-10-24","40","14577","8","1521","12.5","11.1"
"Barrow","2020-10-25","40","14617","6","1527","11.7","11.5"
"Barrow","2020-10-26","161","14778","13","1540","11.6","11"
"Barrow","2020-10-27","156","14934","17","1557","11.4","11.4"
"Barrow","2020-10-28","129","15063","14","1571","12.1","11.8"
"Barrow","2020-10-29","129","15192","13","1584","12.3","11.4"
"Barrow","2020-10-30","159","15351","17","1601","12.2","11.5"
"Barrow","2020-10-31","62","15413","6","1607","10.8","11.6"
"Barrow","2020-11-01","43","15456","3","1610","9.6","10.7"
"Barrow","2020-11-02","148","15604","9","1619","9.3","10.5"
"Barrow","2020-11-03","160","15764","6","1625","8.3","9.8"
"Barrow","2020-11-04","118","15882","7","1632","7.6","9.8"
"Barrow","2020-11-05","120","16002","5","1637","6.8","9.5"
"Barrow","2020-11-06","104","16106","7","1644","6.2","9.2"
"Barrow","2020-11-07","55","16161","11","1655","7.7","9.2"
"Barrow","2020-11-08","55","16216","6","1661","8.2","8.9"
"Barrow","2020-11-09","158","16374","18","1679","9","9.2"
"Barrow","2020-11-10","152","16526","18","1697","10.1","9.2"
"Barrow","2020-11-11","173","16699","14","1711","10.4","9"
"Barrow","2020-11-12","137","16836","14","1725","11.3","9"
"Barrow","2020-11-13","123","16959","16","1741","12.2","9.2"
"Barrow","2020-11-14","98","17057","18","1759","12","9.8"
"Barrow","2020-11-15","59","17116","5","1764","11.6","9.9"
"Barrow","2020-11-16","219","17335","35","1799","12.3","10.6"
"Barrow","2020-11-17","185","17520","16","1815","11.8","11"
"Barrow","2020-11-18","205","17725","20","1835","12.1","11.3"
"Barrow","2020-11-19","177","17902","16","1851","11.9","11.6"
"Barrow","2020-11-20","192","18094","21","1872","11.6","11.9"
"Barrow","2020-11-21","95","18189","8","1880","10.2","11.1"
"Barrow","2020-11-22","68","18257","16","1896","12.3","12"
"Barrow","2020-11-23","200","18457","29","1925","12.1","12.2"
"Barrow","2020-11-24","181","18638","26","1951","12.9","12.4"
"Barrow","2020-11-25","206","18844","23","1974","13.1","12.6"
"Barrow","2020-11-26","18","18862","2","1976","13.4","12.7"
"Barrow","2020-11-27","166","19028","36","2012","15","13.3"
"Barrow","2020-11-28","94","19122","13","2025","15.7","13"
"Barrow","2020-11-29","78","19200","14","2039","14.9","13.6"
"Barrow","2020-11-30","274","19474","59","2098","15.9","14"
"Barrow","2020-12-01","251","19725","45","2143","16.5","14.7"
"Barrow","2020-12-02","228","19953","35","2178","17.1","15.1"
"Barrow","2020-12-03","242","20195","35","2213","17.5","15.5"
"Barrow","2020-12-04","221","20416","31","2244","16.4","15.7"
"Barrow","2020-12-05","140","20556","39","2283","18.4","17.1"
"Barrow","2020-12-06","118","20674","30","2313","19.5","17.2"
"Barrow","2020-12-07","250","20924","57","2370","19.7","17.8"
"Barrow","2020-12-08","297","21221","40","2410","19.1","17.8"
"Barrow","2020-12-09","270","21491","45","2455","19.2","18.1"
"Barrow","2020-12-10","266","21757","53","2508","20","18.8"
"Barrow","2020-12-11","267","22024","52","2560","20.8","18.6"
"Barrow","2020-12-12","161","22185","42","2602","20.5","19.5"
"Barrow","2020-12-13","114","22299","27","2629","20.3","19.9"
"Barrow","2020-12-14","271","22570","64","2693","20.4","20.1"
"Barrow","2020-12-15","289","22859","49","2742","20.9","20"
"Barrow","2020-12-16","305","23164","60","2802","21.3","20.3"
"Barrow","2020-12-17","288","23452","47","2849","20.8","20.4"
"Barrow","2020-12-18","279","23731","70","2919","21.6","21.2"
"Barrow","2020-12-19","142","23873","33","2952","21.2","20.9"
"Barrow","2020-12-20","121","23994","25","2977","20.8","20.5"
"Barrow","2020-12-21","320","24314","76","3053","20.8","20.6"
"Barrow","2020-12-22","308","24622","81","3134","22.1","21.5"
"Barrow","2020-12-23","295","24917","67","3201","22.6","22"
"Barrow","2020-12-24","155","25072","49","3250","24.8","22.8"
"Barrow","2020-12-25","25","25097","4","3254","23.5","22.5"
"Barrow","2020-12-26","137","25234","47","3301","25","23.1"
"Barrow","2020-12-27","109","25343","34","3335","26.6","23.7"
"Barrow","2020-12-28","318","25661","88","3423","27.1","24"
"Barrow","2020-12-29","334","25995","116","3539","28.3","25.2"
"Barrow","2020-12-30","318","26313","97","3636","29.4","26"
"Barrow","2020-12-31","209","26522","61","3697","29.1","26.9"
"Barrow","2021-01-01","72","26594","27","3724","32.2","27.8"
"Barrow","2021-01-02","113","26707","32","3756","31.3","28.2"
"Barrow","2021-01-03","105","26812","37","3793","31.9","29.2"
"Barrow","2021-01-04","277","27089","71","3864","31.6","29.4"
"Barrow","2021-01-05","377","27466","113","3977","30.9","29.6"
"Barrow","2021-01-06","417","27883","118","4095","30.6","30"
"Barrow","2021-01-07","383","28266","102","4197","30.2","29.7"
"Barrow","2021-01-08","362","28628","99","4296","28.8","30.5"
"Barrow","2021-01-09","168","28796","44","4340","28.5","29.9"
"Barrow","2021-01-10","148","28944","53","4393","28.6","30.2"
"Barrow","2021-01-11","309","29253","87","4480","28.9","30.3"
"Barrow","2021-01-12","284","29537","64","4544","27.9","29.4"
"Barrow","2021-01-13","287","29824","70","4614","27.3","28.9"
"Barrow","2021-01-14","271","30095","61","4675","26.7","28.5"
"Barrow","2021-01-15","293","30388","80","4755","26.7","27.7"
"Barrow","2021-01-16","186","30574","41","4796","26.1","27.3"
"Barrow","2021-01-17","139","30713","42","4838","25.3","26.9"
"Barrow","2021-01-18","275","30988","55","4893","24.1","26.5"
"Barrow","2021-01-19","334","31322","84","4977","24.5","26.2"
"Barrow","2021-01-20","287","31609","56","5033","23.8","25.6"
"Barrow","2021-01-21","275","31884","64","5097","23.9","25.3"
"Barrow","2021-01-22","280","32164","57","5154","22.9","24.8"
"Barrow","2021-01-23","140","32304","42","5196","24.1","25.1"
"Barrow","2021-01-24","83","32387","29","5225","24.7","25"
"Barrow","2021-01-25","80","32467","15","5240","24.6","24.4"
"Barrow","2021-01-26","7","32474","2","5242","25.1","24.8"
"Barrow","2021-01-27","0","32474","0","5242","22.3","23"
"Bartow","2020-02-01","0","0","0","0",".","."
"Bartow","2020-02-02","0","0","0","0",".","."
"Bartow","2020-02-03","0","0","0","0",".","."
"Bartow","2020-02-04","0","0","0","0",".","."
"Bartow","2020-02-05","0","0","0","0",".","."
"Bartow","2020-02-06","0","0","0","0",".","."
"Bartow","2020-02-07","0","0","0","0","0","."
"Bartow","2020-02-08","0","0","0","0","0","."
"Bartow","2020-02-09","0","0","0","0","0","."
"Bartow","2020-02-10","0","0","0","0","0","."
"Bartow","2020-02-11","0","0","0","0","0","."
"Bartow","2020-02-12","0","0","0","0","0","."
"Bartow","2020-02-13","0","0","0","0","0","."
"Bartow","2020-02-14","0","0","0","0","0","0"
"Bartow","2020-02-15","0","0","0","0","0","0"
"Bartow","2020-02-16","0","0","0","0","0","0"
"Bartow","2020-02-17","0","0","0","0","0","0"
"Bartow","2020-02-18","0","0","0","0","0","0"
"Bartow","2020-02-19","0","0","0","0","0","0"
"Bartow","2020-02-20","0","0","0","0","0","0"
"Bartow","2020-02-21","0","0","0","0","0","0"
"Bartow","2020-02-22","0","0","0","0","0","0"
"Bartow","2020-02-23","0","0","0","0","0","0"
"Bartow","2020-02-24","0","0","0","0","0","0"
"Bartow","2020-02-25","0","0","0","0","0","0"
"Bartow","2020-02-26","0","0","0","0","0","0"
"Bartow","2020-02-27","0","0","0","0","0","0"
"Bartow","2020-02-28","0","0","0","0","0","0"
"Bartow","2020-02-29","0","0","0","0","0","0"
"Bartow","2020-03-01","0","0","0","0","0","0"
"Bartow","2020-03-02","0","0","0","0","0","0"
"Bartow","2020-03-03","0","0","0","0","0","0"
"Bartow","2020-03-04","0","0","0","0","0","0"
"Bartow","2020-03-05","0","0","0","0","0","0"
"Bartow","2020-03-06","4","4","2","2","7.1","3.6"
"Bartow","2020-03-07","2","6","0","2","7.1","3.6"
"Bartow","2020-03-08","0","6","0","2","7.1","3.6"
"Bartow","2020-03-09","3","9","2","4","16.7","8.3"
"Bartow","2020-03-10","11","20","3","7","20.6","10.3"
"Bartow","2020-03-11","6","26","4","11","30.1","15"
"Bartow","2020-03-12","22","48","14","25","39.2","19.6"
"Bartow","2020-03-13","33","81","18","43","39.8","23.5"
"Bartow","2020-03-14","6","87","3","46","47","27.1"
"Bartow","2020-03-15","13","100","7","53","54.7","30.9"
"Bartow","2020-03-16","35","135","12","65","50","33.4"
"Bartow","2020-03-17","38","173","14","79","51.4","36"
"Bartow","2020-03-18","36","209","8","87","45.1","37.6"
"Bartow","2020-03-19","43","252","11","98","39.6","39.4"
"Bartow","2020-03-20","35","287","7","105","34.7","37.3"
"Bartow","2020-03-21","14","301","3","108","30.6","38.8"
"Bartow","2020-03-22","10","311","4","112","28.6","41.6"
"Bartow","2020-03-23","35","346","11","123","28.2","39.1"
"Bartow","2020-03-24","26","372","6","129","26.2","38.8"
"Bartow","2020-03-25","19","391","2","131","24.6","34.8"
"Bartow","2020-03-26","12","403","2","133","23.3","31.5"
"Bartow","2020-03-27","34","437","13","146","25.9","30.3"
"Bartow","2020-03-28","30","467","6","152","25.7","28.2"
"Bartow","2020-03-29","11","478","3","155","23.9","26.3"
"Bartow","2020-03-30","24","502","6","161","23","25.6"
"Bartow","2020-03-31","12","514","2","163","22.1","24.2"
"Bartow","2020-04-01","13","527","5","168","26","25.3"
"Bartow","2020-04-02","34","561","1","169","24.1","23.7"
"Bartow","2020-04-03","39","600","4","173","20.1","23"
"Bartow","2020-04-04","17","617","1","174","18.1","21.9"
"Bartow","2020-04-05","3","620","0","174","14.2","19"
"Bartow","2020-04-06","24","644","3","177","12.4","17.7"
"Bartow","2020-04-07","43","687","2","179","10.7","16.4"
"Bartow","2020-04-08","28","715","3","182","6.7","16.4"
"Bartow","2020-04-09","43","758","7","189","8.6","16.3"
"Bartow","2020-04-10","45","803","5","194","8.7","14.4"
"Bartow","2020-04-11","44","847","3","197","8.9","13.5"
"Bartow","2020-04-12","6","853","0","197","8.9","11.5"
"Bartow","2020-04-13","18","871","2","199","8.7","10.5"
"Bartow","2020-04-14","47","918","5","204","9.5","10.1"
"Bartow","2020-04-15","107","1025","4","208","8.5","7.6"
"Bartow","2020-04-16","109","1134","2","210","6.5","7.5"
"Bartow","2020-04-17","65","1199","4","214","5.8","7.2"
"Bartow","2020-04-18","43","1242","2","216","5.4","7.2"
"Bartow","2020-04-19","1","1243","1","217","19.7","14.3"
"Bartow","2020-04-20","163","1406","12","229","19.2","13.9"
"Bartow","2020-04-21","107","1513","4","233","18.2","13.9"
"Bartow","2020-04-22","70","1583","7","240","19.1","13.8"
"Bartow","2020-04-23","42","1625","1","241","19.2","12.8"
"Bartow","2020-04-24","79","1704","8","249","19.8","12.8"
"Bartow","2020-04-25","80","1784","4","253","19.8","12.6"
"Bartow","2020-04-26","16","1800","2","255","7.3","13.5"
"Bartow","2020-04-27","99","1899","2","257","6.5","12.9"
"Bartow","2020-04-28","89","1988","7","264","7.1","12.7"
"Bartow","2020-04-29","63","2051","3","267","6.4","12.7"
"Bartow","2020-04-30","152","2203","5","272","6.5","12.8"
"Bartow","2020-05-01","74","2277","5","277","6","12.9"
"Bartow","2020-05-02","51","2328","1","278","5.6","12.7"
"Bartow","2020-05-03","14","2342","0","278","3.8","5.6"
"Bartow","2020-05-04","141","2483","2","280","3.7","5.1"
"Bartow","2020-05-05","85","2568","1","281","2.8","4.9"
"Bartow","2020-05-06","108","2676","1","282","2.2","4.3"
"Bartow","2020-05-07","118","2794","9","291","2.8","4.7"
"Bartow","2020-05-08","139","2933","5","296","2.4","4.2"
"Bartow","2020-05-09","85","3018","4","300","2.8","4.2"
"Bartow","2020-05-10","1","3019","0","300","2.8","3.3"
"Bartow","2020-05-11","172","3191","9","309","3.3","3.5"
"Bartow","2020-05-12","137","3328","7","316","3.9","3.3"
"Bartow","2020-05-13","140","3468","3","319","4.1","3.1"
"Bartow","2020-05-14","96","3564","5","324","3.7","3.3"
"Bartow","2020-05-15","155","3719","9","333","4","3.2"
"Bartow","2020-05-16","79","3798","4","337","4.1","3.4"
"Bartow","2020-05-17","8","3806","0","337","4.1","3.4"
"Bartow","2020-05-18","136","3942","8","345","4.2","3.7"
"Bartow","2020-05-19","136","4078","5","350","4","3.9"
"Bartow","2020-05-20","143","4221","8","358","4.5","4.3"
"Bartow","2020-05-21","63","4284","3","361","4.4","4.1"
"Bartow","2020-05-22","53","4337","3","364","4.4","4.2"
"Bartow","2020-05-23","17","4354","0","364","3.7","3.9"
"Bartow","2020-05-24","11","4365","1","365","5","4.5"
"Bartow","2020-05-25","5","4370","0","365","4.1","4.1"
"Bartow","2020-05-26","127","4497","11","376","4.8","4.4"
"Bartow","2020-05-27","129","4626","10","386","5.1","4.8"
"Bartow","2020-05-28","139","4765","9","395","5.4","4.9"
"Bartow","2020-05-29","193","4958","7","402","5.1","4.7"
"Bartow","2020-05-30","44","5002","2","404","5.7","4.7"
"Bartow","2020-05-31","27","5029","2","406","5.5","5.2"
"Bartow","2020-06-01","179","5208","15","421","6.7","5.4"
"Bartow","2020-06-02","121","5329","13","434","7","5.9"
"Bartow","2020-06-03","124","5453","3","437","6.2","5.7"
"Bartow","2020-06-04","157","5610","7","444","5.9","5.7"
"Bartow","2020-06-05","168","5778","6","450","5.9","5.5"
"Bartow","2020-06-06","74","5852","1","451","5.5","5.6"
"Bartow","2020-06-07","14","5866","2","453","6.5","6"
"Bartow","2020-06-08","181","6047","9","462","6","6.3"
"Bartow","2020-06-09","147","6194","5","467","4.9","6"
"Bartow","2020-06-10","125","6319","4","471","5","5.6"
"Bartow","2020-06-11","209","6528","17","488","5.6","5.7"
"Bartow","2020-06-12","153","6681","8","496","5.8","5.9"
"Bartow","2020-06-13","79","6760","8","504","7","6.3"
"Bartow","2020-06-14","13","6773","0","504","5","5.7"
"Bartow","2020-06-15","259","7032","9","513","4.8","5.4"
"Bartow","2020-06-16","267","7299","11","524","4.9","4.9"
"Bartow","2020-06-17","129","7428","8","532","5.3","5.2"
"Bartow","2020-06-18","209","7637","24","556","5.8","5.7"
"Bartow","2020-06-19","156","7793","8","564","5.8","5.8"
"Bartow","2020-06-20","97","7890","9","573","5.7","6.4"
"Bartow","2020-06-21","16","7906","3","576","8.3","6.7"
"Bartow","2020-06-22","285","8191","19","595","8.8","6.8"
"Bartow","2020-06-23","187","8378","16","611","9.4","7.2"
"Bartow","2020-06-24","227","8605","27","638","10.3","7.8"
"Bartow","2020-06-25","314","8919","33","671","10.1","8"
"Bartow","2020-06-26","414","9333","33","704","10.5","8.2"
"Bartow","2020-06-27","186","9519","16","720","10.4","8"
"Bartow","2020-06-28","23","9542","5","725","10.8","9.6"
"Bartow","2020-06-29","616","10158","58","783","11.2","10"
"Bartow","2020-06-30","401","10559","37","820","11.3","10.4"
"Bartow","2020-07-01","507","11066","43","863","10.8","10.6"
"Bartow","2020-07-02","491","11557","47","910","10.7","10.4"
"Bartow","2020-07-03","128","11685","13","923","11","10.8"
"Bartow","2020-07-04","30","11715","6","929","12.7","11.5"
"Bartow","2020-07-05","13","11728","0","929","9.6","10.2"
"Bartow","2020-07-06","578","12306","94","1023","10.5","10.9"
"Bartow","2020-07-07","591","12897","66","1089","10.8","11.1"
"Bartow","2020-07-08","618","13515","147","1236","13","11.9"
"Bartow","2020-07-09","565","14080","54","1290","13","11.9"
"Bartow","2020-07-10","522","14602","41","1331","12.7","11.8"
"Bartow","2020-07-11","173","14775","12","1343","10.8","11.7"
"Bartow","2020-07-12","42","14817","10","1353","14.2","11.9"
"Bartow","2020-07-13","443","15260","51","1404","13.5","12"
"Bartow","2020-07-14","519","15779","65","1469","13.7","12.3"
"Bartow","2020-07-15","473","16252","50","1519","11.8","12.4"
"Bartow","2020-07-16","501","16753","36","1555","11.5","12.2"
"Bartow","2020-07-17","464","17217","49","1604","11.9","12.3"
"Bartow","2020-07-18","104","17321","12","1616","12.5","11.7"
"Bartow","2020-07-19","28","17349","2","1618","10.1","12.2"
"Bartow","2020-07-20","392","17741","37","1655","9.9","11.7"
"Bartow","2020-07-21","481","18222","71","1726","10.2","11.9"
"Bartow","2020-07-22","250","18472","35","1761","10.7","11.2"
"Bartow","2020-07-23","454","18926","56","1817","11.4","11.4"
"Bartow","2020-07-24","400","19326","46","1863","11.5","11.7"
"Bartow","2020-07-25","219","19545","36","1899","12.2","12.4"
"Bartow","2020-07-26","24","19569","4","1903","13.6","11.9"
"Bartow","2020-07-27","530","20099","59","1962","13.8","11.8"
"Bartow","2020-07-28","363","20462","45","2007","13.5","11.8"
"Bartow","2020-07-29","364","20826","48","2055","13.4","12"
"Bartow","2020-07-30","309","21135","32","2087","13.1","12.2"
"Bartow","2020-07-31","440","21575","39","2126","12.7","12.1"
"Bartow","2020-08-01","75","21650","15","2141","13.2","12.7"
"Bartow","2020-08-02","41","21691","1","2142","11.2","12.4"
"Bartow","2020-08-03","230","21921","29","2171","11.4","12.6"
"Bartow","2020-08-04","366","22287","33","2204","10.9","12.2"
"Bartow","2020-08-05","287","22574","20","2224","10","11.7"
"Bartow","2020-08-06","303","22877","21","2245","9.5","11.3"
"Bartow","2020-08-07","395","23272","32","2277","9.4","11.1"
"Bartow","2020-08-08","191","23463","19","2296","8","10.6"
"Bartow","2020-08-09","30","23493","2","2298","8.6","9.9"
"Bartow","2020-08-10","340","23833","38","2336","8.4","9.9"
"Bartow","2020-08-11","435","24268","41","2377","8.5","9.7"
"Bartow","2020-08-12","302","24570","32","2409","9","9.5"
"Bartow","2020-08-13","360","24930","29","2438","9.1","9.3"
"Bartow","2020-08-14","386","25316","30","2468","9.1","9.3"
"Bartow","2020-08-15","79","25395","11","2479","9.7","8.8"
"Bartow","2020-08-16","30","25425","5","2484","11.1","9.8"
"Bartow","2020-08-17","137","25562","20","2504","11.6","10"
"Bartow","2020-08-18","355","25917","24","2528","11.2","9.8"
"Bartow","2020-08-19","418","26335","31","2559","10.7","9.9"
"Bartow","2020-08-20","241","26576","17","2576","10.6","9.9"
"Bartow","2020-08-21","332","26908","23","2599","10.5","9.8"
"Bartow","2020-08-22","173","27081","20","2619","10.1","9.9"
"Bartow","2020-08-23","46","27127","8","2627","10.2","10.7"
"Bartow","2020-08-24","397","27524","46","2673","9.8","10.7"
"Bartow","2020-08-25","175","27699","14","2687","10","10.6"
"Bartow","2020-08-26","328","28027","25","2712","10","10.4"
"Bartow","2020-08-27","366","28393","29","2741","10.1","10.4"
"Bartow","2020-08-28","303","28696","23","2764","10.2","10.4"
"Bartow","2020-08-29","43","28739","3","2767","9.6","9.9"
"Bartow","2020-08-30","28","28767","4","2771","9.1","9.7"
"Bartow","2020-08-31","357","29124","47","2818","9.4","9.6"
"Bartow","2020-09-01","156","29280","13","2831","9.4","9.7"
"Bartow","2020-09-02","114","29394","15","2846","10.2","10.1"
"Bartow","2020-09-03","241","29635","23","2869","10.4","10.3"
"Bartow","2020-09-04","198","29833","19","2888","10.7","10.5"
"Bartow","2020-09-05","83","29916","7","2895","10.9","10.3"
"Bartow","2020-09-06","41","29957","2","2897","9.6","9.4"
"Bartow","2020-09-07","20","29977","2","2899","9.1","9.3"
"Bartow","2020-09-08","135","30112","15","2914","9.5","9.5"
"Bartow","2020-09-09","114","30226","11","2925","9","9.6"
"Bartow","2020-09-10","233","30459","28","2953","9.4","9.9"
"Bartow","2020-09-11","193","30652","11","2964","8.8","9.8"
"Bartow","2020-09-12","106","30758","7","2971","8.6","9.7"
"Bartow","2020-09-13","33","30791","4","2975","9.6","9.6"
"Bartow","2020-09-14","240","31031","21","2996","9.4","9.3"
"Bartow","2020-09-15","149","31180","11","3007","8.9","9.2"
"Bartow","2020-09-16","81","31261","7","3014","8.7","8.9"
"Bartow","2020-09-17","95","31356","7","3021","8.1","8.7"
"Bartow","2020-09-18","236","31592","25","3046","8.8","8.8"
"Bartow","2020-09-19","98","31690","6","3052","8.7","8.6"
"Bartow","2020-09-20","24","31714","3","3055","8.8","9.2"
"Bartow","2020-09-21","162","31876","21","3076","9.4","9.4"
"Bartow","2020-09-22","163","32039","11","3087","9.3","9.1"
"Bartow","2020-09-23","65","32104","8","3095","9.8","9.3"
"Bartow","2020-09-24","183","32287","18","3113","10.2","9.1"
"Bartow","2020-09-25","153","32440","5","3118","9.1","8.9"
"Bartow","2020-09-26","79","32519","4","3122","9","8.8"
"Bartow","2020-09-27","17","32536","1","3123","8","8.4"
"Bartow","2020-09-28","142","32678","25","3148","8.7","9"
"Bartow","2020-09-29","141","32819","10","3158","8.7","9"
"Bartow","2020-09-30","92","32911","8","3166","8.2","9"
"Bartow","2020-10-01","193","33104","18","3184","8.1","9.1"
"Bartow","2020-10-02","163","33267","15","3199","9","9"
"Bartow","2020-10-03","56","33323","5","3204","9.5","9.2"
"Bartow","2020-10-04","30","33353","2","3206","9.6","8.8"
"Bartow","2020-10-05","247","33600","25","3231","8.6","8.6"
"Bartow","2020-10-06","270","33870","20","3251","8.6","8.7"
"Bartow","2020-10-07","131","34001","10","3261","8.5","8.3"
"Bartow","2020-10-08","432","34433","67","3328","9.4","8.7"
"Bartow","2020-10-09","244","34677","29","3357","9.7","9.4"
"Bartow","2020-10-10","91","34768","14","3371","10.7","10.1"
"Bartow","2020-10-11","27","34795","1","3372","10.2","9.9"
"Bartow","2020-10-12","284","35079","29","3401","10.2","9.4"
"Bartow","2020-10-13","184","35263","22","3423","10.9","9.8"
"Bartow","2020-10-14","135","35398","22","3445","12.1","10.3"
"Bartow","2020-10-15","392","35790","46","3491","11.6","10.5"
"Bartow","2020-10-16","297","36087","27","3518","11.2","10.5"
"Bartow","2020-10-17","110","36197","10","3528","10.3","10.5"
"Bartow","2020-10-18","22","36219","1","3529","10.4","10.3"
"Bartow","2020-10-19","290","36509","42","3571","11","10.6"
"Bartow","2020-10-20","133","36642","21","3592","11.6","11.2"
"Bartow","2020-10-21","154","36796","25","3617","11.6","11.9"
"Bartow","2020-10-22","367","37163","41","3658","11.5","11.5"
"Bartow","2020-10-23","296","37459","32","3690","11.7","11.5"
"Bartow","2020-10-24","191","37650","21","3711","12","11.2"
"Bartow","2020-10-25","96","37746","6","3717","12.2","11.3"
"Bartow","2020-10-26","355","38101","36","3753","11.6","11.3"
"Bartow","2020-10-27","139","38240","19","3772","11.3","11.5"
"Bartow","2020-10-28","173","38413","17","3789","10.4","11"
"Bartow","2020-10-29","127","38540","8","3797","9.7","10.6"
"Bartow","2020-10-30","258","38798","24","3821","9.5","10.6"
"Bartow","2020-10-31","136","38934","20","3841","10","11"
"Bartow","2020-11-01","95","39029","11","3852","10.8","11.5"
"Bartow","2020-11-02","220","39249","31","3883","11.4","11.5"
"Bartow","2020-11-03","103","39352","10","3893","10.8","11.1"
"Bartow","2020-11-04","219","39571","26","3919","11.1","10.7"
"Bartow","2020-11-05","341","39912","38","3957","11.8","10.7"
"Bartow","2020-11-06","261","40173","29","3986","12","10.8"
"Bartow","2020-11-07","118","40291","24","4010","12.8","11.4"
"Bartow","2020-11-08","60","40351","13","4023","14.3","12.5"
"Bartow","2020-11-09","288","40639","50","4073","14.7","13"
"Bartow","2020-11-10","135","40774","22","4095","15.7","13.2"
"Bartow","2020-11-11","166","40940","22","4117","15.9","13.5"
"Bartow","2020-11-12","458","41398","67","4184","16.4","14.1"
"Bartow","2020-11-13","202","41600","29","4213","16.8","14.4"
"Bartow","2020-11-14","172","41772","28","4241","16.3","14.5"
"Bartow","2020-11-15","86","41858","11","4252","15","14.6"
"Bartow","2020-11-16","426","42284","63","4315","14.6","14.7"
"Bartow","2020-11-17","137","42421","17","4332","14.1","14.9"
"Bartow","2020-11-18","196","42617","30","4362","14.4","15.1"
"Bartow","2020-11-19","496","43113","73","4435","14.4","15.4"
"Bartow","2020-11-20","403","43516","54","4489","14.2","15.5"
"Bartow","2020-11-21","140","43656","26","4515","14.6","15.4"
"Bartow","2020-11-22","73","43729","12","4527","15.1","15"
"Bartow","2020-11-23","505","44234","66","4593","14.8","14.7"
"Bartow","2020-11-24","195","44429","31","4624","15.3","14.7"
"Bartow","2020-11-25","225","44654","40","4664","15.7","15"
"Bartow","2020-11-26","44","44698","8","4672","16.2","15.3"
"Bartow","2020-11-27","142","44840","31","4703","17.4","15.8"
"Bartow","2020-11-28","137","44977","25","4728","17.3","16"
"Bartow","2020-11-29","202","45179","31","4759","17.2","16.1"
"Bartow","2020-11-30","394","45573","82","4841","18.3","16.6"
"Bartow","2020-12-01","341","45914","60","4901","18.5","16.9"
"Bartow","2020-12-02","239","46153","41","4942","18.5","17.1"
"Bartow","2020-12-03","449","46602","76","5018","18.3","17.2"
"Bartow","2020-12-04","327","46929","64","5082","18","17.7"
"Bartow","2020-12-05","125","47054","23","5105","18","17.7"
"Bartow","2020-12-06","93","47147","27","5132","19.9","18.6"
"Bartow","2020-12-07","587","47734","81","5213","18.9","18.6"
"Bartow","2020-12-08","419","48153","55","5268","18.3","18.4"
"Bartow","2020-12-09","199","48352","44","5312","19","18.7"
"Bartow","2020-12-10","517","48869","95","5407","19.2","18.7"
"Bartow","2020-12-11","517","49386","65","5472","18.2","18.1"
"Bartow","2020-12-12","136","49522","24","5496","18.1","18"
"Bartow","2020-12-13","91","49613","22","5518","17.4","18.7"
"Bartow","2020-12-14","545","50158","94","5612","17.9","18.4"
"Bartow","2020-12-15","655","50813","138","5750","19","18.7"
"Bartow","2020-12-16","285","51098","57","5807","18.7","18.9"
"Bartow","2020-12-17","621","51719","84","5891","18","18.6"
"Bartow","2020-12-18","639","52358","109","6000","18.7","18.4"
"Bartow","2020-12-19","172","52530","48","6048","20.1","19.1"
"Bartow","2020-12-20","74","52604","16","6064","19.8","18.6"
"Bartow","2020-12-21","773","53377","161","6225","20.3","19.1"
"Bartow","2020-12-22","667","54044","149","6374","20.5","19.7"
"Bartow","2020-12-23","260","54304","49","6423","20.3","19.5"
"Bartow","2020-12-24","249","54553","99","6522","24.1","21"
"Bartow","2020-12-25","44","54597","9","6531","24.5","21.6"
"Bartow","2020-12-26","141","54738","43","6574","24.9","22.5"
"Bartow","2020-12-27","121","54859","48","6622","27.5","23.6"
"Bartow","2020-12-28","861","55720","261","6883","28.8","24.6"
"Bartow","2020-12-29","771","56491","165","7048","28.7","24.6"
"Bartow","2020-12-30","360","56851","76","7124","29","24.7"
"Bartow","2020-12-31","690","57541","161","7285","26.7","25.4"
"Bartow","2021-01-01","58","57599","21","7306","28.9","26.7"
"Bartow","2021-01-02","100","57699","34","7340","29.4","27.2"
"Bartow","2021-01-03","110","57809","50","7390","30.3","28.9"
"Bartow","2021-01-04","1172","58981","287","7677","29.4","29.1"
"Bartow","2021-01-05","1291","60272","264","7941","29.3","29"
"Bartow","2021-01-06","235","60507","54","7995","29.6","29.3"
"Bartow","2021-01-07","822","61329","147","8142","28.8","27.7"
"Bartow","2021-01-08","526","61855","93","8235","26.1","27.5"
"Bartow","2021-01-09","158","62013","38","8273","24.7","27.1"
"Bartow","2021-01-10","110","62123","31","8304","22.2","26.3"
"Bartow","2021-01-11","317","62440","58","8362","21.4","25.4"
"Bartow","2021-01-12","554","62994","88","8450","20.7","25"
"Bartow","2021-01-13","252","63246","53","8503","20.4","25"
"Bartow","2021-01-14","562","63808","89","8592","20.1","24.5"
"Bartow","2021-01-15","529","64337","89","8681","20","23.1"
"Bartow","2021-01-16","132","64469","35","8716","20.4","22.5"
"Bartow","2021-01-17","91","64560","12","8728","18.2","20.2"
"Bartow","2021-01-18","520","65080","104","8832","18.5","19.9"
"Bartow","2021-01-19","177","65257","34","8866","18.9","19.8"
"Bartow","2021-01-20","214","65471","40","8906","18.6","19.5"
"Bartow","2021-01-21","483","65954","61","8967","18.2","19.1"
"Bartow","2021-01-22","214","66168","39","9006","18.4","19.2"
"Bartow","2021-01-23","124","66292","33","9039","18.4","19.4"
"Bartow","2021-01-24","59","66351","14","9053","19.9","19"
"Bartow","2021-01-25","52","66403","10","9063","19.8","19.1"
"Bartow","2021-01-26","6","66409","0","9063","17","18"
"Bartow","2021-01-27","0","66409","0","9063","14.3","16.5"
"Ben Hill","2020-02-01","0","0","0","0",".","."
"Ben Hill","2020-02-02","0","0","0","0",".","."
"Ben Hill","2020-02-03","0","0","0","0",".","."
"Ben Hill","2020-02-04","0","0","0","0",".","."
"Ben Hill","2020-02-05","0","0","0","0",".","."
"Ben Hill","2020-02-06","0","0","0","0",".","."
"Ben Hill","2020-02-07","0","0","0","0","0","."
"Ben Hill","2020-02-08","0","0","0","0","0","."
"Ben Hill","2020-02-09","0","0","0","0","0","."
"Ben Hill","2020-02-10","0","0","0","0","0","."
"Ben Hill","2020-02-11","0","0","0","0","0","."
"Ben Hill","2020-02-12","0","0","0","0","0","."
"Ben Hill","2020-02-13","0","0","0","0","0","."
"Ben Hill","2020-02-14","0","0","0","0","0","0"
"Ben Hill","2020-02-15","0","0","0","0","0","0"
"Ben Hill","2020-02-16","0","0","0","0","0","0"
"Ben Hill","2020-02-17","0","0","0","0","0","0"
"Ben Hill","2020-02-18","0","0","0","0","0","0"
"Ben Hill","2020-02-19","0","0","0","0","0","0"
"Ben Hill","2020-02-20","0","0","0","0","0","0"
"Ben Hill","2020-02-21","0","0","0","0","0","0"
"Ben Hill","2020-02-22","0","0","0","0","0","0"
"Ben Hill","2020-02-23","0","0","0","0","0","0"
"Ben Hill","2020-02-24","0","0","0","0","0","0"
"Ben Hill","2020-02-25","0","0","0","0","0","0"
"Ben Hill","2020-02-26","0","0","0","0","0","0"
"Ben Hill","2020-02-27","0","0","0","0","0","0"
"Ben Hill","2020-02-28","0","0","0","0","0","0"
"Ben Hill","2020-02-29","0","0","0","0","0","0"
"Ben Hill","2020-03-01","0","0","0","0","0","0"
"Ben Hill","2020-03-02","0","0","0","0","0","0"
"Ben Hill","2020-03-03","0","0","0","0","0","0"
"Ben Hill","2020-03-04","0","0","0","0","0","0"
"Ben Hill","2020-03-05","0","0","0","0","0","0"
"Ben Hill","2020-03-06","0","0","0","0","0","0"
"Ben Hill","2020-03-07","0","0","0","0","0","0"
"Ben Hill","2020-03-08","0","0","0","0","0","0"
"Ben Hill","2020-03-09","0","0","0","0","0","0"
"Ben Hill","2020-03-10","0","0","0","0","0","0"
"Ben Hill","2020-03-11","0","0","0","0","0","0"
"Ben Hill","2020-03-12","0","0","0","0","0","0"
"Ben Hill","2020-03-13","1","1","0","0","0","0"
"Ben Hill","2020-03-14","1","2","0","0","0","0"
"Ben Hill","2020-03-15","1","3","0","0","0","0"
"Ben Hill","2020-03-16","3","6","0","0","0","0"
"Ben Hill","2020-03-17","3","9","0","0","0","0"
"Ben Hill","2020-03-18","5","14","0","0","0","0"
"Ben Hill","2020-03-19","5","19","1","1","2.9","1.4"
"Ben Hill","2020-03-20","2","21","0","1","2.9","1.4"
"Ben Hill","2020-03-21","1","22","0","1","2.9","1.4"
"Ben Hill","2020-03-22","0","22","0","1","2.9","1.4"
"Ben Hill","2020-03-23","28","50","0","1","2.9","1.4"
"Ben Hill","2020-03-24","19","69","0","1","2.9","1.4"
"Ben Hill","2020-03-25","7","76","0","1","2.9","1.4"
"Ben Hill","2020-03-26","18","94","0","1","0","1.4"
"Ben Hill","2020-03-27","5","99","2","3","5.7","4.3"
"Ben Hill","2020-03-28","4","103","0","3","5.7","4.3"
"Ben Hill","2020-03-29","6","109","0","3","5.7","4.3"
"Ben Hill","2020-03-30","15","124","1","4","6.7","4.8"
"Ben Hill","2020-03-31","21","145","1","5","7.3","5.1"
"Ben Hill","2020-04-01","7","152","0","5","7.3","5.1"
"Ben Hill","2020-04-02","12","164","3","8","10.9","5.5"
"Ben Hill","2020-04-03","4","168","0","8","5.2","5.5"
"Ben Hill","2020-04-04","4","172","0","8","5.2","5.5"
"Ben Hill","2020-04-05","4","176","0","8","5.2","5.5"
"Ben Hill","2020-04-06","5","181","0","8","4.3","5.5"
"Ben Hill","2020-04-07","21","202","0","8","3.6","5.5"
"Ben Hill","2020-04-08","5","207","1","9","6.4","6.9"
"Ben Hill","2020-04-09","9","216","1","10","4.4","7.7"
"Ben Hill","2020-04-10","3","219","0","10","4.4","4.8"
"Ben Hill","2020-04-11","1","220","0","10","4.4","4.8"
"Ben Hill","2020-04-12","1","221","0","10","4.4","4.8"
"Ben Hill","2020-04-13","6","227","2","12","9.2","6.7"
"Ben Hill","2020-04-14","3","230","1","13","14","8.8"
"Ben Hill","2020-04-15","2","232","0","13","11.1","8.8"
"Ben Hill","2020-04-16","13","245","2","15","11.7","8.1"
"Ben Hill","2020-04-17","10","255","4","19","17.4","10.9"
"Ben Hill","2020-04-18","5","260","0","19","17.4","10.9"
"Ben Hill","2020-04-19","2","262","0","19","17.4","10.9"
"Ben Hill","2020-04-20","17","279","4","23","16","12.6"
"Ben Hill","2020-04-21","5","284","0","23","11.3","12.6"
"Ben Hill","2020-04-22","9","293","1","24","12.9","12"
"Ben Hill","2020-04-23","9","302","2","26","13.8","12.8"
"Ben Hill","2020-04-24","5","307","1","27","11","14.2"
"Ben Hill","2020-04-25","1","308","0","27","11","14.2"
"Ben Hill","2020-04-26","2","310","0","27","11","14.2"
"Ben Hill","2020-04-27","45","355","2","29","8.3","12.1"
"Ben Hill","2020-04-28","22","377","2","31","9.6","10.4"
"Ben Hill","2020-04-29","17","394","1","32","8.8","10.8"
"Ben Hill","2020-04-30","5","399","0","32","5.6","9.7"
"Ben Hill","2020-05-01","21","420","2","34","4.1","7.6"
"Ben Hill","2020-05-02","4","424","1","35","7.7","9.3"
"Ben Hill","2020-05-03","4","428","2","37","14.8","12.9"
"Ben Hill","2020-05-04","3","431","0","37","14.2","11.2"
"Ben Hill","2020-05-05","12","443","0","37","12.9","11.2"
"Ben Hill","2020-05-06","33","476","0","37","12.1","10.4"
"Ben Hill","2020-05-07","39","515","0","37","12.1","8.9"
"Ben Hill","2020-05-08","39","554","1","38","11.1","7.6"
"Ben Hill","2020-05-09","4","558","0","38","7.5","7.6"
"Ben Hill","2020-05-10","0","558","0","38","0.4","7.6"
"Ben Hill","2020-05-11","19","577","2","40","1.9","8"
"Ben Hill","2020-05-12","20","597","1","41","2.6","7.7"
"Ben Hill","2020-05-13","25","622","2","43","3.7","7.9"
"Ben Hill","2020-05-14","15","637","2","45","5.6","8.9"
"Ben Hill","2020-05-15","24","661","4","49","7.6","9.4"
"Ben Hill","2020-05-16","3","664","0","49","7.6","7.6"
"Ben Hill","2020-05-17","1","665","0","49","7.6","4"
"Ben Hill","2020-05-18","38","703","1","50","6.5","4.2"
"Ben Hill","2020-05-19","25","728","1","51","6.4","4.5"
"Ben Hill","2020-05-20","30","758","1","52","5.7","4.7"
"Ben Hill","2020-05-21","37","795","4","56","5.3","5.5"
"Ben Hill","2020-05-22","34","829","4","60","4.6","6.1"
"Ben Hill","2020-05-23","2","831","1","61","11.8","9.7"
"Ben Hill","2020-05-24","4","835","0","61","11.8","9.7"
"Ben Hill","2020-05-25","0","835","0","61","11.4","9"
"Ben Hill","2020-05-26","51","886","7","68","12.8","9.6"
"Ben Hill","2020-05-27","23","909","1","69","12.9","9.3"
"Ben Hill","2020-05-28","31","940","1","70","11.9","8.6"
"Ben Hill","2020-05-29","32","972","5","75","12.4","8.5"
"Ben Hill","2020-05-30","1","973","0","75","5.3","8.5"
"Ben Hill","2020-05-31","5","978","0","75","5.3","8.5"
"Ben Hill","2020-06-01","72","1050","6","81","6.5","8.9"
"Ben Hill","2020-06-02","33","1083","4","85","6.2","9.5"
"Ben Hill","2020-06-03","43","1126","2","87","6.3","9.6"
"Ben Hill","2020-06-04","51","1177","0","87","5.8","8.8"
"Ben Hill","2020-06-05","81","1258","3","90","4.1","8.3"
"Ben Hill","2020-06-06","2","1260","0","90","4.1","4.7"
"Ben Hill","2020-06-07","2","1262","1","91","11.3","8.3"
"Ben Hill","2020-06-08","53","1315","4","95","11.1","8.8"
"Ben Hill","2020-06-09","26","1341","1","96","10","8.1"
"Ben Hill","2020-06-10","31","1372","0","96","9.3","7.8"
"Ben Hill","2020-06-11","31","1403","7","103","12.5","9.2"
"Ben Hill","2020-06-12","38","1441","2","105","12.7","8.4"
"Ben Hill","2020-06-13","2","1443","0","105","12.7","8.4"
"Ben Hill","2020-06-14","1","1444","0","105","5.6","8.4"
"Ben Hill","2020-06-15","90","1534","8","113","5.8","8.5"
"Ben Hill","2020-06-16","43","1577","5","118","6.9","8.4"
"Ben Hill","2020-06-17","62","1639","4","122","7.8","8.6"
"Ben Hill","2020-06-18","40","1679","2","124","5.3","8.9"
"Ben Hill","2020-06-19","41","1720","3","127","5.6","9.2"
"Ben Hill","2020-06-20","3","1723","0","127","5.6","9.2"
"Ben Hill","2020-06-21","3","1726","0","127","5.6","5.6"
"Ben Hill","2020-06-22","75","1801","16","143","7.4","6.6"
"Ben Hill","2020-06-23","62","1863","6","149","7.1","7"
"Ben Hill","2020-06-24","77","1940","9","158","7.9","7.8"
"Ben Hill","2020-06-25","57","1997","10","168","9.7","7.5"
"Ben Hill","2020-06-26","76","2073","4","172","9.4","7.5"
"Ben Hill","2020-06-27","3","2076","1","173","14.1","9.9"
"Ben Hill","2020-06-28","1","2077","0","173","14.1","9.9"
"Ben Hill","2020-06-29","130","2207","13","186","12.5","9.9"
"Ben Hill","2020-06-30","61","2268","14","200","14.4","10.8"
"Ben Hill","2020-07-01","89","2357","5","205","13.5","10.7"
"Ben Hill","2020-07-02","103","2460","8","213","12.1","10.9"
"Ben Hill","2020-07-03","13","2473","1","214","12.5","10.9"
"Ben Hill","2020-07-04","3","2476","1","215","12.5","13.3"
"Ben Hill","2020-07-05","1","2477","0","215","12.5","13.3"
"Ben Hill","2020-07-06","168","2645","25","240","13.2","12.8"
"Ben Hill","2020-07-07","103","2748","9","249","11.1","12.8"
"Ben Hill","2020-07-08","43","2791","1","250","10.7","12.1"
"Ben Hill","2020-07-09","116","2907","8","258","10.6","11.3"
"Ben Hill","2020-07-10","69","2976","9","267","11.3","11.9"
"Ben Hill","2020-07-11","2","2978","0","267","6.6","9.5"
"Ben Hill","2020-07-12","2","2980","0","267","6.6","9.5"
"Ben Hill","2020-07-13","89","3069","0","267","4.4","8.8"
"Ben Hill","2020-07-14","55","3124","6","273","4.7","7.9"
"Ben Hill","2020-07-15","68","3192","8","281","6.1","8.4"
"Ben Hill","2020-07-16","36","3228","2","283","5.9","8.2"
"Ben Hill","2020-07-17","67","3295","7","290","5.5","8.4"
"Ben Hill","2020-07-18","20","3315","6","296","9.8","8.2"
"Ben Hill","2020-07-19","4","3319","0","296","9.8","8.2"
"Ben Hill","2020-07-20","92","3411","11","307","11.5","8"
"Ben Hill","2020-07-21","89","3500","2","309","10.3","7.5"
"Ben Hill","2020-07-22","38","3538","4","313","10.1","8.1"
"Ben Hill","2020-07-23","58","3596","4","317","10.3","8.1"
"Ben Hill","2020-07-24","68","3664","7","324","10.3","7.9"
"Ben Hill","2020-07-25","21","3685","4","328","8.7","9.3"
"Ben Hill","2020-07-26","0","3685","0","328","8.7","9.3"
"Ben Hill","2020-07-27","87","3772","12","340","9","10.2"
"Ben Hill","2020-07-28","65","3837","8","348","10.4","10.3"
"Ben Hill","2020-07-29","78","3915","9","357","10.6","10.3"
"Ben Hill","2020-07-30","94","4009","13","370","11.5","10.9"
"Ben Hill","2020-07-31","46","4055","2","372","10.7","10.5"
"Ben Hill","2020-08-01","25","4080","5","377","10.8","9.8"
"Ben Hill","2020-08-02","4","4084","2","379","18","13.3"
"Ben Hill","2020-08-03","121","4205","13","392","17.5","13.3"
"Ben Hill","2020-08-04","94","4299","21","413","19","14.7"
"Ben Hill","2020-08-05","119","4418","24","437","20.2","15.4"
"Ben Hill","2020-08-06","81","4499","13","450","20.5","16"
"Ben Hill","2020-08-07","148","4647","18","468","21.6","16.2"
"Ben Hill","2020-08-08","45","4692","10","478","22","16.4"
"Ben Hill","2020-08-09","4","4696","0","478","14.8","16.4"
"Ben Hill","2020-08-10","99","4795","11","489","14.9","16.2"
"Ben Hill","2020-08-11","110","4905","18","507","14","16.5"
"Ben Hill","2020-08-12","166","5071","19","526","12.8","16.5"
"Ben Hill","2020-08-13","191","5262","18","544","11.8","16.2"
"Ben Hill","2020-08-14","104","5366","8","552","11.2","16.4"
"Ben Hill","2020-08-15","31","5397","3","555","9.4","15.7"
"Ben Hill","2020-08-16","2","5399","0","555","9.4","12.1"
"Ben Hill","2020-08-17","7","5406","2","557","11.9","13.4"
"Ben Hill","2020-08-18","95","5501","13","570","11.5","12.8"
"Ben Hill","2020-08-19","90","5591","10","580","11.5","12.1"
"Ben Hill","2020-08-20","152","5743","19","599","11.9","11.9"
"Ben Hill","2020-08-21","53","5796","7","606","12.7","11.9"
"Ben Hill","2020-08-22","18","5814","5","611","15.3","12.3"
"Ben Hill","2020-08-23","2","5816","0","611","15.3","12.3"
"Ben Hill","2020-08-24","83","5899","2","613","11.5","11.7"
"Ben Hill","2020-08-25","84","5983","7","620","10.8","11.1"
"Ben Hill","2020-08-26","88","6071","7","627","10.3","10.9"
"Ben Hill","2020-08-27","81","6152","8","635","9.9","10.9"
"Ben Hill","2020-08-28","50","6202","8","643","10.3","11.5"
"Ben Hill","2020-08-29","42","6244","2","645","7","11.2"
"Ben Hill","2020-08-30","19","6263","5","650","10.8","13"
"Ben Hill","2020-08-31","57","6320","2","652","11","11.2"
"Ben Hill","2020-09-01","48","6368","5","657","11.3","11"
"Ben Hill","2020-09-02","62","6430","9","666","12.2","11.3"
"Ben Hill","2020-09-03","65","6495","7","673","12.3","11.1"
"Ben Hill","2020-09-04","85","6580","13","686","12.2","11.3"
"Ben Hill","2020-09-05","16","6596","1","687","12.4","9.7"
"Ben Hill","2020-09-06","3","6599","0","687","8.7","9.7"
"Ben Hill","2020-09-07","25","6624","3","690","9.9","10.4"
"Ben Hill","2020-09-08","55","6679","1","691","8.7","10"
"Ben Hill","2020-09-09","48","6727","4","695","7.8","10"
"Ben Hill","2020-09-10","42","6769","7","702","8.6","10.5"
"Ben Hill","2020-09-11","61","6830","5","707","7.6","9.9"
"Ben Hill","2020-09-12","8","6838","3","710","12.1","12.3"
"Ben Hill","2020-09-13","5","6843","0","710","12.1","10.4"
"Ben Hill","2020-09-14","50","6893","7","717","12.4","11.1"
"Ben Hill","2020-09-15","54","6947","5","722","13.4","11"
"Ben Hill","2020-09-16","53","7000","2","724","12.8","10.3"
"Ben Hill","2020-09-17","38","7038","9","733","13.8","11.2"
"Ben Hill","2020-09-18","36","7074","2","735","13.4","10.5"
"Ben Hill","2020-09-19","20","7094","2","737","9.5","10.8"
"Ben Hill","2020-09-20","2","7096","1","738","16.6","14.3"
"Ben Hill","2020-09-21","36","7132","6","744","17","14.7"
"Ben Hill","2020-09-22","27","7159","4","748","17.8","15.6"
"Ben Hill","2020-09-23","27","7186","1","749","17.8","15.3"
"Ben Hill","2020-09-24","35","7221","10","759","18.5","16.1"
"Ben Hill","2020-09-25","47","7268","9","768","20.4","16.9"
"Ben Hill","2020-09-26","5","7273","1","769","21.8","15.7"
"Ben Hill","2020-09-27","3","7276","0","769","14.7","15.7"
"Ben Hill","2020-09-28","64","7340","9","778","14.3","15.7"
"Ben Hill","2020-09-29","39","7379","2","780","12.9","15.4"
"Ben Hill","2020-09-30","42","7421","4","784","13.8","15.8"
"Ben Hill","2020-10-01","42","7463","9","793","12.8","15.6"
"Ben Hill","2020-10-02","54","7517","5","798","11.3","15.9"
"Ben Hill","2020-10-03","15","7532","4","802","12.3","17.1"
"Ben Hill","2020-10-04","4","7536","0","802","12.3","13.5"
"Ben Hill","2020-10-05","45","7581","3","805","11.2","12.8"
"Ben Hill","2020-10-06","49","7630","2","807","11.1","12"
"Ben Hill","2020-10-07","47","7677","2","809","10.3","12.1"
"Ben Hill","2020-10-08","58","7735","8","817","9.2","11"
"Ben Hill","2020-10-09","26","7761","2","819","9","10.2"
"Ben Hill","2020-10-10","13","7774","2","821","7.4","9.9"
"Ben Hill","2020-10-11","3","7777","0","821","7.4","9.9"
"Ben Hill","2020-10-12","32","7809","1","822","6.9","9.1"
"Ben Hill","2020-10-13","31","7840","0","822","6.3","8.7"
"Ben Hill","2020-10-14","22","7862","2","824","7","8.7"
"Ben Hill","2020-10-15","34","7896","3","827","6.3","7.8"
"Ben Hill","2020-10-16","30","7926","3","830","6.6","7.8"
"Ben Hill","2020-10-17","5","7931","0","830","4.4","5.9"
"Ben Hill","2020-10-18","3","7934","0","830","4.4","5.9"
"Ben Hill","2020-10-19","39","7973","7","837","6.6","6.7"
"Ben Hill","2020-10-20","27","8000","7","844","10.3","8.3"
"Ben Hill","2020-10-21","25","8025","3","847","10.7","8.8"
"Ben Hill","2020-10-22","24","8049","1","848","10","8.2"
"Ben Hill","2020-10-23","37","8086","4","852","10.1","8.4"
"Ben Hill","2020-10-24","7","8093","1","853","12.2","8.3"
"Ben Hill","2020-10-25","0","8093","0","853","12.2","8.3"
"Ben Hill","2020-10-26","33","8126","6","859","12.2","9.4"
"Ben Hill","2020-10-27","17","8143","1","860","9.3","9.8"
"Ben Hill","2020-10-28","12","8155","4","864","12.4","11.5"
"Ben Hill","2020-10-29","23","8178","1","865","12.4","11.2"
"Ben Hill","2020-10-30","51","8229","4","869","12","11.1"
"Ben Hill","2020-10-31","5","8234","0","869","9.9","11.1"
"Ben Hill","2020-11-01","2","8236","1","870","17.1","14.6"
"Ben Hill","2020-11-02","24","8260","2","872","15.7","13.9"
"Ben Hill","2020-11-03","26","8286","3","875","16.5","12.9"
"Ben Hill","2020-11-04","35","8321","3","878","12.9","12.7"
"Ben Hill","2020-11-05","30","8351","3","881","13.8","13.1"
"Ben Hill","2020-11-06","26","8377","1","882","13.2","12.6"
"Ben Hill","2020-11-07","11","8388","3","885","17.1","13.5"
"Ben Hill","2020-11-08","4","8392","0","885","9.9","13.5"
"Ben Hill","2020-11-09","18","8410","1","886","9.5","12.6"
"Ben Hill","2020-11-10","17","8427","1","887","8.7","12.6"
"Ben Hill","2020-11-11","26","8453","2","889","8.6","10.8"
"Ben Hill","2020-11-12","35","8488","1","890","7.6","10.7"
"Ben Hill","2020-11-13","33","8521","1","891","7.5","10.3"
"Ben Hill","2020-11-14","13","8534","1","892","4.7","10.9"
"Ben Hill","2020-11-15","4","8538","1","893","8.2","9.1"
"Ben Hill","2020-11-16","41","8579","4","897","8.8","9.2"
"Ben Hill","2020-11-17","29","8608","1","898","8.5","8.6"
"Ben Hill","2020-11-18","22","8630","2","900","8.7","8.7"
"Ben Hill","2020-11-19","71","8701","2","902","8.7","8.1"
"Ben Hill","2020-11-20","42","8743","5","907","10","8.7"
"Ben Hill","2020-11-21","7","8750","0","907","8.9","6.8"
"Ben Hill","2020-11-22","4","8754","0","907","5.3","6.8"
"Ben Hill","2020-11-23","30","8784","6","913","6.8","7.8"
"Ben Hill","2020-11-24","41","8825","6","919","8.3","8.4"
"Ben Hill","2020-11-25","50","8875","7","926","9.1","8.9"
"Ben Hill","2020-11-26","4","8879","1","927","12.2","10.5"
"Ben Hill","2020-11-27","8","8887","2","929","14.1","12"
"Ben Hill","2020-11-28","11","8898","3","932","18","13.4"
"Ben Hill","2020-11-29","5","8903","0","932","18","11.6"
"Ben Hill","2020-11-30","15","8918","0","932","15.1","10.9"
"Ben Hill","2020-12-01","70","8988","12","944","15.5","11.9"
"Ben Hill","2020-12-02","51","9039","7","951","15.4","12.2"
"Ben Hill","2020-12-03","24","9063","3","954","13.7","12.9"
"Ben Hill","2020-12-04","51","9114","5","959","11.5","12.8"
"Ben Hill","2020-12-05","11","9125","5","964","14.1","16"
"Ben Hill","2020-12-06","7","9132","2","966","18.2","18.1"
"Ben Hill","2020-12-07","85","9217","15","981","20.7","17.9"
"Ben Hill","2020-12-08","32","9249","9","990","22.3","18.9"
"Ben Hill","2020-12-09","29","9278","8","998","24.2","19.8"
"Ben Hill","2020-12-10","84","9362","10","1008","24.2","18.9"
"Ben Hill","2020-12-11","66","9428","12","1020","25.4","18.4"
"Ben Hill","2020-12-12","23","9451","7","1027","23.2","18.6"
"Ben Hill","2020-12-13","3","9454","0","1027","19.1","18.6"
"Ben Hill","2020-12-14","87","9541","18","1045","19.6","20.1"
"Ben Hill","2020-12-15","25","9566","5","1050","18.4","20.3"
"Ben Hill","2020-12-16","92","9658","20","1070","17.6","20.9"
"Ben Hill","2020-12-17","39","9697","10","1080","19.5","21.8"
"Ben Hill","2020-12-18","24","9721","1","1081","17.5","21.4"
"Ben Hill","2020-12-19","17","9738","8","1089","19.9","21.6"
"Ben Hill","2020-12-20","9","9747","2","1091","23.1","21.1"
"Ben Hill","2020-12-21","17","9764","4","1095","23.5","21.5"
"Ben Hill","2020-12-22","75","9839","13","1108","23.1","20.7"
"Ben Hill","2020-12-23","84","9923","19","1127","23.2","20.4"
"Ben Hill","2020-12-24","24","9947","5","1132","22.5","21"
"Ben Hill","2020-12-25","2","9949","0","1132","21.9","19.7"
"Ben Hill","2020-12-26","8","9957","1","1133","17","18.5"
"Ben Hill","2020-12-27","3","9960","0","1133","13.8","18.5"
"Ben Hill","2020-12-28","59","10019","16","1149","14.3","18.9"
"Ben Hill","2020-12-29","25","10044","9","1158","17","20.1"
"Ben Hill","2020-12-30","59","10103","18","1176","18.1","20.7"
"Ben Hill","2020-12-31","56","10159","18","1194","19.8","21.1"
"Ben Hill","2021-01-01","4","10163","0","1194","19.8","20.8"
"Ben Hill","2021-01-02","12","10175","4","1198","22.7","19.9"
"Ben Hill","2021-01-03","22","10197","3","1201","24.7","19.3"
"Ben Hill","2021-01-04","39","10236","10","1211","24.5","19.4"
"Ben Hill","2021-01-05","51","10287","11","1222","22.4","19.7"
"Ben Hill","2021-01-06","62","10349","14","1236","21.3","19.7"
"Ben Hill","2021-01-07","45","10394","11","1247","20.2","20"
"Ben Hill","2021-01-08","41","10435","9","1256","23.3","21.5"
"Ben Hill","2021-01-09","9","10444","2","1258","21.7","22.2"
"Ben Hill","2021-01-10","6","10450","2","1260","24.5","24.6"
"Ben Hill","2021-01-11","40","10490","8","1268","23.7","24.1"
"Ben Hill","2021-01-12","53","10543","7","1275","22.5","22.5"
"Ben Hill","2021-01-13","57","10600","9","1284","21.6","21.4"
"Ben Hill","2021-01-14","45","10645","9","1293","20.9","20.6"
"Ben Hill","2021-01-15","34","10679","7","1300","20.7","22"
"Ben Hill","2021-01-16","31","10710","9","1309","21.7","21.7"
"Ben Hill","2021-01-17","8","10718","2","1311","20.5","22.5"
"Ben Hill","2021-01-18","23","10741","4","1315","20.1","21.9"
"Ben Hill","2021-01-19","28","10769","6","1321","21.3","21.9"
"Ben Hill","2021-01-20","29","10798","7","1328","22.5","22"
"Ben Hill","2021-01-21","32","10830","6","1334","22.3","21.6"
"Ben Hill","2021-01-22","34","10864","7","1341","22.3","21.5"
"Ben Hill","2021-01-23","17","10881","1","1342","19","20.4"
"Ben Hill","2021-01-24","3","10884","2","1344","25","22.7"
"Ben Hill","2021-01-25","4","10888","1","1345","26.1","23.1"
"Ben Hill","2021-01-26","0","10888","0","1345","23","22.2"
"Ben Hill","2021-01-27","0","10888","0","1345","19.6","21"
"Berrien","2020-02-01","0","0","0","0",".","."
"Berrien","2020-02-02","0","0","0","0",".","."
"Berrien","2020-02-03","0","0","0","0",".","."
"Berrien","2020-02-04","0","0","0","0",".","."
"Berrien","2020-02-05","0","0","0","0",".","."
"Berrien","2020-02-06","0","0","0","0",".","."
"Berrien","2020-02-07","0","0","0","0","0","."
"Berrien","2020-02-08","0","0","0","0","0","."
"Berrien","2020-02-09","0","0","0","0","0","."
"Berrien","2020-02-10","0","0","0","0","0","."
"Berrien","2020-02-11","0","0","0","0","0","."
"Berrien","2020-02-12","0","0","0","0","0","."
"Berrien","2020-02-13","0","0","0","0","0","."
"Berrien","2020-02-14","0","0","0","0","0","0"
"Berrien","2020-02-15","0","0","0","0","0","0"
"Berrien","2020-02-16","0","0","0","0","0","0"
"Berrien","2020-02-17","0","0","0","0","0","0"
"Berrien","2020-02-18","0","0","0","0","0","0"
"Berrien","2020-02-19","0","0","0","0","0","0"
"Berrien","2020-02-20","0","0","0","0","0","0"
"Berrien","2020-02-21","0","0","0","0","0","0"
"Berrien","2020-02-22","0","0","0","0","0","0"
"Berrien","2020-02-23","0","0","0","0","0","0"
"Berrien","2020-02-24","0","0","0","0","0","0"
"Berrien","2020-02-25","0","0","0","0","0","0"
"Berrien","2020-02-26","0","0","0","0","0","0"
"Berrien","2020-02-27","0","0","0","0","0","0"
"Berrien","2020-02-28","0","0","0","0","0","0"
"Berrien","2020-02-29","0","0","0","0","0","0"
"Berrien","2020-03-01","0","0","0","0","0","0"
"Berrien","2020-03-02","0","0","0","0","0","0"
"Berrien","2020-03-03","0","0","0","0","0","0"
"Berrien","2020-03-04","0","0","0","0","0","0"
"Berrien","2020-03-05","0","0","0","0","0","0"
"Berrien","2020-03-06","0","0","0","0","0","0"
"Berrien","2020-03-07","0","0","0","0","0","0"
"Berrien","2020-03-08","0","0","0","0","0","0"
"Berrien","2020-03-09","0","0","0","0","0","0"
"Berrien","2020-03-10","0","0","0","0","0","0"
"Berrien","2020-03-11","0","0","0","0","0","0"
"Berrien","2020-03-12","0","0","0","0","0","0"
"Berrien","2020-03-13","0","0","0","0","0","0"
"Berrien","2020-03-14","1","1","0","0","0","0"
"Berrien","2020-03-15","0","1","0","0","0","0"
"Berrien","2020-03-16","0","1","0","0","0","0"
"Berrien","2020-03-17","0","1","0","0","0","0"
"Berrien","2020-03-18","2","3","0","0","0","0"
"Berrien","2020-03-19","2","5","0","0","0","0"
"Berrien","2020-03-20","1","6","0","0","0","0"
"Berrien","2020-03-21","0","6","0","0","0","0"
"Berrien","2020-03-22","1","7","0","0","0","0"
"Berrien","2020-03-23","2","9","0","0","0","0"
"Berrien","2020-03-24","1","10","0","0","0","0"
"Berrien","2020-03-25","3","13","0","0","0","0"
"Berrien","2020-03-26","10","23","0","0","0","0"
"Berrien","2020-03-27","1","24","0","0","0","0"
"Berrien","2020-03-28","1","25","0","0","0","0"
"Berrien","2020-03-29","2","27","0","0","0","0"
"Berrien","2020-03-30","1","28","0","0","0","0"
"Berrien","2020-03-31","1","29","0","0","0","0"
"Berrien","2020-04-01","1","30","0","0","0","0"
"Berrien","2020-04-02","5","35","0","0","0","0"
"Berrien","2020-04-03","5","40","1","1","2.9","1.4"
"Berrien","2020-04-04","0","40","0","1","2.9","1.4"
"Berrien","2020-04-05","1","41","0","1","2.9","1.4"
"Berrien","2020-04-06","2","43","1","2","10","5"
"Berrien","2020-04-07","4","47","0","2","10","5"
"Berrien","2020-04-08","5","52","1","3","12.9","6.4"
"Berrien","2020-04-09","2","54","0","3","12.9","6.4"
"Berrien","2020-04-10","4","58","0","3","10","6.4"
"Berrien","2020-04-11","2","60","0","3","10","6.4"
"Berrien","2020-04-12","1","61","1","4","24.3","13.6"
"Berrien","2020-04-13","2","63","0","4","17.1","13.6"
"Berrien","2020-04-14","7","70","1","5","19.2","14.6"
"Berrien","2020-04-15","4","74","0","5","16.3","14.6"
"Berrien","2020-04-16","6","80","0","5","16.3","14.6"
"Berrien","2020-04-17","4","84","0","5","16.3","13.2"
"Berrien","2020-04-18","2","86","1","6","23.5","16.7"
"Berrien","2020-04-19","0","86","0","6","9.2","16.7"
"Berrien","2020-04-20","6","92","1","7","11.6","14.4"
"Berrien","2020-04-21","8","100","1","8","11.3","15.2"
"Berrien","2020-04-22","2","102","0","8","11.3","13.8"
"Berrien","2020-04-23","3","105","1","9","16.1","16.2"
"Berrien","2020-04-24","6","111","0","9","16.1","16.2"
"Berrien","2020-04-25","2","113","0","9","8.9","16.2"
"Berrien","2020-04-26","1","114","1","10","23.2","16.2"
"Berrien","2020-04-27","6","120","2","12","25.6","18.6"
"Berrien","2020-04-28","5","125","0","12","23.8","17.6"
"Berrien","2020-04-29","50","175","1","13","24.1","17.7"
"Berrien","2020-04-30","6","181","0","13","19.3","17.7"
"Berrien","2020-05-01","14","195","1","14","20.4","18.2"
"Berrien","2020-05-02","1","196","0","14","20.4","14.6"
"Berrien","2020-05-03","0","196","0","14","6.1","14.6"
"Berrien","2020-05-04","12","208","0","14","1.3","13.5"
"Berrien","2020-05-05","7","215","0","14","1.3","12.6"
"Berrien","2020-05-06","15","230","0","14","1","12.6"
"Berrien","2020-05-07","18","248","1","15","1.8","10.6"
"Berrien","2020-05-08","6","254","0","15","0.8","10.6"
"Berrien","2020-05-09","1","255","0","15","0.8","10.6"
"Berrien","2020-05-10","1","256","0","15","0.8","3.4"
"Berrien","2020-05-11","41","297","1","16","1.1","1.2"
"Berrien","2020-05-12","8","305","0","16","1.1","1.2"
"Berrien","2020-05-13","32","337","0","16","1.1","1.1"
"Berrien","2020-05-14","21","358","3","19","2.4","2.1"
"Berrien","2020-05-15","4","362","0","19","2.4","1.6"
"Berrien","2020-05-16","4","366","0","19","2.4","1.6"
"Berrien","2020-05-17","3","369","1","20","7.2","4"
"Berrien","2020-05-18","11","380","5","25","13.3","7.2"
"Berrien","2020-05-19","6","386","2","27","18.1","9.6"
"Berrien","2020-05-20","24","410","1","28","18.7","9.9"
"Berrien","2020-05-21","19","429","2","30","18.1","10.3"
"Berrien","2020-05-22","9","438","1","31","19.7","11"
"Berrien","2020-05-23","3","441","1","32","24.5","13.4"
"Berrien","2020-05-24","1","442","1","33","34","20.6"
"Berrien","2020-05-25","1","443","1","34","41.8","27.5"
"Berrien","2020-05-26","14","457","3","37","40.1","29.1"
"Berrien","2020-05-27","15","472","2","39","41.4","30"
"Berrien","2020-05-28","10","482","2","41","42.7","30.4"
"Berrien","2020-05-29","4","486","0","41","41.2","30.4"
"Berrien","2020-05-30","0","486","0","41","36.4","30.4"
"Berrien","2020-05-31","2","488","1","42","29.3","31.6"
"Berrien","2020-06-01","8","496","2","44","18.5","30.2"
"Berrien","2020-06-02","9","505","1","45","17.1","28.6"
"Berrien","2020-06-03","21","526","3","48","17.2","29.3"
"Berrien","2020-06-04","37","563","1","49","14.7","28.7"
"Berrien","2020-06-05","18","581","1","50","15.5","28.3"
"Berrien","2020-06-06","8","589","1","51","17.3","26.9"
"Berrien","2020-06-07","1","590","0","51","10.2","19.7"
"Berrien","2020-06-08","16","606","2","53","8.4","13.5"
"Berrien","2020-06-09","14","620","0","53","6.8","11.9"
"Berrien","2020-06-10","33","653","5","58","6.9","12.1"
"Berrien","2020-06-11","36","689","6","64","8.9","11.8"
"Berrien","2020-06-12","32","721","1","65","8.6","12"
"Berrien","2020-06-13","2","723","1","66","13.9","15.6"
"Berrien","2020-06-14","1","724","0","66","13.9","12"
"Berrien","2020-06-15","18","742","2","68","13.7","11.1"
"Berrien","2020-06-16","27","769","1","69","14.3","10.5"
"Berrien","2020-06-17","71","840","5","74","13.1","10"
"Berrien","2020-06-18","76","916","2","76","11.1","10"
"Berrien","2020-06-19","190","1106","2","78","10.8","9.7"
"Berrien","2020-06-20","5","1111","0","78","3.6","8.8"
"Berrien","2020-06-21","3","1114","1","79","8.4","11.2"
"Berrien","2020-06-22","44","1158","7","86","9.1","11.4"
"Berrien","2020-06-23","28","1186","3","89","10.1","12.2"
"Berrien","2020-06-24","73","1259","6","95","10.3","11.7"
"Berrien","2020-06-25","76","1335","3","98","10.5","10.8"
"Berrien","2020-06-26","43","1378","1","99","10.6","10.7"
"Berrien","2020-06-27","6","1384","1","100","13","8.3"
"Berrien","2020-06-28","8","1392","2","102","11.8","10.1"
"Berrien","2020-06-29","38","1430","7","109","12.2","10.6"
"Berrien","2020-06-30","47","1477","15","124","15.2","12.7"
"Berrien","2020-07-01","55","1532","4","128","15.1","12.7"
"Berrien","2020-07-02","75","1607","2","130","14.9","12.7"
"Berrien","2020-07-03","9","1616","1","131","16.2","13.4"
"Berrien","2020-07-04","1","1617","0","131","13.8","13.4"
"Berrien","2020-07-05","2","1619","0","131","10.2","11"
"Berrien","2020-07-06","33","1652","8","139","11","11.6"
"Berrien","2020-07-07","18","1670","8","147","12.8","14"
"Berrien","2020-07-08","45","1715","4","151","13.1","14.1"
"Berrien","2020-07-09","46","1761","2","153","13.3","14.1"
"Berrien","2020-07-10","16","1777","2","155","13.5","14.8"
"Berrien","2020-07-11","11","1788","3","158","17.4","15.6"
"Berrien","2020-07-12","7","1795","4","162","25.5","17.9"
"Berrien","2020-07-13","31","1826","4","166","23.9","17.5"
"Berrien","2020-07-14","17","1843","0","166","17.6","15.2"
"Berrien","2020-07-15","57","1900","4","170","17.3","15.2"
"Berrien","2020-07-16","84","1984","6","176","17.7","15.5"
"Berrien","2020-07-17","32","2016","1","177","16.4","14.9"
"Berrien","2020-07-18","8","2024","1","178","14.3","15.8"
"Berrien","2020-07-19","8","2032","1","179","7.9","16.7"
"Berrien","2020-07-20","35","2067","7","186","8.9","16.4"
"Berrien","2020-07-21","32","2099","8","194","12.5","15"
"Berrien","2020-07-22","90","2189","11","205","13.2","15.3"
"Berrien","2020-07-23","75","2264","3","208","12.8","15.2"
"Berrien","2020-07-24","29","2293","6","214","15.3","15.8"
"Berrien","2020-07-25","9","2302","1","215","15.1","14.7"
"Berrien","2020-07-26","2","2304","0","215","13.3","10.6"
"Berrien","2020-07-27","44","2348","16","231","15.6","12.3"
"Berrien","2020-07-28","21","2369","3","234","14.1","13.3"
"Berrien","2020-07-29","73","2442","5","239","13.3","13.3"
"Berrien","2020-07-30","68","2510","12","251","15.3","14"
"Berrien","2020-07-31","22","2532","2","253","13.6","14.4"
"Berrien","2020-08-01","6","2538","0","253","12","13.6"
"Berrien","2020-08-02","5","2543","4","257","23.5","18.4"
"Berrien","2020-08-03","32","2575","3","260","19.6","17.6"
"Berrien","2020-08-04","38","2613","4","264","19.1","16.6"
"Berrien","2020-08-05","75","2688","13","277","20.6","16.9"
"Berrien","2020-08-06","55","2743","5","282","19.3","17.3"
"Berrien","2020-08-07","30","2773","12","294","23.8","18.7"
"Berrien","2020-08-08","11","2784","4","298","29","20.5"
"Berrien","2020-08-09","12","2796","1","299","18.7","21.1"
"Berrien","2020-08-10","51","2847","13","312","21","20.3"
"Berrien","2020-08-11","29","2876","8","320","23.5","21.3"
"Berrien","2020-08-12","78","2954","9","329","22.6","21.6"
"Berrien","2020-08-13","54","3008","6","335","22.9","21.1"
"Berrien","2020-08-14","33","3041","6","341","19.8","21.8"
"Berrien","2020-08-15","8","3049","1","342","16.4","22.7"
"Berrien","2020-08-16","9","3058","0","342","15.2","17"
"Berrien","2020-08-17","36","3094","3","345","12.8","16.9"
"Berrien","2020-08-18","39","3133","3","348","9.9","16.7"
"Berrien","2020-08-19","69","3202","17","365","11.8","17.2"
"Berrien","2020-08-20","49","3251","6","371","11.9","17.4"
"Berrien","2020-08-21","38","3289","9","380","12.7","16.3"
"Berrien","2020-08-22","4","3293","1","381","14.5","15.5"
"Berrien","2020-08-23","5","3298","1","382","17.4","16.3"
"Berrien","2020-08-24","48","3346","6","388","18","15.4"
"Berrien","2020-08-25","53","3399","8","396","19","14.5"
"Berrien","2020-08-26","72","3471","3","399","16.1","13.9"
"Berrien","2020-08-27","63","3534","3","402","15","13.5"
"Berrien","2020-08-28","22","3556","0","402","11.6","12.2"
"Berrien","2020-08-29","7","3563","2","404","12.2","13.3"
"Berrien","2020-08-30","8","3571","3","407","14.7","16"
"Berrien","2020-08-31","42","3613","2","409","13.6","15.8"
"Berrien","2020-09-01","36","3649","9","418","15","17"
"Berrien","2020-09-02","63","3712","3","421","15.1","15.6"
"Berrien","2020-09-03","69","3781","7","428","15.8","15.4"
"Berrien","2020-09-04","29","3810","1","429","16.3","14"
"Berrien","2020-09-05","5","3815","1","430","15.1","13.6"
"Berrien","2020-09-06","5","3820","2","432","15.4","15.1"
"Berrien","2020-09-07","5","3825","1","433","17.6","15.6"
"Berrien","2020-09-08","44","3869","2","435","14.7","14.8"
"Berrien","2020-09-09","56","3925","2","437","14.5","14.8"
"Berrien","2020-09-10","60","3985","3","440","13.8","14.8"
"Berrien","2020-09-11","25","4010","3","443","15","15.7"
"Berrien","2020-09-12","3","4013","0","443","12.2","13.6"
"Berrien","2020-09-13","10","4023","3","446","10.7","13.1"
"Berrien","2020-09-14","38","4061","4","450","9.4","13.5"
"Berrien","2020-09-15","27","4088","1","451","9.3","12"
"Berrien","2020-09-16","57","4145","5","456","10","12.3"
"Berrien","2020-09-17","43","4188","8","464","11.9","12.9"
"Berrien","2020-09-18","17","4205","2","466","11.9","13.5"
"Berrien","2020-09-19","6","4211","0","466","11.9","12"
"Berrien","2020-09-20","5","4216","1","467","10.5","10.6"
"Berrien","2020-09-21","29","4245","3","470","10.5","9.9"
"Berrien","2020-09-22","13","4258","2","472","12.1","10.7"
"Berrien","2020-09-23","43","4301","1","473","11.2","10.6"
"Berrien","2020-09-24","32","4333","1","474","9","10.5"
"Berrien","2020-09-25","15","4348","2","476","9.2","10.6"
"Berrien","2020-09-26","5","4353","1","477","12.1","12"
"Berrien","2020-09-27","5","4358","2","479","14.9","12.7"
"Berrien","2020-09-28","28","4386","4","483","15.5","13"
"Berrien","2020-09-29","13","4399","0","483","13.3","12.7"
"Berrien","2020-09-30","32","4431","3","486","14.3","12.8"
"Berrien","2020-10-01","29","4460","0","486","13.9","11.4"
"Berrien","2020-10-02","19","4479","1","487","12.7","11"
"Berrien","2020-10-03","3","4482","0","487","9.8","11"
"Berrien","2020-10-04","8","4490","1","488","5.9","10.4"
"Berrien","2020-10-05","20","4510","0","488","3.9","9.7"
"Berrien","2020-10-06","16","4526","1","489","4.8","9"
"Berrien","2020-10-07","36","4562","0","489","3.4","8.9"
"Berrien","2020-10-08","36","4598","2","491","4.2","9"
"Berrien","2020-10-09","27","4625","3","494","5.1","8.9"
"Berrien","2020-10-10","6","4631","0","494","5.1","7.5"
"Berrien","2020-10-11","5","4636","1","495","6.1","6"
"Berrien","2020-10-12","25","4661","2","497","7.3","5.6"
"Berrien","2020-10-13","29","4690","2","499","7.4","6.1"
"Berrien","2020-10-14","42","4732","5","504","9.1","6.2"
"Berrien","2020-10-15","30","4762","1","505","8.7","6.5"
"Berrien","2020-10-16","24","4786","1","506","7.8","6.4"
"Berrien","2020-10-17","5","4791","1","507","10.6","7.8"
"Berrien","2020-10-18","1","4792","0","507","7.8","6.9"
"Berrien","2020-10-19","30","4822","1","508","7.1","7.2"
"Berrien","2020-10-20","23","4845","2","510","7.3","7.4"
"Berrien","2020-10-21","36","4881","3","513","6.8","8"
"Berrien","2020-10-22","27","4908","4","517","8.5","8.6"
"Berrien","2020-10-23","17","4925","2","519","9.6","8.7"
"Berrien","2020-10-24","4","4929","0","519","6.7","8.7"
"Berrien","2020-10-25","4","4933","0","519","6.7","7.2"
"Berrien","2020-10-26","27","4960","1","520","6.8","6.9"
"Berrien","2020-10-27","17","4977","0","520","5.5","6.4"
"Berrien","2020-10-28","67","5044","8","528","6","6.4"
"Berrien","2020-10-29","40","5084","2","530","4.6","6.6"
"Berrien","2020-10-30","22","5106","0","530","2.9","6.3"
"Berrien","2020-10-31","11","5117","2","532","5.5","6.1"
"Berrien","2020-11-01","5","5122","0","532","5.5","6.1"
"Berrien","2020-11-02","23","5145","0","532","5","5.9"
"Berrien","2020-11-03","18","5163","0","532","5","5.3"
"Berrien","2020-11-04","33","5196","3","535","4.6","5.3"
"Berrien","2020-11-05","20","5216","1","536","4.6","4.6"
"Berrien","2020-11-06","19","5235","2","538","6.1","4.5"
"Berrien","2020-11-07","5","5240","0","538","3.5","4.5"
"Berrien","2020-11-08","5","5245","1","539","6.4","6"
"Berrien","2020-11-09","22","5267","1","540","7","6"
"Berrien","2020-11-10","26","5293","2","542","8.1","6.6"
"Berrien","2020-11-11","11","5304","2","544","9.4","7"
"Berrien","2020-11-12","33","5337","2","546","9.6","7.1"
"Berrien","2020-11-13","12","5349","0","546","8.1","7.1"
"Berrien","2020-11-14","11","5360","2","548","10.7","7.1"
"Berrien","2020-11-15","7","5367","2","550","11.9","9.1"
"Berrien","2020-11-16","28","5395","0","550","11.2","9.1"
"Berrien","2020-11-17","28","5423","7","557","13.7","10.9"
"Berrien","2020-11-18","71","5494","10","567","13.1","11.3"
"Berrien","2020-11-19","96","5590","10","577","13.8","11.7"
"Berrien","2020-11-20","37","5627","8","585","16.8","12.5"
"Berrien","2020-11-21","12","5639","1","586","15.4","13"
"Berrien","2020-11-22","7","5646","3","589","17.5","14.7"
"Berrien","2020-11-23","37","5683","7","596","20.2","15.7"
"Berrien","2020-11-24","24","5707","3","599","18.4","16.1"
"Berrien","2020-11-25","72","5779","11","610","18.6","15.8"
"Berrien","2020-11-26","7","5786","0","610","17.1","15.4"
"Berrien","2020-11-27","13","5799","3","613","17.3","17.1"
"Berrien","2020-11-28","17","5816","4","617","19.5","17.4"
"Berrien","2020-11-29","7","5823","1","618","15.4","16.4"
"Berrien","2020-11-30","35","5858","9","627","16.3","18.3"
"Berrien","2020-12-01","33","5891","5","632","16.7","17.6"
"Berrien","2020-12-02","22","5913","2","634","15.8","17.2"
"Berrien","2020-12-03","75","5988","15","649","18.7","17.9"
"Berrien","2020-12-04","23","6011","6","655","19.1","18.2"
"Berrien","2020-12-05","12","6023","2","657","18.1","18.8"
"Berrien","2020-12-06","12","6035","1","658","17.3","16.3"
"Berrien","2020-12-07","38","6073","5","663","15.5","15.9"
"Berrien","2020-12-08","44","6117","5","668","15","15.8"
"Berrien","2020-12-09","28","6145","2","670","14.7","15.3"
"Berrien","2020-12-10","84","6229","11","681","13.7","16.2"
"Berrien","2020-12-11","33","6262","4","685","11.7","15.4"
"Berrien","2020-12-12","4","6266","1","686","12.9","15.5"
"Berrien","2020-12-13","12","6278","1","687","12.9","15.1"
"Berrien","2020-12-14","51","6329","9","696","13.5","14.5"
"Berrien","2020-12-15","33","6362","8","704","15.4","15.2"
"Berrien","2020-12-16","36","6398","9","713","17.9","16.3"
"Berrien","2020-12-17","103","6501","20","733","18.8","16.3"
"Berrien","2020-12-18","33","6534","2","735","18","14.8"
"Berrien","2020-12-19","4","6538","1","736","18","15.4"
"Berrien","2020-12-20","14","6552","3","739","19.8","16.4"
"Berrien","2020-12-21","32","6584","9","748","21.3","17.4"
"Berrien","2020-12-22","22","6606","4","752","20.5","17.9"
"Berrien","2020-12-23","32","6638","3","755","18.2","18.1"
"Berrien","2020-12-24","5","6643","2","757","21.2","20"
"Berrien","2020-12-25","9","6652","6","763","29.8","23.9"
"Berrien","2020-12-26","7","6659","2","765","30.3","24.1"
"Berrien","2020-12-27","13","6672","4","769","31.7","25.7"
"Berrien","2020-12-28","36","6708","12","781","32.4","26.9"
"Berrien","2020-12-29","33","6741","12","793","35","27.7"
"Berrien","2020-12-30","35","6776","6","799","36.1","27.2"
"Berrien","2020-12-31","89","6865","13","812","32.5","26.8"
"Berrien","2021-01-01","5","6870","0","812","23","26.4"
"Berrien","2021-01-02","2","6872","0","812","18.9","24.6"
"Berrien","2021-01-03","11","6883","3","815","18.4","25"
"Berrien","2021-01-04","34","6917","11","826","18.2","25.3"
"Berrien","2021-01-05","34","6951","9","835","16.8","25.9"
"Berrien","2021-01-06","51","7002","15","850","18.6","27.4"
"Berrien","2021-01-07","49","7051","18","868","21.7","27.1"
"Berrien","2021-01-08","42","7093","6","874","23.8","23.4"
"Berrien","2021-01-09","12","7105","1","875","25","21.9"
"Berrien","2021-01-10","17","7122","5","880","25.3","21.8"
"Berrien","2021-01-11","45","7167","9","889","23.5","20.9"
"Berrien","2021-01-12","38","7205","4","893","21.2","19"
"Berrien","2021-01-13","30","7235","4","897","18.9","18.8"
"Berrien","2021-01-14","30","7265","3","900","15.1","18.4"
"Berrien","2021-01-15","40","7305","4","904","14.5","19.2"
"Berrien","2021-01-16","10","7315","2","906","16.2","20.6"
"Berrien","2021-01-17","15","7330","2","908","13.9","19.6"
"Berrien","2021-01-18","29","7359","3","911","12.5","18"
"Berrien","2021-01-19","37","7396","1","912","11.4","16.3"
"Berrien","2021-01-20","32","7428","6","918","12.2","15.6"
"Berrien","2021-01-21","32","7460","7","925","13.9","14.5"
"Berrien","2021-01-22","25","7485","2","927","13.6","14"
"Berrien","2021-01-23","6","7491","1","928","13.1","14.6"
"Berrien","2021-01-24","7","7498","2","930","15.3","14.6"
"Berrien","2021-01-25","13","7511","2","932","16","14.2"
"Berrien","2021-01-26","1","7512","0","932","15.6","13.5"
"Berrien","2021-01-27","0","7512","0","932","12.9","12.5"
"Bibb","2020-02-01","0","0","0","0",".","."
"Bibb","2020-02-02","0","0","0","0",".","."
"Bibb","2020-02-03","1","1","1","1",".","."
"Bibb","2020-02-04","0","1","0","1",".","."
"Bibb","2020-02-05","1","2","0","1",".","."
"Bibb","2020-02-06","1","3","0","1",".","."
"Bibb","2020-02-07","0","3","0","1","14.3","."
"Bibb","2020-02-08","0","3","0","1","14.3","."
"Bibb","2020-02-09","0","3","0","1","14.3","."
"Bibb","2020-02-10","0","3","0","1","0","."
"Bibb","2020-02-11","0","3","0","1","0","."
"Bibb","2020-02-12","0","3","0","1","0","."
"Bibb","2020-02-13","0","3","0","1","0","."
"Bibb","2020-02-14","0","3","0","1","0","7.1"
"Bibb","2020-02-15","0","3","0","1","0","7.1"
"Bibb","2020-02-16","0","3","0","1","0","7.1"
"Bibb","2020-02-17","0","3","0","1","0","0"
"Bibb","2020-02-18","0","3","0","1","0","0"
"Bibb","2020-02-19","0","3","0","1","0","0"
"Bibb","2020-02-20","0","3","0","1","0","0"
"Bibb","2020-02-21","0","3","0","1","0","0"
"Bibb","2020-02-22","0","3","0","1","0","0"
"Bibb","2020-02-23","0","3","0","1","0","0"
"Bibb","2020-02-24","0","3","0","1","0","0"
"Bibb","2020-02-25","0","3","0","1","0","0"
"Bibb","2020-02-26","0","3","0","1","0","0"
"Bibb","2020-02-27","0","3","0","1","0","0"
"Bibb","2020-02-28","0","3","0","1","0","0"
"Bibb","2020-02-29","0","3","0","1","0","0"
"Bibb","2020-03-01","0","3","0","1","0","0"
"Bibb","2020-03-02","0","3","0","1","0","0"
"Bibb","2020-03-03","0","3","0","1","0","0"
"Bibb","2020-03-04","0","3","0","1","0","0"
"Bibb","2020-03-05","3","6","0","1","0","0"
"Bibb","2020-03-06","0","6","0","1","0","0"
"Bibb","2020-03-07","0","6","0","1","0","0"
"Bibb","2020-03-08","0","6","0","1","0","0"
"Bibb","2020-03-09","0","6","0","1","0","0"
"Bibb","2020-03-10","0","6","0","1","0","0"
"Bibb","2020-03-11","3","9","0","1","0","0"
"Bibb","2020-03-12","14","23","0","1","0","0"
"Bibb","2020-03-13","4","27","0","1","0","0"
"Bibb","2020-03-14","7","34","0","1","0","0"
"Bibb","2020-03-15","3","37","1","2","4.8","2.4"
"Bibb","2020-03-16","16","53","1","3","5.7","2.8"
"Bibb","2020-03-17","16","69","0","3","5.7","2.8"
"Bibb","2020-03-18","28","97","0","3","5.7","2.8"
"Bibb","2020-03-19","33","130","2","5","6.5","3.3"
"Bibb","2020-03-20","60","190","2","7","7","3.5"
"Bibb","2020-03-21","14","204","1","8","8","4"
"Bibb","2020-03-22","19","223","3","11","5.5","5.1"
"Bibb","2020-03-23","48","271","10","21","7.6","6.6"
"Bibb","2020-03-24","65","336","9","30","9.6","7.6"
"Bibb","2020-03-25","73","409","7","37","10.9","8.3"
"Bibb","2020-03-26","55","464","6","43","11.6","9.1"
"Bibb","2020-03-27","60","524","6","49","12.6","9.8"
"Bibb","2020-03-28","13","537","1","50","12.7","10.3"
"Bibb","2020-03-29","17","554","5","55","14.6","10.1"
"Bibb","2020-03-30","62","616","7","62","13.2","10.4"
"Bibb","2020-03-31","43","659","0","62","11.3","10.4"
"Bibb","2020-04-01","102","761","12","74","11.6","11.3"
"Bibb","2020-04-02","124","885","12","86","11.4","11.5"
"Bibb","2020-04-03","119","1004","14","100","11.7","12.1"
"Bibb","2020-04-04","30","1034","4","104","12.5","12.6"
"Bibb","2020-04-05","24","1058","2","106","9.5","12"
"Bibb","2020-04-06","116","1174","15","121","9.7","11.5"
"Bibb","2020-04-07","93","1267","15","136","12","11.6"
"Bibb","2020-04-08","105","1372","22","158","13.3","12.4"
"Bibb","2020-04-09","64","1436","8","166","13.7","12.6"
"Bibb","2020-04-10","86","1522","19","185","15.2","13.4"
"Bibb","2020-04-11","33","1555","6","191","15.9","14.2"
"Bibb","2020-04-12","22","1577","10","201","21.2","15.3"
"Bibb","2020-04-13","111","1688","15","216","21.3","15.5"
"Bibb","2020-04-14","123","1811","18","234","21","16.5"
"Bibb","2020-04-15","84","1895","22","256","21.8","17.5"
"Bibb","2020-04-16","102","1997","4","260","20.6","17.1"
"Bibb","2020-04-17","75","2072","8","268","18.9","17.1"
"Bibb","2020-04-18","45","2117","4","272","17.6","16.7"
"Bibb","2020-04-19","32","2149","12","284","16.5","18.8"
"Bibb","2020-04-20","117","2266","21","305","17.1","19.2"
"Bibb","2020-04-21","115","2381","10","315","16.3","18.7"
"Bibb","2020-04-22","93","2474","2","317","12.8","17.3"
"Bibb","2020-04-23","47","2521","10","327","15.3","17.9"
"Bibb","2020-04-24","136","2657","16","343","15.5","17.2"
"Bibb","2020-04-25","65","2722","8","351","15.9","16.8"
"Bibb","2020-04-26","30","2752","2","353","11.5","14"
"Bibb","2020-04-27","161","2913","47","400","13.2","15.1"
"Bibb","2020-04-28","138","3051","37","437","15.7","16"
"Bibb","2020-04-29","133","3184","7","444","16.2","14.5"
"Bibb","2020-04-30","75","3259","9","453","14.9","15.1"
"Bibb","2020-05-01","99","3358","7","460","14.2","14.8"
"Bibb","2020-05-02","50","3408","6","466","14.1","15"
"Bibb","2020-05-03","54","3462","1","467","13.5","12.5"
"Bibb","2020-05-04","158","3620","32","499","12.2","12.7"
"Bibb","2020-05-05","109","3729","6","505","9.1","12.4"
"Bibb","2020-05-06","152","3881","7","512","9","12.6"
"Bibb","2020-05-07","161","4042","6","518","7.9","11.4"
"Bibb","2020-05-08","166","4208","7","525","7.5","10.8"
"Bibb","2020-05-09","70","4278","5","530","6.8","10.5"
"Bibb","2020-05-10","45","4323","6","536","8.4","10.9"
"Bibb","2020-05-11","128","4451","4","540","6","9.1"
"Bibb","2020-05-12","140","4591","6","546","5.8","7.5"
"Bibb","2020-05-13","142","4733","11","557","6.2","7.6"
"Bibb","2020-05-14","219","4952","16","573","6.7","7.3"
"Bibb","2020-05-15","145","5097","8","581","6.9","7.2"
"Bibb","2020-05-16","81","5178","4","585","6.6","6.7"
"Bibb","2020-05-17","41","5219","2","587","5.4","6.9"
"Bibb","2020-05-18","122","5341","9","596","6","6"
"Bibb","2020-05-19","189","5530","7","603","5.9","5.9"
"Bibb","2020-05-20","225","5755","11","614","5.5","5.9"
"Bibb","2020-05-21","113","5868","8","622","5.5","6.1"
"Bibb","2020-05-22","194","6062","6","628","5.1","6"
"Bibb","2020-05-23","61","6123","3","631","5.1","5.9"
"Bibb","2020-05-24","41","6164","4","635","5.8","5.6"
"Bibb","2020-05-25","35","6199","3","638","6","6"
"Bibb","2020-05-26","145","6344","8","646","6.3","6.1"
"Bibb","2020-05-27","104","6448","10","656","6.9","6.2"
"Bibb","2020-05-28","172","6620","12","668","6.9","6.2"
"Bibb","2020-05-29","106","6726","6","674","7.3","6.2"
"Bibb","2020-05-30","86","6812","6","680","7.6","6.4"
"Bibb","2020-05-31","55","6867","5","685","7.5","6.7"
"Bibb","2020-06-01","189","7056","15","700","7.4","6.7"
"Bibb","2020-06-02","191","7247","14","714","7.7","7"
"Bibb","2020-06-03","210","7457","13","727","7.2","7.1"
"Bibb","2020-06-04","197","7654","8","735","6.7","6.8"
"Bibb","2020-06-05","193","7847","11","746","6.8","7"
"Bibb","2020-06-06","60","7907","7","753","7.4","7.5"
"Bibb","2020-06-07","37","7944","7","760","8.8","8.2"
"Bibb","2020-06-08","216","8160","13","773","8.6","8"
"Bibb","2020-06-09","194","8354","4","777","7.8","7.7"
"Bibb","2020-06-10","170","8524","11","788","7.8","7.5"
"Bibb","2020-06-11","218","8742","9","797","7.9","7.3"
"Bibb","2020-06-12","160","8902","8","805","7.8","7.3"
"Bibb","2020-06-13","71","8973","6","811","7.3","7.4"
"Bibb","2020-06-14","39","9012","6","817","6.8","7.8"
"Bibb","2020-06-15","230","9242","23","840","7.4","8"
"Bibb","2020-06-16","184","9426","14","854","8.1","8"
"Bibb","2020-06-17","240","9666","22","876","8.5","8.2"
"Bibb","2020-06-18","242","9908","19","895","9.1","8.5"
"Bibb","2020-06-19","338","10246","19","914","9.2","8.5"
"Bibb","2020-06-20","144","10390","23","937","10.2","8.8"
"Bibb","2020-06-21","144","10534","13","950","9.3","8.1"
"Bibb","2020-06-22","364","10898","53","1003","10","8.7"
"Bibb","2020-06-23","285","11183","49","1052","11.3","9.7"
"Bibb","2020-06-24","326","11509","58","1110","12.6","10.6"
"Bibb","2020-06-25","465","11974","90","1200","14.2","11.6"
"Bibb","2020-06-26","416","12390","73","1273","15.9","12.5"
"Bibb","2020-06-27","307","12697","78","1351","17.3","13.7"
"Bibb","2020-06-28","161","12858","60","1411","21.3","15.3"
"Bibb","2020-06-29","495","13353","130","1541","23","16.5"
"Bibb","2020-06-30","550","13903","112","1653","23.4","17.4"
"Bibb","2020-07-01","690","14593","123","1776","23.4","18"
"Bibb","2020-07-02","647","15240","112","1888","23.1","18.7"
"Bibb","2020-07-03","287","15527","90","1978","25.1","20.5"
"Bibb","2020-07-04","133","15660","57","2035","27.6","22.4"
"Bibb","2020-07-05","179","15839","71","2106","27.9","24.6"
"Bibb","2020-07-06","525","16364","137","2243","27.9","25.5"
"Bibb","2020-07-07","678","17042","168","2411","28.6","26"
"Bibb","2020-07-08","624","17666","155","2566","29.6","26.5"
"Bibb","2020-07-09","721","18387","171","2737","30.5","26.8"
"Bibb","2020-07-10","705","19092","144","2881","28.9","27"
"Bibb","2020-07-11","345","19437","69","2950","25.6","26.6"
"Bibb","2020-07-12","196","19633","66","3016","24.8","26.4"
"Bibb","2020-07-13","604","20237","146","3162","24.5","26.2"
"Bibb","2020-07-14","555","20792","124","3286","24.2","26.4"
"Bibb","2020-07-15","620","21412","131","3417","23.6","26.6"
"Bibb","2020-07-16","580","21992","127","3544","23.4","26.9"
"Bibb","2020-07-17","646","22638","149","3693","23.8","26.3"
"Bibb","2020-07-18","277","22915","83","3776","25.2","25.4"
"Bibb","2020-07-19","255","23170","81","3857","24.9","24.8"
"Bibb","2020-07-20","618","23788","132","3989","24.5","24.5"
"Bibb","2020-07-21","540","24328","112","4101","24.3","24.2"
"Bibb","2020-07-22","558","24886","113","4214","24.1","23.9"
"Bibb","2020-07-23","576","25462","112","4326","23.8","23.6"
"Bibb","2020-07-24","663","26125","136","4462","23.4","23.6"
"Bibb","2020-07-25","234","26359","47","4509","22","23.6"
"Bibb","2020-07-26","151","26510","62","4571","23.4","24.1"
"Bibb","2020-07-27","686","27196","132","4703","23","23.8"
"Bibb","2020-07-28","585","27781","132","4835","23.3","23.8"
"Bibb","2020-07-29","498","28279","97","4932","23.2","23.7"
"Bibb","2020-07-30","706","28985","109","5041","22.6","23.2"
"Bibb","2020-07-31","502","29487","101","5142","22.6","23"
"Bibb","2020-08-01","289","29776","78","5220","23.6","22.8"
"Bibb","2020-08-02","173","29949","40","5260","21","22.2"
"Bibb","2020-08-03","574","30523","93","5353","20.6","21.8"
"Bibb","2020-08-04","442","30965","78","5431","19.9","21.6"
"Bibb","2020-08-05","485","31450","98","5529","20","21.6"
"Bibb","2020-08-06","474","31924","98","5627","20.7","21.7"
"Bibb","2020-08-07","574","32498","94","5721","20.2","21.4"
"Bibb","2020-08-08","250","32748","45","5766","18.9","21.2"
"Bibb","2020-08-09","147","32895","35","5801","19","20"
"Bibb","2020-08-10","401","33296","84","5885","19.7","20.1"
"Bibb","2020-08-11","380","33676","59","5944","19.4","19.6"
"Bibb","2020-08-12","405","34081","67","6011","18.8","19.4"
"Bibb","2020-08-13","444","34525","76","6087","18.3","19.5"
"Bibb","2020-08-14","401","34926","70","6157","18.5","19.3"
"Bibb","2020-08-15","233","35159","76","6233","20.6","19.7"
"Bibb","2020-08-16","321","35480","54","6287","19.6","19.3"
"Bibb","2020-08-17","303","35783","41","6328","18.5","19.1"
"Bibb","2020-08-18","404","36187","65","6393","18.6","19"
"Bibb","2020-08-19","367","36554","57","6450","18.5","18.6"
"Bibb","2020-08-20","293","36847","31","6481","17.5","17.9"
"Bibb","2020-08-21","535","37382","51","6532","16.4","17.4"
"Bibb","2020-08-22","201","37583","21","6553","13.2","16.9"
"Bibb","2020-08-23","181","37764","20","6573","12.4","16"
"Bibb","2020-08-24","353","38117","44","6617","12.2","15.4"
"Bibb","2020-08-25","369","38486","39","6656","11.5","15"
"Bibb","2020-08-26","410","38896","38","6694","10.6","14.5"
"Bibb","2020-08-27","297","39193","33","6727","10.6","14.1"
"Bibb","2020-08-28","337","39530","36","6763","10.8","13.6"
"Bibb","2020-08-29","125","39655","16","6779","11.1","12.2"
"Bibb","2020-08-30","130","39785","24","6803","12.2","12.3"
"Bibb","2020-08-31","396","40181","38","6841","11.8","12"
"Bibb","2020-09-01","298","40479","35","6876","12","11.7"
"Bibb","2020-09-02","322","40801","28","6904","11.9","11.2"
"Bibb","2020-09-03","280","41081","30","6934","11.8","11.2"
"Bibb","2020-09-04","273","41354","18","6952","11.2","11"
"Bibb","2020-09-05","162","41516","14","6966","10.6","10.9"
"Bibb","2020-09-06","85","41601","11","6977","9.8","11"
"Bibb","2020-09-07","85","41686","18","6995","11.5","11.6"
"Bibb","2020-09-08","312","41998","28","7023","11.1","11.5"
"Bibb","2020-09-09","401","42399","29","7052","10.9","11.4"
"Bibb","2020-09-10","276","42675","28","7080","10.8","11.3"
"Bibb","2020-09-11","230","42905","20","7100","11.1","11.2"
"Bibb","2020-09-12","146","43051","11","7111","11","10.8"
"Bibb","2020-09-13","76","43127","19","7130","12.7","11.3"
"Bibb","2020-09-14","256","43383","29","7159","11.3","11.4"
"Bibb","2020-09-15","244","43627","30","7189","11.7","11.4"
"Bibb","2020-09-16","279","43906","18","7207","11.6","11.3"
"Bibb","2020-09-17","222","44128","14","7221","11.1","11"
"Bibb","2020-09-18","276","44404","14","7235","10.6","10.8"
"Bibb","2020-09-19","137","44541","7","7242","10.2","10.6"
"Bibb","2020-09-20","96","44637","12","7254","8.4","10.6"
"Bibb","2020-09-21","269","44906","13","7267","7.5","9.4"
"Bibb","2020-09-22","268","45174","13","7280","6.4","9.1"
"Bibb","2020-09-23","194","45368","15","7295","6.6","9.1"
"Bibb","2020-09-24","171","45539","17","7312","7.1","9.1"
"Bibb","2020-09-25","259","45798","19","7331","7.5","9"
"Bibb","2020-09-26","89","45887","3","7334","7.2","8.7"
"Bibb","2020-09-27","85","45972","7","7341","6.6","7.5"
"Bibb","2020-09-28","271","46243","22","7363","7.1","7.3"
"Bibb","2020-09-29","242","46485","10","7373","7","6.7"
"Bibb","2020-09-30","243","46728","19","7392","7","6.8"
"Bibb","2020-10-01","218","46946","11","7403","6.3","6.7"
"Bibb","2020-10-02","260","47206","29","7432","6.8","7.2"
"Bibb","2020-10-03","107","47313","9","7441","7.6","7.4"
"Bibb","2020-10-04","107","47420","16","7457","8.5","7.6"
"Bibb","2020-10-05","335","47755","38","7495","9","8"
"Bibb","2020-10-06","408","48163","29","7524","9.4","8.2"
"Bibb","2020-10-07","363","48526","26","7550","9.3","8.2"
"Bibb","2020-10-08","243","48769","28","7578","10.2","8.3"
"Bibb","2020-10-09","314","49083","18","7596","9.5","8.2"
"Bibb","2020-10-10","160","49243","15","7611","9.6","8.6"
"Bibb","2020-10-11","98","49341","13","7624","9.4","8.9"
"Bibb","2020-10-12","278","49619","26","7650","9.1","9"
"Bibb","2020-10-13","385","50004","34","7684","9.3","9.4"
"Bibb","2020-10-14","325","50329","20","7704","9.2","9.2"
"Bibb","2020-10-15","259","50588","17","7721","8.5","9.4"
"Bibb","2020-10-16","290","50878","18","7739","8.5","9"
"Bibb","2020-10-17","89","50967","9","7748","8.6","9.1"
"Bibb","2020-10-18","81","51048","13","7761","9","9.2"
"Bibb","2020-10-19","376","51424","31","7792","8.9","9"
"Bibb","2020-10-20","302","51726","22","7814","8.7","9"
"Bibb","2020-10-21","278","52004","12","7826","8.4","8.8"
"Bibb","2020-10-22","223","52227","19","7845","8.7","8.6"
"Bibb","2020-10-23","280","52507","19","7864","8.8","8.6"
"Bibb","2020-10-24","118","52625","8","7872","8.3","8.5"
"Bibb","2020-10-25","94","52719","12","7884","7.8","8.4"
"Bibb","2020-10-26","273","52992","22","7906","7.8","8.3"
"Bibb","2020-10-27","236","53228","24","7930","8.2","8.4"
"Bibb","2020-10-28","301","53529","30","7960","9","8.7"
"Bibb","2020-10-29","243","53772","18","7978","8.8","8.8"
"Bibb","2020-10-30","266","54038","21","7999","9","8.9"
"Bibb","2020-10-31","114","54152","12","8011","9.5","8.9"
"Bibb","2020-11-01","94","54246","16","8027","10.1","9"
"Bibb","2020-11-02","365","54611","20","8047","9.8","8.8"
"Bibb","2020-11-03","308","54919","24","8071","9.4","8.8"
"Bibb","2020-11-04","274","55193","18","8089","9","9"
"Bibb","2020-11-05","203","55396","9","8098","8.5","8.7"
"Bibb","2020-11-06","263","55659","23","8121","8.7","8.8"
"Bibb","2020-11-07","105","55764","17","8138","9.5","9.5"
"Bibb","2020-11-08","109","55873","11","8149","8.5","9.3"
"Bibb","2020-11-09","374","56247","40","8189","9.2","9.5"
"Bibb","2020-11-10","285","56532","25","8214","9.4","9.4"
"Bibb","2020-11-11","239","56771","23","8237","9.8","9.4"
"Bibb","2020-11-12","251","57022","24","8261","10.5","9.5"
"Bibb","2020-11-13","292","57314","25","8286","10.5","9.6"
"Bibb","2020-11-14","108","57422","17","8303","10.4","9.9"
"Bibb","2020-11-15","103","57525","15","8318","11.1","9.8"
"Bibb","2020-11-16","404","57929","33","8351","10.7","10"
"Bibb","2020-11-17","294","58223","24","8375","10.6","10"
"Bibb","2020-11-18","371","58594","24","8399","10.2","10"
"Bibb","2020-11-19","267","58861","18","8417","9.8","10.1"
"Bibb","2020-11-20","313","59174","27","8444","9.8","10.1"
"Bibb","2020-11-21","144","59318","15","8459","9","9.7"
"Bibb","2020-11-22","108","59426","11","8470","8.4","9.7"
"Bibb","2020-11-23","354","59780","36","8506","8.7","9.7"
"Bibb","2020-11-24","260","60040","32","8538","9.3","9.9"
"Bibb","2020-11-25","334","60374","43","8581","10.2","10.2"
"Bibb","2020-11-26","42","60416","6","8587","11.3","10.5"
"Bibb","2020-11-27","202","60618","34","8621","12.4","11.1"
"Bibb","2020-11-28","138","60756","22","8643","13.2","11.1"
"Bibb","2020-11-29","151","60907","37","8680","15.3","11.8"
"Bibb","2020-11-30","509","61416","73","8753","15.9","12.3"
"Bibb","2020-12-01","318","61734","33","8786","15.6","12.4"
"Bibb","2020-12-02","372","62106","65","8851","16.3","13.2"
"Bibb","2020-12-03","325","62431","53","8904","16.5","13.9"
"Bibb","2020-12-04","377","62808","73","8977","16.9","14.7"
"Bibb","2020-12-05","196","63004","48","9025","18.1","15.7"
"Bibb","2020-12-06","179","63183","27","9052","16.8","16"
"Bibb","2020-12-07","390","63573","48","9100","16.5","16.2"
"Bibb","2020-12-08","462","64035","55","9155","16.7","16.1"
"Bibb","2020-12-09","388","64423","52","9207","16.1","16.2"
"Bibb","2020-12-10","425","64848","83","9290","16.6","16.6"
"Bibb","2020-12-11","391","65239","64","9354","16.2","16.5"
"Bibb","2020-12-12","179","65418","48","9402","16.5","17.3"
"Bibb","2020-12-13","187","65605","56","9458","18.6","17.7"
"Bibb","2020-12-14","441","66046","81","9539","19.5","18"
"Bibb","2020-12-15","482","66528","74","9613","20","18.3"
"Bibb","2020-12-16","408","66936","64","9677","20.3","18.2"
"Bibb","2020-12-17","481","67417","99","9776","20.4","18.5"
"Bibb","2020-12-18","412","67829","63","9839","20.3","18.2"
"Bibb","2020-12-19","210","68039","45","9884","19.5","18"
"Bibb","2020-12-20","246","68285","55","9939","18.4","18.5"
"Bibb","2020-12-21","444","68729","109","10048","19.3","19.4"
"Bibb","2020-12-22","483","69212","99","10147","20.1","20"
"Bibb","2020-12-23","501","69713","89","10236","20.4","20.3"
"Bibb","2020-12-24","331","70044","69","10305","20.4","20.4"
"Bibb","2020-12-25","100","70144","20","10325","21.1","20.7"
"Bibb","2020-12-26","242","70386","75","10400","22.4","21"
"Bibb","2020-12-27","251","70637","52","10452","22.2","20.3"
"Bibb","2020-12-28","718","71355","170","10622","22.1","20.7"
"Bibb","2020-12-29","683","72038","195","10817","23.2","21.6"
"Bibb","2020-12-30","607","72645","135","10952","23.9","22.1"
"Bibb","2020-12-31","546","73191","119","11071","24","22.2"
"Bibb","2021-01-01","215","73406","47","11118","24.3","22.7"
"Bibb","2021-01-02","228","73634","66","11184","24","23.2"
"Bibb","2021-01-03","271","73905","81","11265","25.3","23.7"
"Bibb","2021-01-04","591","74496","151","11416","25.5","23.8"
"Bibb","2021-01-05","777","75273","142","11558","24.1","23.7"
"Bibb","2021-01-06","577","75850","131","11689","24.1","24"
"Bibb","2021-01-07","647","76497","127","11816","23.8","23.9"
"Bibb","2021-01-08","485","76982","81","11897","23.1","23.7"
"Bibb","2021-01-09","273","77255","70","11967","22.6","23.3"
"Bibb","2021-01-10","272","77527","78","12045","22.5","23.9"
"Bibb","2021-01-11","598","78125","114","12159","21.5","23.5"
"Bibb","2021-01-12","508","78633","106","12265","21.9","23"
"Bibb","2021-01-13","469","79102","81","12346","21.1","22.6"
"Bibb","2021-01-14","546","79648","85","12431","20.5","22.2"
"Bibb","2021-01-15","402","80050","75","12506","20.8","22"
"Bibb","2021-01-16","210","80260","48","12554","20.4","21.5"
"Bibb","2021-01-17","289","80549","56","12610","19.1","20.8"
"Bibb","2021-01-18","463","81012","69","12679","18.5","20"
"Bibb","2021-01-19","447","81459","77","12756","18","19.9"
"Bibb","2021-01-20","430","81889","58","12814","17.4","19.3"
"Bibb","2021-01-21","419","82308","69","12883","17.6","19.1"
"Bibb","2021-01-22","324","82632","60","12943","17.5","19.2"
"Bibb","2021-01-23","165","82797","41","12984","17.8","19.1"
"Bibb","2021-01-24","125","82922","25","13009","17.9","18.5"
"Bibb","2021-01-25","131","83053","21","13030","18.1","18.3"
"Bibb","2021-01-26","11","83064","3","13033","19.5","18.7"
"Bibb","2021-01-27","0","83064","0","13033","17.6","17.5"
"Bleckley","2020-02-01","0","0","0","0",".","."
"Bleckley","2020-02-02","0","0","0","0",".","."
"Bleckley","2020-02-03","0","0","0","0",".","."
"Bleckley","2020-02-04","0","0","0","0",".","."
"Bleckley","2020-02-05","0","0","0","0",".","."
"Bleckley","2020-02-06","0","0","0","0",".","."
"Bleckley","2020-02-07","0","0","0","0","0","."
"Bleckley","2020-02-08","0","0","0","0","0","."
"Bleckley","2020-02-09","0","0","0","0","0","."
"Bleckley","2020-02-10","0","0","0","0","0","."
"Bleckley","2020-02-11","0","0","0","0","0","."
"Bleckley","2020-02-12","0","0","0","0","0","."
"Bleckley","2020-02-13","0","0","0","0","0","."
"Bleckley","2020-02-14","0","0","0","0","0","0"
"Bleckley","2020-02-15","0","0","0","0","0","0"
"Bleckley","2020-02-16","0","0","0","0","0","0"
"Bleckley","2020-02-17","0","0","0","0","0","0"
"Bleckley","2020-02-18","0","0","0","0","0","0"
"Bleckley","2020-02-19","0","0","0","0","0","0"
"Bleckley","2020-02-20","0","0","0","0","0","0"
"Bleckley","2020-02-21","0","0","0","0","0","0"
"Bleckley","2020-02-22","0","0","0","0","0","0"
"Bleckley","2020-02-23","0","0","0","0","0","0"
"Bleckley","2020-02-24","0","0","0","0","0","0"
"Bleckley","2020-02-25","0","0","0","0","0","0"
"Bleckley","2020-02-26","0","0","0","0","0","0"
"Bleckley","2020-02-27","0","0","0","0","0","0"
"Bleckley","2020-02-28","0","0","0","0","0","0"
"Bleckley","2020-02-29","0","0","0","0","0","0"
"Bleckley","2020-03-01","0","0","0","0","0","0"
"Bleckley","2020-03-02","0","0","0","0","0","0"
"Bleckley","2020-03-03","0","0","0","0","0","0"
"Bleckley","2020-03-04","0","0","0","0","0","0"
"Bleckley","2020-03-05","0","0","0","0","0","0"
"Bleckley","2020-03-06","0","0","0","0","0","0"
"Bleckley","2020-03-07","0","0","0","0","0","0"
"Bleckley","2020-03-08","0","0","0","0","0","0"
"Bleckley","2020-03-09","0","0","0","0","0","0"
"Bleckley","2020-03-10","0","0","0","0","0","0"
"Bleckley","2020-03-11","0","0","0","0","0","0"
"Bleckley","2020-03-12","1","1","0","0","0","0"
"Bleckley","2020-03-13","0","1","0","0","0","0"
"Bleckley","2020-03-14","0","1","0","0","0","0"
"Bleckley","2020-03-15","0","1","0","0","0","0"
"Bleckley","2020-03-16","1","2","0","0","0","0"
"Bleckley","2020-03-17","1","3","0","0","0","0"
"Bleckley","2020-03-18","2","5","0","0","0","0"
"Bleckley","2020-03-19","5","10","0","0","0","0"
"Bleckley","2020-03-20","3","13","0","0","0","0"
"Bleckley","2020-03-21","0","13","0","0","0","0"
"Bleckley","2020-03-22","0","13","0","0","0","0"
"Bleckley","2020-03-23","4","17","0","0","0","0"
"Bleckley","2020-03-24","3","20","0","0","0","0"
"Bleckley","2020-03-25","2","22","0","0","0","0"
"Bleckley","2020-03-26","5","27","1","1","2.9","1.4"
"Bleckley","2020-03-27","1","28","0","1","2.9","1.4"
"Bleckley","2020-03-28","0","28","0","1","2.9","1.4"
"Bleckley","2020-03-29","0","28","0","1","2.9","1.4"
"Bleckley","2020-03-30","3","31","0","1","2.9","1.4"
"Bleckley","2020-03-31","6","37","0","1","2.9","1.4"
"Bleckley","2020-04-01","1","38","0","1","2.9","1.4"
"Bleckley","2020-04-02","2","40","0","1","0","1.4"
"Bleckley","2020-04-03","2","42","0","1","0","1.4"
"Bleckley","2020-04-04","1","43","0","1","0","1.4"
"Bleckley","2020-04-05","2","45","0","1","0","1.4"
"Bleckley","2020-04-06","1","46","0","1","0","1.4"
"Bleckley","2020-04-07","0","46","0","1","0","1.4"
"Bleckley","2020-04-08","0","46","0","1","0","1.4"
"Bleckley","2020-04-09","3","49","0","1","0","0"
"Bleckley","2020-04-10","2","51","0","1","0","0"
"Bleckley","2020-04-11","0","51","0","1","0","0"
"Bleckley","2020-04-12","1","52","0","1","0","0"
"Bleckley","2020-04-13","2","54","1","2","7.1","3.6"
"Bleckley","2020-04-14","0","54","0","2","7.1","3.6"
"Bleckley","2020-04-15","3","57","1","3","11.9","6"
"Bleckley","2020-04-16","0","57","0","3","11.9","6"
"Bleckley","2020-04-17","1","58","0","3","11.9","6"
"Bleckley","2020-04-18","1","59","0","3","11.9","6"
"Bleckley","2020-04-19","1","60","0","3","11.9","6"
"Bleckley","2020-04-20","2","62","0","3","4.8","6"
"Bleckley","2020-04-21","10","72","4","7","10.5","8.8"
"Bleckley","2020-04-22","3","75","1","8","10.5","11.2"
"Bleckley","2020-04-23","2","77","0","8","10.5","11.2"
"Bleckley","2020-04-24","11","88","2","10","13.1","12.5"
"Bleckley","2020-04-25","0","88","0","10","13.1","12.5"
"Bleckley","2020-04-26","1","89","0","10","13.1","12.5"
"Bleckley","2020-04-27","5","94","3","13","21.6","13.2"
"Bleckley","2020-04-28","5","99","1","14","18.8","14.6"
"Bleckley","2020-04-29","8","107","1","15","15.8","13.1"
"Bleckley","2020-04-30","1","108","0","15","15.8","13.1"
"Bleckley","2020-05-01","3","111","1","16","18","15.5"
"Bleckley","2020-05-02","1","112","1","17","32.3","22.7"
"Bleckley","2020-05-03","5","117","0","17","32.3","22.7"
"Bleckley","2020-05-04","1","118","0","17","23.7","22.7"
"Bleckley","2020-05-05","4","122","1","18","24.4","21.6"
"Bleckley","2020-05-06","0","122","0","18","22.6","19.2"
"Bleckley","2020-05-07","0","122","0","18","22.6","19.2"
"Bleckley","2020-05-08","20","142","0","18","17.9","17.9"
"Bleckley","2020-05-09","3","145","0","18","3.6","17.9"
"Bleckley","2020-05-10","0","145","0","18","3.6","17.9"
"Bleckley","2020-05-11","26","171","0","18","3.6","13.6"
"Bleckley","2020-05-12","1","172","0","18","0","12.2"
"Bleckley","2020-05-13","1","173","0","18","0","11.3"
"Bleckley","2020-05-14","2","175","0","18","0","11.3"
"Bleckley","2020-05-15","2","177","0","18","0","8.9"
"Bleckley","2020-05-16","2","179","1","19","7.1","5.4"
"Bleckley","2020-05-17","2","181","1","20","14.3","8.9"
"Bleckley","2020-05-18","3","184","1","21","19","11.3"
"Bleckley","2020-05-19","2","186","0","21","19","9.5"
"Bleckley","2020-05-20","23","209","1","22","19.7","9.8"
"Bleckley","2020-05-21","4","213","0","22","19.7","9.8"
"Bleckley","2020-05-22","5","218","1","23","22.5","11.3"
"Bleckley","2020-05-23","6","224","3","26","22.5","14.8"
"Bleckley","2020-05-24","1","225","1","27","29.7","22"
"Bleckley","2020-05-25","3","228","0","27","24.9","22"
"Bleckley","2020-05-26","4","232","0","27","24.9","22"
"Bleckley","2020-05-27","6","238","1","28","26.7","23.2"
"Bleckley","2020-05-28","7","245","0","28","26.7","23.2"
"Bleckley","2020-05-29","5","250","0","28","23.8","23.2"
"Bleckley","2020-05-30","3","253","1","29","21.4","22"
"Bleckley","2020-05-31","1","254","0","29","7.1","18.4"
"Bleckley","2020-06-01","11","265","1","30","8.4","16.7"
"Bleckley","2020-06-02","11","276","2","32","11","18"
"Bleckley","2020-06-03","4","280","0","32","8.7","17.7"
"Bleckley","2020-06-04","19","299","2","34","10.2","18.4"
"Bleckley","2020-06-05","13","312","1","35","11.3","17.5"
"Bleckley","2020-06-06","5","317","0","35","6.5","14"
"Bleckley","2020-06-07","2","319","1","36","13.6","10.4"
"Bleckley","2020-06-08","10","329","1","37","13.8","11.1"
"Bleckley","2020-06-09","7","336","2","39","15.3","13.1"
"Bleckley","2020-06-10","7","343","0","39","15.3","12"
"Bleckley","2020-06-11","6","349","1","40","16.1","13.1"
"Bleckley","2020-06-12","8","357","1","41","16.8","14"
"Bleckley","2020-06-13","4","361","0","41","16.8","11.7"
"Bleckley","2020-06-14","2","363","1","42","16.8","15.2"
"Bleckley","2020-06-15","5","368","2","44","21.1","17.4"
"Bleckley","2020-06-16","4","372","0","44","17","16.1"
"Bleckley","2020-06-17","10","382","3","47","21.3","18.3"
"Bleckley","2020-06-18","2","384","0","47","18.9","17.5"
"Bleckley","2020-06-19","10","394","1","48","18.6","17.7"
"Bleckley","2020-06-20","1","395","0","48","18.6","17.7"
"Bleckley","2020-06-21","4","399","3","51","22.1","19.5"
"Bleckley","2020-06-22","7","406","0","51","16.4","18.8"
"Bleckley","2020-06-23","4","410","2","53","23.6","20.3"
"Bleckley","2020-06-24","9","419","0","53","19.3","20.3"
"Bleckley","2020-06-25","4","423","1","54","22.9","20.9"
"Bleckley","2020-06-26","1","424","0","54","21.4","20"
"Bleckley","2020-06-27","4","428","2","56","28.6","23.6"
"Bleckley","2020-06-28","1","429","0","56","17.9","20"
"Bleckley","2020-06-29","5","434","3","59","26.4","21.4"
"Bleckley","2020-06-30","12","446","2","61","21.7","22.6"
"Bleckley","2020-07-01","12","458","2","63","24","21.7"
"Bleckley","2020-07-02","6","464","1","64","22.9","22.9"
"Bleckley","2020-07-03","3","467","0","64","22.9","22.1"
"Bleckley","2020-07-04","2","469","2","66","30","29.3"
"Bleckley","2020-07-05","0","469","0","66","30","23.9"
"Bleckley","2020-07-06","13","482","2","68","23.6","25"
"Bleckley","2020-07-07","3","485","0","68","21.2","21.5"
"Bleckley","2020-07-08","9","494","0","68","18.9","21.5"
"Bleckley","2020-07-09","15","509","0","68","16.5","19.7"
"Bleckley","2020-07-10","101","610","5","73","17.2","20"
"Bleckley","2020-07-11","0","610","0","73","2.9","16.5"
"Bleckley","2020-07-12","2","612","1","74","10","20"
"Bleckley","2020-07-13","6","618","0","74","7.9","15.7"
"Bleckley","2020-07-14","5","623","0","74","7.9","14.5"
"Bleckley","2020-07-15","1","624","0","74","7.9","13.4"
"Bleckley","2020-07-16","4","628","0","74","7.9","12.2"
"Bleckley","2020-07-17","6","634","1","75","9.5","13.4"
"Bleckley","2020-07-18","1","635","0","75","9.5","6.2"
"Bleckley","2020-07-19","0","635","0","75","2.4","6.2"
"Bleckley","2020-07-20","11","646","0","75","2.4","5.1"
"Bleckley","2020-07-21","7","653","2","77","6.5","7.2"
"Bleckley","2020-07-22","1","654","0","77","6.5","7.2"
"Bleckley","2020-07-23","4","658","1","78","10","8.9"
"Bleckley","2020-07-24","9","667","0","78","7.7","8.6"
"Bleckley","2020-07-25","3","670","1","79","12.4","11"
"Bleckley","2020-07-26","2","672","0","79","12.4","7.4"
"Bleckley","2020-07-27","7","679","1","80","14.5","8.4"
"Bleckley","2020-07-28","3","682","1","81","15.1","10.8"
"Bleckley","2020-07-29","6","688","2","83","19.9","13.2"
"Bleckley","2020-07-30","5","693","0","83","16.3","13.2"
"Bleckley","2020-07-31","11","704","4","87","21.5","14.6"
"Bleckley","2020-08-01","0","704","0","87","16.8","14.6"
"Bleckley","2020-08-02","0","704","0","87","16.8","14.6"
"Bleckley","2020-08-03","7","711","1","88","16.8","15.6"
"Bleckley","2020-08-04","23","734","12","100","19.5","17.3"
"Bleckley","2020-08-05","25","759","12","112","21.5","20.7"
"Bleckley","2020-08-06","14","773","3","115","24.6","20.5"
"Bleckley","2020-08-07","14","787","6","121","25.5","23.5"
"Bleckley","2020-08-08","1","788","1","122","39.8","28.3"
"Bleckley","2020-08-09","1","789","0","122","39.8","28.3"
"Bleckley","2020-08-10","4","793","3","125","48.5","32.6"
"Bleckley","2020-08-11","8","801","1","126","42.8","31.1"
"Bleckley","2020-08-12","7","808","5","131","46.2","33.9"
"Bleckley","2020-08-13","10","818","3","134","47.4","36"
"Bleckley","2020-08-14","4","822","1","135","44.8","35.2"
"Bleckley","2020-08-15","10","832","1","136","32","35.9"
"Bleckley","2020-08-16","2","834","1","137","39.1","39.5"
"Bleckley","2020-08-17","11","845","0","137","28.4","38.5"
"Bleckley","2020-08-18","12","857","2","139","29","35.9"
"Bleckley","2020-08-19","7","864","1","140","20.9","33.5"
"Bleckley","2020-08-20","28","892","10","150","21.7","34.5"
"Bleckley","2020-08-21","6","898","0","150","18.1","31.5"
"Bleckley","2020-08-22","6","904","1","151","19","25.5"
"Bleckley","2020-08-23","2","906","0","151","11.9","25.5"
"Bleckley","2020-08-24","11","917","1","152","13.2","20.8"
"Bleckley","2020-08-25","14","931","1","153","11.8","20.4"
"Bleckley","2020-08-26","7","938","3","156","15.9","18.4"
"Bleckley","2020-08-27","8","946","1","157","12.6","17.1"
"Bleckley","2020-08-28","9","955","1","158","14.2","16.1"
"Bleckley","2020-08-29","5","960","0","158","11.8","15.4"
"Bleckley","2020-08-30","1","961","0","158","11.8","11.9"
"Bleckley","2020-08-31","9","970","0","158","10.5","11.9"
"Bleckley","2020-09-01","5","975","1","159","12.4","12.1"
"Bleckley","2020-09-02","135","1110","24","183","8.8","12.3"
"Bleckley","2020-09-03","6","1116","1","184","9.4","11"
"Bleckley","2020-09-04","3","1119","0","184","7.8","11"
"Bleckley","2020-09-05","5","1124","0","184","7.8","9.8"
"Bleckley","2020-09-06","3","1127","0","184","7.8","9.8"
"Bleckley","2020-09-07","2","1129","1","185","14.9","12.7"
"Bleckley","2020-09-08","9","1138","0","185","12.1","12.2"
"Bleckley","2020-09-09","95","1233","10","195","11","9.9"
"Bleckley","2020-09-10","4","1237","0","195","8.6","9"
"Bleckley","2020-09-11","3","1240","0","195","8.6","8.2"
"Bleckley","2020-09-12","2","1242","0","195","8.6","8.2"
"Bleckley","2020-09-13","0","1242","0","195","8.6","8.2"
"Bleckley","2020-09-14","9","1251","1","196","3.1","9"
"Bleckley","2020-09-15","7","1258","0","196","3.1","7.6"
"Bleckley","2020-09-16","2","1260","1","197","8.7","9.9"
"Bleckley","2020-09-17","5","1265","1","198","11.6","10.1"
"Bleckley","2020-09-18","11","1276","0","198","11.6","10.1"
"Bleckley","2020-09-19","3","1279","0","198","11.6","10.1"
"Bleckley","2020-09-20","1","1280","1","199","25.9","17.3"
"Bleckley","2020-09-21","5","1285","1","200","27.1","15.1"
"Bleckley","2020-09-22","21","1306","2","202","28.5","15.8"
"Bleckley","2020-09-23","79","1385","4","206","22.1","15.4"
"Bleckley","2020-09-24","4","1389","0","206","19.2","15.4"
"Bleckley","2020-09-25","12","1401","0","206","19.2","15.4"
"Bleckley","2020-09-26","3","1404","0","206","19.2","15.4"
"Bleckley","2020-09-27","1","1405","1","207","19.2","22.5"
"Bleckley","2020-09-28","6","1411","0","207","16.4","21.8"
"Bleckley","2020-09-29","6","1417","0","207","15","21.8"
"Bleckley","2020-09-30","64","1481","6","213","15.6","18.9"
"Bleckley","2020-10-01","8","1489","0","213","15.6","17.4"
"Bleckley","2020-10-02","6","1495","0","213","15.6","17.4"
"Bleckley","2020-10-03","9","1504","0","213","15.6","17.4"
"Bleckley","2020-10-04","3","1507","1","214","6.1","12.7"
"Bleckley","2020-10-05","7","1514","0","214","6.1","11.2"
"Bleckley","2020-10-06","10","1524","0","214","6.1","10.6"
"Bleckley","2020-10-07","91","1615","11","225","6.5","11.1"
"Bleckley","2020-10-08","9","1624","0","225","6.5","11.1"
"Bleckley","2020-10-09","4","1628","0","225","6.5","11.1"
"Bleckley","2020-10-10","2","1630","0","225","6.5","11.1"
"Bleckley","2020-10-11","3","1633","0","225","1.7","3.9"
"Bleckley","2020-10-12","7","1640","0","225","1.7","3.9"
"Bleckley","2020-10-13","6","1646","1","226","4.1","5.1"
"Bleckley","2020-10-14","107","1753","15","241","4.4","5.4"
"Bleckley","2020-10-15","5","1758","0","241","4.4","5.4"
"Bleckley","2020-10-16","7","1765","0","241","4.4","5.4"
"Bleckley","2020-10-17","3","1768","1","242","9.1","7.8"
"Bleckley","2020-10-18","2","1770","1","243","16.3","9"
"Bleckley","2020-10-19","12","1782","2","245","18.7","10.2"
"Bleckley","2020-10-20","6","1788","1","246","18.7","11.4"
"Bleckley","2020-10-21","44","1832","7","253","18.9","11.7"
"Bleckley","2020-10-22","7","1839","1","254","21","12.7"
"Bleckley","2020-10-23","9","1848","1","255","22.6","13.5"
"Bleckley","2020-10-24","7","1855","0","255","17.8","13.5"
"Bleckley","2020-10-25","3","1858","1","256","15.4","15.9"
"Bleckley","2020-10-26","10","1868","0","256","13","15.9"
"Bleckley","2020-10-27","6","1874","0","256","10.7","14.7"
"Bleckley","2020-10-28","50","1924","2","258","9","14"
"Bleckley","2020-10-29","13","1937","3","261","10.2","15.6"
"Bleckley","2020-10-30","2","1939","0","261","8.6","15.6"
"Bleckley","2020-10-31","7","1946","0","261","8.6","13.2"
"Bleckley","2020-11-01","5","1951","2","263","9.6","12.5"
"Bleckley","2020-11-02","14","1965","0","263","9.6","11.3"
"Bleckley","2020-11-03","12","1977","1","264","10.8","10.7"
"Bleckley","2020-11-04","31","2008","1","265","10.7","9.8"
"Bleckley","2020-11-05","7","2015","2","267","11.4","10.8"
"Bleckley","2020-11-06","11","2026","0","267","11.4","10"
"Bleckley","2020-11-07","9","2035","0","267","11.4","10"
"Bleckley","2020-11-08","6","2041","1","268","8.1","8.8"
"Bleckley","2020-11-09","12","2053","1","269","9.3","9.4"
"Bleckley","2020-11-10","12","2065","0","269","8.1","9.4"
"Bleckley","2020-11-11","7","2072","2","271","11.7","11.2"
"Bleckley","2020-11-12","27","2099","3","274","9.2","10.3"
"Bleckley","2020-11-13","12","2111","1","275","10.4","10.9"
"Bleckley","2020-11-14","2","2113","0","275","10.4","10.9"
"Bleckley","2020-11-15","5","2118","0","275","8","8.1"
"Bleckley","2020-11-16","39","2157","2","277","7.6","8.4"
"Bleckley","2020-11-17","9","2166","1","278","9.2","8.6"
"Bleckley","2020-11-18","40","2206","2","280","5.8","8.8"
"Bleckley","2020-11-19","8","2214","0","280","4.2","6.7"
"Bleckley","2020-11-20","10","2224","1","281","4.5","7.4"
"Bleckley","2020-11-21","7","2231","1","282","6.5","8.5"
"Bleckley","2020-11-22","3","2234","0","282","6.5","7.3"
"Bleckley","2020-11-23","11","2245","0","282","5.8","6.7"
"Bleckley","2020-11-24","5","2250","0","282","4.2","6.7"
"Bleckley","2020-11-25","33","2283","3","285","4.8","5.3"
"Bleckley","2020-11-26","0","2283","0","285","4.8","4.5"
"Bleckley","2020-11-27","7","2290","1","286","5.4","4.9"
"Bleckley","2020-11-28","3","2293","0","286","3.3","4.9"
"Bleckley","2020-11-29","0","2293","0","286","3.3","4.9"
"Bleckley","2020-11-30","12","2305","2","288","5.7","5.7"
"Bleckley","2020-12-01","9","2314","0","288","5.7","5"
"Bleckley","2020-12-02","54","2368","7","295","6.3","5.5"
"Bleckley","2020-12-03","9","2377","0","295","6.3","5.5"
"Bleckley","2020-12-04","7","2384","1","296","6.3","5.8"
"Bleckley","2020-12-05","8","2392","1","297","8.1","5.7"
"Bleckley","2020-12-06","4","2396","0","297","8.1","5.7"
"Bleckley","2020-12-07","5","2401","0","297","5.7","5.7"
"Bleckley","2020-12-08","6","2407","1","298","8.1","6.9"
"Bleckley","2020-12-09","41","2448","4","302","7.6","6.9"
"Bleckley","2020-12-10","7","2455","1","303","9.6","8"
"Bleckley","2020-12-11","11","2466","2","305","10.2","8.2"
"Bleckley","2020-12-12","6","2472","1","306","10.8","9.4"
"Bleckley","2020-12-13","4","2476","1","307","14.4","11.2"
"Bleckley","2020-12-14","18","2494","0","307","14.4","10"
"Bleckley","2020-12-15","16","2510","2","309","13.8","10.9"
"Bleckley","2020-12-16","18","2528","4","313","15.6","11.6"
"Bleckley","2020-12-17","14","2542","3","316","16.6","13.1"
"Bleckley","2020-12-18","16","2558","1","317","14.9","12.5"
"Bleckley","2020-12-19","12","2570","5","322","18.4","14.6"
"Bleckley","2020-12-20","13","2583","3","325","18.2","16.3"
"Bleckley","2020-12-21","19","2602","2","327","19.7","17"
"Bleckley","2020-12-22","17","2619","2","329","19.6","16.7"
"Bleckley","2020-12-23","44","2663","5","334","18","16.8"
"Bleckley","2020-12-24","1","2664","0","334","14.9","15.8"
"Bleckley","2020-12-25","1","2665","1","335","28.3","21.6"
"Bleckley","2020-12-26","6","2671","1","336","24.8","21.6"
"Bleckley","2020-12-27","3","2674","0","336","21.5","19.8"
"Bleckley","2020-12-28","20","2694","4","340","22.8","21.2"
"Bleckley","2020-12-29","18","2712","3","343","23.5","21.5"
"Bleckley","2020-12-30","112","2824","5","348","22.5","20.3"
"Bleckley","2020-12-31","20","2844","3","351","24.7","19.8"
"Bleckley","2021-01-01","4","2848","1","352","14","21.2"
"Bleckley","2021-01-02","6","2854","0","352","11.6","18.2"
"Bleckley","2021-01-03","5","2859","2","354","17.3","19.4"
"Bleckley","2021-01-04","16","2875","0","354","14.4","18.6"
"Bleckley","2021-01-05","22","2897","1","355","12.7","18.1"
"Bleckley","2021-01-06","80","2977","10","365","13.9","18.2"
"Bleckley","2021-01-07","31","3008","3","368","13.1","18.9"
"Bleckley","2021-01-08","14","3022","0","368","9.5","11.8"
"Bleckley","2021-01-09","9","3031","2","370","12.7","12.1"
"Bleckley","2021-01-10","8","3039","1","371","8.8","13"
"Bleckley","2021-01-11","25","3064","3","374","10.5","12.5"
"Bleckley","2021-01-12","26","3090","2","376","10.9","11.8"
"Bleckley","2021-01-13","86","3176","8","384","10.5","12.2"
"Bleckley","2021-01-14","15","3191","3","387","12","12.5"
"Bleckley","2021-01-15","20","3211","4","391","14.8","12.2"
"Bleckley","2021-01-16","7","3218","0","391","11.6","12.2"
"Bleckley","2021-01-17","6","3224","1","392","12.2","10.5"
"Bleckley","2021-01-18","19","3243","4","396","13.5","12"
"Bleckley","2021-01-19","49","3292","13","409","16.2","13.6"
"Bleckley","2021-01-20","16","3308","1","410","15.8","13.1"
"Bleckley","2021-01-21","11","3319","1","411","14.2","13.1"
"Bleckley","2021-01-22","14","3333","2","413","13.4","14.1"
"Bleckley","2021-01-23","5","3338","0","413","13.4","12.5"
"Bleckley","2021-01-24","0","3338","0","413","11","11.6"
"Bleckley","2021-01-25","6","3344","0","413","8","10.8"
"Bleckley","2021-01-26","0","3344","0","413","4.2","10.2"
"Bleckley","2021-01-27","0","3344","0","413","3.3","9.6"
"Brantley","2020-02-01","0","0","0","0",".","."
"Brantley","2020-02-02","0","0","0","0",".","."
"Brantley","2020-02-03","0","0","0","0",".","."
"Brantley","2020-02-04","0","0","0","0",".","."
"Brantley","2020-02-05","0","0","0","0",".","."
"Brantley","2020-02-06","0","0","0","0",".","."
"Brantley","2020-02-07","0","0","0","0","0","."
"Brantley","2020-02-08","0","0","0","0","0","."
"Brantley","2020-02-09","0","0","0","0","0","."
"Brantley","2020-02-10","0","0","0","0","0","."
"Brantley","2020-02-11","0","0","0","0","0","."
"Brantley","2020-02-12","0","0","0","0","0","."
"Brantley","2020-02-13","0","0","0","0","0","."
"Brantley","2020-02-14","0","0","0","0","0","0"
"Brantley","2020-02-15","0","0","0","0","0","0"
"Brantley","2020-02-16","0","0","0","0","0","0"
"Brantley","2020-02-17","0","0","0","0","0","0"
"Brantley","2020-02-18","0","0","0","0","0","0"
"Brantley","2020-02-19","0","0","0","0","0","0"
"Brantley","2020-02-20","0","0","0","0","0","0"
"Brantley","2020-02-21","0","0","0","0","0","0"
"Brantley","2020-02-22","0","0","0","0","0","0"
"Brantley","2020-02-23","0","0","0","0","0","0"
"Brantley","2020-02-24","0","0","0","0","0","0"
"Brantley","2020-02-25","0","0","0","0","0","0"
"Brantley","2020-02-26","0","0","0","0","0","0"
"Brantley","2020-02-27","0","0","0","0","0","0"
"Brantley","2020-02-28","0","0","0","0","0","0"
"Brantley","2020-02-29","0","0","0","0","0","0"
"Brantley","2020-03-01","0","0","0","0","0","0"
"Brantley","2020-03-02","0","0","0","0","0","0"
"Brantley","2020-03-03","0","0","0","0","0","0"
"Brantley","2020-03-04","0","0","0","0","0","0"
"Brantley","2020-03-05","0","0","0","0","0","0"
"Brantley","2020-03-06","0","0","0","0","0","0"
"Brantley","2020-03-07","0","0","0","0","0","0"
"Brantley","2020-03-08","0","0","0","0","0","0"
"Brantley","2020-03-09","0","0","0","0","0","0"
"Brantley","2020-03-10","0","0","0","0","0","0"
"Brantley","2020-03-11","0","0","0","0","0","0"
"Brantley","2020-03-12","2","2","0","0","0","0"
"Brantley","2020-03-13","0","2","0","0","0","0"
"Brantley","2020-03-14","0","2","0","0","0","0"
"Brantley","2020-03-15","1","3","0","0","0","0"
"Brantley","2020-03-16","1","4","0","0","0","0"
"Brantley","2020-03-17","1","5","0","0","0","0"
"Brantley","2020-03-18","9","14","0","0","0","0"
"Brantley","2020-03-19","6","20","0","0","0","0"
"Brantley","2020-03-20","6","26","0","0","0","0"
"Brantley","2020-03-21","0","26","0","0","0","0"
"Brantley","2020-03-22","4","30","0","0","0","0"
"Brantley","2020-03-23","4","34","0","0","0","0"
"Brantley","2020-03-24","11","45","0","0","0","0"
"Brantley","2020-03-25","3","48","0","0","0","0"
"Brantley","2020-03-26","4","52","0","0","0","0"
"Brantley","2020-03-27","7","59","0","0","0","0"
"Brantley","2020-03-28","0","59","0","0","0","0"
"Brantley","2020-03-29","2","61","0","0","0","0"
"Brantley","2020-03-30","5","66","0","0","0","0"
"Brantley","2020-03-31","6","72","0","0","0","0"
"Brantley","2020-04-01","2","74","1","1","7.1","3.6"
"Brantley","2020-04-02","1","75","0","1","7.1","3.6"
"Brantley","2020-04-03","5","80","1","2","10","5"
"Brantley","2020-04-04","2","82","0","2","10","5"
"Brantley","2020-04-05","0","82","0","2","10","5"
"Brantley","2020-04-06","3","85","0","2","10","5"
"Brantley","2020-04-07","7","92","1","3","12","6"
"Brantley","2020-04-08","4","96","2","5","12","9.6"
"Brantley","2020-04-09","10","106","7","12","22","14.6"
"Brantley","2020-04-10","7","113","0","12","19.2","14.6"
"Brantley","2020-04-11","1","114","0","12","19.2","14.6"
"Brantley","2020-04-12","0","114","0","12","19.2","14.6"
"Brantley","2020-04-13","4","118","1","13","22.8","16.4"
"Brantley","2020-04-14","2","120","0","13","20.7","16.4"
"Brantley","2020-04-15","9","129","1","14","15.2","13.6"
"Brantley","2020-04-16","8","137","1","15","6.9","14.5"
"Brantley","2020-04-17","13","150","1","16","8","13.6"
"Brantley","2020-04-18","5","155","0","16","8","13.6"
"Brantley","2020-04-19","3","158","0","16","8","13.6"
"Brantley","2020-04-20","11","169","0","16","4.5","13.6"
"Brantley","2020-04-21","8","177","0","16","4.5","12.6"
"Brantley","2020-04-22","2","179","1","17","10","12.6"
"Brantley","2020-04-23","14","193","0","17","8.2","7.6"
"Brantley","2020-04-24","4","197","0","17","7.1","7.6"
"Brantley","2020-04-25","1","198","0","17","7.1","7.6"
"Brantley","2020-04-26","1","199","0","17","7.1","7.6"
"Brantley","2020-04-27","7","206","0","17","7.1","5.8"
"Brantley","2020-04-28","2","208","0","17","7.1","5.8"
"Brantley","2020-04-29","3","211","0","17","0","5"
"Brantley","2020-04-30","5","216","0","17","0","4.1"
"Brantley","2020-05-01","4","220","0","17","0","3.6"
"Brantley","2020-05-02","5","225","0","17","0","3.6"
"Brantley","2020-05-03","1","226","0","17","0","3.6"
"Brantley","2020-05-04","8","234","0","17","0","3.6"
"Brantley","2020-05-05","3","237","0","17","0","3.6"
"Brantley","2020-05-06","1","238","0","17","0","0"
"Brantley","2020-05-07","8","246","0","17","0","0"
"Brantley","2020-05-08","5","251","0","17","0","0"
"Brantley","2020-05-09","5","256","1","18","2.9","1.4"
"Brantley","2020-05-10","0","256","0","18","2.9","1.4"
"Brantley","2020-05-11","14","270","0","18","2.9","1.4"
"Brantley","2020-05-12","43","313","13","31","7.2","3.6"
"Brantley","2020-05-13","4","317","1","32","10.7","5.4"
"Brantley","2020-05-14","14","331","0","32","10.7","5.4"
"Brantley","2020-05-15","8","339","0","32","10.7","5.4"
"Brantley","2020-05-16","2","341","0","32","7.9","5.4"
"Brantley","2020-05-17","0","341","0","32","7.9","5.4"
"Brantley","2020-05-18","16","357","0","32","7.9","5.4"
"Brantley","2020-05-19","7","364","0","32","3.6","5.4"
"Brantley","2020-05-20","9","373","1","33","1.6","6.2"
"Brantley","2020-05-21","4","377","0","33","1.6","6.2"
"Brantley","2020-05-22","15","392","0","33","1.6","6.2"
"Brantley","2020-05-23","8","400","0","33","1.6","4.7"
"Brantley","2020-05-24","2","402","0","33","1.6","4.7"
"Brantley","2020-05-25","9","411","0","33","1.6","4.7"
"Brantley","2020-05-26","7","418","0","33","1.6","2.6"
"Brantley","2020-05-27","5","423","0","33","0","0.8"
"Brantley","2020-05-28","21","444","2","35","1.4","1.5"
"Brantley","2020-05-29","6","450","3","38","8.5","5"
"Brantley","2020-05-30","2","452","0","38","8.5","5"
"Brantley","2020-05-31","1","453","0","38","8.5","5"
"Brantley","2020-06-01","16","469","0","38","8.5","5"
"Brantley","2020-06-02","3","472","0","38","8.5","5"
"Brantley","2020-06-03","6","478","0","38","8.5","4.3"
"Brantley","2020-06-04","5","483","0","38","7.1","4.3"
"Brantley","2020-06-05","11","494","0","38","0","4.3"
"Brantley","2020-06-06","5","499","0","38","0","4.3"
"Brantley","2020-06-07","3","502","0","38","0","4.3"
"Brantley","2020-06-08","22","524","2","40","1.3","4.9"
"Brantley","2020-06-09","12","536","1","41","2.5","5.5"
"Brantley","2020-06-10","12","548","3","44","6.1","7.3"
"Brantley","2020-06-11","24","572","1","45","6.7","6.9"
"Brantley","2020-06-12","12","584","1","46","7.8","3.9"
"Brantley","2020-06-13","7","591","0","46","7.8","3.9"
"Brantley","2020-06-14","0","591","0","46","7.8","3.9"
"Brantley","2020-06-15","18","609","0","46","6.5","3.9"
"Brantley","2020-06-16","13","622","2","48","7.6","5"
"Brantley","2020-06-17","9","631","1","49","5.6","5.8"
"Brantley","2020-06-18","23","654","3","52","6.8","6.7"
"Brantley","2020-06-19","11","665","2","54","8.2","8"
"Brantley","2020-06-20","5","670","2","56","14","10.9"
"Brantley","2020-06-21","3","673","0","56","14","10.9"
"Brantley","2020-06-22","20","693","0","56","14","10.3"
"Brantley","2020-06-23","27","720","0","56","11.8","9.7"
"Brantley","2020-06-24","15","735","0","56","10.2","7.9"
"Brantley","2020-06-25","32","767","1","57","8.8","7.8"
"Brantley","2020-06-26","32","799","7","64","9.3","8.8"
"Brantley","2020-06-27","3","802","1","65","8.3","11.1"
"Brantley","2020-06-28","5","807","0","65","8.3","11.1"
"Brantley","2020-06-29","17","824","2","67","10","12"
"Brantley","2020-06-30","27","851","2","69","11.1","11.4"
"Brantley","2020-07-01","23","874","1","70","11.7","10.9"
"Brantley","2020-07-02","34","908","6","76","13.8","11.3"
"Brantley","2020-07-03","10","918","1","77","12.1","10.7"
"Brantley","2020-07-04","6","924","3","80","14.5","11.4"
"Brantley","2020-07-05","1","925","0","80","14.5","11.4"
"Brantley","2020-07-06","19","944","2","82","14.3","12.1"
"Brantley","2020-07-07","34","978","2","84","14.1","12.6"
"Brantley","2020-07-08","22","1000","2","86","14.7","13.2"
"Brantley","2020-07-09","37","1037","7","93","14.9","14.3"
"Brantley","2020-07-10","27","1064","2","95","14.5","13.3"
"Brantley","2020-07-11","7","1071","6","101","19.6","17.1"
"Brantley","2020-07-12","11","1082","5","106","26.1","20.3"
"Brantley","2020-07-13","27","1109","6","112","27.8","21"
"Brantley","2020-07-14","29","1138","6","118","29.9","22"
"Brantley","2020-07-15","31","1169","4","122","30.5","22.6"
"Brantley","2020-07-16","36","1205","2","124","28.6","21.7"
"Brantley","2020-07-17","26","1231","1","125","28.1","21.3"
"Brantley","2020-07-18","14","1245","3","128","18.9","19.3"
"Brantley","2020-07-19","4","1249","1","129","15.9","21"
"Brantley","2020-07-20","23","1272","3","132","14.6","21.2"
"Brantley","2020-07-21","19","1291","4","136","14.7","22.3"
"Brantley","2020-07-22","20","1311","4","140","15.7","23.1"
"Brantley","2020-07-23","24","1335","2","142","16.1","22.3"
"Brantley","2020-07-24","21","1356","9","151","21.7","24.9"
"Brantley","2020-07-25","5","1361","1","152","21.5","20.2"
"Brantley","2020-07-26","4","1365","1","153","21.5","18.7"
"Brantley","2020-07-27","34","1399","3","156","20.9","17.8"
"Brantley","2020-07-28","34","1433","8","164","21.2","18"
"Brantley","2020-07-29","23","1456","2","166","19.6","17.7"
"Brantley","2020-07-30","19","1475","2","168","19.9","18"
"Brantley","2020-07-31","10","1485","4","172","19.5","20.6"
"Brantley","2020-08-01","16","1501","1","173","17.5","19.5"
"Brantley","2020-08-02","5","1506","1","174","16.8","19.2"
"Brantley","2020-08-03","31","1537","3","177","17","18.9"
"Brantley","2020-08-04","24","1561","2","179","14.8","18"
"Brantley","2020-08-05","34","1595","3","182","14.8","17.2"
"Brantley","2020-08-06","26","1621","5","187","16","18"
"Brantley","2020-08-07","21","1642","2","189","11.7","15.6"
"Brantley","2020-08-08","15","1657","2","191","12.7","15.1"
"Brantley","2020-08-09","14","1671","3","194","12.9","14.9"
"Brantley","2020-08-10","33","1704","4","198","13.3","15.1"
"Brantley","2020-08-11","41","1745","6","204","14.2","14.5"
"Brantley","2020-08-12","28","1773","1","205","13.4","14.1"
"Brantley","2020-08-13","29","1802","3","208","12.1","14.1"
"Brantley","2020-08-14","20","1822","0","208","10.8","11.2"
"Brantley","2020-08-15","14","1836","2","210","10.9","11.8"
"Brantley","2020-08-16","13","1849","4","214","12.2","12.6"
"Brantley","2020-08-17","33","1882","2","216","11.4","12.3"
"Brantley","2020-08-18","32","1914","0","216","9.3","11.7"
"Brantley","2020-08-19","36","1950","1","217","9.2","11.3"
"Brantley","2020-08-20","22","1972","5","222","10.9","11.5"
"Brantley","2020-08-21","28","2000","0","222","10.9","10.9"
"Brantley","2020-08-22","13","2013","1","223","10","10.5"
"Brantley","2020-08-23","8","2021","0","223","5.6","8.9"
"Brantley","2020-08-24","40","2061","2","225","5.5","8.4"
"Brantley","2020-08-25","35","2096","2","227","6.3","7.8"
"Brantley","2020-08-26","37","2133","4","231","7.4","8.3"
"Brantley","2020-08-27","22","2155","3","234","6.1","8.5"
"Brantley","2020-08-28","32","2187","5","239","8.4","9.6"
"Brantley","2020-08-29","20","2207","5","244","10.8","10.4"
"Brantley","2020-08-30","12","2219","1","245","12","8.8"
"Brantley","2020-08-31","24","2243","0","245","11.3","8.4"
"Brantley","2020-09-01","32","2275","1","246","10.9","8.6"
"Brantley","2020-09-02","21","2296","0","246","9.4","8.4"
"Brantley","2020-09-03","34","2330","3","249","8.7","7.4"
"Brantley","2020-09-04","11","2341","1","250","7.8","8.1"
"Brantley","2020-09-05","10","2351","0","250","4.2","7.5"
"Brantley","2020-09-06","4","2355","2","252","10.1","11.1"
"Brantley","2020-09-07","17","2372","0","252","10.1","10.7"
"Brantley","2020-09-08","39","2411","0","252","9.7","10.3"
"Brantley","2020-09-09","27","2438","2","254","10.8","10.1"
"Brantley","2020-09-10","26","2464","0","254","9.5","9.1"
"Brantley","2020-09-11","14","2478","2","256","10.2","9"
"Brantley","2020-09-12","13","2491","2","258","12.4","8.3"
"Brantley","2020-09-13","10","2501","1","259","6.7","8.4"
"Brantley","2020-09-14","30","2531","1","260","7.2","8.7"
"Brantley","2020-09-15","37","2568","1","261","7.6","8.6"
"Brantley","2020-09-16","27","2595","0","261","6.5","8.6"
"Brantley","2020-09-17","18","2613","0","261","6.5","8"
"Brantley","2020-09-18","25","2638","3","264","6.2","8.2"
"Brantley","2020-09-19","10","2648","0","264","4","8.2"
"Brantley","2020-09-20","7","2655","0","264","2.6","4.7"
"Brantley","2020-09-21","26","2681","1","265","2.6","4.9"
"Brantley","2020-09-22","34","2715","4","269","3.9","5.8"
"Brantley","2020-09-23","23","2738","1","270","4.6","5.5"
"Brantley","2020-09-24","20","2758","2","272","6","6.3"
"Brantley","2020-09-25","13","2771","0","272","4.3","5.2"
"Brantley","2020-09-26","12","2783","0","272","4.3","4.1"
"Brantley","2020-09-27","9","2792","2","274","7.5","5"
"Brantley","2020-09-28","23","2815","0","274","6.9","4.8"
"Brantley","2020-09-29","21","2836","4","278","7.9","5.9"
"Brantley","2020-09-30","26","2862","1","279","7.9","6.2"
"Brantley","2020-10-01","13","2875","0","279","6.4","6.2"
"Brantley","2020-10-02","19","2894","2","281","7.9","6.1"
"Brantley","2020-10-03","6","2900","1","282","10.3","7.3"
"Brantley","2020-10-04","9","2909","0","282","7.2","7.3"
"Brantley","2020-10-05","36","2945","4","286","8.7","7.8"
"Brantley","2020-10-06","38","2983","5","291","7.9","7.9"
"Brantley","2020-10-07","38","3021","3","294","8.5","8.2"
"Brantley","2020-10-08","37","3058","4","298","10","8.2"
"Brantley","2020-10-09","16","3074","3","301","11.2","9.6"
"Brantley","2020-10-10","14","3088","3","304","11.9","11.1"
"Brantley","2020-10-11","6","3094","0","304","11.9","9.5"
"Brantley","2020-10-12","38","3132","5","309","12.2","10.5"
"Brantley","2020-10-13","30","3162","4","313","12.2","10"
"Brantley","2020-10-14","51","3213","7","320","13","10.8"
"Brantley","2020-10-15","31","3244","3","323","12.9","11.4"
"Brantley","2020-10-16","21","3265","4","327","12.9","12.1"
"Brantley","2020-10-17","11","3276","3","330","13.7","12.8"
"Brantley","2020-10-18","8","3284","1","331","15.5","13.7"
"Brantley","2020-10-19","42","3326","4","335","15","13.6"
"Brantley","2020-10-20","25","3351","2","337","14.2","13.2"
"Brantley","2020-10-21","41","3392","0","337","12.3","12.7"
"Brantley","2020-10-22","24","3416","2","339","12.1","12.5"
"Brantley","2020-10-23","25","3441","2","341","10.5","11.7"
"Brantley","2020-10-24","12","3453","1","342","7.8","10.8"
"Brantley","2020-10-25","9","3462","1","343","7.6","11.6"
"Brantley","2020-10-26","35","3497","3","346","7.5","11.2"
"Brantley","2020-10-27","27","3524","0","346","6.3","10.3"
"Brantley","2020-10-28","43","3567","6","352","8.3","10.3"
"Brantley","2020-10-29","26","3593","0","352","7.1","9.6"
"Brantley","2020-10-30","22","3615","3","355","7.9","9.2"
"Brantley","2020-10-31","11","3626","1","356","8.1","7.9"
"Brantley","2020-11-01","10","3636","1","357","7.9","7.8"
"Brantley","2020-11-02","38","3674","1","358","7","7.3"
"Brantley","2020-11-03","28","3702","3","361","8.6","7.5"
"Brantley","2020-11-04","31","3733","0","361","6.6","7.5"
"Brantley","2020-11-05","23","3756","2","363","7.8","7.5"
"Brantley","2020-11-06","17","3773","1","364","6.7","7.3"
"Brantley","2020-11-07","10","3783","1","365","6.8","7.4"
"Brantley","2020-11-08","7","3790","1","366","7.5","7.7"
"Brantley","2020-11-09","25","3815","1","367","7.7","7.3"
"Brantley","2020-11-10","22","3837","3","370","8.1","8.3"
"Brantley","2020-11-11","21","3858","3","373","10.1","8.3"
"Brantley","2020-11-12","32","3890","0","373","8.9","8.3"
"Brantley","2020-11-13","23","3913","1","374","8.7","7.7"
"Brantley","2020-11-14","11","3924","1","375","8.5","7.7"
"Brantley","2020-11-15","6","3930","1","376","8.9","8.2"
"Brantley","2020-11-16","28","3958","3","379","9.8","8.7"
"Brantley","2020-11-17","35","3993","5","384","9.9","9"
"Brantley","2020-11-18","44","4037","2","386","8.5","9.3"
"Brantley","2020-11-19","24","4061","6","392","12.1","10.5"
"Brantley","2020-11-20","23","4084","1","393","12.1","10.4"
"Brantley","2020-11-21","8","4092","1","394","12.6","10.6"
"Brantley","2020-11-22","14","4106","0","394","10.2","9.5"
"Brantley","2020-11-23","36","4142","3","397","9.9","9.8"
"Brantley","2020-11-24","25","4167","5","402","10.7","10.3"
"Brantley","2020-11-25","35","4202","4","406","11.7","10.1"
"Brantley","2020-11-26","10","4212","3","409","12.4","12.2"
"Brantley","2020-11-27","21","4233","2","411","13.1","12.6"
"Brantley","2020-11-28","20","4253","4","415","14.2","13.4"
"Brantley","2020-11-29","10","4263","1","416","15.6","12.9"
"Brantley","2020-11-30","31","4294","1","417","14.9","12.4"
"Brantley","2020-12-01","26","4320","4","421","14.2","12.4"
"Brantley","2020-12-02","22","4342","2","423","13.9","12.8"
"Brantley","2020-12-03","17","4359","1","424","10.4","11.4"
"Brantley","2020-12-04","29","4388","3","427","10.6","11.8"
"Brantley","2020-12-05","12","4400","2","429","10.1","12.1"
"Brantley","2020-12-06","11","4411","2","431","11.3","13.4"
"Brantley","2020-12-07","38","4449","6","437","13","14"
"Brantley","2020-12-08","27","4476","4","441","13","13.6"
"Brantley","2020-12-09","41","4517","4","445","13.1","13.5"
"Brantley","2020-12-10","14","4531","1","446","13.2","11.8"
"Brantley","2020-12-11","113","4644","3","449","12.1","11.4"
"Brantley","2020-12-12","16","4660","4","453","13.3","11.7"
"Brantley","2020-12-13","9","4669","2","455","13.9","12.6"
"Brantley","2020-12-14","37","4706","5","460","13.6","13.3"
"Brantley","2020-12-15","36","4742","1","461","11.9","12.4"
"Brantley","2020-12-16","47","4789","3","464","11.4","12.2"
"Brantley","2020-12-17","20","4809","3","467","12.5","12.9"
"Brantley","2020-12-18","23","4832","3","470","14","13.1"
"Brantley","2020-12-19","11","4843","2","472","13","13.2"
"Brantley","2020-12-20","92","4935","8","480","11.1","12.5"
"Brantley","2020-12-21","25","4960","3","483","10.9","12.2"
"Brantley","2020-12-22","45","5005","8","491","13","12.4"
"Brantley","2020-12-23","33","5038","7","498","15.1","13.3"
"Brantley","2020-12-24","29","5067","4","502","15","13.7"
"Brantley","2020-12-25","11","5078","2","504","15.7","14.8"
"Brantley","2020-12-26","17","5095","2","506","14.8","13.9"
"Brantley","2020-12-27","14","5109","3","509","16.6","13.8"
"Brantley","2020-12-28","33","5142","7","516","17.9","14.4"
"Brantley","2020-12-29","45","5187","5","521","17","15"
"Brantley","2020-12-30","47","5234","6","527","15.8","15.4"
"Brantley","2020-12-31","19","5253","4","531","16.8","15.9"
"Brantley","2021-01-01","8","5261","2","533","17.8","16.7"
"Brantley","2021-01-02","17","5278","4","537","19.4","17.1"
"Brantley","2021-01-03","12","5290","5","542","22.3","19.5"
"Brantley","2021-01-04","27","5317","4","546","21.4","19.7"
"Brantley","2021-01-05","52","5369","7","553","21.8","19.4"
"Brantley","2021-01-06","55","5424","3","556","20.7","18.2"
"Brantley","2021-01-07","44","5468","5","561","19.3","18.1"
"Brantley","2021-01-08","29","5497","4","565","17.7","17.7"
"Brantley","2021-01-09","16","5513","3","568","17","18.2"
"Brantley","2021-01-10","8","5521","1","569","12.9","17.6"
"Brantley","2021-01-11","44","5565","7","576","13","17.2"
"Brantley","2021-01-12","37","5602","7","583","13.8","17.8"
"Brantley","2021-01-13","37","5639","2","585","13.8","17.3"
"Brantley","2021-01-14","38","5677","4","589","13.7","16.5"
"Brantley","2021-01-15","41","5718","7","596","14.2","15.9"
"Brantley","2021-01-16","12","5730","1","597","12.7","14.9"
"Brantley","2021-01-17","13","5743","5","602","16.4","14.6"
"Brantley","2021-01-18","43","5786","8","610","16.8","14.9"
"Brantley","2021-01-19","48","5834","10","620","17","15.4"
"Brantley","2021-01-20","40","5874","9","629","19.5","16.6"
"Brantley","2021-01-21","42","5916","5","634","19.7","16.7"
"Brantley","2021-01-22","35","5951","2","636","18.1","16.1"
"Brantley","2021-01-23","17","5968","4","640","20.2","16.4"
"Brantley","2021-01-24","3","5971","1","641","19.5","17.9"
"Brantley","2021-01-25","29","6000","6","647","19.8","18.3"
"Brantley","2021-01-26","2","6002","0","647","16.8","16.9"
"Brantley","2021-01-27","0","6002","0","647","13.6","16.5"
"Brooks","2020-02-01","0","0","0","0",".","."
"Brooks","2020-02-02","0","0","0","0",".","."
"Brooks","2020-02-03","0","0","0","0",".","."
"Brooks","2020-02-04","0","0","0","0",".","."
"Brooks","2020-02-05","0","0","0","0",".","."
"Brooks","2020-02-06","0","0","0","0",".","."
"Brooks","2020-02-07","0","0","0","0","0","."
"Brooks","2020-02-08","0","0","0","0","0","."
"Brooks","2020-02-09","0","0","0","0","0","."
"Brooks","2020-02-10","0","0","0","0","0","."
"Brooks","2020-02-11","0","0","0","0","0","."
"Brooks","2020-02-12","0","0","0","0","0","."
"Brooks","2020-02-13","0","0","0","0","0","."
"Brooks","2020-02-14","0","0","0","0","0","0"
"Brooks","2020-02-15","0","0","0","0","0","0"
"Brooks","2020-02-16","0","0","0","0","0","0"
"Brooks","2020-02-17","0","0","0","0","0","0"
"Brooks","2020-02-18","0","0","0","0","0","0"
"Brooks","2020-02-19","0","0","0","0","0","0"
"Brooks","2020-02-20","0","0","0","0","0","0"
"Brooks","2020-02-21","0","0","0","0","0","0"
"Brooks","2020-02-22","0","0","0","0","0","0"
"Brooks","2020-02-23","0","0","0","0","0","0"
"Brooks","2020-02-24","0","0","0","0","0","0"
"Brooks","2020-02-25","0","0","0","0","0","0"
"Brooks","2020-02-26","0","0","0","0","0","0"
"Brooks","2020-02-27","0","0","0","0","0","0"
"Brooks","2020-02-28","0","0","0","0","0","0"
"Brooks","2020-02-29","0","0","0","0","0","0"
"Brooks","2020-03-01","0","0","0","0","0","0"
"Brooks","2020-03-02","0","0","0","0","0","0"
"Brooks","2020-03-03","0","0","0","0","0","0"
"Brooks","2020-03-04","0","0","0","0","0","0"
"Brooks","2020-03-05","0","0","0","0","0","0"
"Brooks","2020-03-06","0","0","0","0","0","0"
"Brooks","2020-03-07","0","0","0","0","0","0"
"Brooks","2020-03-08","0","0","0","0","0","0"
"Brooks","2020-03-09","0","0","0","0","0","0"
"Brooks","2020-03-10","0","0","0","0","0","0"
"Brooks","2020-03-11","0","0","0","0","0","0"
"Brooks","2020-03-12","0","0","0","0","0","0"
"Brooks","2020-03-13","0","0","0","0","0","0"
"Brooks","2020-03-14","0","0","0","0","0","0"
"Brooks","2020-03-15","0","0","0","0","0","0"
"Brooks","2020-03-16","1","1","0","0","0","0"
"Brooks","2020-03-17","0","1","0","0","0","0"
"Brooks","2020-03-18","0","1","0","0","0","0"
"Brooks","2020-03-19","1","2","0","0","0","0"
"Brooks","2020-03-20","0","2","0","0","0","0"
"Brooks","2020-03-21","0","2","0","0","0","0"
"Brooks","2020-03-22","1","3","0","0","0","0"
"Brooks","2020-03-23","1","4","0","0","0","0"
"Brooks","2020-03-24","2","6","1","1","7.1","3.6"
"Brooks","2020-03-25","2","8","0","1","7.1","3.6"
"Brooks","2020-03-26","5","13","1","2","10","5"
"Brooks","2020-03-27","2","15","0","2","10","5"
"Brooks","2020-03-28","1","16","1","3","24.3","12.1"
"Brooks","2020-03-29","0","16","0","3","24.3","12.1"
"Brooks","2020-03-30","16","32","11","14","34.1","17.1"
"Brooks","2020-03-31","1","33","1","15","41.3","24.2"
"Brooks","2020-04-01","2","35","2","17","55.5","31.3"
"Brooks","2020-04-02","5","40","3","20","61.3","35.6"
"Brooks","2020-04-03","0","40","0","20","61.3","35.6"
"Brooks","2020-04-04","1","41","0","20","47","35.6"
"Brooks","2020-04-05","1","42","1","21","61.3","42.8"
"Brooks","2020-04-06","5","47","1","22","54.3","44.2"
"Brooks","2020-04-07","2","49","1","23","47.1","44.2"
"Brooks","2020-04-08","3","52","0","23","32.9","44.2"
"Brooks","2020-04-09","2","54","0","23","24.3","42.8"
"Brooks","2020-04-10","0","54","0","23","24.3","42.8"
"Brooks","2020-04-11","2","56","2","25","38.6","42.8"
"Brooks","2020-04-12","2","58","1","26","31.4","46.3"
"Brooks","2020-04-13","0","58","0","26","28.6","41.4"
"Brooks","2020-04-14","6","64","1","27","23.8","35.5"
"Brooks","2020-04-15","9","73","5","32","31.7","32.3"
"Brooks","2020-04-16","3","76","1","33","36.5","30.4"
"Brooks","2020-04-17","5","81","1","34","39.4","31.8"
"Brooks","2020-04-18","0","81","0","34","25.1","31.8"
"Brooks","2020-04-19","39","120","1","35","18.3","24.9"
"Brooks","2020-04-20","2","122","1","36","25.4","27"
"Brooks","2020-04-21","2","124","0","36","23.1","23.4"
"Brooks","2020-04-22","29","153","15","51","22.5","27.1"
"Brooks","2020-04-23","5","158","0","51","17.8","27.1"
"Brooks","2020-04-24","5","163","2","53","20.6","30"
"Brooks","2020-04-25","1","164","1","54","34.9","30"
"Brooks","2020-04-26","4","168","2","56","41.7","30"
"Brooks","2020-04-27","6","174","1","57","36.9","31.2"
"Brooks","2020-04-28","3","177","0","57","36.9","30"
"Brooks","2020-04-29","8","185","3","60","34.9","28.7"
"Brooks","2020-04-30","13","198","0","60","34.9","26.3"
"Brooks","2020-05-01","11","209","2","62","31.8","26.2"
"Brooks","2020-05-02","0","209","0","62","17.5","26.2"
"Brooks","2020-05-03","2","211","1","63","17.5","29.6"
"Brooks","2020-05-04","14","225","0","63","15.1","26"
"Brooks","2020-05-05","23","248","0","63","15.1","26"
"Brooks","2020-05-06","9","257","0","63","9.7","22.3"
"Brooks","2020-05-07","4","261","0","63","9.7","22.3"
"Brooks","2020-05-08","5","266","0","63","7.1","19.5"
"Brooks","2020-05-09","2","268","0","63","7.1","12.3"
"Brooks","2020-05-10","0","268","0","63","0","8.7"
"Brooks","2020-05-11","18","286","0","63","0","7.5"
"Brooks","2020-05-12","21","307","0","63","0","7.5"
"Brooks","2020-05-13","5","312","0","63","0","4.9"
"Brooks","2020-05-14","5","317","0","63","0","4.9"
"Brooks","2020-05-15","7","324","0","63","0","3.6"
"Brooks","2020-05-16","2","326","0","63","0","3.6"
"Brooks","2020-05-17","1","327","1","64","14.3","7.1"
"Brooks","2020-05-18","27","354","1","65","14.8","7.4"
"Brooks","2020-05-19","23","377","0","65","14.8","7.4"
"Brooks","2020-05-20","13","390","4","69","19.2","9.6"
"Brooks","2020-05-21","14","404","0","69","19.2","9.6"
"Brooks","2020-05-22","12","416","0","69","19.2","9.6"
"Brooks","2020-05-23","0","416","0","69","19.2","9.6"
"Brooks","2020-05-24","1","417","0","69","4.9","9.6"
"Brooks","2020-05-25","0","417","0","69","4.4","9.6"
"Brooks","2020-05-26","31","448","0","69","4.4","9.6"
"Brooks","2020-05-27","12","460","1","70","1.2","10.2"
"Brooks","2020-05-28","6","466","0","70","1.2","10.2"
"Brooks","2020-05-29","7","473","1","71","3.2","11.2"
"Brooks","2020-05-30","0","473","0","71","3.2","11.2"
"Brooks","2020-05-31","3","476","2","73","12.8","8.8"
"Brooks","2020-06-01","47","523","4","77","14","9.2"
"Brooks","2020-06-02","25","548","3","80","15.7","10"
"Brooks","2020-06-03","20","568","2","82","15.9","8.6"
"Brooks","2020-06-04","12","580","0","82","15.9","8.6"
"Brooks","2020-06-05","17","597","3","85","16.4","9.8"
"Brooks","2020-06-06","4","601","1","86","20","11.6"
"Brooks","2020-06-07","2","603","0","86","10.5","11.6"
"Brooks","2020-06-08","67","670","2","88","9.7","11.8"
"Brooks","2020-06-09","27","697","0","88","7.9","11.8"
"Brooks","2020-06-10","16","713","3","91","9.2","12.6"
"Brooks","2020-06-11","10","723","0","91","9.2","12.6"
"Brooks","2020-06-12","21","744","0","91","6.7","11.5"
"Brooks","2020-06-13","4","748","0","91","3.1","11.5"
"Brooks","2020-06-14","3","751","0","91","3.1","6.8"
"Brooks","2020-06-15","49","800","9","100","5.3","7.5"
"Brooks","2020-06-16","71","871","5","105","6.3","7.1"
"Brooks","2020-06-17","28","899","4","109","5.7","7.4"
"Brooks","2020-06-18","25","924","3","112","7.4","8.3"
"Brooks","2020-06-19","40","964","13","125","12","9.4"
"Brooks","2020-06-20","11","975","0","125","12","7.6"
"Brooks","2020-06-21","5","980","0","125","12","7.6"
"Brooks","2020-06-22","87","1067","5","130","10.2","7.8"
"Brooks","2020-06-23","32","1099","5","135","11.5","8.9"
"Brooks","2020-06-24","20","1119","3","138","11.6","8.6"
"Brooks","2020-06-25","25","1144","5","143","12.7","10"
"Brooks","2020-06-26","42","1186","16","159","13.5","12.8"
"Brooks","2020-06-27","3","1189","0","159","13.5","12.8"
"Brooks","2020-06-28","7","1196","1","160","15.5","13.8"
"Brooks","2020-06-29","122","1318","18","178","16.8","13.5"
"Brooks","2020-06-30","112","1430","14","192","16.4","13.9"
"Brooks","2020-07-01","50","1480","9","201","16.8","14.2"
"Brooks","2020-07-02","103","1583","9","210","15.2","13.9"
"Brooks","2020-07-03","15","1598","3","213","12.6","13.1"
"Brooks","2020-07-04","0","1598","0","213","12.6","13.1"
"Brooks","2020-07-05","5","1603","0","213","10.6","13.1"
"Brooks","2020-07-06","71","1674","16","229","11.7","14.3"
"Brooks","2020-07-07","78","1752","15","244","12.6","14.5"
"Brooks","2020-07-08","48","1800","2","246","10.7","13.7"
"Brooks","2020-07-09","24","1824","10","256","15.4","15.3"
"Brooks","2020-07-10","11","1835","2","258","15.1","13.9"
"Brooks","2020-07-11","26","1861","11","269","21.2","16.9"
"Brooks","2020-07-12","9","1870","5","274","29.1","19.8"
"Brooks","2020-07-13","74","1944","10","284","27.8","19.7"
"Brooks","2020-07-14","90","2034","10","294","26.6","19.6"
"Brooks","2020-07-15","25","2059","5","299","28.9","19.8"
"Brooks","2020-07-16","37","2096","12","311","27.6","21.5"
"Brooks","2020-07-17","26","2122","11","322","31","23.1"
"Brooks","2020-07-18","6","2128","2","324","29.8","25.5"
"Brooks","2020-07-19","8","2136","6","330","32.5","30.8"
"Brooks","2020-07-20","108","2244","11","341","32.1","29.9"
"Brooks","2020-07-21","108","2352","18","359","32.8","29.7"
"Brooks","2020-07-22","25","2377","9","368","35.1","32"
"Brooks","2020-07-23","36","2413","6","374","32.9","30.2"
"Brooks","2020-07-24","30","2443","6","380","29.7","30.4"
"Brooks","2020-07-25","13","2456","7","387","32.6","31.2"
"Brooks","2020-07-26","8","2464","1","388","23.7","28.1"
"Brooks","2020-07-27","96","2560","8","396","23.4","27.7"
"Brooks","2020-07-28","71","2631","6","402","22.3","27.6"
"Brooks","2020-07-29","24","2655","9","411","22.5","28.8"
"Brooks","2020-07-30","34","2689","5","416","22.2","27.5"
"Brooks","2020-07-31","28","2717","8","424","23.4","26.6"
"Brooks","2020-08-01","11","2728","1","425","17","24.8"
"Brooks","2020-08-02","10","2738","5","430","22.4","23"
"Brooks","2020-08-03","63","2801","6","436","22.5","23"
"Brooks","2020-08-04","77","2878","14","450","23.9","23.1"
"Brooks","2020-08-05","22","2900","1","451","19.2","20.9"
"Brooks","2020-08-06","45","2945","10","461","20.3","21.2"
"Brooks","2020-08-07","15","2960","1","462","17.2","20.3"
"Brooks","2020-08-08","7","2967","2","464","20","18.5"
"Brooks","2020-08-09","11","2978","1","465","14.1","18.2"
"Brooks","2020-08-10","50","3028","3","468","13.6","18.1"
"Brooks","2020-08-11","40","3068","10","478","14.6","19.3"
"Brooks","2020-08-12","12","3080","0","478","13.9","16.6"
"Brooks","2020-08-13","22","3102","6","484","14.7","17.5"
"Brooks","2020-08-14","22","3124","6","490","17.6","17.4"
"Brooks","2020-08-15","6","3130","0","490","13.5","16.7"
"Brooks","2020-08-16","14","3144","6","496","18.3","16.2"
"Brooks","2020-08-17","35","3179","9","505","21.2","17.4"
"Brooks","2020-08-18","35","3214","3","508","18.8","16.7"
"Brooks","2020-08-19","14","3228","2","510","20.9","17.4"
"Brooks","2020-08-20","24","3252","0","510","17","15.8"
"Brooks","2020-08-21","16","3268","3","513","15.7","16.7"
"Brooks","2020-08-22","4","3272","1","514","19.3","16.4"
"Brooks","2020-08-23","4","3276","1","515","16.8","17.6"
"Brooks","2020-08-24","27","3303","10","525","18.4","19.8"
"Brooks","2020-08-25","14","3317","6","531","23.3","21"
"Brooks","2020-08-26","15","3332","3","534","24.1","22.5"
"Brooks","2020-08-27","14","3346","4","538","28.2","22.6"
"Brooks","2020-08-28","13","3359","2","540","27.7","21.7"
"Brooks","2020-08-29","3","3362","0","540","24.1","21.7"
"Brooks","2020-08-30","5","3367","0","540","20.6","18.7"
"Brooks","2020-08-31","32","3399","5","545","17.5","17.9"
"Brooks","2020-09-01","35","3434","0","545","11.4","17.3"
"Brooks","2020-09-02","16","3450","1","546","9.4","16.7"
"Brooks","2020-09-03","14","3464","0","546","5.3","16.7"
"Brooks","2020-09-04","17","3481","2","548","4.8","16.2"
"Brooks","2020-09-05","5","3486","1","549","7.7","15.9"
"Brooks","2020-09-06","6","3492","1","550","10","15.3"
"Brooks","2020-09-07","6","3498","2","552","12.6","15"
"Brooks","2020-09-08","34","3532","3","555","13.8","12.6"
"Brooks","2020-09-09","16","3548","1","556","13.8","11.6"
"Brooks","2020-09-10","18","3566","2","558","15.4","10.4"
"Brooks","2020-09-11","17","3583","3","561","16.3","10.5"
"Brooks","2020-09-12","4","3587","2","563","20.5","14.1"
"Brooks","2020-09-13","4","3591","0","563","18.2","14.1"
"Brooks","2020-09-14","35","3626","6","569","15.9","14.2"
"Brooks","2020-09-15","42","3668","7","576","17","15.4"
"Brooks","2020-09-16","24","3692","1","577","16.7","15.3"
"Brooks","2020-09-17","10","3702","2","579","17.9","16.7"
"Brooks","2020-09-18","14","3716","0","579","15.4","15.8"
"Brooks","2020-09-19","5","3721","0","579","8.3","14.4"
"Brooks","2020-09-20","4","3725","0","579","8.3","13.2"
"Brooks","2020-09-21","44","3769","4","583","7.1","11.5"
"Brooks","2020-09-22","37","3806","5","588","6.7","11.8"
"Brooks","2020-09-23","18","3824","1","589","6.9","11.8"
"Brooks","2020-09-24","14","3838","3","592","7.1","12.5"
"Brooks","2020-09-25","12","3850","2","594","9.5","12.4"
"Brooks","2020-09-26","4","3854","0","594","9.5","8.9"
"Brooks","2020-09-27","2","3856","1","595","16.6","12.4"
"Brooks","2020-09-28","28","3884","0","595","15.3","11.2"
"Brooks","2020-09-29","20","3904","0","595","13.4","10"
"Brooks","2020-09-30","16","3920","0","595","12.6","9.7"
"Brooks","2020-10-01","18","3938","3","598","11.9","9.5"
"Brooks","2020-10-02","13","3951","3","601","12.8","11.1"
"Brooks","2020-10-03","2","3953","0","601","12.8","11.1"
"Brooks","2020-10-04","4","3957","0","601","5.7","11.1"
"Brooks","2020-10-05","23","3980","0","601","5.7","10.5"
"Brooks","2020-10-06","26","4006","0","601","5.7","9.5"
"Brooks","2020-10-07","18","4024","0","601","5.7","9.1"
"Brooks","2020-10-08","22","4046","2","603","4.6","8.3"
"Brooks","2020-10-09","26","4072","0","603","1.3","7.1"
"Brooks","2020-10-10","6","4078","0","603","1.3","7.1"
"Brooks","2020-10-11","3","4081","0","603","1.3","3.5"
"Brooks","2020-10-12","15","4096","1","604","2.3","4"
"Brooks","2020-10-13","25","4121","1","605","2.8","4.3"
"Brooks","2020-10-14","21","4142","6","611","6.9","6.3"
"Brooks","2020-10-15","13","4155","2","613","7.8","6.2"
"Brooks","2020-10-16","12","4167","1","614","9","5.1"
"Brooks","2020-10-17","9","4176","3","617","13.8","7.5"
"Brooks","2020-10-18","4","4180","0","617","13.8","7.5"
"Brooks","2020-10-19","34","4214","1","618","13.2","7.7"
"Brooks","2020-10-20","21","4235","3","621","14.7","8.8"
"Brooks","2020-10-21","7","4242","0","621","10.6","8.8"
"Brooks","2020-10-22","28","4270","2","623","9.4","8.6"
"Brooks","2020-10-23","10","4280","0","623","8.2","8.6"
"Brooks","2020-10-24","5","4285","0","623","3.5","8.6"
"Brooks","2020-10-25","7","4292","0","623","3.5","8.6"
"Brooks","2020-10-26","20","4312","1","624","3.8","8.5"
"Brooks","2020-10-27","15","4327","0","624","1.7","8.2"
"Brooks","2020-10-28","18","4345","0","624","1.7","6.2"
"Brooks","2020-10-29","13","4358","1","625","1.8","5.6"
"Brooks","2020-10-30","10","4368","0","625","1.8","5"
"Brooks","2020-10-31","4","4372","0","625","1.8","2.6"
"Brooks","2020-11-01","4","4376","1","626","5.4","4.4"
"Brooks","2020-11-02","17","4393","1","627","5.5","4.6"
"Brooks","2020-11-03","12","4405","0","627","5.5","3.6"
"Brooks","2020-11-04","20","4425","0","627","5.5","3.6"
"Brooks","2020-11-05","11","4436","1","628","5.7","3.8"
"Brooks","2020-11-06","14","4450","0","628","5.7","3.8"
"Brooks","2020-11-07","5","4455","0","628","5.7","3.8"
"Brooks","2020-11-08","5","4460","1","629","5","5.2"
"Brooks","2020-11-09","17","4477","0","629","4.2","4.8"
"Brooks","2020-11-10","19","4496","1","630","4.9","5.2"
"Brooks","2020-11-11","12","4508","1","631","6.1","5.8"
"Brooks","2020-11-12","7","4515","0","631","4.8","5.3"
"Brooks","2020-11-13","10","4525","1","632","6.2","6"
"Brooks","2020-11-14","8","4533","0","632","6.2","6"
"Brooks","2020-11-15","4","4537","0","632","3.4","4.2"
"Brooks","2020-11-16","25","4562","5","637","6.2","5.2"
"Brooks","2020-11-17","25","4587","0","637","5.5","5.2"
"Brooks","2020-11-18","13","4600","1","638","5.4","5.7"
"Brooks","2020-11-19","18","4618","0","638","5.4","5.1"
"Brooks","2020-11-20","15","4633","1","639","4.9","5.6"
"Brooks","2020-11-21","7","4640","2","641","9","7.6"
"Brooks","2020-11-22","6","4646","0","641","9","6.2"
"Brooks","2020-11-23","11","4657","2","643","8.7","7.5"
"Brooks","2020-11-24","26","4683","5","648","11.5","8.5"
"Brooks","2020-11-25","19","4702","6","654","14.9","10.1"
"Brooks","2020-11-26","6","4708","2","656","19.7","12.5"
"Brooks","2020-11-27","10","4718","3","659","23","13.9"
"Brooks","2020-11-28","10","4728","4","663","24.6","16.8"
"Brooks","2020-11-29","6","4734","1","664","27","18"
"Brooks","2020-11-30","56","4790","20","684","29.5","19.1"
"Brooks","2020-12-01","55","4845","15","699","30.7","21.1"
"Brooks","2020-12-02","22","4867","6","705","30","22.5"
"Brooks","2020-12-03","18","4885","4","709","28.4","24.1"
"Brooks","2020-12-04","18","4903","5","714","28.1","25.6"
"Brooks","2020-12-05","8","4911","2","716","26","25.3"
"Brooks","2020-12-06","7","4918","0","716","23.6","25.3"
"Brooks","2020-12-07","28","4946","6","722","21.6","25.5"
"Brooks","2020-12-08","55","5001","6","728","19.2","24.9"
"Brooks","2020-12-09","27","5028","6","734","18.5","24.3"
"Brooks","2020-12-10","29","5057","7","741","18.8","23.6"
"Brooks","2020-12-11","21","5078","5","746","18.2","23.2"
"Brooks","2020-12-12","16","5094","8","754","21.8","23.9"
"Brooks","2020-12-13","9","5103","3","757","26.5","25.1"
"Brooks","2020-12-14","36","5139","8","765","26.7","24.1"
"Brooks","2020-12-15","71","5210","6","771","26.3","22.8"
"Brooks","2020-12-16","26","5236","4","775","25.3","21.9"
"Brooks","2020-12-17","21","5257","3","778","23.9","21.4"
"Brooks","2020-12-18","28","5285","5","783","23.1","20.6"
"Brooks","2020-12-19","11","5296","2","785","18.5","20.2"
"Brooks","2020-12-20","13","5309","3","788","17.1","21.8"
"Brooks","2020-12-21","29","5338","6","794","16.8","21.8"
"Brooks","2020-12-22","84","5422","17","811","18.5","22.4"
"Brooks","2020-12-23","11","5433","3","814","20.2","22.8"
"Brooks","2020-12-24","12","5445","2","816","20.6","22.2"
"Brooks","2020-12-25","5","5450","2","818","23.7","23.4"
"Brooks","2020-12-26","9","5459","0","818","21.1","19.8"
"Brooks","2020-12-27","9","5468","3","821","22.6","19.8"
"Brooks","2020-12-28","33","5501","8","829","23.1","20"
"Brooks","2020-12-29","73","5574","14","843","23","20.7"
"Brooks","2020-12-30","26","5600","3","846","20.7","20.5"
"Brooks","2020-12-31","17","5617","3","849","20.8","20.7"
"Brooks","2021-01-01","7","5624","3","852","21.3","22.5"
"Brooks","2021-01-02","3","5627","0","852","21.3","21.2"
"Brooks","2021-01-03","8","5635","1","853","18.3","20.4"
"Brooks","2021-01-04","26","5661","8","861","19.2","21.2"
"Brooks","2021-01-05","78","5739","17","878","19.6","21.3"
"Brooks","2021-01-06","24","5763","6","884","21.5","21.1"
"Brooks","2021-01-07","20","5783","6","890","23.3","22.1"
"Brooks","2021-01-08","14","5797","3","893","20.2","20.7"
"Brooks","2021-01-09","10","5807","2","895","23.1","22.2"
"Brooks","2021-01-10","8","5815","0","895","21.3","19.8"
"Brooks","2021-01-11","23","5838","5","900","20","19.6"
"Brooks","2021-01-12","65","5903","7","907","18.4","19"
"Brooks","2021-01-13","21","5924","5","912","18.2","19.9"
"Brooks","2021-01-14","18","5942","5","917","17.9","20.6"
"Brooks","2021-01-15","15","5957","1","918","15.8","18"
"Brooks","2021-01-16","4","5961","3","921","23.7","23.4"
"Brooks","2021-01-17","9","5970","1","922","25.3","23.3"
"Brooks","2021-01-18","18","5988","3","925","24.5","22.3"
"Brooks","2021-01-19","20","6008","3","928","25.1","21.8"
"Brooks","2021-01-20","23","6031","2","930","23","20.6"
"Brooks","2021-01-21","9","6040","4","934","25.4","21.7"
"Brooks","2021-01-22","19","6059","2","936","25.9","20.9"
"Brooks","2021-01-23","6","6065","0","936","15.2","19.4"
"Brooks","2021-01-24","2","6067","1","937","20.8","23"
"Brooks","2021-01-25","12","6079","5","942","24.3","24.4"
"Brooks","2021-01-26","0","6079","0","942","22.2","23.7"
"Brooks","2021-01-27","0","6079","0","942","20.9","22"
"Bryan","2020-02-01","0","0","0","0",".","."
"Bryan","2020-02-02","0","0","0","0",".","."
"Bryan","2020-02-03","0","0","0","0",".","."
"Bryan","2020-02-04","0","0","0","0",".","."
"Bryan","2020-02-05","0","0","0","0",".","."
"Bryan","2020-02-06","0","0","0","0",".","."
"Bryan","2020-02-07","0","0","0","0","0","."
"Bryan","2020-02-08","0","0","0","0","0","."
"Bryan","2020-02-09","0","0","0","0","0","."
"Bryan","2020-02-10","0","0","0","0","0","."
"Bryan","2020-02-11","0","0","0","0","0","."
"Bryan","2020-02-12","0","0","0","0","0","."
"Bryan","2020-02-13","0","0","0","0","0","."
"Bryan","2020-02-14","0","0","0","0","0","0"
"Bryan","2020-02-15","0","0","0","0","0","0"
"Bryan","2020-02-16","0","0","0","0","0","0"
"Bryan","2020-02-17","0","0","0","0","0","0"
"Bryan","2020-02-18","0","0","0","0","0","0"
"Bryan","2020-02-19","0","0","0","0","0","0"
"Bryan","2020-02-20","0","0","0","0","0","0"
"Bryan","2020-02-21","0","0","0","0","0","0"
"Bryan","2020-02-22","0","0","0","0","0","0"
"Bryan","2020-02-23","0","0","0","0","0","0"
"Bryan","2020-02-24","0","0","0","0","0","0"
"Bryan","2020-02-25","0","0","0","0","0","0"
"Bryan","2020-02-26","0","0","0","0","0","0"
"Bryan","2020-02-27","0","0","0","0","0","0"
"Bryan","2020-02-28","0","0","0","0","0","0"
"Bryan","2020-02-29","0","0","0","0","0","0"
"Bryan","2020-03-01","0","0","0","0","0","0"
"Bryan","2020-03-02","0","0","0","0","0","0"
"Bryan","2020-03-03","0","0","0","0","0","0"
"Bryan","2020-03-04","0","0","0","0","0","0"
"Bryan","2020-03-05","0","0","0","0","0","0"
"Bryan","2020-03-06","0","0","0","0","0","0"
"Bryan","2020-03-07","0","0","0","0","0","0"
"Bryan","2020-03-08","0","0","0","0","0","0"
"Bryan","2020-03-09","0","0","0","0","0","0"
"Bryan","2020-03-10","0","0","0","0","0","0"
"Bryan","2020-03-11","3","3","0","0","0","0"
"Bryan","2020-03-12","1","4","0","0","0","0"
"Bryan","2020-03-13","4","8","0","0","0","0"
"Bryan","2020-03-14","0","8","0","0","0","0"
"Bryan","2020-03-15","0","8","0","0","0","0"
"Bryan","2020-03-16","13","21","0","0","0","0"
"Bryan","2020-03-17","11","32","0","0","0","0"
"Bryan","2020-03-18","6","38","0","0","0","0"
"Bryan","2020-03-19","9","47","0","0","0","0"
"Bryan","2020-03-20","11","58","1","1","1.3","0.6"
"Bryan","2020-03-21","7","65","1","2","3.3","1.7"
"Bryan","2020-03-22","8","73","2","4","6.9","3.5"
"Bryan","2020-03-23","16","89","4","8","10.5","5.2"
"Bryan","2020-03-24","11","100","2","10","13.1","6.5"
"Bryan","2020-03-25","26","126","1","11","13.6","6.8"
"Bryan","2020-03-26","9","135","2","13","16.8","8.4"
"Bryan","2020-03-27","21","156","1","14","16.2","8.7"
"Bryan","2020-03-28","5","161","2","16","19.9","11.6"
"Bryan","2020-03-29","2","163","1","17","23.4","15.2"
"Bryan","2020-03-30","15","178","1","18","20.8","15.6"
"Bryan","2020-03-31","14","192","3","21","21.3","17.2"
"Bryan","2020-04-01","11","203","1","22","22","17.8"
"Bryan","2020-04-02","10","213","2","24","21.7","19.3"
"Bryan","2020-04-03","20","233","2","26","22.5","19.3"
"Bryan","2020-04-04","14","247","0","26","16.7","18.3"
"Bryan","2020-04-05","3","250","1","27","14.4","18.9"
"Bryan","2020-04-06","13","263","1","28","14.5","17.7"
"Bryan","2020-04-07","35","298","3","31","12.7","17"
"Bryan","2020-04-08","23","321","0","31","11.4","16.7"
"Bryan","2020-04-09","24","345","2","33","9.7","15.7"
"Bryan","2020-04-10","12","357","1","34","9.5","16"
"Bryan","2020-04-11","24","381","3","37","11.3","14"
"Bryan","2020-04-12","6","387","1","38","8.9","11.6"
"Bryan","2020-04-13","10","397","1","39","9.2","11.9"
"Bryan","2020-04-14","5","402","0","39","8","10.3"
"Bryan","2020-04-15","10","412","1","40","9.4","10.4"
"Bryan","2020-04-16","22","434","1","41","8.9","9.3"
"Bryan","2020-04-17","22","456","1","42","8.3","8.9"
"Bryan","2020-04-18","9","465","0","42","6.5","8.9"
"Bryan","2020-04-19","3","468","1","43","8.9","8.9"
"Bryan","2020-04-20","17","485","1","44","8.3","8.8"
"Bryan","2020-04-21","18","503","0","44","8.3","8.2"
"Bryan","2020-04-22","16","519","0","44","6.9","8.2"
"Bryan","2020-04-23","13","532","1","45","7.4","8.1"
"Bryan","2020-04-24","20","552","1","46","7.4","7.9"
"Bryan","2020-04-25","5","557","1","47","10.3","8.4"
"Bryan","2020-04-26","4","561","0","47","5.5","7.2"
"Bryan","2020-04-27","7","568","0","47","4.7","6.5"
"Bryan","2020-04-28","10","578","0","47","4.7","6.5"
"Bryan","2020-04-29","15","593","1","48","5.6","6.3"
"Bryan","2020-04-30","9","602","1","49","6.1","6.7"
"Bryan","2020-05-01","12","614","0","49","5.4","6.4"
"Bryan","2020-05-02","4","618","0","49","2.5","6.4"
"Bryan","2020-05-03","1","619","0","49","2.5","4"
"Bryan","2020-05-04","14","633","0","49","2.5","3.6"
"Bryan","2020-05-05","8","641","0","49","2.5","3.6"
"Bryan","2020-05-06","37","678","0","49","1.6","3.6"
"Bryan","2020-05-07","8","686","0","49","0","3.1"
"Bryan","2020-05-08","13","699","0","49","0","2.7"
"Bryan","2020-05-09","6","705","0","49","0","1.3"
"Bryan","2020-05-10","3","708","0","49","0","1.3"
"Bryan","2020-05-11","9","717","0","49","0","1.3"
"Bryan","2020-05-12","15","732","2","51","1.9","2.2"
"Bryan","2020-05-13","18","750","0","51","1.9","1.7"
"Bryan","2020-05-14","7","757","0","51","1.9","1"
"Bryan","2020-05-15","35","792","0","51","1.9","1"
"Bryan","2020-05-16","1","793","0","51","1.9","1"
"Bryan","2020-05-17","5","798","1","52","4.8","2.4"
"Bryan","2020-05-18","14","812","4","56","8.8","4.4"
"Bryan","2020-05-19","20","832","2","58","8.4","5.1"
"Bryan","2020-05-20","10","842","1","59","9.8","5.9"
"Bryan","2020-05-21","16","858","1","60","10.7","6.3"
"Bryan","2020-05-22","47","905","2","62","11.3","6.6"
"Bryan","2020-05-23","13","918","0","62","11.3","6.6"
"Bryan","2020-05-24","7","925","0","62","8.4","6.6"
"Bryan","2020-05-25","4","929","1","63","7.9","8.4"
"Bryan","2020-05-26","17","946","1","64","7.3","7.9"
"Bryan","2020-05-27","22","968","2","66","7.2","8.5"
"Bryan","2020-05-28","23","991","1","67","6.9","8.8"
"Bryan","2020-05-29","42","1033","1","68","6.7","9"
"Bryan","2020-05-30","11","1044","1","69","8","9.6"
"Bryan","2020-05-31","3","1047","1","70","12.7","10.6"
"Bryan","2020-06-01","43","1090","3","73","10.2","9"
"Bryan","2020-06-02","39","1129","1","74","9.7","8.5"
"Bryan","2020-06-03","25","1154","2","76","9.5","8.4"
"Bryan","2020-06-04","36","1190","0","76","8.9","7.9"
"Bryan","2020-06-05","46","1236","1","77","8.9","7.8"
"Bryan","2020-06-06","20","1256","1","78","8.3","8.1"
"Bryan","2020-06-07","13","1269","0","78","3.5","8.1"
"Bryan","2020-06-08","40","1309","0","78","2.5","6.3"
"Bryan","2020-06-09","28","1337","1","79","2.7","6.2"
"Bryan","2020-06-10","19","1356","0","79","1.5","5.5"
"Bryan","2020-06-11","33","1389","1","80","2","5.4"
"Bryan","2020-06-12","41","1430","2","82","2.4","5.6"
"Bryan","2020-06-13","9","1439","1","83","3.2","5.8"
"Bryan","2020-06-14","17","1456","1","84","4.1","3.8"
"Bryan","2020-06-15","40","1496","1","85","4.4","3.5"
"Bryan","2020-06-16","45","1541","1","86","4.2","3.5"
"Bryan","2020-06-17","34","1575","3","89","5.5","3.5"
"Bryan","2020-06-18","53","1628","9","98","7.5","4.7"
"Bryan","2020-06-19","68","1696","11","109","9.1","5.7"
"Bryan","2020-06-20","32","1728","6","115","10.2","6.7"
"Bryan","2020-06-21","19","1747","5","120","13.1","8.6"
"Bryan","2020-06-22","53","1800","7","127","14.6","9.5"
"Bryan","2020-06-23","58","1858","7","134","16","10.1"
"Bryan","2020-06-24","85","1943","13","147","17","11.2"
"Bryan","2020-06-25","73","2016","8","155","16.1","11.8"
"Bryan","2020-06-26","108","2124","11","166","15.3","12.2"
"Bryan","2020-06-27","78","2202","2","168","12.9","11.6"
"Bryan","2020-06-28","37","2239","3","171","10.3","11.7"
"Bryan","2020-06-29","108","2347","9","180","9.6","12.1"
"Bryan","2020-06-30","141","2488","13","193","9.2","12.6"
"Bryan","2020-07-01","139","2627","19","212","9","13"
"Bryan","2020-07-02","107","2734","10","222","8.8","12.4"
"Bryan","2020-07-03","58","2792","9","231","9.5","12.4"
"Bryan","2020-07-04","40","2832","7","238","11.7","12.3"
"Bryan","2020-07-05","32","2864","7","245","13.6","12"
"Bryan","2020-07-06","102","2966","18","263","15","12.3"
"Bryan","2020-07-07","130","3096","15","278","15.3","12.3"
"Bryan","2020-07-08","127","3223","18","296","15.4","12.2"
"Bryan","2020-07-09","132","3355","14","310","15.6","12.2"
"Bryan","2020-07-10","226","3581","21","331","14.7","12.1"
"Bryan","2020-07-11","70","3651","10","341","14.2","12.9"
"Bryan","2020-07-12","37","3688","3","344","12.2","12.9"
"Bryan","2020-07-13","204","3892","15","359","10.8","12.9"
"Bryan","2020-07-14","102","3994","14","373","11.1","13.2"
"Bryan","2020-07-15","157","4151","19","392","10.8","13.1"
"Bryan","2020-07-16","100","4251","4","396","9.8","12.7"
"Bryan","2020-07-17","146","4397","21","417","10.6","12.6"
"Bryan","2020-07-18","30","4427","5","422","10.9","12.6"
"Bryan","2020-07-19","17","4444","3","425","12.3","12.3"
"Bryan","2020-07-20","61","4505","12","437","14","12.4"
"Bryan","2020-07-21","89","4594","14","451","14.3","12.7"
"Bryan","2020-07-22","43","4637","10","461","15.9","13.3"
"Bryan","2020-07-23","120","4757","10","471","16.5","13.2"
"Bryan","2020-07-24","176","4933","13","484","15.5","13"
"Bryan","2020-07-25","28","4961","6","490","16.2","13.6"
"Bryan","2020-07-26","16","4977","3","493","16.4","14.3"
"Bryan","2020-07-27","89","5066","15","508","16","15"
"Bryan","2020-07-28","118","5184","13","521","15.3","14.8"
"Bryan","2020-07-29","39","5223","6","527","14.2","15"
"Bryan","2020-07-30","137","5360","9","536","13.9","15.2"
"Bryan","2020-07-31","113","5473","7","543","13.7","14.6"
"Bryan","2020-08-01","29","5502","3","546","12.2","14.2"
"Bryan","2020-08-02","19","5521","6","552","14","15.2"
"Bryan","2020-08-03","62","5583","14","566","14.8","15.4"
"Bryan","2020-08-04","118","5701","6","572","14","14.6"
"Bryan","2020-08-05","33","5734","4","576","13.5","13.8"
"Bryan","2020-08-06","108","5842","3","579","13","13.4"
"Bryan","2020-08-07","91","5933","5","584","12.9","13.3"
"Bryan","2020-08-08","23","5956","0","584","11.4","11.8"
"Bryan","2020-08-09","20","5976","1","585","7.6","10.8"
"Bryan","2020-08-10","68","6044","14","599","7.3","11.1"
"Bryan","2020-08-11","111","6155","8","607","7.6","10.8"
"Bryan","2020-08-12","30","6185","2","609","6.8","10.2"
"Bryan","2020-08-13","117","6302","6","615","7.2","10.1"
"Bryan","2020-08-14","88","6390","3","618","6.9","9.9"
"Bryan","2020-08-15","29","6419","2","620","7.8","9.6"
"Bryan","2020-08-16","16","6435","3","623","9.8","8.7"
"Bryan","2020-08-17","66","6501","10","633","9","8.2"
"Bryan","2020-08-18","92","6593","10","643","9.6","8.6"
"Bryan","2020-08-19","36","6629","2","645","9.4","8.1"
"Bryan","2020-08-20","78","6707","3","648","9.2","8.2"
"Bryan","2020-08-21","74","6781","15","663","11.6","9.2"
"Bryan","2020-08-22","19","6800","1","664","11.4","9.6"
"Bryan","2020-08-23","22","6822","2","666","10","9.9"
"Bryan","2020-08-24","41","6863","3","669","8.9","9"
"Bryan","2020-08-25","121","6984","6","675","8","8.8"
"Bryan","2020-08-26","27","7011","3","678","8.8","9.1"
"Bryan","2020-08-27","46","7057","2","680","8.9","9.1"
"Bryan","2020-08-28","101","7158","22","702","9.1","10.4"
"Bryan","2020-08-29","21","7179","5","707","11.8","11.6"
"Bryan","2020-08-30","27","7206","0","707","10.5","10.2"
"Bryan","2020-08-31","41","7247","2","709","10.1","9.5"
"Bryan","2020-09-01","106","7353","6","715","10.2","9.1"
"Bryan","2020-09-02","42","7395","5","720","10.3","9.6"
"Bryan","2020-09-03","49","7444","2","722","10.3","9.6"
"Bryan","2020-09-04","84","7528","11","733","9.1","9.1"
"Bryan","2020-09-05","29","7557","8","741","9.6","10.7"
"Bryan","2020-09-06","22","7579","1","742","10.3","10.4"
"Bryan","2020-09-07","14","7593","2","744","11.6","10.9"
"Bryan","2020-09-08","107","7700","6","750","11.6","10.9"
"Bryan","2020-09-09","54","7754","5","755","11.2","10.8"
"Bryan","2020-09-10","79","7833","5","760","11.5","10.9"
"Bryan","2020-09-11","100","7933","10","770","11.1","10.1"
"Bryan","2020-09-12","26","7959","3","773","8.8","9.2"
"Bryan","2020-09-13","23","7982","2","775","9.4","9.8"
"Bryan","2020-09-14","59","8041","5","780","8.6","10.1"
"Bryan","2020-09-15","99","8140","6","786","8.6","10.1"
"Bryan","2020-09-16","39","8179","9","795","10.6","10.9"
"Bryan","2020-09-17","79","8258","7","802","11","11.2"
"Bryan","2020-09-18","68","8326","6","808","10.8","10.9"
"Bryan","2020-09-19","28","8354","3","811","10.7","9.7"
"Bryan","2020-09-20","24","8378","1","812","10","9.7"
"Bryan","2020-09-21","47","8425","4","816","10","9.3"
"Bryan","2020-09-22","87","8512","9","825","10.6","9.6"
"Bryan","2020-09-23","29","8541","1","826","7.8","9.2"
"Bryan","2020-09-24","79","8620","3","829","7.1","9"
"Bryan","2020-09-25","69","8689","2","831","6.3","8.5"
"Bryan","2020-09-26","19","8708","1","832","5.5","8.1"
"Bryan","2020-09-27","9","8717","1","833","6.5","8.3"
"Bryan","2020-09-28","43","8760","4","837","6.6","8.3"
"Bryan","2020-09-29","80","8840","1","838","5.3","8"
"Bryan","2020-09-30","36","8876","4","842","6.4","7.1"
"Bryan","2020-10-01","66","8942","5","847","6.9","7"
"Bryan","2020-10-02","53","8995","4","851","7.6","6.9"
"Bryan","2020-10-03","30","9025","1","852","7.3","6.4"
"Bryan","2020-10-04","31","9056","3","855","7.1","6.8"
"Bryan","2020-10-05","38","9094","5","860","7.7","7.1"
"Bryan","2020-10-06","110","9204","2","862","7.7","6.5"
"Bryan","2020-10-07","67","9271","3","865","6.8","6.6"
"Bryan","2020-10-08","65","9336","7","872","7.3","7.1"
"Bryan","2020-10-09","60","9396","6","878","7.6","7.6"
"Bryan","2020-10-10","22","9418","1","879","7.8","7.5"
"Bryan","2020-10-11","21","9439","2","881","7.8","7.4"
"Bryan","2020-10-12","46","9485","7","888","8.1","7.9"
"Bryan","2020-10-13","94","9579","3","891","8.2","8"
"Bryan","2020-10-14","37","9616","1","892","8","7.4"
"Bryan","2020-10-15","62","9678","5","897","7.6","7.4"
"Bryan","2020-10-16","76","9754","5","902","7.1","7.4"
"Bryan","2020-10-17","20","9774","4","906","9.3","8.6"
"Bryan","2020-10-18","12","9786","0","906","8","7.9"
"Bryan","2020-10-19","40","9826","2","908","6.5","7.3"
"Bryan","2020-10-20","107","9933","2","910","6.3","7.3"
"Bryan","2020-10-21","33","9966","3","913","7.2","7.6"
"Bryan","2020-10-22","38","10004","12","925","10.6","9.1"
"Bryan","2020-10-23","64","10068","7","932","11.2","9.2"
"Bryan","2020-10-24","22","10090","2","934","9.7","9.5"
"Bryan","2020-10-25","19","10109","3","937","11.9","9.9"
"Bryan","2020-10-26","37","10146","4","941","12.7","9.6"
"Bryan","2020-10-27","92","10238","8","949","13.7","10"
"Bryan","2020-10-28","36","10274","4","953","14","10.6"
"Bryan","2020-10-29","33","10307","2","955","10.4","10.5"
"Bryan","2020-10-30","86","10393","7","962","10","10.6"
"Bryan","2020-10-31","20","10413","5","967","12.2","10.9"
"Bryan","2020-11-01","9","10422","0","967","10","10.9"
"Bryan","2020-11-02","42","10464","3","970","9.4","11.1"
"Bryan","2020-11-03","81","10545","4","974","8.9","11.3"
"Bryan","2020-11-04","35","10580","2","976","8.1","11.1"
"Bryan","2020-11-05","35","10615","2","978","8.1","9.2"
"Bryan","2020-11-06","63","10678","6","984","8.3","9.1"
"Bryan","2020-11-07","18","10696","2","986","6.3","9.3"
"Bryan","2020-11-08","10","10706","1","987","7.7","8.9"
"Bryan","2020-11-09","41","10747","1","988","7.1","8.3"
"Bryan","2020-11-10","41","10788","7","995","8.8","8.9"
"Bryan","2020-11-11","42","10830","5","1000","9.7","8.9"
"Bryan","2020-11-12","49","10879","3","1003","9.7","8.9"
"Bryan","2020-11-13","88","10967","2","1005","8.7","8.5"
"Bryan","2020-11-14","59","11026","7","1012","8.8","7.6"
"Bryan","2020-11-15","18","11044","2","1014","9","8.4"
"Bryan","2020-11-16","69","11113","9","1023","10.5","8.8"
"Bryan","2020-11-17","156","11269","10","1033","9","8.9"
"Bryan","2020-11-18","69","11338","9","1042","9.1","9.4"
"Bryan","2020-11-19","48","11386","4","1046","9.4","9.6"
"Bryan","2020-11-20","121","11507","5","1051","9.7","9.2"
"Bryan","2020-11-21","26","11533","4","1055","10.2","9.5"
"Bryan","2020-11-22","28","11561","0","1055","8.6","8.8"
"Bryan","2020-11-23","51","11612","6","1061","8.4","9.5"
"Bryan","2020-11-24","152","11764","6","1067","8.1","8.5"
"Bryan","2020-11-25","27","11791","3","1070","7.8","8.5"
"Bryan","2020-11-26","4","11795","0","1070","6.6","8"
"Bryan","2020-11-27","14","11809","5","1075","11.1","10.4"
"Bryan","2020-11-28","22","11831","5","1080","12.2","11.2"
"Bryan","2020-11-29","25","11856","6","1086","15.6","12.1"
"Bryan","2020-11-30","45","11901","5","1091","15.5","12"
"Bryan","2020-12-01","171","12072","15","1106","16.2","12.1"
"Bryan","2020-12-02","41","12113","4","1110","16","11.9"
"Bryan","2020-12-03","31","12144","4","1114","17.9","12.2"
"Bryan","2020-12-04","95","12239","3","1117","13.2","12.2"
"Bryan","2020-12-05","25","12264","5","1122","12.8","12.5"
"Bryan","2020-12-06","20","12284","1","1123","10.1","12.9"
"Bryan","2020-12-07","62","12346","3","1126","9.2","12.4"
"Bryan","2020-12-08","151","12497","17","1143","9.6","12.9"
"Bryan","2020-12-09","45","12542","4","1147","9.4","12.7"
"Bryan","2020-12-10","51","12593","4","1151","8.7","13.3"
"Bryan","2020-12-11","97","12690","17","1168","10.8","12"
"Bryan","2020-12-12","22","12712","6","1174","11.8","12.3"
"Bryan","2020-12-13","11","12723","2","1176","13.7","11.9"
"Bryan","2020-12-14","66","12789","10","1186","15.2","12.2"
"Bryan","2020-12-15","178","12967","13","1199","14.6","12.1"
"Bryan","2020-12-16","58","13025","12","1211","16.3","12.9"
"Bryan","2020-12-17","61","13086","16","1227","18.9","13.8"
"Bryan","2020-12-18","122","13208","8","1235","17.3","14.1"
"Bryan","2020-12-19","37","13245","5","1240","15.4","13.6"
"Bryan","2020-12-20","26","13271","4","1244","15","14.3"
"Bryan","2020-12-21","87","13358","13","1257","14.9","15.1"
"Bryan","2020-12-22","156","13514","12","1269","15","14.8"
"Bryan","2020-12-23","39","13553","10","1279","15.7","16"
"Bryan","2020-12-24","38","13591","5","1284","13.8","16.4"
"Bryan","2020-12-25","10","13601","1","1285","14.3","15.8"
"Bryan","2020-12-26","26","13627","6","1291","15.7","15.5"
"Bryan","2020-12-27","30","13657","4","1295","15.4","15.2"
"Bryan","2020-12-28","78","13735","18","1313","16.6","15.8"
"Bryan","2020-12-29","158","13893","16","1329","16.9","16"
"Bryan","2020-12-30","56","13949","14","1343","16.8","16.3"
"Bryan","2020-12-31","36","13985","11","1354","19.3","16.6"
"Bryan","2021-01-01","7","13992","2","1356","22","18.1"
"Bryan","2021-01-02","10","14002","1","1357","20.1","17.9"
"Bryan","2021-01-03","8","14010","2","1359","21.8","18.6"
"Bryan","2021-01-04","58","14068","10","1369","20.9","18.7"
"Bryan","2021-01-05","288","14356","33","1402","21.1","19"
"Bryan","2021-01-06","60","14416","14","1416","20.9","18.9"
"Bryan","2021-01-07","54","14470","11","1427","19.4","19.4"
"Bryan","2021-01-08","130","14600","19","1446","17.4","19.7"
"Bryan","2021-01-09","50","14650","3","1449","16.9","18.5"
"Bryan","2021-01-10","22","14672","3","1452","15.2","18.5"
"Bryan","2021-01-11","69","14741","9","1461","14.6","17.8"
"Bryan","2021-01-12","170","14911","15","1476","14.3","17.7"
"Bryan","2021-01-13","50","14961","7","1483","12.9","16.9"
"Bryan","2021-01-14","82","15043","6","1489","11.1","15.2"
"Bryan","2021-01-15","130","15173","12","1501","10.3","13.9"
"Bryan","2021-01-16","37","15210","7","1508","12.1","14.5"
"Bryan","2021-01-17","32","15242","4","1512","12","13.6"
"Bryan","2021-01-18","78","15320","8","1520","11.6","13.1"
"Bryan","2021-01-19","170","15490","12","1532","11.3","12.8"
"Bryan","2021-01-20","77","15567","7","1539","10.6","11.8"
"Bryan","2021-01-21","95","15662","13","1552","11.5","11.3"
"Bryan","2021-01-22","127","15789","20","1572","12.5","11.4"
"Bryan","2021-01-23","29","15818","2","1574","10.7","11.4"
"Bryan","2021-01-24","17","15835","3","1577","11.5","11.7"
"Bryan","2021-01-25","51","15886","6","1583","11.7","11.6"
"Bryan","2021-01-26","3","15889","1","1584","15.5","13.4"
"Bryan","2021-01-27","0","15889","0","1584","14.2","12.4"
"Bulloch","2020-02-01","0","0","0","0",".","."
"Bulloch","2020-02-02","0","0","0","0",".","."
"Bulloch","2020-02-03","0","0","0","0",".","."
"Bulloch","2020-02-04","0","0","0","0",".","."
"Bulloch","2020-02-05","0","0","0","0",".","."
"Bulloch","2020-02-06","0","0","0","0",".","."
"Bulloch","2020-02-07","0","0","0","0","0","."
"Bulloch","2020-02-08","0","0","0","0","0","."
"Bulloch","2020-02-09","0","0","0","0","0","."
"Bulloch","2020-02-10","0","0","0","0","0","."
"Bulloch","2020-02-11","0","0","0","0","0","."
"Bulloch","2020-02-12","0","0","0","0","0","."
"Bulloch","2020-02-13","0","0","0","0","0","."
"Bulloch","2020-02-14","0","0","0","0","0","0"
"Bulloch","2020-02-15","0","0","0","0","0","0"
"Bulloch","2020-02-16","0","0","0","0","0","0"
"Bulloch","2020-02-17","0","0","0","0","0","0"
"Bulloch","2020-02-18","0","0","0","0","0","0"
"Bulloch","2020-02-19","0","0","0","0","0","0"
"Bulloch","2020-02-20","0","0","0","0","0","0"
"Bulloch","2020-02-21","0","0","0","0","0","0"
"Bulloch","2020-02-22","0","0","0","0","0","0"
"Bulloch","2020-02-23","0","0","0","0","0","0"
"Bulloch","2020-02-24","0","0","0","0","0","0"
"Bulloch","2020-02-25","0","0","0","0","0","0"
"Bulloch","2020-02-26","0","0","0","0","0","0"
"Bulloch","2020-02-27","0","0","0","0","0","0"
"Bulloch","2020-02-28","0","0","0","0","0","0"
"Bulloch","2020-02-29","0","0","0","0","0","0"
"Bulloch","2020-03-01","0","0","0","0","0","0"
"Bulloch","2020-03-02","0","0","0","0","0","0"
"Bulloch","2020-03-03","0","0","0","0","0","0"
"Bulloch","2020-03-04","0","0","0","0","0","0"
"Bulloch","2020-03-05","0","0","0","0","0","0"
"Bulloch","2020-03-06","0","0","0","0","0","0"
"Bulloch","2020-03-07","0","0","0","0","0","0"
"Bulloch","2020-03-08","0","0","0","0","0","0"
"Bulloch","2020-03-09","0","0","0","0","0","0"
"Bulloch","2020-03-10","0","0","0","0","0","0"
"Bulloch","2020-03-11","1","1","0","0","0","0"
"Bulloch","2020-03-12","2","3","0","0","0","0"
"Bulloch","2020-03-13","5","8","0","0","0","0"
"Bulloch","2020-03-14","4","12","0","0","0","0"
"Bulloch","2020-03-15","2","14","0","0","0","0"
"Bulloch","2020-03-16","12","26","0","0","0","0"
"Bulloch","2020-03-17","11","37","0","0","0","0"
"Bulloch","2020-03-18","6","43","0","0","0","0"
"Bulloch","2020-03-19","10","53","0","0","0","0"
"Bulloch","2020-03-20","6","59","0","0","0","0"
"Bulloch","2020-03-21","1","60","0","0","0","0"
"Bulloch","2020-03-22","3","63","0","0","0","0"
"Bulloch","2020-03-23","11","74","0","0","0","0"
"Bulloch","2020-03-24","3","77","0","0","0","0"
"Bulloch","2020-03-25","18","95","1","1","0.8","0.4"
"Bulloch","2020-03-26","17","112","1","2","1.6","0.8"
"Bulloch","2020-03-27","12","124","1","3","2.8","1.4"
"Bulloch","2020-03-28","1","125","0","3","2.8","1.4"
"Bulloch","2020-03-29","1","126","0","3","2.8","1.4"
"Bulloch","2020-03-30","11","137","0","3","2.8","1.4"
"Bulloch","2020-03-31","14","151","1","4","3.8","1.9"
"Bulloch","2020-04-01","12","163","3","7","6.6","3.7"
"Bulloch","2020-04-02","12","175","1","8","7","4.3"
"Bulloch","2020-04-03","15","190","0","8","5.8","4.3"
"Bulloch","2020-04-04","5","195","2","10","11.5","7.2"
"Bulloch","2020-04-05","2","197","0","10","11.5","7.2"
"Bulloch","2020-04-06","21","218","1","11","12.2","7.5"
"Bulloch","2020-04-07","7","225","0","11","11.2","7.5"
"Bulloch","2020-04-08","18","243","0","11","7.6","7.1"
"Bulloch","2020-04-09","25","268","0","11","6.4","6.7"
"Bulloch","2020-04-10","18","286","2","13","8","6.9"
"Bulloch","2020-04-11","3","289","1","14","7","9.3"
"Bulloch","2020-04-12","0","289","0","14","7","9.3"
"Bulloch","2020-04-13","16","305","1","15","7.2","9.7"
"Bulloch","2020-04-14","13","318","2","17","9.4","10.3"
"Bulloch","2020-04-15","13","331","0","17","9.4","8.5"
"Bulloch","2020-04-16","16","347","1","18","10.3","8.4"
"Bulloch","2020-04-17","29","376","0","18","8.7","8.4"
"Bulloch","2020-04-18","8","384","0","18","4","5.5"
"Bulloch","2020-04-19","1","385","0","18","4","5.5"
"Bulloch","2020-04-20","15","400","0","18","3.1","5.2"
"Bulloch","2020-04-21","8","408","0","18","0.9","5.2"
"Bulloch","2020-04-22","8","416","0","18","0.9","5.2"
"Bulloch","2020-04-23","84","500","0","18","0","5.2"
"Bulloch","2020-04-24","16","516","0","18","0","4.4"
"Bulloch","2020-04-25","7","523","0","18","0","2"
"Bulloch","2020-04-26","2","525","0","18","0","2"
"Bulloch","2020-04-27","7","532","0","18","0","1.5"
"Bulloch","2020-04-28","11","543","1","19","1.3","1.1"
"Bulloch","2020-04-29","18","561","0","19","1.3","1.1"
"Bulloch","2020-04-30","11","572","0","19","1.3","0.6"
"Bulloch","2020-05-01","6","578","0","19","1.3","0.6"
"Bulloch","2020-05-02","4","582","0","19","1.3","0.6"
"Bulloch","2020-05-03","0","582","0","19","1.3","0.6"
"Bulloch","2020-05-04","15","597","0","19","1.3","0.6"
"Bulloch","2020-05-05","18","615","0","19","0","0.6"
"Bulloch","2020-05-06","12","627","2","21","2.4","1.8"
"Bulloch","2020-05-07","6","633","1","22","4.8","3"
"Bulloch","2020-05-08","9","642","0","22","4.8","3"
"Bulloch","2020-05-09","1","643","0","22","4.8","3"
"Bulloch","2020-05-10","0","643","0","22","4.8","3"
"Bulloch","2020-05-11","16","659","0","22","4.8","3"
"Bulloch","2020-05-12","17","676","0","22","4.8","2.4"
"Bulloch","2020-05-13","22","698","0","22","2.4","2.4"
"Bulloch","2020-05-14","34","732","0","22","0","2.4"
"Bulloch","2020-05-15","30","762","0","22","0","2.4"
"Bulloch","2020-05-16","1","763","0","22","0","2.4"
"Bulloch","2020-05-17","100","863","1","23","0.1","2.5"
"Bulloch","2020-05-18","69","932","1","24","0.3","2.6"
"Bulloch","2020-05-19","13","945","2","26","2.5","3.7"
"Bulloch","2020-05-20","52","997","1","27","2.8","2.6"
"Bulloch","2020-05-21","63","1060","0","27","2.8","1.4"
"Bulloch","2020-05-22","51","1111","0","27","2.8","1.4"
"Bulloch","2020-05-23","5","1116","0","27","2.8","1.4"
"Bulloch","2020-05-24","4","1120","0","27","2.7","1.4"
"Bulloch","2020-05-25","2","1122","0","27","2.5","1.4"
"Bulloch","2020-05-26","21","1143","0","27","0.3","1.4"
"Bulloch","2020-05-27","35","1178","0","27","0","1.4"
"Bulloch","2020-05-28","25","1203","2","29","1.1","2"
"Bulloch","2020-05-29","18","1221","0","29","1.1","2"
"Bulloch","2020-05-30","2","1223","0","29","1.1","2"
"Bulloch","2020-05-31","3","1226","0","29","1.1","1.9"
"Bulloch","2020-06-01","21","1247","0","29","1.1","1.8"
"Bulloch","2020-06-02","16","1263","0","29","1.1","0.7"
"Bulloch","2020-06-03","26","1289","0","29","1.1","0.6"
"Bulloch","2020-06-04","28","1317","0","29","0","0.6"
"Bulloch","2020-06-05","25","1342","0","29","0","0.6"
"Bulloch","2020-06-06","4","1346","0","29","0","0.6"
"Bulloch","2020-06-07","3","1349","0","29","0","0.6"
"Bulloch","2020-06-08","29","1378","0","29","0","0.6"
"Bulloch","2020-06-09","16","1394","0","29","0","0.6"
"Bulloch","2020-06-10","15","1409","2","31","1.9","1.5"
"Bulloch","2020-06-11","33","1442","0","31","1.9","1"
"Bulloch","2020-06-12","40","1482","0","31","1.9","1"
"Bulloch","2020-06-13","9","1491","1","32","3.5","1.7"
"Bulloch","2020-06-14","8","1499","2","34","7.1","3.5"
"Bulloch","2020-06-15","58","1557","11","45","9.8","4.9"
"Bulloch","2020-06-16","52","1609","3","48","10.6","5.3"
"Bulloch","2020-06-17","57","1666","10","58","11.2","6.6"
"Bulloch","2020-06-18","75","1741","4","62","12","6.9"
"Bulloch","2020-06-19","97","1838","11","73","13.6","7.7"
"Bulloch","2020-06-20","43","1881","14","87","16.6","10.1"
"Bulloch","2020-06-21","18","1899","1","88","13.9","10.5"
"Bulloch","2020-06-22","133","2032","21","109","13.4","11.6"
"Bulloch","2020-06-23","93","2125","15","124","14.9","12.7"
"Bulloch","2020-06-24","111","2236","15","139","14.3","12.8"
"Bulloch","2020-06-25","120","2356","23","162","16.3","14.1"
"Bulloch","2020-06-26","116","2472","6","168","15.4","14.5"
"Bulloch","2020-06-27","87","2559","16","184","13.4","15"
"Bulloch","2020-06-28","27","2586","4","188","14.7","14.3"
"Bulloch","2020-06-29","236","2822","29","217","14.2","13.8"
"Bulloch","2020-06-30","181","3003","22","239","13.6","14.3"
"Bulloch","2020-07-01","151","3154","24","263","14","14.2"
"Bulloch","2020-07-02","160","3314","15","278","12.6","14.4"
"Bulloch","2020-07-03","70","3384","7","285","13.3","14.3"
"Bulloch","2020-07-04","14","3398","2","287","12.7","13"
"Bulloch","2020-07-05","33","3431","5","292","12.7","13.7"
"Bulloch","2020-07-06","184","3615","24","316","12.8","13.5"
"Bulloch","2020-07-07","100","3715","18","334","13.7","13.7"
"Bulloch","2020-07-08","201","3916","26","360","13.3","13.6"
"Bulloch","2020-07-09","109","4025","13","373","13.6","13.1"
"Bulloch","2020-07-10","134","4159","23","396","14.6","14"
"Bulloch","2020-07-11","25","4184","5","401","15.5","14.1"
"Bulloch","2020-07-12","18","4202","1","402","14.1","13.4"
"Bulloch","2020-07-13","108","4310","24","426","15.4","14.1"
"Bulloch","2020-07-14","135","4445","25","451","15.5","14.6"
"Bulloch","2020-07-15","95","4540","13","464","15.6","14.4"
"Bulloch","2020-07-16","133","4673","14","478","15.4","14.5"
"Bulloch","2020-07-17","99","4772","10","488","14.4","14.5"
"Bulloch","2020-07-18","35","4807","8","496","14.8","15.1"
"Bulloch","2020-07-19","14","4821","0","496","14","14"
"Bulloch","2020-07-20","126","4947","31","527","14.3","14.9"
"Bulloch","2020-07-21","77","5024","10","537","13.5","14.5"
"Bulloch","2020-07-22","104","5128","18","555","14.1","14.8"
"Bulloch","2020-07-23","89","5217","16","571","15.1","15.3"
"Bulloch","2020-07-24","95","5312","9","580","15","14.7"
"Bulloch","2020-07-25","30","5342","4","584","13.7","14.2"
"Bulloch","2020-07-26","14","5356","4","588","17.8","15.9"
"Bulloch","2020-07-27","118","5474","20","608","16.7","15.5"
"Bulloch","2020-07-28","50","5524","10","618","17.7","15.6"
"Bulloch","2020-07-29","76","5600","10","628","17.1","15.6"
"Bulloch","2020-07-30","85","5685","15","643","17","16.1"
"Bulloch","2020-07-31","67","5752","6","649","16.9","16"
"Bulloch","2020-08-01","22","5774","5","654","18.3","16"
"Bulloch","2020-08-02","24","5798","5","659","17.2","17.5"
"Bulloch","2020-08-03","43","5841","0","659","14.8","15.7"
"Bulloch","2020-08-04","61","5902","9","668","14","15.8"
"Bulloch","2020-08-05","57","5959","9","677","14.4","15.7"
"Bulloch","2020-08-06","66","6025","10","687","14","15.5"
"Bulloch","2020-08-07","60","6085","9","696","14.9","15.9"
"Bulloch","2020-08-08","35","6120","2","698","12.5","15.4"
"Bulloch","2020-08-09","21","6141","3","701","11.5","14.4"
"Bulloch","2020-08-10","45","6186","3","704","12.5","13.6"
"Bulloch","2020-08-11","39","6225","5","709","12.2","13.1"
"Bulloch","2020-08-12","48","6273","9","718","12.6","13.5"
"Bulloch","2020-08-13","51","6324","3","721","11.3","12.7"
"Bulloch","2020-08-14","54","6378","6","727","10.7","12.8"
"Bulloch","2020-08-15","28","6406","3","730","11.5","12"
"Bulloch","2020-08-16","18","6424","5","735","13.4","12.5"
"Bulloch","2020-08-17","39","6463","5","740","14.3","13.4"
"Bulloch","2020-08-18","34","6497","2","742","13.3","12.7"
"Bulloch","2020-08-19","69","6566","6","748","11.8","12.2"
"Bulloch","2020-08-20","72","6638","7","755","12.4","11.8"
"Bulloch","2020-08-21","71","6709","11","766","13","11.9"
"Bulloch","2020-08-22","24","6733","5","771","14.5","13"
"Bulloch","2020-08-23","26","6759","4","775","12.7","13"
"Bulloch","2020-08-24","69","6828","13","788","13.6","13.9"
"Bulloch","2020-08-25","71","6899","24","812","17.5","15.4"
"Bulloch","2020-08-26","117","7016","38","850","20.9","16.4"
"Bulloch","2020-08-27","113","7129","23","873","22.5","17.4"
"Bulloch","2020-08-28","97","7226","38","911","25.8","19.4"
"Bulloch","2020-08-29","41","7267","11","922","26.7","20.6"
"Bulloch","2020-08-30","33","7300","4","926","26.2","19.5"
"Bulloch","2020-08-31","71","7371","21","947","27.8","20.7"
"Bulloch","2020-09-01","105","7476","14","961","24.8","21.2"
"Bulloch","2020-09-02","80","7556","18","979","23.4","22.2"
"Bulloch","2020-09-03","136","7692","17","996","22.3","22.4"
"Bulloch","2020-09-04","79","7771","22","1018","20.7","23.3"
"Bulloch","2020-09-05","39","7810","6","1024","19","22.9"
"Bulloch","2020-09-06","19","7829","4","1028","20.3","23.3"
"Bulloch","2020-09-07","4","7833","0","1028","16.1","21.9"
"Bulloch","2020-09-08","51","7884","12","1040","17.5","21.2"
"Bulloch","2020-09-09","101","7985","13","1053","16.2","19.8"
"Bulloch","2020-09-10","111","8096","11","1064","15.8","19"
"Bulloch","2020-09-11","56","8152","12","1076","14.9","17.8"
"Bulloch","2020-09-12","34","8186","9","1085","16.5","17.8"
"Bulloch","2020-09-13","29","8215","3","1088","14.9","17.6"
"Bulloch","2020-09-14","51","8266","6","1094","16.6","16.4"
"Bulloch","2020-09-15","168","8434","14","1108","14.4","16"
"Bulloch","2020-09-16","47","8481","7","1115","14.7","15.5"
"Bulloch","2020-09-17","116","8597","10","1125","14.6","15.2"
"Bulloch","2020-09-18","54","8651","3","1128","12.3","13.6"
"Bulloch","2020-09-19","31","8682","3","1131","9.9","13.2"
"Bulloch","2020-09-20","17","8699","2","1133","10.1","12.5"
"Bulloch","2020-09-21","50","8749","5","1138","9.8","13.2"
"Bulloch","2020-09-22","85","8834","3","1141","9.1","11.8"
"Bulloch","2020-09-23","62","8896","6","1147","8.4","11.6"
"Bulloch","2020-09-24","113","9009","6","1153","7.9","11.2"
"Bulloch","2020-09-25","47","9056","5","1158","8.7","10.5"
"Bulloch","2020-09-26","29","9085","1","1159","7.8","8.8"
"Bulloch","2020-09-27","14","9099","1","1160","7.1","8.6"
"Bulloch","2020-09-28","41","9140","1","1161","6","7.9"
"Bulloch","2020-09-29","84","9224","5","1166","6.4","7.8"
"Bulloch","2020-09-30","47","9271","4","1170","6.2","7.3"
"Bulloch","2020-10-01","87","9358","2","1172","5.8","6.9"
"Bulloch","2020-10-02","43","9401","6","1178","6.2","7.5"
"Bulloch","2020-10-03","20","9421","3","1181","7.9","7.8"
"Bulloch","2020-10-04","12","9433","1","1182","8.1","7.6"
"Bulloch","2020-10-05","47","9480","4","1186","8.9","7.5"
"Bulloch","2020-10-06","115","9595","4","1190","8.6","7.5"
"Bulloch","2020-10-07","49","9644","5","1195","8.8","7.5"
"Bulloch","2020-10-08","88","9732","4","1199","9.1","7.5"
"Bulloch","2020-10-09","37","9769","2","1201","7.9","7.1"
"Bulloch","2020-10-10","17","9786","0","1201","5.8","6.8"
"Bulloch","2020-10-11","11","9797","1","1202","5.9","7"
"Bulloch","2020-10-12","50","9847","2","1204","5.2","7.1"
"Bulloch","2020-10-13","62","9909","1","1205","5","6.8"
"Bulloch","2020-10-14","43","9952","1","1206","3.9","6.3"
"Bulloch","2020-10-15","64","10016","5","1211","4.3","6.7"
"Bulloch","2020-10-16","32","10048","3","1214","4.9","6.4"
"Bulloch","2020-10-17","29","10077","2","1216","5.9","5.8"
"Bulloch","2020-10-18","11","10088","1","1217","5.9","5.9"
"Bulloch","2020-10-19","43","10131","2","1219","6","5.6"
"Bulloch","2020-10-20","45","10176","2","1221","6.4","5.7"
"Bulloch","2020-10-21","56","10232","8","1229","8.1","6"
"Bulloch","2020-10-22","78","10310","3","1232","7.5","5.9"
"Bulloch","2020-10-23","36","10346","3","1235","7.4","6.1"
"Bulloch","2020-10-24","29","10375","0","1235","6.4","6.1"
"Bulloch","2020-10-25","11","10386","3","1238","9","7.4"
"Bulloch","2020-10-26","39","10425","4","1242","9.8","7.9"
"Bulloch","2020-10-27","45","10470","0","1242","9.1","7.8"
"Bulloch","2020-10-28","54","10524","11","1253","10","9"
"Bulloch","2020-10-29","58","10582","7","1260","11.2","9.3"
"Bulloch","2020-10-30","32","10614","5","1265","12.2","9.8"
"Bulloch","2020-10-31","25","10639","1","1266","12.8","9.6"
"Bulloch","2020-11-01","13","10652","3","1269","12.2","10.6"
"Bulloch","2020-11-02","47","10699","10","1279","13.8","11.8"
"Bulloch","2020-11-03","44","10743","1","1280","14.1","11.6"
"Bulloch","2020-11-04","54","10797","2","1282","11.7","10.9"
"Bulloch","2020-11-05","43","10840","3","1285","11","11.1"
"Bulloch","2020-11-06","55","10895","4","1289","9.8","11"
"Bulloch","2020-11-07","22","10917","2","1291","10.5","11.7"
"Bulloch","2020-11-08","13","10930","2","1293","9.4","10.8"
"Bulloch","2020-11-09","50","10980","4","1297","7.5","10.7"
"Bulloch","2020-11-10","57","11037","5","1302","8.5","11.3"
"Bulloch","2020-11-11","25","11062","1","1303","8.5","10.1"
"Bulloch","2020-11-12","50","11112","9","1312","10.1","10.5"
"Bulloch","2020-11-13","41","11153","6","1318","11.1","10.5"
"Bulloch","2020-11-14","33","11186","3","1321","11.1","10.8"
"Bulloch","2020-11-15","20","11206","2","1323","10.4","9.9"
"Bulloch","2020-11-16","60","11266","6","1329","10.6","9.1"
"Bulloch","2020-11-17","60","11326","1","1330","9.6","9"
"Bulloch","2020-11-18","54","11380","1","1331","9.3","8.9"
"Bulloch","2020-11-19","65","11445","5","1336","7.8","9"
"Bulloch","2020-11-20","63","11508","3","1339","6.4","8.8"
"Bulloch","2020-11-21","47","11555","6","1345","7","9"
"Bulloch","2020-11-22","36","11591","3","1348","6.7","8.5"
"Bulloch","2020-11-23","80","11671","9","1357","6.9","8.8"
"Bulloch","2020-11-24","67","11738","3","1360","7.3","8.5"
"Bulloch","2020-11-25","55","11793","2","1362","7.6","8.4"
"Bulloch","2020-11-26","4","11797","0","1362","6.5","7.2"
"Bulloch","2020-11-27","43","11840","4","1366","7.1","6.8"
"Bulloch","2020-11-28","35","11875","3","1369","6.5","6.7"
"Bulloch","2020-11-29","26","11901","6","1375","8.6","7.7"
"Bulloch","2020-11-30","60","11961","11","1386","9.6","8.3"
"Bulloch","2020-12-01","59","12020","6","1392","10.4","8.9"
"Bulloch","2020-12-02","74","12094","10","1402","11.9","9.7"
"Bulloch","2020-12-03","58","12152","5","1407","13.1","9.8"
"Bulloch","2020-12-04","64","12216","4","1411","12.6","9.9"
"Bulloch","2020-12-05","37","12253","6","1417","13.7","10.1"
"Bulloch","2020-12-06","30","12283","4","1421","12.3","10.5"
"Bulloch","2020-12-07","69","12352","7","1428","11.2","10.4"
"Bulloch","2020-12-08","74","12426","7","1435","11.1","10.8"
"Bulloch","2020-12-09","64","12490","6","1441","10.5","11.2"
"Bulloch","2020-12-10","149","12639","14","1455","10.6","11.8"
"Bulloch","2020-12-11","106","12745","4","1459","10.2","11.4"
"Bulloch","2020-12-12","35","12780","6","1465","10.4","12.1"
"Bulloch","2020-12-13","44","12824","6","1471","10.4","11.4"
"Bulloch","2020-12-14","83","12907","6","1477","10","10.6"
"Bulloch","2020-12-15","105","13012","15","1492","10.7","10.9"
"Bulloch","2020-12-16","100","13112","18","1510","11.9","11.2"
"Bulloch","2020-12-17","63","13175","4","1514","11.5","11"
"Bulloch","2020-12-18","75","13250","5","1519","11.9","11.1"
"Bulloch","2020-12-19","60","13310","8","1527","11.4","10.9"
"Bulloch","2020-12-20","23","13333","4","1531","11.9","11.2"
"Bulloch","2020-12-21","129","13462","23","1554","13.4","11.7"
"Bulloch","2020-12-22","69","13531","5","1559","12.4","11.5"
"Bulloch","2020-12-23","81","13612","14","1573","12.3","12.1"
"Bulloch","2020-12-24","56","13668","6","1579","12.9","12.2"
"Bulloch","2020-12-25","7","13675","0","1579","12","11.9"
"Bulloch","2020-12-26","36","13711","9","1588","13.6","12.5"
"Bulloch","2020-12-27","25","13736","8","1596","15.7","13.8"
"Bulloch","2020-12-28","80","13816","17","1613","16.2","14.8"
"Bulloch","2020-12-29","83","13899","17","1630","18.1","15.3"
"Bulloch","2020-12-30","74","13973","13","1643","18.1","15.2"
"Bulloch","2020-12-31","85","14058","21","1664","20.1","16.5"
"Bulloch","2021-01-01","0","14058","0","1664","20.1","16.1"
"Bulloch","2021-01-02","41","14099","12","1676","20.8","17.2"
"Bulloch","2021-01-03","47","14146","20","1696","22.3","19"
"Bulloch","2021-01-04","106","14252","32","1728","23.5","19.9"
"Bulloch","2021-01-05","138","14390","32","1760","23.9","21"
"Bulloch","2021-01-06","105","14495","27","1787","25.1","21.6"
"Bulloch","2021-01-07","103","14598","36","1823","26.6","23.3"
"Bulloch","2021-01-08","102","14700","28","1851","30.5","25.3"
"Bulloch","2021-01-09","47","14747","23","1874","33.3","27"
"Bulloch","2021-01-10","48","14795","13","1887","31.1","26.7"
"Bulloch","2021-01-11","94","14889","20","1907","29.8","26.7"
"Bulloch","2021-01-12","97","14986","21","1928","29.6","26.8"
"Bulloch","2021-01-13","98","15084","15","1943","28.1","26.6"
"Bulloch","2021-01-14","90","15174","14","1957","25.3","25.9"
"Bulloch","2021-01-15","90","15264","10","1967","23","26.7"
"Bulloch","2021-01-16","48","15312","10","1977","19","26.1"
"Bulloch","2021-01-17","39","15351","3","1980","16.2","23.6"
"Bulloch","2021-01-18","84","15435","17","1997","16.1","22.9"
"Bulloch","2021-01-19","95","15530","17","2014","15.5","22.5"
"Bulloch","2021-01-20","297","15827","46","2060","15.5","21.8"
"Bulloch","2021-01-21","283","16110","48","2108","15.7","20.5"
"Bulloch","2021-01-22","169","16279","15","2123","15.4","19.2"
"Bulloch","2021-01-23","82","16361","14","2137","14.9","16.9"
"Bulloch","2021-01-24","28","16389","7","2144","17.4","16.8"
"Bulloch","2021-01-25","251","16640","43","2187","16.9","16.5"
"Bulloch","2021-01-26","53","16693","8","2195","16.5","16"
"Bulloch","2021-01-27","0","16693","0","2195","14.3","14.9"
"Burke","2020-02-01","0","0","0","0",".","."
"Burke","2020-02-02","0","0","0","0",".","."
"Burke","2020-02-03","0","0","0","0",".","."
"Burke","2020-02-04","0","0","0","0",".","."
"Burke","2020-02-05","0","0","0","0",".","."
"Burke","2020-02-06","0","0","0","0",".","."
"Burke","2020-02-07","0","0","0","0","0","."
"Burke","2020-02-08","0","0","0","0","0","."
"Burke","2020-02-09","0","0","0","0","0","."
"Burke","2020-02-10","0","0","0","0","0","."
"Burke","2020-02-11","0","0","0","0","0","."
"Burke","2020-02-12","0","0","0","0","0","."
"Burke","2020-02-13","0","0","0","0","0","."
"Burke","2020-02-14","0","0","0","0","0","0"
"Burke","2020-02-15","0","0","0","0","0","0"
"Burke","2020-02-16","0","0","0","0","0","0"
"Burke","2020-02-17","0","0","0","0","0","0"
"Burke","2020-02-18","0","0","0","0","0","0"
"Burke","2020-02-19","0","0","0","0","0","0"
"Burke","2020-02-20","0","0","0","0","0","0"
"Burke","2020-02-21","0","0","0","0","0","0"
"Burke","2020-02-22","0","0","0","0","0","0"
"Burke","2020-02-23","0","0","0","0","0","0"
"Burke","2020-02-24","0","0","0","0","0","0"
"Burke","2020-02-25","0","0","0","0","0","0"
"Burke","2020-02-26","0","0","0","0","0","0"
"Burke","2020-02-27","0","0","0","0","0","0"
"Burke","2020-02-28","0","0","0","0","0","0"
"Burke","2020-02-29","0","0","0","0","0","0"
"Burke","2020-03-01","0","0","0","0","0","0"
"Burke","2020-03-02","0","0","0","0","0","0"
"Burke","2020-03-03","0","0","0","0","0","0"
"Burke","2020-03-04","0","0","0","0","0","0"
"Burke","2020-03-05","0","0","0","0","0","0"
"Burke","2020-03-06","0","0","0","0","0","0"
"Burke","2020-03-07","0","0","0","0","0","0"
"Burke","2020-03-08","0","0","0","0","0","0"
"Burke","2020-03-09","0","0","0","0","0","0"
"Burke","2020-03-10","0","0","0","0","0","0"
"Burke","2020-03-11","0","0","0","0","0","0"
"Burke","2020-03-12","0","0","0","0","0","0"
"Burke","2020-03-13","0","0","0","0","0","0"
"Burke","2020-03-14","0","0","0","0","0","0"
"Burke","2020-03-15","0","0","0","0","0","0"
"Burke","2020-03-16","4","4","0","0","0","0"
"Burke","2020-03-17","2","6","0","0","0","0"
"Burke","2020-03-18","0","6","0","0","0","0"
"Burke","2020-03-19","2","8","0","0","0","0"
"Burke","2020-03-20","2","10","0","0","0","0"
"Burke","2020-03-21","0","10","0","0","0","0"
"Burke","2020-03-22","0","10","0","0","0","0"
"Burke","2020-03-23","2","12","1","1","7.1","3.6"
"Burke","2020-03-24","0","12","0","1","7.1","3.6"
"Burke","2020-03-25","0","12","0","1","7.1","3.6"
"Burke","2020-03-26","0","12","0","1","7.1","3.6"
"Burke","2020-03-27","2","14","1","2","14.3","7.1"
"Burke","2020-03-28","1","15","1","3","28.6","14.3"
"Burke","2020-03-29","0","15","0","3","28.6","14.3"
"Burke","2020-03-30","3","18","0","3","21.4","14.3"
"Burke","2020-03-31","3","21","1","4","26.2","16.7"
"Burke","2020-04-01","8","29","1","5","28","17.6"
"Burke","2020-04-02","7","36","1","6","30","18.6"
"Burke","2020-04-03","10","46","2","8","25.7","20"
"Burke","2020-04-04","5","51","1","9","14.3","21.4"
"Burke","2020-04-05","5","56","0","9","14.3","21.4"
"Burke","2020-04-06","2","58","1","10","21.4","21.4"
"Burke","2020-04-07","8","66","1","11","18.5","22.3"
"Burke","2020-04-08","4","70","0","11","16.7","22.3"
"Burke","2020-04-09","10","80","0","11","14.6","22.3"
"Burke","2020-04-10","5","85","1","12","14.6","20.2"
"Burke","2020-04-11","9","94","2","14","15","14.6"
"Burke","2020-04-12","4","98","2","16","22.1","18.2"
"Burke","2020-04-13","6","104","1","17","17.3","19.4"
"Burke","2020-04-14","7","111","0","17","15.6","17"
"Burke","2020-04-15","5","116","1","18","18.4","17.5"
"Burke","2020-04-16","5","121","1","19","21.3","18"
"Burke","2020-04-17","17","138","2","21","20.1","17.4"
"Burke","2020-04-18","21","159","10","31","23.7","19.3"
"Burke","2020-04-19","7","166","2","33","20.7","21.4"
"Burke","2020-04-20","6","172","2","35","23","20.2"
"Burke","2020-04-21","13","185","2","37","25.2","20.4"
"Burke","2020-04-22","9","194","2","39","25.6","22"
"Burke","2020-04-23","23","217","6","45","26.4","23.8"
"Burke","2020-04-24","17","234","2","47","26.4","23.3"
"Burke","2020-04-25","5","239","0","47","19.6","21.7"
"Burke","2020-04-26","1","240","0","47","15.5","18.1"
"Burke","2020-04-27","13","253","0","47","10.8","16.9"
"Burke","2020-04-28","9","262","2","49","11.8","18.5"
"Burke","2020-04-29","8","270","1","50","10.4","18"
"Burke","2020-04-30","20","290","3","53","8.8","17.6"
"Burke","2020-05-01","15","305","1","54","8.1","17.2"
"Burke","2020-05-02","7","312","0","54","8.1","13.8"
"Burke","2020-05-03","13","325","0","54","8.1","11.8"
"Burke","2020-05-04","15","340","1","55","9","9.9"
"Burke","2020-05-05","11","351","3","58","9.7","10.7"
"Burke","2020-05-06","9","360","0","58","7.9","9.2"
"Burke","2020-05-07","12","372","3","61","9.4","9.1"
"Burke","2020-05-08","12","384","1","62","9.6","8.8"
"Burke","2020-05-09","9","393","0","62","9.6","8.8"
"Burke","2020-05-10","1","394","0","62","9.6","8.8"
"Burke","2020-05-11","10","404","0","62","8.7","8.8"
"Burke","2020-05-12","12","416","0","62","4.8","7.2"
"Burke","2020-05-13","12","428","2","64","7.1","7.5"
"Burke","2020-05-14","7","435","0","64","3.6","6.5"
"Burke","2020-05-15","13","448","1","65","3.5","6.5"
"Burke","2020-05-16","2","450","0","65","3.5","6.5"
"Burke","2020-05-17","10","460","3","68","7.8","8.7"
"Burke","2020-05-18","9","469","2","70","10.9","9.8"
"Burke","2020-05-19","29","498","1","71","11.4","8.1"
"Burke","2020-05-20","11","509","0","71","9.1","8.1"
"Burke","2020-05-21","20","529","0","71","9.1","6.3"
"Burke","2020-05-22","12","541","2","73","10.3","6.9"
"Burke","2020-05-23","5","546","0","73","10.3","6.9"
"Burke","2020-05-24","11","557","0","73","6","6.9"
"Burke","2020-05-25","3","560","0","73","2.9","6.9"
"Burke","2020-05-26","16","576","1","74","3.3","7.4"
"Burke","2020-05-27","8","584","0","74","3.3","6.2"
"Burke","2020-05-28","6","590","0","74","3.3","6.2"
"Burke","2020-05-29","7","597","0","74","0.9","5.6"
"Burke","2020-05-30","4","601","0","74","0.9","5.6"
"Burke","2020-05-31","5","606","0","74","0.9","3.5"
"Burke","2020-06-01","19","625","2","76","2.4","2.6"
"Burke","2020-06-02","23","648","0","76","1.5","2.4"
"Burke","2020-06-03","12","660","0","76","1.5","2.4"
"Burke","2020-06-04","13","673","0","76","1.5","2.4"
"Burke","2020-06-05","0","673","0","76","1.5","1.2"
"Burke","2020-06-06","0","673","0","76","1.5","1.2"
"Burke","2020-06-07","4","677","0","76","1.5","1.2"
"Burke","2020-06-08","4","681","0","76","0","1.2"
"Burke","2020-06-09","4","685","0","76","0","0.8"
"Burke","2020-06-10","9","694","0","76","0","0.8"
"Burke","2020-06-11","11","705","0","76","0","0.8"
"Burke","2020-06-12","24","729","1","77","0.6","1"
"Burke","2020-06-13","6","735","0","77","0.6","1"
"Burke","2020-06-14","4","739","0","77","0.6","1"
"Burke","2020-06-15","20","759","2","79","2","1"
"Burke","2020-06-16","14","773","2","81","4.1","2"
"Burke","2020-06-17","6","779","1","82","6.4","3.2"
"Burke","2020-06-18","16","795","0","82","6.4","3.2"
"Burke","2020-06-19","18","813","1","83","6.6","3.6"
"Burke","2020-06-20","14","827","0","83","6.6","3.6"
"Burke","2020-06-21","7","834","0","83","6.6","3.6"
"Burke","2020-06-22","50","884","2","85","5.8","3.9"
"Burke","2020-06-23","26","910","4","89","5.9","5"
"Burke","2020-06-24","28","938","3","92","5.1","5.8"
"Burke","2020-06-25","32","970","7","99","8.2","7.3"
"Burke","2020-06-26","28","998","7","106","11","8.8"
"Burke","2020-06-27","18","1016","1","107","11.8","9.2"
"Burke","2020-06-28","5","1021","0","107","11.8","9.2"
"Burke","2020-06-29","39","1060","8","115","14.1","10"
"Burke","2020-06-30","50","1110","13","128","15.7","10.8"
"Burke","2020-07-01","33","1143","7","135","17.2","11.1"
"Burke","2020-07-02","49","1192","4","139","15.2","11.7"
"Burke","2020-07-03","24","1216","9","148","17","14"
"Burke","2020-07-04","8","1224","0","148","16.2","14"
"Burke","2020-07-05","17","1241","1","149","17","14.4"
"Burke","2020-07-06","49","1290","11","160","17.3","15.7"
"Burke","2020-07-07","55","1345","14","174","17.2","16.5"
"Burke","2020-07-08","65","1410","10","184","16.4","16.8"
"Burke","2020-07-09","63","1473","19","203","19.5","17.4"
"Burke","2020-07-10","65","1538","10","213","16.4","16.7"
"Burke","2020-07-11","27","1565","4","217","18.5","17.4"
"Burke","2020-07-12","39","1604","12","229","22.1","19.5"
"Burke","2020-07-13","76","1680","24","253","23.4","20.3"
"Burke","2020-07-14","103","1783","26","279","23.3","20.3"
"Burke","2020-07-15","49","1832","7","286","23.2","19.8"
"Burke","2020-07-16","49","1881","16","302","23.5","21.5"
"Burke","2020-07-17","41","1922","7","309","23.8","20.1"
"Burke","2020-07-18","44","1966","11","320","25.2","21.9"
"Burke","2020-07-19","38","2004","10","330","24.6","23.3"
"Burke","2020-07-20","84","2088","28","358","24.8","24.1"
"Burke","2020-07-21","75","2163","12","370","23.5","23.4"
"Burke","2020-07-22","70","2233","29","399","27.4","25.3"
"Burke","2020-07-23","90","2323","22","421","26.2","24.9"
"Burke","2020-07-24","24","2347","4","425","26.2","25"
"Burke","2020-07-25","29","2376","10","435","27.5","26.4"
"Burke","2020-07-26","25","2401","5","440","26.6","25.6"
"Burke","2020-07-27","37","2438","4","444","23.4","24.1"
"Burke","2020-07-28","45","2483","6","450","23","23.3"
"Burke","2020-07-29","39","2522","6","456","19.3","23.4"
"Burke","2020-07-30","34","2556","4","460","17.5","21.9"
"Burke","2020-07-31","27","2583","5","465","17.8","22"
"Burke","2020-08-01","15","2598","4","469","16.6","22.1"
"Burke","2020-08-02","28","2626","4","473","15.8","21.2"
"Burke","2020-08-03","34","2660","8","481","17.6","20.5"
"Burke","2020-08-04","43","2703","6","487","17.7","20.4"
"Burke","2020-08-05","30","2733","12","499","21.2","20.3"
"Burke","2020-08-06","32","2765","5","504","21.8","19.6"
"Burke","2020-08-07","26","2791","4","508","21.3","19.6"
"Burke","2020-08-08","23","2814","9","517","23.1","19.9"
"Burke","2020-08-09","25","2839","6","523","24.5","20.2"
"Burke","2020-08-10","31","2870","5","528","23.5","20.6"
"Burke","2020-08-11","29","2899","5","533","23.9","20.8"
"Burke","2020-08-12","34","2933","11","544","22.8","22"
"Burke","2020-08-13","30","2963","7","551","23.9","22.9"
"Burke","2020-08-14","37","3000","6","557","24.1","22.7"
"Burke","2020-08-15","39","3039","7","564","21","22.1"
"Burke","2020-08-16","19","3058","4","568","20.6","22.6"
"Burke","2020-08-17","37","3095","7","575","21","22.2"
"Burke","2020-08-18","38","3133","7","582","21.2","22.6"
"Burke","2020-08-19","39","3172","2","584","17.3","20.1"
"Burke","2020-08-20","26","3198","6","590","17.3","20.6"
"Burke","2020-08-21","20","3218","1","591","15.6","19.9"
"Burke","2020-08-22","14","3232","3","594","16.1","18.6"
"Burke","2020-08-23","17","3249","1","595","14","17.3"
"Burke","2020-08-24","20","3269","4","599","14.1","17.6"
"Burke","2020-08-25","25","3294","3","602","13.2","17.2"
"Burke","2020-08-26","57","3351","5","607","13.7","15.5"
"Burke","2020-08-27","60","3411","7","614","12.1","14.7"
"Burke","2020-08-28","61","3472","8","622","13.3","14.5"
"Burke","2020-08-29","36","3508","2","624","11","13.6"
"Burke","2020-08-30","15","3523","2","626","12.1","13"
"Burke","2020-08-31","72","3595","12","638","11.6","12.9"
"Burke","2020-09-01","101","3696","14","652","11.9","12.5"
"Burke","2020-09-02","62","3758","8","660","12.4","13.1"
"Burke","2020-09-03","60","3818","9","669","12.9","12.5"
"Burke","2020-09-04","38","3856","4","673","12.5","12.9"
"Burke","2020-09-05","24","3880","2","675","12.9","12"
"Burke","2020-09-06","11","3891","3","678","14.9","13.5"
"Burke","2020-09-07","20","3911","3","681","14.7","13.1"
"Burke","2020-09-08","93","4004","11","692","14.4","13.1"
"Burke","2020-09-09","82","4086","11","703","14.5","13.5"
"Burke","2020-09-10","81","4167","8","711","13.8","13.3"
"Burke","2020-09-11","43","4210","6","717","14.2","13.4"
"Burke","2020-09-12","25","4235","7","724","17","15"
"Burke","2020-09-13","14","4249","2","726","15.2","15.1"
"Burke","2020-09-14","74","4323","13","739","15.6","15.1"
"Burke","2020-09-15","112","4435","15","754","15.8","15.1"
"Burke","2020-09-16","107","4542","4","758","14.4","14.4"
"Burke","2020-09-17","26","4568","3","761","14.6","14.2"
"Burke","2020-09-18","48","4616","5","766","14.1","14.2"
"Burke","2020-09-19","31","4647","3","769","11.5","14.3"
"Burke","2020-09-20","12","4659","2","771","11.9","13.5"
"Burke","2020-09-21","57","4716","13","784","12.6","14.1"
"Burke","2020-09-22","103","4819","11","795","12.2","14"
"Burke","2020-09-23","67","4886","9","804","13.6","14"
"Burke","2020-09-24","60","4946","6","810","13.4","14"
"Burke","2020-09-25","35","4981","4","814","13.5","13.8"
"Burke","2020-09-26","22","5003","2","816","13.4","12.5"
"Burke","2020-09-27","8","5011","1","817","12.8","12.4"
"Burke","2020-09-28","50","5061","4","821","10.7","11.7"
"Burke","2020-09-29","78","5139","12","833","11.4","11.8"
"Burke","2020-09-30","42","5181","9","842","12.5","13.1"
"Burke","2020-10-01","48","5229","3","845","12","12.7"
"Burke","2020-10-02","50","5279","4","849","11.5","12.5"
"Burke","2020-10-03","44","5323","3","852","11.2","12.3"
"Burke","2020-10-04","12","5335","0","852","9.4","11.1"
"Burke","2020-10-05","66","5401","5","857","9.4","10"
"Burke","2020-10-06","96","5497","9","866","8.5","9.9"
"Burke","2020-10-07","77","5574","3","869","6","9.3"
"Burke","2020-10-08","98","5672","6","875","6","9"
"Burke","2020-10-09","45","5717","3","878","5.8","8.7"
"Burke","2020-10-10","35","5752","5","883","6.8","9"
"Burke","2020-10-11","21","5773","4","887","9.6","9.5"
"Burke","2020-10-12","68","5841","9","896","10.4","9.9"
"Burke","2020-10-13","75","5916","12","908","11.3","9.9"
"Burke","2020-10-14","40","5956","5","913","12.6","9.3"
"Burke","2020-10-15","37","5993","5","918","13.6","9.8"
"Burke","2020-10-16","42","6035","3","921","13.7","9.7"
"Burke","2020-10-17","36","6071","7","928","14.4","10.6"
"Burke","2020-10-18","4","6075","0","928","11.7","10.6"
"Burke","2020-10-19","67","6142","14","942","12.8","11.6"
"Burke","2020-10-20","58","6200","4","946","11.5","11.4"
"Burke","2020-10-21","69","6269","22","968","14.3","13.4"
"Burke","2020-10-22","54","6323","7","975","14.2","13.9"
"Burke","2020-10-23","37","6360","2","977","13.9","13.8"
"Burke","2020-10-24","20","6380","2","979","12.6","13.5"
"Burke","2020-10-25","11","6391","0","979","12.6","12.1"
"Burke","2020-10-26","58","6449","16","995","13.5","13.2"
"Burke","2020-10-27","68","6517","10","1005","14.6","13.1"
"Burke","2020-10-28","45","6562","5","1010","11.7","13"
"Burke","2020-10-29","48","6610","14","1024","14","14.1"
"Burke","2020-10-30","48","6658","6","1030","15","14.5"
"Burke","2020-10-31","39","6697","6","1036","15.8","14.2"
"Burke","2020-11-01","10","6707","0","1036","15.8","14.2"
"Burke","2020-11-02","65","6772","14","1050","14.9","14.2"
"Burke","2020-11-03","70","6842","8","1058","14.4","14.5"
"Burke","2020-11-04","54","6896","8","1066","15","13.3"
"Burke","2020-11-05","61","6957","15","1081","14.3","14.2"
"Burke","2020-11-06","54","7011","9","1090","14.9","15"
"Burke","2020-11-07","33","7044","8","1098","16.2","16"
"Burke","2020-11-08","4","7048","1","1099","19.8","17.8"
"Burke","2020-11-09","76","7124","29","1128","22.1","18.5"
"Burke","2020-11-10","107","7231","35","1163","25.2","19.8"
"Burke","2020-11-11","68","7299","19","1182","27","21"
"Burke","2020-11-12","92","7391","19","1201","26.5","20.4"
"Burke","2020-11-13","89","7480","16","1217","26.7","20.8"
"Burke","2020-11-14","44","7524","18","1235","29","22.6"
"Burke","2020-11-15","12","7536","1","1236","26.7","23.2"
"Burke","2020-11-16","107","7643","34","1270","25.8","23.9"
"Burke","2020-11-17","133","7776","16","1286","22.8","24"
"Burke","2020-11-18","71","7847","12","1298","21.2","24.1"
"Burke","2020-11-19","69","7916","14","1312","21.2","23.8"
"Burke","2020-11-20","42","7958","6","1318","20.6","23.7"
"Burke","2020-11-21","60","8018","9","1327","16.9","23"
"Burke","2020-11-22","8","8026","0","1327","15.8","21.2"
"Burke","2020-11-23","98","8124","22","1349","14.4","20.1"
"Burke","2020-11-24","106","8230","19","1368","15.3","19"
"Burke","2020-11-25","35","8265","8","1376","16.1","18.7"
"Burke","2020-11-26","10","8275","3","1379","17.5","19.3"
"Burke","2020-11-27","19","8294","4","1383","18.5","19.6"
"Burke","2020-11-28","29","8323","6","1389","19.3","18.1"
"Burke","2020-11-29","12","8335","0","1389","19.3","17.5"
"Burke","2020-11-30","97","8432","23","1412","19.5","16.9"
"Burke","2020-12-01","94","8526","14","1426","19","17.1"
"Burke","2020-12-02","53","8579","12","1438","19","17.6"
"Burke","2020-12-03","71","8650","24","1462","19.5","18.5"
"Burke","2020-12-04","53","8703","11","1473","19.5","19"
"Burke","2020-12-05","41","8744","11","1484","20.4","19.8"
"Burke","2020-12-06","8","8752","0","1484","20.4","19.8"
"Burke","2020-12-07","105","8857","12","1496","18.6","19"
"Burke","2020-12-08","83","8940","13","1509","18.7","18.9"
"Burke","2020-12-09","60","9000","6","1515","16.9","18"
"Burke","2020-12-10","72","9072","14","1529","14.9","17.2"
"Burke","2020-12-11","72","9144","18","1547","15.5","17.5"
"Burke","2020-12-12","74","9218","11","1558","13.8","17.1"
"Burke","2020-12-13","13","9231","3","1561","17.1","18.7"
"Burke","2020-12-14","113","9344","18","1579","17.7","18.2"
"Burke","2020-12-15","103","9447","30","1609","19.6","19.2"
"Burke","2020-12-16","73","9520","24","1633","22.9","19.9"
"Burke","2020-12-17","74","9594","15","1648","23","18.9"
"Burke","2020-12-18","65","9659","17","1665","23.2","19.3"
"Burke","2020-12-19","43","9702","11","1676","24.7","19.2"
"Burke","2020-12-20","12","9714","4","1680","26.2","21.6"
"Burke","2020-12-21","142","9856","31","1711","27","22.4"
"Burke","2020-12-22","119","9975","25","1736","25.9","22.7"
"Burke","2020-12-23","73","10048","17","1753","24.5","23.7"
"Burke","2020-12-24","15","10063","3","1756","24.5","23.7"
"Burke","2020-12-25","4","10067","3","1759","31.4","27.3"
"Burke","2020-12-26","20","10087","3","1762","29.9","27.3"
"Burke","2020-12-27","22","10109","5","1767","28.4","27.3"
"Burke","2020-12-28","86","10195","38","1805","31.6","29.3"
"Burke","2020-12-29","103","10298","31","1836","32.9","29.4"
"Burke","2020-12-30","101","10399","28","1864","33.5","29"
"Burke","2020-12-31","55","10454","19","1883","35.6","30"
"Burke","2021-01-01","4","10458","2","1885","32","31.7"
"Burke","2021-01-02","22","10480","8","1893","35.1","32.5"
"Burke","2021-01-03","12","10492","1","1894","33","30.7"
"Burke","2021-01-04","51","10543","19","1913","32","31.8"
"Burke","2021-01-05","116","10659","37","1950","32.3","32.6"
"Burke","2021-01-06","118","10777","28","1978","31.7","32.6"
"Burke","2021-01-07","82","10859","26","2004","31.3","33.5"
"Burke","2021-01-08","99","10958","34","2038","29.1","30.6"
"Burke","2021-01-09","56","11014","24","2062","30","32.6"
"Burke","2021-01-10","21","11035","4","2066","31.5","32.3"
"Burke","2021-01-11","143","11178","37","2103","29.9","31"
"Burke","2021-01-12","122","11300","25","2128","28.3","30.3"
"Burke","2021-01-13","108","11408","20","2148","27.5","29.6"
"Burke","2021-01-14","79","11487","15","2163","25.7","28.5"
"Burke","2021-01-15","95","11582","16","2179","23.2","26.2"
"Burke","2021-01-16","67","11649","19","2198","21.2","25.6"
"Burke","2021-01-17","21","11670","2","2200","19.8","25.7"
"Burke","2021-01-18","80","11750","20","2220","19.7","24.8"
"Burke","2021-01-19","113","11863","30","2250","20.5","24.4"
"Burke","2021-01-20","91","11954","14","2264","20.1","23.8"
"Burke","2021-01-21","79","12033","10","2274","19.2","22.5"
"Burke","2021-01-22","89","12122","19","2293","19.8","21.5"
"Burke","2021-01-23","36","12158","7","2300","18.6","19.9"
"Burke","2021-01-24","19","12177","3","2303","19.5","19.6"
"Burke","2021-01-25","62","12239","14","2317","19.1","19.4"
"Burke","2021-01-26","5","12244","0","2317","15.3","17.9"
"Burke","2021-01-27","0","12244","0","2317","13.1","16.6"
"Butts","2020-02-01","0","0","0","0",".","."
"Butts","2020-02-02","0","0","0","0",".","."
"Butts","2020-02-03","0","0","0","0",".","."
"Butts","2020-02-04","0","0","0","0",".","."
"Butts","2020-02-05","0","0","0","0",".","."
"Butts","2020-02-06","0","0","0","0",".","."
"Butts","2020-02-07","0","0","0","0","0","."
"Butts","2020-02-08","0","0","0","0","0","."
"Butts","2020-02-09","0","0","0","0","0","."
"Butts","2020-02-10","0","0","0","0","0","."
"Butts","2020-02-11","0","0","0","0","0","."
"Butts","2020-02-12","0","0","0","0","0","."
"Butts","2020-02-13","0","0","0","0","0","."
"Butts","2020-02-14","0","0","0","0","0","0"
"Butts","2020-02-15","0","0","0","0","0","0"
"Butts","2020-02-16","0","0","0","0","0","0"
"Butts","2020-02-17","0","0","0","0","0","0"
"Butts","2020-02-18","0","0","0","0","0","0"
"Butts","2020-02-19","0","0","0","0","0","0"
"Butts","2020-02-20","0","0","0","0","0","0"
"Butts","2020-02-21","0","0","0","0","0","0"
"Butts","2020-02-22","0","0","0","0","0","0"
"Butts","2020-02-23","0","0","0","0","0","0"
"Butts","2020-02-24","0","0","0","0","0","0"
"Butts","2020-02-25","0","0","0","0","0","0"
"Butts","2020-02-26","0","0","0","0","0","0"
"Butts","2020-02-27","0","0","0","0","0","0"
"Butts","2020-02-28","0","0","0","0","0","0"
"Butts","2020-02-29","0","0","0","0","0","0"
"Butts","2020-03-01","0","0","0","0","0","0"
"Butts","2020-03-02","0","0","0","0","0","0"
"Butts","2020-03-03","0","0","0","0","0","0"
"Butts","2020-03-04","0","0","0","0","0","0"
"Butts","2020-03-05","0","0","0","0","0","0"
"Butts","2020-03-06","0","0","0","0","0","0"
"Butts","2020-03-07","0","0","0","0","0","0"
"Butts","2020-03-08","0","0","0","0","0","0"
"Butts","2020-03-09","0","0","0","0","0","0"
"Butts","2020-03-10","0","0","0","0","0","0"
"Butts","2020-03-11","0","0","0","0","0","0"
"Butts","2020-03-12","0","0","0","0","0","0"
"Butts","2020-03-13","0","0","0","0","0","0"
"Butts","2020-03-14","1","1","0","0","0","0"
"Butts","2020-03-15","1","2","0","0","0","0"
"Butts","2020-03-16","3","5","0","0","0","0"
"Butts","2020-03-17","3","8","1","1","4.8","2.4"
"Butts","2020-03-18","2","10","0","1","4.8","2.4"
"Butts","2020-03-19","4","14","1","2","8.3","4.2"
"Butts","2020-03-20","5","19","3","5","16.9","8.5"
"Butts","2020-03-21","1","20","0","5","16.9","8.5"
"Butts","2020-03-22","0","20","0","5","16.9","8.5"
"Butts","2020-03-23","8","28","0","5","16.9","8.5"
"Butts","2020-03-24","7","35","3","8","18.3","11.5"
"Butts","2020-03-25","11","46","2","10","20.9","12.8"
"Butts","2020-03-26","13","59","4","14","21.7","15"
"Butts","2020-03-27","3","62","1","15","17.9","17.4"
"Butts","2020-03-28","2","64","1","16","25","21"
"Butts","2020-03-29","3","67","0","16","25","21"
"Butts","2020-03-30","10","77","0","16","25","21"
"Butts","2020-03-31","13","90","1","17","20","19.1"
"Butts","2020-04-01","8","98","1","18","19.2","20"
"Butts","2020-04-02","11","109","0","18","14.8","18.2"
"Butts","2020-04-03","6","115","3","21","17.2","17.5"
"Butts","2020-04-04","4","119","1","22","13.6","19.3"
"Butts","2020-04-05","2","121","0","22","13.6","19.3"
"Butts","2020-04-06","8","129","4","26","20.7","22.9"
"Butts","2020-04-07","7","136","0","26","19.6","19.8"
"Butts","2020-04-08","15","151","3","29","20.7","19.9"
"Butts","2020-04-09","13","164","5","34","26.2","20.5"
"Butts","2020-04-10","4","168","1","35","22.6","19.9"
"Butts","2020-04-11","4","172","2","37","26.2","19.9"
"Butts","2020-04-12","0","172","0","37","26.2","19.9"
"Butts","2020-04-13","10","182","3","40","23.4","22"
"Butts","2020-04-14","16","198","6","46","28.7","24.2"
"Butts","2020-04-15","14","212","0","46","25.9","23.3"
"Butts","2020-04-16","32","244","19","65","28.8","27.5"
"Butts","2020-04-17","19","263","10","75","32.8","27.7"
"Butts","2020-04-18","8","271","3","78","31","28.6"
"Butts","2020-04-19","4","275","1","79","34.6","30.4"
"Butts","2020-04-20","74","349","46","125","39.2","31.3"
"Butts","2020-04-21","22","371","4","129","36.4","32.6"
"Butts","2020-04-22","10","381","2","131","39.3","32.6"
"Butts","2020-04-23","8","389","0","131","30.8","29.8"
"Butts","2020-04-24","8","397","0","131","23.3","28"
"Butts","2020-04-25","9","406","1","132","19.5","25.2"
"Butts","2020-04-26","5","411","0","132","15.9","25.2"
"Butts","2020-04-27","16","427","3","135","9.7","24.4"
"Butts","2020-04-28","17","444","3","138","9.6","23"
"Butts","2020-04-29","24","468","8","146","11.5","25.4"
"Butts","2020-04-30","16","484","7","153","17.8","24.3"
"Butts","2020-05-01","21","505","6","159","21.9","22.6"
"Butts","2020-05-02","1","506","1","160","34.6","27"
"Butts","2020-05-03","4","510","1","161","38.2","27"
"Butts","2020-05-04","18","528","4","165","38.6","24.2"
"Butts","2020-05-05","24","552","7","172","40.3","25"
"Butts","2020-05-06","12","564","3","175","39.1","25.3"
"Butts","2020-05-07","16","580","3","178","35.5","26.7"
"Butts","2020-05-08","12","592","2","180","33.8","27.9"
"Butts","2020-05-09","4","596","0","180","19.5","27.1"
"Butts","2020-05-10","5","601","1","181","18.8","28.5"
"Butts","2020-05-11","22","623","1","182","16.3","27.5"
"Butts","2020-05-12","24","647","6","188","15.7","28"
"Butts","2020-05-13","14","661","5","193","17.2","28.2"
"Butts","2020-05-14","27","688","1","194","15.1","25.3"
"Butts","2020-05-15","16","704","0","194","12.7","23.3"
"Butts","2020-05-16","6","710","1","195","15.1","17.3"
"Butts","2020-05-17","12","722","3","198","15.8","17.3"
"Butts","2020-05-18","73","795","4","202","15.9","16.1"
"Butts","2020-05-19","195","990","3","205","12.6","14.1"
"Butts","2020-05-20","380","1370","5","210","7.7","12.5"
"Butts","2020-05-21","40","1410","1","211","7.5","11.3"
"Butts","2020-05-22","374","1784","8","219","7.8","10.3"
"Butts","2020-05-23","6","1790","0","219","5.4","10.3"
"Butts","2020-05-24","6","1796","0","219","1.9","8.8"
"Butts","2020-05-25","2","1798","0","219","1.1","8.5"
"Butts","2020-05-26","230","2028","5","224","1.2","6.9"
"Butts","2020-05-27","24","2052","3","227","2.8","5.2"
"Butts","2020-05-28","17","2069","2","229","4.1","5.8"
"Butts","2020-05-29","17","2086","2","231","5.5","6.6"
"Butts","2020-05-30","3","2089","0","231","5.5","5.4"
"Butts","2020-05-31","9","2098","0","231","5.5","3.7"
"Butts","2020-06-01","15","2113","1","232","6.4","3.7"
"Butts","2020-06-02","32","2145","4","236","7.9","4.5"
"Butts","2020-06-03","31","2176","3","239","7.5","5.1"
"Butts","2020-06-04","199","2375","7","246","6.3","5.2"
"Butts","2020-06-05","19","2394","1","247","5.4","5.4"
"Butts","2020-06-06","8","2402","2","249","8.9","7.2"
"Butts","2020-06-07","81","2483","2","251","9.3","7.4"
"Butts","2020-06-08","23","2506","2","253","9.6","8"
"Butts","2020-06-09","24","2530","3","256","9.6","8.7"
"Butts","2020-06-10","15","2545","2","258","10.1","8.8"
"Butts","2020-06-11","24","2569","1","259","10.2","8.3"
"Butts","2020-06-12","17","2586","0","259","9.5","7.4"
"Butts","2020-06-13","6","2592","0","259","5.9","7.4"
"Butts","2020-06-14","16","2608","1","260","6.4","7.9"
"Butts","2020-06-15","21","2629","1","261","5.9","7.7"
"Butts","2020-06-16","31","2660","4","265","5.9","7.8"
"Butts","2020-06-17","49","2709","10","275","6.9","8.5"
"Butts","2020-06-18","29","2738","5","280","8.8","9.5"
"Butts","2020-06-19","23","2761","1","281","9.4","9.4"
"Butts","2020-06-20","10","2771","1","282","10.8","8.4"
"Butts","2020-06-21","4","2775","0","282","10","8.2"
"Butts","2020-06-22","26","2801","0","282","9.3","7.6"
"Butts","2020-06-23","255","3056","15","297","8.3","7.1"
"Butts","2020-06-24","39","3095","4","301","6.8","6.9"
"Butts","2020-06-25","30","3125","3","304","5.8","7.3"
"Butts","2020-06-26","27","3152","5","309","7.8","8.6"
"Butts","2020-06-27","16","3168","2","311","8.2","9.5"
"Butts","2020-06-28","6","3174","1","312","10.5","10.2"
"Butts","2020-06-29","190","3364","11","323","11.4","10.3"
"Butts","2020-06-30","202","3566","9","332","11.2","9.7"
"Butts","2020-07-01","164","3730","7","339","10.3","8.6"
"Butts","2020-07-02","278","4008","20","359","9.9","7.8"
"Butts","2020-07-03","17","4025","5","364","11.5","9.6"
"Butts","2020-07-04","8","4033","1","365","11.5","9.8"
"Butts","2020-07-05","14","4047","2","367","11.1","10.8"
"Butts","2020-07-06","34","4081","7","374","13.2","12.3"
"Butts","2020-07-07","25","4106","2","376","13.7","12.5"
"Butts","2020-07-08","42","4148","6","382","15.2","12.7"
"Butts","2020-07-09","139","4287","9","391","15.1","12.5"
"Butts","2020-07-10","29","4316","3","394","12.4","11.9"
"Butts","2020-07-11","16","4332","3","397","13.2","12.4"
"Butts","2020-07-12","4","4336","0","397","11.2","11.2"
"Butts","2020-07-13","35","4371","4","401","9.9","11.6"
"Butts","2020-07-14","35","4406","2","403","9.6","11.7"
"Butts","2020-07-15","30","4436","12","415","13.2","14.2"
"Butts","2020-07-16","85","4521","10","425","14","14.5"
"Butts","2020-07-17","31","4552","3","428","13.9","13.1"
"Butts","2020-07-18","9","4561","1","429","12.8","13"
"Butts","2020-07-19","7","4568","2","431","16.9","14.1"
"Butts","2020-07-20","32","4600","6","437","17.9","13.9"
"Butts","2020-07-21","187","4787","15","452","18.3","13.9"
"Butts","2020-07-22","26","4813","7","459","16.4","14.8"
"Butts","2020-07-23","74","4887","7","466","16.1","15"
"Butts","2020-07-24","28","4915","2","468","15.7","14.8"
"Butts","2020-07-25","149","5064","11","479","15.2","14"
"Butts","2020-07-26","7","5071","1","480","13.1","15"
"Butts","2020-07-27","32","5103","5","485","12.7","15.3"
"Butts","2020-07-28","50","5153","3","488","12.4","15.3"
"Butts","2020-07-29","31","5184","3","491","9.9","13.2"
"Butts","2020-07-30","80","5264","5","496","9.5","12.8"
"Butts","2020-07-31","69","5333","8","504","10.1","12.9"
"Butts","2020-08-01","9","5342","2","506","12.2","13.7"
"Butts","2020-08-02","6","5348","0","506","10.2","11.7"
"Butts","2020-08-03","22","5370","3","509","9.9","11.3"
"Butts","2020-08-04","201","5571","13","522","10","11.2"
"Butts","2020-08-05","228","5799","30","552","10.5","10.2"
"Butts","2020-08-06","240","6039","9","561","10.1","9.8"
"Butts","2020-08-07","21","6060","1","562","9.1","9.6"
"Butts","2020-08-08","14","6074","1","563","7","9.6"
"Butts","2020-08-09","5","6079","2","565","12.7","11.4"
"Butts","2020-08-10","33","6112","5","570","12.9","11.4"
"Butts","2020-08-11","28","6140","5","575","14.5","12.3"
"Butts","2020-08-12","30","6170","7","582","16","13.2"
"Butts","2020-08-13","57","6227","4","586","16.5","13.3"
"Butts","2020-08-14","29","6256","2","588","16.8","13"
"Butts","2020-08-15","16","6272","2","590","17.5","12.3"
"Butts","2020-08-16","10","6282","2","592","14.7","13.7"
"Butts","2020-08-17","39","6321","3","595","13.6","13.3"
"Butts","2020-08-18","46","6367","3","598","12","13.3"
"Butts","2020-08-19","54","6421","2","600","9.2","12.6"
"Butts","2020-08-20","51","6472","7","607","10.1","13.3"
"Butts","2020-08-21","19","6491","3","610","11.4","14.1"
"Butts","2020-08-22","10","6501","1","611","11.1","14.3"
"Butts","2020-08-23","19","6520","0","611","8.2","11.4"
"Butts","2020-08-24","39","6559","7","618","9.7","11.6"
"Butts","2020-08-25","17","6576","2","620","10.4","11.2"
"Butts","2020-08-26","42","6618","5","625","11.6","10.4"
"Butts","2020-08-27","45","6663","4","629","10.9","10.5"
"Butts","2020-08-28","30","6693","2","631","9.6","10.5"
"Butts","2020-08-29","9","6702","1","632","9.8","10.4"
"Butts","2020-08-30","8","6710","0","632","9.8","9"
"Butts","2020-08-31","32","6742","0","632","7.2","8.4"
"Butts","2020-09-01","34","6776","3","635","6.8","8.6"
"Butts","2020-09-02","20","6796","2","637","6.5","9"
"Butts","2020-09-03","51","6847","8","645","7.5","9.2"
"Butts","2020-09-04","20","6867","0","645","6.5","8.1"
"Butts","2020-09-05","20","6887","2","647","6.4","8.1"
"Butts","2020-09-06","13","6900","2","649","8.6","9.2"
"Butts","2020-09-07","9","6909","3","652","13.3","10.3"
"Butts","2020-09-08","29","6938","1","653","12.6","9.7"
"Butts","2020-09-09","27","6965","2","655","12.2","9.3"
"Butts","2020-09-10","398","7363","46","701","11.6","9.5"
"Butts","2020-09-11","24","7387","1","702","12.2","9.4"
"Butts","2020-09-12","13","7400","0","702","10.8","8.6"
"Butts","2020-09-13","3","7403","1","703","13.3","10.9"
"Butts","2020-09-14","27","7430","2","705","9.6","11.5"
"Butts","2020-09-15","81","7511","7","712","10.4","11.5"
"Butts","2020-09-16","104","7615","6","718","10.1","11.2"
"Butts","2020-09-17","24","7639","1","719","9.1","10.3"
"Butts","2020-09-18","28","7667","2","721","9.5","10.8"
"Butts","2020-09-19","8","7675","0","721","9.5","10.1"
"Butts","2020-09-20","4","7679","0","721","4.7","9"
"Butts","2020-09-21","37","7716","4","725","5.2","7.4"
"Butts","2020-09-22","30","7746","3","728","5.4","7.9"
"Butts","2020-09-23","24","7770","3","731","6.4","8.2"
"Butts","2020-09-24","44","7814","10","741","9","9"
"Butts","2020-09-25","30","7844","5","746","10.4","9.9"
"Butts","2020-09-26","16","7860","2","748","12.2","10.8"
"Butts","2020-09-27","214","8074","14","762","13.1","8.9"
"Butts","2020-09-28","34","8108","3","765","12.8","9"
"Butts","2020-09-29","322","8430","24","789","12.5","8.9"
"Butts","2020-09-30","29","8459","3","792","12.2","9.3"
"Butts","2020-10-01","236","8695","42","834","11.4","10.2"
"Butts","2020-10-02","32","8727","2","836","10","10.2"
"Butts","2020-10-03","9","8736","1","837","9.8","11"
"Butts","2020-10-04","11","8747","3","840","12.7","12.9"
"Butts","2020-10-05","44","8791","3","843","12.4","12.6"
"Butts","2020-10-06","33","8824","1","844","11.8","12.1"
"Butts","2020-10-07","34","8858","3","847","11.6","11.9"
"Butts","2020-10-08","37","8895","2","849","9.8","10.6"
"Butts","2020-10-09","34","8929","3","852","10.2","10.1"
"Butts","2020-10-10","13","8942","1","853","9.7","9.7"
"Butts","2020-10-11","9","8951","2","855","9","10.8"
"Butts","2020-10-12","22","8973","0","855","8","10.2"
"Butts","2020-10-13","37","9010","4","859","9.1","10.5"
"Butts","2020-10-14","22","9032","1","860","8.5","10"
"Butts","2020-10-15","23","9055","1","861","8.3","9.1"
"Butts","2020-10-16","41","9096","2","863","7.8","9"
"Butts","2020-10-17","12","9108","0","863","6.7","8.2"
"Butts","2020-10-18","11","9119","1","864","4.8","6.9"
"Butts","2020-10-19","33","9152","4","868","6.5","7.3"
"Butts","2020-10-20","25","9177","1","869","5.6","7.3"
"Butts","2020-10-21","28","9205","2","871","5.9","7.2"
"Butts","2020-10-22","33","9238","6","877","7.9","8.1"
"Butts","2020-10-23","28","9266","1","878","7.7","7.8"
"Butts","2020-10-24","23","9289","1","879","8.4","7.5"
"Butts","2020-10-25","10","9299","2","881","9.9","7.4"
"Butts","2020-10-26","42","9341","4","885","9.5","8"
"Butts","2020-10-27","42","9383","2","887","9.6","7.6"
"Butts","2020-10-28","38","9421","4","891","10.1","8"
"Butts","2020-10-29","27","9448","3","894","9.1","8.5"
"Butts","2020-10-30","25","9473","1","895","9.2","8.5"
"Butts","2020-10-31","22","9495","2","897","9.9","9.1"
"Butts","2020-11-01","8","9503","1","898","8.8","9.3"
"Butts","2020-11-02","50","9553","6","904","9.1","9.3"
"Butts","2020-11-03","39","9592","4","908","9.9","9.8"
"Butts","2020-11-04","37","9629","3","911","9.6","9.9"
"Butts","2020-11-05","45","9674","5","916","9.6","9.4"
"Butts","2020-11-06","124","9798","0","916","9","9.1"
"Butts","2020-11-07","16","9814","2","918","9.5","9.7"
"Butts","2020-11-08","25","9839","3","921","9.4","9.1"
"Butts","2020-11-09","35","9874","7","928","10.6","9.9"
"Butts","2020-11-10","148","10022","11","939","10.2","10"
"Butts","2020-11-11","30","10052","3","942","10.4","10"
"Butts","2020-11-12","297","10349","8","950","9.2","9.4"
"Butts","2020-11-13","45","10394","6","956","11.1","10.1"
"Butts","2020-11-14","24","10418","1","957","9.9","9.7"
"Butts","2020-11-15","11","10429","0","957","8.2","8.8"
"Butts","2020-11-16","128","10557","8","965","6.3","8.4"
"Butts","2020-11-17","55","10612","6","971","6.8","8.5"
"Butts","2020-11-18","47","10659","9","980","8.1","9.3"
"Butts","2020-11-19","57","10716","7","987","9.4","9.3"
"Butts","2020-11-20","46","10762","2","989","8.2","9.6"
"Butts","2020-11-21","25","10787","4","993","9.8","9.9"
"Butts","2020-11-22","13","10800","2","995","12","10.1"
"Butts","2020-11-23","73","10873","8","1003","12.7","9.5"
"Butts","2020-11-24","65","10938","10","1013","13.4","10.1"
"Butts","2020-11-25","41","10979","7","1020","13.1","10.6"
"Butts","2020-11-26","4","10983","0","1020","11.3","10.4"
"Butts","2020-11-27","37","11020","13","1033","15.7","11.9"
"Butts","2020-11-28","18","11038","4","1037","16.6","13.2"
"Butts","2020-11-29","17","11055","3","1040","16.9","14.5"
"Butts","2020-11-30","70","11125","11","1051","17.6","15.2"
"Butts","2020-12-01","56","11181","8","1059","17.4","15.4"
"Butts","2020-12-02","128","11309","10","1069","16.1","14.6"
"Butts","2020-12-03","68","11377","15","1084","19.3","15.3"
"Butts","2020-12-04","65","11442","15","1099","17.5","16.6"
"Butts","2020-12-05","25","11467","2","1101","15.5","16.1"
"Butts","2020-12-06","22","11489","7","1108","17.5","17.2"
"Butts","2020-12-07","60","11549","17","1125","19.3","18.5"
"Butts","2020-12-08","57","11606","20","1145","22.3","19.9"
"Butts","2020-12-09","74","11680","23","1168","25.6","20.9"
"Butts","2020-12-10","79","11759","17","1185","25.6","22.4"
"Butts","2020-12-11","78","11837","19","1204","25.7","21.6"
"Butts","2020-12-12","38","11875","11","1215","28.7","22.1"
"Butts","2020-12-13","30","11905","11","1226","29.4","23.5"
"Butts","2020-12-14","396","12301","66","1292","27.8","23.6"
"Butts","2020-12-15","444","12745","85","1377","25.5","23.9"
"Butts","2020-12-16","379","13124","40","1417","22.6","24.1"
"Butts","2020-12-17","439","13563","55","1472","21.3","23.4"
"Butts","2020-12-18","364","13927","29","1501","18.9","22.3"
"Butts","2020-12-19","46","13973","13","1514","18.8","23.8"
"Butts","2020-12-20","24","13997","10","1524","19.5","24.5"
"Butts","2020-12-21","302","14299","59","1583","20","23.9"
"Butts","2020-12-22","55","14354","20","1603","22.4","23.9"
"Butts","2020-12-23","75","14429","9","1612","22.6","22.6"
"Butts","2020-12-24","48","14477","11","1623","24.1","22.7"
"Butts","2020-12-25","11","14488","2","1625","25.6","22.2"
"Butts","2020-12-26","37","14525","19","1644","28.9","23.8"
"Butts","2020-12-27","27","14552","9","1653","27.7","23.6"
"Butts","2020-12-28","101","14653","19","1672","27.6","23.8"
"Butts","2020-12-29","80","14733","30","1702","27.7","25.1"
"Butts","2020-12-30","76","14809","30","1732","31.7","27.1"
"Butts","2020-12-31","104","14913","33","1765","32.9","28.5"
"Butts","2021-01-01","17","14930","6","1771","35.4","30.5"
"Butts","2021-01-02","34","14964","9","1780","31.8","30.3"
"Butts","2021-01-03","53","15017","31","1811","35.4","31.5"
"Butts","2021-01-04","119","15136","50","1861","38.7","33.1"
"Butts","2021-01-05","398","15534","80","1941","36.2","32"
"Butts","2021-01-06","86","15620","28","1969","35.2","33.4"
"Butts","2021-01-07","106","15726","27","1996","34.3","33.6"
"Butts","2021-01-08","92","15818","21","2017","32.6","34"
"Butts","2021-01-09","50","15868","14","2031","32.8","32.3"
"Butts","2021-01-10","27","15895","9","2040","29.2","32.3"
"Butts","2021-01-11","95","15990","16","2056","25.6","32.2"
"Butts","2021-01-12","77","16067","20","2076","26.4","31.3"
"Butts","2021-01-13","78","16145","17","2093","24.9","30.1"
"Butts","2021-01-14","138","16283","25","2118","23.8","29.1"
"Butts","2021-01-15","65","16348","11","2129","23","27.8"
"Butts","2021-01-16","38","16386","10","2139","22.8","27.8"
"Butts","2021-01-17","27","16413","4","2143","20.1","24.6"
"Butts","2021-01-18","210","16623","30","2173","19.7","22.7"
"Butts","2021-01-19","212","16835","23","2196","17.6","22"
"Butts","2021-01-20","172","17007","16","2212","15.8","20.3"
"Butts","2021-01-21","222","17229","14","2226","14.1","19"
"Butts","2021-01-22","198","17427","17","2243","12.9","18"
"Butts","2021-01-23","35","17462","10","2253","13.2","18"
"Butts","2021-01-24","21","17483","2","2255","12.5","16.3"
"Butts","2021-01-25","28","17511","8","2263","14.5","17.1"
"Butts","2021-01-26","4","17515","1","2264","16.6","17.1"
"Butts","2021-01-27","0","17515","0","2264","15.2","15.5"
"Calhoun","2020-02-01","0","0","0","0",".","."
"Calhoun","2020-02-02","0","0","0","0",".","."
"Calhoun","2020-02-03","0","0","0","0",".","."
"Calhoun","2020-02-04","0","0","0","0",".","."
"Calhoun","2020-02-05","0","0","0","0",".","."
"Calhoun","2020-02-06","0","0","0","0",".","."
"Calhoun","2020-02-07","0","0","0","0","0","."
"Calhoun","2020-02-08","0","0","0","0","0","."
"Calhoun","2020-02-09","0","0","0","0","0","."
"Calhoun","2020-02-10","0","0","0","0","0","."
"Calhoun","2020-02-11","0","0","0","0","0","."
"Calhoun","2020-02-12","0","0","0","0","0","."
"Calhoun","2020-02-13","0","0","0","0","0","."
"Calhoun","2020-02-14","0","0","0","0","0","0"
"Calhoun","2020-02-15","0","0","0","0","0","0"
"Calhoun","2020-02-16","0","0","0","0","0","0"
"Calhoun","2020-02-17","0","0","0","0","0","0"
"Calhoun","2020-02-18","0","0","0","0","0","0"
"Calhoun","2020-02-19","0","0","0","0","0","0"
"Calhoun","2020-02-20","0","0","0","0","0","0"
"Calhoun","2020-02-21","0","0","0","0","0","0"
"Calhoun","2020-02-22","0","0","0","0","0","0"
"Calhoun","2020-02-23","0","0","0","0","0","0"
"Calhoun","2020-02-24","0","0","0","0","0","0"
"Calhoun","2020-02-25","0","0","0","0","0","0"
"Calhoun","2020-02-26","0","0","0","0","0","0"
"Calhoun","2020-02-27","0","0","0","0","0","0"
"Calhoun","2020-02-28","0","0","0","0","0","0"
"Calhoun","2020-02-29","0","0","0","0","0","0"
"Calhoun","2020-03-01","0","0","0","0","0","0"
"Calhoun","2020-03-02","0","0","0","0","0","0"
"Calhoun","2020-03-03","0","0","0","0","0","0"
"Calhoun","2020-03-04","0","0","0","0","0","0"
"Calhoun","2020-03-05","0","0","0","0","0","0"
"Calhoun","2020-03-06","0","0","0","0","0","0"
"Calhoun","2020-03-07","0","0","0","0","0","0"
"Calhoun","2020-03-08","0","0","0","0","0","0"
"Calhoun","2020-03-09","0","0","0","0","0","0"
"Calhoun","2020-03-10","0","0","0","0","0","0"
"Calhoun","2020-03-11","0","0","0","0","0","0"
"Calhoun","2020-03-12","1","1","0","0","0","0"
"Calhoun","2020-03-13","0","1","0","0","0","0"
"Calhoun","2020-03-14","0","1","0","0","0","0"
"Calhoun","2020-03-15","0","1","0","0","0","0"
"Calhoun","2020-03-16","0","1","0","0","0","0"
"Calhoun","2020-03-17","1","2","0","0","0","0"
"Calhoun","2020-03-18","4","6","3","3","10.7","5.4"
"Calhoun","2020-03-19","2","8","1","4","17.9","8.9"
"Calhoun","2020-03-20","7","15","2","6","21.9","11"
"Calhoun","2020-03-21","1","16","0","6","21.9","11"
"Calhoun","2020-03-22","0","16","0","6","21.9","11"
"Calhoun","2020-03-23","7","23","2","8","26","13"
"Calhoun","2020-03-24","8","31","0","8","26","13"
"Calhoun","2020-03-25","0","31","0","8","15.3","13"
"Calhoun","2020-03-26","2","33","0","8","8.2","13"
"Calhoun","2020-03-27","4","37","1","9","7.7","14.8"
"Calhoun","2020-03-28","3","40","1","10","12.4","17.2"
"Calhoun","2020-03-29","0","40","0","10","12.4","17.2"
"Calhoun","2020-03-30","4","44","2","12","15.5","20.7"
"Calhoun","2020-03-31","4","48","3","15","26.2","26.1"
"Calhoun","2020-04-01","5","53","1","16","29","22.2"
"Calhoun","2020-04-02","11","64","7","23","38.1","23.2"
"Calhoun","2020-04-03","8","72","5","28","43.5","25.6"
"Calhoun","2020-04-04","2","74","0","28","38.7","25.6"
"Calhoun","2020-04-05","1","75","1","29","53","32.7"
"Calhoun","2020-04-06","9","84","4","33","52.2","33.9"
"Calhoun","2020-04-07","10","94","8","41","52.9","39.6"
"Calhoun","2020-04-08","14","108","5","46","55.2","42.1"
"Calhoun","2020-04-09","4","112","2","48","53.2","45.7"
"Calhoun","2020-04-10","11","123","4","52","49.5","46.5"
"Calhoun","2020-04-11","1","124","0","52","49.5","44.1"
"Calhoun","2020-04-12","2","126","0","52","35.2","44.1"
"Calhoun","2020-04-13","7","133","1","53","30.9","41.6"
"Calhoun","2020-04-14","8","141","3","56","24.8","38.9"
"Calhoun","2020-04-15","7","148","1","57","21.8","38.5"
"Calhoun","2020-04-16","12","160","4","61","19.4","36.3"
"Calhoun","2020-04-17","11","171","1","62","15.5","32.5"
"Calhoun","2020-04-18","0","171","0","62","15.5","32.5"
"Calhoun","2020-04-19","2","173","0","62","15.5","25.4"
"Calhoun","2020-04-20","10","183","3","65","17.7","24.3"
"Calhoun","2020-04-21","1","184","1","66","26.7","25.8"
"Calhoun","2020-04-22","4","188","1","67","28.2","25"
"Calhoun","2020-04-23","17","205","14","81","35.2","27.3"
"Calhoun","2020-04-24","7","212","0","81","33.9","24.7"
"Calhoun","2020-04-25","7","219","2","83","38","26.7"
"Calhoun","2020-04-26","7","226","1","84","40","27.8"
"Calhoun","2020-04-27","12","238","7","91","44.1","30.9"
"Calhoun","2020-04-28","5","243","1","92","32.6","29.7"
"Calhoun","2020-04-29","9","252","3","95","33.8","31"
"Calhoun","2020-04-30","5","257","1","96","24.9","30.1"
"Calhoun","2020-05-01","9","266","0","96","24.9","29.4"
"Calhoun","2020-05-02","2","268","0","96","20.9","29.4"
"Calhoun","2020-05-03","2","270","0","96","18.8","29.4"
"Calhoun","2020-05-04","20","290","4","100","13.3","28.7"
"Calhoun","2020-05-05","12","302","1","101","11.7","22.2"
"Calhoun","2020-05-06","4","306","1","102","10.5","22.2"
"Calhoun","2020-05-07","2","308","0","102","7.6","16.3"
"Calhoun","2020-05-08","1","309","1","103","21.9","23.4"
"Calhoun","2020-05-09","2","311","0","103","21.9","21.4"
"Calhoun","2020-05-10","0","311","0","103","21.9","20.4"
"Calhoun","2020-05-11","7","318","0","103","19","16.2"
"Calhoun","2020-05-12","6","324","3","106","25","18.3"
"Calhoun","2020-05-13","16","340","2","108","23.2","16.8"
"Calhoun","2020-05-14","14","354","4","112","27.3","17.5"
"Calhoun","2020-05-15","7","361","1","113","15.1","18.5"
"Calhoun","2020-05-16","1","362","0","113","15.1","18.5"
"Calhoun","2020-05-17","1","363","0","113","15.1","18.5"
"Calhoun","2020-05-18","12","375","2","115","17.4","18.2"
"Calhoun","2020-05-19","23","398","0","115","10.3","17.6"
"Calhoun","2020-05-20","25","423","0","115","8.5","15.9"
"Calhoun","2020-05-21","30","453","0","115","4.4","15.9"
"Calhoun","2020-05-22","32","485","0","115","2.4","8.7"
"Calhoun","2020-05-23","2","487","0","115","2.4","8.7"
"Calhoun","2020-05-24","6","493","2","117","7.1","11.1"
"Calhoun","2020-05-25","17","510","0","117","4.8","11.1"
"Calhoun","2020-05-26","22","532","2","119","6.1","8.2"
"Calhoun","2020-05-27","11","543","1","120","7.4","7.9"
"Calhoun","2020-05-28","15","558","2","122","9.3","6.8"
"Calhoun","2020-05-29","5","563","2","124","15","8.7"
"Calhoun","2020-05-30","4","567","0","124","15","8.7"
"Calhoun","2020-05-31","3","570","1","125","15","11.1"
"Calhoun","2020-06-01","23","593","2","127","16.2","10.5"
"Calhoun","2020-06-02","11","604","1","128","16.2","11.1"
"Calhoun","2020-06-03","13","617","1","129","16","11.7"
"Calhoun","2020-06-04","119","736","7","136","15","12.1"
"Calhoun","2020-06-05","10","746","0","136","9.2","12.1"
"Calhoun","2020-06-06","2","748","1","137","16.4","15.7"
"Calhoun","2020-06-07","0","748","0","137","11.6","13.3"
"Calhoun","2020-06-08","14","762","3","140","13.4","14.8"
"Calhoun","2020-06-09","3","765","1","141","16.9","16.6"
"Calhoun","2020-06-10","5","770","1","142","18.7","17.3"
"Calhoun","2020-06-11","16","786","3","145","20.5","17.7"
"Calhoun","2020-06-12","4","790","0","145","20.5","14.9"
"Calhoun","2020-06-13","3","793","1","146","18.1","17.3"
"Calhoun","2020-06-14","0","793","0","146","18.1","14.9"
"Calhoun","2020-06-15","12","805","0","146","15.1","14.3"
"Calhoun","2020-06-16","23","828","4","150","12.8","14.8"
"Calhoun","2020-06-17","13","841","0","150","9.9","14.3"
"Calhoun","2020-06-18","53","894","5","155","8.6","14.5"
"Calhoun","2020-06-19","12","906","0","155","8.6","14.5"
"Calhoun","2020-06-20","3","909","0","155","3.8","11"
"Calhoun","2020-06-21","4","913","2","157","11","14.5"
"Calhoun","2020-06-22","18","931","1","158","11.8","13.4"
"Calhoun","2020-06-23","10","941","4","162","15","13.9"
"Calhoun","2020-06-24","3","944","0","162","15","12.5"
"Calhoun","2020-06-25","12","956","4","166","18.4","13.5"
"Calhoun","2020-06-26","14","970","4","170","22.5","15.5"
"Calhoun","2020-06-27","1","971","0","170","22.5","13.2"
"Calhoun","2020-06-28","5","976","0","170","15.4","13.2"
"Calhoun","2020-06-29","2","978","0","170","14.6","13.2"
"Calhoun","2020-06-30","9","987","3","173","13.6","14.3"
"Calhoun","2020-07-01","14","1001","2","175","15.6","15.3"
"Calhoun","2020-07-02","8","1009","2","177","14.5","16.4"
"Calhoun","2020-07-03","5","1014","0","177","10.4","16.4"
"Calhoun","2020-07-04","1","1015","0","177","10.4","16.4"
"Calhoun","2020-07-05","1","1016","1","178","24.7","20"
"Calhoun","2020-07-06","12","1028","1","179","25.9","20.2"
"Calhoun","2020-07-07","11","1039","1","180","22.4","18"
"Calhoun","2020-07-08","13","1052","1","181","21.4","18.5"
"Calhoun","2020-07-09","9","1061","2","183","21","17.8"
"Calhoun","2020-07-10","9","1070","1","184","22.6","16.5"
"Calhoun","2020-07-11","1","1071","0","184","22.6","16.5"
"Calhoun","2020-07-12","5","1076","4","188","19.8","22.2"
"Calhoun","2020-07-13","6","1082","0","188","18.6","22.2"
"Calhoun","2020-07-14","17","1099","0","188","17.3","19.8"
"Calhoun","2020-07-15","12","1111","0","188","16.2","18.8"
"Calhoun","2020-07-16","1","1112","0","188","13","17"
"Calhoun","2020-07-17","3","1115","2","190","21","21.8"
"Calhoun","2020-07-18","2","1117","0","190","21","21.8"
"Calhoun","2020-07-19","2","1119","0","190","9.5","14.7"
"Calhoun","2020-07-20","7","1126","1","191","11.6","15.1"
"Calhoun","2020-07-21","7","1133","1","192","13.6","15.4"
"Calhoun","2020-07-22","8","1141","2","194","17.2","16.7"
"Calhoun","2020-07-23","9","1150","2","196","20.4","16.7"
"Calhoun","2020-07-24","13","1163","2","198","13","17"
"Calhoun","2020-07-25","7","1170","4","202","21.2","21.1"
"Calhoun","2020-07-26","1","1171","1","203","35.5","22.5"
"Calhoun","2020-07-27","10","1181","1","204","34.9","23.2"
"Calhoun","2020-07-28","8","1189","2","206","36.4","25"
"Calhoun","2020-07-29","18","1207","3","209","35.2","26.2"
"Calhoun","2020-07-30","13","1220","1","210","33.1","26.7"
"Calhoun","2020-07-31","7","1227","1","211","33","23"
"Calhoun","2020-08-01","4","1231","1","212","28.4","24.8"
"Calhoun","2020-08-02","2","1233","0","212","14.1","24.8"
"Calhoun","2020-08-03","9","1242","0","212","12.7","23.8"
"Calhoun","2020-08-04","10","1252","1","213","10.5","23.5"
"Calhoun","2020-08-05","9","1261","2","215","11.3","23.3"
"Calhoun","2020-08-06","7","1268","2","217","14.3","23.7"
"Calhoun","2020-08-07","31","1299","2","219","13.2","23.1"
"Calhoun","2020-08-08","4","1303","1","220","13.2","20.8"
"Calhoun","2020-08-09","0","1303","0","220","13.2","13.6"
"Calhoun","2020-08-10","7","1310","1","221","15.2","13.9"
"Calhoun","2020-08-11","15","1325","3","224","16.6","13.6"
"Calhoun","2020-08-12","7","1332","0","224","13.5","12.4"
"Calhoun","2020-08-13","6","1338","0","224","9.4","11.8"
"Calhoun","2020-08-14","9","1347","1","225","10.1","11.6"
"Calhoun","2020-08-15","2","1349","1","226","13.6","13.4"
"Calhoun","2020-08-16","2","1351","0","226","13.6","13.4"
"Calhoun","2020-08-17","14","1365","1","227","12.6","13.9"
"Calhoun","2020-08-18","7","1372","2","229","13.8","15.2"
"Calhoun","2020-08-19","13","1385","2","231","16","14.8"
"Calhoun","2020-08-20","9","1394","4","235","22.4","15.9"
"Calhoun","2020-08-21","8","1402","1","236","22.6","16.3"
"Calhoun","2020-08-22","2","1404","0","236","15.4","14.5"
"Calhoun","2020-08-23","2","1406","0","236","15.4","14.5"
"Calhoun","2020-08-24","10","1416","1","237","15.8","14.2"
"Calhoun","2020-08-25","17","1433","1","238","12.6","13.2"
"Calhoun","2020-08-26","6","1439","2","240","15.2","15.6"
"Calhoun","2020-08-27","10","1449","1","241","10.2","16.3"
"Calhoun","2020-08-28","29","1478","0","241","8.5","15.5"
"Calhoun","2020-08-29","0","1478","0","241","8.5","11.9"
"Calhoun","2020-08-30","0","1478","0","241","8.5","11.9"
"Calhoun","2020-08-31","5","1483","0","241","7","11.4"
"Calhoun","2020-09-01","7","1490","0","241","6.2","9.4"
"Calhoun","2020-09-02","12","1502","0","241","1.4","8.3"
"Calhoun","2020-09-03","13","1515","0","241","0","5.1"
"Calhoun","2020-09-04","9","1524","0","241","0","4.2"
"Calhoun","2020-09-05","1","1525","0","241","0","4.2"
"Calhoun","2020-09-06","3","1528","0","241","0","4.2"
"Calhoun","2020-09-07","0","1528","0","241","0","3.5"
"Calhoun","2020-09-08","5","1533","0","241","0","3.1"
"Calhoun","2020-09-09","9","1542","0","241","0","0.7"
"Calhoun","2020-09-10","12","1554","0","241","0","0"
"Calhoun","2020-09-11","13","1567","2","243","2.2","1.1"
"Calhoun","2020-09-12","1","1568","0","243","2.2","1.1"
"Calhoun","2020-09-13","1","1569","0","243","2.2","1.1"
"Calhoun","2020-09-14","19","1588","0","243","2.2","1.1"
"Calhoun","2020-09-15","13","1601","0","243","2.2","1.1"
"Calhoun","2020-09-16","8","1609","1","244","4","2"
"Calhoun","2020-09-17","8","1617","1","245","5.8","2.9"
"Calhoun","2020-09-18","10","1627","2","247","6.4","4.3"
"Calhoun","2020-09-19","2","1629","0","247","6.4","4.3"
"Calhoun","2020-09-20","2","1631","1","248","13.6","7.9"
"Calhoun","2020-09-21","16","1647","0","248","13.6","7.9"
"Calhoun","2020-09-22","13","1660","0","248","13.6","7.9"
"Calhoun","2020-09-23","10","1670","1","249","13.2","8.6"
"Calhoun","2020-09-24","19","1689","2","251","12.9","9.4"
"Calhoun","2020-09-25","14","1703","1","252","11.1","8.8"
"Calhoun","2020-09-26","0","1703","0","252","11.1","8.8"
"Calhoun","2020-09-27","1","1704","0","252","4","8.8"
"Calhoun","2020-09-28","14","1718","1","253","5","9.3"
"Calhoun","2020-09-29","9","1727","1","254","6.6","10.1"
"Calhoun","2020-09-30","16","1743","2","256","6.9","10.1"
"Calhoun","2020-10-01","7","1750","1","257","7.5","10.2"
"Calhoun","2020-10-02","8","1758","0","257","6.4","8.8"
"Calhoun","2020-10-03","2","1760","0","257","6.4","8.8"
"Calhoun","2020-10-04","0","1760","0","257","6.4","5.2"
"Calhoun","2020-10-05","15","1775","0","257","5.4","5.2"
"Calhoun","2020-10-06","31","1806","0","257","3.8","5.2"
"Calhoun","2020-10-07","9","1815","0","257","2","4.5"
"Calhoun","2020-10-08","21","1836","1","258","0.7","4.1"
"Calhoun","2020-10-09","9","1845","2","260","3.9","5.1"
"Calhoun","2020-10-10","2","1847","0","260","3.9","5.1"
"Calhoun","2020-10-11","0","1847","0","260","3.9","5.1"
"Calhoun","2020-10-12","18","1865","2","262","5.4","5.4"
"Calhoun","2020-10-13","13","1878","0","262","5.4","4.6"
"Calhoun","2020-10-14","20","1898","1","263","6.2","4.1"
"Calhoun","2020-10-15","7","1905","0","263","5.5","3.1"
"Calhoun","2020-10-16","19","1924","0","263","2.3","3.1"
"Calhoun","2020-10-17","5","1929","1","264","5.2","4.5"
"Calhoun","2020-10-18","1","1930","0","264","5.2","4.5"
"Calhoun","2020-10-19","16","1946","0","264","3.6","4.5"
"Calhoun","2020-10-20","37","1983","0","264","3.6","4.5"
"Calhoun","2020-10-21","16","1999","2","266","4.6","5.4"
"Calhoun","2020-10-22","18","2017","0","266","4.6","5.1"
"Calhoun","2020-10-23","5","2022","0","266","4.6","3.5"
"Calhoun","2020-10-24","0","2022","0","266","1.8","3.5"
"Calhoun","2020-10-25","0","2022","0","266","1.8","3.5"
"Calhoun","2020-10-26","35","2057","2","268","2.6","3.1"
"Calhoun","2020-10-27","9","2066","0","268","2.6","3.1"
"Calhoun","2020-10-28","14","2080","2","270","2.9","3.8"
"Calhoun","2020-10-29","14","2094","1","271","3.9","4.3"
"Calhoun","2020-10-30","8","2102","0","271","3.9","4.3"
"Calhoun","2020-10-31","5","2107","0","271","3.9","2.8"
"Calhoun","2020-11-01","4","2111","0","271","3.9","2.8"
"Calhoun","2020-11-02","36","2147","1","272","3.5","3"
"Calhoun","2020-11-03","13","2160","1","273","4.6","3.6"
"Calhoun","2020-11-04","26","2186","0","273","2.5","2.7"
"Calhoun","2020-11-05","58","2244","1","274","1.7","2.8"
"Calhoun","2020-11-06","9","2253","0","274","1.7","2.8"
"Calhoun","2020-11-07","1","2254","0","274","1.7","2.8"
"Calhoun","2020-11-08","3","2257","0","274","1.7","2.8"
"Calhoun","2020-11-09","50","2307","0","274","1.3","2.4"
"Calhoun","2020-11-10","3","2310","0","274","0.2","2.4"
"Calhoun","2020-11-11","47","2357","0","274","0.2","1.4"
"Calhoun","2020-11-12","9","2366","0","274","0","0.9"
"Calhoun","2020-11-13","22","2388","2","276","1.3","1.5"
"Calhoun","2020-11-14","1","2389","1","277","15.6","8.7"
"Calhoun","2020-11-15","2","2391","1","278","22.7","12.2"
"Calhoun","2020-11-16","41","2432","0","278","22.7","12"
"Calhoun","2020-11-17","11","2443","0","278","22.7","11.5"
"Calhoun","2020-11-18","27","2470","0","278","22.7","11.5"
"Calhoun","2020-11-19","26","2496","1","279","23.3","11.6"
"Calhoun","2020-11-20","133","2629","2","281","22.2","11.7"
"Calhoun","2020-11-21","3","2632","1","282","12.7","14.1"
"Calhoun","2020-11-22","0","2632","0","282","5.5","14.1"
"Calhoun","2020-11-23","16","2648","2","284","7.3","15"
"Calhoun","2020-11-24","11","2659","1","285","8.6","15.7"
"Calhoun","2020-11-25","7","2666","0","285","8.6","15.7"
"Calhoun","2020-11-26","3","2669","0","285","8.1","15.7"
"Calhoun","2020-11-27","3","2672","0","285","7.8","15"
"Calhoun","2020-11-28","1","2673","0","285","3.1","7.9"
"Calhoun","2020-11-29","3","2676","2","287","12.6","9.1"
"Calhoun","2020-11-30","21","2697","3","290","12.9","10.1"
"Calhoun","2020-12-01","39","2736","3","293","12.7","10.6"
"Calhoun","2020-12-02","27","2763","0","293","12.7","10.6"
"Calhoun","2020-12-03","40","2803","1","294","13","10.5"
"Calhoun","2020-12-04","17","2820","2","296","14.7","11.3"
"Calhoun","2020-12-05","8","2828","3","299","20.1","11.6"
"Calhoun","2020-12-06","0","2828","0","299","10.5","11.6"
"Calhoun","2020-12-07","44","2872","0","299","8.5","10.7"
"Calhoun","2020-12-08","25","2897","1","300","8","10.3"
"Calhoun","2020-12-09","30","2927","1","301","8.4","10.6"
"Calhoun","2020-12-10","24","2951","0","301","8.1","10.6"
"Calhoun","2020-12-11","12","2963","1","302","7.6","11.1"
"Calhoun","2020-12-12","3","2966","0","302","2.2","11.1"
"Calhoun","2020-12-13","2","2968","0","302","2.2","6.4"
"Calhoun","2020-12-14","146","3114","1","303","2.3","5.4"
"Calhoun","2020-12-15","31","3145","2","305","2.7","5.3"
"Calhoun","2020-12-16","13","3158","0","305","2.2","5.3"
"Calhoun","2020-12-17","11","3169","2","307","4.8","6.4"
"Calhoun","2020-12-18","6","3175","1","308","6","6.8"
"Calhoun","2020-12-19","6","3181","0","308","6","4.1"
"Calhoun","2020-12-20","1","3182","1","309","20.3","11.3"
"Calhoun","2020-12-21","3","3185","0","309","20.2","11.3"
"Calhoun","2020-12-22","12","3197","3","312","22.8","12.8"
"Calhoun","2020-12-23","11","3208","5","317","29.3","15.8"
"Calhoun","2020-12-24","9","3217","3","320","31.5","18.2"
"Calhoun","2020-12-25","1","3218","0","320","29.1","17.6"
"Calhoun","2020-12-26","2","3220","0","320","29.1","17.6"
"Calhoun","2020-12-27","3","3223","0","320","14.8","17.6"
"Calhoun","2020-12-28","8","3231","1","321","16.6","18.4"
"Calhoun","2020-12-29","16","3247","1","322","13.9","18.4"
"Calhoun","2020-12-30","13","3260","1","323","8.5","18.9"
"Calhoun","2020-12-31","9","3269","0","323","3.8","17.6"
"Calhoun","2021-01-01","2","3271","1","324","10.9","20"
"Calhoun","2021-01-02","4","3275","0","324","10.9","20"
"Calhoun","2021-01-03","2","3277","0","324","10.9","12.9"
"Calhoun","2021-01-04","35","3312","5","329","11.2","13.9"
"Calhoun","2021-01-05","76","3388","8","337","11.8","12.9"
"Calhoun","2021-01-06","37","3425","5","342","12.6","10.6"
"Calhoun","2021-01-07","24","3449","2","344","13.8","8.8"
"Calhoun","2021-01-08","20","3469","5","349","10.2","10.6"
"Calhoun","2021-01-09","17","3486","3","352","12.8","11.8"
"Calhoun","2021-01-10","43","3529","1","353","13.1","12"
"Calhoun","2021-01-11","28","3557","9","362","15.6","13.4"
"Calhoun","2021-01-12","57","3614","4","366","15.1","13.5"
"Calhoun","2021-01-13","20","3634","3","369","15.4","14"
"Calhoun","2021-01-14","20","3654","2","371","15.6","14.7"
"Calhoun","2021-01-15","29","3683","7","378","15.5","12.9"
"Calhoun","2021-01-16","9","3692","2","380","16.1","14.4"
"Calhoun","2021-01-17","4","3696","0","380","15.8","14.4"
"Calhoun","2021-01-18","26","3722","3","383","12.8","14.2"
"Calhoun","2021-01-19","40","3762","3","386","12.9","14"
"Calhoun","2021-01-20","73","3835","0","386","10.8","13.1"
"Calhoun","2021-01-21","33","3868","2","388","10.2","12.9"
"Calhoun","2021-01-22","21","3889","3","391","8.8","12.1"
"Calhoun","2021-01-23","13","3902","4","395","10","13.1"
"Calhoun","2021-01-24","1","3903","0","395","10","12.9"
"Calhoun","2021-01-25","2","3905","0","395","8.4","10.6"
"Calhoun","2021-01-26","4","3909","1","396","10.9","11.9"
"Calhoun","2021-01-27","0","3909","0","396","10.9","10.8"
"Camden","2020-02-01","0","0","0","0",".","."
"Camden","2020-02-02","0","0","0","0",".","."
"Camden","2020-02-03","0","0","0","0",".","."
"Camden","2020-02-04","0","0","0","0",".","."
"Camden","2020-02-05","0","0","0","0",".","."
"Camden","2020-02-06","0","0","0","0",".","."
"Camden","2020-02-07","0","0","0","0","0","."
"Camden","2020-02-08","0","0","0","0","0","."
"Camden","2020-02-09","0","0","0","0","0","."
"Camden","2020-02-10","0","0","0","0","0","."
"Camden","2020-02-11","0","0","0","0","0","."
"Camden","2020-02-12","0","0","0","0","0","."
"Camden","2020-02-13","0","0","0","0","0","."
"Camden","2020-02-14","0","0","0","0","0","0"
"Camden","2020-02-15","0","0","0","0","0","0"
"Camden","2020-02-16","0","0","0","0","0","0"
"Camden","2020-02-17","0","0","0","0","0","0"
"Camden","2020-02-18","0","0","0","0","0","0"
"Camden","2020-02-19","0","0","0","0","0","0"
"Camden","2020-02-20","0","0","0","0","0","0"
"Camden","2020-02-21","0","0","0","0","0","0"
"Camden","2020-02-22","0","0","0","0","0","0"
"Camden","2020-02-23","0","0","0","0","0","0"
"Camden","2020-02-24","0","0","0","0","0","0"
"Camden","2020-02-25","0","0","0","0","0","0"
"Camden","2020-02-26","0","0","0","0","0","0"
"Camden","2020-02-27","0","0","0","0","0","0"
"Camden","2020-02-28","0","0","0","0","0","0"
"Camden","2020-02-29","0","0","0","0","0","0"
"Camden","2020-03-01","0","0","0","0","0","0"
"Camden","2020-03-02","0","0","0","0","0","0"
"Camden","2020-03-03","0","0","0","0","0","0"
"Camden","2020-03-04","0","0","0","0","0","0"
"Camden","2020-03-05","0","0","0","0","0","0"
"Camden","2020-03-06","0","0","0","0","0","0"
"Camden","2020-03-07","0","0","0","0","0","0"
"Camden","2020-03-08","0","0","0","0","0","0"
"Camden","2020-03-09","0","0","0","0","0","0"
"Camden","2020-03-10","0","0","0","0","0","0"
"Camden","2020-03-11","0","0","0","0","0","0"
"Camden","2020-03-12","0","0","0","0","0","0"
"Camden","2020-03-13","3","3","0","0","0","0"
"Camden","2020-03-14","0","3","0","0","0","0"
"Camden","2020-03-15","4","7","0","0","0","0"
"Camden","2020-03-16","4","11","0","0","0","0"
"Camden","2020-03-17","8","19","0","0","0","0"
"Camden","2020-03-18","8","27","0","0","0","0"
"Camden","2020-03-19","8","35","1","1","1.8","0.9"
"Camden","2020-03-20","8","43","1","2","3.6","1.8"
"Camden","2020-03-21","11","54","0","2","3.6","1.8"
"Camden","2020-03-22","2","56","0","2","3.6","1.8"
"Camden","2020-03-23","16","72","3","5","6.3","3.1"
"Camden","2020-03-24","21","93","1","6","6.9","3.5"
"Camden","2020-03-25","30","123","0","6","6.9","3.5"
"Camden","2020-03-26","12","135","1","7","6.3","4.1"
"Camden","2020-03-27","22","157","0","7","4.5","4.1"
"Camden","2020-03-28","8","165","0","7","4.5","4.1"
"Camden","2020-03-29","4","169","1","8","8.1","5.8"
"Camden","2020-03-30","14","183","1","9","6.5","6.4"
"Camden","2020-03-31","11","194","1","10","7.1","7"
"Camden","2020-04-01","8","202","0","10","7.1","7"
"Camden","2020-04-02","14","216","0","10","5.9","6.1"
"Camden","2020-04-03","20","236","0","10","5.9","5.2"
"Camden","2020-04-04","5","241","0","10","5.9","5.2"
"Camden","2020-04-05","1","242","0","10","2.3","5.2"
"Camden","2020-04-06","10","252","0","10","1.3","3.9"
"Camden","2020-04-07","25","277","0","10","0","3.5"
"Camden","2020-04-08","24","301","3","13","1.8","4.4"
"Camden","2020-04-09","25","326","2","15","2.9","4.4"
"Camden","2020-04-10","12","338","0","15","2.9","4.4"
"Camden","2020-04-11","12","350","0","15","2.9","4.4"
"Camden","2020-04-12","2","352","2","17","17.2","9.8"
"Camden","2020-04-13","8","360","2","19","20.8","11"
"Camden","2020-04-14","116","476","2","21","21","10.5"
"Camden","2020-04-15","32","508","0","21","19.2","10.5"
"Camden","2020-04-16","16","524","0","21","18.1","10.5"
"Camden","2020-04-17","18","542","0","21","18.1","10.5"
"Camden","2020-04-18","12","554","0","21","18.1","10.5"
"Camden","2020-04-19","11","565","0","21","3.8","10.5"
"Camden","2020-04-20","5","570","0","21","0.2","10.5"
"Camden","2020-04-21","15","585","1","22","1","11"
"Camden","2020-04-22","20","605","0","22","1","10.1"
"Camden","2020-04-23","14","619","1","23","2","10"
"Camden","2020-04-24","8","627","0","23","2","10"
"Camden","2020-04-25","3","630","0","23","2","10"
"Camden","2020-04-26","1","631","0","23","2","2.9"
"Camden","2020-04-27","5","636","0","23","2","1.1"
"Camden","2020-04-28","17","653","0","23","1","1"
"Camden","2020-04-29","10","663","1","24","2.4","1.7"
"Camden","2020-04-30","17","680","0","24","1.4","1.7"
"Camden","2020-05-01","13","693","1","25","2.5","2.3"
"Camden","2020-05-02","11","704","2","27","5.1","3.5"
"Camden","2020-05-03","1","705","0","27","5.1","3.5"
"Camden","2020-05-04","14","719","0","27","5.1","3.5"
"Camden","2020-05-05","31","750","0","27","5.1","3.1"
"Camden","2020-05-06","20","770","1","28","4.4","3.4"
"Camden","2020-05-07","14","784","1","29","5.4","3.4"
"Camden","2020-05-08","18","802","0","29","4.3","3.4"
"Camden","2020-05-09","26","828","3","32","3.4","4.3"
"Camden","2020-05-10","3","831","0","32","3.4","4.3"
"Camden","2020-05-11","224","1055","3","35","3.6","4.3"
"Camden","2020-05-12","24","1079","0","35","3.6","4.3"
"Camden","2020-05-13","22","1101","1","36","3.5","4"
"Camden","2020-05-14","36","1137","0","36","2.5","4"
"Camden","2020-05-15","42","1179","1","37","2.8","3.6"
"Camden","2020-05-16","39","1218","1","38","1.5","2.5"
"Camden","2020-05-17","6","1224","0","38","1.5","2.5"
"Camden","2020-05-18","158","1382","8","46","2.1","2.8"
"Camden","2020-05-19","30","1412","1","47","2.6","3.1"
"Camden","2020-05-20","19","1431","0","47","1.9","2.7"
"Camden","2020-05-21","20","1451","0","47","1.9","2.2"
"Camden","2020-05-22","23","1474","2","49","2.8","2.8"
"Camden","2020-05-23","10","1484","0","49","2.4","2"
"Camden","2020-05-24","7","1491","0","49","2.4","2"
"Camden","2020-05-25","22","1513","0","49","1.7","1.9"
"Camden","2020-05-26","8","1521","0","49","1.2","1.9"
"Camden","2020-05-27","14","1535","0","49","1.2","1.6"
"Camden","2020-05-28","27","1562","2","51","2.3","2.1"
"Camden","2020-05-29","32","1594","1","52","1.5","2.2"
"Camden","2020-05-30","19","1613","0","52","1.5","2"
"Camden","2020-05-31","5","1618","0","52","1.5","2"
"Camden","2020-06-01","243","1861","3","55","1.7","1.7"
"Camden","2020-06-02","29","1890","0","55","1.7","1.5"
"Camden","2020-06-03","18","1908","1","56","2.5","1.9"
"Camden","2020-06-04","29","1937","1","57","1.9","2.1"
"Camden","2020-06-05","31","1968","0","57","1.5","1.5"
"Camden","2020-06-06","33","2001","0","57","1.5","1.5"
"Camden","2020-06-07","12","2013","0","57","1.5","1.5"
"Camden","2020-06-08","38","2051","1","58","1.7","1.7"
"Camden","2020-06-09","15","2066","1","59","2.6","2.1"
"Camden","2020-06-10","31","2097","0","59","1.8","2.1"
"Camden","2020-06-11","26","2123","0","59","1.3","1.6"
"Camden","2020-06-12","24","2147","1","60","1.9","1.7"
"Camden","2020-06-13","25","2172","0","60","1.9","1.7"
"Camden","2020-06-14","8","2180","1","61","3.7","2.6"
"Camden","2020-06-15","35","2215","0","61","3.3","2.5"
"Camden","2020-06-16","127","2342","4","65","2.8","2.7"
"Camden","2020-06-17","31","2373","4","69","4.7","3.2"
"Camden","2020-06-18","24","2397","2","71","5.9","3.6"
"Camden","2020-06-19","26","2423","4","75","7.5","4.7"
"Camden","2020-06-20","20","2443","0","75","7.5","4.7"
"Camden","2020-06-21","13","2456","0","75","5.7","4.7"
"Camden","2020-06-22","43","2499","3","78","6.7","5"
"Camden","2020-06-23","90","2589","5","83","7","4.9"
"Camden","2020-06-24","107","2696","3","86","5.6","5.1"
"Camden","2020-06-25","33","2729","5","91","6.6","6.2"
"Camden","2020-06-26","37","2766","7","98","7.1","7.3"
"Camden","2020-06-27","29","2795","3","101","8.5","8"
"Camden","2020-06-28","19","2814","0","101","8.5","7.1"
"Camden","2020-06-29","71","2885","5","106","8.5","7.6"
"Camden","2020-06-30","83","2968","7","113","9","8"
"Camden","2020-07-01","164","3132","7","120","9.2","7.4"
"Camden","2020-07-02","184","3316","13","133","8","7.3"
"Camden","2020-07-03","35","3351","6","139","7.8","7.4"
"Camden","2020-07-04","13","3364","2","141","8.5","8.5"
"Camden","2020-07-05","27","3391","5","146","11.1","9.8"
"Camden","2020-07-06","212","3603","13","159","11","9.8"
"Camden","2020-07-07","260","3863","12","171","10.4","9.7"
"Camden","2020-07-08","177","4040","14","185","11","10.1"
"Camden","2020-07-09","145","4185","10","195","10.9","9.5"
"Camden","2020-07-10","127","4312","19","214","10.6","9.2"
"Camden","2020-07-11","74","4386","9","223","10.2","9.3"
"Camden","2020-07-12","39","4425","2","225","8.3","9.7"
"Camden","2020-07-13","126","4551","11","236","8.6","9.8"
"Camden","2020-07-14","268","4819","23","259","9.2","9.8"
"Camden","2020-07-15","163","4982","31","290","10.8","10.9"
"Camden","2020-07-16","361","5343","23","313","10.7","10.8"
"Camden","2020-07-17","103","5446","17","330","10.9","10.8"
"Camden","2020-07-18","83","5529","12","342","11.3","10.7"
"Camden","2020-07-19","30","5559","3","345","12","10.1"
"Camden","2020-07-20","162","5721","22","367","12.6","10.6"
"Camden","2020-07-21","296","6017","26","393","12.7","10.9"
"Camden","2020-07-22","144","6161","12","405","11.1","11"
"Camden","2020-07-23","274","6435","15","420","11","10.9"
"Camden","2020-07-24","212","6647","28","448","10.5","10.7"
"Camden","2020-07-25","30","6677","5","453","10.9","11.1"
"Camden","2020-07-26","31","6708","2","455","10.4","11.2"
"Camden","2020-07-27","224","6932","19","474","9.6","11.1"
"Camden","2020-07-28","306","7238","31","505","9.8","11.2"
"Camden","2020-07-29","229","7467","27","532","10.3","10.7"
"Camden","2020-07-30","271","7738","23","555","10.7","10.9"
"Camden","2020-07-31","150","7888","14","569","10.2","10.4"
"Camden","2020-08-01","51","7939","7","576","9.8","10.3"
"Camden","2020-08-02","34","7973","2","578","9.7","10"
"Camden","2020-08-03","105","8078","14","592","10.4","10"
"Camden","2020-08-04","154","8232","16","608","10.4","10.1"
"Camden","2020-08-05","157","8389","14","622","10","10.2"
"Camden","2020-08-06","218","8607","11","633","9.5","10.1"
"Camden","2020-08-07","189","8796","8","641","8.8","9.5"
"Camden","2020-08-08","53","8849","5","646","8.2","9"
"Camden","2020-08-09","30","8879","5","651","9.7","9.7"
"Camden","2020-08-10","80","8959","14","665","10.3","10.3"
"Camden","2020-08-11","173","9132","18","683","10.3","10.4"
"Camden","2020-08-12","139","9271","4","687","9.5","9.7"
"Camden","2020-08-13","256","9527","25","712","10.1","9.8"
"Camden","2020-08-14","121","9648","11","723","10.8","9.8"
"Camden","2020-08-15","65","9713","6","729","10.8","9.5"
"Camden","2020-08-16","50","9763","3","732","9.3","9.5"
"Camden","2020-08-17","86","9849","12","744","8.8","9.5"
"Camden","2020-08-18","230","10079","16","760","8.3","9.3"
"Camden","2020-08-19","166","10245","10","770","8.7","9.1"
"Camden","2020-08-20","302","10547","16","786","8.1","9.1"
"Camden","2020-08-21","178","10725","14","800","7.9","9.4"
"Camden","2020-08-22","54","10779","6","806","8.2","9.5"
"Camden","2020-08-23","33","10812","7","813","10.3","9.8"
"Camden","2020-08-24","178","10990","9","822","9.1","8.9"
"Camden","2020-08-25","302","11292","14","836","8.7","8.5"
"Camden","2020-08-26","177","11469","3","839","8.1","8.4"
"Camden","2020-08-27","235","11704","16","855","8.3","8.2"
"Camden","2020-08-28","108","11812","7","862","8.1","8"
"Camden","2020-08-29","34","11846","3","865","7.8","8"
"Camden","2020-08-30","25","11871","2","867","5.9","8.1"
"Camden","2020-08-31","74","11945","8","875","6.8","7.9"
"Camden","2020-09-01","158","12103","15","890","7.4","8.1"
"Camden","2020-09-02","153","12256","13","903","8.4","8.3"
"Camden","2020-09-03","206","12462","14","917","8.4","8.4"
"Camden","2020-09-04","97","12559","9","926","8.8","8.5"
"Camden","2020-09-05","38","12597","4","930","9.1","8.4"
"Camden","2020-09-06","27","12624","5","935","10.6","8.2"
"Camden","2020-09-07","42","12666","5","940","10.7","8.7"
"Camden","2020-09-08","205","12871","21","961","10.8","9.1"
"Camden","2020-09-09","182","13053","19","980","11.1","9.8"
"Camden","2020-09-10","202","13255","12","992","11","9.7"
"Camden","2020-09-11","128","13383","8","1000","10.5","9.7"
"Camden","2020-09-12","39","13422","6","1006","11.2","10.1"
"Camden","2020-09-13","33","13455","4","1010","10.3","10.4"
"Camden","2020-09-14","130","13585","15","1025","10.3","10.5"
"Camden","2020-09-15","253","13838","22","1047","10.1","10.4"
"Camden","2020-09-16","43","13881","5","1052","10.2","10.7"
"Camden","2020-09-17","107","13988","13","1065","11.1","11"
"Camden","2020-09-18","126","14114","7","1072","11","10.8"
"Camden","2020-09-19","39","14153","5","1077","10.6","10.9"
"Camden","2020-09-20","24","14177","1","1078","9.5","9.9"
"Camden","2020-09-21","152","14329","10","1088","8.8","9.5"
"Camden","2020-09-22","294","14623","15","1103","8.3","9.2"
"Camden","2020-09-23","137","14760","4","1107","7","8.6"
"Camden","2020-09-24","188","14948","4","1111","5.6","8.4"
"Camden","2020-09-25","91","15039","5","1116","5.6","8.3"
"Camden","2020-09-26","31","15070","4","1120","5.6","8.1"
"Camden","2020-09-27","23","15093","1","1121","5.6","7.6"
"Camden","2020-09-28","51","15144","1","1122","5","6.9"
"Camden","2020-09-29","85","15229","7","1129","5.4","6.9"
"Camden","2020-09-30","71","15300","11","1140","7.2","7.1"
"Camden","2020-10-01","102","15402","3","1143","7.3","6.5"
"Camden","2020-10-02","80","15482","4","1147","7.3","6.4"
"Camden","2020-10-03","25","15507","2","1149","6.6","6.1"
"Camden","2020-10-04","43","15550","2","1151","6.6","6.1"
"Camden","2020-10-05","87","15637","2","1153","6.7","5.8"
"Camden","2020-10-06","140","15777","5","1158","6","5.7"
"Camden","2020-10-07","147","15924","6","1164","4.4","5.8"
"Camden","2020-10-08","119","16043","8","1172","4.9","6.1"
"Camden","2020-10-09","70","16113","4","1176","5","6.1"
"Camden","2020-10-10","46","16159","2","1178","4.5","5.5"
"Camden","2020-10-11","30","16189","1","1179","4.3","5.5"
"Camden","2020-10-12","49","16238","2","1181","4.6","5.6"
"Camden","2020-10-13","124","16362","4","1185","4.5","5.2"
"Camden","2020-10-14","83","16445","5","1190","4.8","4.6"
"Camden","2020-10-15","80","16525","2","1192","4.2","4.5"
"Camden","2020-10-16","154","16679","3","1195","3.6","4.3"
"Camden","2020-10-17","55","16734","2","1197","3.5","4"
"Camden","2020-10-18","29","16763","4","1201","5","4.7"
"Camden","2020-10-19","153","16916","2","1203","4.6","4.6"
"Camden","2020-10-20","201","17117","3","1206","4.4","4.4"
"Camden","2020-10-21","139","17256","4","1210","3.9","4.4"
"Camden","2020-10-22","89","17345","6","1216","4.5","4.4"
"Camden","2020-10-23","79","17424","6","1222","5.3","4.5"
"Camden","2020-10-24","31","17455","6","1228","7.6","5.6"
"Camden","2020-10-25","29","17484","2","1230","6.6","5.8"
"Camden","2020-10-26","87","17571","12","1242","8.4","6.5"
"Camden","2020-10-27","152","17723","18","1260","9.9","7.1"
"Camden","2020-10-28","72","17795","6","1266","10.7","7.3"
"Camden","2020-10-29","93","17888","6","1272","10.6","7.6"
"Camden","2020-10-30","127","18015","6","1278","10.2","7.8"
"Camden","2020-10-31","44","18059","3","1281","8.4","8"
"Camden","2020-11-01","37","18096","2","1283","8.2","7.4"
"Camden","2020-11-02","160","18256","4","1287","6.6","7.5"
"Camden","2020-11-03","132","18388","14","1301","6.4","8.1"
"Camden","2020-11-04","189","18577","9","1310","5.9","8.3"
"Camden","2020-11-05","129","18706","6","1316","5.6","8.1"
"Camden","2020-11-06","106","18812","8","1324","6","8.1"
"Camden","2020-11-07","65","18877","7","1331","6.6","7.5"
"Camden","2020-11-08","51","18928","7","1338","7.8","8"
"Camden","2020-11-09","114","19042","11","1349","8.8","7.7"
"Camden","2020-11-10","183","19225","14","1363","8.4","7.4"
"Camden","2020-11-11","92","19317","8","1371","9","7.4"
"Camden","2020-11-12","113","19430","15","1386","10.2","7.9"
"Camden","2020-11-13","152","19582","14","1400","10.4","8.2"
"Camden","2020-11-14","62","19644","4","1404","9.8","8.2"
"Camden","2020-11-15","46","19690","6","1410","9.7","8.8"
"Camden","2020-11-16","143","19833","16","1426","9.9","9.4"
"Camden","2020-11-17","290","20123","29","1455","10.3","9.3"
"Camden","2020-11-18","207","20330","12","1467","9.9","9.4"
"Camden","2020-11-19","160","20490","23","1490","10","10.1"
"Camden","2020-11-20","137","20627","20","1510","10.8","10.6"
"Camden","2020-11-21","77","20704","13","1523","12.3","11"
"Camden","2020-11-22","60","20764","3","1526","11.1","10.4"
"Camden","2020-11-23","114","20878","8","1534","10.5","10.2"
"Camden","2020-11-24","187","21065","10","1544","9.9","10.1"
"Camden","2020-11-25","135","21200","7","1551","9.8","9.8"
"Camden","2020-11-26","14","21214","2","1553","9.8","9.9"
"Camden","2020-11-27","107","21321","22","1575","10.6","10.7"
"Camden","2020-11-28","84","21405","9","1584","9.7","11"
"Camden","2020-11-29","39","21444","6","1590","11.2","11.2"
"Camden","2020-11-30","328","21772","16","1606","10.9","10.7"
"Camden","2020-12-01","235","22007","15","1621","11.1","10.5"
"Camden","2020-12-02","203","22210","10","1631","11","10.4"
"Camden","2020-12-03","156","22366","14","1645","10.3","10"
"Camden","2020-12-04","130","22496","17","1662","9.2","9.9"
"Camden","2020-12-05","61","22557","2","1664","8.1","8.9"
"Camden","2020-12-06","46","22603","6","1670","7.8","9.5"
"Camden","2020-12-07","245","22848","16","1686","8","9.5"
"Camden","2020-12-08","243","23091","19","1705","8.2","9.6"
"Camden","2020-12-09","112","23203","21","1726","10.2","10.6"
"Camden","2020-12-10","124","23327","16","1742","10.8","10.5"
"Camden","2020-12-11","211","23538","13","1755","9.8","9.5"
"Camden","2020-12-12","80","23618","11","1766","11.3","9.7"
"Camden","2020-12-13","39","23657","7","1773","12","9.9"
"Camden","2020-12-14","425","24082","23","1796","11.8","9.9"
"Camden","2020-12-15","243","24325","18","1814","11.8","10"
"Camden","2020-12-16","209","24534","21","1835","10.5","10.4"
"Camden","2020-12-17","150","24684","16","1851","10.2","10.5"
"Camden","2020-12-18","152","24836","14","1865","10.6","10.2"
"Camden","2020-12-19","71","24907","10","1875","10.7","11"
"Camden","2020-12-20","59","24966","8","1883","10.1","11"
"Camden","2020-12-21","145","25111","25","1908","11.7","11.8"
"Camden","2020-12-22","300","25411","40","1948","12.6","12.2"
"Camden","2020-12-23","125","25536","16","1964","13","11.8"
"Camden","2020-12-24","86","25622","8","1972","12.8","11.5"
"Camden","2020-12-25","16","25638","2","1974","13.3","11.9"
"Camden","2020-12-26","64","25702","18","1992","15.3","13"
"Camden","2020-12-27","54","25756","17","2009","17.8","13.9"
"Camden","2020-12-28","199","25955","33","2042","17.7","14.7"
"Camden","2020-12-29","321","26276","50","2092","18.1","15.3"
"Camden","2020-12-30","162","26438","30","2122","18.9","15.9"
"Camden","2020-12-31","120","26558","16","2138","19.4","16.1"
"Camden","2021-01-01","57","26615","7","2145","19.4","16.3"
"Camden","2021-01-02","49","26664","6","2151","17.1","16.2"
"Camden","2021-01-03","64","26728","18","2169","16.7","17.2"
"Camden","2021-01-04","183","26911","37","2206","17.2","17.5"
"Camden","2021-01-05","450","27361","47","2253","16.5","17.3"
"Camden","2021-01-06","212","27573","20","2273","15.2","17"
"Camden","2021-01-07","169","27742","15","2288","14.5","17"
"Camden","2021-01-08","235","27977","22","2310","14.1","16.8"
"Camden","2021-01-09","63","28040","14","2324","15.5","16.3"
"Camden","2021-01-10","70","28110","11","2335","13.8","15.2"
"Camden","2021-01-11","143","28253","24","2359","13.3","15.2"
"Camden","2021-01-12","315","28568","32","2391","13.2","14.8"
"Camden","2021-01-13","160","28728","22","2413","13.8","14.5"
"Camden","2021-01-14","152","28880","17","2430","14.2","14.3"
"Camden","2021-01-15","283","29163","23","2453","14","14"
"Camden","2021-01-16","57","29220","12","2465","13.8","14.7"
"Camden","2021-01-17","60","29280","12","2477","14.4","14.1"
"Camden","2021-01-18","116","29396","18","2495","14.3","13.8"
"Camden","2021-01-19","411","29807","34","2529","14","13.6"
"Camden","2021-01-20","228","30035","21","2550","13.3","13.6"
"Camden","2021-01-21","231","30266","20","2570","13","13.6"
"Camden","2021-01-22","197","30463","16","2586","13","13.5"
"Camden","2021-01-23","48","30511","10","2596","12.9","13.4"
"Camden","2021-01-24","35","30546","3","2599","11.3","12.9"
"Camden","2021-01-25","84","30630","9","2608","10.6","12.4"
"Camden","2021-01-26","3","30633","1","2609","14.2","14.1"
"Camden","2021-01-27","0","30633","0","2609","12.9","13.1"
"Candler","2020-02-01","0","0","0","0",".","."
"Candler","2020-02-02","0","0","0","0",".","."
"Candler","2020-02-03","0","0","0","0",".","."
"Candler","2020-02-04","0","0","0","0",".","."
"Candler","2020-02-05","0","0","0","0",".","."
"Candler","2020-02-06","0","0","0","0",".","."
"Candler","2020-02-07","0","0","0","0","0","."
"Candler","2020-02-08","0","0","0","0","0","."
"Candler","2020-02-09","0","0","0","0","0","."
"Candler","2020-02-10","0","0","0","0","0","."
"Candler","2020-02-11","0","0","0","0","0","."
"Candler","2020-02-12","0","0","0","0","0","."
"Candler","2020-02-13","0","0","0","0","0","."
"Candler","2020-02-14","0","0","0","0","0","0"
"Candler","2020-02-15","0","0","0","0","0","0"
"Candler","2020-02-16","0","0","0","0","0","0"
"Candler","2020-02-17","0","0","0","0","0","0"
"Candler","2020-02-18","0","0","0","0","0","0"
"Candler","2020-02-19","0","0","0","0","0","0"
"Candler","2020-02-20","0","0","0","0","0","0"
"Candler","2020-02-21","0","0","0","0","0","0"
"Candler","2020-02-22","0","0","0","0","0","0"
"Candler","2020-02-23","0","0","0","0","0","0"
"Candler","2020-02-24","0","0","0","0","0","0"
"Candler","2020-02-25","0","0","0","0","0","0"
"Candler","2020-02-26","0","0","0","0","0","0"
"Candler","2020-02-27","0","0","0","0","0","0"
"Candler","2020-02-28","0","0","0","0","0","0"
"Candler","2020-02-29","0","0","0","0","0","0"
"Candler","2020-03-01","0","0","0","0","0","0"
"Candler","2020-03-02","0","0","0","0","0","0"
"Candler","2020-03-03","0","0","0","0","0","0"
"Candler","2020-03-04","0","0","0","0","0","0"
"Candler","2020-03-05","0","0","0","0","0","0"
"Candler","2020-03-06","0","0","0","0","0","0"
"Candler","2020-03-07","0","0","0","0","0","0"
"Candler","2020-03-08","0","0","0","0","0","0"
"Candler","2020-03-09","0","0","0","0","0","0"
"Candler","2020-03-10","0","0","0","0","0","0"
"Candler","2020-03-11","0","0","0","0","0","0"
"Candler","2020-03-12","0","0","0","0","0","0"
"Candler","2020-03-13","0","0","0","0","0","0"
"Candler","2020-03-14","0","0","0","0","0","0"
"Candler","2020-03-15","0","0","0","0","0","0"
"Candler","2020-03-16","1","1","0","0","0","0"
"Candler","2020-03-17","1","2","0","0","0","0"
"Candler","2020-03-18","0","2","0","0","0","0"
"Candler","2020-03-19","2","4","0","0","0","0"
"Candler","2020-03-20","3","7","0","0","0","0"
"Candler","2020-03-21","1","8","0","0","0","0"
"Candler","2020-03-22","0","8","0","0","0","0"
"Candler","2020-03-23","5","13","1","1","2.9","1.4"
"Candler","2020-03-24","1","14","0","1","2.9","1.4"
"Candler","2020-03-25","2","16","0","1","2.9","1.4"
"Candler","2020-03-26","2","18","0","1","2.9","1.4"
"Candler","2020-03-27","0","18","0","1","2.9","1.4"
"Candler","2020-03-28","0","18","0","1","2.9","1.4"
"Candler","2020-03-29","0","18","0","1","2.9","1.4"
"Candler","2020-03-30","3","21","1","2","4.8","3.8"
"Candler","2020-03-31","2","23","0","2","4.8","3.8"
"Candler","2020-04-01","3","26","0","2","4.8","3.8"
"Candler","2020-04-02","4","30","0","2","4.8","3.8"
"Candler","2020-04-03","0","30","0","2","4.8","3.8"
"Candler","2020-04-04","0","30","0","2","4.8","3.8"
"Candler","2020-04-05","0","30","0","2","4.8","3.8"
"Candler","2020-04-06","5","35","0","2","0","2.4"
"Candler","2020-04-07","5","40","0","2","0","2.4"
"Candler","2020-04-08","0","40","0","2","0","2.4"
"Candler","2020-04-09","1","41","0","2","0","2.4"
"Candler","2020-04-10","1","42","0","2","0","2.4"
"Candler","2020-04-11","0","42","0","2","0","2.4"
"Candler","2020-04-12","0","42","0","2","0","2.4"
"Candler","2020-04-13","1","43","0","2","0","0"
"Candler","2020-04-14","2","45","0","2","0","0"
"Candler","2020-04-15","1","46","0","2","0","0"
"Candler","2020-04-16","2","48","0","2","0","0"
"Candler","2020-04-17","9","57","0","2","0","0"
"Candler","2020-04-18","1","58","0","2","0","0"
"Candler","2020-04-19","0","58","0","2","0","0"
"Candler","2020-04-20","3","61","0","2","0","0"
"Candler","2020-04-21","2","63","0","2","0","0"
"Candler","2020-04-22","0","63","0","2","0","0"
"Candler","2020-04-23","4","67","1","3","3.6","1.8"
"Candler","2020-04-24","1","68","0","3","3.6","1.8"
"Candler","2020-04-25","1","69","0","3","3.6","1.8"
"Candler","2020-04-26","1","70","0","3","3.6","1.8"
"Candler","2020-04-27","3","73","0","3","3.6","1.8"
"Candler","2020-04-28","1","74","0","3","3.6","1.8"
"Candler","2020-04-29","0","74","0","3","3.6","1.8"
"Candler","2020-04-30","1","75","0","3","0","1.8"
"Candler","2020-05-01","0","75","0","3","0","1.8"
"Candler","2020-05-02","1","76","0","3","0","1.8"
"Candler","2020-05-03","1","77","1","4","14.3","8.9"
"Candler","2020-05-04","4","81","0","4","14.3","8.9"
"Candler","2020-05-05","1","82","0","4","14.3","8.9"
"Candler","2020-05-06","3","85","0","4","14.3","8.9"
"Candler","2020-05-07","8","93","0","4","14.3","7.1"
"Candler","2020-05-08","2","95","1","5","21.4","10.7"
"Candler","2020-05-09","0","95","0","5","21.4","10.7"
"Candler","2020-05-10","1","96","1","6","21.4","17.9"
"Candler","2020-05-11","4","100","0","6","21.4","17.9"
"Candler","2020-05-12","1","101","0","6","21.4","17.9"
"Candler","2020-05-13","1","102","0","6","21.4","17.9"
"Candler","2020-05-14","4","106","0","6","21.4","17.9"
"Candler","2020-05-15","4","110","0","6","14.3","17.9"
"Candler","2020-05-16","0","110","0","6","14.3","17.9"
"Candler","2020-05-17","0","110","0","6","0","10.7"
"Candler","2020-05-18","5","115","0","6","0","10.7"
"Candler","2020-05-19","3","118","0","6","0","10.7"
"Candler","2020-05-20","2","120","0","6","0","10.7"
"Candler","2020-05-21","118","238","0","6","0","10.7"
"Candler","2020-05-22","8","246","0","6","0","7.1"
"Candler","2020-05-23","0","246","0","6","0","7.1"
"Candler","2020-05-24","19","265","0","6","0","0"
"Candler","2020-05-25","1","266","0","6","0","0"
"Candler","2020-05-26","8","274","0","6","0","0"
"Candler","2020-05-27","2","276","0","6","0","0"
"Candler","2020-05-28","2","278","0","6","0","0"
"Candler","2020-05-29","8","286","0","6","0","0"
"Candler","2020-05-30","0","286","0","6","0","0"
"Candler","2020-05-31","0","286","0","6","0","0"
"Candler","2020-06-01","6","292","1","7","2.4","1.2"
"Candler","2020-06-02","1","293","0","7","2.4","1.2"
"Candler","2020-06-03","1","294","0","7","2.4","1.2"
"Candler","2020-06-04","5","299","0","7","2.4","1.2"
"Candler","2020-06-05","8","307","0","7","2.4","1.2"
"Candler","2020-06-06","1","308","0","7","2.4","1.2"
"Candler","2020-06-07","0","308","0","7","2.4","1.2"
"Candler","2020-06-08","4","312","0","7","0","1.2"
"Candler","2020-06-09","4","316","0","7","0","1.2"
"Candler","2020-06-10","15","331","0","7","0","1.2"
"Candler","2020-06-11","4","335","0","7","0","1.2"
"Candler","2020-06-12","5","340","0","7","0","1.2"
"Candler","2020-06-13","2","342","0","7","0","1.2"
"Candler","2020-06-14","0","342","0","7","0","1.2"
"Candler","2020-06-15","4","346","1","8","3.6","1.8"
"Candler","2020-06-16","2","348","0","8","3.6","1.8"
"Candler","2020-06-17","5","353","1","9","6.4","3.2"
"Candler","2020-06-18","27","380","3","12","8","4"
"Candler","2020-06-19","10","390","1","13","9.4","4.7"
"Candler","2020-06-20","4","394","0","13","9.4","4.7"
"Candler","2020-06-21","0","394","0","13","9.4","4.7"
"Candler","2020-06-22","24","418","3","16","7.7","5.6"
"Candler","2020-06-23","18","436","4","20","10.8","7.2"
"Candler","2020-06-24","66","502","6","26","9.3","7.9"
"Candler","2020-06-25","13","515","4","30","12.1","10"
"Candler","2020-06-26","10","525","1","31","12.1","10.8"
"Candler","2020-06-27","3","528","0","31","12.1","10.8"
"Candler","2020-06-28","1","529","0","31","12.1","10.8"
"Candler","2020-06-29","38","567","5","36","12.2","9.9"
"Candler","2020-06-30","27","594","6","42","12.2","11.5"
"Candler","2020-07-01","18","612","2","44","12.5","10.9"
"Candler","2020-07-02","37","649","2","46","8.8","10.5"
"Candler","2020-07-03","15","664","4","50","11.2","11.7"
"Candler","2020-07-04","1","665","1","51","25.5","18.8"
"Candler","2020-07-05","4","669","3","54","36.2","24.2"
"Candler","2020-07-06","38","707","5","59","36.2","24.2"
"Candler","2020-07-07","27","734","6","65","36.2","24.2"
"Candler","2020-07-08","28","762","8","73","38.7","25.6"
"Candler","2020-07-09","18","780","7","80","43.5","26.2"
"Candler","2020-07-10","20","800","2","82","41.1","26.2"
"Candler","2020-07-11","1","801","0","82","26.8","26.2"
"Candler","2020-07-12","3","804","2","84","25.6","30.9"
"Candler","2020-07-13","35","839","9","93","27.4","31.8"
"Candler","2020-07-14","30","869","6","99","27.1","31.7"
"Candler","2020-07-15","29","898","13","112","29.4","34.1"
"Candler","2020-07-16","27","925","7","119","27.6","35.5"
"Candler","2020-07-17","30","955","9","128","30.4","35.8"
"Candler","2020-07-18","5","960","0","128","30.4","28.6"
"Candler","2020-07-19","3","963","1","129","25.7","25.7"
"Candler","2020-07-20","53","1016","16","145","26.3","26.9"
"Candler","2020-07-21","36","1052","7","152","26.2","26.7"
"Candler","2020-07-22","46","1098","7","159","22","25.7"
"Candler","2020-07-23","37","1135","6","165","20.6","24.1"
"Candler","2020-07-24","18","1153","5","170","20.3","25.4"
"Candler","2020-07-25","1","1154","0","170","20.3","25.4"
"Candler","2020-07-26","6","1160","3","173","22.7","24.2"
"Candler","2020-07-27","25","1185","8","181","23","24.6"
"Candler","2020-07-28","18","1203","5","186","24.1","25.2"
"Candler","2020-07-29","33","1236","6","192","24.6","23.3"
"Candler","2020-07-30","10","1246","3","195","26.5","23.6"
"Candler","2020-07-31","18","1264","2","197","24.2","22.2"
"Candler","2020-08-01","13","1277","1","198","25.3","22.8"
"Candler","2020-08-02","2","1279","0","198","18.1","20.4"
"Candler","2020-08-03","15","1294","2","200","15.4","19.2"
"Candler","2020-08-04","6","1300","0","200","11.5","17.8"
"Candler","2020-08-05","23","1323","6","206","12.6","18.6"
"Candler","2020-08-06","11","1334","4","210","13.5","20"
"Candler","2020-08-07","13","1347","0","210","11.9","18"
"Candler","2020-08-08","6","1353","0","210","10.8","18"
"Candler","2020-08-09","3","1356","1","211","15.6","16.8"
"Candler","2020-08-10","9","1365","3","214","18.4","16.9"
"Candler","2020-08-11","8","1373","3","217","23.8","17.6"
"Candler","2020-08-12","14","1387","4","221","24.2","18.4"
"Candler","2020-08-13","5","1392","2","223","24.7","19.1"
"Candler","2020-08-14","8","1400","0","223","24.7","18.3"
"Candler","2020-08-15","5","1405","4","227","36.1","23.5"
"Candler","2020-08-16","15","1420","6","233","37.1","26.3"
"Candler","2020-08-17","16","1436","2","235","34.1","26.3"
"Candler","2020-08-18","17","1453","3","238","31.2","27.5"
"Candler","2020-08-19","13","1466","1","239","28.3","26.2"
"Candler","2020-08-20","45","1511","1","240","22.9","23.8"
"Candler","2020-08-21","23","1534","3","243","24.7","24.7"
"Candler","2020-08-22","2","1536","1","244","20.4","28.3"
"Candler","2020-08-23","2","1538","0","244","14.7","25.9"
"Candler","2020-08-24","27","1565","11","255","18.8","26.4"
"Candler","2020-08-25","19","1584","9","264","23","27.1"
"Candler","2020-08-26","22","1606","5","269","25.2","26.7"
"Candler","2020-08-27","20","1626","2","271","26.3","24.6"
"Candler","2020-08-28","27","1653","8","279","28.6","26.7"
"Candler","2020-08-29","6","1659","0","279","21.5","21"
"Candler","2020-08-30","7","1666","4","283","29.7","22.2"
"Candler","2020-08-31","14","1680","2","285","25.9","22.3"
"Candler","2020-09-01","19","1699","4","289","22.1","22.6"
"Candler","2020-09-02","22","1721","8","297","24.1","24.6"
"Candler","2020-09-03","26","1747","3","300","24.3","25.3"
"Candler","2020-09-04","27","1774","1","301","20.6","24.6"
"Candler","2020-09-05","5","1779","2","303","26.3","23.9"
"Candler","2020-09-06","2","1781","1","304","25.3","27.5"
"Candler","2020-09-07","2","1783","2","306","37.5","31.7"
"Candler","2020-09-08","16","1799","5","311","39","30.5"
"Candler","2020-09-09","13","1812","2","313","36","30"
"Candler","2020-09-10","43","1855","1","314","34.7","29.5"
"Candler","2020-09-11","11","1866","2","316","36.7","28.7"
"Candler","2020-09-12","1","1867","0","316","31","28.7"
"Candler","2020-09-13","1","1868","1","317","38.2","31.7"
"Candler","2020-09-14","12","1880","2","319","26.3","31.9"
"Candler","2020-09-15","12","1892","4","323","26.6","32.8"
"Candler","2020-09-16","6","1898","4","327","33.9","34.9"
"Candler","2020-09-17","34","1932","9","336","37.3","36"
"Candler","2020-09-18","4","1936","1","337","38.3","37.5"
"Candler","2020-09-19","1","1937","0","337","38.3","34.7"
"Candler","2020-09-20","2","1939","0","337","24","31.1"
"Candler","2020-09-21","16","1955","5","342","26.1","26.2"
"Candler","2020-09-22","13","1968","0","342","21.3","23.9"
"Candler","2020-09-23","4","1972","2","344","19","26.4"
"Candler","2020-09-24","32","2004","4","348","17","27.1"
"Candler","2020-09-25","18","2022","4","352","16.6","27.4"
"Candler","2020-09-26","4","2026","1","353","20.1","29.2"
"Candler","2020-09-27","0","2026","0","353","20.1","22.1"
"Candler","2020-09-28","3","2029","0","353","15.7","20.9"
"Candler","2020-09-29","19","2048","4","357","18.7","20"
"Candler","2020-09-30","20","2068","3","360","13.7","16.3"
"Candler","2020-10-01","32","2100","3","363","13.2","15.1"
"Candler","2020-10-02","5","2105","1","364","12.9","14.7"
"Candler","2020-10-03","1","2106","0","364","9.3","14.7"
"Candler","2020-10-04","8","2114","1","365","11.1","15.6"
"Candler","2020-10-05","13","2127","5","370","16.6","16.2"
"Candler","2020-10-06","7","2134","1","371","15.7","17.2"
"Candler","2020-10-07","5","2139","1","372","16.4","15"
"Candler","2020-10-08","46","2185","10","382","18.1","15.7"
"Candler","2020-10-09","6","2191","2","384","20","16.5"
"Candler","2020-10-10","2","2193","0","384","20","14.7"
"Candler","2020-10-11","2","2195","0","384","18.3","14.7"
"Candler","2020-10-12","4","2199","0","384","12.8","14.7"
"Candler","2020-10-13","4","2203","1","385","14.3","15"
"Candler","2020-10-14","2","2205","2","387","25.7","21"
"Candler","2020-10-15","33","2238","5","392","24.8","21.5"
"Candler","2020-10-16","5","2243","2","394","25.7","22.9"
"Candler","2020-10-17","3","2246","0","394","25.7","22.9"
"Candler","2020-10-18","3","2249","2","396","35.3","26.8"
"Candler","2020-10-19","3","2252","0","396","35.3","24"
"Candler","2020-10-20","4","2256","1","397","35.3","24.8"
"Candler","2020-10-21","4","2260","1","398","24.5","25.1"
"Candler","2020-10-22","24","2284","3","401","24.2","24.5"
"Candler","2020-10-23","4","2288","2","403","25.6","25.7"
"Candler","2020-10-24","3","2291","1","404","30.4","28"
"Candler","2020-10-25","1","2292","0","404","20.8","28"
"Candler","2020-10-26","2","2294","0","404","20.8","28"
"Candler","2020-10-27","3","2297","1","405","22","28.6"
"Candler","2020-10-28","4","2301","0","405","18.5","21.5"
"Candler","2020-10-29","28","2329","1","406","17.2","20.7"
"Candler","2020-10-30","2","2331","0","406","10","17.8"
"Candler","2020-10-31","2","2333","0","406","5.3","17.8"
"Candler","2020-11-01","0","2333","0","406","5.3","13.1"
"Candler","2020-11-02","6","2339","1","407","7.7","14.2"
"Candler","2020-11-03","3","2342","0","407","2.9","12.5"
"Candler","2020-11-04","6","2348","0","407","2.9","10.7"
"Candler","2020-11-05","21","2369","3","410","4.4","10.8"
"Candler","2020-11-06","4","2373","0","410","4.4","7.2"
"Candler","2020-11-07","2","2375","0","410","4.4","4.8"
"Candler","2020-11-08","1","2376","0","410","4.4","4.8"
"Candler","2020-11-09","5","2381","0","410","2","4.8"
"Candler","2020-11-10","3","2384","0","410","2","2.5"
"Candler","2020-11-11","3","2387","0","410","2","2.5"
"Candler","2020-11-12","20","2407","1","411","0.7","2.6"
"Candler","2020-11-13","4","2411","0","411","0.7","2.6"
"Candler","2020-11-14","0","2411","0","411","0.7","2.6"
"Candler","2020-11-15","1","2412","1","412","15","9.7"
"Candler","2020-11-16","2","2414","0","412","15","8.5"
"Candler","2020-11-17","7","2421","0","412","15","8.5"
"Candler","2020-11-18","7","2428","0","412","15","8.5"
"Candler","2020-11-19","6","2434","0","412","14.3","7.5"
"Candler","2020-11-20","6","2440","0","412","14.3","7.5"
"Candler","2020-11-21","2","2442","0","412","14.3","7.5"
"Candler","2020-11-22","2","2444","0","412","0","7.5"
"Candler","2020-11-23","5","2449","0","412","0","7.5"
"Candler","2020-11-24","6","2455","0","412","0","7.5"
"Candler","2020-11-25","2","2457","0","412","0","7.5"
"Candler","2020-11-26","0","2457","0","412","0","7.1"
"Candler","2020-11-27","1","2458","0","412","0","7.1"
"Candler","2020-11-28","2","2460","0","412","0","7.1"
"Candler","2020-11-29","0","2460","0","412","0","0"
"Candler","2020-11-30","2","2462","0","412","0","0"
"Candler","2020-12-01","6","2468","0","412","0","0"
"Candler","2020-12-02","2","2470","0","412","0","0"
"Candler","2020-12-03","10","2480","3","415","4.3","2.1"
"Candler","2020-12-04","3","2483","2","417","13.8","6.9"
"Candler","2020-12-05","1","2484","0","417","13.8","6.9"
"Candler","2020-12-06","3","2487","0","417","13.8","6.9"
"Candler","2020-12-07","7","2494","1","418","15.9","7.9"
"Candler","2020-12-08","3","2497","0","418","15.9","7.9"
"Candler","2020-12-09","8","2505","0","418","15.9","7.9"
"Candler","2020-12-10","5","2510","0","418","11.6","7.9"
"Candler","2020-12-11","5","2515","1","419","4.9","9.4"
"Candler","2020-12-12","1","2516","0","419","4.9","9.4"
"Candler","2020-12-13","2","2518","0","419","4.9","9.4"
"Candler","2020-12-14","3","2521","1","420","7.6","11.7"
"Candler","2020-12-15","6","2527","0","420","7.6","11.7"
"Candler","2020-12-16","4","2531","3","423","18.3","17.1"
"Candler","2020-12-17","37","2568","3","426","19.5","15.5"
"Candler","2020-12-18","7","2575","0","426","16.6","10.8"
"Candler","2020-12-19","6","2581","1","427","19","12"
"Candler","2020-12-20","7","2588","1","428","21.1","13"
"Candler","2020-12-21","13","2601","0","428","16.3","12"
"Candler","2020-12-22","9","2610","1","429","17.9","12.8"
"Candler","2020-12-23","5","2615","0","429","7.2","12.8"
"Candler","2020-12-24","5","2620","0","429","6","12.8"
"Candler","2020-12-25","0","2620","0","429","6","11.3"
"Candler","2020-12-26","2","2622","1","430","10.8","14.9"
"Candler","2020-12-27","0","2622","0","430","8.7","14.9"
"Candler","2020-12-28","9","2631","5","435","16.7","16.5"
"Candler","2020-12-29","9","2640","1","436","16.7","17.3"
"Candler","2020-12-30","9","2649","3","439","21.4","14.3"
"Candler","2020-12-31","5","2654","2","441","27.1","16.6"
"Candler","2021-01-01","1","2655","0","441","27.1","16.6"
"Candler","2021-01-02","0","2655","0","441","20","15.4"
"Candler","2021-01-03","4","2659","2","443","27.1","17.9"
"Candler","2021-01-04","11","2670","9","452","30.9","23.8"
"Candler","2021-01-05","9","2679","1","453","30.9","23.8"
"Candler","2021-01-06","5","2684","1","454","29","25.2"
"Candler","2021-01-07","49","2733","6","460","25","26.1"
"Candler","2021-01-08","8","2741","3","463","30.4","28.8"
"Candler","2021-01-09","6","2747","4","467","39.9","30"
"Candler","2021-01-10","7","2754","4","471","40.9","34"
"Candler","2021-01-11","5","2759","1","472","32.1","31.5"
"Candler","2021-01-12","12","2771","5","477","36.5","33.7"
"Candler","2021-01-13","8","2779","2","479","37.2","33.1"
"Candler","2021-01-14","36","2815","6","485","37.8","31.4"
"Candler","2021-01-15","6","2821","1","486","34.8","32.6"
"Candler","2021-01-16","4","2825","4","490","39.6","39.7"
"Candler","2021-01-17","3","2828","0","490","31.4","36.2"
"Candler","2021-01-18","7","2835","2","492","32.7","32.4"
"Candler","2021-01-19","14","2849","5","497","31.8","34.1"
"Candler","2021-01-20","10","2859","1","498","29.7","33.4"
"Candler","2021-01-21","119","2978","17","515","29.3","33.6"
"Candler","2021-01-22","6","2984","1","516","29.3","32.1"
"Candler","2021-01-23","2","2986","1","517","22.2","30.9"
"Candler","2021-01-24","0","2986","0","517","22.2","26.8"
"Candler","2021-01-25","6","2992","1","518","20.5","26.6"
"Candler","2021-01-26","0","2992","0","518","15.4","23.6"
"Candler","2021-01-27","0","2992","0","518","13.9","21.8"
"Carroll","2020-02-01","0","0","0","0",".","."
"Carroll","2020-02-02","0","0","0","0",".","."
"Carroll","2020-02-03","0","0","0","0",".","."
"Carroll","2020-02-04","0","0","0","0",".","."
"Carroll","2020-02-05","0","0","0","0",".","."
"Carroll","2020-02-06","0","0","0","0",".","."
"Carroll","2020-02-07","0","0","0","0","0","."
"Carroll","2020-02-08","0","0","0","0","0","."
"Carroll","2020-02-09","0","0","0","0","0","."
"Carroll","2020-02-10","0","0","0","0","0","."
"Carroll","2020-02-11","0","0","0","0","0","."
"Carroll","2020-02-12","0","0","0","0","0","."
"Carroll","2020-02-13","0","0","0","0","0","."
"Carroll","2020-02-14","0","0","0","0","0","0"
"Carroll","2020-02-15","0","0","0","0","0","0"
"Carroll","2020-02-16","0","0","0","0","0","0"
"Carroll","2020-02-17","0","0","0","0","0","0"
"Carroll","2020-02-18","0","0","0","0","0","0"
"Carroll","2020-02-19","0","0","0","0","0","0"
"Carroll","2020-02-20","0","0","0","0","0","0"
"Carroll","2020-02-21","0","0","0","0","0","0"
"Carroll","2020-02-22","0","0","0","0","0","0"
"Carroll","2020-02-23","0","0","0","0","0","0"
"Carroll","2020-02-24","0","0","0","0","0","0"
"Carroll","2020-02-25","0","0","0","0","0","0"
"Carroll","2020-02-26","0","0","0","0","0","0"
"Carroll","2020-02-27","0","0","0","0","0","0"
"Carroll","2020-02-28","0","0","0","0","0","0"
"Carroll","2020-02-29","0","0","0","0","0","0"
"Carroll","2020-03-01","0","0","0","0","0","0"
"Carroll","2020-03-02","0","0","0","0","0","0"
"Carroll","2020-03-03","0","0","0","0","0","0"
"Carroll","2020-03-04","0","0","0","0","0","0"
"Carroll","2020-03-05","0","0","0","0","0","0"
"Carroll","2020-03-06","2","2","0","0","0","0"
"Carroll","2020-03-07","0","2","0","0","0","0"
"Carroll","2020-03-08","0","2","0","0","0","0"
"Carroll","2020-03-09","1","3","0","0","0","0"
"Carroll","2020-03-10","2","5","0","0","0","0"
"Carroll","2020-03-11","5","10","0","0","0","0"
"Carroll","2020-03-12","10","20","0","0","0","0"
"Carroll","2020-03-13","15","35","4","4","3.8","1.9"
"Carroll","2020-03-14","9","44","4","8","10.2","5.1"
"Carroll","2020-03-15","13","57","3","11","13.5","6.7"
"Carroll","2020-03-16","31","88","4","15","15.3","7.6"
"Carroll","2020-03-17","60","148","5","20","16.5","8.2"
"Carroll","2020-03-18","47","195","6","26","18.3","9.2"
"Carroll","2020-03-19","26","221","2","28","19.4","9.7"
"Carroll","2020-03-20","9","230","1","29","17.2","10.5"
"Carroll","2020-03-21","2","232","0","29","10.8","10.5"
"Carroll","2020-03-22","7","239","3","32","13.7","13.6"
"Carroll","2020-03-23","5","244","1","33","14.7","15"
"Carroll","2020-03-24","15","259","3","36","16.3","16.4"
"Carroll","2020-03-25","19","278","8","44","20.5","19.4"
"Carroll","2020-03-26","7","285","4","48","27.6","23.5"
"Carroll","2020-03-27","22","307","4","52","28.6","22.9"
"Carroll","2020-03-28","1","308","0","52","28.6","19.7"
"Carroll","2020-03-29","3","311","0","52","22.5","18.1"
"Carroll","2020-03-30","12","323","4","56","24.4","19.5"
"Carroll","2020-03-31","3","326","0","56","21.5","18.9"
"Carroll","2020-04-01","11","337","4","60","20.7","20.6"
"Carroll","2020-04-02","92","429","11","71","14.3","20.9"
"Carroll","2020-04-03","85","514","10","81","13.3","21"
"Carroll","2020-04-04","80","594","11","92","15.3","22"
"Carroll","2020-04-05","0","594","0","92","15.3","18.9"
"Carroll","2020-04-06","60","654","12","104","13.4","18.9"
"Carroll","2020-04-07","112","766","14","118","15.2","18.4"
"Carroll","2020-04-08","83","849","5","123","10.9","15.8"
"Carroll","2020-04-09","76","925","18","141","12.5","13.4"
"Carroll","2020-04-10","106","1031","10","151","12.2","12.8"
"Carroll","2020-04-11","53","1084","6","157","11.9","13.6"
"Carroll","2020-04-12","7","1091","1","158","13.9","14.6"
"Carroll","2020-04-13","59","1150","17","175","15.2","14.3"
"Carroll","2020-04-14","88","1238","10","185","15","15.1"
"Carroll","2020-04-15","71","1309","12","197","16.5","13.7"
"Carroll","2020-04-16","158","1467","28","225","15.7","14.1"
"Carroll","2020-04-17","68","1535","15","240","17.5","14.8"
"Carroll","2020-04-18","79","1614","18","258","19.1","15.5"
"Carroll","2020-04-19","6","1620","1","259","19.5","16.7"
"Carroll","2020-04-20","56","1676","9","268","17.7","16.4"
"Carroll","2020-04-21","110","1786","10","278","17.3","16.2"
"Carroll","2020-04-22","99","1885","14","292","16.9","16.7"
"Carroll","2020-04-23","93","1978","7","299","15.5","15.6"
"Carroll","2020-04-24","94","2072","7","306","13.4","15.4"
"Carroll","2020-04-25","88","2160","7","313","11.3","15.2"
"Carroll","2020-04-26","18","2178","3","316","11.3","15.4"
"Carroll","2020-04-27","104","2282","18","334","11.4","14.6"
"Carroll","2020-04-28","107","2389","10","344","11.5","14.4"
"Carroll","2020-04-29","149","2538","14","358","10.8","13.9"
"Carroll","2020-04-30","141","2679","7","365","10.4","13"
"Carroll","2020-05-01","185","2864","15","380","10.5","12"
"Carroll","2020-05-02","119","2983","5","385","10","10.6"
"Carroll","2020-05-03","28","3011","0","385","7.6","9.4"
"Carroll","2020-05-04","199","3210","13","398","6.1","8.8"
"Carroll","2020-05-05","142","3352","3","401","5","8.3"
"Carroll","2020-05-06","143","3495","4","405","4.1","7.5"
"Carroll","2020-05-07","94","3589","8","413","4.6","7.5"
"Carroll","2020-05-08","135","3724","4","417","3.9","7.2"
"Carroll","2020-05-09","132","3856","3","420","3.6","6.8"
"Carroll","2020-05-10","12","3868","2","422","6","6.8"
"Carroll","2020-05-11","139","4007","8","430","5.9","6"
"Carroll","2020-05-12","220","4227","11","441","6.3","5.7"
"Carroll","2020-05-13","124","4351","2","443","6.1","5.1"
"Carroll","2020-05-14","104","4455","5","448","5.6","5.1"
"Carroll","2020-05-15","158","4613","8","456","5.9","4.9"
"Carroll","2020-05-16","102","4715","8","464","6.7","5.1"
"Carroll","2020-05-17","38","4753","5","469","6.2","6.1"
"Carroll","2020-05-18","161","4914","21","490","7.2","6.5"
"Carroll","2020-05-19","194","5108","24","514","8.3","7.3"
"Carroll","2020-05-20","201","5309","33","547","10.4","8.2"
"Carroll","2020-05-21","151","5460","13","560","10.9","8.3"
"Carroll","2020-05-22","162","5622","11","571","11.2","8.5"
"Carroll","2020-05-23","32","5654","7","578","13.2","9.9"
"Carroll","2020-05-24","19","5673","1","579","12.1","9.1"
"Carroll","2020-05-25","55","5728","3","582","11","9.1"
"Carroll","2020-05-26","115","5843","6","588","9.9","9.1"
"Carroll","2020-05-27","249","6092","13","601","8.3","9.4"
"Carroll","2020-05-28","149","6241","11","612","8.2","9.6"
"Carroll","2020-05-29","150","6391","11","623","8.2","9.7"
"Carroll","2020-05-30","111","6502","7","630","6","9.6"
"Carroll","2020-05-31","19","6521","3","633","7.5","9.8"
"Carroll","2020-06-01","151","6672","17","650","8.4","9.7"
"Carroll","2020-06-02","177","6849","14","664","8.7","9.3"
"Carroll","2020-06-03","146","6995","9","673","8.9","8.6"
"Carroll","2020-06-04","148","7143","7","680","8.5","8.3"
"Carroll","2020-06-05","157","7300","9","689","8.3","8.3"
"Carroll","2020-06-06","131","7431","5","694","7.9","7"
"Carroll","2020-06-07","28","7459","3","697","7.2","7.4"
"Carroll","2020-06-08","175","7634","11","708","6.5","7.4"
"Carroll","2020-06-09","272","7906","11","719","5.9","7.3"
"Carroll","2020-06-10","276","8182","14","733","5.8","7.3"
"Carroll","2020-06-11","122","8304","9","742","6.1","7.3"
"Carroll","2020-06-12","117","8421","3","745","5.7","7"
"Carroll","2020-06-13","9","8430","2","747","8.3","8.1"
"Carroll","2020-06-14","6","8436","0","747","6.8","7"
"Carroll","2020-06-15","161","8597","7","754","6.5","6.5"
"Carroll","2020-06-16","182","8779","20","774","7.5","6.7"
"Carroll","2020-06-17","162","8941","11","785","7.8","6.8"
"Carroll","2020-06-18","148","9089","17","802","8.3","7.2"
"Carroll","2020-06-19","196","9285","13","815","8.9","7.3"
"Carroll","2020-06-20","135","9420","7","822","6.5","7.4"
"Carroll","2020-06-21","20","9440","2","824","7.9","7.4"
"Carroll","2020-06-22","158","9598","24","848","9.5","8"
"Carroll","2020-06-23","253","9851","34","882","9.8","8.7"
"Carroll","2020-06-24","199","10050","27","909","10.8","9.3"
"Carroll","2020-06-25","252","10302","36","945","11.2","9.8"
"Carroll","2020-06-26","280","10582","32","977","11.9","10.4"
"Carroll","2020-06-27","181","10763","24","1001","13","9.8"
"Carroll","2020-06-28","37","10800","4","1005","13.1","10.5"
"Carroll","2020-06-29","223","11023","35","1040","13.2","11.3"
"Carroll","2020-06-30","308","11331","51","1091","13.7","11.7"
"Carroll","2020-07-01","428","11759","61","1152","13.8","12.3"
"Carroll","2020-07-02","288","12047","53","1205","14.3","12.8"
"Carroll","2020-07-03","334","12381","79","1284","16.1","14"
"Carroll","2020-07-04","66","12447","20","1304","18.5","15.8"
"Carroll","2020-07-05","53","12500","17","1321","21.6","17.4"
"Carroll","2020-07-06","421","12921","110","1431","23.1","18.1"
"Carroll","2020-07-07","366","13287","87","1518","24.1","18.9"
"Carroll","2020-07-08","347","13634","87","1605","25.6","19.7"
"Carroll","2020-07-09","542","14176","121","1726","26.2","20.3"
"Carroll","2020-07-10","530","14706","120","1846","26","21.1"
"Carroll","2020-07-11","356","15062","86","1932","25.2","21.8"
"Carroll","2020-07-12","59","15121","11","1943","23.2","22.4"
"Carroll","2020-07-13","416","15537","106","2049","23.2","23.1"
"Carroll","2020-07-14","542","16079","131","2180","23.2","23.6"
"Carroll","2020-07-15","690","16769","113","2293","22","23.8"
"Carroll","2020-07-16","409","17178","94","2387","22.1","24.1"
"Carroll","2020-07-17","550","17728","120","2507","21.9","24"
"Carroll","2020-07-18","214","17942","52","2559","22","23.6"
"Carroll","2020-07-19","59","18001","16","2575","23.2","23.2"
"Carroll","2020-07-20","380","18381","122","2697","24.1","23.6"
"Carroll","2020-07-21","419","18800","141","2838","25.5","24.3"
"Carroll","2020-07-22","456","19256","68","2906","25.3","23.6"
"Carroll","2020-07-23","412","19668","110","3016","25.8","23.9"
"Carroll","2020-07-24","379","20047","99","3115","26.4","24.2"
"Carroll","2020-07-25","196","20243","52","3167","26.7","24.4"
"Carroll","2020-07-26","20","20263","1","3168","23.6","23.4"
"Carroll","2020-07-27","225","20488","52","3220","22.3","23.2"
"Carroll","2020-07-28","349","20837","93","3313","21.3","23.4"
"Carroll","2020-07-29","436","21273","94","3407","22.2","23.8"
"Carroll","2020-07-30","271","21544","63","3470","21.7","23.8"
"Carroll","2020-07-31","230","21774","50","3520","21.1","23.8"
"Carroll","2020-08-01","211","21985","31","3551","19.4","23.1"
"Carroll","2020-08-02","12","21997","3","3554","22.3","22.9"
"Carroll","2020-08-03","182","22179","38","3592","22","22.1"
"Carroll","2020-08-04","326","22505","68","3660","21.1","21.2"
"Carroll","2020-08-05","358","22863","49","3709","20","21.1"
"Carroll","2020-08-06","239","23102","42","3751","19.2","20.5"
"Carroll","2020-08-07","209","23311","33","3784","18.4","19.7"
"Carroll","2020-08-08","121","23432","13","3797","17.8","18.6"
"Carroll","2020-08-09","25","23457","2","3799","15.4","18.8"
"Carroll","2020-08-10","146","23603","30","3829","15.3","18.6"
"Carroll","2020-08-11","289","23892","60","3889","15.3","18.2"
"Carroll","2020-08-12","447","24339","69","3958","15.6","17.8"
"Carroll","2020-08-13","375","24714","43","4001","14.7","16.9"
"Carroll","2020-08-14","226","24940","29","4030","14.3","16.3"
"Carroll","2020-08-15","163","25103","24","4054","14.8","16.3"
"Carroll","2020-08-16","27","25130","3","4057","15.3","15.3"
"Carroll","2020-08-17","143","25273","30","4087","15.3","15.3"
"Carroll","2020-08-18","247","25520","42","4129","14.8","15"
"Carroll","2020-08-19","465","25985","49","4178","14.1","14.8"
"Carroll","2020-08-20","265","26250","37","4215","14.4","14.6"
"Carroll","2020-08-21","185","26435","28","4243","14.8","14.5"
"Carroll","2020-08-22","104","26539","11","4254","14.2","14.5"
"Carroll","2020-08-23","12","26551","0","4254","12.6","13.9"
"Carroll","2020-08-24","122","26673","25","4279","12.5","13.9"
"Carroll","2020-08-25","208","26881","41","4320","12.9","13.9"
"Carroll","2020-08-26","278","27159","36","4356","13.3","13.7"
"Carroll","2020-08-27","219","27378","23","4379","12.8","13.6"
"Carroll","2020-08-28","165","27543","21","4400","12.4","13.6"
"Carroll","2020-08-29","111","27654","13","4413","12.6","13.4"
"Carroll","2020-08-30","8","27662","1","4414","14.4","13.5"
"Carroll","2020-08-31","133","27795","12","4426","12.7","12.6"
"Carroll","2020-09-01","206","28001","24","4450","11.6","12.2"
"Carroll","2020-09-02","365","28366","33","4483","11","12.1"
"Carroll","2020-09-03","209","28575","22","4505","11","11.9"
"Carroll","2020-09-04","201","28776","19","4524","10.6","11.5"
"Carroll","2020-09-05","142","28918","9","4533","9.8","11.2"
"Carroll","2020-09-06","15","28933","4","4537","11.8","13.1"
"Carroll","2020-09-07","39","28972","4","4541","12","12.4"
"Carroll","2020-09-08","114","29086","19","4560","12.7","12.1"
"Carroll","2020-09-09","335","29421","35","4595","12.9","12"
"Carroll","2020-09-10","198","29619","16","4611","12.6","11.8"
"Carroll","2020-09-11","205","29824","21","4632","12.7","11.6"
"Carroll","2020-09-12","47","29871","3","4635","12.7","11.2"
"Carroll","2020-09-13","16","29887","1","4636","9.8","10.8"
"Carroll","2020-09-14","129","30016","11","4647","9.5","10.8"
"Carroll","2020-09-15","225","30241","16","4663","8.1","10.4"
"Carroll","2020-09-16","172","30413","9","4672","7.4","10.2"
"Carroll","2020-09-17","100","30513","8","4680","7.4","10"
"Carroll","2020-09-18","101","30614","15","4695","8.1","10.4"
"Carroll","2020-09-19","169","30783","8","4703","7.8","10.2"
"Carroll","2020-09-20","15","30798","0","4703","6.9","8.3"
"Carroll","2020-09-21","115","30913","16","4719","7.7","8.6"
"Carroll","2020-09-22","186","31099","33","4752","9.2","8.7"
"Carroll","2020-09-23","323","31422","32","4784","9.9","8.6"
"Carroll","2020-09-24","225","31647","26","4810","10.4","8.9"
"Carroll","2020-09-25","142","31789","19","4829","10.2","9.1"
"Carroll","2020-09-26","88","31877","8","4837","10.8","9.3"
"Carroll","2020-09-27","15","31892","3","4840","13.7","10.3"
"Carroll","2020-09-28","80","31972","10","4850","13.5","10.6"
"Carroll","2020-09-29","141","32113","17","4867","12.6","10.9"
"Carroll","2020-09-30","331","32444","26","4893","12.3","11.1"
"Carroll","2020-10-01","132","32576","18","4911","12.6","11.5"
"Carroll","2020-10-02","144","32720","18","4929","12.5","11.3"
"Carroll","2020-10-03","93","32813","8","4937","12.5","11.6"
"Carroll","2020-10-04","10","32823","1","4938","11","12.3"
"Carroll","2020-10-05","108","32931","11","4949","10.7","12.1"
"Carroll","2020-10-06","207","33138","20","4969","10.3","11.5"
"Carroll","2020-10-07","314","33452","20","4989","10.1","11.2"
"Carroll","2020-10-08","210","33662","21","5010","9.6","11.1"
"Carroll","2020-10-09","166","33828","18","5028","9.4","11"
"Carroll","2020-10-10","82","33910","15","5043","10.8","11.6"
"Carroll","2020-10-11","52","33962","0","5043","9.3","10.2"
"Carroll","2020-10-12","127","34089","24","5067","10.6","10.6"
"Carroll","2020-10-13","217","34306","27","5094","11","10.7"
"Carroll","2020-10-14","359","34665","23","5117","11","10.6"
"Carroll","2020-10-15","231","34896","28","5145","11.3","10.5"
"Carroll","2020-10-16","226","35122","16","5161","10.7","10.1"
"Carroll","2020-10-17","170","35292","16","5177","9.5","10.1"
"Carroll","2020-10-18","50","35342","2","5179","10.1","9.7"
"Carroll","2020-10-19","276","35618","30","5209","8.9","9.7"
"Carroll","2020-10-20","227","35845","40","5249","9.6","10.3"
"Carroll","2020-10-21","306","36151","45","5294","10.8","10.9"
"Carroll","2020-10-22","197","36348","28","5322","11.1","11.2"
"Carroll","2020-10-23","199","36547","20","5342","11.6","11.2"
"Carroll","2020-10-24","142","36689","19","5361","12.1","10.8"
"Carroll","2020-10-25","49","36738","7","5368","13.6","11.8"
"Carroll","2020-10-26","141","36879","8","5376","12.8","10.9"
"Carroll","2020-10-27","247","37126","26","5402","11.8","10.7"
"Carroll","2020-10-28","273","37399","36","5438","11.6","11.2"
"Carroll","2020-10-29","213","37612","24","5462","11.2","11.2"
"Carroll","2020-10-30","135","37747","16","5478","11.5","11.5"
"Carroll","2020-10-31","160","37907","21","5499","11.4","11.8"
"Carroll","2020-11-01","29","37936","3","5502","10.9","12.2"
"Carroll","2020-11-02","150","38086","35","5537","13.4","13.1"
"Carroll","2020-11-03","108","38194","19","5556","14.4","13.1"
"Carroll","2020-11-04","342","38536","45","5601","14.4","13"
"Carroll","2020-11-05","251","38787","37","5638","14.9","13"
"Carroll","2020-11-06","187","38974","20","5658","14.7","13.1"
"Carroll","2020-11-07","135","39109","22","5680","15.2","13.3"
"Carroll","2020-11-08","41","39150","3","5683","14.7","12.8"
"Carroll","2020-11-09","147","39297","19","5702","13.2","13.3"
"Carroll","2020-11-10","298","39595","39","5741","12.6","13.5"
"Carroll","2020-11-11","229","39824","27","5768","12.4","13.4"
"Carroll","2020-11-12","218","40042","24","5792","11.9","13.4"
"Carroll","2020-11-13","285","40327","39","5831","12.3","13.5"
"Carroll","2020-11-14","144","40471","19","5850","11.9","13.5"
"Carroll","2020-11-15","63","40534","8","5858","12.6","13.7"
"Carroll","2020-11-16","175","40709","25","5883","12.8","13"
"Carroll","2020-11-17","176","40885","32","5915","13.5","13.1"
"Carroll","2020-11-18","459","41344","72","5987","14.1","13.3"
"Carroll","2020-11-19","310","41654","38","6025","14.3","13.1"
"Carroll","2020-11-20","278","41932","51","6076","15","13.6"
"Carroll","2020-11-21","144","42076","19","6095","15","13.4"
"Carroll","2020-11-22","54","42130","12","6107","16.3","14.5"
"Carroll","2020-11-23","153","42283","28","6135","16.9","14.9"
"Carroll","2020-11-24","108","42391","21","6156","17.1","15.3"
"Carroll","2020-11-25","363","42754","59","6215","17.1","15.6"
"Carroll","2020-11-26","13","42767","0","6215","15.4","14.8"
"Carroll","2020-11-27","125","42892","21","6236","15.2","15.1"
"Carroll","2020-11-28","114","43006","14","6250","15","15"
"Carroll","2020-11-29","37","43043","7","6257","14.6","15.4"
"Carroll","2020-11-30","184","43227","21","6278","13.6","15.2"
"Carroll","2020-12-01","272","43499","64","6342","14.2","15.6"
"Carroll","2020-12-02","457","43956","98","6440","14.9","16"
"Carroll","2020-12-03","284","44240","68","6508","18.3","16.9"
"Carroll","2020-12-04","247","44487","43","6551","18.4","16.8"
"Carroll","2020-12-05","129","44616","24","6575","19.3","17.2"
"Carroll","2020-12-06","57","44673","7","6582","18.4","16.5"
"Carroll","2020-12-07","206","44879","31","6613","18.9","16.2"
"Carroll","2020-12-08","252","45131","42","6655","17.9","16"
"Carroll","2020-12-09","344","45475","51","6706","17","15.9"
"Carroll","2020-12-10","219","45694","34","6740","15.8","17"
"Carroll","2020-12-11","255","45949","44","6784","15.7","17.1"
"Carroll","2020-12-12","280","46229","40","6824","15.1","17.2"
"Carroll","2020-12-13","45","46274","4","6828","14.6","16.5"
"Carroll","2020-12-14","183","46457","33","6861","15.1","17"
"Carroll","2020-12-15","372","46829","82","6943","15.8","16.9"
"Carroll","2020-12-16","451","47280","59","7002","15.6","16.3"
"Carroll","2020-12-17","251","47531","33","7035","15.2","15.5"
"Carroll","2020-12-18","266","47797","30","7065","14.4","15.1"
"Carroll","2020-12-19","187","47984","42","7107","15.6","15.3"
"Carroll","2020-12-20","68","48052","9","7116","16.2","15.4"
"Carroll","2020-12-21","133","48185","33","7149","17.2","16.1"
"Carroll","2020-12-22","347","48532","87","7236","17.6","16.7"
"Carroll","2020-12-23","502","49034","77","7313","17.9","16.7"
"Carroll","2020-12-24","213","49247","35","7348","18.4","16.8"
"Carroll","2020-12-25","14","49261","1","7349","17.8","16.1"
"Carroll","2020-12-26","104","49365","18","7367","17","16.3"
"Carroll","2020-12-27","128","49493","13","7380","16.6","16.4"
"Carroll","2020-12-28","261","49754","57","7437","16.2","16.7"
"Carroll","2020-12-29","435","50189","111","7548","16.2","16.9"
"Carroll","2020-12-30","452","50641","99","7647","17.2","17.5"
"Carroll","2020-12-31","333","50974","71","7718","17.9","18.1"
"Carroll","2021-01-01","26","51000","8","7726","21.3","19.5"
"Carroll","2021-01-02","82","51082","21","7747","22.4","19.7"
"Carroll","2021-01-03","86","51168","7","7754","22.2","19.4"
"Carroll","2021-01-04","188","51356","53","7807","23.1","19.6"
"Carroll","2021-01-05","378","51734","94","7901","23","19.6"
"Carroll","2021-01-06","490","52224","97","7998","22.7","19.9"
"Carroll","2021-01-07","388","52612","53","8051","21.6","19.7"
"Carroll","2021-01-08","341","52953","53","8104","19.4","20.3"
"Carroll","2021-01-09","190","53143","31","8135","18.1","20.3"
"Carroll","2021-01-10","60","53203","12","8147","19.8","21"
"Carroll","2021-01-11","330","53533","43","8190","17.6","20.3"
"Carroll","2021-01-12","312","53845","53","8243","16.5","19.7"
"Carroll","2021-01-13","400","54245","69","8312","16.1","19.4"
"Carroll","2021-01-14","342","54587","51","8363","16.3","18.9"
"Carroll","2021-01-15","366","54953","59","8422","16.4","17.9"
"Carroll","2021-01-16","202","55155","43","8465","17.1","17.6"
"Carroll","2021-01-17","57","55212","14","8479","17.7","18.8"
"Carroll","2021-01-18","214","55426","32","8511","18","17.8"
"Carroll","2021-01-19","312","55738","50","8561","17.9","17.2"
"Carroll","2021-01-20","350","56088","58","8619","17.8","16.9"
"Carroll","2021-01-21","326","56414","65","8684","18.5","17.4"
"Carroll","2021-01-22","275","56689","36","8720","18.1","17.2"
"Carroll","2021-01-23","172","56861","39","8759","18.3","17.7"
"Carroll","2021-01-24","33","56894","6","8765","17.3","17.5"
"Carroll","2021-01-25","51","56945","4","8769","16.3","17.2"
"Carroll","2021-01-26","11","56956","1","8770","15.3","16.6"
"Carroll","2021-01-27","0","56956","0","8770","13","15.4"
"Catoosa","2020-02-01","0","0","0","0",".","."
"Catoosa","2020-02-02","0","0","0","0",".","."
"Catoosa","2020-02-03","0","0","0","0",".","."
"Catoosa","2020-02-04","0","0","0","0",".","."
"Catoosa","2020-02-05","0","0","0","0",".","."
"Catoosa","2020-02-06","0","0","0","0",".","."
"Catoosa","2020-02-07","0","0","0","0","0","."
"Catoosa","2020-02-08","0","0","0","0","0","."
"Catoosa","2020-02-09","0","0","0","0","0","."
"Catoosa","2020-02-10","0","0","0","0","0","."
"Catoosa","2020-02-11","0","0","0","0","0","."
"Catoosa","2020-02-12","0","0","0","0","0","."
"Catoosa","2020-02-13","0","0","0","0","0","."
"Catoosa","2020-02-14","0","0","0","0","0","0"
"Catoosa","2020-02-15","0","0","0","0","0","0"
"Catoosa","2020-02-16","0","0","0","0","0","0"
"Catoosa","2020-02-17","0","0","0","0","0","0"
"Catoosa","2020-02-18","0","0","0","0","0","0"
"Catoosa","2020-02-19","0","0","0","0","0","0"
"Catoosa","2020-02-20","0","0","0","0","0","0"
"Catoosa","2020-02-21","0","0","0","0","0","0"
"Catoosa","2020-02-22","0","0","0","0","0","0"
"Catoosa","2020-02-23","0","0","0","0","0","0"
"Catoosa","2020-02-24","0","0","0","0","0","0"
"Catoosa","2020-02-25","0","0","0","0","0","0"
"Catoosa","2020-02-26","0","0","0","0","0","0"
"Catoosa","2020-02-27","0","0","0","0","0","0"
"Catoosa","2020-02-28","0","0","0","0","0","0"
"Catoosa","2020-02-29","0","0","0","0","0","0"
"Catoosa","2020-03-01","0","0","0","0","0","0"
"Catoosa","2020-03-02","0","0","0","0","0","0"
"Catoosa","2020-03-03","0","0","0","0","0","0"
"Catoosa","2020-03-04","0","0","0","0","0","0"
"Catoosa","2020-03-05","0","0","0","0","0","0"
"Catoosa","2020-03-06","1","1","0","0","0","0"
"Catoosa","2020-03-07","0","1","0","0","0","0"
"Catoosa","2020-03-08","0","1","0","0","0","0"
"Catoosa","2020-03-09","0","1","0","0","0","0"
"Catoosa","2020-03-10","1","2","0","0","0","0"
"Catoosa","2020-03-11","0","2","0","0","0","0"
"Catoosa","2020-03-12","5","7","0","0","0","0"
"Catoosa","2020-03-13","5","12","0","0","0","0"
"Catoosa","2020-03-14","2","14","0","0","0","0"
"Catoosa","2020-03-15","1","15","1","1","14.3","7.1"
"Catoosa","2020-03-16","14","29","0","1","14.3","7.1"
"Catoosa","2020-03-17","17","46","0","1","14.3","7.1"
"Catoosa","2020-03-18","15","61","0","1","14.3","7.1"
"Catoosa","2020-03-19","22","83","0","1","14.3","7.1"
"Catoosa","2020-03-20","10","93","0","1","14.3","7.1"
"Catoosa","2020-03-21","5","98","0","1","14.3","7.1"
"Catoosa","2020-03-22","2","100","0","1","0","7.1"
"Catoosa","2020-03-23","13","113","0","1","0","7.1"
"Catoosa","2020-03-24","11","124","0","1","0","7.1"
"Catoosa","2020-03-25","14","138","1","2","1","7.7"
"Catoosa","2020-03-26","8","146","0","2","1","7.7"
"Catoosa","2020-03-27","11","157","0","2","1","7.7"
"Catoosa","2020-03-28","0","157","0","2","1","7.7"
"Catoosa","2020-03-29","1","158","0","2","1","0.5"
"Catoosa","2020-03-30","6","164","1","3","3.4","1.7"
"Catoosa","2020-03-31","3","167","0","3","3.4","1.7"
"Catoosa","2020-04-01","5","172","0","3","2.4","1.7"
"Catoosa","2020-04-02","6","178","0","3","2.4","1.7"
"Catoosa","2020-04-03","10","188","0","3","2.4","1.7"
"Catoosa","2020-04-04","0","188","0","3","2.4","1.7"
"Catoosa","2020-04-05","0","188","0","3","2.4","1.7"
"Catoosa","2020-04-06","3","191","0","3","0","1.7"
"Catoosa","2020-04-07","7","198","0","3","0","1.7"
"Catoosa","2020-04-08","12","210","0","3","0","1.2"
"Catoosa","2020-04-09","15","225","0","3","0","1.2"
"Catoosa","2020-04-10","20","245","0","3","0","1.2"
"Catoosa","2020-04-11","2","247","1","4","7.1","4.8"
"Catoosa","2020-04-12","1","248","0","4","7.1","4.8"
"Catoosa","2020-04-13","1","249","0","4","7.1","3.6"
"Catoosa","2020-04-14","10","259","0","4","7.1","3.6"
"Catoosa","2020-04-15","15","274","0","4","7.1","3.6"
"Catoosa","2020-04-16","9","283","1","5","8.7","4.4"
"Catoosa","2020-04-17","17","300","0","5","8.7","4.4"
"Catoosa","2020-04-18","6","306","0","5","1.6","4.4"
"Catoosa","2020-04-19","4","310","0","5","1.6","4.4"
"Catoosa","2020-04-20","10","320","0","5","1.6","4.4"
"Catoosa","2020-04-21","28","348","0","5","1.6","4.4"
"Catoosa","2020-04-22","4","352","0","5","1.6","4.4"
"Catoosa","2020-04-23","7","359","0","5","0","4.4"
"Catoosa","2020-04-24","13","372","0","5","0","4.4"
"Catoosa","2020-04-25","6","378","0","5","0","0.8"
"Catoosa","2020-04-26","3","381","0","5","0","0.8"
"Catoosa","2020-04-27","13","394","0","5","0","0.8"
"Catoosa","2020-04-28","7","401","0","5","0","0.8"
"Catoosa","2020-04-29","11","412","0","5","0","0.8"
"Catoosa","2020-04-30","28","440","0","5","0","0"
"Catoosa","2020-05-01","14","454","0","5","0","0"
"Catoosa","2020-05-02","1","455","0","5","0","0"
"Catoosa","2020-05-03","4","459","0","5","0","0"
"Catoosa","2020-05-04","6","465","0","5","0","0"
"Catoosa","2020-05-05","9","474","0","5","0","0"
"Catoosa","2020-05-06","9","483","0","5","0","0"
"Catoosa","2020-05-07","14","497","2","7","2","1"
"Catoosa","2020-05-08","6","503","0","7","2","1"
"Catoosa","2020-05-09","4","507","0","7","2","1"
"Catoosa","2020-05-10","0","507","0","7","2","1"
"Catoosa","2020-05-11","6","513","0","7","2","1"
"Catoosa","2020-05-12","11","524","1","8","3.3","1.7"
"Catoosa","2020-05-13","11","535","0","8","3.3","1.7"
"Catoosa","2020-05-14","9","544","0","8","1.3","1.7"
"Catoosa","2020-05-15","8","552","0","8","1.3","1.7"
"Catoosa","2020-05-16","4","556","2","10","8.4","5.2"
"Catoosa","2020-05-17","1","557","0","10","8.4","5.2"
"Catoosa","2020-05-18","13","570","1","11","9.5","5.8"
"Catoosa","2020-05-19","29","599","1","12","8.7","6"
"Catoosa","2020-05-20","35","634","1","13","9.1","6.2"
"Catoosa","2020-05-21","18","652","0","13","9.1","5.2"
"Catoosa","2020-05-22","28","680","2","15","10.2","5.7"
"Catoosa","2020-05-23","1","681","0","15","3","5.7"
"Catoosa","2020-05-24","0","681","0","15","3","5.7"
"Catoosa","2020-05-25","0","681","0","15","1.9","5.7"
"Catoosa","2020-05-26","22","703","0","15","1.4","5.1"
"Catoosa","2020-05-27","33","736","3","18","2.3","5.7"
"Catoosa","2020-05-28","17","753","3","21","4.8","7"
"Catoosa","2020-05-29","26","779","1","22","4.4","7.3"
"Catoosa","2020-05-30","9","788","1","23","6","4.5"
"Catoosa","2020-05-31","4","792","0","23","6","4.5"
"Catoosa","2020-06-01","30","822","1","24","6.4","4.2"
"Catoosa","2020-06-02","22","844","1","25","7.1","4.3"
"Catoosa","2020-06-03","13","857","0","25","5.8","4.1"
"Catoosa","2020-06-04","14","871","0","25","3.3","4.1"
"Catoosa","2020-06-05","15","886","1","26","3.7","4"
"Catoosa","2020-06-06","8","894","1","27","3.9","4.9"
"Catoosa","2020-06-07","1","895","0","27","3.9","4.9"
"Catoosa","2020-06-08","32","927","1","28","3.8","5.1"
"Catoosa","2020-06-09","20","947","2","30","4.6","5.8"
"Catoosa","2020-06-10","21","968","0","30","4.6","5.2"
"Catoosa","2020-06-11","24","992","2","32","5.8","4.5"
"Catoosa","2020-06-12","24","1016","1","33","5.4","4.6"
"Catoosa","2020-06-13","7","1023","0","33","3.7","3.8"
"Catoosa","2020-06-14","0","1023","0","33","3.7","3.8"
"Catoosa","2020-06-15","20","1043","2","35","4.6","4.2"
"Catoosa","2020-06-16","18","1061","0","35","3.2","3.9"
"Catoosa","2020-06-17","26","1087","2","37","4.3","4.5"
"Catoosa","2020-06-18","29","1116","2","39","4.1","5"
"Catoosa","2020-06-19","20","1136","1","40","4.2","4.8"
"Catoosa","2020-06-20","17","1153","1","41","5.1","4.4"
"Catoosa","2020-06-21","12","1165","4","45","9.8","6.7"
"Catoosa","2020-06-22","14","1179","0","45","8.4","6.5"
"Catoosa","2020-06-23","28","1207","8","53","12.5","7.8"
"Catoosa","2020-06-24","19","1226","2","55","12.9","8.6"
"Catoosa","2020-06-25","25","1251","0","55","11.9","8"
"Catoosa","2020-06-26","12","1263","0","55","11.2","7.7"
"Catoosa","2020-06-27","12","1275","0","55","10.3","7.7"
"Catoosa","2020-06-28","12","1287","0","55","5.6","7.7"
"Catoosa","2020-06-29","26","1313","1","56","6.1","7.3"
"Catoosa","2020-06-30","35","1348","3","59","3.3","7.9"
"Catoosa","2020-07-01","27","1375","1","60","2.3","7.6"
"Catoosa","2020-07-02","35","1410","4","64","3.9","7.9"
"Catoosa","2020-07-03","25","1435","1","65","4.5","7.8"
"Catoosa","2020-07-04","4","1439","0","65","4.5","7.4"
"Catoosa","2020-07-05","3","1442","0","65","4.5","5"
"Catoosa","2020-07-06","36","1478","1","66","4.4","5.2"
"Catoosa","2020-07-07","36","1514","5","71","5.1","4.2"
"Catoosa","2020-07-08","22","1536","1","72","5.2","3.8"
"Catoosa","2020-07-09","24","1560","0","72","3.6","3.8"
"Catoosa","2020-07-10","27","1587","3","75","4.6","4.6"
"Catoosa","2020-07-11","11","1598","2","77","7.2","5.9"
"Catoosa","2020-07-12","5","1603","1","78","10.1","7.3"
"Catoosa","2020-07-13","31","1634","8","86","13.4","8.9"
"Catoosa","2020-07-14","59","1693","2","88","11.9","8.5"
"Catoosa","2020-07-15","33","1726","5","93","13.4","9.3"
"Catoosa","2020-07-16","16","1742","4","97","16.9","10.3"
"Catoosa","2020-07-17","21","1763","1","98","16","10.3"
"Catoosa","2020-07-18","9","1772","0","98","13.4","10.3"
"Catoosa","2020-07-19","7","1779","0","98","10.6","10.3"
"Catoosa","2020-07-20","20","1799","0","98","6.9","10.1"
"Catoosa","2020-07-21","19","1818","0","98","6.4","9.1"
"Catoosa","2020-07-22","29","1847","2","100","5.2","9.3"
"Catoosa","2020-07-23","23","1870","1","101","2.3","9.6"
"Catoosa","2020-07-24","36","1906","4","105","3.2","9.6"
"Catoosa","2020-07-25","18","1924","1","106","4","8.7"
"Catoosa","2020-07-26","1","1925","0","106","4","7.3"
"Catoosa","2020-07-27","38","1963","4","110","5.5","6.2"
"Catoosa","2020-07-28","42","2005","2","112","6.2","6.3"
"Catoosa","2020-07-29","25","2030","4","116","7.5","6.4"
"Catoosa","2020-07-30","23","2053","1","117","7.5","4.9"
"Catoosa","2020-07-31","26","2079","4","121","8.1","5.6"
"Catoosa","2020-08-01","14","2093","2","123","9.3","6.7"
"Catoosa","2020-08-02","4","2097","1","124","12.9","8.4"
"Catoosa","2020-08-03","29","2126","4","128","13.4","9.4"
"Catoosa","2020-08-04","30","2156","1","129","13.2","9.7"
"Catoosa","2020-08-05","20","2176","0","129","10.9","9.2"
"Catoosa","2020-08-06","20","2196","3","132","12.4","9.9"
"Catoosa","2020-08-07","36","2232","3","135","11.4","9.7"
"Catoosa","2020-08-08","21","2253","1","136","10","9.7"
"Catoosa","2020-08-09","9","2262","0","136","6.5","9.7"
"Catoosa","2020-08-10","31","2293","1","137","5","9.2"
"Catoosa","2020-08-11","37","2330","1","138","4.9","9"
"Catoosa","2020-08-12","29","2359","1","139","5.4","8.1"
"Catoosa","2020-08-13","19","2378","0","139","3.2","7.8"
"Catoosa","2020-08-14","20","2398","0","139","2","6.7"
"Catoosa","2020-08-15","13","2411","2","141","3.5","6.8"
"Catoosa","2020-08-16","11","2422","2","143","6.1","6.3"
"Catoosa","2020-08-17","26","2448","0","143","5.7","5.3"
"Catoosa","2020-08-18","37","2485","1","144","5.7","5.3"
"Catoosa","2020-08-19","38","2523","4","148","6.7","6"
"Catoosa","2020-08-20","21","2544","1","149","7.4","5.3"
"Catoosa","2020-08-21","43","2587","5","154","9","5.5"
"Catoosa","2020-08-22","23","2610","1","155","7.4","5.5"
"Catoosa","2020-08-23","8","2618","4","159","12","9.1"
"Catoosa","2020-08-24","33","2651","1","160","12.4","9.1"
"Catoosa","2020-08-25","63","2714","6","166","13.4","9.5"
"Catoosa","2020-08-26","40","2754","5","171","13.7","10.2"
"Catoosa","2020-08-27","25","2779","2","173","14.1","10.8"
"Catoosa","2020-08-28","22","2801","1","174","13.1","11.1"
"Catoosa","2020-08-29","18","2819","4","178","15.7","11.6"
"Catoosa","2020-08-30","9","2828","1","179","10.1","11.1"
"Catoosa","2020-08-31","37","2865","6","185","12","12.2"
"Catoosa","2020-09-01","168","3033","6","191","11.2","12.3"
"Catoosa","2020-09-02","39","3072","5","196","11.2","12.4"
"Catoosa","2020-09-03","37","3109","7","203","12.8","13.5"
"Catoosa","2020-09-04","32","3141","4","207","13.9","13.5"
"Catoosa","2020-09-05","20","3161","4","211","13.6","14.6"
"Catoosa","2020-09-06","10","3171","2","213","14.9","12.5"
"Catoosa","2020-09-07","50","3221","6","219","14.3","13.1"
"Catoosa","2020-09-08","210","3431","18","237","15","13.1"
"Catoosa","2020-09-09","52","3483","3","240","14","12.6"
"Catoosa","2020-09-10","34","3517","5","245","13.4","13.1"
"Catoosa","2020-09-11","27","3544","4","249","13.7","13.8"
"Catoosa","2020-09-12","5","3549","0","249","10.8","12.2"
"Catoosa","2020-09-13","8","3557","1","250","9.8","12.3"
"Catoosa","2020-09-14","180","3737","8","258","8.7","11.5"
"Catoosa","2020-09-15","196","3933","17","275","8.7","11.8"
"Catoosa","2020-09-16","24","3957","2","277","9.1","11.5"
"Catoosa","2020-09-17","25","3982","4","281","9.3","11.3"
"Catoosa","2020-09-18","46","4028","0","281","7.1","10.4"
"Catoosa","2020-09-19","37","4065","5","286","9.1","10"
"Catoosa","2020-09-20","13","4078","1","287","8.4","9.1"
"Catoosa","2020-09-21","136","4214","17","304","9.5","9.1"
"Catoosa","2020-09-22","155","4369","11","315","9.3","9"
"Catoosa","2020-09-23","26","4395","3","318","9.8","9.4"
"Catoosa","2020-09-24","28","4423","1","319","8","8.6"
"Catoosa","2020-09-25","24","4447","1","320","8.6","7.9"
"Catoosa","2020-09-26","16","4463","1","321","7.5","8.3"
"Catoosa","2020-09-27","9","4472","1","322","8","8.2"
"Catoosa","2020-09-28","137","4609","15","337","7.8","8.7"
"Catoosa","2020-09-29","132","4741","11","348","8","8.6"
"Catoosa","2020-09-30","17","4758","0","348","6.3","8.1"
"Catoosa","2020-10-01","20","4778","0","348","5.8","6.9"
"Catoosa","2020-10-02","25","4803","0","348","5.2","6.9"
"Catoosa","2020-10-03","25","4828","1","349","4.9","6.2"
"Catoosa","2020-10-04","19","4847","0","349","3.3","5.7"
"Catoosa","2020-10-05","199","5046","10","359","2.5","5.1"
"Catoosa","2020-10-06","124","5170","9","368","2.3","5.2"
"Catoosa","2020-10-07","38","5208","3","371","3.5","4.9"
"Catoosa","2020-10-08","24","5232","1","372","4","4.9"
"Catoosa","2020-10-09","18","5250","1","373","4.8","5"
"Catoosa","2020-10-10","6","5256","0","373","4.3","4.6"
"Catoosa","2020-10-11","15","5271","3","376","7.1","5.2"
"Catoosa","2020-10-12","30","5301","1","377","6.9","4.7"
"Catoosa","2020-10-13","170","5471","14","391","7","4.7"
"Catoosa","2020-10-14","30","5501","2","393","6.9","5.2"
"Catoosa","2020-10-15","29","5530","0","393","6.3","5.2"
"Catoosa","2020-10-16","32","5562","6","399","8.1","6.5"
"Catoosa","2020-10-17","11","5573","0","399","8.1","6.2"
"Catoosa","2020-10-18","6","5579","0","399","5.3","6.2"
"Catoosa","2020-10-19","196","5775","25","424","6.6","6.8"
"Catoosa","2020-10-20","122","5897","10","434","6.6","6.8"
"Catoosa","2020-10-21","22","5919","0","434","5.7","6.3"
"Catoosa","2020-10-22","19","5938","1","435","6.4","6.3"
"Catoosa","2020-10-23","17","5955","3","438","6.3","7.2"
"Catoosa","2020-10-24","79","6034","8","446","7.7","7.9"
"Catoosa","2020-10-25","4","6038","1","447","11.3","8.3"
"Catoosa","2020-10-26","230","6268","25","472","11","8.8"
"Catoosa","2020-10-27","142","6410","12","484","11.1","8.8"
"Catoosa","2020-10-28","27","6437","3","487","12.6","9.2"
"Catoosa","2020-10-29","34","6471","5","492","14","10.2"
"Catoosa","2020-10-30","33","6504","2","494","12.3","9.3"
"Catoosa","2020-10-31","30","6534","4","498","12.8","10.3"
"Catoosa","2020-11-01","11","6545","1","499","10.5","10.9"
"Catoosa","2020-11-02","261","6806","23","522","10.2","10.6"
"Catoosa","2020-11-03","132","6938","12","534","10.3","10.7"
"Catoosa","2020-11-04","30","6968","3","537","10.2","11.4"
"Catoosa","2020-11-05","46","7014","6","543","9.9","12"
"Catoosa","2020-11-06","41","7055","9","552","12.2","12.3"
"Catoosa","2020-11-07","38","7093","9","561","13.7","13.2"
"Catoosa","2020-11-08","17","7110","5","566","16.6","13.5"
"Catoosa","2020-11-09","292","7402","54","620","18","14.1"
"Catoosa","2020-11-10","287","7689","24","644","17.8","14.1"
"Catoosa","2020-11-11","75","7764","8","652","17.9","14.1"
"Catoosa","2020-11-12","79","7843","3","655","16.6","13.3"
"Catoosa","2020-11-13","91","7934","7","662","14.6","13.4"
"Catoosa","2020-11-14","34","7968","7","669","14.1","13.9"
"Catoosa","2020-11-15","34","8002","5","674","12","14.3"
"Catoosa","2020-11-16","303","8305","37","711","11.1","14.5"
"Catoosa","2020-11-17","336","8641","36","747","11.5","14.7"
"Catoosa","2020-11-18","93","8734","7","754","11","14.5"
"Catoosa","2020-11-19","99","8833","13","767","12.4","14.5"
"Catoosa","2020-11-20","88","8921","13","780","13.4","14"
"Catoosa","2020-11-21","63","8984","12","792","13.2","13.7"
"Catoosa","2020-11-22","34","9018","2","794","11.9","12"
"Catoosa","2020-11-23","385","9403","53","847","12.1","11.6"
"Catoosa","2020-11-24","238","9641","22","869","11.9","11.7"
"Catoosa","2020-11-25","69","9710","13","882","13.5","12.3"
"Catoosa","2020-11-26","2","9712","0","882","11.7","12"
"Catoosa","2020-11-27","65","9777","15","897","12.8","13.1"
"Catoosa","2020-11-28","41","9818","7","904","12.6","12.9"
"Catoosa","2020-11-29","35","9853","8","912","15","13.4"
"Catoosa","2020-11-30","473","10326","59","971","14.8","13.5"
"Catoosa","2020-12-01","253","10579","23","994","14.8","13.3"
"Catoosa","2020-12-02","195","10774","27","1021","14.1","13.8"
"Catoosa","2020-12-03","75","10849","15","1036","16.9","14.3"
"Catoosa","2020-12-04","78","10927","11","1047","15.6","14.2"
"Catoosa","2020-12-05","42","10969","9","1056","16.3","14.4"
"Catoosa","2020-12-06","30","10999","7","1063","16.3","15.7"
"Catoosa","2020-12-07","429","11428","67","1130","16.8","15.8"
"Catoosa","2020-12-08","246","11674","30","1160","17.2","16"
"Catoosa","2020-12-09","232","11906","28","1188","17","15.5"
"Catoosa","2020-12-10","63","11969","12","1200","16.8","16.9"
"Catoosa","2020-12-11","71","12040","17","1217","18.2","16.9"
"Catoosa","2020-12-12","37","12077","5","1222","17.1","16.7"
"Catoosa","2020-12-13","35","12112","10","1232","17.9","17.1"
"Catoosa","2020-12-14","417","12529","67","1299","17.9","17.3"
"Catoosa","2020-12-15","346","12875","66","1365","18.9","18.1"
"Catoosa","2020-12-16","325","13200","52","1417","19.5","18.2"
"Catoosa","2020-12-17","83","13283","12","1429","18.8","17.8"
"Catoosa","2020-12-18","73","13356","16","1445","18.5","18.4"
"Catoosa","2020-12-19","38","13394","8","1453","19.6","18.3"
"Catoosa","2020-12-20","27","13421","6","1459","18.7","18.3"
"Catoosa","2020-12-21","524","13945","94","1553","19","18.4"
"Catoosa","2020-12-22","401","14346","51","1604","18","18.5"
"Catoosa","2020-12-23","305","14651","65","1669","18.8","19.1"
"Catoosa","2020-12-24","39","14690","6","1675","18.9","18.9"
"Catoosa","2020-12-25","0","14690","0","1675","15.8","17.2"
"Catoosa","2020-12-26","43","14733","15","1690","17.8","18.7"
"Catoosa","2020-12-27","43","14776","16","1706","19.9","19.3"
"Catoosa","2020-12-28","587","15363","135","1841","20.6","19.8"
"Catoosa","2020-12-29","423","15786","72","1913","21.3","19.7"
"Catoosa","2020-12-30","479","16265","96","2009","21.1","19.9"
"Catoosa","2020-12-31","62","16327","17","2026","22.8","20.9"
"Catoosa","2021-01-01","7","16334","2","2028","26.9","21.3"
"Catoosa","2021-01-02","10","16344","1","2029","23.3","20.6"
"Catoosa","2021-01-03","19","16363","5","2034","21.8","20.8"
"Catoosa","2021-01-04","478","16841","117","2151","22","21.3"
"Catoosa","2021-01-05","763","17604","142","2293","22.2","21.7"
"Catoosa","2021-01-06","290","17894","58","2351","22.2","21.6"
"Catoosa","2021-01-07","77","17971","18","2369","21.6","22.2"
"Catoosa","2021-01-08","88","18059","14","2383","19.8","23.3"
"Catoosa","2021-01-09","43","18102","11","2394","22","22.7"
"Catoosa","2021-01-10","26","18128","12","2406","24.9","23.3"
"Catoosa","2021-01-11","89","18217","9","2415","22.8","22.4"
"Catoosa","2021-01-12","320","18537","38","2453","21.9","22"
"Catoosa","2021-01-13","57","18594","13","2466","22.3","22.2"
"Catoosa","2021-01-14","68","18662","12","2478","21.4","21.5"
"Catoosa","2021-01-15","62","18724","9","2487","21.2","20.5"
"Catoosa","2021-01-16","45","18769","7","2494","19.8","20.9"
"Catoosa","2021-01-17","17","18786","4","2498","16.6","20.7"
"Catoosa","2021-01-18","72","18858","10","2508","17.1","20"
"Catoosa","2021-01-19","72","18930","10","2518","17.4","19.6"
"Catoosa","2021-01-20","73","19003","11","2529","16.3","19.3"
"Catoosa","2021-01-21","58","19061","8","2537","15.7","18.6"
"Catoosa","2021-01-22","74","19135","6","2543","14.8","18"
"Catoosa","2021-01-23","41","19176","8","2551","15.4","17.6"
"Catoosa","2021-01-24","6","19182","1","2552","14.4","15.5"
"Catoosa","2021-01-25","4","19186","0","2552","12.4","14.8"
"Catoosa","2021-01-26","0","19186","0","2552","10.4","13.9"
"Catoosa","2021-01-27","0","19186","0","2552","8.3","12.3"
"Charlton","2020-02-01","0","0","0","0",".","."
"Charlton","2020-02-02","0","0","0","0",".","."
"Charlton","2020-02-03","0","0","0","0",".","."
"Charlton","2020-02-04","0","0","0","0",".","."
"Charlton","2020-02-05","0","0","0","0",".","."
"Charlton","2020-02-06","0","0","0","0",".","."
"Charlton","2020-02-07","0","0","0","0","0","."
"Charlton","2020-02-08","0","0","0","0","0","."
"Charlton","2020-02-09","0","0","0","0","0","."
"Charlton","2020-02-10","0","0","0","0","0","."
"Charlton","2020-02-11","0","0","0","0","0","."
"Charlton","2020-02-12","0","0","0","0","0","."
"Charlton","2020-02-13","0","0","0","0","0","."
"Charlton","2020-02-14","0","0","0","0","0","0"
"Charlton","2020-02-15","0","0","0","0","0","0"
"Charlton","2020-02-16","0","0","0","0","0","0"
"Charlton","2020-02-17","0","0","0","0","0","0"
"Charlton","2020-02-18","0","0","0","0","0","0"
"Charlton","2020-02-19","0","0","0","0","0","0"
"Charlton","2020-02-20","0","0","0","0","0","0"
"Charlton","2020-02-21","0","0","0","0","0","0"
"Charlton","2020-02-22","0","0","0","0","0","0"
"Charlton","2020-02-23","0","0","0","0","0","0"
"Charlton","2020-02-24","0","0","0","0","0","0"
"Charlton","2020-02-25","0","0","0","0","0","0"
"Charlton","2020-02-26","0","0","0","0","0","0"
"Charlton","2020-02-27","0","0","0","0","0","0"
"Charlton","2020-02-28","0","0","0","0","0","0"
"Charlton","2020-02-29","0","0","0","0","0","0"
"Charlton","2020-03-01","0","0","0","0","0","0"
"Charlton","2020-03-02","0","0","0","0","0","0"
"Charlton","2020-03-03","0","0","0","0","0","0"
"Charlton","2020-03-04","0","0","0","0","0","0"
"Charlton","2020-03-05","0","0","0","0","0","0"
"Charlton","2020-03-06","0","0","0","0","0","0"
"Charlton","2020-03-07","0","0","0","0","0","0"
"Charlton","2020-03-08","0","0","0","0","0","0"
"Charlton","2020-03-09","0","0","0","0","0","0"
"Charlton","2020-03-10","0","0","0","0","0","0"
"Charlton","2020-03-11","0","0","0","0","0","0"
"Charlton","2020-03-12","0","0","0","0","0","0"
"Charlton","2020-03-13","2","2","1","1","7.1","3.6"
"Charlton","2020-03-14","0","2","0","1","7.1","3.6"
"Charlton","2020-03-15","0","2","0","1","7.1","3.6"
"Charlton","2020-03-16","0","2","0","1","7.1","3.6"
"Charlton","2020-03-17","1","3","1","2","21.4","10.7"
"Charlton","2020-03-18","3","6","0","2","21.4","10.7"
"Charlton","2020-03-19","1","7","0","2","21.4","10.7"
"Charlton","2020-03-20","3","10","0","2","14.3","10.7"
"Charlton","2020-03-21","0","10","0","2","14.3","10.7"
"Charlton","2020-03-22","0","10","0","2","14.3","10.7"
"Charlton","2020-03-23","2","12","0","2","14.3","10.7"
"Charlton","2020-03-24","2","14","0","2","0","10.7"
"Charlton","2020-03-25","3","17","1","3","4.8","13.1"
"Charlton","2020-03-26","0","17","0","3","4.8","13.1"
"Charlton","2020-03-27","0","17","0","3","4.8","9.5"
"Charlton","2020-03-28","1","18","0","3","4.8","9.5"
"Charlton","2020-03-29","1","19","0","3","4.8","9.5"
"Charlton","2020-03-30","2","21","0","3","4.8","9.5"
"Charlton","2020-03-31","3","24","0","3","4.8","2.4"
"Charlton","2020-04-01","1","25","0","3","0","2.4"
"Charlton","2020-04-02","0","25","0","3","0","2.4"
"Charlton","2020-04-03","0","25","0","3","0","2.4"
"Charlton","2020-04-04","1","26","0","3","0","2.4"
"Charlton","2020-04-05","1","27","0","3","0","2.4"
"Charlton","2020-04-06","3","30","0","3","0","2.4"
"Charlton","2020-04-07","2","32","0","3","0","2.4"
"Charlton","2020-04-08","9","41","2","5","3.2","1.6"
"Charlton","2020-04-09","6","47","0","5","3.2","1.6"
"Charlton","2020-04-10","2","49","0","5","3.2","1.6"
"Charlton","2020-04-11","2","51","0","5","3.2","1.6"
"Charlton","2020-04-12","0","51","0","5","3.2","1.6"
"Charlton","2020-04-13","2","53","1","6","10.3","5.2"
"Charlton","2020-04-14","9","62","0","6","10.3","5.2"
"Charlton","2020-04-15","8","70","1","7","8.9","6.1"
"Charlton","2020-04-16","4","74","0","7","8.9","6.1"
"Charlton","2020-04-17","10","84","1","8","10.4","6.8"
"Charlton","2020-04-18","4","88","0","8","10.4","6.8"
"Charlton","2020-04-19","0","88","0","8","10.4","6.8"
"Charlton","2020-04-20","1","89","0","8","3.2","6.8"
"Charlton","2020-04-21","2","91","0","8","3.2","6.8"
"Charlton","2020-04-22","13","104","0","8","1.4","5.2"
"Charlton","2020-04-23","4","108","0","8","1.4","5.2"
"Charlton","2020-04-24","3","111","0","8","0","5.2"
"Charlton","2020-04-25","3","114","0","8","0","5.2"
"Charlton","2020-04-26","1","115","0","8","0","5.2"
"Charlton","2020-04-27","5","120","0","8","0","1.6"
"Charlton","2020-04-28","7","127","0","8","0","1.6"
"Charlton","2020-04-29","6","133","2","10","4.8","3.1"
"Charlton","2020-04-30","1","134","0","10","4.8","3.1"
"Charlton","2020-05-01","7","141","1","11","6.8","3.4"
"Charlton","2020-05-02","3","144","1","12","11.6","5.8"
"Charlton","2020-05-03","0","144","0","12","11.6","5.8"
"Charlton","2020-05-04","10","154","1","13","13","6.5"
"Charlton","2020-05-05","16","170","0","13","13","6.5"
"Charlton","2020-05-06","15","185","1","14","9.2","7"
"Charlton","2020-05-07","5","190","1","15","12","8.4"
"Charlton","2020-05-08","2","192","0","15","10","8.4"
"Charlton","2020-05-09","1","193","0","15","5.2","8.4"
"Charlton","2020-05-10","3","196","0","15","5.2","8.4"
"Charlton","2020-05-11","6","202","1","16","6.2","9.6"
"Charlton","2020-05-12","15","217","5","21","11","12"
"Charlton","2020-05-13","3","220","1","22","14.8","12"
"Charlton","2020-05-14","3","223","1","23","16.7","14.4"
"Charlton","2020-05-15","6","229","1","24","19","14.5"
"Charlton","2020-05-16","7","236","1","25","21.1","13.2"
"Charlton","2020-05-17","2","238","1","26","28.2","16.7"
"Charlton","2020-05-18","9","247","0","26","25.9","16"
"Charlton","2020-05-19","13","260","0","26","21.1","16"
"Charlton","2020-05-20","73","333","3","29","16.9","15.8"
"Charlton","2020-05-21","13","346","0","29","12.2","14.4"
"Charlton","2020-05-22","10","356","1","30","11.2","15.1"
"Charlton","2020-05-23","3","359","0","30","9.2","15.1"
"Charlton","2020-05-24","2","361","0","30","2","15.1"
"Charlton","2020-05-25","5","366","0","30","2","13.9"
"Charlton","2020-05-26","3","369","1","31","6.8","13.9"
"Charlton","2020-05-27","10","379","0","31","6.2","11.6"
"Charlton","2020-05-28","10","389","0","31","6.2","9.2"
"Charlton","2020-05-29","10","399","1","32","6.2","8.7"
"Charlton","2020-05-30","3","402","0","32","6.2","7.7"
"Charlton","2020-05-31","0","402","0","32","6.2","4.1"
"Charlton","2020-06-01","6","408","0","32","6.2","4.1"
"Charlton","2020-06-02","5","413","1","33","4.3","5.5"
"Charlton","2020-06-03","5","418","0","33","4.3","5.2"
"Charlton","2020-06-04","1","419","0","33","4.3","5.2"
"Charlton","2020-06-05","5","424","0","33","2.9","4.5"
"Charlton","2020-06-06","5","429","1","34","5.7","6"
"Charlton","2020-06-07","2","431","0","34","5.7","6"
"Charlton","2020-06-08","4","435","0","34","5.7","6"
"Charlton","2020-06-09","3","438","0","34","2.9","3.6"
"Charlton","2020-06-10","4","442","0","34","2.9","3.6"
"Charlton","2020-06-11","5","447","0","34","2.9","3.6"
"Charlton","2020-06-12","5","452","0","34","2.9","2.9"
"Charlton","2020-06-13","4","456","0","34","0","2.9"
"Charlton","2020-06-14","2","458","1","35","7.1","6.4"
"Charlton","2020-06-15","12","470","0","35","7.1","6.4"
"Charlton","2020-06-16","11","481","1","36","8.4","5.6"
"Charlton","2020-06-17","5","486","0","36","8.4","5.6"
"Charlton","2020-06-18","4","490","0","36","8.4","5.6"
"Charlton","2020-06-19","8","498","1","37","10.2","6.5"
"Charlton","2020-06-20","2","500","0","37","10.2","5.1"
"Charlton","2020-06-21","4","504","3","40","13.8","10.5"
"Charlton","2020-06-22","3","507","0","40","13.8","10.5"
"Charlton","2020-06-23","13","520","1","41","13.6","11"
"Charlton","2020-06-24","26","546","2","43","14.7","11.6"
"Charlton","2020-06-25","34","580","2","45","15.5","12"
"Charlton","2020-06-26","23","603","1","46","14.4","12.3"
"Charlton","2020-06-27","14","617","1","47","15.4","12.8"
"Charlton","2020-06-28","3","620","0","47","4.7","9.2"
"Charlton","2020-06-29","16","636","1","48","5.6","9.7"
"Charlton","2020-06-30","35","671","6","54","6.9","10.3"
"Charlton","2020-07-01","23","694","1","55","6.4","10.6"
"Charlton","2020-07-02","48","742","10","65","8.6","12.1"
"Charlton","2020-07-03","9","751","2","67","11.1","12.8"
"Charlton","2020-07-04","8","759","4","71","17.3","16.3"
"Charlton","2020-07-05","7","766","5","76","27.5","16.1"
"Charlton","2020-07-06","24","790","7","83","30.7","18.2"
"Charlton","2020-07-07","54","844","5","88","29.6","18.3"
"Charlton","2020-07-08","81","925","14","102","31.5","19"
"Charlton","2020-07-09","43","968","12","114","32.5","20.5"
"Charlton","2020-07-10","51","1019","14","128","33.2","22.2"
"Charlton","2020-07-11","27","1046","7","135","29.8","23.5"
"Charlton","2020-07-12","9","1055","1","136","21.2","24.3"
"Charlton","2020-07-13","47","1102","11","147","20.3","25.5"
"Charlton","2020-07-14","57","1159","19","166","23.8","26.7"
"Charlton","2020-07-15","45","1204","18","184","27","29.2"
"Charlton","2020-07-16","34","1238","5","189","25.1","28.8"
"Charlton","2020-07-17","45","1283","10","199","24.4","28.8"
"Charlton","2020-07-18","24","1307","8","207","25.4","27.6"
"Charlton","2020-07-19","7","1314","1","208","25.9","23.5"
"Charlton","2020-07-20","30","1344","12","220","28.3","24.3"
"Charlton","2020-07-21","63","1407","11","231","26","24.9"
"Charlton","2020-07-22","56","1463","10","241","22.8","24.9"
"Charlton","2020-07-23","49","1512","17","258","25.7","25.4"
"Charlton","2020-07-24","36","1548","11","269","26.9","25.6"
"Charlton","2020-07-25","18","1566","2","271","23.7","24.6"
"Charlton","2020-07-26","5","1571","1","272","24.5","25.2"
"Charlton","2020-07-27","65","1636","21","293","23.4","25.8"
"Charlton","2020-07-28","46","1682","14","307","25.3","25.6"
"Charlton","2020-07-29","34","1716","3","310","24","23.4"
"Charlton","2020-07-30","123","1839","11","321","20.3","23"
"Charlton","2020-07-31","22","1861","4","325","18.5","22.7"
"Charlton","2020-08-01","10","1871","2","327","19.8","21.8"
"Charlton","2020-08-02","13","1884","5","332","22.5","23.5"
"Charlton","2020-08-03","48","1932","6","338","19.6","21.5"
"Charlton","2020-08-04","57","1989","6","344","16.8","21"
"Charlton","2020-08-05","65","2054","12","356","18.2","21.1"
"Charlton","2020-08-06","209","2263","13","369","17.8","19"
"Charlton","2020-08-07","49","2312","8","377","17.5","18"
"Charlton","2020-08-08","7","2319","2","379","18.7","19.3"
"Charlton","2020-08-09","9","2328","1","380","14.8","18.6"
"Charlton","2020-08-10","59","2387","6","386","14.5","17.1"
"Charlton","2020-08-11","25","2412","7","393","17","16.9"
"Charlton","2020-08-12","98","2510","32","425","19","18.6"
"Charlton","2020-08-13","196","2706","8","433","18.7","18.2"
"Charlton","2020-08-14","105","2811","7","440","17.3","17.4"
"Charlton","2020-08-15","7","2818","0","440","13.2","16"
"Charlton","2020-08-16","46","2864","5","445","13.2","14"
"Charlton","2020-08-17","29","2893","2","447","12.7","13.6"
"Charlton","2020-08-18","81","2974","15","462","11.4","14.2"
"Charlton","2020-08-19","201","3175","9","471","7.4","13.2"
"Charlton","2020-08-20","150","3325","14","485","8.1","13.4"
"Charlton","2020-08-21","70","3395","2","487","7.6","12.4"
"Charlton","2020-08-22","6","3401","0","487","7.6","10.4"
"Charlton","2020-08-23","8","3409","3","490","11.4","12.3"
"Charlton","2020-08-24","33","3442","2","492","11.2","12"
"Charlton","2020-08-25","125","3567","7","499","9.4","10.4"
"Charlton","2020-08-26","215","3782","10","509","9.4","8.4"
"Charlton","2020-08-27","191","3973","15","524","9.2","8.7"
"Charlton","2020-08-28","26","3999","0","524","8.8","8.2"
"Charlton","2020-08-29","16","4015","2","526","10.6","9.1"
"Charlton","2020-08-30","14","4029","4","530","9.3","10.3"
"Charlton","2020-08-31","34","4063","2","532","9.3","10.3"
"Charlton","2020-09-01","66","4129","3","535","9.1","9.3"
"Charlton","2020-09-02","47","4176","2","537","9.1","9.3"
"Charlton","2020-09-03","69","4245","4","541","8.8","9"
"Charlton","2020-09-04","23","4268","0","541","8.8","8.8"
"Charlton","2020-09-05","26","4294","1","542","7.6","9.1"
"Charlton","2020-09-06","5","4299","0","542","3.5","6.4"
"Charlton","2020-09-07","16","4315","1","543","3.5","6.4"
"Charlton","2020-09-08","36","4351","2","545","3.7","6.4"
"Charlton","2020-09-09","46","4397","2","547","3.7","6.4"
"Charlton","2020-09-10","67","4464","8","555","4.6","6.7"
"Charlton","2020-09-11","53","4517","2","557","5.1","6.9"
"Charlton","2020-09-12","6","4523","1","558","6.9","7.2"
"Charlton","2020-09-13","8","4531","1","559","8.7","6.1"
"Charlton","2020-09-14","28","4559","0","559","7.8","5.7"
"Charlton","2020-09-15","40","4599","2","561","7.7","5.7"
"Charlton","2020-09-16","28","4627","2","563","8.1","5.9"
"Charlton","2020-09-17","46","4673","2","565","7.1","5.8"
"Charlton","2020-09-18","16","4689","2","567","8.3","6.7"
"Charlton","2020-09-19","5","4694","0","567","5.9","6.4"
"Charlton","2020-09-20","8","4702","2","569","7.7","8.2"
"Charlton","2020-09-21","27","4729","3","572","9.3","8.6"
"Charlton","2020-09-22","54","4783","5","577","9.9","8.8"
"Charlton","2020-09-23","27","4810","3","580","10.5","9.3"
"Charlton","2020-09-24","49","4859","7","587","11.9","9.5"
"Charlton","2020-09-25","27","4886","1","588","10.6","9.5"
"Charlton","2020-09-26","19","4905","0","588","10.6","8.3"
"Charlton","2020-09-27","1","4906","0","588","7.1","7.4"
"Charlton","2020-09-28","28","4934","2","590","6.5","7.9"
"Charlton","2020-09-29","21","4955","2","592","6.5","8.2"
"Charlton","2020-09-30","30","4985","1","593","5.4","8"
"Charlton","2020-10-01","7","4992","0","593","3.4","7.6"
"Charlton","2020-10-02","12","5004","0","593","2.9","6.7"
"Charlton","2020-10-03","0","5004","0","593","2.9","6.7"
"Charlton","2020-10-04","4","5008","0","593","2.9","5"
"Charlton","2020-10-05","29","5037","1","594","2.3","4.4"
"Charlton","2020-10-06","19","5056","0","594","1","3.8"
"Charlton","2020-10-07","24","5080","1","595","1.1","3.3"
"Charlton","2020-10-08","24","5104","0","595","1.1","2.2"
"Charlton","2020-10-09","72","5176","1","596","1.3","2.1"
"Charlton","2020-10-10","4","5180","0","596","1.3","2.1"
"Charlton","2020-10-11","15","5195","2","598","3.2","3"
"Charlton","2020-10-12","11","5206","1","599","4","3.2"
"Charlton","2020-10-13","16","5222","1","600","4.9","2.9"
"Charlton","2020-10-14","41","5263","0","600","4.3","2.7"
"Charlton","2020-10-15","14","5277","1","601","5.3","3.2"
"Charlton","2020-10-16","17","5294","0","601","5.1","3.2"
"Charlton","2020-10-17","5","5299","0","601","5.1","3.2"
"Charlton","2020-10-18","4","5303","0","601","3.2","3.2"
"Charlton","2020-10-19","22","5325","0","601","1.9","3"
"Charlton","2020-10-20","34","5359","0","601","1","3"
"Charlton","2020-10-21","18","5377","0","601","1","2.7"
"Charlton","2020-10-22","10","5387","2","603","2.9","4.1"
"Charlton","2020-10-23","25","5412","0","603","2.9","4"
"Charlton","2020-10-24","3","5415","0","603","2.9","4"
"Charlton","2020-10-25","4","5419","0","603","2.9","3"
"Charlton","2020-10-26","52","5471","0","603","2.9","2.4"
"Charlton","2020-10-27","20","5491","2","605","4.3","2.7"
"Charlton","2020-10-28","30","5521","1","606","4.8","2.9"
"Charlton","2020-10-29","25","5546","2","608","3","3"
"Charlton","2020-10-30","20","5566","1","609","3.8","3.3"
"Charlton","2020-10-31","6","5572","0","609","3.8","3.3"
"Charlton","2020-11-01","1","5573","0","609","3.8","3.3"
"Charlton","2020-11-02","18","5591","1","610","4.6","3.7"
"Charlton","2020-11-03","17","5608","1","611","4","4.1"
"Charlton","2020-11-04","24","5632","3","614","5.3","5"
"Charlton","2020-11-05","17","5649","3","617","6.7","4.9"
"Charlton","2020-11-06","24","5673","1","618","6.5","5.1"
"Charlton","2020-11-07","8","5681","3","621","11.9","7.8"
"Charlton","2020-11-08","4","5685","1","622","15.5","9.6"
"Charlton","2020-11-09","28","5713","1","623","15.2","9.9"
"Charlton","2020-11-10","18","5731","3","626","16.7","10.3"
"Charlton","2020-11-11","29","5760","0","626","14.9","10.1"
"Charlton","2020-11-12","30","5790","3","629","13.8","10.2"
"Charlton","2020-11-13","17","5807","2","631","14.9","10.7"
"Charlton","2020-11-14","12","5819","0","631","9.6","10.7"
"Charlton","2020-11-15","2","5821","1","632","13.1","14.3"
"Charlton","2020-11-16","32","5853","1","633","13.1","14.1"
"Charlton","2020-11-17","10","5863","2","635","13.6","15.1"
"Charlton","2020-11-18","42","5905","2","637","14.2","14.6"
"Charlton","2020-11-19","21","5926","4","641","15.5","14.7"
"Charlton","2020-11-20","16","5942","2","643","15.6","15.3"
"Charlton","2020-11-21","51","5993","4","647","16.8","13.2"
"Charlton","2020-11-22","4","5997","0","647","9.6","11.4"
"Charlton","2020-11-23","355","6352","3","650","9.3","11.2"
"Charlton","2020-11-24","20","6372","1","651","7.1","10.3"
"Charlton","2020-11-25","39","6411","3","654","7.6","10.9"
"Charlton","2020-11-26","48","6459","1","655","5.1","10.3"
"Charlton","2020-11-27","8","6467","1","656","5.1","10.4"
"Charlton","2020-11-28","14","6481","4","660","8.1","12.4"
"Charlton","2020-11-29","4","6485","1","661","11.7","10.6"
"Charlton","2020-11-30","112","6597","2","663","11.8","10.5"
"Charlton","2020-12-01","68","6665","1","664","11.3","9.2"
"Charlton","2020-12-02","38","6703","2","666","11","9.3"
"Charlton","2020-12-03","72","6775","11","677","12.8","9"
"Charlton","2020-12-04","52","6827","5","682","12.4","8.8"
"Charlton","2020-12-05","31","6858","2","684","9.3","8.7"
"Charlton","2020-12-06","7","6865","0","684","5.7","8.7"
"Charlton","2020-12-07","130","6995","4","688","5.9","8.8"
"Charlton","2020-12-08","20","7015","2","690","7.1","9.2"
"Charlton","2020-12-09","76","7091","7","697","7.7","9.3"
"Charlton","2020-12-10","37","7128","3","700","6.6","9.7"
"Charlton","2020-12-11","132","7260","6","706","5.9","9.2"
"Charlton","2020-12-12","38","7298","3","709","6.1","7.7"
"Charlton","2020-12-13","4","7302","1","710","9.7","7.7"
"Charlton","2020-12-14","49","7351","4","714","10.4","8.1"
"Charlton","2020-12-15","80","7431","6","720","10.1","8.6"
"Charlton","2020-12-16","44","7475","5","725","10.4","9"
"Charlton","2020-12-17","32","7507","6","731","11.9","9.3"
"Charlton","2020-12-18","29","7536","4","735","13.2","9.6"
"Charlton","2020-12-19","15","7551","6","741","17.8","12"
"Charlton","2020-12-20","11","7562","2","743","16.8","13.3"
"Charlton","2020-12-21","64","7626","8","751","17.4","13.9"
"Charlton","2020-12-22","43","7669","3","754","17.4","13.7"
"Charlton","2020-12-23","71","7740","19","773","19.6","15"
"Charlton","2020-12-24","28","7768","8","781","21","16.4"
"Charlton","2020-12-25","3","7771","1","782","23.8","18.5"
"Charlton","2020-12-26","8","7779","3","785","23.4","20.6"
"Charlton","2020-12-27","9","7788","2","787","24","20.4"
"Charlton","2020-12-28","110","7898","5","792","22.8","20.1"
"Charlton","2020-12-29","59","7957","9","801","24","20.7"
"Charlton","2020-12-30","205","8162","16","817","21.3","20.4"
"Charlton","2020-12-31","17","8179","5","822","21.4","21.2"
"Charlton","2021-01-01","8","8187","0","822","16.7","20.2"
"Charlton","2021-01-02","5","8192","1","823","14.2","18.8"
"Charlton","2021-01-03","7","8199","0","823","11","17.5"
"Charlton","2021-01-04","73","8272","11","834","12.5","17.7"
"Charlton","2021-01-05","31","8303","13","847","16.3","20.2"
"Charlton","2021-01-06","127","8430","2","849","15.4","18.4"
"Charlton","2021-01-07","35","8465","5","854","13.3","17.4"
"Charlton","2021-01-08","29","8494","5","859","15.7","16.2"
"Charlton","2021-01-09","13","8507","3","862","16.2","15.2"
"Charlton","2021-01-10","3","8510","2","864","25.7","18.3"
"Charlton","2021-01-11","27","8537","3","867","25.1","18.8"
"Charlton","2021-01-12","34","8571","7","874","22.1","19.2"
"Charlton","2021-01-13","64","8635","3","877","22.5","19"
"Charlton","2021-01-14","132","8767","4","881","20.9","17.1"
"Charlton","2021-01-15","30","8797","4","885","20.4","18"
"Charlton","2021-01-16","13","8810","4","889","21.5","18.8"
"Charlton","2021-01-17","5","8815","2","891","17.6","21.7"
"Charlton","2021-01-18","16","8831","1","892","17","21"
"Charlton","2021-01-19","28","8859","3","895","15.5","18.8"
"Charlton","2021-01-20","83","8942","6","901","15.9","19.2"
"Charlton","2021-01-21","98","9040","2","903","15.8","18.3"
"Charlton","2021-01-22","82","9122","2","905","14.2","17.3"
"Charlton","2021-01-23","52","9174","1","906","10.1","15.8"
"Charlton","2021-01-24","3","9177","1","907","9.1","13.4"
"Charlton","2021-01-25","7","9184","1","908","10.3","13.6"
"Charlton","2021-01-26","1","9185","1","909","23","19.3"
"Charlton","2021-01-27","0","9185","0","909","22","19"
"Chatham","2020-02-01","0","0","0","0",".","."
"Chatham","2020-02-02","0","0","0","0",".","."
"Chatham","2020-02-03","0","0","0","0",".","."
"Chatham","2020-02-04","1","1","0","0",".","."
"Chatham","2020-02-05","0","1","0","0",".","."
"Chatham","2020-02-06","0","1","0","0",".","."
"Chatham","2020-02-07","0","1","0","0","0","."
"Chatham","2020-02-08","0","1","0","0","0","."
"Chatham","2020-02-09","0","1","0","0","0","."
"Chatham","2020-02-10","2","3","0","0","0","."
"Chatham","2020-02-11","0","3","0","0","0","."
"Chatham","2020-02-12","0","3","0","0","0","."
"Chatham","2020-02-13","0","3","0","0","0","."
"Chatham","2020-02-14","0","3","0","0","0","0"
"Chatham","2020-02-15","0","3","0","0","0","0"
"Chatham","2020-02-16","0","3","0","0","0","0"
"Chatham","2020-02-17","0","3","0","0","0","0"
"Chatham","2020-02-18","0","3","0","0","0","0"
"Chatham","2020-02-19","0","3","0","0","0","0"
"Chatham","2020-02-20","0","3","0","0","0","0"
"Chatham","2020-02-21","0","3","0","0","0","0"
"Chatham","2020-02-22","0","3","0","0","0","0"
"Chatham","2020-02-23","0","3","0","0","0","0"
"Chatham","2020-02-24","0","3","0","0","0","0"
"Chatham","2020-02-25","0","3","0","0","0","0"
"Chatham","2020-02-26","0","3","0","0","0","0"
"Chatham","2020-02-27","1","4","1","1","14.3","7.1"
"Chatham","2020-02-28","0","4","0","1","14.3","7.1"
"Chatham","2020-02-29","0","4","0","1","14.3","7.1"
"Chatham","2020-03-01","0","4","0","1","14.3","7.1"
"Chatham","2020-03-02","0","4","0","1","14.3","7.1"
"Chatham","2020-03-03","0","4","0","1","14.3","7.1"
"Chatham","2020-03-04","0","4","0","1","14.3","7.1"
"Chatham","2020-03-05","0","4","0","1","0","7.1"
"Chatham","2020-03-06","2","6","0","1","0","7.1"
"Chatham","2020-03-07","0","6","0","1","0","7.1"
"Chatham","2020-03-08","0","6","0","1","0","7.1"
"Chatham","2020-03-09","2","8","0","1","0","7.1"
"Chatham","2020-03-10","1","9","0","1","0","7.1"
"Chatham","2020-03-11","1","10","0","1","0","7.1"
"Chatham","2020-03-12","22","32","0","1","0","0"
"Chatham","2020-03-13","34","66","1","2","0.4","0.2"
"Chatham","2020-03-14","38","104","0","2","0.4","0.2"
"Chatham","2020-03-15","58","162","0","2","0.4","0.2"
"Chatham","2020-03-16","76","238","3","5","1","0.5"
"Chatham","2020-03-17","74","312","1","6","1.2","0.6"
"Chatham","2020-03-18","76","388","7","13","2.5","1.2"
"Chatham","2020-03-19","28","416","5","18","5","2.5"
"Chatham","2020-03-20","74","490","5","23","5.6","3"
"Chatham","2020-03-21","47","537","1","24","5.9","3.2"
"Chatham","2020-03-22","40","577","3","27","7","3.7"
"Chatham","2020-03-23","87","664","10","37","8","4.5"
"Chatham","2020-03-24","107","771","7","44","8.8","5"
"Chatham","2020-03-25","107","878","6","50","8.3","5.4"
"Chatham","2020-03-26","104","982","9","59","7","6"
"Chatham","2020-03-27","99","1081","16","75","8.3","6.9"
"Chatham","2020-03-28","19","1100","1","76","8.7","7.3"
"Chatham","2020-03-29","22","1122","5","81","10.9","8.9"
"Chatham","2020-03-30","103","1225","10","91","10.7","9.4"
"Chatham","2020-03-31","79","1304","7","98","11","9.9"
"Chatham","2020-04-01","87","1391","11","109","12","10.1"
"Chatham","2020-04-02","73","1464","6","115","11.9","9.4"
"Chatham","2020-04-03","106","1570","8","123","10.7","9.5"
"Chatham","2020-04-04","33","1603","2","125","10.8","9.8"
"Chatham","2020-04-05","39","1642","6","131","9.8","10.3"
"Chatham","2020-04-06","149","1791","7","138","9.1","9.9"
"Chatham","2020-04-07","113","1904","5","143","8.4","9.7"
"Chatham","2020-04-08","119","2023","7","150","7.5","9.7"
"Chatham","2020-04-09","115","2138","10","160","7.5","9.7"
"Chatham","2020-04-10","95","2233","2","162","6.8","8.7"
"Chatham","2020-04-11","13","2246","1","163","7","8.9"
"Chatham","2020-04-12","10","2256","1","164","6.2","8"
"Chatham","2020-04-13","65","2321","6","170","6.9","8"
"Chatham","2020-04-14","122","2443","13","183","7.8","8.1"
"Chatham","2020-04-15","97","2540","7","190","7.9","7.7"
"Chatham","2020-04-16","126","2666","4","194","7.2","7.3"
"Chatham","2020-04-17","113","2779","8","202","7.9","7.3"
"Chatham","2020-04-18","62","2841","2","204","7.2","7.1"
"Chatham","2020-04-19","20","2861","0","204","5.8","6"
"Chatham","2020-04-20","150","3011","13","217","5.7","6.3"
"Chatham","2020-04-21","151","3162","0","217","4.2","6"
"Chatham","2020-04-22","174","3336","4","221","3.5","5.7"
"Chatham","2020-04-23","104","3440","4","225","3.6","5.4"
"Chatham","2020-04-24","96","3536","2","227","2.9","5.4"
"Chatham","2020-04-25","24","3560","0","227","2.4","4.8"
"Chatham","2020-04-26","30","3590","1","228","2.9","4.3"
"Chatham","2020-04-27","184","3774","4","232","2","3.8"
"Chatham","2020-04-28","128","3902","7","239","2.7","3.5"
"Chatham","2020-04-29","91","3993","3","242","2.9","3.2"
"Chatham","2020-04-30","125","4118","13","255","3.8","3.7"
"Chatham","2020-05-01","96","4214","6","261","4.4","3.6"
"Chatham","2020-05-02","42","4256","5","266","6.1","4.3"
"Chatham","2020-05-03","38","4294","0","266","5.6","4.3"
"Chatham","2020-05-04","119","4413","4","270","5.8","3.9"
"Chatham","2020-05-05","89","4502","5","275","5.8","4.3"
"Chatham","2020-05-06","179","4681","3","278","5.6","4.2"
"Chatham","2020-05-07","87","4768","1","279","4.3","4.1"
"Chatham","2020-05-08","84","4852","3","282","3.9","4.2"
"Chatham","2020-05-09","65","4917","6","288","3.5","4.8"
"Chatham","2020-05-10","28","4945","0","288","3.5","4.6"
"Chatham","2020-05-11","167","5112","9","297","3.8","4.8"
"Chatham","2020-05-12","107","5219","2","299","3.3","4.6"
"Chatham","2020-05-13","246","5465","7","306","3.4","4.5"
"Chatham","2020-05-14","351","5816","6","312","3.5","3.9"
"Chatham","2020-05-15","188","6004","6","318","3.5","3.7"
"Chatham","2020-05-16","194","6198","9","327","2.8","3.2"
"Chatham","2020-05-17","34","6232","3","330","4.1","3.8"
"Chatham","2020-05-18","410","6642","17","347","3.9","3.8"
"Chatham","2020-05-19","189","6831","5","352","4","3.6"
"Chatham","2020-05-20","341","7172","13","365","4.1","3.8"
"Chatham","2020-05-21","193","7365","8","373","4.5","4"
"Chatham","2020-05-22","248","7613","5","378","4.3","3.9"
"Chatham","2020-05-23","121","7734","1","379","3.8","3.3"
"Chatham","2020-05-24","62","7796","1","380","2.7","3.4"
"Chatham","2020-05-25","65","7861","3","383","2.8","3.3"
"Chatham","2020-05-26","367","8228","5","388","2.6","3.3"
"Chatham","2020-05-27","424","8652","10","398","2.4","3.3"
"Chatham","2020-05-28","485","9137","6","404","2","3.2"
"Chatham","2020-05-29","639","9776","9","413","1.9","3.1"
"Chatham","2020-05-30","283","10059","3","416","2","2.9"
"Chatham","2020-05-31","66","10125","9","425","3.7","3.2"
"Chatham","2020-06-01","399","10524","6","431","3.2","3"
"Chatham","2020-06-02","300","10824","8","439","3.4","3"
"Chatham","2020-06-03","274","11098","4","443","3.3","2.9"
"Chatham","2020-06-04","462","11560","15","458","3.6","2.8"
"Chatham","2020-06-05","199","11759","5","463","3.7","2.8"
"Chatham","2020-06-06","94","11853","10","473","5.1","3.5"
"Chatham","2020-06-07","40","11893","2","475","3.9","3.8"
"Chatham","2020-06-08","294","12187","23","498","4.8","4"
"Chatham","2020-06-09","228","12415","15","513","5.3","4.4"
"Chatham","2020-06-10","420","12835","25","538","6","4.6"
"Chatham","2020-06-11","297","13132","16","554","6.3","4.9"
"Chatham","2020-06-12","230","13362","12","566","6.7","5.2"
"Chatham","2020-06-13","196","13558","9","575","5.8","5.4"
"Chatham","2020-06-14","72","13630","7","582","6.5","5.2"
"Chatham","2020-06-15","365","13995","30","612","6.5","5.6"
"Chatham","2020-06-16","329","14324","46","658","7.6","6.5"
"Chatham","2020-06-17","286","14610","34","692","8.4","7.2"
"Chatham","2020-06-18","623","15233","59","751","9","7.6"
"Chatham","2020-06-19","902","16135","72","823","9.4","8"
"Chatham","2020-06-20","527","16662","40","863","9.8","7.8"
"Chatham","2020-06-21","71","16733","23","886","13.1","9.8"
"Chatham","2020-06-22","1251","17984","151","1037","13.6","10.1"
"Chatham","2020-06-23","877","18861","81","1118","12.9","10.3"
"Chatham","2020-06-24","1225","20086","142","1260","12.9","10.7"
"Chatham","2020-06-25","1168","21254","121","1381","13","11"
"Chatham","2020-06-26","1439","22693","135","1516","13.2","11.3"
"Chatham","2020-06-27","907","23600","89","1605","13.5","11.7"
"Chatham","2020-06-28","161","23761","26","1631","11.2","12.2"
"Chatham","2020-06-29","1359","25120","145","1776","11","12.3"
"Chatham","2020-06-30","1584","26704","188","1964","11.4","12.2"
"Chatham","2020-07-01","1412","28116","141","2105","11.2","12"
"Chatham","2020-07-02","1280","29396","153","2258","11.4","12.2"
"Chatham","2020-07-03","429","29825","97","2355","13.3","13.3"
"Chatham","2020-07-04","141","29966","35","2390","15.4","14.5"
"Chatham","2020-07-05","161","30127","39","2429","16.6","13.9"
"Chatham","2020-07-06","1521","31648","236","2665","17.3","14.2"
"Chatham","2020-07-07","1287","32935","165","2830","17.4","14.4"
"Chatham","2020-07-08","1495","34430","184","3014","17.8","14.5"
"Chatham","2020-07-09","1300","35730","167","3181","17.9","14.6"
"Chatham","2020-07-10","1231","36961","144","3325","16.3","14.8"
"Chatham","2020-07-11","523","37484","87","3412","15.1","15.3"
"Chatham","2020-07-12","170","37654","51","3463","16","16.3"
"Chatham","2020-07-13","1425","39079","223","3686","16","16.6"
"Chatham","2020-07-14","1365","40444","187","3873","16.1","16.8"
"Chatham","2020-07-15","1209","41653","185","4058","16.5","17.1"
"Chatham","2020-07-16","1525","43178","178","4236","16.4","17.1"
"Chatham","2020-07-17","1247","44425","158","4394","16.5","16.4"
"Chatham","2020-07-18","723","45148","107","4501","16.3","15.7"
"Chatham","2020-07-19","202","45350","43","4544","15","15.5"
"Chatham","2020-07-20","1378","46728","199","4743","14.8","15.4"
"Chatham","2020-07-21","1084","47812","108","4851","14.3","15.2"
"Chatham","2020-07-22","1170","48982","136","4987","13.8","15.2"
"Chatham","2020-07-23","902","49884","132","5119","14.2","15.3"
"Chatham","2020-07-24","999","50883","102","5221","13.9","15.2"
"Chatham","2020-07-25","469","51352","58","5279","13.5","14.9"
"Chatham","2020-07-26","188","51540","45","5324","13.9","14.4"
"Chatham","2020-07-27","1736","53276","173","5497","13.2","14"
"Chatham","2020-07-28","1270","54546","121","5618","13.2","13.7"
"Chatham","2020-07-29","1003","55549","121","5739","13.2","13.5"
"Chatham","2020-07-30","949","56498","128","5867","13.1","13.6"
"Chatham","2020-07-31","1218","57716","143","6010","13.3","13.6"
"Chatham","2020-08-01","892","58608","102","6112","13.2","13.3"
"Chatham","2020-08-02","198","58806","36","6148","12.3","13.1"
"Chatham","2020-08-03","657","59463","97","6245","13","13.1"
"Chatham","2020-08-04","1371","60834","160","6405","13.3","13.3"
"Chatham","2020-08-05","969","61803","83","6488","12.8","13"
"Chatham","2020-08-06","1163","62966","100","6588","12.1","12.6"
"Chatham","2020-08-07","976","63942","89","6677","11.8","12.5"
"Chatham","2020-08-08","443","64385","55","6732","11.9","12.5"
"Chatham","2020-08-09","299","64684","42","6774","11.3","11.8"
"Chatham","2020-08-10","1142","65826","91","6865","10.3","11.7"
"Chatham","2020-08-11","662","66488","82","6947","10.4","11.9"
"Chatham","2020-08-12","960","67448","77","7024","10.4","11.6"
"Chatham","2020-08-13","878","68326","59","7083","10.1","11.1"
"Chatham","2020-08-14","912","69238","95","7178","10.3","11"
"Chatham","2020-08-15","379","69617","33","7211","9.8","10.8"
"Chatham","2020-08-16","517","70134","34","7245","8.7","10"
"Chatham","2020-08-17","481","70615","58","7303","9.3","9.8"
"Chatham","2020-08-18","893","71508","72","7375","8.7","9.5"
"Chatham","2020-08-19","894","72402","77","7452","8.7","9.6"
"Chatham","2020-08-20","796","73198","79","7531","9.2","9.6"
"Chatham","2020-08-21","747","73945","74","7605","9.1","9.7"
"Chatham","2020-08-22","270","74215","34","7639","9.7","9.7"
"Chatham","2020-08-23","173","74388","23","7662","10.6","9.7"
"Chatham","2020-08-24","987","75375","96","7758","10.3","9.8"
"Chatham","2020-08-25","696","76071","80","7838","10.8","9.7"
"Chatham","2020-08-26","856","76927","75","7913","10.8","9.8"
"Chatham","2020-08-27","832","77759","76","7989","10.7","9.9"
"Chatham","2020-08-28","707","78466","71","8060","10.7","9.9"
"Chatham","2020-08-29","226","78692","38","8098","11.3","10.5"
"Chatham","2020-08-30","299","78991","27","8125","10.7","10.7"
"Chatham","2020-08-31","997","79988","92","8217","10.6","10.5"
"Chatham","2020-09-01","881","80869","77","8294","10.3","10.5"
"Chatham","2020-09-02","879","81748","80","8374","10.3","10.6"
"Chatham","2020-09-03","824","82572","75","8449","10.3","10.5"
"Chatham","2020-09-04","752","83324","79","8528","10.4","10.5"
"Chatham","2020-09-05","485","83809","42","8570","9.2","10.3"
"Chatham","2020-09-06","244","84053","14","8584","8.7","9.7"
"Chatham","2020-09-07","465","84518","53","8637","9","9.8"
"Chatham","2020-09-08","893","85411","77","8714","9","9.6"
"Chatham","2020-09-09","902","86313","75","8789","8.9","9.6"
"Chatham","2020-09-10","788","87101","54","8843","8.6","9.4"
"Chatham","2020-09-11","768","87869","75","8918","8.5","9.4"
"Chatham","2020-09-12","215","88084","26","8944","9","9.1"
"Chatham","2020-09-13","355","88439","34","8978","9.5","9.1"
"Chatham","2020-09-14","1030","89469","75","9053","8.9","9"
"Chatham","2020-09-15","750","90219","60","9113","8.8","8.9"
"Chatham","2020-09-16","690","90909","56","9169","8.8","8.9"
"Chatham","2020-09-17","971","91880","82","9251","9","8.8"
"Chatham","2020-09-18","713","92593","48","9299","8.6","8.5"
"Chatham","2020-09-19","466","93059","34","9333","7.9","8.4"
"Chatham","2020-09-20","264","93323","13","9346","7.3","8.4"
"Chatham","2020-09-21","788","94111","51","9397","7.1","8"
"Chatham","2020-09-22","692","94803","54","9451","7.1","8"
"Chatham","2020-09-23","662","95465","42","9493","6.9","7.8"
"Chatham","2020-09-24","838","96303","41","9534","6.4","7.7"
"Chatham","2020-09-25","671","96974","44","9578","6.3","7.5"
"Chatham","2020-09-26","174","97148","12","9590","6.3","7.1"
"Chatham","2020-09-27","95","97243","18","9608","8.3","7.8"
"Chatham","2020-09-28","798","98041","42","9650","8.1","7.6"
"Chatham","2020-09-29","620","98661","50","9700","8.1","7.6"
"Chatham","2020-09-30","712","99373","39","9739","8","7.4"
"Chatham","2020-10-01","629","100002","33","9772","8.1","7.2"
"Chatham","2020-10-02","583","100585","35","9807","8","7.2"
"Chatham","2020-10-03","357","100942","15","9822","7.6","6.9"
"Chatham","2020-10-04","274","101216","12","9834","5.5","6.9"
"Chatham","2020-10-05","840","102056","64","9898","5.9","7"
"Chatham","2020-10-06","733","102789","40","9938","5.5","6.8"
"Chatham","2020-10-07","591","103380","25","9963","5.3","6.7"
"Chatham","2020-10-08","775","104155","53","10016","5.5","6.8"
"Chatham","2020-10-09","628","104783","29","10045","5.3","6.7"
"Chatham","2020-10-10","207","104990","18","10063","6","6.8"
"Chatham","2020-10-11","236","105226","21","10084","6.6","6.1"
"Chatham","2020-10-12","617","105843","46","10130","6.6","6.2"
"Chatham","2020-10-13","818","106661","37","10167","6.5","6"
"Chatham","2020-10-14","491","107152","23","10190","6.5","5.9"
"Chatham","2020-10-15","619","107771","37","10227","6.4","6"
"Chatham","2020-10-16","617","108388","40","10267","6.7","6"
"Chatham","2020-10-17","304","108692","26","10293","6.7","6.3"
"Chatham","2020-10-18","173","108865","12","10305","6.4","6.5"
"Chatham","2020-10-19","906","109771","48","10353","6.1","6.3"
"Chatham","2020-10-20","634","110405","56","10409","6.7","6.6"
"Chatham","2020-10-21","533","110938","29","10438","6.8","6.7"
"Chatham","2020-10-22","706","111644","54","10492","7","6.7"
"Chatham","2020-10-23","512","112156","32","10524","7","6.8"
"Chatham","2020-10-24","261","112417","5","10529","6","6.3"
"Chatham","2020-10-25","129","112546","8","10537","5.9","6.2"
"Chatham","2020-10-26","755","113301","50","10587","6.1","6.1"
"Chatham","2020-10-27","571","113872","41","10628","5.9","6.3"
"Chatham","2020-10-28","541","114413","33","10661","6","6.4"
"Chatham","2020-10-29","609","115022","42","10703","5.9","6.5"
"Chatham","2020-10-30","555","115577","37","10740","5.9","6.5"
"Chatham","2020-10-31","167","115744","8","10748","6.4","6.2"
"Chatham","2020-11-01","116","115860","8","10756","6.5","6.2"
"Chatham","2020-11-02","906","116766","50","10806","6.3","6.2"
"Chatham","2020-11-03","398","117164","37","10843","6.6","6.2"
"Chatham","2020-11-04","422","117586","27","10870","6.6","6.3"
"Chatham","2020-11-05","692","118278","36","10906","6.4","6.1"
"Chatham","2020-11-06","496","118774","34","10940","6.4","6.2"
"Chatham","2020-11-07","247","119021","23","10963","7.1","6.7"
"Chatham","2020-11-08","153","119174","15","10978","7.5","7"
"Chatham","2020-11-09","816","119990","69","11047","7.9","7.1"
"Chatham","2020-11-10","760","120750","51","11098","7.5","7.1"
"Chatham","2020-11-11","460","121210","45","11143","8","7.3"
"Chatham","2020-11-12","558","121768","56","11199","8.7","7.6"
"Chatham","2020-11-13","821","122589","43","11242","8.5","7.4"
"Chatham","2020-11-14","372","122961","33","11275","8.4","7.7"
"Chatham","2020-11-15","175","123136","31","11306","9.5","8.5"
"Chatham","2020-11-16","996","124132","77","11383","9.4","8.7"
"Chatham","2020-11-17","863","124995","61","11444","9.5","8.5"
"Chatham","2020-11-18","660","125655","35","11479","8.9","8.4"
"Chatham","2020-11-19","815","126470","57","11536","8.4","8.6"
"Chatham","2020-11-20","731","127201","44","11580","8.5","8.5"
"Chatham","2020-11-21","457","127658","21","11601","7.9","8.2"
"Chatham","2020-11-22","231","127889","14","11615","6.3","7.9"
"Chatham","2020-11-23","1082","128971","76","11691","6.2","7.8"
"Chatham","2020-11-24","960","129931","79","11770","6.3","7.9"
"Chatham","2020-11-25","940","130871","73","11843","6.7","7.8"
"Chatham","2020-11-26","80","130951","3","11846","6.2","7.3"
"Chatham","2020-11-27","255","131206","35","11881","7.3","7.9"
"Chatham","2020-11-28","169","131375","30","11911","9.2","8.6"
"Chatham","2020-11-29","199","131574","17","11928","9.5","7.9"
"Chatham","2020-11-30","1029","132603","96","12024","9.9","8"
"Chatham","2020-12-01","850","133453","91","12115","10.2","8.3"
"Chatham","2020-12-02","697","134150","60","12175","10.3","8.5"
"Chatham","2020-12-03","761","134911","70","12245","11.1","8.7"
"Chatham","2020-12-04","671","135582","53","12298","10.3","8.8"
"Chatham","2020-12-05","426","136008","47","12345","9.3","9.3"
"Chatham","2020-12-06","195","136203","22","12367","9.7","9.6"
"Chatham","2020-12-07","1025","137228","96","12463","9.7","9.8"
"Chatham","2020-12-08","738","137966","80","12543","9.7","10"
"Chatham","2020-12-09","944","138910","89","12632","9.9","10.1"
"Chatham","2020-12-10","729","139639","77","12709","10.1","10.6"
"Chatham","2020-12-11","756","140395","89","12798","10.6","10.5"
"Chatham","2020-12-12","223","140618","25","12823","10.6","10"
"Chatham","2020-12-13","172","140790","34","12857","11.8","10.8"
"Chatham","2020-12-14","916","141706","127","12984","12.5","11.1"
"Chatham","2020-12-15","865","142571","99","13083","12.6","11.2"
"Chatham","2020-12-16","978","143549","106","13189","12.8","11.3"
"Chatham","2020-12-17","838","144387","90","13279","12.8","11.4"
"Chatham","2020-12-18","845","145232","96","13375","12.7","11.7"
"Chatham","2020-12-19","454","145686","37","13412","12.3","11.5"
"Chatham","2020-12-20","245","145931","38","13450","11.7","11.8"
"Chatham","2020-12-21","1224","147155","106","13556","11","11.7"
"Chatham","2020-12-22","1035","148190","118","13674","11","11.8"
"Chatham","2020-12-23","1019","149209","110","13784","10.9","11.9"
"Chatham","2020-12-24","359","149568","41","13825","11","11.9"
"Chatham","2020-12-25","104","149672","11","13836","10.9","11.8"
"Chatham","2020-12-26","185","149857","27","13863","11.9","12.1"
"Chatham","2020-12-27","201","150058","48","13911","13","12.4"
"Chatham","2020-12-28","1287","151345","158","14069","13.6","12.3"
"Chatham","2020-12-29","1130","152475","151","14220","13.8","12.4"
"Chatham","2020-12-30","1065","153540","154","14374","14.4","12.7"
"Chatham","2020-12-31","833","154373","120","14494","14.8","12.9"
"Chatham","2021-01-01","32","154405","7","14501","16.4","13.7"
"Chatham","2021-01-02","352","154757","36","14537","15.8","13.8"
"Chatham","2021-01-03","126","154883","33","14570","16.1","14.6"
"Chatham","2021-01-04","1198","156081","182","14752","16.5","15"
"Chatham","2021-01-05","1396","157477","201","14953","16.7","15.3"
"Chatham","2021-01-06","1116","158593","174","15127","16.8","15.6"
"Chatham","2021-01-07","894","159487","121","15248","16.7","15.8"
"Chatham","2021-01-08","1015","160502","143","15391","15.6","16"
"Chatham","2021-01-09","319","160821","54","15445","16.6","16.2"
"Chatham","2021-01-10","258","161079","42","15487","15.1","15.6"
"Chatham","2021-01-11","1082","162161","109","15596","14.4","15.5"
"Chatham","2021-01-12","938","163099","117","15713","14.1","15.4"
"Chatham","2021-01-13","1000","164099","123","15836","13.7","15.3"
"Chatham","2021-01-14","1081","165180","122","15958","13.3","15"
"Chatham","2021-01-15","791","165971","107","16065","13.3","14.4"
"Chatham","2021-01-16","478","166449","59","16124","12.6","14.6"
"Chatham","2021-01-17","271","166720","69","16193","13.9","14.5"
"Chatham","2021-01-18","875","167595","115","16308","14.4","14.4"
"Chatham","2021-01-19","1087","168682","146","16454","14.5","14.3"
"Chatham","2021-01-20","866","169548","135","16589","15","14.3"
"Chatham","2021-01-21","1025","170573","154","16743","15.5","14.4"
"Chatham","2021-01-22","915","171488","111","16854","15.3","14.3"
"Chatham","2021-01-23","240","171728","37","16891","15.7","14.2"
"Chatham","2021-01-24","179","171907","38","16929","15.1","14.5"
"Chatham","2021-01-25","727","172634","138","17067","16","15.2"
"Chatham","2021-01-26","16","172650","3","17070","16.7","15.6"
"Chatham","2021-01-27","0","172650","0","17070","14.5","14.7"
"Chattahoochee","2020-02-01","0","0","0","0",".","."
"Chattahoochee","2020-02-02","0","0","0","0",".","."
"Chattahoochee","2020-02-03","0","0","0","0",".","."
"Chattahoochee","2020-02-04","0","0","0","0",".","."
"Chattahoochee","2020-02-05","0","0","0","0",".","."
"Chattahoochee","2020-02-06","0","0","0","0",".","."
"Chattahoochee","2020-02-07","0","0","0","0","0","."
"Chattahoochee","2020-02-08","0","0","0","0","0","."
"Chattahoochee","2020-02-09","0","0","0","0","0","."
"Chattahoochee","2020-02-10","0","0","0","0","0","."
"Chattahoochee","2020-02-11","0","0","0","0","0","."
"Chattahoochee","2020-02-12","0","0","0","0","0","."
"Chattahoochee","2020-02-13","0","0","0","0","0","."
"Chattahoochee","2020-02-14","0","0","0","0","0","0"
"Chattahoochee","2020-02-15","0","0","0","0","0","0"
"Chattahoochee","2020-02-16","0","0","0","0","0","0"
"Chattahoochee","2020-02-17","0","0","0","0","0","0"
"Chattahoochee","2020-02-18","0","0","0","0","0","0"
"Chattahoochee","2020-02-19","0","0","0","0","0","0"
"Chattahoochee","2020-02-20","0","0","0","0","0","0"
"Chattahoochee","2020-02-21","0","0","0","0","0","0"
"Chattahoochee","2020-02-22","0","0","0","0","0","0"
"Chattahoochee","2020-02-23","0","0","0","0","0","0"
"Chattahoochee","2020-02-24","0","0","0","0","0","0"
"Chattahoochee","2020-02-25","0","0","0","0","0","0"
"Chattahoochee","2020-02-26","0","0","0","0","0","0"
"Chattahoochee","2020-02-27","0","0","0","0","0","0"
"Chattahoochee","2020-02-28","0","0","0","0","0","0"
"Chattahoochee","2020-02-29","0","0","0","0","0","0"
"Chattahoochee","2020-03-01","0","0","0","0","0","0"
"Chattahoochee","2020-03-02","0","0","0","0","0","0"
"Chattahoochee","2020-03-03","0","0","0","0","0","0"
"Chattahoochee","2020-03-04","0","0","0","0","0","0"
"Chattahoochee","2020-03-05","0","0","0","0","0","0"
"Chattahoochee","2020-03-06","0","0","0","0","0","0"
"Chattahoochee","2020-03-07","0","0","0","0","0","0"
"Chattahoochee","2020-03-08","0","0","0","0","0","0"
"Chattahoochee","2020-03-09","0","0","0","0","0","0"
"Chattahoochee","2020-03-10","0","0","0","0","0","0"
"Chattahoochee","2020-03-11","1","1","0","0","0","0"
"Chattahoochee","2020-03-12","0","1","0","0","0","0"
"Chattahoochee","2020-03-13","2","3","0","0","0","0"
"Chattahoochee","2020-03-14","0","3","0","0","0","0"
"Chattahoochee","2020-03-15","0","3","0","0","0","0"
"Chattahoochee","2020-03-16","2","5","0","0","0","0"
"Chattahoochee","2020-03-17","0","5","0","0","0","0"
"Chattahoochee","2020-03-18","2","7","1","1","7.1","3.6"
"Chattahoochee","2020-03-19","1","8","0","1","7.1","3.6"
"Chattahoochee","2020-03-20","1","9","0","1","7.1","3.6"
"Chattahoochee","2020-03-21","3","12","0","1","7.1","3.6"
"Chattahoochee","2020-03-22","1","13","0","1","7.1","3.6"
"Chattahoochee","2020-03-23","1","14","0","1","7.1","3.6"
"Chattahoochee","2020-03-24","2","16","0","1","7.1","3.6"
"Chattahoochee","2020-03-25","0","16","0","1","0","3.6"
"Chattahoochee","2020-03-26","3","19","0","1","0","3.6"
"Chattahoochee","2020-03-27","1","20","0","1","0","3.6"
"Chattahoochee","2020-03-28","2","22","1","2","7.1","7.1"
"Chattahoochee","2020-03-29","1","23","0","2","7.1","7.1"
"Chattahoochee","2020-03-30","3","26","0","2","7.1","7.1"
"Chattahoochee","2020-03-31","3","29","2","4","16.7","11.9"
"Chattahoochee","2020-04-01","4","33","0","4","16.7","8.3"
"Chattahoochee","2020-04-02","0","33","0","4","16.7","8.3"
"Chattahoochee","2020-04-03","13","46","0","4","16.7","8.3"
"Chattahoochee","2020-04-04","2","48","1","5","16.7","11.9"
"Chattahoochee","2020-04-05","0","48","0","5","16.7","11.9"
"Chattahoochee","2020-04-06","2","50","0","5","16.7","11.9"
"Chattahoochee","2020-04-07","5","55","0","5","7.1","11.9"
"Chattahoochee","2020-04-08","0","55","0","5","7.1","11.9"
"Chattahoochee","2020-04-09","2","57","1","6","14.3","15.5"
"Chattahoochee","2020-04-10","2","59","0","6","14.3","15.5"
"Chattahoochee","2020-04-11","0","59","0","6","7.1","11.9"
"Chattahoochee","2020-04-12","0","59","0","6","7.1","11.9"
"Chattahoochee","2020-04-13","3","62","0","6","7.1","11.9"
"Chattahoochee","2020-04-14","2","64","0","6","7.1","7.1"
"Chattahoochee","2020-04-15","0","64","0","6","7.1","7.1"
"Chattahoochee","2020-04-16","2","66","1","7","7.1","10.7"
"Chattahoochee","2020-04-17","2","68","1","8","14.3","14.3"
"Chattahoochee","2020-04-18","0","68","0","8","14.3","10.7"
"Chattahoochee","2020-04-19","0","68","0","8","14.3","10.7"
"Chattahoochee","2020-04-20","0","68","0","8","14.3","10.7"
"Chattahoochee","2020-04-21","3","71","2","10","23.8","15.5"
"Chattahoochee","2020-04-22","0","71","0","10","23.8","15.5"
"Chattahoochee","2020-04-23","0","71","0","10","16.7","11.9"
"Chattahoochee","2020-04-24","1","72","0","10","9.5","11.9"
"Chattahoochee","2020-04-25","3","75","0","10","9.5","11.9"
"Chattahoochee","2020-04-26","1","76","0","10","9.5","11.9"
"Chattahoochee","2020-04-27","0","76","0","10","9.5","11.9"
"Chattahoochee","2020-04-28","5","81","1","11","2.9","13.3"
"Chattahoochee","2020-04-29","1","82","0","11","2.9","13.3"
"Chattahoochee","2020-04-30","2","84","0","11","2.9","9.8"
"Chattahoochee","2020-05-01","4","88","1","12","6.4","8"
"Chattahoochee","2020-05-02","1","89","0","12","6.4","8"
"Chattahoochee","2020-05-03","3","92","0","12","6.4","8"
"Chattahoochee","2020-05-04","0","92","0","12","6.4","8"
"Chattahoochee","2020-05-05","5","97","0","12","3.6","3.2"
"Chattahoochee","2020-05-06","3","100","0","12","3.6","3.2"
"Chattahoochee","2020-05-07","2","102","0","12","3.6","3.2"
"Chattahoochee","2020-05-08","1","103","0","12","0","3.2"
"Chattahoochee","2020-05-09","0","103","0","12","0","3.2"
"Chattahoochee","2020-05-10","2","105","0","12","0","3.2"
"Chattahoochee","2020-05-11","4","109","0","12","0","3.2"
"Chattahoochee","2020-05-12","5","114","1","13","2.9","3.2"
"Chattahoochee","2020-05-13","6","120","3","16","10","6.8"
"Chattahoochee","2020-05-14","2","122","1","17","17.1","10.4"
"Chattahoochee","2020-05-15","4","126","0","17","17.1","8.6"
"Chattahoochee","2020-05-16","1","127","0","17","17.1","8.6"
"Chattahoochee","2020-05-17","2","129","0","17","17.1","8.6"
"Chattahoochee","2020-05-18","4","133","1","18","20.7","10.4"
"Chattahoochee","2020-05-19","8","141","0","18","17.9","10.4"
"Chattahoochee","2020-05-20","4","145","0","18","10.7","10.4"
"Chattahoochee","2020-05-21","10","155","0","18","3.6","10.4"
"Chattahoochee","2020-05-22","0","155","0","18","3.6","10.4"
"Chattahoochee","2020-05-23","1","156","0","18","3.6","10.4"
"Chattahoochee","2020-05-24","1","157","1","19","17.9","17.5"
"Chattahoochee","2020-05-25","1","158","1","20","28.6","24.6"
"Chattahoochee","2020-05-26","7","165","3","23","34.7","26.3"
"Chattahoochee","2020-05-27","3","168","0","23","34.7","22.7"
"Chattahoochee","2020-05-28","2","170","0","23","34.7","19.1"
"Chattahoochee","2020-05-29","6","176","1","24","37.1","20.3"
"Chattahoochee","2020-05-30","1","177","0","24","37.1","20.3"
"Chattahoochee","2020-05-31","1","178","0","24","22.8","20.3"
"Chattahoochee","2020-06-01","6","184","0","24","8.5","18.5"
"Chattahoochee","2020-06-02","2","186","0","24","2.4","18.5"
"Chattahoochee","2020-06-03","7","193","0","24","2.4","18.5"
"Chattahoochee","2020-06-04","8","201","0","24","2.4","18.5"
"Chattahoochee","2020-06-05","9","210","2","26","3.2","20.1"
"Chattahoochee","2020-06-06","4","214","0","26","3.2","20.1"
"Chattahoochee","2020-06-07","1","215","0","26","3.2","13"
"Chattahoochee","2020-06-08","4","219","0","26","3.2","5.8"
"Chattahoochee","2020-06-09","4","223","0","26","3.2","2.8"
"Chattahoochee","2020-06-10","3","226","0","26","3.2","2.8"
"Chattahoochee","2020-06-11","5","231","0","26","3.2","2.8"
"Chattahoochee","2020-06-12","3","234","0","26","0","1.6"
"Chattahoochee","2020-06-13","4","238","0","26","0","1.6"
"Chattahoochee","2020-06-14","2","240","0","26","0","1.6"
"Chattahoochee","2020-06-15","14","254","2","28","2","2.6"
"Chattahoochee","2020-06-16","11","265","0","28","2","2.6"
"Chattahoochee","2020-06-17","8","273","1","29","3.8","3.5"
"Chattahoochee","2020-06-18","18","291","1","30","4.6","3.9"
"Chattahoochee","2020-06-19","2","293","1","31","11.8","5.9"
"Chattahoochee","2020-06-20","1","294","0","31","11.8","5.9"
"Chattahoochee","2020-06-21","0","294","0","31","11.8","5.9"
"Chattahoochee","2020-06-22","8","302","2","33","13.3","7.7"
"Chattahoochee","2020-06-23","5","307","2","35","19","10.5"
"Chattahoochee","2020-06-24","14","321","0","35","17.2","10.5"
"Chattahoochee","2020-06-25","15","336","2","37","18.3","11.5"
"Chattahoochee","2020-06-26","22","358","1","38","11.8","11.8"
"Chattahoochee","2020-06-27","15","373","1","39","12.8","12.3"
"Chattahoochee","2020-06-28","15","388","4","43","16.6","14.2"
"Chattahoochee","2020-06-29","15","403","5","48","17.8","15.5"
"Chattahoochee","2020-06-30","17","420","3","51","14.6","16.8"
"Chattahoochee","2020-07-01","8","428","0","51","14.6","15.9"
"Chattahoochee","2020-07-02","16","444","5","56","17.2","17.7"
"Chattahoochee","2020-07-03","19","463","7","63","21.8","16.8"
"Chattahoochee","2020-07-04","7","470","2","65","24.9","18.8"
"Chattahoochee","2020-07-05","8","478","3","68","26.4","21.5"
"Chattahoochee","2020-07-06","330","808","6","74","21.9","19.9"
"Chattahoochee","2020-07-07","546","1354","8","82","19.6","17.1"
"Chattahoochee","2020-07-08","88","1442","7","89","20.8","17.7"
"Chattahoochee","2020-07-09","350","1792","16","105","17","17.1"
"Chattahoochee","2020-07-10","559","2351","11","116","12","16.9"
"Chattahoochee","2020-07-11","24","2375","1","117","8.5","16.7"
"Chattahoochee","2020-07-12","1","2376","0","117","3.1","14.8"
"Chattahoochee","2020-07-13","321","2697","7","124","3.2","12.6"
"Chattahoochee","2020-07-14","436","3133","7","131","3.2","11.4"
"Chattahoochee","2020-07-15","234","3367","11","142","2.7","11.8"
"Chattahoochee","2020-07-16","502","3869","6","148","2.3","9.6"
"Chattahoochee","2020-07-17","69","3938","9","157","3.8","7.9"
"Chattahoochee","2020-07-18","7","3945","1","158","5.3","6.9"
"Chattahoochee","2020-07-19","2","3947","0","158","5.3","4.2"
"Chattahoochee","2020-07-20","17","3964","3","161","7.5","5.3"
"Chattahoochee","2020-07-21","17","3981","2","163","8.9","6.1"
"Chattahoochee","2020-07-22","4","3985","0","163","8.3","5.5"
"Chattahoochee","2020-07-23","16","4001","1","164","9","5.6"
"Chattahoochee","2020-07-24","7","4008","0","164","7.1","5.5"
"Chattahoochee","2020-07-25","4","4012","1","165","8.7","7"
"Chattahoochee","2020-07-26","4","4016","0","165","8.7","7"
"Chattahoochee","2020-07-27","42","4058","7","172","8.5","8"
"Chattahoochee","2020-07-28","27","4085","2","174","7.9","8.4"
"Chattahoochee","2020-07-29","19","4104","1","175","8.7","8.5"
"Chattahoochee","2020-07-30","32","4136","16","191","14.9","12"
"Chattahoochee","2020-07-31","29","4165","10","201","19.8","13.5"
"Chattahoochee","2020-08-01","12","4177","5","206","22.2","15.4"
"Chattahoochee","2020-08-02","0","4177","0","206","22.2","15.4"
"Chattahoochee","2020-08-03","26","4203","7","213","23.7","16.1"
"Chattahoochee","2020-08-04","35","4238","7","220","25.5","16.7"
"Chattahoochee","2020-08-05","25","4263","8","228","29.3","19"
"Chattahoochee","2020-08-06","32","4295","5","233","24.4","19.6"
"Chattahoochee","2020-08-07","7","4302","1","234","21.5","20.7"
"Chattahoochee","2020-08-08","2","4304","1","235","22.7","22.5"
"Chattahoochee","2020-08-09","4","4308","0","235","22.7","22.5"
"Chattahoochee","2020-08-10","45","4353","4","239","20.1","21.9"
"Chattahoochee","2020-08-11","39","4392","1","240","17.6","21.5"
"Chattahoochee","2020-08-12","26","4418","5","245","15.8","22.5"
"Chattahoochee","2020-08-13","16","4434","2","247","15.4","19.9"
"Chattahoochee","2020-08-14","30","4464","1","248","13.8","17.6"
"Chattahoochee","2020-08-15","2","4466","0","248","6.6","14.7"
"Chattahoochee","2020-08-16","3","4469","0","248","6.6","14.7"
"Chattahoochee","2020-08-17","36","4505","0","248","5.4","12.7"
"Chattahoochee","2020-08-18","16","4521","1","249","5.9","11.8"
"Chattahoochee","2020-08-19","13","4534","2","251","5.4","10.6"
"Chattahoochee","2020-08-20","11","4545","1","252","4.9","10.1"
"Chattahoochee","2020-08-21","14","4559","0","252","4.4","9.1"
"Chattahoochee","2020-08-22","4","4563","1","253","8","7.3"
"Chattahoochee","2020-08-23","0","4563","0","253","8","7.3"
"Chattahoochee","2020-08-24","14","4577","1","254","9","7.2"
"Chattahoochee","2020-08-25","19","4596","2","256","9.6","7.7"
"Chattahoochee","2020-08-26","18","4614","2","258","9","7.2"
"Chattahoochee","2020-08-27","12","4626","0","258","7.7","6.3"
"Chattahoochee","2020-08-28","6","4632","0","258","7.7","6"
"Chattahoochee","2020-08-29","1","4633","0","258","4.1","6"
"Chattahoochee","2020-08-30","3","4636","0","258","4.1","6"
"Chattahoochee","2020-08-31","14","4650","2","260","5.1","7.1"
"Chattahoochee","2020-09-01","17","4667","2","262","5.3","7.5"
"Chattahoochee","2020-09-02","17","4684","3","265","6.2","7.6"
"Chattahoochee","2020-09-03","17","4701","4","269","9.6","8.6"
"Chattahoochee","2020-09-04","9","4710","0","269","9.6","8.6"
"Chattahoochee","2020-09-05","0","4710","0","269","9.6","6.9"
"Chattahoochee","2020-09-06","2","4712","0","269","9.6","6.9"
"Chattahoochee","2020-09-07","2","4714","0","269","7.6","6.3"
"Chattahoochee","2020-09-08","27","4741","1","270","6.4","5.9"
"Chattahoochee","2020-09-09","11","4752","0","270","3.9","5.1"
"Chattahoochee","2020-09-10","12","4764","0","270","0.5","5.1"
"Chattahoochee","2020-09-11","8","4772","0","270","0.5","5.1"
"Chattahoochee","2020-09-12","0","4772","0","270","0.5","5.1"
"Chattahoochee","2020-09-13","1","4773","0","270","0.5","5.1"
"Chattahoochee","2020-09-14","4","4777","0","270","0.5","4"
"Chattahoochee","2020-09-15","12","4789","1","271","1.2","3.8"
"Chattahoochee","2020-09-16","4","4793","0","271","1.2","2.5"
"Chattahoochee","2020-09-17","6","4799","0","271","1.2","0.9"
"Chattahoochee","2020-09-18","7","4806","0","271","1.2","0.9"
"Chattahoochee","2020-09-19","0","4806","0","271","1.2","0.9"
"Chattahoochee","2020-09-20","1","4807","0","271","1.2","0.9"
"Chattahoochee","2020-09-21","2","4809","0","271","1.2","0.9"
"Chattahoochee","2020-09-22","5","4814","3","274","8.6","4.9"
"Chattahoochee","2020-09-23","5","4819","1","275","11.4","6.3"
"Chattahoochee","2020-09-24","11","4830","0","275","11.4","6.3"
"Chattahoochee","2020-09-25","5","4835","0","275","11.4","6.3"
"Chattahoochee","2020-09-26","1","4836","0","275","11.4","6.3"
"Chattahoochee","2020-09-27","1","4837","0","275","11.4","6.3"
"Chattahoochee","2020-09-28","4","4841","0","275","11.4","6.3"
"Chattahoochee","2020-09-29","16","4857","2","277","4.6","6.6"
"Chattahoochee","2020-09-30","2","4859","0","277","1.8","6.6"
"Chattahoochee","2020-10-01","7","4866","0","277","1.8","6.6"
"Chattahoochee","2020-10-02","5","4871","0","277","1.8","6.6"
"Chattahoochee","2020-10-03","3","4874","0","277","1.8","6.6"
"Chattahoochee","2020-10-04","1","4875","0","277","1.8","6.6"
"Chattahoochee","2020-10-05","5","4880","0","277","1.8","6.6"
"Chattahoochee","2020-10-06","13","4893","0","277","0","2.3"
"Chattahoochee","2020-10-07","4","4897","0","277","0","0.9"
"Chattahoochee","2020-10-08","8","4905","0","277","0","0.9"
"Chattahoochee","2020-10-09","6","4911","0","277","0","0.9"
"Chattahoochee","2020-10-10","2","4913","1","278","7.1","4.5"
"Chattahoochee","2020-10-11","2","4915","1","279","14.3","8"
"Chattahoochee","2020-10-12","3","4918","0","279","14.3","8"
"Chattahoochee","2020-10-13","5","4923","0","279","14.3","7.1"
"Chattahoochee","2020-10-14","6","4929","0","279","14.3","7.1"
"Chattahoochee","2020-10-15","8","4937","0","279","14.3","7.1"
"Chattahoochee","2020-10-16","4","4941","0","279","14.3","7.1"
"Chattahoochee","2020-10-17","2","4943","0","279","7.1","7.1"
"Chattahoochee","2020-10-18","2","4945","0","279","0","7.1"
"Chattahoochee","2020-10-19","3","4948","0","279","0","7.1"
"Chattahoochee","2020-10-20","11","4959","0","279","0","7.1"
"Chattahoochee","2020-10-21","3","4962","0","279","0","7.1"
"Chattahoochee","2020-10-22","6","4968","0","279","0","7.1"
"Chattahoochee","2020-10-23","4","4972","0","279","0","7.1"
"Chattahoochee","2020-10-24","2","4974","0","279","0","3.6"
"Chattahoochee","2020-10-25","1","4975","0","279","0","0"
"Chattahoochee","2020-10-26","14","4989","0","279","0","0"
"Chattahoochee","2020-10-27","6","4995","1","280","2.4","1.2"
"Chattahoochee","2020-10-28","1","4996","0","280","2.4","1.2"
"Chattahoochee","2020-10-29","13","5009","0","280","2.4","1.2"
"Chattahoochee","2020-10-30","7","5016","0","280","2.4","1.2"
"Chattahoochee","2020-10-31","4","5020","0","280","2.4","1.2"
"Chattahoochee","2020-11-01","0","5020","0","280","2.4","1.2"
"Chattahoochee","2020-11-02","6","5026","2","282","7.1","3.6"
"Chattahoochee","2020-11-03","3","5029","0","282","4.8","3.6"
"Chattahoochee","2020-11-04","7","5036","0","282","4.8","3.6"
"Chattahoochee","2020-11-05","16","5052","0","282","4.8","3.6"
"Chattahoochee","2020-11-06","2","5054","0","282","4.8","3.6"
"Chattahoochee","2020-11-07","4","5058","0","282","4.8","3.6"
"Chattahoochee","2020-11-08","3","5061","0","282","4.8","3.6"
"Chattahoochee","2020-11-09","2","5063","0","282","0","3.6"
"Chattahoochee","2020-11-10","5","5068","0","282","0","2.4"
"Chattahoochee","2020-11-11","6","5074","1","283","2.4","3.6"
"Chattahoochee","2020-11-12","5","5079","0","283","2.4","3.6"
"Chattahoochee","2020-11-13","9","5088","0","283","2.4","3.6"
"Chattahoochee","2020-11-14","2","5090","0","283","2.4","3.6"
"Chattahoochee","2020-11-15","1","5091","0","283","2.4","3.6"
"Chattahoochee","2020-11-16","4","5095","0","283","2.4","1.2"
"Chattahoochee","2020-11-17","13","5108","0","283","2.4","1.2"
"Chattahoochee","2020-11-18","6","5114","0","283","0","1.2"
"Chattahoochee","2020-11-19","15","5129","1","284","1","1.7"
"Chattahoochee","2020-11-20","6","5135","0","284","1","1.7"
"Chattahoochee","2020-11-21","8","5143","0","284","1","1.7"
"Chattahoochee","2020-11-22","3","5146","0","284","1","1.7"
"Chattahoochee","2020-11-23","2","5148","0","284","1","1.7"
"Chattahoochee","2020-11-24","6","5154","0","284","1","1.7"
"Chattahoochee","2020-11-25","3","5157","0","284","1","0.5"
"Chattahoochee","2020-11-26","1","5158","0","284","0","0.5"
"Chattahoochee","2020-11-27","2","5160","0","284","0","0.5"
"Chattahoochee","2020-11-28","2","5162","0","284","0","0.5"
"Chattahoochee","2020-11-29","3","5165","0","284","0","0.5"
"Chattahoochee","2020-11-30","8","5173","2","286","3.6","2.3"
"Chattahoochee","2020-12-01","4","5177","0","286","3.6","2.3"
"Chattahoochee","2020-12-02","9","5186","1","287","5.2","3.1"
"Chattahoochee","2020-12-03","6","5192","0","287","5.2","2.6"
"Chattahoochee","2020-12-04","8","5200","0","287","5.2","2.6"
"Chattahoochee","2020-12-05","8","5208","0","287","5.2","2.6"
"Chattahoochee","2020-12-06","1","5209","0","287","5.2","2.6"
"Chattahoochee","2020-12-07","8","5217","0","287","1.6","2.6"
"Chattahoochee","2020-12-08","5","5222","0","287","1.6","2.6"
"Chattahoochee","2020-12-09","8","5230","0","287","0","2.6"
"Chattahoochee","2020-12-10","10","5240","2","289","2.9","4"
"Chattahoochee","2020-12-11","9","5249","3","292","7.6","6.4"
"Chattahoochee","2020-12-12","2","5251","0","292","7.6","6.4"
"Chattahoochee","2020-12-13","5","5256","1","293","10.5","7.8"
"Chattahoochee","2020-12-14","15","5271","1","294","11.4","6.5"
"Chattahoochee","2020-12-15","22","5293","2","296","12.7","7.2"
"Chattahoochee","2020-12-16","7","5300","0","296","12.7","6.4"
"Chattahoochee","2020-12-17","9","5309","0","296","9.9","6.4"
"Chattahoochee","2020-12-18","14","5323","0","296","5.1","6.4"
"Chattahoochee","2020-12-19","7","5330","0","296","5.1","6.4"
"Chattahoochee","2020-12-20","6","5336","2","298","7","8.7"
"Chattahoochee","2020-12-21","18","5354","1","299","6.9","9.1"
"Chattahoochee","2020-12-22","4","5358","0","299","5.6","9.1"
"Chattahoochee","2020-12-23","6","5364","0","299","5.6","9.1"
"Chattahoochee","2020-12-24","14","5378","2","301","7.6","8.7"
"Chattahoochee","2020-12-25","2","5380","0","301","7.6","6.4"
"Chattahoochee","2020-12-26","3","5383","0","301","7.6","6.4"
"Chattahoochee","2020-12-27","3","5386","0","301","2.8","4.9"
"Chattahoochee","2020-12-28","5","5391","1","302","4.9","5.9"
"Chattahoochee","2020-12-29","3","5394","2","304","14.4","10"
"Chattahoochee","2020-12-30","13","5407","3","307","17.7","11.6"
"Chattahoochee","2020-12-31","4","5411","1","308","19.2","13.4"
"Chattahoochee","2021-01-01","3","5414","2","310","28.8","18.2"
"Chattahoochee","2021-01-02","3","5417","0","310","28.8","18.2"
"Chattahoochee","2021-01-03","2","5419","1","311","35.9","19.4"
"Chattahoochee","2021-01-04","9","5428","1","312","34.6","19.8"
"Chattahoochee","2021-01-05","31","5459","9","321","29.3","21.8"
"Chattahoochee","2021-01-06","6","5465","1","322","28.4","23"
"Chattahoochee","2021-01-07","5","5470","1","323","27.6","23.4"
"Chattahoochee","2021-01-08","13","5483","3","326","21.4","25.1"
"Chattahoochee","2021-01-09","4","5487","0","326","21.4","25.1"
"Chattahoochee","2021-01-10","1","5488","1","327","28.6","32.2"
"Chattahoochee","2021-01-11","4","5492","2","329","34.1","34.4"
"Chattahoochee","2021-01-12","21","5513","1","330","30.6","30"
"Chattahoochee","2021-01-13","7","5520","1","331","30.3","29.3"
"Chattahoochee","2021-01-14","6","5526","0","331","27.4","27.5"
"Chattahoochee","2021-01-15","6","5532","0","331","24.1","22.8"
"Chattahoochee","2021-01-16","11","5543","1","332","25.4","23.4"
"Chattahoochee","2021-01-17","3","5546","1","333","15.9","22.2"
"Chattahoochee","2021-01-18","6","5552","1","334","11.2","22.6"
"Chattahoochee","2021-01-19","26","5578","2","336","11.6","21.1"
"Chattahoochee","2021-01-20","5","5583","0","336","9.5","19.9"
"Chattahoochee","2021-01-21","9","5592","1","337","11.1","19.3"
"Chattahoochee","2021-01-22","9","5601","1","338","12.7","18.4"
"Chattahoochee","2021-01-23","2","5603","0","338","11.4","18.4"
"Chattahoochee","2021-01-24","0","5603","0","338","6.7","11.3"
"Chattahoochee","2021-01-25","4","5607","0","338","4.3","7.7"
"Chattahoochee","2021-01-26","0","5607","0","338","3.2","7.4"
"Chattahoochee","2021-01-27","0","5607","0","338","3.2","6.4"
"Chattooga","2020-02-01","0","0","0","0",".","."
"Chattooga","2020-02-02","0","0","0","0",".","."
"Chattooga","2020-02-03","0","0","0","0",".","."
"Chattooga","2020-02-04","0","0","0","0",".","."
"Chattooga","2020-02-05","0","0","0","0",".","."
"Chattooga","2020-02-06","0","0","0","0",".","."
"Chattooga","2020-02-07","0","0","0","0","0","."
"Chattooga","2020-02-08","0","0","0","0","0","."
"Chattooga","2020-02-09","0","0","0","0","0","."
"Chattooga","2020-02-10","0","0","0","0","0","."
"Chattooga","2020-02-11","0","0","0","0","0","."
"Chattooga","2020-02-12","0","0","0","0","0","."
"Chattooga","2020-02-13","0","0","0","0","0","."
"Chattooga","2020-02-14","0","0","0","0","0","0"
"Chattooga","2020-02-15","0","0","0","0","0","0"
"Chattooga","2020-02-16","0","0","0","0","0","0"
"Chattooga","2020-02-17","0","0","0","0","0","0"
"Chattooga","2020-02-18","0","0","0","0","0","0"
"Chattooga","2020-02-19","0","0","0","0","0","0"
"Chattooga","2020-02-20","0","0","0","0","0","0"
"Chattooga","2020-02-21","0","0","0","0","0","0"
"Chattooga","2020-02-22","0","0","0","0","0","0"
"Chattooga","2020-02-23","0","0","0","0","0","0"
"Chattooga","2020-02-24","0","0","0","0","0","0"
"Chattooga","2020-02-25","0","0","0","0","0","0"
"Chattooga","2020-02-26","0","0","0","0","0","0"
"Chattooga","2020-02-27","0","0","0","0","0","0"
"Chattooga","2020-02-28","0","0","0","0","0","0"
"Chattooga","2020-02-29","0","0","0","0","0","0"
"Chattooga","2020-03-01","0","0","0","0","0","0"
"Chattooga","2020-03-02","0","0","0","0","0","0"
"Chattooga","2020-03-03","0","0","0","0","0","0"
"Chattooga","2020-03-04","0","0","0","0","0","0"
"Chattooga","2020-03-05","0","0","0","0","0","0"
"Chattooga","2020-03-06","0","0","0","0","0","0"
"Chattooga","2020-03-07","0","0","0","0","0","0"
"Chattooga","2020-03-08","0","0","0","0","0","0"
"Chattooga","2020-03-09","0","0","0","0","0","0"
"Chattooga","2020-03-10","0","0","0","0","0","0"
"Chattooga","2020-03-11","0","0","0","0","0","0"
"Chattooga","2020-03-12","3","3","0","0","0","0"
"Chattooga","2020-03-13","3","6","0","0","0","0"
"Chattooga","2020-03-14","1","7","0","0","0","0"
"Chattooga","2020-03-15","2","9","0","0","0","0"
"Chattooga","2020-03-16","8","17","0","0","0","0"
"Chattooga","2020-03-17","7","24","0","0","0","0"
"Chattooga","2020-03-18","8","32","2","2","3.6","1.8"
"Chattooga","2020-03-19","7","39","0","2","3.6","1.8"
"Chattooga","2020-03-20","5","44","0","2","3.6","1.8"
"Chattooga","2020-03-21","4","48","0","2","3.6","1.8"
"Chattooga","2020-03-22","4","52","0","2","3.6","1.8"
"Chattooga","2020-03-23","3","55","0","2","3.6","1.8"
"Chattooga","2020-03-24","8","63","0","2","3.6","1.8"
"Chattooga","2020-03-25","3","66","0","2","0","1.8"
"Chattooga","2020-03-26","5","71","0","2","0","1.8"
"Chattooga","2020-03-27","4","75","0","2","0","1.8"
"Chattooga","2020-03-28","11","86","0","2","0","1.8"
"Chattooga","2020-03-29","6","92","0","2","0","1.8"
"Chattooga","2020-03-30","6","98","0","2","0","1.8"
"Chattooga","2020-03-31","9","107","1","3","1.6","2.6"
"Chattooga","2020-04-01","2","109","0","3","1.6","0.8"
"Chattooga","2020-04-02","9","118","0","3","1.6","0.8"
"Chattooga","2020-04-03","6","124","0","3","1.6","0.8"
"Chattooga","2020-04-04","4","128","1","4","5.2","2.6"
"Chattooga","2020-04-05","2","130","0","4","5.2","2.6"
"Chattooga","2020-04-06","3","133","0","4","5.2","2.6"
"Chattooga","2020-04-07","9","142","0","4","3.6","2.6"
"Chattooga","2020-04-08","8","150","1","5","5.4","3.5"
"Chattooga","2020-04-09","6","156","0","5","5.4","3.5"
"Chattooga","2020-04-10","13","169","0","5","5.4","3.5"
"Chattooga","2020-04-11","6","175","1","6","4.2","4.7"
"Chattooga","2020-04-12","0","175","0","6","4.2","4.7"
"Chattooga","2020-04-13","3","178","0","6","4.2","4.7"
"Chattooga","2020-04-14","15","193","1","7","5.1","4.3"
"Chattooga","2020-04-15","12","205","1","8","4.5","4.9"
"Chattooga","2020-04-16","3","208","0","8","4.5","4.9"
"Chattooga","2020-04-17","10","218","0","8","4.5","4.9"
"Chattooga","2020-04-18","8","226","0","8","2.1","3.2"
"Chattooga","2020-04-19","0","226","0","8","2.1","3.2"
"Chattooga","2020-04-20","3","229","0","8","2.1","3.2"
"Chattooga","2020-04-21","11","240","0","8","1.2","3.2"
"Chattooga","2020-04-22","10","250","1","9","1.4","3"
"Chattooga","2020-04-23","9","259","0","9","1.4","3"
"Chattooga","2020-04-24","13","272","0","9","1.4","3"
"Chattooga","2020-04-25","5","277","1","10","4.3","3.2"
"Chattooga","2020-04-26","1","278","0","10","4.3","3.2"
"Chattooga","2020-04-27","5","283","0","10","4.3","3.2"
"Chattooga","2020-04-28","24","307","0","10","4.3","2.7"
"Chattooga","2020-04-29","12","319","0","10","2.9","2.1"
"Chattooga","2020-04-30","8","327","0","10","2.9","2.1"
"Chattooga","2020-05-01","17","344","0","10","2.9","2.1"
"Chattooga","2020-05-02","6","350","0","10","0","2.1"
"Chattooga","2020-05-03","3","353","0","10","0","2.1"
"Chattooga","2020-05-04","5","358","1","11","2.9","3.6"
"Chattooga","2020-05-05","17","375","0","11","2.9","3.6"
"Chattooga","2020-05-06","9","384","0","11","2.9","2.9"
"Chattooga","2020-05-07","10","394","0","11","2.9","2.9"
"Chattooga","2020-05-08","10","404","0","11","2.9","2.9"
"Chattooga","2020-05-09","8","412","0","11","2.9","1.4"
"Chattooga","2020-05-10","0","412","0","11","2.9","1.4"
"Chattooga","2020-05-11","12","424","2","13","2.4","2.6"
"Chattooga","2020-05-12","18","442","0","13","2.4","2.6"
"Chattooga","2020-05-13","15","457","1","14","3.3","3.1"
"Chattooga","2020-05-14","14","471","0","14","3.3","3.1"
"Chattooga","2020-05-15","5","476","0","14","3.3","3.1"
"Chattooga","2020-05-16","14","490","0","14","3.3","3.1"
"Chattooga","2020-05-17","0","490","0","14","3.3","3.1"
"Chattooga","2020-05-18","8","498","0","14","1","1.7"
"Chattooga","2020-05-19","14","512","0","14","1","1.7"
"Chattooga","2020-05-20","5","517","0","14","0","1.7"
"Chattooga","2020-05-21","27","544","1","15","0.5","1.9"
"Chattooga","2020-05-22","13","557","0","15","0.5","1.9"
"Chattooga","2020-05-23","4","561","0","15","0.5","1.9"
"Chattooga","2020-05-24","0","561","0","15","0.5","1.9"
"Chattooga","2020-05-25","3","564","0","15","0.5","0.7"
"Chattooga","2020-05-26","9","573","1","16","2.1","1.5"
"Chattooga","2020-05-27","10","583","0","16","2.1","1.1"
"Chattooga","2020-05-28","22","605","0","16","1.6","1.1"
"Chattooga","2020-05-29","14","619","0","16","1.6","1.1"
"Chattooga","2020-05-30","7","626","0","16","1.6","1.1"
"Chattooga","2020-05-31","4","630","0","16","1.6","1.1"
"Chattooga","2020-06-01","12","642","0","16","1.6","1.1"
"Chattooga","2020-06-02","15","657","0","16","0","1.1"
"Chattooga","2020-06-03","5","662","0","16","0","1.1"
"Chattooga","2020-06-04","16","678","2","18","1.8","1.7"
"Chattooga","2020-06-05","18","696","0","18","1.8","1.7"
"Chattooga","2020-06-06","11","707","1","19","3.1","2.3"
"Chattooga","2020-06-07","0","707","0","19","3.1","2.3"
"Chattooga","2020-06-08","11","718","0","19","3.1","2.3"
"Chattooga","2020-06-09","24","742","3","22","4.9","2.4"
"Chattooga","2020-06-10","5","747","1","23","7.7","3.9"
"Chattooga","2020-06-11","14","761","0","23","5.9","3.9"
"Chattooga","2020-06-12","10","771","0","23","5.9","3.9"
"Chattooga","2020-06-13","2","773","0","23","4.6","3.9"
"Chattooga","2020-06-14","2","775","0","23","4.6","3.9"
"Chattooga","2020-06-15","8","783","0","23","4.6","3.9"
"Chattooga","2020-06-16","21","804","0","23","2.9","3.9"
"Chattooga","2020-06-17","12","816","1","24","1.2","4.5"
"Chattooga","2020-06-18","16","832","0","24","1.2","3.6"
"Chattooga","2020-06-19","16","848","0","24","1.2","3.6"
"Chattooga","2020-06-20","31","879","0","24","1.2","2.9"
"Chattooga","2020-06-21","0","879","0","24","1.2","2.9"
"Chattooga","2020-06-22","7","886","0","24","1.2","2.9"
"Chattooga","2020-06-23","26","912","3","27","2.8","2.8"
"Chattooga","2020-06-24","26","938","3","30","3.3","2.2"
"Chattooga","2020-06-25","20","958","2","32","4.7","3"
"Chattooga","2020-06-26","9","967","0","32","4.7","3"
"Chattooga","2020-06-27","18","985","0","32","4.7","3"
"Chattooga","2020-06-28","3","988","0","32","4.7","3"
"Chattooga","2020-06-29","18","1006","0","32","4.7","3"
"Chattooga","2020-06-30","22","1028","0","32","3.1","3"
"Chattooga","2020-07-01","24","1052","0","32","1.4","2.4"
"Chattooga","2020-07-02","11","1063","0","32","0","2.4"
"Chattooga","2020-07-03","15","1078","1","33","1","2.8"
"Chattooga","2020-07-04","0","1078","0","33","1","2.8"
"Chattooga","2020-07-05","1","1079","0","33","1","2.8"
"Chattooga","2020-07-06","24","1103","2","35","2.1","3.4"
"Chattooga","2020-07-07","20","1123","1","36","2.9","3"
"Chattooga","2020-07-08","42","1165","3","39","3.9","2.7"
"Chattooga","2020-07-09","14","1179","3","42","6.9","3.5"
"Chattooga","2020-07-10","22","1201","3","45","7.9","4.4"
"Chattooga","2020-07-11","11","1212","0","45","7.9","4.4"
"Chattooga","2020-07-12","3","1215","0","45","7.9","4.4"
"Chattooga","2020-07-13","24","1239","4","49","9.1","5.6"
"Chattooga","2020-07-14","20","1259","2","51","9.8","6.3"
"Chattooga","2020-07-15","11","1270","2","53","11.4","7.6"
"Chattooga","2020-07-16","21","1291","2","55","9.7","8.3"
"Chattooga","2020-07-17","19","1310","2","57","9.3","8.6"
"Chattooga","2020-07-18","24","1334","5","62","12.2","10.1"
"Chattooga","2020-07-19","0","1334","0","62","12.2","10.1"
"Chattooga","2020-07-20","29","1363","2","64","10.9","10"
"Chattooga","2020-07-21","46","1409","15","79","14.1","12"
"Chattooga","2020-07-22","41","1450","11","90","15.3","13.4"
"Chattooga","2020-07-23","119","1569","14","104","15.6","12.7"
"Chattooga","2020-07-24","62","1631","9","113","16.2","12.7"
"Chattooga","2020-07-25","37","1668","6","119","15.5","13.9"
"Chattooga","2020-07-26","6","1674","3","122","22.7","17.5"
"Chattooga","2020-07-27","34","1708","4","126","23.4","17.1"
"Chattooga","2020-07-28","46","1754","14","140","23.1","18.6"
"Chattooga","2020-07-29","35","1789","7","147","22.1","18.7"
"Chattooga","2020-07-30","36","1825","12","159","25.2","20.4"
"Chattooga","2020-07-31","75","1900","15","174","26","21.1"
"Chattooga","2020-08-01","24","1924","5","179","26.6","21.1"
"Chattooga","2020-08-02","5","1929","0","179","19.5","21.1"
"Chattooga","2020-08-03","17","1946","3","182","20.3","21.9"
"Chattooga","2020-08-04","89","2035","17","199","18.7","20.9"
"Chattooga","2020-08-05","62","2097","21","220","20.7","21.4"
"Chattooga","2020-08-06","47","2144","9","229","18.7","21.9"
"Chattooga","2020-08-07","50","2194","5","234","17.2","21.6"
"Chattooga","2020-08-08","10","2204","1","235","15.7","21.2"
"Chattooga","2020-08-09","7","2211","0","235","15.7","17.6"
"Chattooga","2020-08-10","29","2240","3","238","14.6","17.5"
"Chattooga","2020-08-11","88","2328","19","257","15","16.8"
"Chattooga","2020-08-12","53","2381","9","266","12.6","16.6"
"Chattooga","2020-08-13","32","2413","6","272","12.5","15.6"
"Chattooga","2020-08-14","53","2466","3","275","11.9","14.6"
"Chattooga","2020-08-15","39","2505","7","282","13","14.4"
"Chattooga","2020-08-16","12","2517","1","283","14.2","15"
"Chattooga","2020-08-17","24","2541","5","288","15.7","15.2"
"Chattooga","2020-08-18","53","2594","5","293","14","14.5"
"Chattooga","2020-08-19","35","2629","10","303","15.6","14.1"
"Chattooga","2020-08-20","26","2655","3","306","14.6","13.6"
"Chattooga","2020-08-21","54","2709","5","311","15.1","13.5"
"Chattooga","2020-08-22","83","2792","19","330","15.8","14.4"
"Chattooga","2020-08-23","36","2828","23","353","23.8","19"
"Chattooga","2020-08-24","28","2856","4","357","22.8","19.3"
"Chattooga","2020-08-25","66","2922","8","365","23.2","18.6"
"Chattooga","2020-08-26","112","3034","25","390","22.3","19"
"Chattooga","2020-08-27","68","3102","2","392","21.1","17.9"
"Chattooga","2020-08-28","29","3131","4","396","21.7","18.4"
"Chattooga","2020-08-29","15","3146","0","396","18.5","17.2"
"Chattooga","2020-08-30","42","3188","24","420","17.5","20.6"
"Chattooga","2020-08-31","16","3204","1","421","16.4","19.6"
"Chattooga","2020-09-01","139","3343","11","432","15.8","19.5"
"Chattooga","2020-09-02","41","3384","2","434","13.3","17.8"
"Chattooga","2020-09-03","74","3458","8","442","14.4","17.7"
"Chattooga","2020-09-04","36","3494","1","443","12.8","17.3"
"Chattooga","2020-09-05","31","3525","0","443","12.8","15.7"
"Chattooga","2020-09-06","36","3561","5","448","6.6","12.1"
"Chattooga","2020-09-07","3","3564","1","449","10.5","13.4"
"Chattooga","2020-09-08","61","3625","1","450","9.6","12.7"
"Chattooga","2020-09-09","78","3703","5","455","9.8","11.6"
"Chattooga","2020-09-10","27","3730","0","455","8.3","11.3"
"Chattooga","2020-09-11","50","3780","5","460","9.3","11.1"
"Chattooga","2020-09-12","25","3805","1","461","9.9","11.4"
"Chattooga","2020-09-13","3","3808","0","461","7.9","7.3"
"Chattooga","2020-09-14","10","3818","1","462","4.6","7.5"
"Chattooga","2020-09-15","116","3934","4","466","4.8","7.2"
"Chattooga","2020-09-16","12","3946","3","469","7.5","8.7"
"Chattooga","2020-09-17","11","3957","1","470","8.8","8.5"
"Chattooga","2020-09-18","59","4016","7","477","9.1","9.2"
"Chattooga","2020-09-19","13","4029","0","477","8.5","9.2"
"Chattooga","2020-09-20","3","4032","1","478","13.2","10.6"
"Chattooga","2020-09-21","10","4042","1","479","13.2","8.9"
"Chattooga","2020-09-22","72","4114","10","489","14.7","9.8"
"Chattooga","2020-09-23","26","4140","4","493","13.4","10.4"
"Chattooga","2020-09-24","16","4156","2","495","13.9","11.3"
"Chattooga","2020-09-25","19","4175","3","498","14.4","11.7"
"Chattooga","2020-09-26","33","4208","7","505","17.4","13"
"Chattooga","2020-09-27","4","4212","0","505","12.7","13"
"Chattooga","2020-09-28","8","4220","1","506","13","13.1"
"Chattooga","2020-09-29","67","4287","4","510","11.9","13.3"
"Chattooga","2020-09-30","16","4303","3","513","12.4","12.9"
"Chattooga","2020-10-01","18","4321","1","514","11.4","12.6"
"Chattooga","2020-10-02","38","4359","5","519","11","12.7"
"Chattooga","2020-10-03","4","4363","0","519","8","12.7"
"Chattooga","2020-10-04","4","4367","0","519","8","10.3"
"Chattooga","2020-10-05","13","4380","2","521","8.4","10.7"
"Chattooga","2020-10-06","114","4494","9","530","8.7","10.3"
"Chattooga","2020-10-07","52","4546","3","533","6.8","9.6"
"Chattooga","2020-10-08","28","4574","2","535","7","9.2"
"Chattooga","2020-10-09","32","4606","5","540","7.4","9.2"
"Chattooga","2020-10-10","33","4639","0","540","7.4","7.7"
"Chattooga","2020-10-11","0","4639","0","540","7.4","7.7"
"Chattooga","2020-10-12","18","4657","3","543","7.6","8"
"Chattooga","2020-10-13","92","4749","14","557","8.6","8.7"
"Chattooga","2020-10-14","31","4780","1","558","8.3","7.5"
"Chattooga","2020-10-15","32","4812","2","560","8.1","7.6"
"Chattooga","2020-10-16","29","4841","2","562","6.9","7.1"
"Chattooga","2020-10-17","45","4886","6","568","8.8","8.1"
"Chattooga","2020-10-18","9","4895","3","571","13.6","10.5"
"Chattooga","2020-10-19","16","4911","1","572","12.1","9.8"
"Chattooga","2020-10-20","103","5014","11","583","11.4","10"
"Chattooga","2020-10-21","53","5067","3","586","11.8","10"
"Chattooga","2020-10-22","53","5120","11","597","13.8","11"
"Chattooga","2020-10-23","38","5158","6","603","15.1","11"
"Chattooga","2020-10-24","30","5188","7","610","16.5","12.7"
"Chattooga","2020-10-25","8","5196","1","611","13.6","13.6"
"Chattooga","2020-10-26","18","5214","4","615","15.8","14"
"Chattooga","2020-10-27","118","5332","20","635","16.7","14.1"
"Chattooga","2020-10-28","39","5371","5","640","17.8","14.8"
"Chattooga","2020-10-29","27","5398","1","641","15.3","14.6"
"Chattooga","2020-10-30","29","5427","6","647","16","15.6"
"Chattooga","2020-10-31","41","5468","13","660","17.2","16.9"
"Chattooga","2020-11-01","7","5475","2","662","19.5","16.5"
"Chattooga","2020-11-02","26","5501","1","663","16.9","16.4"
"Chattooga","2020-11-03","96","5597","10","673","16","16.4"
"Chattooga","2020-11-04","27","5624","1","674","14.7","16.2"
"Chattooga","2020-11-05","39","5663","3","677","15.2","15.3"
"Chattooga","2020-11-06","41","5704","6","683","14.4","15.2"
"Chattooga","2020-11-07","29","5733","5","688","12.3","14.8"
"Chattooga","2020-11-08","4","5737","1","689","11.8","15.7"
"Chattooga","2020-11-09","28","5765","3","692","12.8","14.8"
"Chattooga","2020-11-10","121","5886","7","699","12.1","14"
"Chattooga","2020-11-11","42","5928","5","704","13.3","14"
"Chattooga","2020-11-12","50","5978","3","707","13","14.1"
"Chattooga","2020-11-13","34","6012","4","711","12.6","13.5"
"Chattooga","2020-11-14","24","6036","1","712","10.8","11.5"
"Chattooga","2020-11-15","9","6045","0","712","7.2","9.5"
"Chattooga","2020-11-16","20","6065","6","718","9.9","11.4"
"Chattooga","2020-11-17","76","6141","5","723","10.1","11.1"
"Chattooga","2020-11-18","29","6170","2","725","9.3","11.3"
"Chattooga","2020-11-19","30","6200","1","726","9","11"
"Chattooga","2020-11-20","41","6241","4","730","8.7","10.7"
"Chattooga","2020-11-21","39","6280","6","736","10.3","10.5"
"Chattooga","2020-11-22","9","6289","2","738","13.5","10.3"
"Chattooga","2020-11-23","28","6317","1","739","9.7","9.8"
"Chattooga","2020-11-24","88","6405","13","752","10.8","10.5"
"Chattooga","2020-11-25","64","6469","13","765","12.8","11.1"
"Chattooga","2020-11-26","13","6482","3","768","15.6","12.3"
"Chattooga","2020-11-27","27","6509","3","771","15.8","12.2"
"Chattooga","2020-11-28","45","6554","12","783","17.4","13.8"
"Chattooga","2020-11-29","12","6566","7","790","22.5","18"
"Chattooga","2020-11-30","31","6597","4","794","23.9","16.8"
"Chattooga","2020-12-01","78","6675","13","807","24.2","17.5"
"Chattooga","2020-12-02","41","6716","8","815","24","18.4"
"Chattooga","2020-12-03","64","6780","9","824","22.8","19.2"
"Chattooga","2020-12-04","61","6841","9","833","23.3","19.5"
"Chattooga","2020-12-05","25","6866","9","842","24.6","21"
"Chattooga","2020-12-06","15","6881","6","848","22","22.3"
"Chattooga","2020-12-07","59","6940","13","861","23.3","23.6"
"Chattooga","2020-12-08","70","7010","16","877","24.2","24.2"
"Chattooga","2020-12-09","51","7061","11","888","24.5","24.3"
"Chattooga","2020-12-10","54","7115","13","901","25.9","24.3"
"Chattooga","2020-12-11","63","7178","13","914","26.7","25"
"Chattooga","2020-12-12","62","7240","7","921","23.2","23.9"
"Chattooga","2020-12-13","22","7262","7","928","22","22"
"Chattooga","2020-12-14","49","7311","9","937","21.5","22.4"
"Chattooga","2020-12-15","114","7425","27","964","21.6","22.9"
"Chattooga","2020-12-16","84","7509","13","977","20.8","22.6"
"Chattooga","2020-12-17","55","7564","11","988","20.2","23"
"Chattooga","2020-12-18","49","7613","11","999","20.4","23.6"
"Chattooga","2020-12-19","49","7662","11","1010","22","22.6"
"Chattooga","2020-12-20","16","7678","4","1014","21.1","21.6"
"Chattooga","2020-12-21","28","7706","5","1019","21","21.3"
"Chattooga","2020-12-22","96","7802","26","1045","21.5","21.6"
"Chattooga","2020-12-23","57","7859","14","1059","22.8","21.8"
"Chattooga","2020-12-24","30","7889","8","1067","23.7","22"
"Chattooga","2020-12-25","8","7897","2","1069","24.1","22.3"
"Chattooga","2020-12-26","42","7939","14","1083","25.6","23.8"
"Chattooga","2020-12-27","29","7968","10","1093","27","24"
"Chattooga","2020-12-28","49","8017","7","1100","26.5","23.7"
"Chattooga","2020-12-29","178","8195","64","1164","27.8","24.6"
"Chattooga","2020-12-30","53","8248","15","1179","28.3","25.5"
"Chattooga","2020-12-31","70","8318","12","1191","26.9","25.3"
"Chattooga","2021-01-01","12","8330","2","1193","25.7","24.9"
"Chattooga","2021-01-02","9","8339","2","1195","24.2","24.9"
"Chattooga","2021-01-03","14","8353","3","1198","22.3","24.6"
"Chattooga","2021-01-04","47","8400","13","1211","24.2","25.3"
"Chattooga","2021-01-05","154","8554","54","1265","24.1","25.9"
"Chattooga","2021-01-06","85","8639","21","1286","23.6","25.9"
"Chattooga","2021-01-07","72","8711","13","1299","23.7","25.3"
"Chattooga","2021-01-08","109","8820","29","1328","25.1","25.4"
"Chattooga","2021-01-09","69","8889","14","1342","24.8","24.5"
"Chattooga","2021-01-10","18","8907","7","1349","27.3","24.8"
"Chattooga","2021-01-11","48","8955","8","1357","25.8","25"
"Chattooga","2021-01-12","109","9064","23","1380","23.8","23.9"
"Chattooga","2021-01-13","50","9114","10","1390","23.1","23.3"
"Chattooga","2021-01-14","127","9241","12","1402","21.9","22.8"
"Chattooga","2021-01-15","61","9302","12","1414","20.9","23"
"Chattooga","2021-01-16","48","9350","8","1422","20.3","22.6"
"Chattooga","2021-01-17","24","9374","2","1424","16","21.7"
"Chattooga","2021-01-18","43","9417","8","1432","16.3","21"
"Chattooga","2021-01-19","57","9474","16","1448","17.3","20.5"
"Chattooga","2021-01-20","66","9540","11","1459","16.8","19.9"
"Chattooga","2021-01-21","54","9594","6","1465","17","19.4"
"Chattooga","2021-01-22","27","9621","4","1469","16.3","18.6"
"Chattooga","2021-01-23","32","9653","4","1473","15.7","18"
"Chattooga","2021-01-24","14","9667","3","1476","17.6","16.8"
"Chattooga","2021-01-25","15","9682","1","1477","15.9","16.1"
"Chattooga","2021-01-26","4","9686","1","1478","15.5","16.4"
"Chattooga","2021-01-27","0","9686","0","1478","13.1","14.9"
"Cherokee","2020-02-01","0","0","0","0",".","."
"Cherokee","2020-02-02","0","0","0","0",".","."
"Cherokee","2020-02-03","0","0","0","0",".","."
"Cherokee","2020-02-04","0","0","0","0",".","."
"Cherokee","2020-02-05","0","0","0","0",".","."
"Cherokee","2020-02-06","0","0","0","0",".","."
"Cherokee","2020-02-07","0","0","0","0","0","."
"Cherokee","2020-02-08","0","0","0","0","0","."
"Cherokee","2020-02-09","0","0","0","0","0","."
"Cherokee","2020-02-10","0","0","0","0","0","."
"Cherokee","2020-02-11","0","0","0","0","0","."
"Cherokee","2020-02-12","0","0","0","0","0","."
"Cherokee","2020-02-13","0","0","0","0","0","."
"Cherokee","2020-02-14","0","0","0","0","0","0"
"Cherokee","2020-02-15","1","1","0","0","0","0"
"Cherokee","2020-02-16","0","1","0","0","0","0"
"Cherokee","2020-02-17","0","1","0","0","0","0"
"Cherokee","2020-02-18","1","2","1","1","14.3","7.1"
"Cherokee","2020-02-19","0","2","0","1","14.3","7.1"
"Cherokee","2020-02-20","0","2","0","1","14.3","7.1"
"Cherokee","2020-02-21","0","2","0","1","14.3","7.1"
"Cherokee","2020-02-22","0","2","0","1","14.3","7.1"
"Cherokee","2020-02-23","0","2","0","1","14.3","7.1"
"Cherokee","2020-02-24","0","2","0","1","14.3","7.1"
"Cherokee","2020-02-25","0","2","0","1","0","7.1"
"Cherokee","2020-02-26","0","2","0","1","0","7.1"
"Cherokee","2020-02-27","1","3","0","1","0","7.1"
"Cherokee","2020-02-28","0","3","0","1","0","7.1"
"Cherokee","2020-02-29","0","3","0","1","0","7.1"
"Cherokee","2020-03-01","0","3","0","1","0","7.1"
"Cherokee","2020-03-02","0","3","0","1","0","7.1"
"Cherokee","2020-03-03","0","3","0","1","0","0"
"Cherokee","2020-03-04","0","3","0","1","0","0"
"Cherokee","2020-03-05","2","5","0","1","0","0"
"Cherokee","2020-03-06","6","11","0","1","0","0"
"Cherokee","2020-03-07","1","12","0","1","0","0"
"Cherokee","2020-03-08","5","17","2","3","5.7","2.9"
"Cherokee","2020-03-09","6","23","0","3","5.7","2.9"
"Cherokee","2020-03-10","20","43","0","3","5.7","2.9"
"Cherokee","2020-03-11","13","56","1","4","6.8","3.4"
"Cherokee","2020-03-12","34","90","1","5","7.2","3.6"
"Cherokee","2020-03-13","17","107","3","8","9.8","4.9"
"Cherokee","2020-03-14","1","108","0","8","9.8","4.9"
"Cherokee","2020-03-15","0","108","0","8","4","4.9"
"Cherokee","2020-03-16","27","135","2","10","5.1","5.4"
"Cherokee","2020-03-17","42","177","2","12","5.8","5.7"
"Cherokee","2020-03-18","12","189","1","13","5.9","6.3"
"Cherokee","2020-03-19","15","204","5","18","10.2","8.7"
"Cherokee","2020-03-20","45","249","4","22","9","9.4"
"Cherokee","2020-03-21","4","253","0","22","9","9.4"
"Cherokee","2020-03-22","7","260","0","22","9","6.5"
"Cherokee","2020-03-23","53","313","9","31","10.3","7.7"
"Cherokee","2020-03-24","27","340","5","36","12.3","9"
"Cherokee","2020-03-25","59","399","5","41","12.3","9.1"
"Cherokee","2020-03-26","51","450","11","52","10.6","10.4"
"Cherokee","2020-03-27","63","513","8","60","11.2","10.1"
"Cherokee","2020-03-28","10","523","0","60","11.2","10.1"
"Cherokee","2020-03-29","19","542","2","62","12.7","10.8"
"Cherokee","2020-03-30","69","611","9","71","12.1","11.2"
"Cherokee","2020-03-31","60","671","5","76","10.7","11.5"
"Cherokee","2020-04-01","43","714","4","80","10.8","11.5"
"Cherokee","2020-04-02","29","743","4","84","9.7","10.2"
"Cherokee","2020-04-03","53","796","5","89","9.2","10.2"
"Cherokee","2020-04-04","15","811","2","91","11.1","11.1"
"Cherokee","2020-04-05","10","821","2","93","12.5","12.6"
"Cherokee","2020-04-06","70","891","10","103","12.6","12.4"
"Cherokee","2020-04-07","64","955","7","110","13","11.8"
"Cherokee","2020-04-08","53","1008","7","117","13.6","12.2"
"Cherokee","2020-04-09","44","1052","6","123","13.5","11.6"
"Cherokee","2020-04-10","50","1102","7","130","14.2","11.7"
"Cherokee","2020-04-11","29","1131","2","132","13.3","12.2"
"Cherokee","2020-04-12","9","1140","1","133","12","12.2"
"Cherokee","2020-04-13","81","1221","14","147","12.4","12.5"
"Cherokee","2020-04-14","109","1330","14","161","12.7","12.9"
"Cherokee","2020-04-15","111","1441","8","169","11.9","12.7"
"Cherokee","2020-04-16","170","1611","22","191","11.8","12.7"
"Cherokee","2020-04-17","331","1942","20","211","10.6","12.4"
"Cherokee","2020-04-18","169","2111","4","215","10","11.6"
"Cherokee","2020-04-19","137","2248","3","218","8.7","10.4"
"Cherokee","2020-04-20","198","2446","34","252","8.7","10.6"
"Cherokee","2020-04-21","209","2655","28","280","8.8","10.7"
"Cherokee","2020-04-22","148","2803","12","292","8.9","10.4"
"Cherokee","2020-04-23","102","2905","10","302","8.4","10.1"
"Cherokee","2020-04-24","272","3177","18","320","8.5","9.6"
"Cherokee","2020-04-25","112","3289","7","327","9.1","9.5"
"Cherokee","2020-04-26","71","3360","4","331","9.6","9.1"
"Cherokee","2020-04-27","187","3547","26","357","9.1","8.9"
"Cherokee","2020-04-28","215","3762","12","369","8","8.4"
"Cherokee","2020-04-29","179","3941","19","388","8.3","8.6"
"Cherokee","2020-04-30","255","4196","24","412","8.3","8.4"
"Cherokee","2020-05-01","145","4341","11","423","8.4","8.5"
"Cherokee","2020-05-02","126","4467","19","442","9.7","9.4"
"Cherokee","2020-05-03","62","4529","11","453","11.4","10.5"
"Cherokee","2020-05-04","197","4726","12","465","10.3","9.7"
"Cherokee","2020-05-05","159","4885","11","476","10.5","9.2"
"Cherokee","2020-05-06","135","5020","6","482","9.6","9"
"Cherokee","2020-05-07","122","5142","15","497","10","9.2"
"Cherokee","2020-05-08","190","5332","9","506","9.6","9"
"Cherokee","2020-05-09","65","5397","1","507","7.7","8.7"
"Cherokee","2020-05-10","38","5435","6","513","7.4","9.4"
"Cherokee","2020-05-11","349","5784","25","538","7.6","8.9"
"Cherokee","2020-05-12","314","6098","16","554","7.3","8.9"
"Cherokee","2020-05-13","255","6353","4","558","6.9","8.2"
"Cherokee","2020-05-14","331","6684","13","571","5.7","7.9"
"Cherokee","2020-05-15","367","7051","30","601","6.2","7.9"
"Cherokee","2020-05-16","88","7139","6","607","6.9","7.3"
"Cherokee","2020-05-17","78","7217","2","609","5","6.2"
"Cherokee","2020-05-18","379","7596","29","638","5.1","6.3"
"Cherokee","2020-05-19","369","7965","18","656","5.1","6.2"
"Cherokee","2020-05-20","307","8272","21","677","5.8","6.4"
"Cherokee","2020-05-21","292","8564","13","690","5.9","5.8"
"Cherokee","2020-05-22","230","8794","1","691","4.8","5.5"
"Cherokee","2020-05-23","115","8909","5","696","4.5","5.7"
"Cherokee","2020-05-24","75","8984","5","701","5","5"
"Cherokee","2020-05-25","114","9098","5","706","4.6","4.8"
"Cherokee","2020-05-26","322","9420","9","715","4.3","4.7"
"Cherokee","2020-05-27","288","9708","14","729","4","4.9"
"Cherokee","2020-05-28","193","9901","8","737","3.9","4.9"
"Cherokee","2020-05-29","199","10100","4","741","4.2","4.5"
"Cherokee","2020-05-30","84","10184","2","743","3.9","4.2"
"Cherokee","2020-05-31","70","10254","1","744","3.1","4.1"
"Cherokee","2020-06-01","277","10531","10","754","3","3.8"
"Cherokee","2020-06-02","302","10833","17","771","3.4","3.9"
"Cherokee","2020-06-03","280","11113","8","779","3.2","3.6"
"Cherokee","2020-06-04","280","11393","4","783","2.8","3.4"
"Cherokee","2020-06-05","229","11622","8","791","3","3.6"
"Cherokee","2020-06-06","128","11750","5","796","3.2","3.5"
"Cherokee","2020-06-07","84","11834","7","803","4.2","3.7"
"Cherokee","2020-06-08","276","12110","9","812","4.1","3.6"
"Cherokee","2020-06-09","236","12346","9","821","3.9","3.7"
"Cherokee","2020-06-10","252","12598","6","827","3.8","3.5"
"Cherokee","2020-06-11","280","12878","6","833","3.9","3.3"
"Cherokee","2020-06-12","245","13123","7","840","3.8","3.4"
"Cherokee","2020-06-13","114","13237","8","848","4.3","3.7"
"Cherokee","2020-06-14","104","13341","1","849","3.2","3.7"
"Cherokee","2020-06-15","333","13674","16","865","3.4","3.8"
"Cherokee","2020-06-16","339","14013","14","879","3.5","3.7"
"Cherokee","2020-06-17","279","14292","11","890","3.7","3.7"
"Cherokee","2020-06-18","347","14639","26","916","4.5","4.2"
"Cherokee","2020-06-19","367","15006","25","941","5","4.4"
"Cherokee","2020-06-20","109","15115","17","958","6.2","5.3"
"Cherokee","2020-06-21","75","15190","10","968","8","5.6"
"Cherokee","2020-06-22","482","15672","30","998","8.2","5.8"
"Cherokee","2020-06-23","447","16119","38","1036","8.8","6.2"
"Cherokee","2020-06-24","466","16585","39","1075","9.5","6.6"
"Cherokee","2020-06-25","509","17094","31","1106","9.3","6.9"
"Cherokee","2020-06-26","531","17625","47","1153","9.6","7.3"
"Cherokee","2020-06-27","186","17811","19","1172","8.8","7.5"
"Cherokee","2020-06-28","90","17901","6","1178","7.8","7.9"
"Cherokee","2020-06-29","650","18551","49","1227","8","8.1"
"Cherokee","2020-06-30","588","19139","57","1284","8.2","8.5"
"Cherokee","2020-07-01","625","19764","50","1334","8.2","8.8"
"Cherokee","2020-07-02","811","20575","62","1396","8.4","8.8"
"Cherokee","2020-07-03","199","20774","19","1415","8.5","9"
"Cherokee","2020-07-04","255","21029","29","1444","8.6","8.7"
"Cherokee","2020-07-05","117","21146","9","1453","8.8","8.3"
"Cherokee","2020-07-06","824","21970","49","1502","8.6","8.3"
"Cherokee","2020-07-07","743","22713","78","1580","8.7","8.4"
"Cherokee","2020-07-08","778","23491","80","1660","9","8.6"
"Cherokee","2020-07-09","821","24312","84","1744","9.4","8.9"
"Cherokee","2020-07-10","754","25066","72","1816","9.4","8.9"
"Cherokee","2020-07-11","198","25264","28","1844","9.8","9.2"
"Cherokee","2020-07-12","134","25398","12","1856","9.9","9.4"
"Cherokee","2020-07-13","722","26120","75","1931","10.6","9.6"
"Cherokee","2020-07-14","690","26810","72","2003","10.6","9.6"
"Cherokee","2020-07-15","669","27479","57","2060","10.3","9.7"
"Cherokee","2020-07-16","693","28172","62","2122","10.1","9.8"
"Cherokee","2020-07-17","753","28925","69","2191","10.1","9.7"
"Cherokee","2020-07-18","232","29157","27","2218","9.7","9.7"
"Cherokee","2020-07-19","139","29296","21","2239","10.6","10.3"
"Cherokee","2020-07-20","790","30086","71","2310","10.4","10.5"
"Cherokee","2020-07-21","631","30717","52","2362","10.1","10.3"
"Cherokee","2020-07-22","668","31385","57","2419","10.1","10.2"
"Cherokee","2020-07-23","782","32167","42","2461","9.6","9.9"
"Cherokee","2020-07-24","730","32897","43","2504","9.1","9.6"
"Cherokee","2020-07-25","222","33119","24","2528","9","9.4"
"Cherokee","2020-07-26","142","33261","13","2541","8.1","9.4"
"Cherokee","2020-07-27","827","34088","61","2602","7.9","9.2"
"Cherokee","2020-07-28","706","34794","42","2644","7.6","8.8"
"Cherokee","2020-07-29","759","35553","66","2710","7.6","8.8"
"Cherokee","2020-07-30","864","36417","59","2769","7.8","8.7"
"Cherokee","2020-07-31","927","37344","76","2845","8.1","8.6"
"Cherokee","2020-08-01","242","37586","13","2858","7.4","8.2"
"Cherokee","2020-08-02","201","37787","26","2884","7.9","8"
"Cherokee","2020-08-03","800","38587","75","2959","8.2","8.1"
"Cherokee","2020-08-04","835","39422","65","3024","8.5","8"
"Cherokee","2020-08-05","739","40161","92","3116","9","8.3"
"Cherokee","2020-08-06","840","41001","62","3178","9.1","8.4"
"Cherokee","2020-08-07","781","41782","76","3254","9.3","8.7"
"Cherokee","2020-08-08","212","41994","20","3274","9.9","8.6"
"Cherokee","2020-08-09","215","42209","22","3296","9.5","8.7"
"Cherokee","2020-08-10","856","43065","88","3384","9.6","8.9"
"Cherokee","2020-08-11","992","44057","99","3483","9.9","9.2"
"Cherokee","2020-08-12","886","44943","52","3535","9","9"
"Cherokee","2020-08-13","962","45905","52","3587","8.7","8.9"
"Cherokee","2020-08-14","973","46878","59","3646","8.2","8.7"
"Cherokee","2020-08-15","327","47205","39","3685","8.5","9.2"
"Cherokee","2020-08-16","182","47387","16","3701","8.3","8.9"
"Cherokee","2020-08-17","493","47880","37","3738","7.9","8.8"
"Cherokee","2020-08-18","921","48801","50","3788","7.3","8.6"
"Cherokee","2020-08-19","831","49632","49","3837","7.3","8.1"
"Cherokee","2020-08-20","823","50455","46","3883","7.3","8"
"Cherokee","2020-08-21","881","51336","68","3951","7.6","7.9"
"Cherokee","2020-08-22","372","51708","23","3974","6.7","7.6"
"Cherokee","2020-08-23","151","51859","21","3995","7.5","7.9"
"Cherokee","2020-08-24","929","52788","80","4075","7.6","7.8"
"Cherokee","2020-08-25","791","53579","60","4135","7.9","7.6"
"Cherokee","2020-08-26","670","54249","48","4183","8.1","7.7"
"Cherokee","2020-08-27","731","54980","44","4227","8.2","7.7"
"Cherokee","2020-08-28","845","55825","39","4266","7.7","7.6"
"Cherokee","2020-08-29","306","56131","22","4288","7.9","7.3"
"Cherokee","2020-08-30","173","56304","18","4306","7.4","7.4"
"Cherokee","2020-08-31","725","57029","64","4370","7.4","7.5"
"Cherokee","2020-09-01","656","57685","51","4421","7.4","7.7"
"Cherokee","2020-09-02","672","58357","35","4456","7.1","7.6"
"Cherokee","2020-09-03","779","59136","51","4507","7.2","7.7"
"Cherokee","2020-09-04","631","59767","63","4570","8","7.9"
"Cherokee","2020-09-05","158","59925","8","4578","7.7","7.8"
"Cherokee","2020-09-06","124","60049","15","4593","7.9","7.6"
"Cherokee","2020-09-07","248","60297","19","4612","7.8","7.6"
"Cherokee","2020-09-08","811","61108","60","4672","7.7","7.6"
"Cherokee","2020-09-09","628","61736","52","4724","8.1","7.6"
"Cherokee","2020-09-10","839","62575","48","4772","8","7.6"
"Cherokee","2020-09-11","673","63248","47","4819","7.6","7.8"
"Cherokee","2020-09-12","285","63533","23","4842","8","7.9"
"Cherokee","2020-09-13","142","63675","10","4852","7.3","7.6"
"Cherokee","2020-09-14","685","64360","50","4902","7.3","7.5"
"Cherokee","2020-09-15","664","65024","27","4929","6.8","7.2"
"Cherokee","2020-09-16","673","65697","33","4962","6.3","7.2"
"Cherokee","2020-09-17","566","66263","15","4977","5.9","6.9"
"Cherokee","2020-09-18","645","66908","34","5011","5.6","6.6"
"Cherokee","2020-09-19","266","67174","15","5026","5.3","6.6"
"Cherokee","2020-09-20","103","67277","16","5042","6.5","6.9"
"Cherokee","2020-09-21","484","67761","40","5082","6.6","6.9"
"Cherokee","2020-09-22","508","68269","22","5104","6.7","6.7"
"Cherokee","2020-09-23","497","68766","30","5134","6.8","6.6"
"Cherokee","2020-09-24","642","69408","29","5163","7.1","6.5"
"Cherokee","2020-09-25","464","69872","33","5196","7.3","6.5"
"Cherokee","2020-09-26","197","70069","12","5208","7.4","6.3"
"Cherokee","2020-09-27","136","70205","10","5218","6.2","6.4"
"Cherokee","2020-09-28","540","70745","41","5259","6.1","6.4"
"Cherokee","2020-09-29","622","71367","28","5287","6.2","6.4"
"Cherokee","2020-09-30","537","71904","32","5319","6.2","6.5"
"Cherokee","2020-10-01","673","72577","26","5345","6.1","6.6"
"Cherokee","2020-10-02","570","73147","26","5371","5.7","6.5"
"Cherokee","2020-10-03","274","73421","18","5389","5.8","6.6"
"Cherokee","2020-10-04","121","73542","15","5404","6.5","6.4"
"Cherokee","2020-10-05","637","74179","32","5436","6.1","6.1"
"Cherokee","2020-10-06","904","75083","37","5473","6.1","6.1"
"Cherokee","2020-10-07","702","75785","39","5512","6","6.1"
"Cherokee","2020-10-08","628","76413","44","5556","6.5","6.3"
"Cherokee","2020-10-09","591","77004","47","5603","6.9","6.3"
"Cherokee","2020-10-10","175","77179","22","5625","7.8","6.8"
"Cherokee","2020-10-11","161","77340","15","5640","7.4","6.9"
"Cherokee","2020-10-12","453","77793","16","5656","7.1","6.6"
"Cherokee","2020-10-13","819","78612","42","5698","7.3","6.7"
"Cherokee","2020-10-14","593","79205","30","5728","7.2","6.6"
"Cherokee","2020-10-15","592","79797","36","5764","7.1","6.8"
"Cherokee","2020-10-16","525","80322","27","5791","6.7","6.8"
"Cherokee","2020-10-17","253","80575","13","5804","5.6","6.7"
"Cherokee","2020-10-18","144","80719","11","5815","5.4","6.4"
"Cherokee","2020-10-19","628","81347","50","5865","6","6.6"
"Cherokee","2020-10-20","835","82182","39","5904","6","6.6"
"Cherokee","2020-10-21","704","82886","57","5961","6.4","6.8"
"Cherokee","2020-10-22","774","83660","51","6012","6.5","6.8"
"Cherokee","2020-10-23","695","84355","39","6051","6.5","6.6"
"Cherokee","2020-10-24","178","84533","19","6070","7.3","6.5"
"Cherokee","2020-10-25","227","84760","31","6101","8.2","6.8"
"Cherokee","2020-10-26","786","85546","61","6162","8.2","7.1"
"Cherokee","2020-10-27","746","86292","53","6215","8.5","7.2"
"Cherokee","2020-10-28","697","86989","44","6259","8.2","7.3"
"Cherokee","2020-10-29","512","87501","23","6282","7.9","7.2"
"Cherokee","2020-10-30","745","88246","61","6343","8.3","7.4"
"Cherokee","2020-10-31","301","88547","27","6370","8.1","7.7"
"Cherokee","2020-11-01","159","88706","24","6394","8.3","8.2"
"Cherokee","2020-11-02","749","89455","64","6458","8.4","8.3"
"Cherokee","2020-11-03","745","90200","56","6514","8.4","8.5"
"Cherokee","2020-11-04","727","90927","71","6585","8.9","8.6"
"Cherokee","2020-11-05","786","91713","53","6638","9.3","8.6"
"Cherokee","2020-11-06","695","92408","60","6698","9.3","8.8"
"Cherokee","2020-11-07","346","92754","50","6748","10.1","9.1"
"Cherokee","2020-11-08","193","92947","37","6785","10.7","9.5"
"Cherokee","2020-11-09","857","93804","88","6873","10.9","9.7"
"Cherokee","2020-11-10","1042","94846","76","6949","10.9","9.7"
"Cherokee","2020-11-11","498","95344","41","6990","10.7","9.8"
"Cherokee","2020-11-12","1258","96602","120","7110","11.1","10.2"
"Cherokee","2020-11-13","1079","97681","69","7179","10.8","10"
"Cherokee","2020-11-14","695","98376","60","7239","9.9","10"
"Cherokee","2020-11-15","200","98576","30","7269","9.3","10"
"Cherokee","2020-11-16","1088","99664","120","7389","9.4","10.2"
"Cherokee","2020-11-17","937","100601","67","7456","9.4","10.2"
"Cherokee","2020-11-18","1161","101762","81","7537","9.2","10"
"Cherokee","2020-11-19","1310","103072","96","7633","8.9","10"
"Cherokee","2020-11-20","1168","104240","90","7723","9.1","9.9"
"Cherokee","2020-11-21","656","104896","56","7779","9.1","9.5"
"Cherokee","2020-11-22","265","105161","37","7816","9","9.1"
"Cherokee","2020-11-23","1077","106238","83","7899","8.5","9"
"Cherokee","2020-11-24","1028","107266","87","7986","8.7","9"
"Cherokee","2020-11-25","866","108132","91","8077","9.2","9.2"
"Cherokee","2020-11-26","94","108226","12","8089","9.9","9.4"
"Cherokee","2020-11-27","515","108741","44","8133","10.1","9.6"
"Cherokee","2020-11-28","435","109176","59","8192","10.8","9.9"
"Cherokee","2020-11-29","224","109400","32","8224","10.8","9.9"
"Cherokee","2020-11-30","1097","110497","146","8370","11.6","10.1"
"Cherokee","2020-12-01","1159","111656","130","8500","12","10.3"
"Cherokee","2020-12-02","1012","112668","100","8600","11.9","10.6"
"Cherokee","2020-12-03","1075","113743","98","8698","11.4","10.7"
"Cherokee","2020-12-04","991","114734","97","8795","11.6","10.8"
"Cherokee","2020-12-05","555","115289","74","8869","11.6","11.2"
"Cherokee","2020-12-06","220","115509","39","8908","12.1","11.4"
"Cherokee","2020-12-07","1036","116545","141","9049","12.1","11.9"
"Cherokee","2020-12-08","1201","117746","106","9155","11.8","11.9"
"Cherokee","2020-12-09","987","118733","121","9276","12.1","12"
"Cherokee","2020-12-10","998","119731","110","9386","12.4","11.9"
"Cherokee","2020-12-11","1102","120833","111","9497","12.4","12"
"Cherokee","2020-12-12","516","121349","85","9582","12.9","12.2"
"Cherokee","2020-12-13","255","121604","40","9622","12.6","12.3"
"Cherokee","2020-12-14","1066","122670","135","9757","12.4","12.3"
"Cherokee","2020-12-15","1411","124081","211","9968","13.3","12.5"
"Cherokee","2020-12-16","1252","125333","143","10111","13.2","12.6"
"Cherokee","2020-12-17","1159","126492","142","10253","13.4","12.9"
"Cherokee","2020-12-18","1045","127537","136","10389","13.8","13.1"
"Cherokee","2020-12-19","575","128112","78","10467","13.4","13.1"
"Cherokee","2020-12-20","253","128365","63","10530","14.7","13.6"
"Cherokee","2020-12-21","1202","129567","180","10710","15","13.7"
"Cherokee","2020-12-22","1230","130797","205","10915","15.3","14.3"
"Cherokee","2020-12-23","1270","132067","192","11107","15.8","14.5"
"Cherokee","2020-12-24","494","132561","108","11215","17.2","15.3"
"Cherokee","2020-12-25","133","132694","40","11255","19.6","16.7"
"Cherokee","2020-12-26","396","133090","93","11348","21","17.2"
"Cherokee","2020-12-27","294","133384","91","11439","21.9","18.3"
"Cherokee","2020-12-28","1320","134704","249","11688","22.4","18.7"
"Cherokee","2020-12-29","1121","135825","231","11919","23","19.1"
"Cherokee","2020-12-30","1166","136991","252","12171","23.9","19.9"
"Cherokee","2020-12-31","1118","138109","220","12391","23.6","20.4"
"Cherokee","2021-01-01","200","138309","57","12448","23.4","21.5"
"Cherokee","2021-01-02","563","138872","126","12574","23.2","22.1"
"Cherokee","2021-01-03","279","139151","108","12682","24.3","23.1"
"Cherokee","2021-01-04","1178","140329","256","12938","24.7","23.6"
"Cherokee","2021-01-05","1835","142164","314","13252","24.2","23.6"
"Cherokee","2021-01-06","1327","143491","273","13525","24.1","24"
"Cherokee","2021-01-07","1421","144912","269","13794","24","23.8"
"Cherokee","2021-01-08","1153","146065","212","14006","22.5","23"
"Cherokee","2021-01-09","679","146744","131","14137","22.1","22.7"
"Cherokee","2021-01-10","330","147074","93","14230","20.6","22.5"
"Cherokee","2021-01-11","1058","148132","184","14414","20","22.4"
"Cherokee","2021-01-12","1222","149354","150","14564","19.3","21.8"
"Cherokee","2021-01-13","982","150336","193","14757","19.2","21.6"
"Cherokee","2021-01-14","1126","151462","153","14910","18.4","21.2"
"Cherokee","2021-01-15","1050","152512","178","15088","18.2","20.4"
"Cherokee","2021-01-16","372","152884","92","15180","19","20.5"
"Cherokee","2021-01-17","304","153188","71","15251","18.3","19.4"
"Cherokee","2021-01-18","794","153982","126","15377","18.1","19"
"Cherokee","2021-01-19","1162","155144","126","15503","17.9","18.6"
"Cherokee","2021-01-20","893","156037","151","15654","17.5","18.3"
"Cherokee","2021-01-21","855","156892","134","15788","17.8","18.1"
"Cherokee","2021-01-22","873","157765","114","15902","17.2","17.7"
"Cherokee","2021-01-23","340","158105","78","15980","16.9","18"
"Cherokee","2021-01-24","255","158360","43","16023","16","17.2"
"Cherokee","2021-01-25","577","158937","86","16109","15.9","17"
"Cherokee","2021-01-26","44","158981","7","16116","16.6","17.2"
"Cherokee","2021-01-27","0","158981","0","16116","14.2","15.8"
"Clarke","2020-02-01","0","0","0","0",".","."
"Clarke","2020-02-02","0","0","0","0",".","."
"Clarke","2020-02-03","0","0","0","0",".","."
"Clarke","2020-02-04","0","0","0","0",".","."
"Clarke","2020-02-05","0","0","0","0",".","."
"Clarke","2020-02-06","0","0","0","0",".","."
"Clarke","2020-02-07","0","0","0","0","0","."
"Clarke","2020-02-08","0","0","0","0","0","."
"Clarke","2020-02-09","0","0","0","0","0","."
"Clarke","2020-02-10","0","0","0","0","0","."
"Clarke","2020-02-11","0","0","0","0","0","."
"Clarke","2020-02-12","0","0","0","0","0","."
"Clarke","2020-02-13","0","0","0","0","0","."
"Clarke","2020-02-14","0","0","0","0","0","0"
"Clarke","2020-02-15","0","0","0","0","0","0"
"Clarke","2020-02-16","0","0","0","0","0","0"
"Clarke","2020-02-17","0","0","0","0","0","0"
"Clarke","2020-02-18","0","0","0","0","0","0"
"Clarke","2020-02-19","0","0","0","0","0","0"
"Clarke","2020-02-20","0","0","0","0","0","0"
"Clarke","2020-02-21","0","0","0","0","0","0"
"Clarke","2020-02-22","0","0","0","0","0","0"
"Clarke","2020-02-23","0","0","0","0","0","0"
"Clarke","2020-02-24","0","0","0","0","0","0"
"Clarke","2020-02-25","0","0","0","0","0","0"
"Clarke","2020-02-26","0","0","0","0","0","0"
"Clarke","2020-02-27","0","0","0","0","0","0"
"Clarke","2020-02-28","0","0","0","0","0","0"
"Clarke","2020-02-29","0","0","0","0","0","0"
"Clarke","2020-03-01","0","0","0","0","0","0"
"Clarke","2020-03-02","0","0","0","0","0","0"
"Clarke","2020-03-03","0","0","0","0","0","0"
"Clarke","2020-03-04","0","0","0","0","0","0"
"Clarke","2020-03-05","0","0","0","0","0","0"
"Clarke","2020-03-06","0","0","0","0","0","0"
"Clarke","2020-03-07","1","1","0","0","0","0"
"Clarke","2020-03-08","3","4","0","0","0","0"
"Clarke","2020-03-09","3","7","0","0","0","0"
"Clarke","2020-03-10","2","9","0","0","0","0"
"Clarke","2020-03-11","8","17","2","2","3.6","1.8"
"Clarke","2020-03-12","15","32","1","3","4.5","2.3"
"Clarke","2020-03-13","10","42","4","7","10.2","5.1"
"Clarke","2020-03-14","6","48","1","8","12.6","6.3"
"Clarke","2020-03-15","13","61","3","11","15.9","8"
"Clarke","2020-03-16","35","96","2","13","16.7","8.4"
"Clarke","2020-03-17","40","136","5","18","18.5","9.3"
"Clarke","2020-03-18","41","177","3","21","16","9.8"
"Clarke","2020-03-19","54","231","7","28","16.9","10.7"
"Clarke","2020-03-20","66","297","5","33","12.3","11.2"
"Clarke","2020-03-21","16","313","1","34","10.8","11.7"
"Clarke","2020-03-22","10","323","3","37","11.8","13.8"
"Clarke","2020-03-23","42","365","4","41","12.3","14.5"
"Clarke","2020-03-24","80","445","17","58","13.6","16"
"Clarke","2020-03-25","66","511","14","72","15.5","15.8"
"Clarke","2020-03-26","62","573","9","81","15.8","16.3"
"Clarke","2020-03-27","67","640","11","92","17","14.6"
"Clarke","2020-03-28","3","643","0","92","16.1","13.5"
"Clarke","2020-03-29","5","648","0","92","11.8","11.8"
"Clarke","2020-03-30","53","701","3","95","11.3","11.8"
"Clarke","2020-03-31","29","730","4","99","10.2","11.9"
"Clarke","2020-04-01","66","796","9","108","9.1","12.3"
"Clarke","2020-04-02","45","841","3","111","8","11.9"
"Clarke","2020-04-03","36","877","2","113","6.5","11.7"
"Clarke","2020-04-04","9","886","1","114","8.1","12.1"
"Clarke","2020-04-05","6","892","0","114","8.1","10"
"Clarke","2020-04-06","35","927","0","114","7.3","9.3"
"Clarke","2020-04-07","37","964","2","116","6.1","8.1"
"Clarke","2020-04-08","48","1012","2","118","4.7","6.9"
"Clarke","2020-04-09","60","1072","2","120","4.2","6.1"
"Clarke","2020-04-10","36","1108","6","126","5.8","6.1"
"Clarke","2020-04-11","9","1117","2","128","7.4","7.7"
"Clarke","2020-04-12","1","1118","0","128","7.4","7.7"
"Clarke","2020-04-13","57","1175","2","130","7.9","7.6"
"Clarke","2020-04-14","38","1213","5","135","9","7.5"
"Clarke","2020-04-15","54","1267","3","138","9.2","7"
"Clarke","2020-04-16","110","1377","4","142","9.2","6.7"
"Clarke","2020-04-17","102","1479","10","152","8.3","7"
"Clarke","2020-04-18","25","1504","1","153","5.7","6.5"
"Clarke","2020-04-19","12","1516","1","154","6.9","7.1"
"Clarke","2020-04-20","84","1600","12","166","8.4","8.1"
"Clarke","2020-04-21","115","1715","8","174","7.5","8.3"
"Clarke","2020-04-22","175","1890","16","190","8","8.6"
"Clarke","2020-04-23","32","1922","1","191","7.9","8.6"
"Clarke","2020-04-24","101","2023","4","195","7.1","7.7"
"Clarke","2020-04-25","92","2115","4","199","7.2","6.4"
"Clarke","2020-04-26","10","2125","3","202","10.3","8.6"
"Clarke","2020-04-27","112","2237","16","218","10.3","9.3"
"Clarke","2020-04-28","187","2424","8","226","9.9","8.7"
"Clarke","2020-04-29","122","2546","4","230","9","8.5"
"Clarke","2020-04-30","111","2657","3","233","9","8.5"
"Clarke","2020-05-01","55","2712","1","234","8.7","7.9"
"Clarke","2020-05-02","61","2773","5","239","9.2","8.2"
"Clarke","2020-05-03","25","2798","3","242","6.7","8.5"
"Clarke","2020-05-04","102","2900","2","244","4.9","7.6"
"Clarke","2020-05-05","98","2998","1","245","4.4","7.2"
"Clarke","2020-05-06","89","3087","1","246","4.1","6.6"
"Clarke","2020-05-07","170","3257","3","249","4","6.5"
"Clarke","2020-05-08","115","3372","2","251","4","6.3"
"Clarke","2020-05-09","129","3501","3","254","3.1","6.2"
"Clarke","2020-05-10","40","3541","2","256","2.1","4.4"
"Clarke","2020-05-11","266","3807","2","258","2","3.4"
"Clarke","2020-05-12","271","4078","5","263","2.1","3.3"
"Clarke","2020-05-13","229","4307","4","267","2.2","3.1"
"Clarke","2020-05-14","213","4520","11","278","2.7","3.3"
"Clarke","2020-05-15","434","4954","10","288","2.7","3.4"
"Clarke","2020-05-16","60","5014","2","290","2.9","3"
"Clarke","2020-05-17","50","5064","0","290","2.2","2.1"
"Clarke","2020-05-18","160","5224","3","293","2.3","2.1"
"Clarke","2020-05-19","338","5562","10","303","2.5","2.3"
"Clarke","2020-05-20","211","5773","8","311","2.8","2.5"
"Clarke","2020-05-21","255","6028","25","336","3.4","3"
"Clarke","2020-05-22","132","6160","10","346","4.2","3.5"
"Clarke","2020-05-23","122","6282","25","371","6.6","4.8"
"Clarke","2020-05-24","42","6324","2","373","7.3","4.7"
"Clarke","2020-05-25","66","6390","11","384","9.4","5.9"
"Clarke","2020-05-26","312","6702","28","412","10.3","6.4"
"Clarke","2020-05-27","249","6951","7","419","10.2","6.5"
"Clarke","2020-05-28","342","7293","7","426","9","6.2"
"Clarke","2020-05-29","244","7537","12","438","8.7","6.4"
"Clarke","2020-05-30","96","7633","5","443","6.5","6.6"
"Clarke","2020-05-31","40","7673","2","445","6.5","6.9"
"Clarke","2020-06-01","256","7929","17","462","5.1","7.3"
"Clarke","2020-06-02","336","8265","14","476","4.4","7.3"
"Clarke","2020-06-03","311","8576","12","488","4.5","7.4"
"Clarke","2020-06-04","328","8904","8","496","4.6","6.8"
"Clarke","2020-06-05","318","9222","6","502","4.2","6.4"
"Clarke","2020-06-06","202","9424","2","504","3.6","5"
"Clarke","2020-06-07","50","9474","2","506","3.4","5"
"Clarke","2020-06-08","327","9801","8","514","2.8","4"
"Clarke","2020-06-09","340","10141","11","525","2.7","3.5"
"Clarke","2020-06-10","325","10466","7","532","2.5","3.5"
"Clarke","2020-06-11","322","10788","14","546","2.7","3.7"
"Clarke","2020-06-12","261","11049","5","551","2.7","3.4"
"Clarke","2020-06-13","107","11156","1","552","2.7","3.1"
"Clarke","2020-06-14","69","11225","3","555","2.8","3.1"
"Clarke","2020-06-15","321","11546","18","573","3.2","3"
"Clarke","2020-06-16","330","11876","8","581","3.1","2.9"
"Clarke","2020-06-17","349","12225","19","600","3.6","3"
"Clarke","2020-06-18","343","12568","17","617","3.7","3.2"
"Clarke","2020-06-19","339","12907","27","644","4.5","3.6"
"Clarke","2020-06-20","107","13014","9","653","5.6","4.2"
"Clarke","2020-06-21","55","13069","5","658","6.3","4.5"
"Clarke","2020-06-22","400","13469","41","699","6.9","5.1"
"Clarke","2020-06-23","384","13853","34","733","7.9","5.5"
"Clarke","2020-06-24","467","14320","51","784","8.6","6.1"
"Clarke","2020-06-25","551","14871","54","838","9.3","6.5"
"Clarke","2020-06-26","518","15389","54","892","9.7","7.1"
"Clarke","2020-06-27","161","15550","27","919","10.9","8.2"
"Clarke","2020-06-28","107","15657","10","929","10.9","8.6"
"Clarke","2020-06-29","617","16274","49","978","10.6","8.8"
"Clarke","2020-06-30","551","16825","65","1043","11","9.4"
"Clarke","2020-07-01","614","17439","63","1106","10.9","9.8"
"Clarke","2020-07-02","559","17998","57","1163","11","10.1"
"Clarke","2020-07-03","255","18253","29","1192","11.1","10.4"
"Clarke","2020-07-04","34","18287","6","1198","11.2","11"
"Clarke","2020-07-05","106","18393","10","1208","11.2","11.1"
"Clarke","2020-07-06","612","19005","90","1298","12.2","11.4"
"Clarke","2020-07-07","649","19654","80","1378","12.3","11.6"
"Clarke","2020-07-08","661","20315","59","1437","12.1","11.5"
"Clarke","2020-07-09","702","21017","76","1513","12.2","11.6"
"Clarke","2020-07-10","741","21758","77","1590","12","11.6"
"Clarke","2020-07-11","152","21910","32","1622","12.5","11.9"
"Clarke","2020-07-12","75","21985","9","1631","12.9","12.1"
"Clarke","2020-07-13","706","22691","66","1697","12.1","12.2"
"Clarke","2020-07-14","729","23420","77","1774","11.9","12.1"
"Clarke","2020-07-15","762","24182","74","1848","12","12"
"Clarke","2020-07-16","665","24847","63","1911","11.8","12"
"Clarke","2020-07-17","617","25464","59","1970","11.7","11.9"
"Clarke","2020-07-18","191","25655","16","1986","9.9","11.2"
"Clarke","2020-07-19","100","25755","17","2003","10.6","11.7"
"Clarke","2020-07-20","724","26479","61","2064","10.4","11.3"
"Clarke","2020-07-21","586","27065","57","2121","10.3","11.1"
"Clarke","2020-07-22","625","27690","57","2178","10.2","11.1"
"Clarke","2020-07-23","658","28348","58","2236","10.1","11"
"Clarke","2020-07-24","693","29041","54","2290","9.9","10.8"
"Clarke","2020-07-25","265","29306","31","2321","10.4","10.1"
"Clarke","2020-07-26","110","29416","14","2335","9.8","10.2"
"Clarke","2020-07-27","604","30020","58","2393","9.9","10.2"
"Clarke","2020-07-28","566","30586","60","2453","10.1","10.2"
"Clarke","2020-07-29","535","31121","57","2510","10.3","10.3"
"Clarke","2020-07-30","534","31655","31","2541","9.8","10"
"Clarke","2020-07-31","495","32150","42","2583","9.9","9.9"
"Clarke","2020-08-01","160","32310","16","2599","9.7","10"
"Clarke","2020-08-02","96","32406","17","2616","10.4","10.1"
"Clarke","2020-08-03","451","32857","50","2666","10.6","10.3"
"Clarke","2020-08-04","495","33352","57","2723","10.8","10.4"
"Clarke","2020-08-05","412","33764","41","2764","10.7","10.5"
"Clarke","2020-08-06","425","34189","32","2796","10.9","10.4"
"Clarke","2020-08-07","450","34639","31","2827","10.7","10.3"
"Clarke","2020-08-08","174","34813","22","2849","11","10.4"
"Clarke","2020-08-09","76","34889","10","2859","10.4","10.4"
"Clarke","2020-08-10","587","35476","46","2905","9.9","10.3"
"Clarke","2020-08-11","627","36103","32","2937","9","9.9"
"Clarke","2020-08-12","538","36641","47","2984","8.8","9.7"
"Clarke","2020-08-13","531","37172","51","3035","9.1","10"
"Clarke","2020-08-14","546","37718","32","3067","9","9.8"
"Clarke","2020-08-15","120","37838","13","3080","8.7","9.9"
"Clarke","2020-08-16","57","37895","7","3087","8.6","9.5"
"Clarke","2020-08-17","641","38536","38","3125","8.3","9.1"
"Clarke","2020-08-18","778","39314","55","3180","8.6","8.8"
"Clarke","2020-08-19","784","40098","53","3233","8.3","8.6"
"Clarke","2020-08-20","640","40738","52","3285","8.1","8.6"
"Clarke","2020-08-21","872","41610","59","3344","8.3","8.6"
"Clarke","2020-08-22","169","41779","25","3369","8.8","8.8"
"Clarke","2020-08-23","59","41838","8","3377","9","8.8"
"Clarke","2020-08-24","865","42703","86","3463","9.6","9"
"Clarke","2020-08-25","763","43466","49","3512","9.5","9"
"Clarke","2020-08-26","809","44275","74","3586","9.8","9.1"
"Clarke","2020-08-27","764","45039","109","3695","10.7","9.4"
"Clarke","2020-08-28","927","45966","154","3849","12.1","10.2"
"Clarke","2020-08-29","308","46274","26","3875","11.2","10"
"Clarke","2020-08-30","103","46377","25","3900","12.7","10.9"
"Clarke","2020-08-31","880","47257","150","4050","13.7","11.7"
"Clarke","2020-09-01","920","48177","182","4232","15.7","12.6"
"Clarke","2020-09-02","993","49170","182","4414","17","13.4"
"Clarke","2020-09-03","907","50077","136","4550","17.1","13.9"
"Clarke","2020-09-04","867","50944","101","4651","16.4","14.2"
"Clarke","2020-09-05","293","51237","26","4677","16.4","13.8"
"Clarke","2020-09-06","95","51332","18","4695","15.7","14.2"
"Clarke","2020-09-07","166","51498","25","4720","15.4","14.6"
"Clarke","2020-09-08","1003","52501","106","4826","14.1","14.9"
"Clarke","2020-09-09","833","53334","95","4921","13.1","15"
"Clarke","2020-09-10","840","54174","97","5018","12.6","14.8"
"Clarke","2020-09-11","892","55066","71","5089","12.1","14.2"
"Clarke","2020-09-12","235","55301","27","5116","12.4","14.4"
"Clarke","2020-09-13","79","55380","10","5126","11.5","13.6"
"Clarke","2020-09-14","764","56144","58","5184","10.5","12.9"
"Clarke","2020-09-15","801","56945","63","5247","10.1","12.1"
"Clarke","2020-09-16","706","57651","35","5282","9.2","11.1"
"Clarke","2020-09-17","645","58296","30","5312","8.2","10.4"
"Clarke","2020-09-18","624","58920","34","5346","7.8","9.9"
"Clarke","2020-09-19","325","59245","10","5356","6.6","9.5"
"Clarke","2020-09-20","78","59323","5","5361","5.7","8.6"
"Clarke","2020-09-21","578","59901","35","5396","5.5","8"
"Clarke","2020-09-22","526","60427","20","5416","4.9","7.5"
"Clarke","2020-09-23","628","61055","24","5440","4.8","7"
"Clarke","2020-09-24","494","61549","22","5462","4.7","6.4"
"Clarke","2020-09-25","489","62038","23","5485","4.6","6.2"
"Clarke","2020-09-26","136","62174","8","5493","5","5.8"
"Clarke","2020-09-27","60","62234","3","5496","4.8","5.3"
"Clarke","2020-09-28","494","62728","15","5511","4.4","4.9"
"Clarke","2020-09-29","495","63223","18","5529","4.4","4.6"
"Clarke","2020-09-30","535","63758","23","5552","4.4","4.6"
"Clarke","2020-10-01","425","64183","11","5563","4.2","4.4"
"Clarke","2020-10-02","461","64644","13","5576","3.9","4.3"
"Clarke","2020-10-03","131","64775","11","5587","4.3","4.6"
"Clarke","2020-10-04","73","64848","7","5594","4.9","4.9"
"Clarke","2020-10-05","640","65488","31","5625","5.2","4.8"
"Clarke","2020-10-06","639","66127","24","5649","5.2","4.8"
"Clarke","2020-10-07","754","66881","35","5684","5.2","4.8"
"Clarke","2020-10-08","552","67433","21","5705","5.4","4.8"
"Clarke","2020-10-09","560","67993","21","5726","5.5","4.7"
"Clarke","2020-10-10","131","68124","9","5735","5.3","4.8"
"Clarke","2020-10-11","77","68201","11","5746","6","5.5"
"Clarke","2020-10-12","530","68731","27","5773","6","5.6"
"Clarke","2020-10-13","612","69343","28","5801","6.1","5.7"
"Clarke","2020-10-14","628","69971","25","5826","6.1","5.6"
"Clarke","2020-10-15","536","70507","17","5843","6","5.7"
"Clarke","2020-10-16","532","71039","16","5859","5.9","5.7"
"Clarke","2020-10-17","157","71196","6","5865","5.4","5.4"
"Clarke","2020-10-18","55","71251","7","5872","5.2","5.6"
"Clarke","2020-10-19","625","71876","25","5897","5","5.5"
"Clarke","2020-10-20","575","72451","18","5915","4.8","5.5"
"Clarke","2020-10-21","582","73033","25","5940","4.9","5.5"
"Clarke","2020-10-22","528","73561","20","5960","5","5.5"
"Clarke","2020-10-23","434","73995","24","5984","5.3","5.6"
"Clarke","2020-10-24","175","74170","11","5995","5.7","5.5"
"Clarke","2020-10-25","63","74233","7","6002","5.4","5.3"
"Clarke","2020-10-26","615","74848","24","6026","5.4","5.2"
"Clarke","2020-10-27","618","75466","26","6052","5.6","5.2"
"Clarke","2020-10-28","625","76091","35","6087","5.8","5.3"
"Clarke","2020-10-29","584","76675","20","6107","5.7","5.3"
"Clarke","2020-10-30","499","77174","22","6129","5.6","5.4"
"Clarke","2020-10-31","134","77308","15","6144","6.3","6"
"Clarke","2020-11-01","64","77372","3","6147","5.3","5.4"
"Clarke","2020-11-02","628","78000","31","6178","5.5","5.5"
"Clarke","2020-11-03","952","78952","39","6217","5.5","5.5"
"Clarke","2020-11-04","558","79510","28","6245","5.4","5.6"
"Clarke","2020-11-05","635","80145","30","6275","5.6","5.7"
"Clarke","2020-11-06","588","80733","24","6299","5.5","5.5"
"Clarke","2020-11-07","145","80878","7","6306","4.6","5.4"
"Clarke","2020-11-08","102","80980","9","6315","5.2","5.3"
"Clarke","2020-11-09","709","81689","38","6353","5.3","5.4"
"Clarke","2020-11-10","715","82404","41","6394","5.5","5.5"
"Clarke","2020-11-11","631","83035","30","6424","5.5","5.4"
"Clarke","2020-11-12","639","83674","31","6455","5.5","5.5"
"Clarke","2020-11-13","528","84202","31","6486","5.7","5.6"
"Clarke","2020-11-14","165","84367","18","6504","6.6","5.6"
"Clarke","2020-11-15","122","84489","11","6515","6.6","5.9"
"Clarke","2020-11-16","839","85328","35","6550","6.5","5.9"
"Clarke","2020-11-17","917","86245","27","6577","6.1","5.8"
"Clarke","2020-11-18","1053","87298","26","6603","5.7","5.6"
"Clarke","2020-11-19","1302","88600","29","6632","5.4","5.4"
"Clarke","2020-11-20","1511","90111","37","6669","4.9","5.3"
"Clarke","2020-11-21","254","90365","20","6689","4.5","5.5"
"Clarke","2020-11-22","190","90555","20","6709","4.7","5.7"
"Clarke","2020-11-23","1381","91936","32","6741","4.4","5.4"
"Clarke","2020-11-24","1076","93012","31","6772","4.4","5.2"
"Clarke","2020-11-25","368","93380","27","6799","5.1","5.4"
"Clarke","2020-11-26","49","93429","9","6808","7.4","6.4"
"Clarke","2020-11-27","306","93735","37","6845","8.8","6.8"
"Clarke","2020-11-28","235","93970","27","6872","9.3","6.9"
"Clarke","2020-11-29","158","94128","24","6896","10","7.3"
"Clarke","2020-11-30","718","94846","99","6995","11.6","8"
"Clarke","2020-12-01","874","95720","61","7056","12.2","8.3"
"Clarke","2020-12-02","884","96604","60","7116","12.1","8.6"
"Clarke","2020-12-03","813","97417","65","7181","10.6","9"
"Clarke","2020-12-04","850","98267","56","7237","9.8","9.3"
"Clarke","2020-12-05","262","98529","21","7258","9.3","9.3"
"Clarke","2020-12-06","197","98726","32","7290","9.5","9.7"
"Clarke","2020-12-07","854","99580","92","7382","9.1","10.3"
"Clarke","2020-12-08","838","100418","59","7441","9.1","10.6"
"Clarke","2020-12-09","734","101152","69","7510","9.4","10.8"
"Clarke","2020-12-10","803","101955","63","7573","9.4","10"
"Clarke","2020-12-11","881","102836","62","7635","9.5","9.7"
"Clarke","2020-12-12","205","103041","37","7672","10.9","10.1"
"Clarke","2020-12-13","144","103185","29","7701","11.5","10.5"
"Clarke","2020-12-14","862","104047","54","7755","10.8","9.9"
"Clarke","2020-12-15","859","104906","60","7815","10.8","9.9"
"Clarke","2020-12-16","947","105853","82","7897","10.7","10.1"
"Clarke","2020-12-17","931","106784","82","7979","10.8","10.1"
"Clarke","2020-12-18","1015","107799","79","8058","11","10.2"
"Clarke","2020-12-19","252","108051","35","8093","10.4","10.6"
"Clarke","2020-12-20","203","108254","30","8123","9.6","10.5"
"Clarke","2020-12-21","1007","109261","92","8215","10","10.4"
"Clarke","2020-12-22","868","110129","85","8300","10.4","10.6"
"Clarke","2020-12-23","815","110944","78","8378","10.5","10.6"
"Clarke","2020-12-24","299","111243","54","8432","11.9","11.4"
"Clarke","2020-12-25","51","111294","14","8446","14.7","12.8"
"Clarke","2020-12-26","361","111655","65","8511","15.3","12.8"
"Clarke","2020-12-27","215","111870","36","8547","15.5","12.6"
"Clarke","2020-12-28","642","112512","130","8677","17.1","13.6"
"Clarke","2020-12-29","623","113135","125","8802","18.6","14.5"
"Clarke","2020-12-30","639","113774","122","8924","20","15.2"
"Clarke","2020-12-31","530","114304","91","9015","19.8","15.8"
"Clarke","2021-01-01","127","114431","40","9055","20.4","17.5"
"Clarke","2021-01-02","163","114594","45","9100","21.8","18.5"
"Clarke","2021-01-03","192","114786","41","9141","22.4","19"
"Clarke","2021-01-04","1211","115997","130","9271","21.1","19.1"
"Clarke","2021-01-05","1122","117119","180","9451","20.5","19.5"
"Clarke","2021-01-06","1339","118458","178","9629","19.7","19.8"
"Clarke","2021-01-07","939","119397","147","9776","19.5","19.6"
"Clarke","2021-01-08","740","120137","109","9885","17.1","18.7"
"Clarke","2021-01-09","216","120353","73","9958","17.9","19.9"
"Clarke","2021-01-10","217","120570","55","10013","18.5","20.5"
"Clarke","2021-01-11","1076","121646","131","10144","18.7","19.9"
"Clarke","2021-01-12","971","122617","119","10263","18.2","19.3"
"Clarke","2021-01-13","973","123590","94","10357","17.7","18.7"
"Clarke","2021-01-14","711","124301","86","10443","17.2","18.3"
"Clarke","2021-01-15","662","124963","68","10511","16.5","16.8"
"Clarke","2021-01-16","205","125168","47","10558","15","16.5"
"Clarke","2021-01-17","188","125356","39","10597","14.3","16.4"
"Clarke","2021-01-18","419","125775","87","10684","15.5","17.1"
"Clarke","2021-01-19","1146","126921","108","10792","15.1","16.7"
"Clarke","2021-01-20","977","127898","101","10893","15.2","16.4"
"Clarke","2021-01-21","643","128541","85","10978","15.4","16.3"
"Clarke","2021-01-22","660","129201","58","11036","15.2","15.8"
"Clarke","2021-01-23","174","129375","44","11080","15.5","15.2"
"Clarke","2021-01-24","130","129505","45","11125","17.5","15.9"
"Clarke","2021-01-25","454","129959","40","11165","15.8","15.7"
"Clarke","2021-01-26","79","130038","9","11174","16.1","15.6"
"Clarke","2021-01-27","0","130038","0","11174","14.6","14.9"
"Clay","2020-02-01","0","0","0","0",".","."
"Clay","2020-02-02","0","0","0","0",".","."
"Clay","2020-02-03","0","0","0","0",".","."
"Clay","2020-02-04","0","0","0","0",".","."
"Clay","2020-02-05","0","0","0","0",".","."
"Clay","2020-02-06","0","0","0","0",".","."
"Clay","2020-02-07","0","0","0","0","0","."
"Clay","2020-02-08","0","0","0","0","0","."
"Clay","2020-02-09","0","0","0","0","0","."
"Clay","2020-02-10","0","0","0","0","0","."
"Clay","2020-02-11","0","0","0","0","0","."
"Clay","2020-02-12","0","0","0","0","0","."
"Clay","2020-02-13","0","0","0","0","0","."
"Clay","2020-02-14","0","0","0","0","0","0"
"Clay","2020-02-15","0","0","0","0","0","0"
"Clay","2020-02-16","0","0","0","0","0","0"
"Clay","2020-02-17","0","0","0","0","0","0"
"Clay","2020-02-18","0","0","0","0","0","0"
"Clay","2020-02-19","0","0","0","0","0","0"
"Clay","2020-02-20","0","0","0","0","0","0"
"Clay","2020-02-21","0","0","0","0","0","0"
"Clay","2020-02-22","0","0","0","0","0","0"
"Clay","2020-02-23","0","0","0","0","0","0"
"Clay","2020-02-24","0","0","0","0","0","0"
"Clay","2020-02-25","0","0","0","0","0","0"
"Clay","2020-02-26","0","0","0","0","0","0"
"Clay","2020-02-27","0","0","0","0","0","0"
"Clay","2020-02-28","0","0","0","0","0","0"
"Clay","2020-02-29","0","0","0","0","0","0"
"Clay","2020-03-01","0","0","0","0","0","0"
"Clay","2020-03-02","0","0","0","0","0","0"
"Clay","2020-03-03","0","0","0","0","0","0"
"Clay","2020-03-04","0","0","0","0","0","0"
"Clay","2020-03-05","0","0","0","0","0","0"
"Clay","2020-03-06","0","0","0","0","0","0"
"Clay","2020-03-07","0","0","0","0","0","0"
"Clay","2020-03-08","0","0","0","0","0","0"
"Clay","2020-03-09","0","0","0","0","0","0"
"Clay","2020-03-10","0","0","0","0","0","0"
"Clay","2020-03-11","0","0","0","0","0","0"
"Clay","2020-03-12","0","0","0","0","0","0"
"Clay","2020-03-13","2","2","0","0","0","0"
"Clay","2020-03-14","0","2","0","0","0","0"
"Clay","2020-03-15","0","2","0","0","0","0"
"Clay","2020-03-16","1","3","0","0","0","0"
"Clay","2020-03-17","0","3","0","0","0","0"
"Clay","2020-03-18","1","4","0","0","0","0"
"Clay","2020-03-19","1","5","0","0","0","0"
"Clay","2020-03-20","0","5","0","0","0","0"
"Clay","2020-03-21","0","5","0","0","0","0"
"Clay","2020-03-22","0","5","0","0","0","0"
"Clay","2020-03-23","2","7","2","2","14.3","7.1"
"Clay","2020-03-24","0","7","0","2","14.3","7.1"
"Clay","2020-03-25","2","9","0","2","14.3","7.1"
"Clay","2020-03-26","2","11","1","3","21.4","10.7"
"Clay","2020-03-27","3","14","1","4","26.2","13.1"
"Clay","2020-03-28","2","16","0","4","26.2","13.1"
"Clay","2020-03-29","0","16","0","4","26.2","13.1"
"Clay","2020-03-30","1","17","1","5","26.2","20.2"
"Clay","2020-03-31","2","19","2","7","40.5","27.4"
"Clay","2020-04-01","0","19","0","7","40.5","27.4"
"Clay","2020-04-02","0","19","0","7","33.3","27.4"
"Clay","2020-04-03","1","20","0","7","28.6","27.4"
"Clay","2020-04-04","0","20","0","7","28.6","27.4"
"Clay","2020-04-05","2","22","2","9","42.9","34.5"
"Clay","2020-04-06","0","22","0","9","28.6","27.4"
"Clay","2020-04-07","1","23","1","10","28.6","34.5"
"Clay","2020-04-08","1","24","0","10","28.6","34.5"
"Clay","2020-04-09","1","25","0","10","28.6","31"
"Clay","2020-04-10","1","26","0","10","28.6","28.6"
"Clay","2020-04-11","2","28","1","11","35.7","32.1"
"Clay","2020-04-12","0","28","0","11","21.4","32.1"
"Clay","2020-04-13","2","30","1","12","28.6","28.6"
"Clay","2020-04-14","2","32","1","13","21.4","25"
"Clay","2020-04-15","3","35","0","13","21.4","25"
"Clay","2020-04-16","1","36","0","13","21.4","25"
"Clay","2020-04-17","4","40","1","14","25","26.8"
"Clay","2020-04-18","0","40","0","14","17.9","26.8"
"Clay","2020-04-19","0","40","0","14","17.9","19.6"
"Clay","2020-04-20","3","43","0","14","10.7","19.6"
"Clay","2020-04-21","1","44","1","15","17.9","19.6"
"Clay","2020-04-22","1","45","0","15","17.9","19.6"
"Clay","2020-04-23","1","46","0","15","17.9","19.6"
"Clay","2020-04-24","1","47","0","15","14.3","19.6"
"Clay","2020-04-25","1","48","0","15","14.3","16.1"
"Clay","2020-04-26","0","48","0","15","14.3","16.1"
"Clay","2020-04-27","2","50","0","15","14.3","12.5"
"Clay","2020-04-28","0","50","0","15","0","8.9"
"Clay","2020-04-29","7","57","3","18","6.1","12"
"Clay","2020-04-30","3","60","1","19","10.9","14.4"
"Clay","2020-05-01","2","62","0","19","10.9","12.6"
"Clay","2020-05-02","0","62","0","19","10.9","12.6"
"Clay","2020-05-03","0","62","0","19","10.9","12.6"
"Clay","2020-05-04","6","68","1","20","13.3","13.8"
"Clay","2020-05-05","0","68","0","20","13.3","6.6"
"Clay","2020-05-06","6","74","0","20","7.1","6.6"
"Clay","2020-05-07","1","75","0","20","2.4","6.6"
"Clay","2020-05-08","2","77","1","21","9.5","10.2"
"Clay","2020-05-09","1","78","0","21","9.5","10.2"
"Clay","2020-05-10","0","78","0","21","9.5","10.2"
"Clay","2020-05-11","1","79","1","22","21.4","17.3"
"Clay","2020-05-12","2","81","0","22","21.4","17.3"
"Clay","2020-05-13","9","90","1","23","23","15.1"
"Clay","2020-05-14","3","93","1","24","27.8","15.1"
"Clay","2020-05-15","5","98","0","24","20.6","15.1"
"Clay","2020-05-16","1","99","0","24","20.6","15.1"
"Clay","2020-05-17","0","99","0","24","20.6","15.1"
"Clay","2020-05-18","5","104","2","26","12.1","16.7"
"Clay","2020-05-19","1","105","0","26","12.1","16.7"
"Clay","2020-05-20","15","120","3","29","13.3","18.2"
"Clay","2020-05-21","0","120","0","29","8.6","18.2"
"Clay","2020-05-22","3","123","2","31","18.1","19.4"
"Clay","2020-05-23","1","124","0","31","18.1","19.4"
"Clay","2020-05-24","1","125","1","32","32.4","26.5"
"Clay","2020-05-25","0","125","0","32","26.7","19.4"
"Clay","2020-05-26","5","130","2","34","32.4","22.2"
"Clay","2020-05-27","16","146","2","36","31.3","22.3"
"Clay","2020-05-28","3","149","0","36","31.3","19.9"
"Clay","2020-05-29","1","150","0","36","21.8","19.9"
"Clay","2020-05-30","1","151","0","36","21.8","19.9"
"Clay","2020-05-31","0","151","0","36","7.5","19.9"
"Clay","2020-06-01","1","152","0","36","7.5","17.1"
"Clay","2020-06-02","3","155","1","37","6.5","19.5"
"Clay","2020-06-03","7","162","3","40","10.9","21.1"
"Clay","2020-06-04","3","165","1","41","15.6","23.5"
"Clay","2020-06-05","4","169","0","41","15.6","18.7"
"Clay","2020-06-06","0","169","0","41","15.6","18.7"
"Clay","2020-06-07","4","173","0","41","15.6","11.6"
"Clay","2020-06-08","30","203","1","42","16.1","11.8"
"Clay","2020-06-09","0","203","0","42","11.4","9"
"Clay","2020-06-10","1","204","0","42","5.2","8.1"
"Clay","2020-06-11","4","208","2","44","7.6","11.6"
"Clay","2020-06-12","2","210","0","44","7.6","11.6"
"Clay","2020-06-13","0","210","0","44","7.6","11.6"
"Clay","2020-06-14","0","210","0","44","7.6","11.6"
"Clay","2020-06-15","1","211","0","44","7.1","11.6"
"Clay","2020-06-16","4","215","0","44","7.1","9.3"
"Clay","2020-06-17","1","216","0","44","7.1","6.2"
"Clay","2020-06-18","1","217","0","44","0","3.8"
"Clay","2020-06-19","2","219","0","44","0","3.8"
"Clay","2020-06-20","0","219","0","44","0","3.8"
"Clay","2020-06-21","0","219","0","44","0","3.8"
"Clay","2020-06-22","0","219","0","44","0","3.6"
"Clay","2020-06-23","0","219","0","44","0","3.6"
"Clay","2020-06-24","0","219","0","44","0","3.6"
"Clay","2020-06-25","0","219","0","44","0","0"
"Clay","2020-06-26","1","220","0","44","0","0"
"Clay","2020-06-27","0","220","0","44","0","0"
"Clay","2020-06-28","0","220","0","44","0","0"
"Clay","2020-06-29","0","220","0","44","0","0"
"Clay","2020-06-30","3","223","0","44","0","0"
"Clay","2020-07-01","1","224","0","44","0","0"
"Clay","2020-07-02","2","226","0","44","0","0"
"Clay","2020-07-03","0","226","0","44","0","0"
"Clay","2020-07-04","0","226","0","44","0","0"
"Clay","2020-07-05","1","227","1","45","14.3","7.1"
"Clay","2020-07-06","0","227","0","45","14.3","7.1"
"Clay","2020-07-07","3","230","1","46","19","9.5"
"Clay","2020-07-08","5","235","1","47","21.9","11"
"Clay","2020-07-09","1","236","0","47","21.9","11"
"Clay","2020-07-10","6","242","0","47","21.9","11"
"Clay","2020-07-11","1","243","0","47","21.9","11"
"Clay","2020-07-12","1","244","1","48","21.9","18.1"
"Clay","2020-07-13","0","244","0","48","21.9","18.1"
"Clay","2020-07-14","3","247","1","49","21.9","20.5"
"Clay","2020-07-15","1","248","0","49","19","20.5"
"Clay","2020-07-16","0","248","0","49","19","20.5"
"Clay","2020-07-17","1","249","1","50","33.3","27.6"
"Clay","2020-07-18","1","250","0","50","33.3","27.6"
"Clay","2020-07-19","2","252","1","51","26.2","24"
"Clay","2020-07-20","4","256","0","51","26.2","24"
"Clay","2020-07-21","1","257","0","51","21.4","21.7"
"Clay","2020-07-22","0","257","0","51","21.4","20.2"
"Clay","2020-07-23","2","259","0","51","21.4","20.2"
"Clay","2020-07-24","1","260","0","51","7.1","20.2"
"Clay","2020-07-25","0","260","0","51","7.1","20.2"
"Clay","2020-07-26","0","260","0","51","0","13.1"
"Clay","2020-07-27","3","263","0","51","0","13.1"
"Clay","2020-07-28","2","265","0","51","0","10.7"
"Clay","2020-07-29","0","265","0","51","0","10.7"
"Clay","2020-07-30","4","269","1","52","3.6","12.5"
"Clay","2020-07-31","4","273","3","55","14.3","10.7"
"Clay","2020-08-01","0","273","0","55","14.3","10.7"
"Clay","2020-08-02","0","273","0","55","14.3","7.1"
"Clay","2020-08-03","1","274","0","55","14.3","7.1"
"Clay","2020-08-04","2","276","0","55","14.3","7.1"
"Clay","2020-08-05","1","277","0","55","14.3","7.1"
"Clay","2020-08-06","2","279","0","55","10.7","7.1"
"Clay","2020-08-07","3","282","2","57","9.5","11.9"
"Clay","2020-08-08","1","283","0","57","9.5","11.9"
"Clay","2020-08-09","0","283","0","57","9.5","11.9"
"Clay","2020-08-10","1","284","0","57","9.5","11.9"
"Clay","2020-08-11","5","289","1","58","12.4","13.3"
"Clay","2020-08-12","2","291","0","58","12.4","13.3"
"Clay","2020-08-13","1","292","0","58","12.4","11.5"
"Clay","2020-08-14","3","295","1","59","7.6","8.6"
"Clay","2020-08-15","1","296","0","59","7.6","8.6"
"Clay","2020-08-16","0","296","0","59","7.6","8.6"
"Clay","2020-08-17","5","301","0","59","7.6","8.6"
"Clay","2020-08-18","1","302","0","59","4.8","8.6"
"Clay","2020-08-19","2","304","0","59","4.8","8.6"
"Clay","2020-08-20","1","305","1","60","19","15.7"
"Clay","2020-08-21","2","307","1","61","21.4","14.5"
"Clay","2020-08-22","1","308","1","62","35.7","21.7"
"Clay","2020-08-23","1","309","1","63","50","28.8"
"Clay","2020-08-24","2","311","0","63","50","28.8"
"Clay","2020-08-25","0","311","0","63","50","27.4"
"Clay","2020-08-26","0","311","0","63","50","27.4"
"Clay","2020-08-27","1","312","1","64","50","34.5"
"Clay","2020-08-28","2","314","0","64","42.9","32.1"
"Clay","2020-08-29","0","314","0","64","28.6","32.1"
"Clay","2020-08-30","0","314","0","64","14.3","32.1"
"Clay","2020-08-31","0","314","0","64","14.3","32.1"
"Clay","2020-09-01","3","317","0","64","14.3","32.1"
"Clay","2020-09-02","0","317","0","64","14.3","32.1"
"Clay","2020-09-03","2","319","0","64","0","25"
"Clay","2020-09-04","1","320","0","64","0","21.4"
"Clay","2020-09-05","0","320","0","64","0","14.3"
"Clay","2020-09-06","0","320","0","64","0","7.1"
"Clay","2020-09-07","0","320","0","64","0","7.1"
"Clay","2020-09-08","6","326","2","66","4.8","9.5"
"Clay","2020-09-09","2","328","0","66","4.8","9.5"
"Clay","2020-09-10","3","331","0","66","4.8","2.4"
"Clay","2020-09-11","4","335","0","66","4.8","2.4"
"Clay","2020-09-12","0","335","0","66","4.8","2.4"
"Clay","2020-09-13","0","335","0","66","4.8","2.4"
"Clay","2020-09-14","4","339","0","66","4.8","2.4"
"Clay","2020-09-15","2","341","0","66","0","2.4"
"Clay","2020-09-16","3","344","0","66","0","2.4"
"Clay","2020-09-17","2","346","0","66","0","2.4"
"Clay","2020-09-18","0","346","0","66","0","2.4"
"Clay","2020-09-19","1","347","0","66","0","2.4"
"Clay","2020-09-20","0","347","0","66","0","2.4"
"Clay","2020-09-21","3","350","0","66","0","2.4"
"Clay","2020-09-22","1","351","0","66","0","0"
"Clay","2020-09-23","0","351","0","66","0","0"
"Clay","2020-09-24","4","355","0","66","0","0"
"Clay","2020-09-25","2","357","1","67","7.1","3.6"
"Clay","2020-09-26","0","357","0","67","7.1","3.6"
"Clay","2020-09-27","0","357","0","67","7.1","3.6"
"Clay","2020-09-28","4","361","0","67","7.1","3.6"
"Clay","2020-09-29","1","362","0","67","7.1","3.6"
"Clay","2020-09-30","3","365","0","67","7.1","3.6"
"Clay","2020-10-01","3","368","1","68","11.9","6"
"Clay","2020-10-02","0","368","0","68","4.8","6"
"Clay","2020-10-03","1","369","0","68","4.8","6"
"Clay","2020-10-04","0","369","0","68","4.8","6"
"Clay","2020-10-05","3","372","0","68","4.8","6"
"Clay","2020-10-06","1","373","0","68","4.8","6"
"Clay","2020-10-07","0","373","0","68","4.8","6"
"Clay","2020-10-08","2","375","0","68","0","6"
"Clay","2020-10-09","1","376","0","68","0","2.4"
"Clay","2020-10-10","0","376","0","68","0","2.4"
"Clay","2020-10-11","0","376","0","68","0","2.4"
"Clay","2020-10-12","0","376","0","68","0","2.4"
"Clay","2020-10-13","3","379","0","68","0","2.4"
"Clay","2020-10-14","3","382","0","68","0","2.4"
"Clay","2020-10-15","1","383","0","68","0","0"
"Clay","2020-10-16","0","383","0","68","0","0"
"Clay","2020-10-17","1","384","0","68","0","0"
"Clay","2020-10-18","0","384","0","68","0","0"
"Clay","2020-10-19","5","389","0","68","0","0"
"Clay","2020-10-20","1","390","0","68","0","0"
"Clay","2020-10-21","1","391","0","68","0","0"
"Clay","2020-10-22","1","392","0","68","0","0"
"Clay","2020-10-23","0","392","0","68","0","0"
"Clay","2020-10-24","1","393","0","68","0","0"
"Clay","2020-10-25","0","393","0","68","0","0"
"Clay","2020-10-26","5","398","0","68","0","0"
"Clay","2020-10-27","4","402","0","68","0","0"
"Clay","2020-10-28","4","406","0","68","0","0"
"Clay","2020-10-29","1","407","0","68","0","0"
"Clay","2020-10-30","0","407","0","68","0","0"
"Clay","2020-10-31","0","407","0","68","0","0"
"Clay","2020-11-01","1","408","0","68","0","0"
"Clay","2020-11-02","3","411","0","68","0","0"
"Clay","2020-11-03","2","413","0","68","0","0"
"Clay","2020-11-04","2","415","0","68","0","0"
"Clay","2020-11-05","2","417","0","68","0","0"
"Clay","2020-11-06","0","417","0","68","0","0"
"Clay","2020-11-07","0","417","0","68","0","0"
"Clay","2020-11-08","0","417","0","68","0","0"
"Clay","2020-11-09","1","418","0","68","0","0"
"Clay","2020-11-10","4","422","0","68","0","0"
"Clay","2020-11-11","5","427","0","68","0","0"
"Clay","2020-11-12","2","429","0","68","0","0"
"Clay","2020-11-13","0","429","0","68","0","0"
"Clay","2020-11-14","0","429","0","68","0","0"
"Clay","2020-11-15","0","429","0","68","0","0"
"Clay","2020-11-16","7","436","0","68","0","0"
"Clay","2020-11-17","2","438","0","68","0","0"
"Clay","2020-11-18","0","438","0","68","0","0"
"Clay","2020-11-19","0","438","0","68","0","0"
"Clay","2020-11-20","2","440","0","68","0","0"
"Clay","2020-11-21","1","441","1","69","14.3","7.1"
"Clay","2020-11-22","1","442","0","69","14.3","7.1"
"Clay","2020-11-23","2","444","0","69","14.3","7.1"
"Clay","2020-11-24","4","448","0","69","14.3","7.1"
"Clay","2020-11-25","3","451","0","69","14.3","7.1"
"Clay","2020-11-26","0","451","0","69","14.3","7.1"
"Clay","2020-11-27","1","452","1","70","28.6","14.3"
"Clay","2020-11-28","0","452","0","70","14.3","14.3"
"Clay","2020-11-29","1","453","0","70","14.3","14.3"
"Clay","2020-11-30","5","458","0","70","14.3","14.3"
"Clay","2020-12-01","0","458","0","70","14.3","14.3"
"Clay","2020-12-02","1","459","0","70","14.3","14.3"
"Clay","2020-12-03","5","464","0","70","14.3","14.3"
"Clay","2020-12-04","3","467","1","71","4.8","16.7"
"Clay","2020-12-05","3","470","2","73","14.3","14.3"
"Clay","2020-12-06","0","470","0","73","14.3","14.3"
"Clay","2020-12-07","2","472","0","73","14.3","14.3"
"Clay","2020-12-08","6","478","3","76","21.4","17.9"
"Clay","2020-12-09","8","486","1","77","23.2","18.8"
"Clay","2020-12-10","3","489","0","77","23.2","18.8"
"Clay","2020-12-11","2","491","1","78","25.6","15.2"
"Clay","2020-12-12","0","491","0","78","16.1","15.2"
"Clay","2020-12-13","0","491","0","78","16.1","15.2"
"Clay","2020-12-14","7","498","1","79","18.1","16.2"
"Clay","2020-12-15","3","501","0","79","11","16.2"
"Clay","2020-12-16","1","502","0","79","9.2","16.2"
"Clay","2020-12-17","1","503","0","79","9.2","16.2"
"Clay","2020-12-18","1","504","0","79","2","13.8"
"Clay","2020-12-19","1","505","1","80","16.3","16.2"
"Clay","2020-12-20","1","506","1","81","30.6","23.3"
"Clay","2020-12-21","0","506","0","81","28.6","23.3"
"Clay","2020-12-22","8","514","4","85","35.7","23.3"
"Clay","2020-12-23","2","516","0","85","35.7","22.4"
"Clay","2020-12-24","0","516","0","85","35.7","22.4"
"Clay","2020-12-25","0","516","0","85","35.7","18.9"
"Clay","2020-12-26","1","517","0","85","21.4","18.9"
"Clay","2020-12-27","1","518","1","86","21.4","26"
"Clay","2020-12-28","3","521","2","88","31","29.8"
"Clay","2020-12-29","6","527","2","90","28.6","32.1"
"Clay","2020-12-30","5","532","0","90","28.6","32.1"
"Clay","2020-12-31","6","538","1","91","31","33.3"
"Clay","2021-01-01","0","538","0","91","31","33.3"
"Clay","2021-01-02","0","538","0","91","31","26.2"
"Clay","2021-01-03","1","539","0","91","16.7","19"
"Clay","2021-01-04","9","548","2","93","10.3","20.6"
"Clay","2021-01-05","7","555","3","96","11.7","20.1"
"Clay","2021-01-06","9","564","2","98","14.9","21.7"
"Clay","2021-01-07","6","570","1","99","14.9","22.9"
"Clay","2021-01-08","3","573","0","99","14.9","22.9"
"Clay","2021-01-09","1","574","0","99","14.9","22.9"
"Clay","2021-01-10","3","577","1","100","19.6","18.1"
"Clay","2021-01-11","4","581","0","100","16.4","13.4"
"Clay","2021-01-12","5","586","1","101","13.2","12.4"
"Clay","2021-01-13","2","588","1","102","17.1","16"
"Clay","2021-01-14","9","597","3","105","19.5","17.2"
"Clay","2021-01-15","9","606","1","106","21.1","18"
"Clay","2021-01-16","2","608","0","106","21.1","18"
"Clay","2021-01-17","0","608","0","106","16.3","18"
"Clay","2021-01-18","3","611","0","106","16.3","16.4"
"Clay","2021-01-19","6","617","2","108","18.3","15.7"
"Clay","2021-01-20","7","624","0","108","11.1","14.1"
"Clay","2021-01-21","11","635","1","109","7.6","13.6"
"Clay","2021-01-22","4","639","2","111","13.2","17.2"
"Clay","2021-01-23","2","641","0","111","13.2","17.2"
"Clay","2021-01-24","1","642","0","111","13.2","14.8"
"Clay","2021-01-25","1","643","0","111","13.2","14.8"
"Clay","2021-01-26","0","643","0","111","8.4","13.3"
"Clay","2021-01-27","0","643","0","111","8.4","9.8"
"Clayton","2020-02-01","0","0","0","0",".","."
"Clayton","2020-02-02","0","0","0","0",".","."
"Clayton","2020-02-03","0","0","0","0",".","."
"Clayton","2020-02-04","0","0","0","0",".","."
"Clayton","2020-02-05","0","0","0","0",".","."
"Clayton","2020-02-06","0","0","0","0",".","."
"Clayton","2020-02-07","0","0","0","0","0","."
"Clayton","2020-02-08","0","0","0","0","0","."
"Clayton","2020-02-09","0","0","0","0","0","."
"Clayton","2020-02-10","0","0","0","0","0","."
"Clayton","2020-02-11","0","0","0","0","0","."
"Clayton","2020-02-12","0","0","0","0","0","."
"Clayton","2020-02-13","0","0","0","0","0","."
"Clayton","2020-02-14","0","0","0","0","0","0"
"Clayton","2020-02-15","0","0","0","0","0","0"
"Clayton","2020-02-16","0","0","0","0","0","0"
"Clayton","2020-02-17","0","0","0","0","0","0"
"Clayton","2020-02-18","0","0","0","0","0","0"
"Clayton","2020-02-19","0","0","0","0","0","0"
"Clayton","2020-02-20","0","0","0","0","0","0"
"Clayton","2020-02-21","0","0","0","0","0","0"
"Clayton","2020-02-22","0","0","0","0","0","0"
"Clayton","2020-02-23","0","0","0","0","0","0"
"Clayton","2020-02-24","0","0","0","0","0","0"
"Clayton","2020-02-25","0","0","0","0","0","0"
"Clayton","2020-02-26","0","0","0","0","0","0"
"Clayton","2020-02-27","0","0","0","0","0","0"
"Clayton","2020-02-28","0","0","0","0","0","0"
"Clayton","2020-02-29","0","0","0","0","0","0"
"Clayton","2020-03-01","0","0","0","0","0","0"
"Clayton","2020-03-02","0","0","0","0","0","0"
"Clayton","2020-03-03","0","0","0","0","0","0"
"Clayton","2020-03-04","0","0","0","0","0","0"
"Clayton","2020-03-05","0","0","0","0","0","0"
"Clayton","2020-03-06","0","0","0","0","0","0"
"Clayton","2020-03-07","0","0","0","0","0","0"
"Clayton","2020-03-08","0","0","0","0","0","0"
"Clayton","2020-03-09","0","0","0","0","0","0"
"Clayton","2020-03-10","3","3","2","2","9.5","4.8"
"Clayton","2020-03-11","1","4","0","2","9.5","4.8"
"Clayton","2020-03-12","2","6","0","2","9.5","4.8"
"Clayton","2020-03-13","19","25","4","6","12.5","6.3"
"Clayton","2020-03-14","7","32","2","8","16.6","8.3"
"Clayton","2020-03-15","9","41","3","11","21.4","10.7"
"Clayton","2020-03-16","36","77","3","14","22.6","11.3"
"Clayton","2020-03-17","32","109","4","18","14.8","12.2"
"Clayton","2020-03-18","35","144","9","27","18.5","14"
"Clayton","2020-03-19","32","176","13","40","24.3","16.9"
"Clayton","2020-03-20","59","235","20","60","26.1","19.3"
"Clayton","2020-03-21","18","253","7","67","27.6","22.1"
"Clayton","2020-03-22","28","281","14","81","30","25.7"
"Clayton","2020-03-23","53","334","21","102","34.5","28.5"
"Clayton","2020-03-24","82","416","29","131","37.7","26.3"
"Clayton","2020-03-25","82","498","29","160","39.1","28.8"
"Clayton","2020-03-26","96","594","30","190","37.8","31"
"Clayton","2020-03-27","101","695","41","231","38.7","32.4"
"Clayton","2020-03-28","31","726","13","244","39.2","33.4"
"Clayton","2020-03-29","29","755","8","252","36","33"
"Clayton","2020-03-30","113","868","24","276","33.3","33.9"
"Clayton","2020-03-31","93","961","27","303","32.4","35.1"
"Clayton","2020-04-01","99","1060","36","339","32.6","35.8"
"Clayton","2020-04-02","91","1151","25","364","32","34.9"
"Clayton","2020-04-03","100","1251","17","381","28.7","33.7"
"Clayton","2020-04-04","21","1272","7","388","27.4","33.3"
"Clayton","2020-04-05","9","1281","3","391","28.3","32.1"
"Clayton","2020-04-06","111","1392","30","421","29.1","31.2"
"Clayton","2020-04-07","178","1570","22","443","26.7","29.6"
"Clayton","2020-04-08","122","1692","19","462","23.7","28.2"
"Clayton","2020-04-09","122","1814","22","484","22.4","27.2"
"Clayton","2020-04-10","251","2065","54","538","23","25.8"
"Clayton","2020-04-11","56","2121","5","543","19.5","23.5"
"Clayton","2020-04-12","23","2144","4","547","17.3","22.8"
"Clayton","2020-04-13","118","2262","7","554","14.2","21.7"
"Clayton","2020-04-14","153","2415","21","575","14.4","20.6"
"Clayton","2020-04-15","122","2537","16","591","14.1","18.9"
"Clayton","2020-04-16","119","2656","24","615","14.4","18.4"
"Clayton","2020-04-17","175","2831","16","631","12.6","17.8"
"Clayton","2020-04-18","84","2915","9","640","12.9","16.2"
"Clayton","2020-04-19","54","2969","5","645","11.7","14.5"
"Clayton","2020-04-20","220","3189","58","703","14.6","14.4"
"Clayton","2020-04-21","184","3373","12","715","13.6","14"
"Clayton","2020-04-22","188","3561","11","726","12.6","13.3"
"Clayton","2020-04-23","169","3730","18","744","11.2","12.8"
"Clayton","2020-04-24","224","3954","17","761","11","11.8"
"Clayton","2020-04-25","117","4071","13","774","11","12"
"Clayton","2020-04-26","61","4132","10","784","12.1","11.9"
"Clayton","2020-04-27","342","4474","112","896","13","13.8"
"Clayton","2020-04-28","263","4737","19","915","13.1","13.3"
"Clayton","2020-04-29","244","4981","12","927","12.9","12.8"
"Clayton","2020-04-30","244","5225","23","950","12.8","12"
"Clayton","2020-05-01","339","5564","53","1003","13.9","12.5"
"Clayton","2020-05-02","147","5711","11","1014","13.4","12.2"
"Clayton","2020-05-03","80","5791","5","1019","12","12"
"Clayton","2020-05-04","413","6204","20","1039","8","10.5"
"Clayton","2020-05-05","293","6497","34","1073","8.6","10.8"
"Clayton","2020-05-06","372","6869","12","1085","8.4","10.7"
"Clayton","2020-05-07","207","7076","22","1107","8.5","10.6"
"Clayton","2020-05-08","191","7267","18","1125","7.6","10.8"
"Clayton","2020-05-09","150","7417","15","1140","8","10.7"
"Clayton","2020-05-10","57","7474","5","1145","8.4","10.2"
"Clayton","2020-05-11","296","7770","17","1162","8.5","8.2"
"Clayton","2020-05-12","340","8110","10","1172","7.2","7.9"
"Clayton","2020-05-13","395","8505","33","1205","8","8.2"
"Clayton","2020-05-14","353","8858","9","1214","6.8","7.7"
"Clayton","2020-05-15","336","9194","21","1235","6.4","7"
"Clayton","2020-05-16","191","9385","27","1262","7","7.5"
"Clayton","2020-05-17","95","9480","7","1269","6.8","7.6"
"Clayton","2020-05-18","466","9946","17","1286","6.5","7.5"
"Clayton","2020-05-19","348","10294","44","1330","7.9","7.5"
"Clayton","2020-05-20","373","10667","21","1351","7.5","7.7"
"Clayton","2020-05-21","257","10924","15","1366","7.9","7.4"
"Clayton","2020-05-22","208","11132","12","1378","7.9","7.1"
"Clayton","2020-05-23","84","11216","6","1384","6.9","6.9"
"Clayton","2020-05-24","80","11296","5","1389","6.7","6.7"
"Clayton","2020-05-25","35","11331","1","1390","6.6","6.5"
"Clayton","2020-05-26","305","11636","26","1416","6","6.9"
"Clayton","2020-05-27","367","12003","22","1438","6.1","6.8"
"Clayton","2020-05-28","260","12263","20","1458","6.3","7.1"
"Clayton","2020-05-29","259","12522","21","1479","6.7","7.3"
"Clayton","2020-05-30","149","12671","14","1493","7","6.9"
"Clayton","2020-05-31","69","12740","6","1499","7.3","7"
"Clayton","2020-06-01","267","13007","13","1512","7.6","7.1"
"Clayton","2020-06-02","275","13282","34","1546","8.2","7.1"
"Clayton","2020-06-03","240","13522","13","1559","8.1","7.1"
"Clayton","2020-06-04","230","13752","11","1570","7.7","7"
"Clayton","2020-06-05","252","14004","27","1597","8","7.3"
"Clayton","2020-06-06","258","14262","10","1607","7.2","7.1"
"Clayton","2020-06-07","81","14343","7","1614","7.2","7.3"
"Clayton","2020-06-08","325","14668","27","1641","7.7","7.7"
"Clayton","2020-06-09","353","15021","19","1660","6.7","7.4"
"Clayton","2020-06-10","322","15343","22","1682","6.9","7.5"
"Clayton","2020-06-11","400","15743","31","1713","7.4","7.5"
"Clayton","2020-06-12","277","16020","28","1741","7.3","7.7"
"Clayton","2020-06-13","69","16089","7","1748","8.2","7.7"
"Clayton","2020-06-14","81","16170","12","1760","9","8.1"
"Clayton","2020-06-15","406","16576","66","1826","10.2","9"
"Clayton","2020-06-16","428","17004","34","1860","10.6","8.6"
"Clayton","2020-06-17","383","17387","56","1916","11.7","9.3"
"Clayton","2020-06-18","388","17775","61","1977","12.8","10.1"
"Clayton","2020-06-19","374","18149","60","2037","13.6","10.5"
"Clayton","2020-06-20","151","18300","37","2074","15.7","11.9"
"Clayton","2020-06-21","63","18363","8","2082","15.4","12.2"
"Clayton","2020-06-22","602","18965","102","2184","15.5","12.8"
"Clayton","2020-06-23","572","19537","106","2290","17","13.8"
"Clayton","2020-06-24","519","20056","92","2382","17.5","14.6"
"Clayton","2020-06-25","546","20602","105","2487","18","15.4"
"Clayton","2020-06-26","683","21285","109","2596","17.9","15.8"
"Clayton","2020-06-27","234","21519","62","2658","18.2","17"
"Clayton","2020-06-28","154","21673","44","2702","20.5","17.9"
"Clayton","2020-06-29","861","22534","168","2870","20.9","18.2"
"Clayton","2020-06-30","931","23465","139","3009","20.3","18.7"
"Clayton","2020-07-01","844","24309","155","3164","20.4","18.9"
"Clayton","2020-07-02","832","25141","129","3293","19.9","18.9"
"Clayton","2020-07-03","285","25426","67","3360","21","19.5"
"Clayton","2020-07-04","76","25502","17","3377","20.4","19.3"
"Clayton","2020-07-05","200","25702","37","3414","19","19.7"
"Clayton","2020-07-06","843","26545","213","3627","19.8","20.3"
"Clayton","2020-07-07","953","27498","219","3846","20.9","20.6"
"Clayton","2020-07-08","861","28359","158","4004","20.9","20.7"
"Clayton","2020-07-09","998","29357","199","4203","21.6","20.7"
"Clayton","2020-07-10","935","30292","178","4381","20.9","21"
"Clayton","2020-07-11","445","30737","95","4476","20.8","20.6"
"Clayton","2020-07-12","178","30915","27","4503","20.3","19.6"
"Clayton","2020-07-13","910","31825","206","4709","19.9","19.9"
"Clayton","2020-07-14","938","32763","217","4926","19.9","20.4"
"Clayton","2020-07-15","1036","33799","198","5124","20.1","20.5"
"Clayton","2020-07-16","917","34716","160","5284","19.7","20.6"
"Clayton","2020-07-17","856","35572","157","5441","19.6","20.3"
"Clayton","2020-07-18","433","36005","82","5523","19.3","20"
"Clayton","2020-07-19","205","36210","44","5567","20.2","20.2"
"Clayton","2020-07-20","919","37129","210","5777","20.2","20.1"
"Clayton","2020-07-21","677","37806","129","5906","19.6","19.8"
"Clayton","2020-07-22","962","38768","136","6042","18.9","19.5"
"Clayton","2020-07-23","903","39671","167","6209","19","19.4"
"Clayton","2020-07-24","991","40662","214","6423","19.5","19.6"
"Clayton","2020-07-25","457","41119","88","6511","19.6","19.4"
"Clayton","2020-07-26","139","41258","18","6529","18.3","19.2"
"Clayton","2020-07-27","940","42198","198","6727","18.1","19.1"
"Clayton","2020-07-28","696","42894","116","6843","17.7","18.7"
"Clayton","2020-07-29","884","43778","190","7033","18.8","18.8"
"Clayton","2020-07-30","750","44528","135","7168","18.7","18.9"
"Clayton","2020-07-31","953","45481","160","7328","18","18.8"
"Clayton","2020-08-01","219","45700","27","7355","17","18.3"
"Clayton","2020-08-02","125","45825","20","7375","17.5","17.9"
"Clayton","2020-08-03","854","46679","64","7439","15.5","16.8"
"Clayton","2020-08-04","864","47543","178","7617","16.1","16.9"
"Clayton","2020-08-05","865","48408","192","7809","16.2","17.5"
"Clayton","2020-08-06","807","49215","127","7936","15.9","17.3"
"Clayton","2020-08-07","887","50102","151","8087","15.9","17"
"Clayton","2020-08-08","1168","51270","50","8137","14.8","15.9"
"Clayton","2020-08-09","170","51440","21","8158","14.2","15.9"
"Clayton","2020-08-10","758","52198","122","8280","15.5","15.5"
"Clayton","2020-08-11","776","52974","80","8360","14","15.1"
"Clayton","2020-08-12","596","53570","61","8421","12.3","14.2"
"Clayton","2020-08-13","655","54225","71","8492","11.6","13.7"
"Clayton","2020-08-14","920","55145","98","8590","10.7","13.3"
"Clayton","2020-08-15","457","55602","42","8632","11.4","13.1"
"Clayton","2020-08-16","229","55831","25","8657","11.2","12.7"
"Clayton","2020-08-17","531","56362","60","8717","10.5","13"
"Clayton","2020-08-18","727","57089","70","8787","10.4","12.2"
"Clayton","2020-08-19","659","57748","70","8857","10.4","11.4"
"Clayton","2020-08-20","530","58278","49","8906","10.2","10.9"
"Clayton","2020-08-21","663","58941","75","8981","10.3","10.5"
"Clayton","2020-08-22","217","59158","9","8990","9.6","10.5"
"Clayton","2020-08-23","155","59313","14","9004","9.3","10.3"
"Clayton","2020-08-24","582","59895","65","9069","9.3","9.9"
"Clayton","2020-08-25","523","60418","42","9111","9.1","9.7"
"Clayton","2020-08-26","552","60970","46","9157","8.8","9.6"
"Clayton","2020-08-27","554","61524","46","9203","8.6","9.4"
"Clayton","2020-08-28","538","62062","42","9245","8.1","9.2"
"Clayton","2020-08-29","281","62343","22","9267","8.6","9.1"
"Clayton","2020-08-30","117","62460","11","9278","8.7","9"
"Clayton","2020-08-31","453","62913","45","9323","8.5","8.9"
"Clayton","2020-09-01","466","63379","21","9344","8","8.5"
"Clayton","2020-09-02","436","63815","35","9379","8","8.4"
"Clayton","2020-09-03","422","64237","24","9403","7.6","8.1"
"Clayton","2020-09-04","505","64742","41","9444","7.6","7.9"
"Clayton","2020-09-05","254","64996","11","9455","7.1","7.9"
"Clayton","2020-09-06","132","65128","5","9460","6.3","7.5"
"Clayton","2020-09-07","163","65291","14","9474","6.1","7.3"
"Clayton","2020-09-08","581","65872","42","9516","6.5","7.3"
"Clayton","2020-09-09","503","66375","45","9561","6.7","7.3"
"Clayton","2020-09-10","458","66833","26","9587","6.7","7.1"
"Clayton","2020-09-11","514","67347","36","9623","6.5","7.1"
"Clayton","2020-09-12","211","67558","12","9635","6.7","6.9"
"Clayton","2020-09-13","114","67672","13","9648","7.8","7.1"
"Clayton","2020-09-14","550","68222","44","9692","7.7","6.9"
"Clayton","2020-09-15","488","68710","27","9719","7.5","7"
"Clayton","2020-09-16","561","69271","22","9741","6.7","6.7"
"Clayton","2020-09-17","379","69650","14","9755","6.5","6.6"
"Clayton","2020-09-18","578","70228","29","9784","6.2","6.3"
"Clayton","2020-09-19","194","70422","17","9801","6.6","6.7"
"Clayton","2020-09-20","106","70528","7","9808","5.9","6.9"
"Clayton","2020-09-21","554","71082","30","9838","5.6","6.6"
"Clayton","2020-09-22","520","71602","30","9868","5.6","6.5"
"Clayton","2020-09-23","526","72128","33","9901","5.9","6.3"
"Clayton","2020-09-24","499","72627","20","9921","6","6.2"
"Clayton","2020-09-25","512","73139","30","9951","6.1","6.1"
"Clayton","2020-09-26","179","73318","23","9974","6.7","6.7"
"Clayton","2020-09-27","137","73455","8","9982","6.6","6.3"
"Clayton","2020-09-28","620","74075","60","10042","7.2","6.4"
"Clayton","2020-09-29","485","74560","24","10066","7.1","6.3"
"Clayton","2020-09-30","559","75119","29","10095","6.9","6.4"
"Clayton","2020-10-01","502","75621","26","10121","7.1","6.5"
"Clayton","2020-10-02","559","76180","35","10156","7.1","6.6"
"Clayton","2020-10-03","215","76395","17","10173","6.4","6.6"
"Clayton","2020-10-04","160","76555","16","10189","7","6.8"
"Clayton","2020-10-05","620","77175","41","10230","6.6","6.9"
"Clayton","2020-10-06","884","78059","41","10271","6.5","6.8"
"Clayton","2020-10-07","626","78685","34","10305","6.6","6.7"
"Clayton","2020-10-08","696","79381","39","10344","6.6","6.9"
"Clayton","2020-10-09","627","80008","58","10402","7.1","7.1"
"Clayton","2020-10-10","244","80252","18","10420","7","6.7"
"Clayton","2020-10-11","151","80403","13","10433","6.8","6.9"
"Clayton","2020-10-12","516","80919","36","10469","6.8","6.7"
"Clayton","2020-10-13","671","81590","47","10516","7.2","6.9"
"Clayton","2020-10-14","608","82198","34","10550","7.2","6.9"
"Clayton","2020-10-15","600","82798","36","10586","7.3","6.9"
"Clayton","2020-10-16","512","83310","35","10621","6.9","7"
"Clayton","2020-10-17","168","83478","12","10633","6.9","6.9"
"Clayton","2020-10-18","161","83639","17","10650","7.2","7"
"Clayton","2020-10-19","583","84222","57","10707","7.6","7.2"
"Clayton","2020-10-20","601","84823","46","10753","7.7","7.4"
"Clayton","2020-10-21","668","85491","47","10800","7.9","7.5"
"Clayton","2020-10-22","598","86089","43","10843","8","7.6"
"Clayton","2020-10-23","680","86769","71","10914","8.5","7.7"
"Clayton","2020-10-24","240","87009","25","10939","9","7.9"
"Clayton","2020-10-25","203","87212","16","10955","8.6","7.9"
"Clayton","2020-10-26","748","87960","99","11054","9.1","8.3"
"Clayton","2020-10-27","608","88568","66","11120","9.6","8.6"
"Clayton","2020-10-28","719","89287","77","11197","10.1","9"
"Clayton","2020-10-29","437","89724","27","11224","10","9"
"Clayton","2020-10-30","821","90545","101","11325","10.2","9.4"
"Clayton","2020-10-31","254","90799","25","11350","10.1","9.6"
"Clayton","2020-11-01","196","90995","32","11382","11.3","10"
"Clayton","2020-11-02","721","91716","77","11459","11","10.1"
"Clayton","2020-11-03","564","92280","59","11518","10.9","10.3"
"Clayton","2020-11-04","599","92879","84","11602","11.4","10.8"
"Clayton","2020-11-05","784","93663","51","11653","11.4","10.7"
"Clayton","2020-11-06","631","94294","77","11730","11.4","10.8"
"Clayton","2020-11-07","287","94581","32","11762","11.6","10.9"
"Clayton","2020-11-08","177","94758","22","11784","11.1","11.2"
"Clayton","2020-11-09","667","95425","86","11870","11.4","11.2"
"Clayton","2020-11-10","691","96116","62","11932","11.2","11"
"Clayton","2020-11-11","477","96593","42","11974","10.4","10.9"
"Clayton","2020-11-12","886","97479","79","12053","10.8","11.1"
"Clayton","2020-11-13","789","98268","74","12127","10.4","10.9"
"Clayton","2020-11-14","371","98639","38","12165","10.2","10.9"
"Clayton","2020-11-15","254","98893","22","12187","9.7","10.4"
"Clayton","2020-11-16","836","99729","109","12296","9.7","10.5"
"Clayton","2020-11-17","826","100555","77","12373","9.8","10.5"
"Clayton","2020-11-18","839","101394","53","12426","9.4","9.9"
"Clayton","2020-11-19","829","102223","93","12519","9.7","10.3"
"Clayton","2020-11-20","917","103140","92","12611","9.8","10.1"
"Clayton","2020-11-21","347","103487","28","12639","9.5","9.9"
"Clayton","2020-11-22","245","103732","25","12664","9.7","9.7"
"Clayton","2020-11-23","900","104632","99","12763","9.5","9.6"
"Clayton","2020-11-24","932","105564","79","12842","9.3","9.5"
"Clayton","2020-11-25","718","106282","85","12927","10.1","9.8"
"Clayton","2020-11-26","302","106584","16","12943","9.3","9.5"
"Clayton","2020-11-27","319","106903","42","12985","9.7","9.8"
"Clayton","2020-11-28","370","107273","62","13047","11","10.2"
"Clayton","2020-11-29","543","107816","48","13095","10.8","10.3"
"Clayton","2020-11-30","963","108779","157","13252","11.5","10.5"
"Clayton","2020-12-01","865","109644","138","13390","12.6","11"
"Clayton","2020-12-02","855","110499","151","13541","13.4","11.8"
"Clayton","2020-12-03","1020","111519","129","13670","14.5","11.9"
"Clayton","2020-12-04","958","112477","141","13811","14.7","12.2"
"Clayton","2020-12-05","578","113055","95","13906","14.7","12.8"
"Clayton","2020-12-06","457","113512","49","13955","14.9","12.8"
"Clayton","2020-12-07","1008","114520","184","14139","15.2","13.4"
"Clayton","2020-12-08","1158","115678","173","14312","15.1","13.8"
"Clayton","2020-12-09","1078","116756","184","14496","15","14.2"
"Clayton","2020-12-10","1096","117852","181","14677","15.5","15"
"Clayton","2020-12-11","1040","118892","188","14865","16","15.3"
"Clayton","2020-12-12","420","119312","71","14936","16.1","15.4"
"Clayton","2020-12-13","265","119577","35","14971","16.4","15.7"
"Clayton","2020-12-14","1196","120773","200","15171","16.2","15.7"
"Clayton","2020-12-15","1284","122057","224","15395","16.6","15.8"
"Clayton","2020-12-16","759","122816","82","15477","15.7","15.3"
"Clayton","2020-12-17","1351","124167","189","15666","15.3","15.4"
"Clayton","2020-12-18","1109","125276","172","15838","14.9","15.5"
"Clayton","2020-12-19","414","125690","78","15916","15.2","15.6"
"Clayton","2020-12-20","443","126133","44","15960","14.7","15.6"
"Clayton","2020-12-21","1202","127335","209","16169","14.8","15.5"
"Clayton","2020-12-22","1019","128354","180","16349","14.9","15.7"
"Clayton","2020-12-23","957","129311","151","16500","15.6","15.6"
"Clayton","2020-12-24","628","129939","74","16574","15.3","15.3"
"Clayton","2020-12-25","165","130104","31","16605","15.7","15.3"
"Clayton","2020-12-26","440","130544","91","16696","16","15.6"
"Clayton","2020-12-27","323","130867","59","16755","17.2","16"
"Clayton","2020-12-28","1246","132113","302","17057","18.2","16.5"
"Clayton","2020-12-29","1281","133394","226","17283","18.2","16.5"
"Clayton","2020-12-30","1131","134525","240","17523","18.9","17.3"
"Clayton","2020-12-31","748","135273","115","17638","19.5","17.4"
"Clayton","2021-01-01","186","135459","46","17684","20.3","18"
"Clayton","2021-01-02","564","136023","125","17809","20.5","18.3"
"Clayton","2021-01-03","233","136256","43","17852","20.5","18.9"
"Clayton","2021-01-04","813","137069","179","18031","20.2","19.2"
"Clayton","2021-01-05","1443","138512","299","18330","20.7","19.4"
"Clayton","2021-01-06","1242","139754","281","18611","20.9","19.9"
"Clayton","2021-01-07","1427","141181","311","18922","21.8","20.6"
"Clayton","2021-01-08","836","142017","142","19064","20.7","20.5"
"Clayton","2021-01-09","627","142644","111","19175","20","20.3"
"Clayton","2021-01-10","314","142958","56","19231","20","20.3"
"Clayton","2021-01-11","1002","143960","177","19408","19.3","19.8"
"Clayton","2021-01-12","1345","145305","260","19668","19.1","19.9"
"Clayton","2021-01-13","1252","146557","216","19884","18.4","19.6"
"Clayton","2021-01-14","1214","147771","204","20088","17.7","19.7"
"Clayton","2021-01-15","790","148561","130","20218","17.6","19.1"
"Clayton","2021-01-16","521","149082","108","20326","18","19"
"Clayton","2021-01-17","325","149407","51","20377","17.7","18.8"
"Clayton","2021-01-18","561","149968","78","20455","17.2","18.2"
"Clayton","2021-01-19","1254","151222","217","20672","16.9","18"
"Clayton","2021-01-20","1147","152369","204","20876","17","17.7"
"Clayton","2021-01-21","1052","153421","177","21053","17","17.3"
"Clayton","2021-01-22","988","154409","150","21203","16.8","17.2"
"Clayton","2021-01-23","354","154763","54","21257","16","17"
"Clayton","2021-01-24","248","155011","40","21297","16.1","16.9"
"Clayton","2021-01-25","638","155649","122","21419","16.8","17"
"Clayton","2021-01-26","46","155695","7","21426","16.5","16.7"
"Clayton","2021-01-27","0","155695","0","21426","14","15.5"
"Clinch","2020-02-01","0","0","0","0",".","."
"Clinch","2020-02-02","0","0","0","0",".","."
"Clinch","2020-02-03","0","0","0","0",".","."
"Clinch","2020-02-04","0","0","0","0",".","."
"Clinch","2020-02-05","0","0","0","0",".","."
"Clinch","2020-02-06","0","0","0","0",".","."
"Clinch","2020-02-07","0","0","0","0","0","."
"Clinch","2020-02-08","0","0","0","0","0","."
"Clinch","2020-02-09","0","0","0","0","0","."
"Clinch","2020-02-10","0","0","0","0","0","."
"Clinch","2020-02-11","0","0","0","0","0","."
"Clinch","2020-02-12","0","0","0","0","0","."
"Clinch","2020-02-13","0","0","0","0","0","."
"Clinch","2020-02-14","0","0","0","0","0","0"
"Clinch","2020-02-15","0","0","0","0","0","0"
"Clinch","2020-02-16","0","0","0","0","0","0"
"Clinch","2020-02-17","0","0","0","0","0","0"
"Clinch","2020-02-18","0","0","0","0","0","0"
"Clinch","2020-02-19","0","0","0","0","0","0"
"Clinch","2020-02-20","0","0","0","0","0","0"
"Clinch","2020-02-21","0","0","0","0","0","0"
"Clinch","2020-02-22","0","0","0","0","0","0"
"Clinch","2020-02-23","0","0","0","0","0","0"
"Clinch","2020-02-24","0","0","0","0","0","0"
"Clinch","2020-02-25","0","0","0","0","0","0"
"Clinch","2020-02-26","0","0","0","0","0","0"
"Clinch","2020-02-27","0","0","0","0","0","0"
"Clinch","2020-02-28","0","0","0","0","0","0"
"Clinch","2020-02-29","0","0","0","0","0","0"
"Clinch","2020-03-01","0","0","0","0","0","0"
"Clinch","2020-03-02","0","0","0","0","0","0"
"Clinch","2020-03-03","0","0","0","0","0","0"
"Clinch","2020-03-04","0","0","0","0","0","0"
"Clinch","2020-03-05","0","0","0","0","0","0"
"Clinch","2020-03-06","0","0","0","0","0","0"
"Clinch","2020-03-07","0","0","0","0","0","0"
"Clinch","2020-03-08","0","0","0","0","0","0"
"Clinch","2020-03-09","0","0","0","0","0","0"
"Clinch","2020-03-10","0","0","0","0","0","0"
"Clinch","2020-03-11","0","0","0","0","0","0"
"Clinch","2020-03-12","6","6","0","0","0","0"
"Clinch","2020-03-13","2","8","0","0","0","0"
"Clinch","2020-03-14","0","8","0","0","0","0"
"Clinch","2020-03-15","0","8","0","0","0","0"
"Clinch","2020-03-16","2","10","1","1","7.1","3.6"
"Clinch","2020-03-17","1","11","0","1","7.1","3.6"
"Clinch","2020-03-18","3","14","0","1","7.1","3.6"
"Clinch","2020-03-19","0","14","0","1","7.1","3.6"
"Clinch","2020-03-20","2","16","0","1","7.1","3.6"
"Clinch","2020-03-21","3","19","0","1","7.1","3.6"
"Clinch","2020-03-22","1","20","0","1","7.1","3.6"
"Clinch","2020-03-23","4","24","0","1","0","3.6"
"Clinch","2020-03-24","2","26","0","1","0","3.6"
"Clinch","2020-03-25","0","26","0","1","0","3.6"
"Clinch","2020-03-26","1","27","0","1","0","3.6"
"Clinch","2020-03-27","2","29","0","1","0","3.6"
"Clinch","2020-03-28","0","29","0","1","0","3.6"
"Clinch","2020-03-29","1","30","0","1","0","3.6"
"Clinch","2020-03-30","2","32","0","1","0","0"
"Clinch","2020-03-31","4","36","2","3","7.1","3.6"
"Clinch","2020-04-01","4","40","0","3","7.1","3.6"
"Clinch","2020-04-02","2","42","0","3","7.1","3.6"
"Clinch","2020-04-03","5","47","0","3","7.1","3.6"
"Clinch","2020-04-04","2","49","0","3","7.1","3.6"
"Clinch","2020-04-05","0","49","0","3","7.1","3.6"
"Clinch","2020-04-06","0","49","0","3","7.1","3.6"
"Clinch","2020-04-07","4","53","0","3","0","3.6"
"Clinch","2020-04-08","10","63","3","6","4.3","5.7"
"Clinch","2020-04-09","3","66","1","7","9","8.1"
"Clinch","2020-04-10","14","80","1","8","10.1","8.6"
"Clinch","2020-04-11","6","86","1","9","12.4","9.8"
"Clinch","2020-04-12","0","86","0","9","12.4","9.8"
"Clinch","2020-04-13","0","86","0","9","12.4","9.8"
"Clinch","2020-04-14","6","92","1","10","14.8","7.4"
"Clinch","2020-04-15","7","99","2","12","14.6","9.5"
"Clinch","2020-04-16","6","105","1","13","12.2","10.6"
"Clinch","2020-04-17","2","107","0","13","11.2","10.6"
"Clinch","2020-04-18","5","112","0","13","8.8","10.6"
"Clinch","2020-04-19","0","112","0","13","8.8","10.6"
"Clinch","2020-04-20","8","120","0","13","8.8","10.6"
"Clinch","2020-04-21","16","136","3","16","9.1","12"
"Clinch","2020-04-22","8","144","2","18","8.6","11.6"
"Clinch","2020-04-23","9","153","0","18","6.3","9.2"
"Clinch","2020-04-24","7","160","0","18","6.3","8.7"
"Clinch","2020-04-25","0","160","0","18","6.3","7.5"
"Clinch","2020-04-26","0","160","0","18","6.3","7.5"
"Clinch","2020-04-27","19","179","1","19","7","7.9"
"Clinch","2020-04-28","5","184","1","20","7.2","8.2"
"Clinch","2020-04-29","20","204","1","21","4.3","6.5"
"Clinch","2020-04-30","35","239","4","25","6","6.1"
"Clinch","2020-05-01","10","249","0","25","6","6.1"
"Clinch","2020-05-02","1","250","1","26","20.2","13.2"
"Clinch","2020-05-03","0","250","0","26","20.2","13.2"
"Clinch","2020-05-04","6","256","0","26","19.5","13.2"
"Clinch","2020-05-05","14","270","3","29","19.7","13.4"
"Clinch","2020-05-06","17","287","1","30","19.8","12.1"
"Clinch","2020-05-07","28","315","12","42","24.3","15.1"
"Clinch","2020-05-08","2","317","1","43","31.5","18.7"
"Clinch","2020-05-09","5","322","0","43","17.2","18.7"
"Clinch","2020-05-10","26","348","13","56","24.3","22.3"
"Clinch","2020-05-11","57","405","25","81","30.6","25"
"Clinch","2020-05-12","9","414","2","83","30.7","25.2"
"Clinch","2020-05-13","45","459","1","84","30.2","25"
"Clinch","2020-05-14","89","548","12","96","26","25.1"
"Clinch","2020-05-15","16","564","2","98","20.6","26"
"Clinch","2020-05-16","2","566","0","98","20.6","18.9"
"Clinch","2020-05-17","0","566","0","98","13.5","18.9"
"Clinch","2020-05-18","11","577","0","98","7.2","18.9"
"Clinch","2020-05-19","3","580","0","98","4","17.4"
"Clinch","2020-05-20","23","603","6","104","7.4","18.8"
"Clinch","2020-05-21","27","630","3","107","7.1","16.5"
"Clinch","2020-05-22","29","659","2","109","6.3","13.5"
"Clinch","2020-05-23","6","665","1","110","8.7","14.6"
"Clinch","2020-05-24","4","669","0","110","8.7","11.1"
"Clinch","2020-05-25","4","673","0","110","8.7","7.9"
"Clinch","2020-05-26","10","683","0","110","8.7","6.4"
"Clinch","2020-05-27","23","706","0","110","5","6.2"
"Clinch","2020-05-28","17","723","3","113","5.9","6.5"
"Clinch","2020-05-29","11","734","3","116","8.8","7.5"
"Clinch","2020-05-30","3","737","1","117","11.2","9.9"
"Clinch","2020-05-31","3","740","0","117","11.2","9.9"
"Clinch","2020-06-01","5","745","2","119","16.9","12.8"
"Clinch","2020-06-02","3","748","0","119","16.9","12.8"
"Clinch","2020-06-03","80","828","4","123","17.6","11.3"
"Clinch","2020-06-04","11","839","0","123","15.1","10.5"
"Clinch","2020-06-05","7","846","0","123","11.2","10"
"Clinch","2020-06-06","0","846","0","123","6.4","8.8"
"Clinch","2020-06-07","3","849","0","123","6.4","8.8"
"Clinch","2020-06-08","13","862","2","125","2.9","9.9"
"Clinch","2020-06-09","126","988","11","136","4.2","10.5"
"Clinch","2020-06-10","13","1001","0","136","3.4","10.5"
"Clinch","2020-06-11","22","1023","6","142","7.3","11.2"
"Clinch","2020-06-12","32","1055","0","142","7.3","9.3"
"Clinch","2020-06-13","5","1060","0","142","7.3","6.9"
"Clinch","2020-06-14","4","1064","1","143","10.9","8.7"
"Clinch","2020-06-15","30","1094","1","144","9.2","6.1"
"Clinch","2020-06-16","26","1120","3","147","9.6","6.9"
"Clinch","2020-06-17","16","1136","2","149","11.4","7.4"
"Clinch","2020-06-18","16","1152","5","154","11.9","9.6"
"Clinch","2020-06-19","15","1167","3","157","14.8","11.1"
"Clinch","2020-06-20","0","1167","0","157","14.8","11.1"
"Clinch","2020-06-21","5","1172","1","158","14.1","12.5"
"Clinch","2020-06-22","35","1207","12","170","18.5","13.9"
"Clinch","2020-06-23","41","1248","5","175","18.6","14.1"
"Clinch","2020-06-24","100","1348","4","179","17.4","14.4"
"Clinch","2020-06-25","23","1371","1","180","13.5","12.7"
"Clinch","2020-06-26","60","1431","5","185","11.9","13.3"
"Clinch","2020-06-27","4","1435","1","186","15.5","15.1"
"Clinch","2020-06-28","9","1444","1","187","14.2","14.1"
"Clinch","2020-06-29","63","1507","13","200","12.2","15.4"
"Clinch","2020-06-30","33","1540","2","202","11.4","15"
"Clinch","2020-07-01","29","1569","6","208","13.7","15.6"
"Clinch","2020-07-02","21","1590","2","210","14.5","14"
"Clinch","2020-07-03","13","1603","0","210","13.3","12.6"
"Clinch","2020-07-04","1","1604","0","210","9.7","12.6"
"Clinch","2020-07-05","3","1607","0","210","8.1","11.2"
"Clinch","2020-07-06","30","1637","8","218","9","10.6"
"Clinch","2020-07-07","35","1672","9","227","11.8","11.6"
"Clinch","2020-07-08","23","1695","9","236","14.4","14.1"
"Clinch","2020-07-09","19","1714","4","240","16.1","15.3"
"Clinch","2020-07-10","42","1756","12","252","20.2","16.7"
"Clinch","2020-07-11","9","1765","0","252","20.2","14.9"
"Clinch","2020-07-12","3","1768","1","253","24.9","16.5"
"Clinch","2020-07-13","56","1824","15","268","24.9","17"
"Clinch","2020-07-14","47","1871","7","275","23.4","17.6"
"Clinch","2020-07-15","29","1900","3","278","19.3","16.9"
"Clinch","2020-07-16","10","1910","1","279","17.7","16.9"
"Clinch","2020-07-17","41","1951","5","284","15.4","17.8"
"Clinch","2020-07-18","6","1957","3","287","22.5","21.3"
"Clinch","2020-07-19","9","1966","0","287","17.7","21.3"
"Clinch","2020-07-20","60","2026","5","292","15.1","20"
"Clinch","2020-07-21","4","2030","1","293","16.6","20"
"Clinch","2020-07-22","16","2046","6","299","20.4","19.9"
"Clinch","2020-07-23","28","2074","3","302","20.5","19.1"
"Clinch","2020-07-24","12","2086","3","305","22.4","18.9"
"Clinch","2020-07-25","6","2092","0","305","15.2","18.9"
"Clinch","2020-07-26","2","2094","0","305","15.2","16.5"
"Clinch","2020-07-27","30","2124","4","309","15.9","15.5"
"Clinch","2020-07-28","19","2143","2","311","13.9","15.2"
"Clinch","2020-07-29","10","2153","0","311","8.5","14.5"
"Clinch","2020-07-30","14","2167","3","314","10","15.3"
"Clinch","2020-07-31","17","2184","4","318","9.8","16.1"
"Clinch","2020-08-01","2","2186","1","319","17","16.1"
"Clinch","2020-08-02","3","2189","0","319","17","16.1"
"Clinch","2020-08-03","29","2218","5","324","17.5","16.7"
"Clinch","2020-08-04","23","2241","4","328","18.5","16.2"
"Clinch","2020-08-05","21","2262","6","334","22.6","15.6"
"Clinch","2020-08-06","15","2277","2","336","21.4","15.7"
"Clinch","2020-08-07","41","2318","9","345","21.2","15.5"
"Clinch","2020-08-08","4","2322","0","345","14.1","15.5"
"Clinch","2020-08-09","8","2330","0","345","14.1","15.5"
"Clinch","2020-08-10","42","2372","6","351","13.6","15.6"
"Clinch","2020-08-11","14","2386","4","355","15.2","16.9"
"Clinch","2020-08-12","22","2408","2","357","12.5","17.5"
"Clinch","2020-08-13","19","2427","4","361","13.6","17.5"
"Clinch","2020-08-14","19","2446","2","363","11.9","16.6"
"Clinch","2020-08-15","3","2449","2","365","21.5","17.8"
"Clinch","2020-08-16","2","2451","0","365","21.5","17.8"
"Clinch","2020-08-17","30","2481","3","368","20.8","17.2"
"Clinch","2020-08-18","20","2501","6","374","21","18.1"
"Clinch","2020-08-19","26","2527","6","380","23","17.8"
"Clinch","2020-08-20","15","2542","2","382","21.9","17.8"
"Clinch","2020-08-21","14","2556","2","384","22.5","17.2"
"Clinch","2020-08-22","4","2560","0","384","13","17.2"
"Clinch","2020-08-23","5","2565","1","385","15.8","18.6"
"Clinch","2020-08-24","26","2591","3","388","16","18.4"
"Clinch","2020-08-25","23","2614","7","395","16.1","18.6"
"Clinch","2020-08-26","21","2635","1","396","13.5","18.3"
"Clinch","2020-08-27","23","2658","3","399","13.4","17.7"
"Clinch","2020-08-28","14","2672","4","403","15.5","19"
"Clinch","2020-08-29","8","2680","5","408","24.4","18.7"
"Clinch","2020-08-30","7","2687","1","409","23.6","19.7"
"Clinch","2020-08-31","32","2719","7","416","25.1","20.6"
"Clinch","2020-09-01","16","2735","6","422","26.1","21.1"
"Clinch","2020-09-02","22","2757","0","422","25.4","19.4"
"Clinch","2020-09-03","12","2769","1","423","24.7","19.1"
"Clinch","2020-09-04","23","2792","1","424","21.3","18.4"
"Clinch","2020-09-05","4","2796","0","424","12.3","18.4"
"Clinch","2020-09-06","12","2808","3","427","13.9","18.7"
"Clinch","2020-09-07","8","2816","1","428","12.5","18.8"
"Clinch","2020-09-08","22","2838","7","435","11.7","18.9"
"Clinch","2020-09-09","20","2858","1","436","12.4","18.9"
"Clinch","2020-09-10","18","2876","2","438","12.8","18.8"
"Clinch","2020-09-11","40","2916","7","445","14.7","18"
"Clinch","2020-09-12","13","2929","2","447","16.9","14.6"
"Clinch","2020-09-13","8","2937","2","449","16.9","15.4"
"Clinch","2020-09-14","36","2973","7","456","17.9","15.2"
"Clinch","2020-09-15","16","2989","3","459","16","13.9"
"Clinch","2020-09-16","17","3006","6","465","20.4","16.4"
"Clinch","2020-09-17","16","3022","3","468","21.4","17.1"
"Clinch","2020-09-18","16","3038","2","470","20.7","17.7"
"Clinch","2020-09-19","5","3043","2","472","24.2","20.6"
"Clinch","2020-09-20","4","3047","2","474","27.8","22.4"
"Clinch","2020-09-21","17","3064","1","475","25.9","21.9"
"Clinch","2020-09-22","24","3088","1","476","23.8","19.9"
"Clinch","2020-09-23","21","3109","6","482","22.8","21.6"
"Clinch","2020-09-24","12","3121","0","482","20.2","20.8"
"Clinch","2020-09-25","23","3144","1","483","19","19.9"
"Clinch","2020-09-26","8","3152","0","483","13.3","18.8"
"Clinch","2020-09-27","4","3156","1","484","9.7","18.8"
"Clinch","2020-09-28","23","3179","4","488","11.4","18.6"
"Clinch","2020-09-29","13","3192","0","488","10.8","17.3"
"Clinch","2020-09-30","14","3206","1","489","7.7","15.3"
"Clinch","2020-10-01","13","3219","2","491","9.9","15"
"Clinch","2020-10-02","6","3225","2","493","14","16.5"
"Clinch","2020-10-03","7","3232","1","494","16.1","14.7"
"Clinch","2020-10-04","1","3233","1","495","26.8","18.3"
"Clinch","2020-10-05","15","3248","3","498","27.2","19.3"
"Clinch","2020-10-06","16","3264","0","498","27.2","19"
"Clinch","2020-10-07","16","3280","3","501","28.8","18.3"
"Clinch","2020-10-08","10","3290","0","501","26.6","18.3"
"Clinch","2020-10-09","18","3308","4","505","25","19.5"
"Clinch","2020-10-10","3","3311","0","505","23","19.5"
"Clinch","2020-10-11","4","3315","0","505","8.7","17.8"
"Clinch","2020-10-12","19","3334","1","506","6.6","16.9"
"Clinch","2020-10-13","21","3355","2","508","8","17.6"
"Clinch","2020-10-14","14","3369","1","509","6.3","17.6"
"Clinch","2020-10-15","10","3379","1","510","7.7","17.2"
"Clinch","2020-10-16","5","3384","0","510","4.6","14.8"
"Clinch","2020-10-17","66","3450","0","510","4.6","13.8"
"Clinch","2020-10-18","5","3455","1","511","7.4","8.1"
"Clinch","2020-10-19","13","3468","3","514","10","8.3"
"Clinch","2020-10-20","13","3481","4","518","13","10.5"
"Clinch","2020-10-21","13","3494","7","525","19.7","13"
"Clinch","2020-10-22","12","3506","0","525","18.2","13"
"Clinch","2020-10-23","18","3524","1","526","19","11.8"
"Clinch","2020-10-24","4","3528","1","527","22.6","13.6"
"Clinch","2020-10-25","6","3534","0","527","19.7","13.6"
"Clinch","2020-10-26","21","3555","3","530","18.5","14.2"
"Clinch","2020-10-27","11","3566","2","532","16.7","14.8"
"Clinch","2020-10-28","18","3584","7","539","14.6","17.1"
"Clinch","2020-10-29","14","3598","1","540","15.6","16.9"
"Clinch","2020-10-30","9","3607","2","542","18","18.5"
"Clinch","2020-10-31","1","3608","0","542","14.4","18.5"
"Clinch","2020-11-01","2","3610","1","543","21.5","20.6"
"Clinch","2020-11-02","13","3623","4","547","23.9","21.2"
"Clinch","2020-11-03","13","3636","1","548","22.4","19.5"
"Clinch","2020-11-04","5","3641","0","548","16.8","15.7"
"Clinch","2020-11-05","9","3650","4","552","22.2","18.9"
"Clinch","2020-11-06","12","3662","2","554","21.4","19.7"
"Clinch","2020-11-07","7","3669","2","556","25.4","19.9"
"Clinch","2020-11-08","4","3673","2","558","25.4","23.5"
"Clinch","2020-11-09","22","3695","3","561","23","23.4"
"Clinch","2020-11-10","8","3703","2","563","25.5","23.9"
"Clinch","2020-11-11","10","3713","0","563","25.5","21.2"
"Clinch","2020-11-12","10","3723","0","563","19.1","20.6"
"Clinch","2020-11-13","11","3734","0","563","16.7","19.1"
"Clinch","2020-11-14","3","3737","0","563","12.7","19.1"
"Clinch","2020-11-15","5","3742","0","563","5.5","15.5"
"Clinch","2020-11-16","14","3756","1","564","4.6","13.8"
"Clinch","2020-11-17","10","3766","0","564","1","13.2"
"Clinch","2020-11-18","9","3775","3","567","5.8","15.6"
"Clinch","2020-11-19","13","3788","1","568","6.9","13"
"Clinch","2020-11-20","11","3799","1","569","8.2","12.5"
"Clinch","2020-11-21","5","3804","0","569","8.2","10.4"
"Clinch","2020-11-22","5","3809","1","570","11","8.3"
"Clinch","2020-11-23","4","3813","0","570","10","7.3"
"Clinch","2020-11-24","16","3829","0","570","10","5.5"
"Clinch","2020-11-25","6","3835","0","570","5.3","5.5"
"Clinch","2020-11-26","1","3836","0","570","4.2","5.5"
"Clinch","2020-11-27","7","3843","0","570","2.9","5.5"
"Clinch","2020-11-28","5","3848","2","572","8.6","8.4"
"Clinch","2020-11-29","3","3851","0","572","5.7","8.4"
"Clinch","2020-11-30","15","3866","3","575","8.6","9.3"
"Clinch","2020-12-01","13","3879","1","576","9.7","9.8"
"Clinch","2020-12-02","3","3882","0","576","9.7","7.5"
"Clinch","2020-12-03","9","3891","0","576","9.7","6.9"
"Clinch","2020-12-04","9","3900","1","577","11.3","7.1"
"Clinch","2020-12-05","4","3904","1","578","9.1","8.8"
"Clinch","2020-12-06","4","3908","0","578","9.1","7.4"
"Clinch","2020-12-07","13","3921","4","582","10.7","9.6"
"Clinch","2020-12-08","8","3929","2","584","13.1","11.4"
"Clinch","2020-12-09","6","3935","0","584","13.1","11.4"
"Clinch","2020-12-10","12","3947","1","585","14.3","12"
"Clinch","2020-12-11","7","3954","0","585","12.7","12"
"Clinch","2020-12-12","7","3961","0","585","9.2","9.1"
"Clinch","2020-12-13","6","3967","3","588","16.3","12.7"
"Clinch","2020-12-14","14","3981","5","593","17","13.8"
"Clinch","2020-12-15","8","3989","1","594","15.2","14.2"
"Clinch","2020-12-16","9","3998","3","597","20","16.6"
"Clinch","2020-12-17","4","4002","0","597","18.8","16.6"
"Clinch","2020-12-18","18","4020","1","598","19.6","16.2"
"Clinch","2020-12-19","5","4025","3","601","28.2","18.7"
"Clinch","2020-12-20","6","4031","1","602","23.4","19.8"
"Clinch","2020-12-21","12","4043","3","605","21.9","19.4"
"Clinch","2020-12-22","19","4062","7","612","25.3","20.3"
"Clinch","2020-12-23","12","4074","3","615","24.2","22.1"
"Clinch","2020-12-24","7","4081","3","618","30.3","24.5"
"Clinch","2020-12-25","2","4083","2","620","43.8","31.7"
"Clinch","2020-12-26","4","4087","2","622","42.3","35.2"
"Clinch","2020-12-27","4","4091","1","623","43.5","33.5"
"Clinch","2020-12-28","27","4118","13","636","46.8","34.4"
"Clinch","2020-12-29","36","4154","11","647","45.9","35.6"
"Clinch","2020-12-30","37","4191","6","653","44.7","34.4"
"Clinch","2020-12-31","18","4209","5","658","42.5","36.4"
"Clinch","2021-01-01","2","4211","1","659","35.4","39.6"
"Clinch","2021-01-02","1","4212","0","659","28.2","35.3"
"Clinch","2021-01-03","3","4215","1","660","29.4","36.5"
"Clinch","2021-01-04","42","4257","8","668","25.3","36.1"
"Clinch","2021-01-05","31","4288","8","676","24.6","35.3"
"Clinch","2021-01-06","14","4302","4","680","26.4","35.5"
"Clinch","2021-01-07","26","4328","7","687","26.2","34.4"
"Clinch","2021-01-08","15","4343","4","691","22.9","29.1"
"Clinch","2021-01-09","4","4347","1","692","26.5","27.4"
"Clinch","2021-01-10","4","4351","1","693","25.3","27.4"
"Clinch","2021-01-11","39","4390","9","702","25.9","25.6"
"Clinch","2021-01-12","25","4415","2","704","23.3","24"
"Clinch","2021-01-13","36","4451","1","705","19.6","23"
"Clinch","2021-01-14","24","4475","3","708","17.6","21.9"
"Clinch","2021-01-15","17","4492","4","712","17.1","20"
"Clinch","2021-01-16","1","4493","1","713","27.8","27.2"
"Clinch","2021-01-17","2","4495","2","715","38.6","31.9"
"Clinch","2021-01-18","30","4525","8","723","39.1","32.5"
"Clinch","2021-01-19","22","4547","3","726","39.9","31.6"
"Clinch","2021-01-20","18","4565","7","733","45","32.3"
"Clinch","2021-01-21","24","4589","6","739","46.8","32.2"
"Clinch","2021-01-22","19","4608","4","743","46.5","31.8"
"Clinch","2021-01-23","4","4612","0","743","32.2","30"
"Clinch","2021-01-24","6","4618","2","745","22.7","30.6"
"Clinch","2021-01-25","6","4624","1","746","21.2","30.1"
"Clinch","2021-01-26","0","4624","0","746","19.3","29.6"
"Clinch","2021-01-27","0","4624","0","746","13.7","29.4"
"Cobb","2020-02-01","0","0","0","0",".","."
"Cobb","2020-02-02","0","0","0","0",".","."
"Cobb","2020-02-03","0","0","0","0",".","."
"Cobb","2020-02-04","0","0","0","0",".","."
"Cobb","2020-02-05","0","0","0","0",".","."
"Cobb","2020-02-06","0","0","0","0",".","."
"Cobb","2020-02-07","0","0","0","0","0","."
"Cobb","2020-02-08","0","0","0","0","0","."
"Cobb","2020-02-09","0","0","0","0","0","."
"Cobb","2020-02-10","0","0","0","0","0","."
"Cobb","2020-02-11","0","0","0","0","0","."
"Cobb","2020-02-12","0","0","0","0","0","."
"Cobb","2020-02-13","1","1","0","0","0","."
"Cobb","2020-02-14","0","1","0","0","0","0"
"Cobb","2020-02-15","0","1","0","0","0","0"
"Cobb","2020-02-16","0","1","0","0","0","0"
"Cobb","2020-02-17","0","1","0","0","0","0"
"Cobb","2020-02-18","0","1","0","0","0","0"
"Cobb","2020-02-19","0","1","0","0","0","0"
"Cobb","2020-02-20","0","1","0","0","0","0"
"Cobb","2020-02-21","0","1","0","0","0","0"
"Cobb","2020-02-22","0","1","0","0","0","0"
"Cobb","2020-02-23","0","1","0","0","0","0"
"Cobb","2020-02-24","0","1","0","0","0","0"
"Cobb","2020-02-25","0","1","0","0","0","0"
"Cobb","2020-02-26","0","1","0","0","0","0"
"Cobb","2020-02-27","0","1","0","0","0","0"
"Cobb","2020-02-28","0","1","0","0","0","0"
"Cobb","2020-02-29","0","1","0","0","0","0"
"Cobb","2020-03-01","0","1","0","0","0","0"
"Cobb","2020-03-02","0","1","0","0","0","0"
"Cobb","2020-03-03","0","1","0","0","0","0"
"Cobb","2020-03-04","2","3","0","0","0","0"
"Cobb","2020-03-05","0","3","0","0","0","0"
"Cobb","2020-03-06","2","5","0","0","0","0"
"Cobb","2020-03-07","2","7","0","0","0","0"
"Cobb","2020-03-08","0","7","0","0","0","0"
"Cobb","2020-03-09","14","21","0","0","0","0"
"Cobb","2020-03-10","65","86","0","0","0","0"
"Cobb","2020-03-11","78","164","2","2","0.4","0.2"
"Cobb","2020-03-12","74","238","10","12","2.3","1.1"
"Cobb","2020-03-13","53","291","18","30","7.1","3.6"
"Cobb","2020-03-14","46","337","17","47","12.4","6.2"
"Cobb","2020-03-15","40","377","9","56","15.6","7.8"
"Cobb","2020-03-16","95","472","19","75","18.5","9.2"
"Cobb","2020-03-17","119","591","32","107","22.3","11.2"
"Cobb","2020-03-18","92","683","26","133","26","13.2"
"Cobb","2020-03-19","118","801","17","150","26.1","14.2"
"Cobb","2020-03-20","121","922","30","180","24.8","16"
"Cobb","2020-03-21","35","957","10","190","23.6","18"
"Cobb","2020-03-22","42","999","14","204","25.2","20.4"
"Cobb","2020-03-23","195","1194","59","263","26.6","22.6"
"Cobb","2020-03-24","171","1365","54","317","27.3","24.8"
"Cobb","2020-03-25","278","1643","77","394","27.2","26.6"
"Cobb","2020-03-26","230","1873","59","453","28.8","27.5"
"Cobb","2020-03-27","286","2159","66","519","28.6","26.7"
"Cobb","2020-03-28","132","2291","45","564","29.4","26.5"
"Cobb","2020-03-29","119","2410","46","610","30.1","27.7"
"Cobb","2020-03-30","285","2695","78","688","29.7","28.2"
"Cobb","2020-03-31","299","2994","68","756","28.5","27.9"
"Cobb","2020-04-01","230","3224","44","800","27.2","27.2"
"Cobb","2020-04-02","220","3444","39","839","26.1","27.5"
"Cobb","2020-04-03","228","3672","31","870","24.8","26.7"
"Cobb","2020-04-04","102","3774","20","890","22.7","26"
"Cobb","2020-04-05","80","3854","10","900","19","24.5"
"Cobb","2020-04-06","287","4141","50","950","17.5","23.6"
"Cobb","2020-04-07","338","4479","52","1002","16.5","22.5"
"Cobb","2020-04-08","318","4797","30","1032","15.1","21.2"
"Cobb","2020-04-09","259","5056","37","1069","14.6","20.4"
"Cobb","2020-04-10","303","5359","42","1111","14.6","19.7"
"Cobb","2020-04-11","153","5512","12","1123","13","17.8"
"Cobb","2020-04-12","75","5587","19","1142","14.8","16.9"
"Cobb","2020-04-13","289","5876","55","1197","15","16.3"
"Cobb","2020-04-14","278","6154","36","1233","14.7","15.6"
"Cobb","2020-04-15","305","6459","31","1264","14.8","14.9"
"Cobb","2020-04-16","335","6794","39","1303","14.4","14.5"
"Cobb","2020-04-17","474","7268","55","1358","14.1","14.4"
"Cobb","2020-04-18","243","7511","18","1376","14","13.5"
"Cobb","2020-04-19","140","7651","14","1390","11.8","13.3"
"Cobb","2020-04-20","499","8150","52","1442","10.6","12.8"
"Cobb","2020-04-21","434","8584","45","1487","10.2","12.5"
"Cobb","2020-04-22","380","8964","34","1521","10.1","12.4"
"Cobb","2020-04-23","416","9380","40","1561","9.8","12.1"
"Cobb","2020-04-24","469","9849","41","1602","9.4","11.7"
"Cobb","2020-04-25","272","10121","26","1628","9.7","11.8"
"Cobb","2020-04-26","114","10235","15","1643","10.1","11"
"Cobb","2020-04-27","625","10860","88","1731","10.6","10.6"
"Cobb","2020-04-28","734","11594","55","1786","10.2","10.2"
"Cobb","2020-04-29","970","12564","44","1830","9.6","9.8"
"Cobb","2020-04-30","759","13323","39","1869","9","9.4"
"Cobb","2020-05-01","475","13798","36","1905","8.8","9.1"
"Cobb","2020-05-02","369","14167","20","1925","8.2","8.9"
"Cobb","2020-05-03","247","14414","25","1950","7.8","8.9"
"Cobb","2020-05-04","560","14974","31","1981","6.5","8.6"
"Cobb","2020-05-05","501","15475","33","2014","6.4","8.3"
"Cobb","2020-05-06","818","16293","28","2042","6.3","7.9"
"Cobb","2020-05-07","582","16875","26","2068","6.2","7.6"
"Cobb","2020-05-08","943","17818","75","2143","6.2","7.5"
"Cobb","2020-05-09","572","18390","36","2179","6.3","7.3"
"Cobb","2020-05-10","126","18516","18","2197","6.9","7.4"
"Cobb","2020-05-11","919","19435","58","2255","7","6.8"
"Cobb","2020-05-12","1002","20437","48","2303","6.8","6.6"
"Cobb","2020-05-13","1234","21671","46","2349","6.8","6.5"
"Cobb","2020-05-14","896","22567","44","2393","6.9","6.5"
"Cobb","2020-05-15","922","23489","50","2443","6.5","6.4"
"Cobb","2020-05-16","539","24028","48","2491","6.9","6.6"
"Cobb","2020-05-17","301","24329","31","2522","6.3","6.6"
"Cobb","2020-05-18","944","25273","61","2583","6.4","6.7"
"Cobb","2020-05-19","1041","26314","54","2637","6.4","6.6"
"Cobb","2020-05-20","914","27228","56","2693","6.8","6.8"
"Cobb","2020-05-21","922","28150","44","2737","6.7","6.8"
"Cobb","2020-05-22","737","28887","44","2781","6.8","6.7"
"Cobb","2020-05-23","354","29241","33","2814","6.9","6.9"
"Cobb","2020-05-24","207","29448","14","2828","6.4","6.4"
"Cobb","2020-05-25","207","29655","9","2837","6.1","6.2"
"Cobb","2020-05-26","906","30561","48","2885","6.1","6.3"
"Cobb","2020-05-27","1002","31563","41","2926","5.8","6.3"
"Cobb","2020-05-28","707","32270","37","2963","5.9","6.3"
"Cobb","2020-05-29","802","33072","55","3018","6","6.4"
"Cobb","2020-05-30","428","33500","15","3033","5.2","6"
"Cobb","2020-05-31","185","33685","7","3040","4.7","5.6"
"Cobb","2020-06-01","589","34274","41","3081","5.1","5.6"
"Cobb","2020-06-02","774","35048","33","3114","5","5.5"
"Cobb","2020-06-03","899","35947","50","3164","5.2","5.5"
"Cobb","2020-06-04","832","36779","61","3225","5.5","5.7"
"Cobb","2020-06-05","758","37537","61","3286","5.6","5.8"
"Cobb","2020-06-06","555","38092","25","3311","5.8","5.5"
"Cobb","2020-06-07","227","38319","23","3334","6.7","5.7"
"Cobb","2020-06-08","835","39154","55","3389","6.6","5.9"
"Cobb","2020-06-09","873","40027","53","3442","6.9","5.9"
"Cobb","2020-06-10","786","40813","48","3490","7","6.1"
"Cobb","2020-06-11","1042","41855","62","3552","6.8","6.1"
"Cobb","2020-06-12","848","42703","46","3598","6.4","6"
"Cobb","2020-06-13","578","43281","46","3644","6.9","6.3"
"Cobb","2020-06-14","301","43582","35","3679","7.1","6.9"
"Cobb","2020-06-15","698","44280","56","3735","7.3","7"
"Cobb","2020-06-16","1037","45317","95","3830","7.8","7.3"
"Cobb","2020-06-17","1166","46483","90","3920","8","7.5"
"Cobb","2020-06-18","1057","47540","106","4026","8.6","7.7"
"Cobb","2020-06-19","944","48484","102","4128","9.3","7.9"
"Cobb","2020-06-20","739","49223","114","4242","10.4","8.6"
"Cobb","2020-06-21","309","49532","40","4282","10.6","8.8"
"Cobb","2020-06-22","1332","50864","166","4448","11.2","9.3"
"Cobb","2020-06-23","1144","52008","171","4619","12","9.9"
"Cobb","2020-06-24","1153","53161","145","4764","12.7","10.4"
"Cobb","2020-06-25","1254","54415","160","4924","13.1","10.8"
"Cobb","2020-06-26","1497","55912","183","5107","13.3","11.3"
"Cobb","2020-06-27","1004","56916","148","5255","13.2","11.8"
"Cobb","2020-06-28","354","57270","52","5307","13.5","12"
"Cobb","2020-06-29","1672","58942","200","5507","13.4","12.3"
"Cobb","2020-06-30","1527","60469","186","5693","13","12.5"
"Cobb","2020-07-01","1641","62110","192","5885","12.9","12.8"
"Cobb","2020-07-02","1664","63774","223","6108","13","13.1"
"Cobb","2020-07-03","882","64656","128","6236","13.3","13.3"
"Cobb","2020-07-04","254","64910","32","6268","13","13.1"
"Cobb","2020-07-05","360","65270","69","6337","13.6","13.6"
"Cobb","2020-07-06","1637","66907","199","6536","13.7","13.5"
"Cobb","2020-07-07","1690","68597","232","6768","13.9","13.5"
"Cobb","2020-07-08","1709","70306","204","6972","13.9","13.4"
"Cobb","2020-07-09","2172","72478","223","7195","13.5","13.2"
"Cobb","2020-07-10","2168","74646","184","7379","12.6","13"
"Cobb","2020-07-11","1023","75669","122","7501","12.5","12.8"
"Cobb","2020-07-12","383","76052","52","7553","11.7","12.7"
"Cobb","2020-07-13","1515","77567","176","7729","11.6","12.7"
"Cobb","2020-07-14","2110","79677","220","7949","11.2","12.5"
"Cobb","2020-07-15","1518","81195","175","8124","11.1","12.5"
"Cobb","2020-07-16","1842","83037","185","8309","11.1","12.3"
"Cobb","2020-07-17","1414","84451","153","8462","11.4","12"
"Cobb","2020-07-18","748","85199","65","8527","11","11.7"
"Cobb","2020-07-19","386","85585","41","8568","10.5","11.1"
"Cobb","2020-07-20","1450","87035","169","8737","10.5","11.1"
"Cobb","2020-07-21","1247","88282","99","8836","10.2","10.7"
"Cobb","2020-07-22","1367","89649","88","8924","9.5","10.3"
"Cobb","2020-07-23","1433","91082","133","9057","9.3","10.2"
"Cobb","2020-07-24","1423","92505","100","9157","8.8","10.1"
"Cobb","2020-07-25","871","93376","74","9231","8.8","9.9"
"Cobb","2020-07-26","294","93670","16","9247","8","9.3"
"Cobb","2020-07-27","1566","95236","138","9385","7.6","9.1"
"Cobb","2020-07-28","1230","96466","102","9487","7.7","8.9"
"Cobb","2020-07-29","1745","98211","140","9627","7.9","8.7"
"Cobb","2020-07-30","1586","99797","133","9760","7.8","8.6"
"Cobb","2020-07-31","1267","101064","78","9838","7.7","8.2"
"Cobb","2020-08-01","947","102011","85","9923","7.7","8.3"
"Cobb","2020-08-02","281","102292","30","9953","8.5","8.3"
"Cobb","2020-08-03","1532","103824","119","10072","8.3","8"
"Cobb","2020-08-04","1435","105259","91","10163","8","7.9"
"Cobb","2020-08-05","1316","106575","89","10252","7.9","7.9"
"Cobb","2020-08-06","1513","108088","107","10359","7.7","7.7"
"Cobb","2020-08-07","1579","109667","103","10462","7.7","7.7"
"Cobb","2020-08-08","1068","110735","77","10539","7.5","7.6"
"Cobb","2020-08-09","368","111103","27","10566","7","7.7"
"Cobb","2020-08-10","1591","112694","93","10659","6.7","7.5"
"Cobb","2020-08-11","1488","114182","82","10741","6.6","7.3"
"Cobb","2020-08-12","1474","115656","87","10828","6.5","7.2"
"Cobb","2020-08-13","1723","117379","89","10917","6.2","6.9"
"Cobb","2020-08-14","1681","119060","70","10987","5.9","6.8"
"Cobb","2020-08-15","523","119583","36","11023","5.8","6.7"
"Cobb","2020-08-16","748","120331","56","11079","5.9","6.4"
"Cobb","2020-08-17","1051","121382","57","11136","5.8","6.3"
"Cobb","2020-08-18","1459","122841","103","11239","6","6.3"
"Cobb","2020-08-19","1376","124217","61","11300","5.8","6.1"
"Cobb","2020-08-20","1499","125716","87","11387","5.9","6.1"
"Cobb","2020-08-21","1456","127172","76","11463","6","6"
"Cobb","2020-08-22","1034","128206","45","11508","5.7","5.8"
"Cobb","2020-08-23","352","128558","30","11538","5.8","5.8"
"Cobb","2020-08-24","1484","130042","90","11628","5.9","5.9"
"Cobb","2020-08-25","1608","131650","116","11744","5.9","6"
"Cobb","2020-08-26","1304","132954","98","11842","6.4","6.1"
"Cobb","2020-08-27","1480","134434","108","11950","6.6","6.2"
"Cobb","2020-08-28","1543","135977","101","12051","6.8","6.4"
"Cobb","2020-08-29","705","136682","44","12095","7.1","6.4"
"Cobb","2020-08-30","367","137049","32","12127","7.1","6.5"
"Cobb","2020-08-31","1517","138566","83","12210","7","6.5"
"Cobb","2020-09-01","1557","140123","101","12311","6.9","6.4"
"Cobb","2020-09-02","1252","141375","79","12390","6.7","6.6"
"Cobb","2020-09-03","1534","142909","121","12511","6.8","6.7"
"Cobb","2020-09-04","1424","144333","86","12597","6.7","6.8"
"Cobb","2020-09-05","782","145115","53","12650","6.8","6.9"
"Cobb","2020-09-06","330","145445","17","12667","6.3","6.7"
"Cobb","2020-09-07","462","145907","24","12691","6.3","6.6"
"Cobb","2020-09-08","1939","147846","120","12811","6.2","6.6"
"Cobb","2020-09-09","1661","149507","87","12898","6.1","6.4"
"Cobb","2020-09-10","1444","150951","81","12979","5.7","6.3"
"Cobb","2020-09-11","1492","152443","72","13051","5.6","6.2"
"Cobb","2020-09-12","821","153264","35","13086","5.2","6"
"Cobb","2020-09-13","498","153762","20","13106","5","5.7"
"Cobb","2020-09-14","1685","155447","61","13167","4.8","5.5"
"Cobb","2020-09-15","1371","156818","70","13237","4.7","5.4"
"Cobb","2020-09-16","1595","158413","63","13300","4.5","5.3"
"Cobb","2020-09-17","1083","159496","42","13342","4.2","5"
"Cobb","2020-09-18","1416","160912","54","13396","4.1","4.8"
"Cobb","2020-09-19","939","161851","43","13439","4.1","4.7"
"Cobb","2020-09-20","317","162168","26","13465","4.7","4.9"
"Cobb","2020-09-21","1688","163856","47","13512","4.6","4.7"
"Cobb","2020-09-22","1357","165213","53","13565","4.4","4.6"
"Cobb","2020-09-23","1793","167006","47","13612","4.3","4.4"
"Cobb","2020-09-24","1535","168541","63","13675","4.3","4.3"
"Cobb","2020-09-25","1836","170377","55","13730","4.2","4.1"
"Cobb","2020-09-26","676","171053","35","13765","4.3","4.2"
"Cobb","2020-09-27","400","171453","25","13790","4","4.4"
"Cobb","2020-09-28","1481","172934","38","13828","3.9","4.3"
"Cobb","2020-09-29","1250","174184","44","13872","3.9","4.2"
"Cobb","2020-09-30","1551","175735","29","13901","3.8","4"
"Cobb","2020-10-01","1423","177158","49","13950","3.7","4"
"Cobb","2020-10-02","1354","178512","44","13994","3.7","3.9"
"Cobb","2020-10-03","779","179291","40","14034","3.7","4"
"Cobb","2020-10-04","411","179702","16","14050","3.4","3.7"
"Cobb","2020-10-05","1703","181405","61","14111","3.5","3.7"
"Cobb","2020-10-06","1599","183004","63","14174","3.6","3.7"
"Cobb","2020-10-07","1863","184867","61","14235","3.8","3.8"
"Cobb","2020-10-08","1217","186084","32","14267","3.7","3.7"
"Cobb","2020-10-09","1730","187814","56","14323","3.7","3.7"
"Cobb","2020-10-10","1017","188831","52","14375","3.7","3.7"
"Cobb","2020-10-11","451","189282","23","14398","3.8","3.6"
"Cobb","2020-10-12","1380","190662","75","14473","4.1","3.8"
"Cobb","2020-10-13","1498","192160","63","14536","4.1","3.9"
"Cobb","2020-10-14","1520","193680","68","14604","4.3","4.1"
"Cobb","2020-10-15","1233","194913","32","14636","4.3","4"
"Cobb","2020-10-16","1689","196602","63","14699","4.4","4"
"Cobb","2020-10-17","647","197249","38","14737","4.5","4.1"
"Cobb","2020-10-18","487","197736","22","14759","4.4","4.1"
"Cobb","2020-10-19","1622","199358","71","14830","4.3","4.2"
"Cobb","2020-10-20","1528","200886","60","14890","4.2","4.2"
"Cobb","2020-10-21","2265","203151","86","14976","4.1","4.2"
"Cobb","2020-10-22","1314","204465","89","15065","4.7","4.5"
"Cobb","2020-10-23","2123","206588","106","15171","4.9","4.6"
"Cobb","2020-10-24","874","207462","45","15216","4.8","4.6"
"Cobb","2020-10-25","623","208085","55","15271","5.4","4.9"
"Cobb","2020-10-26","1975","210060","93","15364","5.5","4.9"
"Cobb","2020-10-27","1891","211951","102","15466","5.7","4.9"
"Cobb","2020-10-28","2285","214236","107","15573","5.8","5"
"Cobb","2020-10-29","1190","215426","70","15643","5.7","5.2"
"Cobb","2020-10-30","2090","217516","111","15754","5.7","5.3"
"Cobb","2020-10-31","888","218404","54","15808","5.8","5.3"
"Cobb","2020-11-01","627","219031","58","15866","5.9","5.7"
"Cobb","2020-11-02","2005","221036","112","15978","6","5.7"
"Cobb","2020-11-03","1792","222828","100","16078","6.1","5.9"
"Cobb","2020-11-04","1859","224687","102","16180","6.2","6"
"Cobb","2020-11-05","1584","226271","90","16270","6.1","5.9"
"Cobb","2020-11-06","2046","228317","109","16379","6.1","5.9"
"Cobb","2020-11-07","1022","229339","99","16478","6.7","6.2"
"Cobb","2020-11-08","572","229911","64","16542","6.9","6.4"
"Cobb","2020-11-09","2294","232205","147","16689","7.1","6.5"
"Cobb","2020-11-10","2115","234320","152","16841","7.3","6.7"
"Cobb","2020-11-11","2633","236953","148","16989","7.3","6.7"
"Cobb","2020-11-12","1986","238939","133","17122","7.4","6.8"
"Cobb","2020-11-13","2366","241305","155","17277","7.6","6.9"
"Cobb","2020-11-14","1635","242940","116","17393","7.2","7"
"Cobb","2020-11-15","583","243523","69","17462","7.3","7.1"
"Cobb","2020-11-16","2847","246370","194","17656","7.4","7.2"
"Cobb","2020-11-17","2652","249022","171","17827","7.3","7.3"
"Cobb","2020-11-18","3390","252412","186","18013","7.3","7.3"
"Cobb","2020-11-19","2578","254990","158","18171","7.2","7.3"
"Cobb","2020-11-20","3180","258170","175","18346","7","7.3"
"Cobb","2020-11-21","2195","260365","113","18459","6.8","7"
"Cobb","2020-11-22","792","261157","69","18528","6.3","6.8"
"Cobb","2020-11-23","2883","264040","157","18685","6.1","6.8"
"Cobb","2020-11-24","2429","266469","160","18845","6.1","6.7"
"Cobb","2020-11-25","2703","269172","218","19063","6.5","6.9"
"Cobb","2020-11-26","294","269466","17","19080","6.5","6.8"
"Cobb","2020-11-27","1504","270970","147","19227","7.1","7.1"
"Cobb","2020-11-28","1133","272103","141","19368","8.1","7.4"
"Cobb","2020-11-29","723","272826","65","19433","8.2","7.2"
"Cobb","2020-11-30","2839","275665","285","19718","8.8","7.5"
"Cobb","2020-12-01","2921","278586","309","20027","9.4","7.8"
"Cobb","2020-12-02","3754","282340","322","20349","9.5","8"
"Cobb","2020-12-03","2549","284889","254","20603","10.1","8.3"
"Cobb","2020-12-04","2675","287564","226","20829","9.9","8.5"
"Cobb","2020-12-05","1893","289457","232","21061","9.8","9"
"Cobb","2020-12-06","664","290121","74","21135","10.1","9.1"
"Cobb","2020-12-07","3114","293235","326","21461","10.2","9.5"
"Cobb","2020-12-08","3230","296465","325","21786","10.1","9.8"
"Cobb","2020-12-09","3875","300340","334","22120","10.1","9.8"
"Cobb","2020-12-10","2945","303285","362","22482","10.5","10.3"
"Cobb","2020-12-11","3494","306779","360","22842","10.7","10.3"
"Cobb","2020-12-12","2126","308905","254","23096","10.7","10.3"
"Cobb","2020-12-13","673","309578","106","23202","11.3","10.7"
"Cobb","2020-12-14","3384","312962","433","23635","11.7","10.9"
"Cobb","2020-12-15","3585","316547","446","24081","12","11.1"
"Cobb","2020-12-16","3962","320509","396","24477","12.2","11.2"
"Cobb","2020-12-17","3835","324344","400","24877","12","11.2"
"Cobb","2020-12-18","3717","328061","417","25294","12.1","11.4"
"Cobb","2020-12-19","2547","330608","279","25573","11.9","11.3"
"Cobb","2020-12-20","800","331408","113","25686","11.7","11.5"
"Cobb","2020-12-21","4573","335981","557","26243","11.6","11.7"
"Cobb","2020-12-22","4269","340250","571","26814","11.8","11.9"
"Cobb","2020-12-23","3855","344105","427","27241","11.9","12.1"
"Cobb","2020-12-24","1232","345337","198","27439","12.7","12.3"
"Cobb","2020-12-25","343","345680","47","27486","13.1","12.6"
"Cobb","2020-12-26","1818","347498","358","27844","14.3","13.1"
"Cobb","2020-12-27","864","348362","147","27991","14.7","13.2"
"Cobb","2020-12-28","3943","352305","729","28720","15.6","13.6"
"Cobb","2020-12-29","3696","356001","649","29369","16.2","14"
"Cobb","2020-12-30","4388","360389","761","30130","17.1","14.5"
"Cobb","2020-12-31","2557","362946","411","30541","17.1","14.9"
"Cobb","2021-01-01","456","363402","85","30626","17.8","15.4"
"Cobb","2021-01-02","2493","365895","449","31075","17.6","16"
"Cobb","2021-01-03","913","366808","146","31221","17.4","16.1"
"Cobb","2021-01-04","4073","370881","638","31859","17","16.3"
"Cobb","2021-01-05","5283","376164","849","32708","16.8","16.5"
"Cobb","2021-01-06","5369","381533","805","33513","16.5","16.8"
"Cobb","2021-01-07","3790","385323","739","34252","17","17.1"
"Cobb","2021-01-08","3180","388503","525","34777","16.7","17.3"
"Cobb","2021-01-09","2552","391055","405","35182","16.4","17"
"Cobb","2021-01-10","866","391921","182","35364","17.1","17.3"
"Cobb","2021-01-11","3693","395614","502","35866","16.8","16.9"
"Cobb","2021-01-12","3328","398942","465","36331","16.5","16.7"
"Cobb","2021-01-13","4087","403029","555","36886","16.3","16.4"
"Cobb","2021-01-14","3292","406321","437","37323","15.4","16.2"
"Cobb","2021-01-15","2841","409162","404","37727","15.1","15.9"
"Cobb","2021-01-16","2417","411579","420","38147","15.3","15.8"
"Cobb","2021-01-17","970","412549","177","38324","14.9","16"
"Cobb","2021-01-18","2480","415029","353","38677","15","15.9"
"Cobb","2021-01-19","3423","418452","454","39131","14.9","15.7"
"Cobb","2021-01-20","3693","422145","432","39563","14.6","15.5"
"Cobb","2021-01-21","2647","424792","369","39932","14.7","15.1"
"Cobb","2021-01-22","2785","427577","346","40278","14.5","14.8"
"Cobb","2021-01-23","2165","429742","339","40617","14.2","14.7"
"Cobb","2021-01-24","537","430279","79","40696","13.7","14.3"
"Cobb","2021-01-25","1106","431385","165","40861","13.8","14.4"
"Cobb","2021-01-26","105","431490","13","40874","13.7","14.3"
"Cobb","2021-01-27","0","431490","0","40874","12","13.3"
"Coffee","2020-02-01","0","0","0","0",".","."
"Coffee","2020-02-02","0","0","0","0",".","."
"Coffee","2020-02-03","0","0","0","0",".","."
"Coffee","2020-02-04","0","0","0","0",".","."
"Coffee","2020-02-05","0","0","0","0",".","."
"Coffee","2020-02-06","0","0","0","0",".","."
"Coffee","2020-02-07","0","0","0","0","0","."
"Coffee","2020-02-08","0","0","0","0","0","."
"Coffee","2020-02-09","0","0","0","0","0","."
"Coffee","2020-02-10","0","0","0","0","0","."
"Coffee","2020-02-11","0","0","0","0","0","."
"Coffee","2020-02-12","0","0","0","0","0","."
"Coffee","2020-02-13","0","0","0","0","0","."
"Coffee","2020-02-14","0","0","0","0","0","0"
"Coffee","2020-02-15","0","0","0","0","0","0"
"Coffee","2020-02-16","0","0","0","0","0","0"
"Coffee","2020-02-17","0","0","0","0","0","0"
"Coffee","2020-02-18","0","0","0","0","0","0"
"Coffee","2020-02-19","0","0","0","0","0","0"
"Coffee","2020-02-20","0","0","0","0","0","0"
"Coffee","2020-02-21","0","0","0","0","0","0"
"Coffee","2020-02-22","0","0","0","0","0","0"
"Coffee","2020-02-23","0","0","0","0","0","0"
"Coffee","2020-02-24","0","0","0","0","0","0"
"Coffee","2020-02-25","0","0","0","0","0","0"
"Coffee","2020-02-26","0","0","0","0","0","0"
"Coffee","2020-02-27","0","0","0","0","0","0"
"Coffee","2020-02-28","0","0","0","0","0","0"
"Coffee","2020-02-29","0","0","0","0","0","0"
"Coffee","2020-03-01","0","0","0","0","0","0"
"Coffee","2020-03-02","0","0","0","0","0","0"
"Coffee","2020-03-03","0","0","0","0","0","0"
"Coffee","2020-03-04","0","0","0","0","0","0"
"Coffee","2020-03-05","0","0","0","0","0","0"
"Coffee","2020-03-06","0","0","0","0","0","0"
"Coffee","2020-03-07","0","0","0","0","0","0"
"Coffee","2020-03-08","0","0","0","0","0","0"
"Coffee","2020-03-09","0","0","0","0","0","0"
"Coffee","2020-03-10","0","0","0","0","0","0"
"Coffee","2020-03-11","0","0","0","0","0","0"
"Coffee","2020-03-12","2","2","0","0","0","0"
"Coffee","2020-03-13","3","5","0","0","0","0"
"Coffee","2020-03-14","0","5","0","0","0","0"
"Coffee","2020-03-15","1","6","0","0","0","0"
"Coffee","2020-03-16","2","8","0","0","0","0"
"Coffee","2020-03-17","6","14","0","0","0","0"
"Coffee","2020-03-18","6","20","1","1","2.4","1.2"
"Coffee","2020-03-19","8","28","1","2","4.2","2.1"
"Coffee","2020-03-20","12","40","0","2","4.2","2.1"
"Coffee","2020-03-21","1","41","0","2","4.2","2.1"
"Coffee","2020-03-22","2","43","0","2","4.2","2.1"
"Coffee","2020-03-23","19","62","1","3","4.9","2.5"
"Coffee","2020-03-24","20","82","3","6","7.1","3.5"
"Coffee","2020-03-25","17","99","1","7","5.5","4"
"Coffee","2020-03-26","26","125","6","13","7","5.6"
"Coffee","2020-03-27","17","142","3","16","9.6","6.9"
"Coffee","2020-03-28","8","150","4","20","16.7","10.4"
"Coffee","2020-03-29","10","160","2","22","19.6","11.9"
"Coffee","2020-03-30","27","187","4","26","20.9","12.9"
"Coffee","2020-03-31","24","211","3","29","20.6","13.8"
"Coffee","2020-04-01","28","239","7","36","23.3","14.4"
"Coffee","2020-04-02","21","260","5","41","23.4","15.2"
"Coffee","2020-04-03","20","280","5","46","24.4","17"
"Coffee","2020-04-04","0","280","0","46","17.3","17"
"Coffee","2020-04-05","1","281","0","46","14.4","17"
"Coffee","2020-04-06","18","299","5","51","16.3","18.6"
"Coffee","2020-04-07","24","323","1","52","15.1","17.8"
"Coffee","2020-04-08","30","353","5","57","13.9","18.6"
"Coffee","2020-04-09","25","378","1","58","11.1","17.2"
"Coffee","2020-04-10","13","391","2","60","9.7","17.1"
"Coffee","2020-04-11","7","398","2","62","13.8","15.5"
"Coffee","2020-04-12","11","409","0","62","13.8","14.1"
"Coffee","2020-04-13","23","432","9","71","15.4","15.9"
"Coffee","2020-04-14","28","460","2","73","15.8","15.5"
"Coffee","2020-04-15","29","489","1","74","14","13.9"
"Coffee","2020-04-16","51","540","9","83","15.9","13.5"
"Coffee","2020-04-17","46","586","2","85","14.3","12"
"Coffee","2020-04-18","18","604","3","88","12.6","13.2"
"Coffee","2020-04-19","8","612","3","91","18","15.9"
"Coffee","2020-04-20","81","693","9","100","14","14.7"
"Coffee","2020-04-21","57","750","11","111","15.7","15.8"
"Coffee","2020-04-22","50","800","4","115","16.4","15.2"
"Coffee","2020-04-23","43","843","6","121","15.8","15.9"
"Coffee","2020-04-24","36","879","5","126","17.2","15.8"
"Coffee","2020-04-25","15","894","3","129","17.7","15.2"
"Coffee","2020-04-26","8","902","2","131","15.9","16.9"
"Coffee","2020-04-27","41","943","8","139","17.1","15.5"
"Coffee","2020-04-28","56","999","9","148","16.6","16.2"
"Coffee","2020-04-29","44","1043","6","154","17.4","16.9"
"Coffee","2020-04-30","76","1119","5","159","16.4","16.1"
"Coffee","2020-05-01","25","1144","2","161","15.5","16.4"
"Coffee","2020-05-02","30","1174","6","167","15.5","16.6"
"Coffee","2020-05-03","17","1191","0","167","12","13.9"
"Coffee","2020-05-04","85","1276","5","172","10","13.6"
"Coffee","2020-05-05","51","1327","6","178","9.4","13"
"Coffee","2020-05-06","103","1430","5","183","8.2","12.8"
"Coffee","2020-05-07","48","1478","4","187","8.4","12.4"
"Coffee","2020-05-08","51","1529","5","192","8.7","12.1"
"Coffee","2020-05-09","29","1558","0","192","5.8","10.7"
"Coffee","2020-05-10","7","1565","2","194","9.9","10.9"
"Coffee","2020-05-11","52","1617","5","199","10.4","10.2"
"Coffee","2020-05-12","141","1758","9","208","9.7","9.5"
"Coffee","2020-05-13","168","1926","7","215","9.6","8.9"
"Coffee","2020-05-14","148","2074","16","231","9.9","9.2"
"Coffee","2020-05-15","4","2078","0","231","8.5","8.6"
"Coffee","2020-05-16","60","2138","8","239","10.4","8.1"
"Coffee","2020-05-17","17","2155","1","240","7.2","8.5"
"Coffee","2020-05-18","85","2240","23","263","9.7","10"
"Coffee","2020-05-19","94","2334","4","267","9.4","9.5"
"Coffee","2020-05-20","8","2342","1","268","10.5","10.1"
"Coffee","2020-05-21","99","2441","6","274","9.9","9.9"
"Coffee","2020-05-22","52","2493","4","278","11","9.7"
"Coffee","2020-05-23","11","2504","0","278","9.1","9.7"
"Coffee","2020-05-24","8","2512","0","278","8.2","7.7"
"Coffee","2020-05-25","11","2523","1","279","5.7","7.7"
"Coffee","2020-05-26","42","2565","2","281","5.7","7.5"
"Coffee","2020-05-27","59","2624","5","286","5.2","7.9"
"Coffee","2020-05-28","171","2795","9","295","5","7.5"
"Coffee","2020-05-29","65","2860","3","298","4.6","7.8"
"Coffee","2020-05-30","8","2868","0","298","4.6","6.8"
"Coffee","2020-05-31","48","2916","6","304","6.4","7.3"
"Coffee","2020-06-01","124","3040","13","317","6.6","6.1"
"Coffee","2020-06-02","65","3105","5","322","7","6.4"
"Coffee","2020-06-03","126","3231","16","338","7.6","6.4"
"Coffee","2020-06-04","123","3354","20","358","9.2","7.1"
"Coffee","2020-06-05","110","3464","7","365","9.4","7"
"Coffee","2020-06-06","87","3551","11","376","11.2","7.9"
"Coffee","2020-06-07","5","3556","3","379","18","12.2"
"Coffee","2020-06-08","106","3662","10","389","17.9","12.2"
"Coffee","2020-06-09","95","3757","11","400","18.4","12.7"
"Coffee","2020-06-10","78","3835","10","410","18.4","13"
"Coffee","2020-06-11","131","3966","23","433","18.6","13.9"
"Coffee","2020-06-12","236","4202","15","448","18.6","14"
"Coffee","2020-06-13","18","4220","3","451","19.2","15.2"
"Coffee","2020-06-14","61","4281","7","458","12.3","15.1"
"Coffee","2020-06-15","175","4456","25","483","13","15.4"
"Coffee","2020-06-16","195","4651","13","496","12.3","15.3"
"Coffee","2020-06-17","176","4827","35","531","13.3","15.9"
"Coffee","2020-06-18","198","5025","21","552","12.3","15.5"
"Coffee","2020-06-19","149","5174","21","573","13.4","16"
"Coffee","2020-06-20","82","5256","15","588","13.6","16.4"
"Coffee","2020-06-21","13","5269","2","590","14.2","13.2"
"Coffee","2020-06-22","200","5469","48","638","15.6","14.3"
"Coffee","2020-06-23","230","5699","14","652","15.5","13.9"
"Coffee","2020-06-24","321","6020","46","698","14.7","14"
"Coffee","2020-06-25","115","6135","25","723","16.3","14.3"
"Coffee","2020-06-26","205","6340","21","744","15.7","14.6"
"Coffee","2020-06-27","104","6444","17","761","15.4","14.5"
"Coffee","2020-06-28","16","6460","6","767","18.6","16.4"
"Coffee","2020-06-29","185","6645","27","794","17.3","16.4"
"Coffee","2020-06-30","252","6897","30","824","18.1","16.8"
"Coffee","2020-07-01","39","6936","11","835","20.1","17.4"
"Coffee","2020-07-02","153","7089","20","855","18.8","17.6"
"Coffee","2020-07-03","141","7230","19","874","19.3","17.5"
"Coffee","2020-07-04","22","7252","6","880","20.9","18.2"
"Coffee","2020-07-05","12","7264","8","888","25","21.8"
"Coffee","2020-07-06","237","7501","54","942","26.2","21.7"
"Coffee","2020-07-07","147","7648","20","962","26.4","22.3"
"Coffee","2020-07-08","164","7812","19","981","24.1","22.1"
"Coffee","2020-07-09","223","8035","26","1007","23.9","21.4"
"Coffee","2020-07-10","48","8083","13","1020","25.8","22.6"
"Coffee","2020-07-11","106","8189","12","1032","23.5","22.2"
"Coffee","2020-07-12","23","8212","6","1038","17.7","21.4"
"Coffee","2020-07-13","148","8360","39","1077","18.2","22.2"
"Coffee","2020-07-14","165","8525","26","1103","18.5","22.5"
"Coffee","2020-07-15","33","8558","10","1113","21.2","22.6"
"Coffee","2020-07-16","196","8754","25","1138","21.4","22.6"
"Coffee","2020-07-17","37","8791","7","1145","20.2","23"
"Coffee","2020-07-18","72","8863","17","1162","22","22.7"
"Coffee","2020-07-19","21","8884","10","1172","25","21.4"
"Coffee","2020-07-20","217","9101","31","1203","23.3","20.8"
"Coffee","2020-07-21","258","9359","26","1229","22.5","20.5"
"Coffee","2020-07-22","105","9464","9","1238","19.4","20.3"
"Coffee","2020-07-23","230","9694","20","1258","18.8","20.1"
"Coffee","2020-07-24","25","9719","4","1262","18.4","19.3"
"Coffee","2020-07-25","133","9852","22","1284","17.4","19.7"
"Coffee","2020-07-26","19","9871","6","1290","15.1","20.1"
"Coffee","2020-07-27","162","10033","34","1324","16.1","19.7"
"Coffee","2020-07-28","187","10220","19","1343","16.1","19.3"
"Coffee","2020-07-29","110","10330","21","1364","17.6","18.5"
"Coffee","2020-07-30","144","10474","11","1375","17.4","18.1"
"Coffee","2020-07-31","23","10497","4","1379","17.6","18"
"Coffee","2020-08-01","140","10637","25","1404","17.8","17.6"
"Coffee","2020-08-02","10","10647","2","1406","16.2","15.6"
"Coffee","2020-08-03","178","10825","36","1442","16.1","16.1"
"Coffee","2020-08-04","151","10976","25","1467","17","16.5"
"Coffee","2020-08-05","126","11102","8","1475","15.1","16.4"
"Coffee","2020-08-06","136","11238","13","1488","15.4","16.4"
"Coffee","2020-08-07","35","11273","10","1498","17","17.3"
"Coffee","2020-08-08","208","11481","43","1541","17.4","17.6"
"Coffee","2020-08-09","14","11495","4","1545","18.6","17.4"
"Coffee","2020-08-10","144","11639","20","1565","17.7","16.9"
"Coffee","2020-08-11","175","11814","28","1593","17.7","17.3"
"Coffee","2020-08-12","130","11944","18","1611","18.7","16.9"
"Coffee","2020-08-13","135","12079","13","1624","18.7","17.1"
"Coffee","2020-08-14","28","12107","4","1628","16.7","16.9"
"Coffee","2020-08-15","9","12116","0","1628","13.7","15.6"
"Coffee","2020-08-16","127","12243","23","1651","12.3","15.4"
"Coffee","2020-08-17","45","12288","11","1662","13.8","15.7"
"Coffee","2020-08-18","158","12446","34","1696","14.5","16.1"
"Coffee","2020-08-19","99","12545","14","1710","14.6","16.7"
"Coffee","2020-08-20","138","12683","16","1726","14.9","16.8"
"Coffee","2020-08-21","28","12711","3","1729","14.4","15.5"
"Coffee","2020-08-22","107","12818","9","1738","15.6","14.7"
"Coffee","2020-08-23","10","12828","3","1741","17.3","14.8"
"Coffee","2020-08-24","156","12984","25","1766","16.1","14.9"
"Coffee","2020-08-25","131","13115","10","1776","14.1","14.3"
"Coffee","2020-08-26","144","13259","14","1790","13.4","14"
"Coffee","2020-08-27","102","13361","6","1796","12.6","13.7"
"Coffee","2020-08-28","24","13385","1","1797","11.7","13"
"Coffee","2020-08-29","113","13498","14","1811","12.3","13.9"
"Coffee","2020-08-30","9","13507","2","1813","11.1","14.2"
"Coffee","2020-08-31","168","13675","23","1836","10.8","13.4"
"Coffee","2020-09-01","149","13824","10","1846","10.7","12.4"
"Coffee","2020-09-02","144","13968","10","1856","10.3","11.9"
"Coffee","2020-09-03","128","14096","17","1873","11.3","12"
"Coffee","2020-09-04","20","14116","1","1874","11.5","11.6"
"Coffee","2020-09-05","127","14243","10","1884","10.8","11.5"
"Coffee","2020-09-06","5","14248","2","1886","13.4","12.3"
"Coffee","2020-09-07","61","14309","6","1892","12.8","11.8"
"Coffee","2020-09-08","137","14446","18","1910","13.7","12.2"
"Coffee","2020-09-09","107","14553","19","1929","15.3","12.8"
"Coffee","2020-09-10","82","14635","7","1936","14.6","13"
"Coffee","2020-09-11","29","14664","0","1936","13.9","12.7"
"Coffee","2020-09-12","96","14760","4","1940","13.3","12.1"
"Coffee","2020-09-13","7","14767","3","1943","13.8","13.6"
"Coffee","2020-09-14","144","14911","14","1957","13.7","13.3"
"Coffee","2020-09-15","154","15065","9","1966","12.7","13.2"
"Coffee","2020-09-16","94","15159","10","1976","11.7","13.5"
"Coffee","2020-09-17","29","15188","1","1977","11","12.8"
"Coffee","2020-09-18","27","15215","7","1984","14.7","14.3"
"Coffee","2020-09-19","105","15320","18","2002","16.5","14.9"
"Coffee","2020-09-20","9","15329","1","2003","12","12.9"
"Coffee","2020-09-21","83","15412","10","2013","12.3","13"
"Coffee","2020-09-22","85","15497","11","2024","13.3","13"
"Coffee","2020-09-23","84","15581","6","2030","12.8","12.3"
"Coffee","2020-09-24","85","15666","8","2038","13.7","12.3"
"Coffee","2020-09-25","13","15679","1","2039","11.1","12.9"
"Coffee","2020-09-26","64","15743","2","2041","9.1","12.8"
"Coffee","2020-09-27","4","15747","1","2042","11.1","11.5"
"Coffee","2020-09-28","93","15840","14","2056","11.5","11.9"
"Coffee","2020-09-29","71","15911","2","2058","10","11.7"
"Coffee","2020-09-30","78","15989","4","2062","9.7","11.3"
"Coffee","2020-10-01","91","16080","5","2067","9.2","11.4"
"Coffee","2020-10-02","20","16100","1","2068","8.8","9.9"
"Coffee","2020-10-03","41","16141","3","2071","9.4","9.2"
"Coffee","2020-10-04","19","16160","2","2073","7.3","9.2"
"Coffee","2020-10-05","141","16301","12","2085","6.4","8.9"
"Coffee","2020-10-06","110","16411","3","2088","6.4","8.2"
"Coffee","2020-10-07","96","16507","8","2096","6.8","8.3"
"Coffee","2020-10-08","83","16590","1","2097","6.2","7.7"
"Coffee","2020-10-09","55","16645","0","2097","5.5","7.2"
"Coffee","2020-10-10","61","16706","10","2107","6.8","8.1"
"Coffee","2020-10-11","1","16707","0","2107","5.3","6.3"
"Coffee","2020-10-12","48","16755","2","2109","4.7","5.5"
"Coffee","2020-10-13","95","16850","6","2115","5.2","5.8"
"Coffee","2020-10-14","87","16937","7","2122","5.2","6"
"Coffee","2020-10-15","60","16997","1","2123","5.2","5.7"
"Coffee","2020-10-16","8","17005","1","2124","7","6.3"
"Coffee","2020-10-17","69","17074","3","2127","5.3","6.1"
"Coffee","2020-10-18","5","17079","0","2127","5.3","5.3"
"Coffee","2020-10-19","88","17167","8","2135","6","5.3"
"Coffee","2020-10-20","119","17286","10","2145","6.3","5.7"
"Coffee","2020-10-21","85","17371","5","2150","6","5.6"
"Coffee","2020-10-22","73","17444","7","2157","7.1","6.2"
"Coffee","2020-10-23","22","17466","1","2158","6","6.5"
"Coffee","2020-10-24","78","17544","10","2168","7.2","6.2"
"Coffee","2020-10-25","9","17553","1","2169","8.8","7"
"Coffee","2020-10-26","106","17659","10","2179","8.8","7.4"
"Coffee","2020-10-27","85","17744","12","2191","9.6","8"
"Coffee","2020-10-28","70","17814","5","2196","9.8","7.9"
"Coffee","2020-10-29","69","17883","5","2201","9.5","8.3"
"Coffee","2020-10-30","21","17904","2","2203","10.2","8.1"
"Coffee","2020-10-31","76","17980","7","2210","9.7","8.4"
"Coffee","2020-11-01","9","17989","3","2213","12.9","10.8"
"Coffee","2020-11-02","82","18071","10","2223","13.3","11"
"Coffee","2020-11-03","32","18103","6","2229","13.9","11.8"
"Coffee","2020-11-04","101","18204","18","2247","15.4","12.6"
"Coffee","2020-11-05","95","18299","8","2255","15.6","12.5"
"Coffee","2020-11-06","30","18329","7","2262","17.6","13.9"
"Coffee","2020-11-07","56","18385","8","2270","18.3","14"
"Coffee","2020-11-08","8","18393","4","2274","20.7","16.8"
"Coffee","2020-11-09","68","18461","9","2283","20.8","17"
"Coffee","2020-11-10","33","18494","1","2284","18.6","16.3"
"Coffee","2020-11-11","88","18582","13","2297","18.2","16.8"
"Coffee","2020-11-12","104","18686","11","2308","18.5","17"
"Coffee","2020-11-13","22","18708","6","2314","19","18.3"
"Coffee","2020-11-14","98","18806","19","2333","19.8","19"
"Coffee","2020-11-15","5","18811","3","2336","21.2","20.9"
"Coffee","2020-11-16","60","18871","11","2347","21.9","21.4"
"Coffee","2020-11-17","54","18925","4","2351","22.5","20.6"
"Coffee","2020-11-18","144","19069","13","2364","21.7","19.9"
"Coffee","2020-11-19","98","19167","9","2373","21.5","20"
"Coffee","2020-11-20","25","19192","1","2374","18.2","18.6"
"Coffee","2020-11-21","139","19331","22","2396","17.7","18.7"
"Coffee","2020-11-22","16","19347","4","2400","12.7","16.9"
"Coffee","2020-11-23","114","19461","22","2422","12.8","17.4"
"Coffee","2020-11-24","28","19489","6","2428","14.8","18.7"
"Coffee","2020-11-25","117","19606","19","2447","15.9","18.8"
"Coffee","2020-11-26","7","19613","2","2449","18.6","20.1"
"Coffee","2020-11-27","27","19640","6","2455","21.2","19.7"
"Coffee","2020-11-28","97","19737","23","2478","22.4","20"
"Coffee","2020-11-29","17","19754","8","2486","25.5","19.1"
"Coffee","2020-11-30","182","19936","48","2534","26.5","19.7"
"Coffee","2020-12-01","55","19991","10","2544","26.1","20.4"
"Coffee","2020-12-02","208","20199","38","2582","26.3","21.1"
"Coffee","2020-12-03","175","20374","37","2619","25.3","22"
"Coffee","2020-12-04","32","20406","9","2628","26.1","23.7"
"Coffee","2020-12-05","98","20504","27","2655","26.7","24.5"
"Coffee","2020-12-06","16","20520","4","2659","23.5","24.5"
"Coffee","2020-12-07","208","20728","25","2684","21.5","24"
"Coffee","2020-12-08","67","20795","10","2694","21","23.5"
"Coffee","2020-12-09","203","20998","38","2732","21.1","23.7"
"Coffee","2020-12-10","237","21235","34","2766","20.1","22.7"
"Coffee","2020-12-11","40","21275","11","2777","20","23.1"
"Coffee","2020-12-12","202","21477","30","2807","18.2","22.4"
"Coffee","2020-12-13","23","21500","5","2812","17.7","20.6"
"Coffee","2020-12-14","246","21746","46","2858","18.7","20.1"
"Coffee","2020-12-15","52","21798","14","2872","20.4","20.7"
"Coffee","2020-12-16","257","22055","47","2919","20.3","20.7"
"Coffee","2020-12-17","211","22266","27","2946","20.1","20.1"
"Coffee","2020-12-18","34","22300","7","2953","19.1","19.6"
"Coffee","2020-12-19","187","22487","31","2984","19.4","18.8"
"Coffee","2020-12-20","26","22513","10","2994","21.8","19.7"
"Coffee","2020-12-21","156","22669","34","3028","22.2","20.4"
"Coffee","2020-12-22","48","22717","14","3042","22.5","21.5"
"Coffee","2020-12-23","217","22934","58","3100","23.7","22"
"Coffee","2020-12-24","36","22970","12","3112","26.7","23.4"
"Coffee","2020-12-25","4","22974","2","3114","30.9","25"
"Coffee","2020-12-26","107","23081","27","3141","32.1","25.7"
"Coffee","2020-12-27","13","23094","9","3150","36.5","29.1"
"Coffee","2020-12-28","168","23262","34","3184","36.3","29.2"
"Coffee","2020-12-29","79","23341","19","3203","35.5","29"
"Coffee","2020-12-30","264","23605","58","3261","34.9","29.3"
"Coffee","2020-12-31","74","23679","23","3284","34.5","30.6"
"Coffee","2021-01-01","4","23683","0","3284","27.4","29.1"
"Coffee","2021-01-02","151","23834","41","3325","27.7","29.9"
"Coffee","2021-01-03","5","23839","1","3326","20.6","28.6"
"Coffee","2021-01-04","267","24106","62","3388","21.1","28.7"
"Coffee","2021-01-05","118","24224","34","3422","21.7","28.6"
"Coffee","2021-01-06","271","24495","41","3463","20.8","27.8"
"Coffee","2021-01-07","200","24695","29","3492","18.4","26.5"
"Coffee","2021-01-08","53","24748","11","3503","21.4","24.4"
"Coffee","2021-01-09","210","24958","26","3529","19.3","23.5"
"Coffee","2021-01-10","26","24984","4","3533","18.6","19.6"
"Coffee","2021-01-11","63","25047","14","3547","18.5","19.8"
"Coffee","2021-01-12","97","25144","21","3568","17.4","19.6"
"Coffee","2021-01-13","65","25209","5","3573","16.4","18.6"
"Coffee","2021-01-14","146","25355","17","3590","16","17.2"
"Coffee","2021-01-15","49","25404","7","3597","15","18.2"
"Coffee","2021-01-16","29","25433","8","3605","17.2","18.2"
"Coffee","2021-01-17","23","25456","2","3607","16.3","17.4"
"Coffee","2021-01-18","73","25529","8","3615","14.6","16.5"
"Coffee","2021-01-19","76","25605","9","3624","13.2","15.3"
"Coffee","2021-01-20","110","25715","13","3637","13.8","15.1"
"Coffee","2021-01-21","133","25848","10","3647","13.2","14.6"
"Coffee","2021-01-22","74","25922","11","3658","13.3","14.2"
"Coffee","2021-01-23","21","25943","9","3667","15.5","16.4"
"Coffee","2021-01-24","15","25958","4","3671","18.1","17.2"
"Coffee","2021-01-25","52","26010","9","3680","19","16.8"
"Coffee","2021-01-26","3","26013","0","3680","17.3","15.3"
"Coffee","2021-01-27","0","26013","0","3680","15.6","14.7"
"Colquitt","2020-02-01","0","0","0","0",".","."
"Colquitt","2020-02-02","0","0","0","0",".","."
"Colquitt","2020-02-03","0","0","0","0",".","."
"Colquitt","2020-02-04","0","0","0","0",".","."
"Colquitt","2020-02-05","0","0","0","0",".","."
"Colquitt","2020-02-06","0","0","0","0",".","."
"Colquitt","2020-02-07","0","0","0","0","0","."
"Colquitt","2020-02-08","0","0","0","0","0","."
"Colquitt","2020-02-09","0","0","0","0","0","."
"Colquitt","2020-02-10","0","0","0","0","0","."
"Colquitt","2020-02-11","0","0","0","0","0","."
"Colquitt","2020-02-12","0","0","0","0","0","."
"Colquitt","2020-02-13","0","0","0","0","0","."
"Colquitt","2020-02-14","0","0","0","0","0","0"
"Colquitt","2020-02-15","0","0","0","0","0","0"
"Colquitt","2020-02-16","0","0","0","0","0","0"
"Colquitt","2020-02-17","0","0","0","0","0","0"
"Colquitt","2020-02-18","0","0","0","0","0","0"
"Colquitt","2020-02-19","0","0","0","0","0","0"
"Colquitt","2020-02-20","0","0","0","0","0","0"
"Colquitt","2020-02-21","0","0","0","0","0","0"
"Colquitt","2020-02-22","0","0","0","0","0","0"
"Colquitt","2020-02-23","0","0","0","0","0","0"
"Colquitt","2020-02-24","0","0","0","0","0","0"
"Colquitt","2020-02-25","0","0","0","0","0","0"
"Colquitt","2020-02-26","0","0","0","0","0","0"
"Colquitt","2020-02-27","0","0","0","0","0","0"
"Colquitt","2020-02-28","0","0","0","0","0","0"
"Colquitt","2020-02-29","0","0","0","0","0","0"
"Colquitt","2020-03-01","0","0","0","0","0","0"
"Colquitt","2020-03-02","0","0","0","0","0","0"
"Colquitt","2020-03-03","0","0","0","0","0","0"
"Colquitt","2020-03-04","0","0","0","0","0","0"
"Colquitt","2020-03-05","0","0","0","0","0","0"
"Colquitt","2020-03-06","0","0","0","0","0","0"
"Colquitt","2020-03-07","0","0","0","0","0","0"
"Colquitt","2020-03-08","0","0","0","0","0","0"
"Colquitt","2020-03-09","0","0","0","0","0","0"
"Colquitt","2020-03-10","0","0","0","0","0","0"
"Colquitt","2020-03-11","0","0","0","0","0","0"
"Colquitt","2020-03-12","0","0","0","0","0","0"
"Colquitt","2020-03-13","1","1","0","0","0","0"
"Colquitt","2020-03-14","0","1","0","0","0","0"
"Colquitt","2020-03-15","2","3","0","0","0","0"
"Colquitt","2020-03-16","3","6","0","0","0","0"
"Colquitt","2020-03-17","8","14","2","2","3.6","1.8"
"Colquitt","2020-03-18","6","20","0","2","3.6","1.8"
"Colquitt","2020-03-19","4","24","1","3","7.1","3.6"
"Colquitt","2020-03-20","7","31","1","4","9.2","4.6"
"Colquitt","2020-03-21","4","35","0","4","9.2","4.6"
"Colquitt","2020-03-22","6","41","4","8","18.7","9.4"
"Colquitt","2020-03-23","11","52","4","12","23.9","12"
"Colquitt","2020-03-24","31","83","7","19","23.6","13.6"
"Colquitt","2020-03-25","22","105","3","22","25.5","14.5"
"Colquitt","2020-03-26","16","121","6","28","27.3","17.2"
"Colquitt","2020-03-27","7","128","3","31","31.4","20.3"
"Colquitt","2020-03-28","4","132","1","32","34.9","22.1"
"Colquitt","2020-03-29","0","132","0","32","25.4","22.1"
"Colquitt","2020-03-30","2","134","1","33","27.4","25.6"
"Colquitt","2020-03-31","2","136","2","35","38.4","31"
"Colquitt","2020-04-01","4","140","2","37","43.6","34.6"
"Colquitt","2020-04-02","5","145","1","38","41.1","34.2"
"Colquitt","2020-04-03","2","147","1","39","42.1","36.8"
"Colquitt","2020-04-04","0","147","0","39","38.6","36.8"
"Colquitt","2020-04-05","1","148","0","39","38.6","32"
"Colquitt","2020-04-06","3","151","1","40","36.2","31.8"
"Colquitt","2020-04-07","6","157","0","40","21.9","30.2"
"Colquitt","2020-04-08","2","159","0","40","14.8","29.2"
"Colquitt","2020-04-09","1","160","0","40","11.9","26.5"
"Colquitt","2020-04-10","5","165","1","41","7.6","24.9"
"Colquitt","2020-04-11","5","170","0","41","7.6","23.1"
"Colquitt","2020-04-12","11","181","4","45","12.8","25.7"
"Colquitt","2020-04-13","24","205","7","52","12.2","24.2"
"Colquitt","2020-04-14","44","249","14","66","16.8","19.3"
"Colquitt","2020-04-15","30","279","4","70","18.7","16.7"
"Colquitt","2020-04-16","39","318","6","76","20.9","16.4"
"Colquitt","2020-04-17","36","354","4","80","19.6","13.6"
"Colquitt","2020-04-18","19","373","3","83","21.9","14.7"
"Colquitt","2020-04-19","7","380","1","84","18.7","15.8"
"Colquitt","2020-04-20","16","396","4","88","18.1","15.2"
"Colquitt","2020-04-21","50","446","5","93","15","15.9"
"Colquitt","2020-04-22","38","484","6","99","15.3","17"
"Colquitt","2020-04-23","28","512","4","103","15.2","18"
"Colquitt","2020-04-24","20","532","5","108","17.2","18.4"
"Colquitt","2020-04-25","22","554","0","108","14.9","18.4"
"Colquitt","2020-04-26","8","562","1","109","14.7","16.7"
"Colquitt","2020-04-27","28","590","3","112","12.6","15.4"
"Colquitt","2020-04-28","44","634","3","115","12.2","13.6"
"Colquitt","2020-04-29","110","744","9","124","11.1","13.2"
"Colquitt","2020-04-30","59","803","4","128","10","12.6"
"Colquitt","2020-05-01","63","866","6","134","7.8","12.5"
"Colquitt","2020-05-02","36","902","2","136","8.6","11.7"
"Colquitt","2020-05-03","18","920","1","137","7.6","11.1"
"Colquitt","2020-05-04","52","972","6","143","7.7","10.2"
"Colquitt","2020-05-05","43","1015","2","145","7.4","9.8"
"Colquitt","2020-05-06","30","1045","6","151","9.1","10.1"
"Colquitt","2020-05-07","30","1075","4","155","10","10"
"Colquitt","2020-05-08","66","1141","14","169","11.7","9.7"
"Colquitt","2020-05-09","26","1167","5","174","13.6","11.1"
"Colquitt","2020-05-10","38","1205","10","184","16.6","12.1"
"Colquitt","2020-05-11","75","1280","8","192","16.5","12.1"
"Colquitt","2020-05-12","54","1334","18","210","20.6","14"
"Colquitt","2020-05-13","20","1354","3","213","19.9","14.5"
"Colquitt","2020-05-14","80","1434","1","214","18.1","14.1"
"Colquitt","2020-05-15","110","1544","29","243","18.9","15.3"
"Colquitt","2020-05-16","38","1582","8","251","19.1","16.4"
"Colquitt","2020-05-17","52","1634","28","279","23.1","19.8"
"Colquitt","2020-05-18","118","1752","31","310","25.3","20.9"
"Colquitt","2020-05-19","93","1845","32","342","25.5","23"
"Colquitt","2020-05-20","84","1929","4","346","24","21.9"
"Colquitt","2020-05-21","228","2157","74","420","28.5","23.3"
"Colquitt","2020-05-22","140","2297","9","429","25.6","22.2"
"Colquitt","2020-05-23","69","2366","14","443","25.5","22.3"
"Colquitt","2020-05-24","33","2399","6","449","20.4","21.7"
"Colquitt","2020-05-25","17","2416","3","452","19.2","22.2"
"Colquitt","2020-05-26","96","2512","15","467","16.5","21"
"Colquitt","2020-05-27","127","2639","10","477","16.9","20.5"
"Colquitt","2020-05-28","38","2677","4","481","13.8","21.1"
"Colquitt","2020-05-29","72","2749","8","489","14.5","20"
"Colquitt","2020-05-30","41","2790","7","496","14","19.8"
"Colquitt","2020-05-31","33","2823","7","503","14.4","17.4"
"Colquitt","2020-06-01","74","2897","14","517","14.6","16.9"
"Colquitt","2020-06-02","99","2996","22","539","15.6","16"
"Colquitt","2020-06-03","96","3092","5","544","15.2","16.1"
"Colquitt","2020-06-04","106","3198","12","556","15.3","14.5"
"Colquitt","2020-06-05","214","3412","17","573","14.8","14.7"
"Colquitt","2020-06-06","9","3421","3","576","17.2","15.6"
"Colquitt","2020-06-07","29","3450","6","582","17.1","15.8"
"Colquitt","2020-06-08","173","3623","16","598","15.7","15.2"
"Colquitt","2020-06-09","137","3760","34","632","16.1","15.8"
"Colquitt","2020-06-10","127","3887","15","647","17","16.1"
"Colquitt","2020-06-11","163","4050","23","670","17.4","16.4"
"Colquitt","2020-06-12","131","4181","16","686","18","16.4"
"Colquitt","2020-06-13","7","4188","4","690","21.4","19.3"
"Colquitt","2020-06-14","144","4332","27","717","21.2","19.1"
"Colquitt","2020-06-15","160","4492","22","739","21.8","18.8"
"Colquitt","2020-06-16","144","4636","26","765","20.8","18.5"
"Colquitt","2020-06-17","73","4709","10","775","21.1","19.1"
"Colquitt","2020-06-18","164","4873","29","804","21.6","19.5"
"Colquitt","2020-06-19","152","5025","22","826","21.9","20"
"Colquitt","2020-06-20","73","5098","11","837","15.9","18.7"
"Colquitt","2020-06-21","27","5125","8","845","17.5","19.3"
"Colquitt","2020-06-22","234","5359","37","882","17.8","19.8"
"Colquitt","2020-06-23","214","5573","45","927","18.2","19.5"
"Colquitt","2020-06-24","65","5638","16","943","19.8","20.4"
"Colquitt","2020-06-25","252","5890","59","1002","20.6","21.1"
"Colquitt","2020-06-26","233","6123","26","1028","20.1","21"
"Colquitt","2020-06-27","161","6284","18","1046","19.5","17.7"
"Colquitt","2020-06-28","19","6303","5","1051","19.1","18.3"
"Colquitt","2020-06-29","286","6589","60","1111","19.8","18.8"
"Colquitt","2020-06-30","259","6848","44","1155","19.2","18.7"
"Colquitt","2020-07-01","72","6920","9","1164","17.5","18.6"
"Colquitt","2020-07-02","299","7219","45","1209","16.3","18.4"
"Colquitt","2020-07-03","206","7425","35","1244","17.1","18.6"
"Colquitt","2020-07-04","11","7436","1","1245","16.8","18.2"
"Colquitt","2020-07-05","10","7446","2","1247","15.9","17.5"
"Colquitt","2020-07-06","227","7673","26","1273","14.6","17.2"
"Colquitt","2020-07-07","192","7865","32","1305","14.5","16.9"
"Colquitt","2020-07-08","64","7929","12","1317","15.4","16.5"
"Colquitt","2020-07-09","237","8166","22","1339","14.6","15.5"
"Colquitt","2020-07-10","143","8309","14","1353","13.6","15.4"
"Colquitt","2020-07-11","78","8387","5","1358","13.2","15"
"Colquitt","2020-07-12","13","8400","2","1360","12.5","14.2"
"Colquitt","2020-07-13","205","8605","22","1382","12.4","13.5"
"Colquitt","2020-07-14","169","8774","23","1405","12","13.3"
"Colquitt","2020-07-15","69","8843","11","1416","11.6","13.5"
"Colquitt","2020-07-16","201","9044","17","1433","11.5","13"
"Colquitt","2020-07-17","182","9226","23","1456","11.9","12.7"
"Colquitt","2020-07-18","69","9295","7","1463","12.4","12.8"
"Colquitt","2020-07-19","24","9319","9","1472","15.6","14.1"
"Colquitt","2020-07-20","207","9526","12","1484","14.9","13.7"
"Colquitt","2020-07-21","189","9715","13","1497","13.9","13"
"Colquitt","2020-07-22","107","9822","18","1515","14","12.8"
"Colquitt","2020-07-23","171","9993","12","1527","13.8","12.7"
"Colquitt","2020-07-24","156","10149","16","1543","13.5","12.7"
"Colquitt","2020-07-25","58","10207","10","1553","14.5","13.5"
"Colquitt","2020-07-26","18","10225","4","1557","12.3","13.9"
"Colquitt","2020-07-27","158","10383","10","1567","12.4","13.6"
"Colquitt","2020-07-28","124","10507","5","1572","12","12.9"
"Colquitt","2020-07-29","17","10524","1","1573","10.4","12.2"
"Colquitt","2020-07-30","143","10667","18","1591","11.2","12.5"
"Colquitt","2020-07-31","104","10771","15","1606","11.8","12.7"
"Colquitt","2020-08-01","61","10832","4","1610","10.3","12.4"
"Colquitt","2020-08-02","6","10838","2","1612","11.9","12.1"
"Colquitt","2020-08-03","121","10959","11","1623","12.3","12.3"
"Colquitt","2020-08-04","43","11002","2","1625","12.4","12.2"
"Colquitt","2020-08-05","158","11160","14","1639","12.8","11.6"
"Colquitt","2020-08-06","50","11210","5","1644","12.4","11.8"
"Colquitt","2020-08-07","182","11392","13","1657","11.4","11.6"
"Colquitt","2020-08-08","93","11485","1","1658","10.6","10.4"
"Colquitt","2020-08-09","64","11549","3","1661","6.5","9.2"
"Colquitt","2020-08-10","161","11710","14","1675","6.4","9.4"
"Colquitt","2020-08-11","112","11822","12","1687","7.3","9.8"
"Colquitt","2020-08-12","185","12007","9","1696","6.7","9.8"
"Colquitt","2020-08-13","74","12081","6","1702","6.5","9.4"
"Colquitt","2020-08-14","158","12239","9","1711","6.3","8.8"
"Colquitt","2020-08-15","95","12334","8","1719","7.3","9"
"Colquitt","2020-08-16","70","12404","3","1722","7.3","6.9"
"Colquitt","2020-08-17","75","12479","4","1726","6.8","6.6"
"Colquitt","2020-08-18","88","12567","5","1731","6.1","6.7"
"Colquitt","2020-08-19","210","12777","20","1751","6.7","6.7"
"Colquitt","2020-08-20","105","12882","9","1760","6.8","6.6"
"Colquitt","2020-08-21","274","13156","15","1775","6.8","6.5"
"Colquitt","2020-08-22","77","13233","4","1779","6.3","6.8"
"Colquitt","2020-08-23","79","13312","3","1782","6.2","6.7"
"Colquitt","2020-08-24","192","13504","16","1798","6.7","6.7"
"Colquitt","2020-08-25","46","13550","13","1811","9.9","8"
"Colquitt","2020-08-26","262","13812","12","1823","9.2","7.9"
"Colquitt","2020-08-27","78","13890","3","1826","8.5","7.6"
"Colquitt","2020-08-28","333","14223","15","1841","8.4","7.6"
"Colquitt","2020-08-29","91","14314","5","1846","8.4","7.3"
"Colquitt","2020-08-30","151","14465","2","1848","8","7.1"
"Colquitt","2020-08-31","243","14708","12","1860","7.6","7.1"
"Colquitt","2020-09-01","63","14771","3","1863","4.2","7"
"Colquitt","2020-09-02","280","15051","5","1868","3.8","6.5"
"Colquitt","2020-09-03","61","15112","3","1871","4","6.2"
"Colquitt","2020-09-04","339","15451","7","1878","3.6","6"
"Colquitt","2020-09-05","9","15460","1","1879","4.4","6.4"
"Colquitt","2020-09-06","6","15466","1","1880","6.6","7.3"
"Colquitt","2020-09-07","7","15473","1","1881","7.9","7.8"
"Colquitt","2020-09-08","201","15674","22","1903","8.8","6.5"
"Colquitt","2020-09-09","135","15809","6","1909","9.2","6.5"
"Colquitt","2020-09-10","145","15954","11","1920","9.6","6.8"
"Colquitt","2020-09-11","85","16039","6","1926","10.3","7"
"Colquitt","2020-09-12","146","16185","4","1930","9.1","6.8"
"Colquitt","2020-09-13","12","16197","3","1933","10.3","8.5"
"Colquitt","2020-09-14","117","16314","13","1946","9.8","8.9"
"Colquitt","2020-09-15","31","16345","5","1951","10.6","9.7"
"Colquitt","2020-09-16","228","16573","8","1959","10.4","9.8"
"Colquitt","2020-09-17","48","16621","3","1962","10.3","9.9"
"Colquitt","2020-09-18","110","16731","8","1970","10.3","10.3"
"Colquitt","2020-09-19","56","16787","0","1970","9.9","9.5"
"Colquitt","2020-09-20","8","16795","1","1971","8.1","9.2"
"Colquitt","2020-09-21","75","16870","4","1975","7.3","8.6"
"Colquitt","2020-09-22","27","16897","1","1976","5.5","8"
"Colquitt","2020-09-23","92","16989","5","1981","5.8","8.1"
"Colquitt","2020-09-24","13","17002","0","1981","4.9","7.6"
"Colquitt","2020-09-25","128","17130","6","1987","4.5","7.4"
"Colquitt","2020-09-26","7","17137","1","1988","6.6","8.2"
"Colquitt","2020-09-27","7","17144","2","1990","8.9","8.5"
"Colquitt","2020-09-28","72","17216","5","1995","9.1","8.2"
"Colquitt","2020-09-29","50","17266","5","2000","10","7.7"
"Colquitt","2020-09-30","101","17367","8","2008","10.3","8.1"
"Colquitt","2020-10-01","30","17397","2","2010","11.3","8.1"
"Colquitt","2020-10-02","92","17489","7","2017","11.7","8.1"
"Colquitt","2020-10-03","26","17515","1","2018","10.2","8.4"
"Colquitt","2020-10-04","67","17582","4","2022","7","7.9"
"Colquitt","2020-10-05","111","17693","15","2037","7.9","8.5"
"Colquitt","2020-10-06","38","17731","6","2043","8.8","9.4"
"Colquitt","2020-10-07","145","17876","12","2055","8.8","9.6"
"Colquitt","2020-10-08","110","17986","5","2060","8.5","9.9"
"Colquitt","2020-10-09","172","18158","14","2074","8.6","10.1"
"Colquitt","2020-10-10","46","18204","0","2074","8","9.1"
"Colquitt","2020-10-11","14","18218","0","2074","7.2","7.1"
"Colquitt","2020-10-12","59","18277","8","2082","7.2","7.6"
"Colquitt","2020-10-13","181","18458","13","2095","6","7.4"
"Colquitt","2020-10-14","55","18513","3","2098","5.6","7.2"
"Colquitt","2020-10-15","203","18716","11","2109","5.7","7.1"
"Colquitt","2020-10-16","44","18760","1","2110","4.8","6.7"
"Colquitt","2020-10-17","103","18863","6","2116","5.7","6.9"
"Colquitt","2020-10-18","6","18869","0","2116","5.7","6.4"
"Colquitt","2020-10-19","96","18965","8","2124","4.9","6.1"
"Colquitt","2020-10-20","110","19075","1","2125","4","5"
"Colquitt","2020-10-21","53","19128","1","2126","3.5","4.5"
"Colquitt","2020-10-22","82","19210","8","2134","4.1","4.9"
"Colquitt","2020-10-23","83","19293","7","2141","5","4.9"
"Colquitt","2020-10-24","6","19299","0","2141","4.2","4.9"
"Colquitt","2020-10-25","4","19303","1","2142","7.8","6.7"
"Colquitt","2020-10-26","73","19376","6","2148","7.7","6.3"
"Colquitt","2020-10-27","14","19390","1","2149","8.6","6.3"
"Colquitt","2020-10-28","80","19470","6","2155","9.4","6.5"
"Colquitt","2020-10-29","25","19495","2","2157","9.2","6.7"
"Colquitt","2020-10-30","58","19553","3","2160","8.7","6.9"
"Colquitt","2020-10-31","5","19558","0","2160","8.7","6.5"
"Colquitt","2020-11-01","1","19559","0","2160","5.1","6.5"
"Colquitt","2020-11-02","54","19613","2","2162","4.5","6.1"
"Colquitt","2020-11-03","24","19637","4","2166","5.9","7.2"
"Colquitt","2020-11-04","88","19725","5","2171","5.6","7.5"
"Colquitt","2020-11-05","14","19739","0","2171","4.5","6.8"
"Colquitt","2020-11-06","70","19809","3","2174","4.3","6.5"
"Colquitt","2020-11-07","8","19817","1","2175","6.1","7.4"
"Colquitt","2020-11-08","8","19825","2","2177","9.7","7.4"
"Colquitt","2020-11-09","63","19888","6","2183","10.5","7.5"
"Colquitt","2020-11-10","27","19915","1","2184","8.7","7.3"
"Colquitt","2020-11-11","31","19946","2","2186","8.8","7.2"
"Colquitt","2020-11-12","65","20011","6","2192","10.1","7.3"
"Colquitt","2020-11-13","34","20045","2","2194","10.3","7.3"
"Colquitt","2020-11-14","11","20056","1","2195","9.8","8"
"Colquitt","2020-11-15","9","20065","0","2195","6.3","8"
"Colquitt","2020-11-16","70","20135","6","2201","6.1","8.3"
"Colquitt","2020-11-17","33","20168","5","2206","7.8","8.2"
"Colquitt","2020-11-18","101","20269","3","2209","7.3","8"
"Colquitt","2020-11-19","24","20293","1","2210","6.5","8.3"
"Colquitt","2020-11-20","88","20381","1","2211","5.9","8.1"
"Colquitt","2020-11-21","4","20385","1","2212","8.1","9"
"Colquitt","2020-11-22","3","20388","0","2212","8.1","7.2"
"Colquitt","2020-11-23","60","20448","5","2217","8.1","7.1"
"Colquitt","2020-11-24","24","20472","1","2218","6.5","7.2"
"Colquitt","2020-11-25","42","20514","4","2222","7.5","7.4"
"Colquitt","2020-11-26","9","20523","1","2223","8.5","7.5"
"Colquitt","2020-11-27","15","20538","4","2227","12.1","9"
"Colquitt","2020-11-28","12","20550","2","2229","10.9","9.5"
"Colquitt","2020-11-29","6","20556","1","2230","13.3","10.7"
"Colquitt","2020-11-30","120","20676","20","2250","14.5","11.3"
"Colquitt","2020-12-01","65","20741","12","2262","16.5","11.5"
"Colquitt","2020-12-02","33","20774","4","2266","16.9","12.2"
"Colquitt","2020-12-03","38","20812","5","2271","17.2","12.8"
"Colquitt","2020-12-04","100","20912","20","2291","16.2","14.2"
"Colquitt","2020-12-05","9","20921","1","2292","15.5","13.2"
"Colquitt","2020-12-06","13","20934","4","2296","17.5","15.4"
"Colquitt","2020-12-07","44","20978","13","2309","19.3","16.9"
"Colquitt","2020-12-08","164","21142","14","2323","17.9","17.2"
"Colquitt","2020-12-09","96","21238","12","2335","17.9","17.4"
"Colquitt","2020-12-10","47","21285","3","2338","17","17.1"
"Colquitt","2020-12-11","162","21447","11","2349","15.1","15.7"
"Colquitt","2020-12-12","19","21466","5","2354","17.3","16.4"
"Colquitt","2020-12-13","9","21475","0","2354","12.9","15.2"
"Colquitt","2020-12-14","50","21525","6","2360","10.4","14.8"
"Colquitt","2020-12-15","124","21649","13","2373","10.6","14.3"
"Colquitt","2020-12-16","55","21704","11","2384","11.7","14.8"
"Colquitt","2020-12-17","127","21831","9","2393","11.8","14.4"
"Colquitt","2020-12-18","143","21974","12","2405","12","13.6"
"Colquitt","2020-12-19","20","21994","4","2409","11.1","14.2"
"Colquitt","2020-12-20","3","21997","0","2409","11.1","12"
"Colquitt","2020-12-21","161","22158","31","2440","12.2","11.3"
"Colquitt","2020-12-22","41","22199","9","2449","13.8","12.2"
"Colquitt","2020-12-23","141","22340","24","2473","13.4","12.5"
"Colquitt","2020-12-24","8","22348","1","2474","14.2","13"
"Colquitt","2020-12-25","5","22353","2","2476","18.7","15.4"
"Colquitt","2020-12-26","19","22372","9","2485","22.6","16.9"
"Colquitt","2020-12-27","11","22383","5","2490","29.1","20.1"
"Colquitt","2020-12-28","180","22563","24","2514","28.2","20.2"
"Colquitt","2020-12-29","133","22696","17","2531","26.9","20.4"
"Colquitt","2020-12-30","26","22722","8","2539","28.9","21.1"
"Colquitt","2020-12-31","154","22876","23","2562","29.2","21.7"
"Colquitt","2021-01-01","4","22880","2","2564","30.7","24.7"
"Colquitt","2021-01-02","23","22903","7","2571","28.2","25.4"
"Colquitt","2021-01-03","30","22933","9","2580","26","27.6"
"Colquitt","2021-01-04","190","23123","38","2618","27","27.6"
"Colquitt","2021-01-05","38","23161","7","2625","27.8","27.4"
"Colquitt","2021-01-06","40","23201","8","2633","26.3","27.6"
"Colquitt","2021-01-07","245","23446","40","2673","26.5","27.8"
"Colquitt","2021-01-08","44","23490","3","2676","20.3","25.5"
"Colquitt","2021-01-09","79","23569","8","2684","17.4","22.8"
"Colquitt","2021-01-10","6","23575","2","2686","17.9","21.9"
"Colquitt","2021-01-11","177","23752","22","2708","16.8","21.9"
"Colquitt","2021-01-12","23","23775","6","2714","17.9","22.8"
"Colquitt","2021-01-13","28","23803","7","2721","18.6","22.4"
"Colquitt","2021-01-14","208","24011","29","2750","18.2","22.4"
"Colquitt","2021-01-15","137","24148","19","2769","19.3","19.8"
"Colquitt","2021-01-16","9","24157","1","2770","19.4","18.4"
"Colquitt","2021-01-17","16","24173","6","2776","20","18.9"
"Colquitt","2021-01-18","125","24298","31","2807","21.8","19.3"
"Colquitt","2021-01-19","31","24329","8","2815","21.7","19.8"
"Colquitt","2021-01-20","47","24376","2","2817","18.8","18.7"
"Colquitt","2021-01-21","198","24574","26","2843","18.6","18.4"
"Colquitt","2021-01-22","26","24600","2","2845","17.8","18.5"
"Colquitt","2021-01-23","11","24611","2","2847","18.8","19.1"
"Colquitt","2021-01-24","4","24615","1","2848","17","18.5"
"Colquitt","2021-01-25","3","24618","1","2849","18.2","20"
"Colquitt","2021-01-26","4","24622","0","2849","14.5","18.1"
"Colquitt","2021-01-27","0","24622","0","2849","13.9","16.3"
"Columbia","2020-02-01","0","0","0","0",".","."
"Columbia","2020-02-02","0","0","0","0",".","."
"Columbia","2020-02-03","0","0","0","0",".","."
"Columbia","2020-02-04","0","0","0","0",".","."
"Columbia","2020-02-05","0","0","0","0",".","."
"Columbia","2020-02-06","0","0","0","0",".","."
"Columbia","2020-02-07","0","0","0","0","0","."
"Columbia","2020-02-08","0","0","0","0","0","."
"Columbia","2020-02-09","0","0","0","0","0","."
"Columbia","2020-02-10","0","0","0","0","0","."
"Columbia","2020-02-11","0","0","0","0","0","."
"Columbia","2020-02-12","0","0","0","0","0","."
"Columbia","2020-02-13","0","0","0","0","0","."
"Columbia","2020-02-14","0","0","0","0","0","0"
"Columbia","2020-02-15","0","0","0","0","0","0"
"Columbia","2020-02-16","0","0","0","0","0","0"
"Columbia","2020-02-17","0","0","0","0","0","0"
"Columbia","2020-02-18","0","0","0","0","0","0"
"Columbia","2020-02-19","0","0","0","0","0","0"
"Columbia","2020-02-20","0","0","0","0","0","0"
"Columbia","2020-02-21","0","0","0","0","0","0"
"Columbia","2020-02-22","0","0","0","0","0","0"
"Columbia","2020-02-23","0","0","0","0","0","0"
"Columbia","2020-02-24","0","0","0","0","0","0"
"Columbia","2020-02-25","0","0","0","0","0","0"
"Columbia","2020-02-26","0","0","0","0","0","0"
"Columbia","2020-02-27","0","0","0","0","0","0"
"Columbia","2020-02-28","0","0","0","0","0","0"
"Columbia","2020-02-29","0","0","0","0","0","0"
"Columbia","2020-03-01","0","0","0","0","0","0"
"Columbia","2020-03-02","0","0","0","0","0","0"
"Columbia","2020-03-03","3","3","0","0","0","0"
"Columbia","2020-03-04","0","3","0","0","0","0"
"Columbia","2020-03-05","0","3","0","0","0","0"
"Columbia","2020-03-06","0","3","0","0","0","0"
"Columbia","2020-03-07","0","3","0","0","0","0"
"Columbia","2020-03-08","0","3","0","0","0","0"
"Columbia","2020-03-09","0","3","0","0","0","0"
"Columbia","2020-03-10","0","3","0","0","0","0"
"Columbia","2020-03-11","0","3","0","0","0","0"
"Columbia","2020-03-12","1","4","0","0","0","0"
"Columbia","2020-03-13","2","6","1","1","7.1","3.6"
"Columbia","2020-03-14","0","6","0","1","7.1","3.6"
"Columbia","2020-03-15","0","6","0","1","7.1","3.6"
"Columbia","2020-03-16","1","7","0","1","7.1","3.6"
"Columbia","2020-03-17","9","16","1","2","8.7","4.4"
"Columbia","2020-03-18","9","25","2","4","11.9","6"
"Columbia","2020-03-19","5","30","0","4","11.9","6"
"Columbia","2020-03-20","9","39","1","5","6.3","6.7"
"Columbia","2020-03-21","6","45","0","5","6.3","6.7"
"Columbia","2020-03-22","7","52","2","7","10.4","8.8"
"Columbia","2020-03-23","16","68","1","8","11.3","9.2"
"Columbia","2020-03-24","14","82","1","9","10.8","9.7"
"Columbia","2020-03-25","7","89","0","9","7.6","9.7"
"Columbia","2020-03-26","21","110","0","9","7.6","9.7"
"Columbia","2020-03-27","28","138","2","11","7","6.7"
"Columbia","2020-03-28","6","144","0","11","7","6.7"
"Columbia","2020-03-29","6","150","2","13","7.7","9.1"
"Columbia","2020-03-30","22","172","1","14","7.5","9.4"
"Columbia","2020-03-31","12","184","1","15","7.6","9.2"
"Columbia","2020-04-01","19","203","1","16","8.4","8"
"Columbia","2020-04-02","27","230","2","18","9.4","8.5"
"Columbia","2020-04-03","52","282","4","22","9.5","8.3"
"Columbia","2020-04-04","24","306","5","27","12.5","9.8"
"Columbia","2020-04-05","17","323","2","29","9.4","8.6"
"Columbia","2020-04-06","25","348","3","32","10.5","9"
"Columbia","2020-04-07","47","395","2","34","9.9","8.8"
"Columbia","2020-04-08","48","443","2","36","9.7","9.1"
"Columbia","2020-04-09","35","478","1","37","9.1","9.3"
"Columbia","2020-04-10","34","512","1","38","8.4","9"
"Columbia","2020-04-11","20","532","2","40","6.9","9.7"
"Columbia","2020-04-12","6","538","0","40","5.2","7.3"
"Columbia","2020-04-13","41","579","5","45","5.2","7.8"
"Columbia","2020-04-14","28","607","2","47","5.6","7.8"
"Columbia","2020-04-15","40","647","5","52","6.8","8.3"
"Columbia","2020-04-16","38","685","8","60","9.4","9.2"
"Columbia","2020-04-17","67","752","8","68","10.7","9.5"
"Columbia","2020-04-18","30","782","13","81","15.5","11.2"
"Columbia","2020-04-19","21","803","6","87","19.5","12.4"
"Columbia","2020-04-20","44","847","5","92","19.4","12.3"
"Columbia","2020-04-21","83","930","10","102","20.1","12.9"
"Columbia","2020-04-22","71","1001","7","109","19.7","13.3"
"Columbia","2020-04-23","37","1038","5","114","18.7","14"
"Columbia","2020-04-24","107","1145","15","129","19","14.8"
"Columbia","2020-04-25","57","1202","1","130","13","14.2"
"Columbia","2020-04-26","42","1244","2","132","9.6","14.6"
"Columbia","2020-04-27","86","1330","6","138","9","14.2"
"Columbia","2020-04-28","37","1367","4","142","8.8","14.5"
"Columbia","2020-04-29","75","1442","1","143","7.6","13.7"
"Columbia","2020-04-30","90","1532","5","148","6.5","12.6"
"Columbia","2020-05-01","67","1599","5","153","5.5","12.2"
"Columbia","2020-05-02","68","1667","9","162","7.2","10.1"
"Columbia","2020-05-03","52","1719","4","166","7.6","8.6"
"Columbia","2020-05-04","65","1784","1","167","6.8","7.9"
"Columbia","2020-05-05","87","1871","2","169","5.6","7.2"
"Columbia","2020-05-06","64","1935","5","174","6.5","7.1"
"Columbia","2020-05-07","63","1998","6","180","7.1","6.8"
"Columbia","2020-05-08","72","2070","3","183","6.6","6.1"
"Columbia","2020-05-09","58","2128","0","183","4.7","5.9"
"Columbia","2020-05-10","8","2136","1","184","5.4","6.5"
"Columbia","2020-05-11","116","2252","3","187","5.6","6.2"
"Columbia","2020-05-12","122","2374","3","190","5.6","5.6"
"Columbia","2020-05-13","78","2452","9","199","6.1","6.3"
"Columbia","2020-05-14","80","2532","2","201","5.1","6.1"
"Columbia","2020-05-15","85","2617","10","211","6.2","6.4"
"Columbia","2020-05-16","75","2692","4","215","7","5.8"
"Columbia","2020-05-17","59","2751","0","215","5.2","5.3"
"Columbia","2020-05-18","128","2879","3","218","5.1","5.3"
"Columbia","2020-05-19","130","3009","4","222","5.2","5.4"
"Columbia","2020-05-20","85","3094","2","224","3.9","5"
"Columbia","2020-05-21","104","3198","1","225","3.7","4.4"
"Columbia","2020-05-22","95","3293","4","229","2.6","4.4"
"Columbia","2020-05-23","36","3329","3","232","3","5"
"Columbia","2020-05-24","39","3368","3","235","4.1","4.7"
"Columbia","2020-05-25","35","3403","3","238","5","5.1"
"Columbia","2020-05-26","35","3438","4","242","6.2","5.7"
"Columbia","2020-05-27","17","3455","1","243","6.7","5.3"
"Columbia","2020-05-28","109","3564","11","254","8","5.9"
"Columbia","2020-05-29","47","3611","2","256","8","5.3"
"Columbia","2020-05-30","14","3625","0","256","6.8","4.9"
"Columbia","2020-05-31","54","3679","0","256","5.7","4.9"
"Columbia","2020-06-01","93","3772","2","258","4.8","4.9"
"Columbia","2020-06-02","114","3886","5","263","3.8","5"
"Columbia","2020-06-03","75","3961","3","266","3.6","5.1"
"Columbia","2020-06-04","47","4008","6","272","3.9","6"
"Columbia","2020-06-05","30","4038","1","273","3.8","5.9"
"Columbia","2020-06-06","16","4054","0","273","3.8","5.3"
"Columbia","2020-06-07","12","4066","0","273","3.8","4.8"
"Columbia","2020-06-08","24","4090","0","273","3.5","4.2"
"Columbia","2020-06-09","76","4166","4","277","3.6","3.7"
"Columbia","2020-06-10","119","4285","8","285","4","3.8"
"Columbia","2020-06-11","108","4393","8","293","3.2","3.6"
"Columbia","2020-06-12","123","4516","3","296","3.1","3.5"
"Columbia","2020-06-13","85","4601","3","299","3.6","3.7"
"Columbia","2020-06-14","65","4666","4","303","4.5","4.2"
"Columbia","2020-06-15","157","4823","9","312","5.3","4.4"
"Columbia","2020-06-16","118","4941","7","319","5.4","4.5"
"Columbia","2020-06-17","59","5000","3","322","5.2","4.6"
"Columbia","2020-06-18","103","5103","10","332","5.5","4.4"
"Columbia","2020-06-19","111","5214","7","339","6.1","4.6"
"Columbia","2020-06-20","103","5317","5","344","6.3","4.9"
"Columbia","2020-06-21","26","5343","5","349","8.1","6.3"
"Columbia","2020-06-22","182","5525","15","364","8.5","6.9"
"Columbia","2020-06-23","163","5688","20","384","9.4","7.4"
"Columbia","2020-06-24","200","5888","37","421","11.3","8.2"
"Columbia","2020-06-25","209","6097","19","440","11.2","8.4"
"Columbia","2020-06-26","186","6283","16","456","11.5","8.8"
"Columbia","2020-06-27","140","6423","25","481","13.4","9.8"
"Columbia","2020-06-28","111","6534","15","496","12.6","10.4"
"Columbia","2020-06-29","266","6800","38","534","13.4","11"
"Columbia","2020-06-30","364","7164","38","572","13.2","11.3"
"Columbia","2020-07-01","376","7540","39","611","12","11.7"
"Columbia","2020-07-02","416","7956","40","651","12.1","11.7"
"Columbia","2020-07-03","297","8253","32","683","12.4","12"
"Columbia","2020-07-04","47","8300","9","692","12.6","13"
"Columbia","2020-07-05","222","8522","23","715","12.1","12.4"
"Columbia","2020-07-06","312","8834","45","760","12.2","12.8"
"Columbia","2020-07-07","273","9107","42","802","12.9","13"
"Columbia","2020-07-08","317","9424","35","837","13","12.5"
"Columbia","2020-07-09","332","9756","34","871","13.1","12.6"
"Columbia","2020-07-10","343","10099","47","918","13.5","12.9"
"Columbia","2020-07-11","281","10380","25","943","12","12.3"
"Columbia","2020-07-12","159","10539","28","971","13","12.6"
"Columbia","2020-07-13","355","10894","40","1011","12.6","12.4"
"Columbia","2020-07-14","374","11268","45","1056","12.1","12.5"
"Columbia","2020-07-15","326","11594","49","1105","12.7","12.8"
"Columbia","2020-07-16","352","11946","54","1159","13.4","13.2"
"Columbia","2020-07-17","257","12203","42","1201","13.8","13.6"
"Columbia","2020-07-18","232","12435","22","1223","13.9","12.9"
"Columbia","2020-07-19","159","12594","22","1245","13.3","13.2"
"Columbia","2020-07-20","288","12882","48","1293","14.1","13.3"
"Columbia","2020-07-21","366","13248","35","1328","13.8","12.9"
"Columbia","2020-07-22","284","13532","66","1394","14.9","13.8"
"Columbia","2020-07-23","342","13874","53","1447","14.9","14.2"
"Columbia","2020-07-24","271","14145","43","1490","14.9","14.3"
"Columbia","2020-07-25","238","14383","46","1536","16.3","15.1"
"Columbia","2020-07-26","160","14543","33","1569","17.3","15.3"
"Columbia","2020-07-27","341","14884","46","1615","16.8","15.5"
"Columbia","2020-07-28","422","15306","70","1685","17.8","15.8"
"Columbia","2020-07-29","350","15656","44","1729","16.3","15.6"
"Columbia","2020-07-30","320","15976","75","1804","17.4","16.2"
"Columbia","2020-07-31","262","16238","52","1856","18","16.4"
"Columbia","2020-08-01","195","16433","32","1888","17.6","16.9"
"Columbia","2020-08-02","122","16555","15","1903","16.4","16.8"
"Columbia","2020-08-03","203","16758","38","1941","17.1","17"
"Columbia","2020-08-04","380","17138","52","1993","16.7","17.3"
"Columbia","2020-08-05","282","17420","49","2042","17.4","16.8"
"Columbia","2020-08-06","317","17737","47","2089","16.2","16.8"
"Columbia","2020-08-07","277","18014","30","2119","14.9","16.4"
"Columbia","2020-08-08","141","18155","15","2134","14.1","15.8"
"Columbia","2020-08-09","179","18334","13","2147","13.3","14.9"
"Columbia","2020-08-10","311","18645","51","2198","13","15.1"
"Columbia","2020-08-11","429","19074","55","2253","12.9","14.8"
"Columbia","2020-08-12","283","19357","53","2306","13.1","15.2"
"Columbia","2020-08-13","382","19739","50","2356","12.8","14.5"
"Columbia","2020-08-14","294","20033","36","2392","13","14"
"Columbia","2020-08-15","202","20235","29","2421","13.6","13.8"
"Columbia","2020-08-16","184","20419","25","2446","14.5","13.9"
"Columbia","2020-08-17","306","20725","43","2489","14.1","13.6"
"Columbia","2020-08-18","377","21102","44","2533","14","13.4"
"Columbia","2020-08-19","262","21364","28","2561","12.8","12.9"
"Columbia","2020-08-20","282","21646","18","2579","11.9","12.3"
"Columbia","2020-08-21","295","21941","35","2614","11.8","12.4"
"Columbia","2020-08-22","142","22083","6","2620","10.4","12"
"Columbia","2020-08-23","168","22251","15","2635","9.7","12.1"
"Columbia","2020-08-24","305","22556","46","2681","9.8","12"
"Columbia","2020-08-25","316","22872","31","2712","9.6","11.8"
"Columbia","2020-08-26","245","23117","27","2739","9.6","11.2"
"Columbia","2020-08-27","268","23385","36","2775","10.6","11.2"
"Columbia","2020-08-28","215","23600","31","2806","11","11.4"
"Columbia","2020-08-29","159","23759","23","2829","12.5","11.4"
"Columbia","2020-08-30","121","23880","15","2844","12.9","11.3"
"Columbia","2020-08-31","235","24115","22","2866","12.1","11"
"Columbia","2020-09-01","298","24413","23","2889","11.8","10.7"
"Columbia","2020-09-02","210","24623","23","2912","11.8","10.7"
"Columbia","2020-09-03","250","24873","45","2957","12.5","11.5"
"Columbia","2020-09-04","166","25039","22","2979","12.3","11.6"
"Columbia","2020-09-05","158","25197","13","2992","11.4","11.9"
"Columbia","2020-09-06","82","25279","12","3004","11.7","12.3"
"Columbia","2020-09-07","61","25340","4","3008","11.3","11.7"
"Columbia","2020-09-08","305","25645","36","3044","11.9","11.9"
"Columbia","2020-09-09","212","25857","28","3072","12.2","12"
"Columbia","2020-09-10","344","26201","35","3107","11.1","11.8"
"Columbia","2020-09-11","245","26446","31","3138","11","11.7"
"Columbia","2020-09-12","141","26587","20","3158","11.9","11.7"
"Columbia","2020-09-13","61","26648","7","3165","11.4","11.6"
"Columbia","2020-09-14","254","26902","32","3197","12.3","11.8"
"Columbia","2020-09-15","264","27166","18","3215","11.6","11.8"
"Columbia","2020-09-16","183","27349","12","3227","10.6","11.4"
"Columbia","2020-09-17","163","27512","15","3242","10.5","10.8"
"Columbia","2020-09-18","213","27725","17","3259","9.8","10.4"
"Columbia","2020-09-19","127","27852","9","3268","8.8","10.4"
"Columbia","2020-09-20","68","27920","3","3271","7.8","9.6"
"Columbia","2020-09-21","253","28173","16","3287","6.9","9.6"
"Columbia","2020-09-22","257","28430","23","3310","7.2","9.4"
"Columbia","2020-09-23","158","28588","12","3322","7.4","9"
"Columbia","2020-09-24","313","28901","23","3345","7.1","8.8"
"Columbia","2020-09-25","214","29115","20","3365","7.3","8.6"
"Columbia","2020-09-26","91","29206","8","3373","7.5","8.2"
"Columbia","2020-09-27","43","29249","2","3375","7.6","7.7"
"Columbia","2020-09-28","285","29534","11","3386","7.2","7.1"
"Columbia","2020-09-29","227","29761","15","3401","6.9","7.1"
"Columbia","2020-09-30","177","29938","25","3426","7.8","7.6"
"Columbia","2020-10-01","231","30169","13","3439","7.6","7.3"
"Columbia","2020-10-02","261","30430","22","3461","7.4","7.4"
"Columbia","2020-10-03","136","30566","4","3465","6.6","7.1"
"Columbia","2020-10-04","71","30637","2","3467","6.3","7"
"Columbia","2020-10-05","331","30968","27","3494","7","7.1"
"Columbia","2020-10-06","320","31288","20","3514","6.9","6.9"
"Columbia","2020-10-07","431","31719","29","3543","5.9","6.8"
"Columbia","2020-10-08","363","32082","18","3561","5.8","6.7"
"Columbia","2020-10-09","300","32382","28","3589","5.9","6.7"
"Columbia","2020-10-10","220","32602","5","3594","5.8","6.2"
"Columbia","2020-10-11","63","32665","4","3598","6.3","6.3"
"Columbia","2020-10-12","358","33023","33","3631","6.4","6.7"
"Columbia","2020-10-13","348","33371","26","3657","6.6","6.8"
"Columbia","2020-10-14","290","33661","27","3684","7","6.4"
"Columbia","2020-10-15","309","33970","34","3718","7.9","6.8"
"Columbia","2020-10-16","239","34209","23","3741","7.9","6.9"
"Columbia","2020-10-17","218","34427","17","3758","8.7","7.2"
"Columbia","2020-10-18","75","34502","7","3765","9.1","7.7"
"Columbia","2020-10-19","329","34831","33","3798","9.2","7.8"
"Columbia","2020-10-20","340","35171","24","3822","9.2","7.9"
"Columbia","2020-10-21","292","35463","27","3849","9.2","8.1"
"Columbia","2020-10-22","258","35721","31","3880","9.3","8.6"
"Columbia","2020-10-23","252","35973","31","3911","9.7","8.8"
"Columbia","2020-10-24","139","36112","13","3924","9.9","9.3"
"Columbia","2020-10-25","80","36192","8","3932","10","9.6"
"Columbia","2020-10-26","322","36514","25","3957","9.7","9.5"
"Columbia","2020-10-27","319","36833","29","3986","10","9.6"
"Columbia","2020-10-28","250","37083","35","4021","10.6","9.9"
"Columbia","2020-10-29","274","37357","25","4046","10.2","9.8"
"Columbia","2020-10-30","289","37646","28","4074","9.9","9.8"
"Columbia","2020-10-31","143","37789","10","4084","9.5","9.7"
"Columbia","2020-11-01","102","37891","4","4088","8.7","9.3"
"Columbia","2020-11-02","372","38263","28","4116","8.6","9.1"
"Columbia","2020-11-03","303","38566","26","4142","8.5","9.3"
"Columbia","2020-11-04","350","38916","33","4175","7.9","9.3"
"Columbia","2020-11-05","415","39331","33","4208","7.7","9"
"Columbia","2020-11-06","346","39677","34","4242","7.7","8.8"
"Columbia","2020-11-07","190","39867","17","4259","8","8.8"
"Columbia","2020-11-08","88","39955","6","4265","8.4","8.5"
"Columbia","2020-11-09","368","40323","58","4323","9.6","9.1"
"Columbia","2020-11-10","358","40681","51","4374","10.4","9.5"
"Columbia","2020-11-11","335","41016","32","4406","10.4","9.2"
"Columbia","2020-11-12","322","41338","49","4455","11.5","9.6"
"Columbia","2020-11-13","352","41690","26","4481","11.1","9.4"
"Columbia","2020-11-14","147","41837","24","4505","12.2","10.1"
"Columbia","2020-11-15","117","41954","8","4513","12.2","10.3"
"Columbia","2020-11-16","403","42357","39","4552","11.3","10.5"
"Columbia","2020-11-17","460","42817","49","4601","10.8","10.6"
"Columbia","2020-11-18","368","43185","27","4628","10.5","10.5"
"Columbia","2020-11-19","351","43536","34","4662","9.7","10.6"
"Columbia","2020-11-20","534","44070","34","4696","9.6","10.3"
"Columbia","2020-11-21","238","44308","9","4705","7.8","10"
"Columbia","2020-11-22","170","44478","10","4715","7.6","9.9"
"Columbia","2020-11-23","441","44919","46","4761","7.7","9.5"
"Columbia","2020-11-24","543","45462","63","4824","7.9","9.3"
"Columbia","2020-11-25","303","45765","17","4841","7.6","9.1"
"Columbia","2020-11-26","59","45824","2","4843","6.7","8.2"
"Columbia","2020-11-27","190","46014","24","4867","7.6","8.6"
"Columbia","2020-11-28","166","46180","22","4889","9","8.4"
"Columbia","2020-11-29","118","46298","9","4898","9.2","8.4"
"Columbia","2020-11-30","460","46758","71","4969","9.9","8.8"
"Columbia","2020-12-01","465","47223","61","5030","10.2","9"
"Columbia","2020-12-02","578","47801","71","5101","11.1","9.4"
"Columbia","2020-12-03","398","48199","55","5156","12.6","9.7"
"Columbia","2020-12-04","370","48569","62","5218","13.2","10.4"
"Columbia","2020-12-05","247","48816","37","5255","13.4","11.2"
"Columbia","2020-12-06","94","48910","14","5269","14.5","11.8"
"Columbia","2020-12-07","473","49383","72","5341","14.4","12.2"
"Columbia","2020-12-08","441","49824","100","5441","15.8","13"
"Columbia","2020-12-09","522","50346","62","5503","15.7","13.4"
"Columbia","2020-12-10","403","50749","66","5569","16.1","14.4"
"Columbia","2020-12-11","366","51115","47","5616","15.6","14.4"
"Columbia","2020-12-12","297","51412","40","5656","15.3","14.4"
"Columbia","2020-12-13","122","51534","24","5680","16","15.2"
"Columbia","2020-12-14","437","51971","75","5755","16.3","15.4"
"Columbia","2020-12-15","569","52540","74","5829","14.9","15.4"
"Columbia","2020-12-16","540","53080","78","5907","15.3","15.5"
"Columbia","2020-12-17","445","53525","90","5997","15.8","16"
"Columbia","2020-12-18","438","53963","54","6051","15.8","15.7"
"Columbia","2020-12-19","310","54273","43","6094","15.8","15.6"
"Columbia","2020-12-20","151","54424","30","6124","15.8","15.9"
"Columbia","2020-12-21","561","54985","98","6222","15.9","16.1"
"Columbia","2020-12-22","527","55512","78","6300","16.1","15.5"
"Columbia","2020-12-23","524","56036","75","6375","16.1","15.7"
"Columbia","2020-12-24","171","56207","26","6401","15.4","15.6"
"Columbia","2020-12-25","31","56238","9","6410","17.8","16.8"
"Columbia","2020-12-26","265","56503","58","6468","18.9","17.4"
"Columbia","2020-12-27","138","56641","36","6504","19.8","17.8"
"Columbia","2020-12-28","481","57122","100","6604","20.3","18.1"
"Columbia","2020-12-29","426","57548","139","6743","22.8","19.5"
"Columbia","2020-12-30","472","58020","104","6847","24","20"
"Columbia","2020-12-31","207","58227","44","6891","24.8","20.1"
"Columbia","2021-01-01","44","58271","10","6901","23.9","20.9"
"Columbia","2021-01-02","157","58428","44","6945","24.8","21.9"
"Columbia","2021-01-03","67","58495","18","6963","24.9","22.4"
"Columbia","2021-01-04","247","58742","82","7045","26.7","23.5"
"Columbia","2021-01-05","538","59280","106","7151","24.8","23.8"
"Columbia","2021-01-06","448","59728","100","7251","24.9","24.4"
"Columbia","2021-01-07","458","60186","107","7358","25.2","25"
"Columbia","2021-01-08","637","60823","117","7475","24.5","24.2"
"Columbia","2021-01-09","330","61153","73","7548","23.7","24.2"
"Columbia","2021-01-10","173","61326","43","7591","23.4","24.2"
"Columbia","2021-01-11","636","61962","129","7720","21.6","24.1"
"Columbia","2021-01-12","654","62616","125","7845","21.5","23.2"
"Columbia","2021-01-13","601","63217","106","7951","20.8","22.8"
"Columbia","2021-01-14","484","63701","110","8061","20.7","23"
"Columbia","2021-01-15","493","64194","79","8140","20.4","22.5"
"Columbia","2021-01-16","290","64484","79","8219","21.1","22.4"
"Columbia","2021-01-17","144","64628","21","8240","19.7","21.5"
"Columbia","2021-01-18","453","65081","111","8351","20.3","20.9"
"Columbia","2021-01-19","539","65620","91","8442","19.9","20.7"
"Columbia","2021-01-20","446","66066","75","8517","19.8","20.3"
"Columbia","2021-01-21","354","66420","65","8582","19.2","20"
"Columbia","2021-01-22","436","66856","71","8653","19.2","19.8"
"Columbia","2021-01-23","195","67051","34","8687","17.8","19.5"
"Columbia","2021-01-24","96","67147","14","8701","17.8","18.7"
"Columbia","2021-01-25","161","67308","21","8722","16.2","18.2"
"Columbia","2021-01-26","9","67317","1","8723","15.4","17.7"
"Columbia","2021-01-27","0","67317","0","8723","13","16.4"
"Cook","2020-02-01","0","0","0","0",".","."
"Cook","2020-02-02","0","0","0","0",".","."
"Cook","2020-02-03","0","0","0","0",".","."
"Cook","2020-02-04","0","0","0","0",".","."
"Cook","2020-02-05","0","0","0","0",".","."
"Cook","2020-02-06","0","0","0","0",".","."
"Cook","2020-02-07","0","0","0","0","0","."
"Cook","2020-02-08","0","0","0","0","0","."
"Cook","2020-02-09","0","0","0","0","0","."
"Cook","2020-02-10","0","0","0","0","0","."
"Cook","2020-02-11","0","0","0","0","0","."
"Cook","2020-02-12","0","0","0","0","0","."
"Cook","2020-02-13","0","0","0","0","0","."
"Cook","2020-02-14","0","0","0","0","0","0"
"Cook","2020-02-15","0","0","0","0","0","0"
"Cook","2020-02-16","0","0","0","0","0","0"
"Cook","2020-02-17","0","0","0","0","0","0"
"Cook","2020-02-18","0","0","0","0","0","0"
"Cook","2020-02-19","0","0","0","0","0","0"
"Cook","2020-02-20","0","0","0","0","0","0"
"Cook","2020-02-21","0","0","0","0","0","0"
"Cook","2020-02-22","0","0","0","0","0","0"
"Cook","2020-02-23","0","0","0","0","0","0"
"Cook","2020-02-24","0","0","0","0","0","0"
"Cook","2020-02-25","0","0","0","0","0","0"
"Cook","2020-02-26","0","0","0","0","0","0"
"Cook","2020-02-27","0","0","0","0","0","0"
"Cook","2020-02-28","0","0","0","0","0","0"
"Cook","2020-02-29","0","0","0","0","0","0"
"Cook","2020-03-01","0","0","0","0","0","0"
"Cook","2020-03-02","0","0","0","0","0","0"
"Cook","2020-03-03","0","0","0","0","0","0"
"Cook","2020-03-04","0","0","0","0","0","0"
"Cook","2020-03-05","0","0","0","0","0","0"
"Cook","2020-03-06","0","0","0","0","0","0"
"Cook","2020-03-07","0","0","0","0","0","0"
"Cook","2020-03-08","0","0","0","0","0","0"
"Cook","2020-03-09","0","0","0","0","0","0"
"Cook","2020-03-10","0","0","0","0","0","0"
"Cook","2020-03-11","0","0","0","0","0","0"
"Cook","2020-03-12","0","0","0","0","0","0"
"Cook","2020-03-13","0","0","0","0","0","0"
"Cook","2020-03-14","0","0","0","0","0","0"
"Cook","2020-03-15","0","0","0","0","0","0"
"Cook","2020-03-16","0","0","0","0","0","0"
"Cook","2020-03-17","1","1","0","0","0","0"
"Cook","2020-03-18","0","1","0","0","0","0"
"Cook","2020-03-19","3","4","0","0","0","0"
"Cook","2020-03-20","1","5","0","0","0","0"
"Cook","2020-03-21","0","5","0","0","0","0"
"Cook","2020-03-22","1","6","0","0","0","0"
"Cook","2020-03-23","0","6","0","0","0","0"
"Cook","2020-03-24","2","8","0","0","0","0"
"Cook","2020-03-25","0","8","0","0","0","0"
"Cook","2020-03-26","5","13","0","0","0","0"
"Cook","2020-03-27","5","18","0","0","0","0"
"Cook","2020-03-28","0","18","0","0","0","0"
"Cook","2020-03-29","0","18","0","0","0","0"
"Cook","2020-03-30","5","23","0","0","0","0"
"Cook","2020-03-31","4","27","0","0","0","0"
"Cook","2020-04-01","6","33","0","0","0","0"
"Cook","2020-04-02","3","36","0","0","0","0"
"Cook","2020-04-03","5","41","0","0","0","0"
"Cook","2020-04-04","2","43","1","1","7.1","3.6"
"Cook","2020-04-05","1","44","0","1","7.1","3.6"
"Cook","2020-04-06","2","46","0","1","7.1","3.6"
"Cook","2020-04-07","5","51","1","2","10","5"
"Cook","2020-04-08","2","53","0","2","10","5"
"Cook","2020-04-09","3","56","0","2","10","5"
"Cook","2020-04-10","5","61","0","2","10","5"
"Cook","2020-04-11","1","62","0","2","2.9","5"
"Cook","2020-04-12","2","64","1","3","10","8.6"
"Cook","2020-04-13","0","64","0","3","10","8.6"
"Cook","2020-04-14","4","68","0","3","7.1","8.6"
"Cook","2020-04-15","1","69","0","3","7.1","8.6"
"Cook","2020-04-16","4","73","1","4","10.7","10.4"
"Cook","2020-04-17","1","74","0","4","10.7","10.4"
"Cook","2020-04-18","3","77","1","5","15.5","9.2"
"Cook","2020-04-19","4","81","1","6","11.9","11"
"Cook","2020-04-20","10","91","0","6","11.9","11"
"Cook","2020-04-21","8","99","0","6","11.9","9.5"
"Cook","2020-04-22","9","108","1","7","13.5","10.3"
"Cook","2020-04-23","6","114","1","8","12.3","11.5"
"Cook","2020-04-24","7","121","1","9","14.3","12.5"
"Cook","2020-04-25","6","127","2","11","14.3","14.9"
"Cook","2020-04-26","0","127","0","11","10.8","11.3"
"Cook","2020-04-27","19","146","2","13","12.3","12.1"
"Cook","2020-04-28","21","167","2","15","13.6","12.8"
"Cook","2020-04-29","12","179","4","19","16.8","15.2"
"Cook","2020-04-30","8","187","0","19","14.4","13.4"
"Cook","2020-05-01","13","200","1","20","13.5","13.9"
"Cook","2020-05-02","1","201","0","20","8.7","11.5"
"Cook","2020-05-03","1","202","1","21","23","16.9"
"Cook","2020-05-04","3","205","0","21","21.5","16.9"
"Cook","2020-05-05","14","219","1","22","21.2","17.4"
"Cook","2020-05-06","9","228","0","22","16.4","16.6"
"Cook","2020-05-07","12","240","0","22","16.4","15.4"
"Cook","2020-05-08","21","261","0","22","15.3","14.4"
"Cook","2020-05-09","7","268","1","23","17.3","13"
"Cook","2020-05-10","2","270","0","23","3.1","13"
"Cook","2020-05-11","24","294","1","24","3.7","12.6"
"Cook","2020-05-12","16","310","1","25","3.5","12.3"
"Cook","2020-05-13","17","327","1","26","4.4","10.4"
"Cook","2020-05-14","18","345","2","28","6","11.2"
"Cook","2020-05-15","18","363","2","30","7.5","11.4"
"Cook","2020-05-16","5","368","0","30","5.5","11.4"
"Cook","2020-05-17","3","371","1","31","10.3","6.7"
"Cook","2020-05-18","25","396","2","33","10.8","7.2"
"Cook","2020-05-19","7","403","1","34","12","7.7"
"Cook","2020-05-20","22","425","3","37","13.1","8.7"
"Cook","2020-05-21","23","448","0","37","11.5","8.7"
"Cook","2020-05-22","14","462","2","39","11.9","9.7"
"Cook","2020-05-23","2","464","1","40","19.1","12.3"
"Cook","2020-05-24","0","464","0","40","14.3","12.3"
"Cook","2020-05-25","1","465","0","40","13.2","12"
"Cook","2020-05-26","25","490","2","42","12.3","12.1"
"Cook","2020-05-27","13","503","0","42","10.3","11.7"
"Cook","2020-05-28","20","523","1","43","11","11.3"
"Cook","2020-05-29","22","545","2","45","10.3","11.1"
"Cook","2020-05-30","11","556","1","46","4.5","11.8"
"Cook","2020-05-31","51","607","7","53","6.4","10.4"
"Cook","2020-06-01","42","649","4","57","7.8","10.5"
"Cook","2020-06-02","18","667","5","62","10.6","11.4"
"Cook","2020-06-03","26","693","3","65","12.2","11.3"
"Cook","2020-06-04","36","729","4","69","13.1","12.1"
"Cook","2020-06-05","46","775","3","72","12.8","11.5"
"Cook","2020-06-06","5","780","2","74","17.2","10.8"
"Cook","2020-06-07","4","784","0","74","15.2","10.8"
"Cook","2020-06-08","61","845","7","81","15.5","11.6"
"Cook","2020-06-09","26","871","1","82","12.1","11.3"
"Cook","2020-06-10","34","905","3","85","11.7","12"
"Cook","2020-06-11","38","943","5","90","12","12.5"
"Cook","2020-06-12","35","978","2","92","11.9","12.3"
"Cook","2020-06-13","13","991","1","93","7.2","12.2"
"Cook","2020-06-14","1","992","1","94","21.5","18.4"
"Cook","2020-06-15","59","1051","12","106","22.8","19.1"
"Cook","2020-06-16","52","1103","4","110","23.3","17.7"
"Cook","2020-06-17","51","1154","5","115","23.5","17.6"
"Cook","2020-06-18","62","1216","12","127","24.4","18.2"
"Cook","2020-06-19","71","1287","3","130","24.2","18"
"Cook","2020-06-20","12","1299","4","134","27.8","17.5"
"Cook","2020-06-21","5","1304","1","135","16.4","19"
"Cook","2020-06-22","78","1382","10","145","15.3","19.1"
"Cook","2020-06-23","83","1465","5","150","15.1","19.2"
"Cook","2020-06-24","92","1557","8","158","14.9","19.2"
"Cook","2020-06-25","114","1671","11","169","13.5","19"
"Cook","2020-06-26","83","1754","9","178","14.5","19.3"
"Cook","2020-06-27","4","1758","0","178","9.7","18.8"
"Cook","2020-06-28","6","1764","1","179","9.2","12.8"
"Cook","2020-06-29","104","1868","12","191","9.1","12.2"
"Cook","2020-06-30","83","1951","10","201","9.9","12.5"
"Cook","2020-07-01","60","2011","5","206","9.9","12.4"
"Cook","2020-07-02","73","2084","14","220","11.2","12.4"
"Cook","2020-07-03","31","2115","7","227","12.9","13.7"
"Cook","2020-07-04","11","2126","4","231","18.1","13.9"
"Cook","2020-07-05","6","2132","1","232","18.1","13.7"
"Cook","2020-07-06","88","2220","23","255","20.2","14.6"
"Cook","2020-07-07","74","2294","8","263","20","15"
"Cook","2020-07-08","27","2321","5","268","21.5","15.7"
"Cook","2020-07-09","82","2403","14","282","21.2","16.2"
"Cook","2020-07-10","198","2601","34","316","20.4","16.6"
"Cook","2020-07-11","9","2610","1","317","16.8","17.4"
"Cook","2020-07-12","5","2615","0","317","14.4","16.3"
"Cook","2020-07-13","74","2689","6","323","11.8","16"
"Cook","2020-07-14","87","2776","12","335","12.3","16.1"
"Cook","2020-07-15","33","2809","5","340","11.8","16.6"
"Cook","2020-07-16","172","2981","28","368","11.7","16.4"
"Cook","2020-07-17","145","3126","23","391","11.5","15.9"
"Cook","2020-07-18","12","3138","0","391","9.9","13.3"
"Cook","2020-07-19","9","3147","2","393","13.1","13.7"
"Cook","2020-07-20","107","3254","19","412","14.4","13.1"
"Cook","2020-07-21","92","3346","11","423","14.2","13.2"
"Cook","2020-07-22","41","3387","6","429","14.1","12.9"
"Cook","2020-07-23","76","3463","8","437","13.3","12.5"
"Cook","2020-07-24","79","3542","11","448","13","12.2"
"Cook","2020-07-25","10","3552","5","453","20.1","15"
"Cook","2020-07-26","4","3556","2","455","24.1","18.6"
"Cook","2020-07-27","67","3623","16","471","25","19.7"
"Cook","2020-07-28","94","3717","8","479","24.5","19.3"
"Cook","2020-07-29","123","3840","51","530","28.3","21.2"
"Cook","2020-07-30","80","3920","8","538","28.3","20.8"
"Cook","2020-07-31","75","3995","8","546","27.8","20.4"
"Cook","2020-08-01","14","4009","2","548","22.7","21.4"
"Cook","2020-08-02","4","4013","0","548","15.5","19.8"
"Cook","2020-08-03","52","4065","9","557","14.6","19.8"
"Cook","2020-08-04","55","4120","4","561","14.4","19.5"
"Cook","2020-08-05","28","4148","6","567","11.6","19.9"
"Cook","2020-08-06","83","4231","11","578","12","20.1"
"Cook","2020-08-07","74","4305","10","588","12.4","20.1"
"Cook","2020-08-08","5","4310","2","590","16.1","19.4"
"Cook","2020-08-09","2","4312","0","590","16.1","15.8"
"Cook","2020-08-10","40","4352","5","595","15.4","15"
"Cook","2020-08-11","63","4415","4","599","15.3","14.9"
"Cook","2020-08-12","25","4440","4","603","14.5","13"
"Cook","2020-08-13","41","4481","2","605","13.3","12.7"
"Cook","2020-08-14","58","4539","5","610","12.6","12.5"
"Cook","2020-08-15","4","4543","1","611","10.5","13.3"
"Cook","2020-08-16","10","4553","1","612","11.9","14"
"Cook","2020-08-17","29","4582","5","617","12.6","14"
"Cook","2020-08-18","39","4621","7","624","14.2","14.8"
"Cook","2020-08-19","22","4643","1","625","12.6","13.6"
"Cook","2020-08-20","35","4678","1","626","12.3","12.8"
"Cook","2020-08-21","37","4715","2","628","11.9","12.2"
"Cook","2020-08-22","5","4720","0","628","8.3","9.4"
"Cook","2020-08-23","7","4727","4","632","15","13.5"
"Cook","2020-08-24","42","4769","1","633","12.9","12.7"
"Cook","2020-08-25","58","4827","3","636","11.1","12.7"
"Cook","2020-08-26","26","4853","6","642","13.7","13.2"
"Cook","2020-08-27","47","4900","0","642","13.3","12.8"
"Cook","2020-08-28","53","4953","0","642","12.5","12.2"
"Cook","2020-08-29","7","4960","0","642","12.5","10.4"
"Cook","2020-08-30","10","4970","0","642","4.4","9.7"
"Cook","2020-08-31","31","5001","3","645","5.4","9.2"
"Cook","2020-09-01","27","5028","1","646","5.2","8.1"
"Cook","2020-09-02","22","5050","5","651","5.2","9.4"
"Cook","2020-09-03","27","5077","4","655","7.3","10.3"
"Cook","2020-09-04","10","5087","1","656","8.7","10.6"
"Cook","2020-09-05","7","5094","0","656","8.7","10.6"
"Cook","2020-09-06","3","5097","0","656","8.7","6.5"
"Cook","2020-09-07","10","5107","0","656","7.3","6.4"
"Cook","2020-09-08","161","5268","1","657","6.9","6"
"Cook","2020-09-09","77","5345","2","659","4","4.6"
"Cook","2020-09-10","26","5371","4","663","4.1","5.7"
"Cook","2020-09-11","9","5380","0","663","2.7","5.7"
"Cook","2020-09-12","6","5386","0","663","2.7","5.7"
"Cook","2020-09-13","7","5393","2","665","6.7","7.7"
"Cook","2020-09-14","82","5475","2","667","7.1","7.2"
"Cook","2020-09-15","20","5495","1","668","7.7","7.3"
"Cook","2020-09-16","69","5564","2","670","7.8","5.9"
"Cook","2020-09-17","38","5602","2","672","6.3","5.2"
"Cook","2020-09-18","20","5622","7","679","11.3","7"
"Cook","2020-09-19","10","5632","0","679","11.3","7"
"Cook","2020-09-20","8","5640","1","680","9","7.9"
"Cook","2020-09-21","98","5738","2","682","9","8"
"Cook","2020-09-22","27","5765","1","683","8.8","8.2"
"Cook","2020-09-23","56","5821","0","683","8.4","8.1"
"Cook","2020-09-24","19","5840","0","683","7.6","7"
"Cook","2020-09-25","9","5849","0","683","2.6","7"
"Cook","2020-09-26","5","5854","0","683","2.6","7"
"Cook","2020-09-27","2","5856","0","683","0.8","4.9"
"Cook","2020-09-28","90","5946","3","686","1","5"
"Cook","2020-09-29","27","5973","1","687","1","4.9"
"Cook","2020-09-30","79","6052","2","689","1.4","4.9"
"Cook","2020-10-01","25","6077","1","690","1.9","4.8"
"Cook","2020-10-02","19","6096","0","690","1.9","2.3"
"Cook","2020-10-03","4","6100","1","691","5.5","4.1"
"Cook","2020-10-04","5","6105","2","693","11.2","6"
"Cook","2020-10-05","34","6139","0","693","10.7","5.9"
"Cook","2020-10-06","46","6185","1","694","10.5","5.8"
"Cook","2020-10-07","44","6229","2","696","10.8","6.1"
"Cook","2020-10-08","41","6270","3","699","11.3","6.6"
"Cook","2020-10-09","23","6293","0","699","11.3","6.6"
"Cook","2020-10-10","11","6304","0","699","7.7","6.6"
"Cook","2020-10-11","6","6310","1","700","4.4","7.8"
"Cook","2020-10-12","22","6332","1","701","5","7.9"
"Cook","2020-10-13","32","6364","4","705","6.5","8.5"
"Cook","2020-10-14","12","6376","0","705","5.9","8.3"
"Cook","2020-10-15","19","6395","1","706","5.6","8.4"
"Cook","2020-10-16","24","6419","2","708","6.8","9"
"Cook","2020-10-17","6","6425","1","709","9.1","8.4"
"Cook","2020-10-18","5","6430","0","709","6.8","5.6"
"Cook","2020-10-19","39","6469","1","710","6.5","5.8"
"Cook","2020-10-20","50","6519","6","716","6.4","6.5"
"Cook","2020-10-21","39","6558","1","717","6.8","6.3"
"Cook","2020-10-22","24","6582","0","717","6","5.8"
"Cook","2020-10-23","13","6595","1","718","5.9","6.3"
"Cook","2020-10-24","7","6602","1","719","5.6","7.4"
"Cook","2020-10-25","2","6604","0","719","5.6","6.2"
"Cook","2020-10-26","32","6636","1","720","5.7","6.1"
"Cook","2020-10-27","53","6689","8","728","6.1","6.3"
"Cook","2020-10-28","104","6793","6","734","6.6","6.7"
"Cook","2020-10-29","37","6830","9","743","10","8"
"Cook","2020-10-30","24","6854","4","747","11.3","8.6"
"Cook","2020-10-31","11","6865","1","748","10.6","8.1"
"Cook","2020-11-01","10","6875","8","756","22","13.8"
"Cook","2020-11-02","36","6911","6","762","23.9","14.8"
"Cook","2020-11-03","134","7045","4","766","22.2","14.2"
"Cook","2020-11-04","37","7082","3","769","22.5","14.6"
"Cook","2020-11-05","68","7150","13","782","21.8","15.9"
"Cook","2020-11-06","19","7169","1","783","20.2","15.7"
"Cook","2020-11-07","1","7170","0","783","18.9","14.7"
"Cook","2020-11-08","5","7175","0","783","7.4","14.7"
"Cook","2020-11-09","61","7236","5","788","6.2","15.1"
"Cook","2020-11-10","59","7295","5","793","7","14.6"
"Cook","2020-11-11","39","7334","6","799","8.1","15.3"
"Cook","2020-11-12","96","7430","7","806","6.4","14.1"
"Cook","2020-11-13","32","7462","2","808","6.5","13.3"
"Cook","2020-11-14","14","7476","2","810","8.6","13.7"
"Cook","2020-11-15","15","7491","2","812","10.5","9"
"Cook","2020-11-16","71","7562","6","818","10.5","8.4"
"Cook","2020-11-17","63","7625","6","824","10.6","8.8"
"Cook","2020-11-18","27","7652","3","827","10","9"
"Cook","2020-11-19","19","7671","4","831","12","9.2"
"Cook","2020-11-20","27","7698","6","837","14.3","10.4"
"Cook","2020-11-21","15","7713","3","840","15.1","11.8"
"Cook","2020-11-22","11","7724","0","840","13.2","11.8"
"Cook","2020-11-23","105","7829","22","862","15","12.7"
"Cook","2020-11-24","44","7873","5","867","15.2","12.9"
"Cook","2020-11-25","27","7900","9","876","18.4","14.2"
"Cook","2020-11-26","8","7908","0","876","15.4","13.7"
"Cook","2020-11-27","16","7924","3","879","14.9","14.6"
"Cook","2020-11-28","10","7934","4","883","17.8","16.4"
"Cook","2020-11-29","9","7943","3","886","22.5","17.9"
"Cook","2020-11-30","59","8002","9","895","21.7","18.3"
"Cook","2020-12-01","78","8080","12","907","22.3","18.8"
"Cook","2020-12-02","34","8114","7","914","20.5","19.4"
"Cook","2020-12-03","24","8138","8","922","25.2","20.3"
"Cook","2020-12-04","23","8161","6","928","26.3","20.6"
"Cook","2020-12-05","9","8170","3","931","25.3","21.6"
"Cook","2020-12-06","13","8183","5","936","26.1","24.3"
"Cook","2020-12-07","75","8258","17","953","27.1","24.4"
"Cook","2020-12-08","56","8314","4","957","25.9","24.1"
"Cook","2020-12-09","41","8355","9","966","26.1","23.3"
"Cook","2020-12-10","26","8381","3","969","23","24.1"
"Cook","2020-12-11","24","8405","3","972","21.1","23.7"
"Cook","2020-12-12","11","8416","0","972","16.3","20.8"
"Cook","2020-12-13","12","8428","4","976","15.6","20.8"
"Cook","2020-12-14","36","8464","9","985","15.9","21.5"
"Cook","2020-12-15","92","8556","28","1013","19.3","22.6"
"Cook","2020-12-16","40","8596","4","1017","17.5","21.8"
"Cook","2020-12-17","84","8680","11","1028","17.8","20.4"
"Cook","2020-12-18","22","8702","6","1034","19.9","20.5"
"Cook","2020-12-19","10","8712","1","1035","21.3","18.8"
"Cook","2020-12-20","17","8729","7","1042","22.4","19"
"Cook","2020-12-21","24","8753","7","1049","23","19.5"
"Cook","2020-12-22","91","8844","22","1071","22.1","20.7"
"Cook","2020-12-23","15","8859","2","1073","22.6","20.1"
"Cook","2020-12-24","15","8874","3","1076","23.6","20.7"
"Cook","2020-12-25","2","8876","0","1076","19.7","19.8"
"Cook","2020-12-26","12","8888","4","1080","23","22.2"
"Cook","2020-12-27","9","8897","3","1083","21.9","22.2"
"Cook","2020-12-28","57","8954","11","1094","20.5","21.8"
"Cook","2020-12-29","37","8991","5","1099","19","20.5"
"Cook","2020-12-30","34","9025","8","1107","20.4","21.5"
"Cook","2020-12-31","23","9048","2","1109","18.8","21.2"
"Cook","2021-01-01","7","9055","0","1109","18.8","19.3"
"Cook","2021-01-02","10","9065","1","1110","15.5","19.3"
"Cook","2021-01-03","14","9079","0","1110","10.7","16.3"
"Cook","2021-01-04","42","9121","4","1114","9.3","14.9"
"Cook","2021-01-05","45","9166","8","1122","9.9","14.5"
"Cook","2021-01-06","35","9201","2","1124","7.4","13.9"
"Cook","2021-01-07","28","9229","1","1125","6.7","12.7"
"Cook","2021-01-08","38","9267","6","1131","8.9","13.9"
"Cook","2021-01-09","10","9277","3","1134","11.8","13.6"
"Cook","2021-01-10","16","9293","1","1135","12.7","11.7"
"Cook","2021-01-11","16","9309","3","1138","14","11.7"
"Cook","2021-01-12","35","9344","7","1145","14.3","12.1"
"Cook","2021-01-13","17","9361","2","1147","15.2","11.3"
"Cook","2021-01-14","27","9388","1","1148","15.2","10.9"
"Cook","2021-01-15","13","9401","2","1150","15.1","12"
"Cook","2021-01-16","10","9411","0","1150","10.8","11.3"
"Cook","2021-01-17","8","9419","1","1151","11.7","12.2"
"Cook","2021-01-18","26","9445","2","1153","10.1","12.1"
"Cook","2021-01-19","24","9469","4","1157","9.7","12"
"Cook","2021-01-20","25","9494","6","1163","11.4","13.3"
"Cook","2021-01-21","7","9501","1","1164","12.9","14.1"
"Cook","2021-01-22","16","9517","4","1168","14.3","14.7"
"Cook","2021-01-23","4","9521","2","1170","21.4","16.1"
"Cook","2021-01-24","3","9524","0","1170","19.7","15.7"
"Cook","2021-01-25","5","9529","3","1173","27.1","18.6"
"Cook","2021-01-26","1","9530","0","1173","24.8","17.2"
"Cook","2021-01-27","0","9530","0","1173","21.3","16.4"
"Coweta","2020-02-01","0","0","0","0",".","."
"Coweta","2020-02-02","0","0","0","0",".","."
"Coweta","2020-02-03","0","0","0","0",".","."
"Coweta","2020-02-04","0","0","0","0",".","."
"Coweta","2020-02-05","0","0","0","0",".","."
"Coweta","2020-02-06","0","0","0","0",".","."
"Coweta","2020-02-07","0","0","0","0","0","."
"Coweta","2020-02-08","0","0","0","0","0","."
"Coweta","2020-02-09","0","0","0","0","0","."
"Coweta","2020-02-10","0","0","0","0","0","."
"Coweta","2020-02-11","0","0","0","0","0","."
"Coweta","2020-02-12","0","0","0","0","0","."
"Coweta","2020-02-13","0","0","0","0","0","."
"Coweta","2020-02-14","0","0","0","0","0","0"
"Coweta","2020-02-15","0","0","0","0","0","0"
"Coweta","2020-02-16","0","0","0","0","0","0"
"Coweta","2020-02-17","0","0","0","0","0","0"
"Coweta","2020-02-18","0","0","0","0","0","0"
"Coweta","2020-02-19","0","0","0","0","0","0"
"Coweta","2020-02-20","0","0","0","0","0","0"
"Coweta","2020-02-21","0","0","0","0","0","0"
"Coweta","2020-02-22","0","0","0","0","0","0"
"Coweta","2020-02-23","0","0","0","0","0","0"
"Coweta","2020-02-24","0","0","0","0","0","0"
"Coweta","2020-02-25","0","0","0","0","0","0"
"Coweta","2020-02-26","0","0","0","0","0","0"
"Coweta","2020-02-27","0","0","0","0","0","0"
"Coweta","2020-02-28","0","0","0","0","0","0"
"Coweta","2020-02-29","0","0","0","0","0","0"
"Coweta","2020-03-01","0","0","0","0","0","0"
"Coweta","2020-03-02","1","1","1","1","14.3","7.1"
"Coweta","2020-03-03","0","1","0","1","14.3","7.1"
"Coweta","2020-03-04","0","1","0","1","14.3","7.1"
"Coweta","2020-03-05","0","1","0","1","14.3","7.1"
"Coweta","2020-03-06","0","1","0","1","14.3","7.1"
"Coweta","2020-03-07","0","1","0","1","14.3","7.1"
"Coweta","2020-03-08","0","1","0","1","14.3","7.1"
"Coweta","2020-03-09","0","1","0","1","0","7.1"
"Coweta","2020-03-10","2","3","0","1","0","7.1"
"Coweta","2020-03-11","5","8","1","2","2.9","8.6"
"Coweta","2020-03-12","4","12","1","3","6.4","10.4"
"Coweta","2020-03-13","11","23","2","5","9","11.7"
"Coweta","2020-03-14","2","25","0","5","9","11.7"
"Coweta","2020-03-15","1","26","0","5","9","11.7"
"Coweta","2020-03-16","12","38","1","6","10.2","5.1"
"Coweta","2020-03-17","24","62","2","8","11.4","5.7"
"Coweta","2020-03-18","21","83","3","11","10.6","6.7"
"Coweta","2020-03-19","16","99","1","12","7.9","7.2"
"Coweta","2020-03-20","29","128","3","15","6.8","7.9"
"Coweta","2020-03-21","11","139","4","19","12","10.5"
"Coweta","2020-03-22","15","154","5","24","16.7","12.9"
"Coweta","2020-03-23","33","187","5","29","17.7","14"
"Coweta","2020-03-24","67","254","7","36","18","14.7"
"Coweta","2020-03-25","51","305","5","41","17.4","14"
"Coweta","2020-03-26","56","361","8","49","18.5","13.2"
"Coweta","2020-03-27","36","397","11","60","21.4","14.1"
"Coweta","2020-03-28","8","405","3","63","21.6","16.8"
"Coweta","2020-03-29","16","421","2","65","18.6","17.7"
"Coweta","2020-03-30","50","471","5","70","17.9","17.8"
"Coweta","2020-03-31","31","502","4","74","18.2","18.1"
"Coweta","2020-04-01","43","545","5","79","18.5","17.9"
"Coweta","2020-04-02","29","574","3","82","17.9","18.2"
"Coweta","2020-04-03","46","620","10","92","16.7","19"
"Coweta","2020-04-04","11","631","4","96","16.5","19"
"Coweta","2020-04-05","7","638","2","98","18.8","18.7"
"Coweta","2020-04-06","40","678","9","107","20.6","19.2"
"Coweta","2020-04-07","39","717","4","111","20.2","19.2"
"Coweta","2020-04-08","45","762","0","111","18.5","18.5"
"Coweta","2020-04-09","49","811","13","124","20.9","19.4"
"Coweta","2020-04-10","48","859","6","130","19.5","18.1"
"Coweta","2020-04-11","9","868","1","131","15.9","16.2"
"Coweta","2020-04-12","10","878","1","132","13.3","16"
"Coweta","2020-04-13","33","911","4","136","11.8","16.2"
"Coweta","2020-04-14","34","945","5","141","12.4","16.3"
"Coweta","2020-04-15","53","998","6","147","14","16.3"
"Coweta","2020-04-16","68","1066","12","159","12.8","16.8"
"Coweta","2020-04-17","108","1174","12","171","12.6","16.1"
"Coweta","2020-04-18","58","1232","10","181","13.4","14.7"
"Coweta","2020-04-19","22","1254","2","183","13.3","13.3"
"Coweta","2020-04-20","117","1371","8","191","12.6","12.2"
"Coweta","2020-04-21","106","1477","6","197","11.3","11.8"
"Coweta","2020-04-22","85","1562","5","202","10.5","12.3"
"Coweta","2020-04-23","43","1605","4","206","9.3","11"
"Coweta","2020-04-24","121","1726","14","220","9.4","11"
"Coweta","2020-04-25","67","1793","3","223","7.5","10.5"
"Coweta","2020-04-26","22","1815","1","224","6.9","10.1"
"Coweta","2020-04-27","111","1926","9","233","7.1","9.8"
"Coweta","2020-04-28","122","2048","1","234","6.4","8.8"
"Coweta","2020-04-29","99","2147","4","238","6.1","8.3"
"Coweta","2020-04-30","141","2288","7","245","5.5","7.4"
"Coweta","2020-05-01","63","2351","4","249","4.8","7.1"
"Coweta","2020-05-02","73","2424","2","251","4.5","6"
"Coweta","2020-05-03","30","2454","3","254","5.3","6.1"
"Coweta","2020-05-04","136","2590","5","259","4.7","5.9"
"Coweta","2020-05-05","109","2699","2","261","4.8","5.6"
"Coweta","2020-05-06","111","2810","3","264","4.6","5.4"
"Coweta","2020-05-07","96","2906","8","272","5.1","5.3"
"Coweta","2020-05-08","139","3045","7","279","4.9","4.8"
"Coweta","2020-05-09","72","3117","0","279","4.5","4.5"
"Coweta","2020-05-10","29","3146","5","284","5.5","5.4"
"Coweta","2020-05-11","196","3342","7","291","5.5","5.1"
"Coweta","2020-05-12","170","3512","4","295","5.6","5.2"
"Coweta","2020-05-13","175","3687","5","300","5.6","5.1"
"Coweta","2020-05-14","160","3847","13","313","5.6","5.3"
"Coweta","2020-05-15","181","4028","11","324","5.7","5.3"
"Coweta","2020-05-16","113","4141","11","335","7.1","5.8"
"Coweta","2020-05-17","39","4180","2","337","5.4","5.5"
"Coweta","2020-05-18","133","4313","7","344","5.6","5.6"
"Coweta","2020-05-19","298","4611","17","361","6.1","5.9"
"Coweta","2020-05-20","201","4812","4","365","6","5.8"
"Coweta","2020-05-21","135","4947","5","370","5.4","5.5"
"Coweta","2020-05-22","123","5070","12","382","5.9","5.8"
"Coweta","2020-05-23","73","5143","14","396","7.2","7.2"
"Coweta","2020-05-24","32","5175","1","397","7","6.2"
"Coweta","2020-05-25","47","5222","3","400","7.1","6.4"
"Coweta","2020-05-26","199","5421","6","406","6.7","6.4"
"Coweta","2020-05-27","194","5615","5","411","6.8","6.4"
"Coweta","2020-05-28","178","5793","11","422","7.2","6.3"
"Coweta","2020-05-29","172","5965","9","431","6.5","6.2"
"Coweta","2020-05-30","24","5989","2","433","5","6.1"
"Coweta","2020-05-31","36","6025","4","437","6.1","6.5"
"Coweta","2020-06-01","178","6203","4","441","5.5","6.3"
"Coweta","2020-06-02","170","6373","10","451","5.9","6.3"
"Coweta","2020-06-03","153","6526","4","455","5.9","6.4"
"Coweta","2020-06-04","153","6679","5","460","5.5","6.4"
"Coweta","2020-06-05","105","6784","4","464","5.3","5.9"
"Coweta","2020-06-06","36","6820","3","467","5.3","5.2"
"Coweta","2020-06-07","28","6848","5","472","6.3","6.2"
"Coweta","2020-06-08","105","6953","1","473","6.1","5.8"
"Coweta","2020-06-09","109","7062","4","477","5.8","5.9"
"Coweta","2020-06-10","92","7154","6","483","6.3","6.1"
"Coweta","2020-06-11","164","7318","8","491","6.6","6.1"
"Coweta","2020-06-12","255","7573","6","497","6.4","5.8"
"Coweta","2020-06-13","38","7611","5","502","7.1","6.2"
"Coweta","2020-06-14","31","7642","4","506","6.3","6.3"
"Coweta","2020-06-15","198","7840","11","517","7","6.6"
"Coweta","2020-06-16","210","8050","9","526","7.1","6.4"
"Coweta","2020-06-17","192","8242","11","537","7","6.7"
"Coweta","2020-06-18","159","8401","18","555","7.9","7.2"
"Coweta","2020-06-19","156","8557","13","568","8.8","7.6"
"Coweta","2020-06-20","34","8591","2","570","7.7","7.4"
"Coweta","2020-06-21","33","8624","5","575","8","7.2"
"Coweta","2020-06-22","274","8898","25","600","8.5","7.8"
"Coweta","2020-06-23","311","9209","25","625","9.1","8.1"
"Coweta","2020-06-24","206","9415","17","642","9.4","8.2"
"Coweta","2020-06-25","133","9548","11","653","9","8.5"
"Coweta","2020-06-26","257","9805","13","666","8.5","8.6"
"Coweta","2020-06-27","35","9840","6","672","10.1","8.9"
"Coweta","2020-06-28","32","9872","3","675","9.3","8.7"
"Coweta","2020-06-29","331","10203","20","695","8.9","8.7"
"Coweta","2020-06-30","318","10521","15","710","8.4","8.7"
"Coweta","2020-07-01","252","10773","11","721","7.9","8.6"
"Coweta","2020-07-02","275","11048","18","739","7.6","8.3"
"Coweta","2020-07-03","90","11138","8","747","8.2","8.3"
"Coweta","2020-07-04","27","11165","7","754","9.4","9.8"
"Coweta","2020-07-05","42","11207","8","762","10.8","10.1"
"Coweta","2020-07-06","294","11501","29","791","11.3","10.1"
"Coweta","2020-07-07","311","11812","29","820","12","10.2"
"Coweta","2020-07-08","177","11989","10","830","12.2","10"
"Coweta","2020-07-09","191","12180","25","855","13.1","10.4"
"Coweta","2020-07-10","184","12364","10","865","12.6","10.4"
"Coweta","2020-07-11","58","12422","13","878","12.1","10.8"
"Coweta","2020-07-12","45","12467","11","889","12.9","11.8"
"Coweta","2020-07-13","162","12629","7","896","12.1","11.7"
"Coweta","2020-07-14","159","12788","24","920","12.9","12.5"
"Coweta","2020-07-15","159","12947","18","938","13.7","13"
"Coweta","2020-07-16","132","13079","24","962","14.5","13.8"
"Coweta","2020-07-17","131","13210","19","981","15.8","14.2"
"Coweta","2020-07-18","44","13254","6","987","14.5","13.3"
"Coweta","2020-07-19","31","13285","3","990","12.4","12.6"
"Coweta","2020-07-20","150","13435","18","1008","13.5","12.8"
"Coweta","2020-07-21","112","13547","15","1023","13.2","13.1"
"Coweta","2020-07-22","120","13667","14","1037","13.3","13.5"
"Coweta","2020-07-23","176","13843","12","1049","11.7","13.1"
"Coweta","2020-07-24","145","13988","12","1061","10.8","13.3"
"Coweta","2020-07-25","58","14046","9","1070","11","12.8"
"Coweta","2020-07-26","32","14078","4","1074","11.5","11.9"
"Coweta","2020-07-27","216","14294","12","1086","10.5","12"
"Coweta","2020-07-28","170","14464","11","1097","9.5","11.4"
"Coweta","2020-07-29","152","14616","15","1112","9.3","11.3"
"Coweta","2020-07-30","125","14741","14","1126","9.9","10.8"
"Coweta","2020-07-31","132","14873","7","1133","9.5","10.1"
"Coweta","2020-08-01","58","14931","7","1140","9","10"
"Coweta","2020-08-02","46","14977","7","1147","9.4","10.4"
"Coweta","2020-08-03","176","15153","19","1166","10.1","10.3"
"Coweta","2020-08-04","208","15361","8","1174","9.8","9.7"
"Coweta","2020-08-05","119","15480","6","1180","9.1","9.2"
"Coweta","2020-08-06","199","15679","11","1191","8.3","9.1"
"Coweta","2020-08-07","175","15854","12","1203","8.5","9"
"Coweta","2020-08-08","91","15945","7","1210","7.9","8.4"
"Coweta","2020-08-09","55","16000","6","1216","7.2","8.3"
"Coweta","2020-08-10","208","16208","9","1225","6.3","8.2"
"Coweta","2020-08-11","268","16476","47","1272","8.3","9"
"Coweta","2020-08-12","291","16767","37","1309","9.4","9.2"
"Coweta","2020-08-13","232","16999","30","1339","10.4","9.3"
"Coweta","2020-08-14","322","17321","40","1379","11.2","9.8"
"Coweta","2020-08-15","102","17423","9","1388","11.4","9.6"
"Coweta","2020-08-16","69","17492","4","1392","10.7","8.9"
"Coweta","2020-08-17","324","17816","24","1416","11.1","8.7"
"Coweta","2020-08-18","228","18044","27","1443","10.3","9.3"
"Coweta","2020-08-19","257","18301","35","1478","10.4","9.9"
"Coweta","2020-08-20","224","18525","18","1496","9.7","10.1"
"Coweta","2020-08-21","248","18773","35","1531","9.9","10.6"
"Coweta","2020-08-22","68","18841","7","1538","10.2","10.8"
"Coweta","2020-08-23","73","18914","13","1551","11.9","11.3"
"Coweta","2020-08-24","281","19195","58","1609","13.8","12.4"
"Coweta","2020-08-25","199","19394","24","1633","13.8","12"
"Coweta","2020-08-26","194","19588","23","1656","13.5","12"
"Coweta","2020-08-27","164","19752","21","1677","14.2","12"
"Coweta","2020-08-28","258","20010","31","1708","13.9","11.9"
"Coweta","2020-08-29","58","20068","3","1711","13.2","11.7"
"Coweta","2020-08-30","66","20134","7","1718","12.2","12"
"Coweta","2020-08-31","228","20362","31","1749","11.2","12.5"
"Coweta","2020-09-01","198","20560","13","1762","10.4","12.1"
"Coweta","2020-09-02","198","20758","24","1786","10.4","12"
"Coweta","2020-09-03","188","20946","26","1812","10.6","12.4"
"Coweta","2020-09-04","205","21151","24","1836","10.5","12.2"
"Coweta","2020-09-05","54","21205","4","1840","10.8","12"
"Coweta","2020-09-06","30","21235","1","1841","9.8","11"
"Coweta","2020-09-07","115","21350","16","1857","9.8","10.5"
"Coweta","2020-09-08","194","21544","18","1875","10.2","10.3"
"Coweta","2020-09-09","192","21736","15","1890","9.6","10"
"Coweta","2020-09-10","234","21970","19","1909","8.8","9.7"
"Coweta","2020-09-11","197","22167","17","1926","8.4","9.4"
"Coweta","2020-09-12","42","22209","6","1932","9.3","10.1"
"Coweta","2020-09-13","47","22256","1","1933","9.2","9.5"
"Coweta","2020-09-14","261","22517","31","1964","8.9","9.4"
"Coweta","2020-09-15","219","22736","10","1974","8.2","9.2"
"Coweta","2020-09-16","132","22868","0","1974","7.1","8.3"
"Coweta","2020-09-17","132","23000","3","1977","6.3","7.5"
"Coweta","2020-09-18","243","23243","15","1992","5.9","7.1"
"Coweta","2020-09-19","50","23293","2","1994","4.4","6.9"
"Coweta","2020-09-20","34","23327","4","1998","5.8","7.5"
"Coweta","2020-09-21","219","23546","10","2008","4.8","6.8"
"Coweta","2020-09-22","204","23750","10","2018","4.8","6.5"
"Coweta","2020-09-23","212","23962","4","2022","5.1","6.1"
"Coweta","2020-09-24","156","24118","16","2038","6.2","6.2"
"Coweta","2020-09-25","196","24314","3","2041","5.6","5.7"
"Coweta","2020-09-26","87","24401","7","2048","6.1","5.3"
"Coweta","2020-09-27","40","24441","1","2049","4.8","5.3"
"Coweta","2020-09-28","221","24662","13","2062","5","4.9"
"Coweta","2020-09-29","211","24873","7","2069","4.8","4.8"
"Coweta","2020-09-30","184","25057","11","2080","5.4","5.2"
"Coweta","2020-10-01","191","25248","9","2089","4.6","5.4"
"Coweta","2020-10-02","180","25428","5","2094","4.7","5.2"
"Coweta","2020-10-03","80","25508","5","2099","4.5","5.3"
"Coweta","2020-10-04","57","25565","1","2100","4.4","4.6"
"Coweta","2020-10-05","326","25891","12","2112","4.1","4.5"
"Coweta","2020-10-06","274","26165","14","2126","4.3","4.5"
"Coweta","2020-10-07","204","26369","11","2137","4.2","4.8"
"Coweta","2020-10-08","236","26605","25","2162","5.1","4.8"
"Coweta","2020-10-09","220","26825","13","2175","5.5","5.1"
"Coweta","2020-10-10","48","26873","2","2177","5.2","4.9"
"Coweta","2020-10-11","48","26921","6","2183","6.8","5.6"
"Coweta","2020-10-12","204","27125","5","2188","6.6","5.3"
"Coweta","2020-10-13","305","27430","23","2211","6.9","5.6"
"Coweta","2020-10-14","282","27712","15","2226","6.9","5.6"
"Coweta","2020-10-15","192","27904","12","2238","6.3","5.7"
"Coweta","2020-10-16","246","28150","6","2244","5.8","5.7"
"Coweta","2020-10-17","58","28208","3","2247","6","5.6"
"Coweta","2020-10-18","68","28276","2","2249","4.6","5.7"
"Coweta","2020-10-19","296","28572","17","2266","5.1","5.8"
"Coweta","2020-10-20","230","28802","13","2279","4.8","5.9"
"Coweta","2020-10-21","249","29051","20","2299","5.2","6.1"
"Coweta","2020-10-22","233","29284","18","2317","5.4","5.8"
"Coweta","2020-10-23","261","29545","13","2330","5.7","5.8"
"Coweta","2020-10-24","78","29623","9","2339","6.7","6.3"
"Coweta","2020-10-25","63","29686","2","2341","6.7","5.6"
"Coweta","2020-10-26","315","30001","26","2367","7.1","6.1"
"Coweta","2020-10-27","321","30322","24","2391","7.3","6"
"Coweta","2020-10-28","247","30569","15","2406","7","6.1"
"Coweta","2020-10-29","169","30738","10","2416","6.8","6.1"
"Coweta","2020-10-30","288","31026","14","2430","6.8","6.3"
"Coweta","2020-10-31","72","31098","4","2434","5.9","6.3"
"Coweta","2020-11-01","82","31180","2","2436","5.8","6.2"
"Coweta","2020-11-02","315","31495","20","2456","5.5","6.3"
"Coweta","2020-11-03","179","31674","10","2466","5.3","6.3"
"Coweta","2020-11-04","290","31964","24","2490","5.6","6.3"
"Coweta","2020-11-05","258","32222","15","2505","5.6","6.2"
"Coweta","2020-11-06","236","32458","21","2526","6.1","6.4"
"Coweta","2020-11-07","89","32547","3","2529","5.8","5.9"
"Coweta","2020-11-08","76","32623","6","2535","6.6","6.2"
"Coweta","2020-11-09","273","32896","16","2551","6.5","6"
"Coweta","2020-11-10","315","33211","11","2562","6.2","5.7"
"Coweta","2020-11-11","263","33474","10","2572","5.6","5.6"
"Coweta","2020-11-12","224","33698","15","2587","5.7","5.6"
"Coweta","2020-11-13","333","34031","26","2613","5.6","5.8"
"Coweta","2020-11-14","116","34147","14","2627","6.8","6.3"
"Coweta","2020-11-15","95","34242","10","2637","7.2","6.9"
"Coweta","2020-11-16","407","34649","49","2686","8.1","7.3"
"Coweta","2020-11-17","427","35076","44","2730","9","7.6"
"Coweta","2020-11-18","423","35499","34","2764","9.6","7.6"
"Coweta","2020-11-19","403","35902","21","2785","9.4","7.6"
"Coweta","2020-11-20","394","36296","29","2814","9.4","7.5"
"Coweta","2020-11-21","128","36424","13","2827","9.1","7.9"
"Coweta","2020-11-22","113","36537","12","2839","9.1","8.1"
"Coweta","2020-11-23","575","37112","74","2913","9.2","8.6"
"Coweta","2020-11-24","444","37556","50","2963","9.4","9.2"
"Coweta","2020-11-25","396","37952","41","3004","9.7","9.7"
"Coweta","2020-11-26","39","37991","3","3007","10","9.7"
"Coweta","2020-11-27","151","38142","25","3032","11.4","10.4"
"Coweta","2020-11-28","121","38263","13","3045","11.4","10.3"
"Coweta","2020-11-29","99","38362","16","3061","12.2","10.7"
"Coweta","2020-11-30","456","38818","62","3123","12.3","10.8"
"Coweta","2020-12-01","397","39215","27","3150","11.7","10.5"
"Coweta","2020-12-02","411","39626","36","3186","11.5","10.6"
"Coweta","2020-12-03","420","40046","54","3240","12.2","11.1"
"Coweta","2020-12-04","401","40447","47","3287","11.5","11.4"
"Coweta","2020-12-05","133","40580","18","3305","11.9","11.7"
"Coweta","2020-12-06","127","40707","19","3324","11.7","12"
"Coweta","2020-12-07","465","41172","67","3391","11.9","12.1"
"Coweta","2020-12-08","518","41690","61","3452","12.6","12.1"
"Coweta","2020-12-09","525","42215","66","3518","13.1","12.3"
"Coweta","2020-12-10","506","42721","58","3576","12.9","12.6"
"Coweta","2020-12-11","453","43174","62","3638","13.2","12.4"
"Coweta","2020-12-12","217","43391","40","3678","13.9","12.9"
"Coweta","2020-12-13","141","43532","17","3695","13.5","12.6"
"Coweta","2020-12-14","603","44135","75","3770","13.2","12.5"
"Coweta","2020-12-15","551","44686","64","3834","13.2","12.9"
"Coweta","2020-12-16","526","45212","79","3913","13.5","13.3"
"Coweta","2020-12-17","526","45738","90","4003","14.3","13.6"
"Coweta","2020-12-18","551","46289","86","4089","14.6","13.9"
"Coweta","2020-12-19","221","46510","42","4131","14.7","14.3"
"Coweta","2020-12-20","175","46685","29","4160","15.3","14.4"
"Coweta","2020-12-21","581","47266","85","4245","15.7","14.4"
"Coweta","2020-12-22","573","47839","100","4345","16.5","14.8"
"Coweta","2020-12-23","492","48331","64","4409","16.2","14.9"
"Coweta","2020-12-24","244","48575","45","4454","16.4","15.4"
"Coweta","2020-12-25","64","48639","11","4465","16.6","15.6"
"Coweta","2020-12-26","225","48864","57","4522","17.5","16.1"
"Coweta","2020-12-27","190","49054","44","4566","18.5","16.9"
"Coweta","2020-12-28","565","49619","137","4703","19.8","17.7"
"Coweta","2020-12-29","569","50188","149","4852","21.1","18.8"
"Coweta","2020-12-30","360","50548","65","4917","21.8","19"
"Coweta","2020-12-31","504","51052","104","5021","22.1","19.3"
"Coweta","2021-01-01","86","51138","15","5036","22.2","19.4"
"Coweta","2021-01-02","220","51358","40","5076","21.1","19.3"
"Coweta","2021-01-03","130","51488","33","5109","21.4","20"
"Coweta","2021-01-04","368","51856","86","5195","21.3","20.6"
"Coweta","2021-01-05","768","52624","123","5318","19.9","20.5"
"Coweta","2021-01-06","626","53250","121","5439","20.1","20.9"
"Coweta","2021-01-07","599","53849","109","5548","19.7","20.9"
"Coweta","2021-01-08","608","54457","118","5666","20","21.1"
"Coweta","2021-01-09","192","54649","34","5700","19.9","20.5"
"Coweta","2021-01-10","161","54810","29","5729","18.9","20.2"
"Coweta","2021-01-11","531","55341","89","5818","17.9","19.6"
"Coweta","2021-01-12","611","55952","81","5899","17.5","18.7"
"Coweta","2021-01-13","543","56495","99","5998","17.4","18.7"
"Coweta","2021-01-14","526","57021","65","6063","16.5","18.1"
"Coweta","2021-01-15","488","57509","67","6130","15.7","17.9"
"Coweta","2021-01-16","248","57757","54","6184","16.3","18.1"
"Coweta","2021-01-17","172","57929","26","6210","15.9","17.4"
"Coweta","2021-01-18","414","58343","65","6275","15.7","16.8"
"Coweta","2021-01-19","660","59003","84","6359","15.7","16.6"
"Coweta","2021-01-20","483","59486","66","6425","15","16.2"
"Coweta","2021-01-21","632","60118","94","6519","15.4","16"
"Coweta","2021-01-22","517","60635","55","6574","14.9","15.3"
"Coweta","2021-01-23","155","60790","27","6601","14.3","15.3"
"Coweta","2021-01-24","65","60855","9","6610","14.1","15"
"Coweta","2021-01-25","216","61071","15","6625","12.9","14.3"
"Coweta","2021-01-26","9","61080","1","6626","12.6","14.2"
"Coweta","2021-01-27","0","61080","0","6626","10.7","12.9"
"Crawford","2020-02-01","0","0","0","0",".","."
"Crawford","2020-02-02","0","0","0","0",".","."
"Crawford","2020-02-03","0","0","0","0",".","."
"Crawford","2020-02-04","0","0","0","0",".","."
"Crawford","2020-02-05","0","0","0","0",".","."
"Crawford","2020-02-06","0","0","0","0",".","."
"Crawford","2020-02-07","0","0","0","0","0","."
"Crawford","2020-02-08","0","0","0","0","0","."
"Crawford","2020-02-09","0","0","0","0","0","."
"Crawford","2020-02-10","0","0","0","0","0","."
"Crawford","2020-02-11","0","0","0","0","0","."
"Crawford","2020-02-12","0","0","0","0","0","."
"Crawford","2020-02-13","0","0","0","0","0","."
"Crawford","2020-02-14","1","1","0","0","0","0"
"Crawford","2020-02-15","0","1","0","0","0","0"
"Crawford","2020-02-16","0","1","0","0","0","0"
"Crawford","2020-02-17","0","1","0","0","0","0"
"Crawford","2020-02-18","0","1","0","0","0","0"
"Crawford","2020-02-19","0","1","0","0","0","0"
"Crawford","2020-02-20","0","1","0","0","0","0"
"Crawford","2020-02-21","0","1","0","0","0","0"
"Crawford","2020-02-22","0","1","0","0","0","0"
"Crawford","2020-02-23","0","1","0","0","0","0"
"Crawford","2020-02-24","0","1","0","0","0","0"
"Crawford","2020-02-25","0","1","0","0","0","0"
"Crawford","2020-02-26","0","1","0","0","0","0"
"Crawford","2020-02-27","0","1","0","0","0","0"
"Crawford","2020-02-28","0","1","0","0","0","0"
"Crawford","2020-02-29","0","1","0","0","0","0"
"Crawford","2020-03-01","0","1","0","0","0","0"
"Crawford","2020-03-02","0","1","0","0","0","0"
"Crawford","2020-03-03","0","1","0","0","0","0"
"Crawford","2020-03-04","0","1","0","0","0","0"
"Crawford","2020-03-05","0","1","0","0","0","0"
"Crawford","2020-03-06","0","1","0","0","0","0"
"Crawford","2020-03-07","0","1","0","0","0","0"
"Crawford","2020-03-08","0","1","0","0","0","0"
"Crawford","2020-03-09","0","1","0","0","0","0"
"Crawford","2020-03-10","0","1","0","0","0","0"
"Crawford","2020-03-11","0","1","0","0","0","0"
"Crawford","2020-03-12","1","2","0","0","0","0"
"Crawford","2020-03-13","0","2","0","0","0","0"
"Crawford","2020-03-14","0","2","0","0","0","0"
"Crawford","2020-03-15","0","2","0","0","0","0"
"Crawford","2020-03-16","0","2","0","0","0","0"
"Crawford","2020-03-17","1","3","0","0","0","0"
"Crawford","2020-03-18","2","5","0","0","0","0"
"Crawford","2020-03-19","2","7","0","0","0","0"
"Crawford","2020-03-20","2","9","0","0","0","0"
"Crawford","2020-03-21","0","9","0","0","0","0"
"Crawford","2020-03-22","0","9","0","0","0","0"
"Crawford","2020-03-23","3","12","0","0","0","0"
"Crawford","2020-03-24","10","22","0","0","0","0"
"Crawford","2020-03-25","0","22","0","0","0","0"
"Crawford","2020-03-26","2","24","0","0","0","0"
"Crawford","2020-03-27","3","27","0","0","0","0"
"Crawford","2020-03-28","2","29","0","0","0","0"
"Crawford","2020-03-29","5","34","0","0","0","0"
"Crawford","2020-03-30","1","35","0","0","0","0"
"Crawford","2020-03-31","0","35","0","0","0","0"
"Crawford","2020-04-01","7","42","0","0","0","0"
"Crawford","2020-04-02","4","46","1","1","3.6","1.8"
"Crawford","2020-04-03","3","49","0","1","3.6","1.8"
"Crawford","2020-04-04","0","49","0","1","3.6","1.8"
"Crawford","2020-04-05","3","52","2","3","13.1","6.5"
"Crawford","2020-04-06","4","56","1","4","16.7","8.3"
"Crawford","2020-04-07","7","63","4","8","24.8","12.4"
"Crawford","2020-04-08","7","70","0","8","24.8","12.4"
"Crawford","2020-04-09","5","75","4","12","32.7","18.1"
"Crawford","2020-04-10","7","82","0","12","32.7","18.1"
"Crawford","2020-04-11","0","82","0","12","32.7","18.1"
"Crawford","2020-04-12","4","86","0","12","23.2","18.1"
"Crawford","2020-04-13","5","91","0","12","19.6","18.1"
"Crawford","2020-04-14","7","98","4","16","19.6","22.2"
"Crawford","2020-04-15","6","104","0","16","19.6","22.2"
"Crawford","2020-04-16","2","106","0","16","8.2","20.4"
"Crawford","2020-04-17","3","109","0","16","8.2","20.4"
"Crawford","2020-04-18","4","113","0","16","8.2","20.4"
"Crawford","2020-04-19","0","113","0","16","8.2","15.7"
"Crawford","2020-04-20","0","113","0","16","8.2","13.9"
"Crawford","2020-04-21","6","119","0","16","0","9.8"
"Crawford","2020-04-22","5","124","0","16","0","9.8"
"Crawford","2020-04-23","3","127","0","16","0","4.1"
"Crawford","2020-04-24","4","131","1","17","3.6","5.9"
"Crawford","2020-04-25","0","131","0","17","3.6","5.9"
"Crawford","2020-04-26","0","131","0","17","3.6","5.9"
"Crawford","2020-04-27","6","137","3","20","10.7","9.4"
"Crawford","2020-04-28","7","144","0","20","10.7","5.4"
"Crawford","2020-04-29","6","150","3","23","17.9","8.9"
"Crawford","2020-04-30","4","154","2","25","25","12.5"
"Crawford","2020-05-01","4","158","0","25","21.4","12.5"
"Crawford","2020-05-02","3","161","0","25","21.4","12.5"
"Crawford","2020-05-03","4","165","0","25","21.4","12.5"
"Crawford","2020-05-04","6","171","0","25","14.3","12.5"
"Crawford","2020-05-05","1","172","0","25","14.3","12.5"
"Crawford","2020-05-06","0","172","0","25","7.1","12.5"
"Crawford","2020-05-07","18","190","0","25","0","12.5"
"Crawford","2020-05-08","4","194","0","25","0","10.7"
"Crawford","2020-05-09","1","195","0","25","0","10.7"
"Crawford","2020-05-10","1","196","0","25","0","10.7"
"Crawford","2020-05-11","27","223","8","33","4.2","9.3"
"Crawford","2020-05-12","10","233","7","40","14.2","14.3"
"Crawford","2020-05-13","12","245","1","41","15.4","11.3"
"Crawford","2020-05-14","18","263","1","42","16.2","8.1"
"Crawford","2020-05-15","8","271","0","42","16.2","8.1"
"Crawford","2020-05-16","0","271","0","42","16.2","8.1"
"Crawford","2020-05-17","1","272","0","42","16.2","8.1"
"Crawford","2020-05-18","2","274","1","43","19.1","11.7"
"Crawford","2020-05-19","13","287","2","45","11.3","12.8"
"Crawford","2020-05-20","9","296","0","45","10.1","12.8"
"Crawford","2020-05-21","21","317","1","46","10","13.1"
"Crawford","2020-05-22","3","320","1","47","14.8","15.5"
"Crawford","2020-05-23","1","321","0","47","14.8","15.5"
"Crawford","2020-05-24","4","325","0","47","14.8","15.5"
"Crawford","2020-05-25","6","331","0","47","7.6","13.4"
"Crawford","2020-05-26","13","344","0","47","5.4","8.4"
"Crawford","2020-05-27","5","349","0","47","5.4","7.8"
"Crawford","2020-05-28","23","372","2","49","6","8"
"Crawford","2020-05-29","3","375","0","49","1.2","8"
"Crawford","2020-05-30","2","377","1","50","8.4","11.6"
"Crawford","2020-05-31","5","382","0","50","8.4","11.6"
"Crawford","2020-06-01","7","389","0","50","8.4","8"
"Crawford","2020-06-02","4","393","1","51","12","8.7"
"Crawford","2020-06-03","7","400","0","51","12","8.7"
"Crawford","2020-06-04","15","415","0","51","10.7","8.4"
"Crawford","2020-06-05","11","426","0","51","10.7","6"
"Crawford","2020-06-06","1","427","0","51","3.6","6"
"Crawford","2020-06-07","4","431","1","52","7.1","7.8"
"Crawford","2020-06-08","6","437","0","52","7.1","7.8"
"Crawford","2020-06-09","3","440","0","52","3.6","7.8"
"Crawford","2020-06-10","6","446","0","52","3.6","7.8"
"Crawford","2020-06-11","16","462","1","53","4.5","7.6"
"Crawford","2020-06-12","7","469","0","53","4.5","7.6"
"Crawford","2020-06-13","2","471","1","54","11.6","7.6"
"Crawford","2020-06-14","6","477","2","56","12.8","10"
"Crawford","2020-06-15","10","487","0","56","12.8","10"
"Crawford","2020-06-16","5","492","0","56","12.8","8.2"
"Crawford","2020-06-17","8","500","1","57","14.6","9.1"
"Crawford","2020-06-18","20","520","1","58","14.4","9.4"
"Crawford","2020-06-19","22","542","0","58","14.4","9.4"
"Crawford","2020-06-20","1","543","0","58","7.3","9.4"
"Crawford","2020-06-21","40","583","0","58","2.5","7.6"
"Crawford","2020-06-22","22","605","0","58","2.5","7.6"
"Crawford","2020-06-23","9","614","1","59","4.1","8.4"
"Crawford","2020-06-24","12","626","0","59","2.3","8.4"
"Crawford","2020-06-25","25","651","3","62","3.3","8.9"
"Crawford","2020-06-26","12","663","0","62","3.3","8.9"
"Crawford","2020-06-27","4","667","2","64","10.4","8.9"
"Crawford","2020-06-28","6","673","3","67","17.6","10"
"Crawford","2020-06-29","16","689","4","71","21.2","11.8"
"Crawford","2020-06-30","7","696","2","73","23.7","13.9"
"Crawford","2020-07-01","14","710","4","77","27.7","15"
"Crawford","2020-07-02","44","754","12","89","29.9","16.6"
"Crawford","2020-07-03","10","764","1","90","31.3","17.3"
"Crawford","2020-07-04","2","766","0","90","24.2","17.3"
"Crawford","2020-07-05","1","767","0","90","17.1","17.3"
"Crawford","2020-07-06","22","789","3","93","15.4","18.3"
"Crawford","2020-07-07","16","805","4","97","14.9","19.3"
"Crawford","2020-07-08","9","814","3","100","15.6","21.7"
"Crawford","2020-07-09","35","849","8","108","15","22.4"
"Crawford","2020-07-10","12","861","0","108","13.5","22.4"
"Crawford","2020-07-11","5","866","1","109","16.4","20.3"
"Crawford","2020-07-12","7","873","3","112","22.5","19.8"
"Crawford","2020-07-13","24","897","2","114","21.8","18.6"
"Crawford","2020-07-14","15","912","3","117","21.1","18"
"Crawford","2020-07-15","16","928","3","120","19","17.3"
"Crawford","2020-07-16","39","967","7","127","18.3","16.6"
"Crawford","2020-07-17","24","991","6","133","21.8","17.7"
"Crawford","2020-07-18","8","999","0","133","19","17.7"
"Crawford","2020-07-19","0","999","0","133","12.9","17.7"
"Crawford","2020-07-20","13","1012","2","135","13.9","17.8"
"Crawford","2020-07-21","19","1031","2","137","12.5","16.8"
"Crawford","2020-07-22","10","1041","2","139","12.7","15.8"
"Crawford","2020-07-23","43","1084","5","144","11.8","15"
"Crawford","2020-07-24","18","1102","2","146","9.8","15.8"
"Crawford","2020-07-25","9","1111","1","147","11.4","15.2"
"Crawford","2020-07-26","6","1117","1","148","13.8","13.3"
"Crawford","2020-07-27","26","1143","1","149","12.1","13"
"Crawford","2020-07-28","13","1156","2","151","12.8","12.7"
"Crawford","2020-07-29","16","1172","4","155","13.5","13.1"
"Crawford","2020-07-30","54","1226","7","162","13.7","12.8"
"Crawford","2020-07-31","12","1238","1","163","13.3","11.6"
"Crawford","2020-08-01","6","1244","3","166","18.9","15.1"
"Crawford","2020-08-02","3","1247","0","166","16.5","15.1"
"Crawford","2020-08-03","13","1260","2","168","18.2","15.1"
"Crawford","2020-08-04","11","1271","1","169","17.3","15"
"Crawford","2020-08-05","15","1286","2","171","15.6","14.6"
"Crawford","2020-08-06","49","1335","2","173","14.3","14"
"Crawford","2020-08-07","21","1356","4","177","15.8","14.6"
"Crawford","2020-08-08","5","1361","0","177","8.7","13.8"
"Crawford","2020-08-09","8","1369","2","179","12.3","14.4"
"Crawford","2020-08-10","15","1384","1","180","11","14.6"
"Crawford","2020-08-11","15","1399","4","184","13.5","15.4"
"Crawford","2020-08-12","11","1410","2","186","14.2","14.9"
"Crawford","2020-08-13","63","1473","3","189","14.3","14.3"
"Crawford","2020-08-14","19","1492","3","192","13.9","14.9"
"Crawford","2020-08-15","12","1504","4","196","18.6","13.7"
"Crawford","2020-08-16","5","1509","1","197","17.9","15.1"
"Crawford","2020-08-17","15","1524","3","200","19.8","15.4"
"Crawford","2020-08-18","15","1539","2","202","17.9","15.7"
"Crawford","2020-08-19","10","1549","2","204","18.2","16.2"
"Crawford","2020-08-20","40","1589","7","211","20","17.2"
"Crawford","2020-08-21","16","1605","0","211","17.7","15.8"
"Crawford","2020-08-22","12","1617","2","213","15.4","17"
"Crawford","2020-08-23","16","1633","3","216","15.2","16.5"
"Crawford","2020-08-24","18","1651","3","219","14.7","17.3"
"Crawford","2020-08-25","14","1665","4","223","16.9","17.4"
"Crawford","2020-08-26","19","1684","1","224","14.8","16.5"
"Crawford","2020-08-27","30","1714","8","232","16.1","18"
"Crawford","2020-08-28","19","1733","1","233","16.8","17.3"
"Crawford","2020-08-29","11","1744","2","235","17.1","16.2"
"Crawford","2020-08-30","5","1749","0","235","14.4","14.8"
"Crawford","2020-08-31","13","1762","1","236","13.1","13.9"
"Crawford","2020-09-01","17","1779","3","239","11.5","14.2"
"Crawford","2020-09-02","7","1786","2","241","14.9","14.8"
"Crawford","2020-09-03","38","1824","3","244","12.2","14.1"
"Crawford","2020-09-04","14","1838","2","246","13.5","15.2"
"Crawford","2020-09-05","10","1848","0","246","10.9","14"
"Crawford","2020-09-06","27","1875","0","246","10.9","12.6"
"Crawford","2020-09-07","7","1882","1","247","11.8","12.5"
"Crawford","2020-09-08","20","1902","0","247","9.3","10.4"
"Crawford","2020-09-09","12","1914","4","251","10","12.4"
"Crawford","2020-09-10","24","1938","2","253","10","11.1"
"Crawford","2020-09-11","16","1954","1","254","8.9","11.2"
"Crawford","2020-09-12","4","1958","0","254","8.9","9.9"
"Crawford","2020-09-13","2","1960","0","254","8.9","9.9"
"Crawford","2020-09-14","13","1973","1","255","7.9","9.9"
"Crawford","2020-09-15","13","1986","1","256","9","9.2"
"Crawford","2020-09-16","15","2001","1","257","5.2","7.6"
"Crawford","2020-09-17","21","2022","0","257","4","7"
"Crawford","2020-09-18","12","2034","1","258","4.3","6.6"
"Crawford","2020-09-19","14","2048","3","261","7.4","8.1"
"Crawford","2020-09-20","4","2052","0","261","7.4","8.1"
"Crawford","2020-09-21","9","2061","0","261","6.3","7.1"
"Crawford","2020-09-22","15","2076","0","261","5.2","7.1"
"Crawford","2020-09-23","10","2086","0","261","4.3","4.7"
"Crawford","2020-09-24","19","2105","1","262","5","4.5"
"Crawford","2020-09-25","11","2116","0","262","3.8","4.1"
"Crawford","2020-09-26","5","2121","2","264","6.5","6.9"
"Crawford","2020-09-27","5","2126","0","264","6.5","6.9"
"Crawford","2020-09-28","14","2140","0","264","6.5","6.4"
"Crawford","2020-09-29","11","2151","0","264","6.5","5.8"
"Crawford","2020-09-30","14","2165","0","264","6.5","5.4"
"Crawford","2020-10-01","15","2180","0","264","5.7","5.4"
"Crawford","2020-10-02","15","2195","1","265","6.7","5.2"
"Crawford","2020-10-03","10","2205","1","266","2.4","4.4"
"Crawford","2020-10-04","9","2214","3","269","7.1","6.8"
"Crawford","2020-10-05","20","2234","0","269","7.1","6.8"
"Crawford","2020-10-06","20","2254","1","270","7.9","7.2"
"Crawford","2020-10-07","6","2260","0","270","7.9","7.2"
"Crawford","2020-10-08","15","2275","3","273","10.7","8.2"
"Crawford","2020-10-09","15","2290","1","274","10.7","8.7"
"Crawford","2020-10-10","6","2296","0","274","9.3","5.8"
"Crawford","2020-10-11","5","2301","0","274","4.5","5.8"
"Crawford","2020-10-12","29","2330","2","276","5.5","6.3"
"Crawford","2020-10-13","20","2350","1","277","5.5","6.7"
"Crawford","2020-10-14","11","2361","1","278","6.8","7.3"
"Crawford","2020-10-15","20","2381","2","280","5.4","8"
"Crawford","2020-10-16","10","2391","0","280","4.4","7.6"
"Crawford","2020-10-17","3","2394","0","280","4.4","6.9"
"Crawford","2020-10-18","5","2399","1","281","7.3","5.9"
"Crawford","2020-10-19","31","2430","2","283","7.2","6.4"
"Crawford","2020-10-20","11","2441","0","283","6.5","6"
"Crawford","2020-10-21","13","2454","2","285","7.4","7.1"
"Crawford","2020-10-22","22","2476","3","288","7.9","6.7"
"Crawford","2020-10-23","18","2494","2","290","9.5","7"
"Crawford","2020-10-24","7","2501","1","291","11.6","8"
"Crawford","2020-10-25","5","2506","0","291","8.7","8"
"Crawford","2020-10-26","14","2520","0","291","7.8","7.5"
"Crawford","2020-10-27","13","2533","0","291","7.8","7.1"
"Crawford","2020-10-28","9","2542","0","291","5.6","6.5"
"Crawford","2020-10-29","14","2556","1","292","4.6","6.3"
"Crawford","2020-10-30","13","2569","2","294","5.3","7.4"
"Crawford","2020-10-31","3","2572","1","295","8","9.8"
"Crawford","2020-11-01","8","2580","0","295","8","8.3"
"Crawford","2020-11-02","13","2593","0","295","8","7.9"
"Crawford","2020-11-03","12","2605","1","296","9.2","8.5"
"Crawford","2020-11-04","13","2618","0","296","9.2","7.4"
"Crawford","2020-11-05","22","2640","1","297","8.8","6.7"
"Crawford","2020-11-06","24","2664","0","297","6.6","5.9"
"Crawford","2020-11-07","6","2670","0","297","1.8","4.9"
"Crawford","2020-11-08","1","2671","0","297","1.8","4.9"
"Crawford","2020-11-09","27","2698","1","298","2.4","5.2"
"Crawford","2020-11-10","14","2712","1","299","2.2","5.7"
"Crawford","2020-11-11","11","2723","1","300","3.5","6.3"
"Crawford","2020-11-12","31","2754","3","303","4.2","6.5"
"Crawford","2020-11-13","7","2761","0","303","4.2","5.4"
"Crawford","2020-11-14","11","2772","0","303","4.2","3"
"Crawford","2020-11-15","4","2776","1","304","7.8","4.8"
"Crawford","2020-11-16","22","2798","4","308","9.9","6.1"
"Crawford","2020-11-17","19","2817","0","308","8.9","5.5"
"Crawford","2020-11-18","12","2829","2","310","9.9","6.7"
"Crawford","2020-11-19","8","2837","0","310","8.5","6.4"
"Crawford","2020-11-20","15","2852","1","311","9.5","6.9"
"Crawford","2020-11-21","3","2855","0","311","9.5","6.9"
"Crawford","2020-11-22","6","2861","0","311","5.9","6.9"
"Crawford","2020-11-23","17","2878","3","314","5.9","7.9"
"Crawford","2020-11-24","11","2889","2","316","8.5","8.7"
"Crawford","2020-11-25","9","2898","2","318","9.2","9.6"
"Crawford","2020-11-26","3","2901","1","319","14","11.3"
"Crawford","2020-11-27","7","2908","0","319","13.1","11.3"
"Crawford","2020-11-28","6","2914","1","320","15.4","12.5"
"Crawford","2020-11-29","4","2918","1","321","19","12.5"
"Crawford","2020-11-30","26","2944","5","326","19.2","12.5"
"Crawford","2020-12-01","13","2957","1","327","17.7","13.1"
"Crawford","2020-12-02","14","2971","2","329","16.6","12.9"
"Crawford","2020-12-03","24","2995","5","334","14.8","14.4"
"Crawford","2020-12-04","19","3014","5","339","18.6","15.8"
"Crawford","2020-12-05","11","3025","2","341","18.8","17.1"
"Crawford","2020-12-06","8","3033","1","342","17","18"
"Crawford","2020-12-07","23","3056","5","347","17.4","18.3"
"Crawford","2020-12-08","18","3074","2","349","17.9","17.8"
"Crawford","2020-12-09","16","3090","2","351","17.6","17.1"
"Crawford","2020-12-10","42","3132","8","359","17.3","16.1"
"Crawford","2020-12-11","19","3151","0","359","13.6","16.1"
"Crawford","2020-12-12","8","3159","2","361","14.6","16.7"
"Crawford","2020-12-13","4","3163","2","363","19.9","18.5"
"Crawford","2020-12-14","27","3190","5","368","19.5","18.4"
"Crawford","2020-12-15","15","3205","5","373","22.6","20.2"
"Crawford","2020-12-16","20","3225","4","377","23.7","20.6"
"Crawford","2020-12-17","44","3269","8","385","23.6","20.5"
"Crawford","2020-12-18","22","3291","6","391","27.5","20.5"
"Crawford","2020-12-19","18","3309","8","399","30.3","22.4"
"Crawford","2020-12-20","14","3323","3","402","26.2","23"
"Crawford","2020-12-21","26","3349","8","410","27.9","23.7"
"Crawford","2020-12-22","15","3364","3","413","26","24.3"
"Crawford","2020-12-23","21","3385","7","420","27.9","25.8"
"Crawford","2020-12-24","11","3396","6","426","33.1","28.3"
"Crawford","2020-12-25","9","3405","2","428","32.4","29.9"
"Crawford","2020-12-26","15","3420","4","432","29.9","30.1"
"Crawford","2020-12-27","11","3431","5","437","33.3","29.7"
"Crawford","2020-12-28","39","3470","8","445","31.8","29.9"
"Crawford","2020-12-29","31","3501","5","450","31.3","28.6"
"Crawford","2020-12-30","26","3527","5","455","29.3","28.6"
"Crawford","2020-12-31","38","3565","7","462","24.1","28.6"
"Crawford","2021-01-01","5","3570","2","464","26.6","29.5"
"Crawford","2021-01-02","9","3579","3","467","27.6","28.7"
"Crawford","2021-01-03","12","3591","3","470","24.7","29"
"Crawford","2021-01-04","29","3620","5","475","24.2","28"
"Crawford","2021-01-05","35","3655","10","485","26","28.6"
"Crawford","2021-01-06","27","3682","6","491","26.4","27.8"
"Crawford","2021-01-07","44","3726","4","495","25.1","24.6"
"Crawford","2021-01-08","30","3756","2","497","20.3","23.5"
"Crawford","2021-01-09","22","3778","4","501","18.1","22.9"
"Crawford","2021-01-10","14","3792","3","504","17.6","21.1"
"Crawford","2021-01-11","33","3825","3","507","16.5","20.3"
"Crawford","2021-01-12","26","3851","8","515","16.8","21.4"
"Crawford","2021-01-13","19","3870","1","516","14.4","20.4"
"Crawford","2021-01-14","13","3883","1","517","14.2","19.6"
"Crawford","2021-01-15","10","3893","1","518","14.6","17.5"
"Crawford","2021-01-16","7","3900","2","520","16.1","17.1"
"Crawford","2021-01-17","10","3910","1","521","14.5","16.1"
"Crawford","2021-01-18","25","3935","4","525","15.5","16"
"Crawford","2021-01-19","16","3951","4","529","14.6","15.7"
"Crawford","2021-01-20","22","3973","7","536","18.4","16.4"
"Crawford","2021-01-21","35","4008","1","537","17.7","16"
"Crawford","2021-01-22","17","4025","1","538","17.2","15.9"
"Crawford","2021-01-23","12","4037","3","541","16.7","16.4"
"Crawford","2021-01-24","4","4041","0","541","15.2","14.9"
"Crawford","2021-01-25","3","4044","0","541","12.9","14.2"
"Crawford","2021-01-26","0","4044","0","541","9.4","12"
"Crawford","2021-01-27","0","4044","0","541","4.8","11.6"
"Crisp","2020-02-01","0","0","0","0",".","."
"Crisp","2020-02-02","0","0","0","0",".","."
"Crisp","2020-02-03","0","0","0","0",".","."
"Crisp","2020-02-04","0","0","0","0",".","."
"Crisp","2020-02-05","0","0","0","0",".","."
"Crisp","2020-02-06","0","0","0","0",".","."
"Crisp","2020-02-07","0","0","0","0","0","."
"Crisp","2020-02-08","0","0","0","0","0","."
"Crisp","2020-02-09","0","0","0","0","0","."
"Crisp","2020-02-10","0","0","0","0","0","."
"Crisp","2020-02-11","0","0","0","0","0","."
"Crisp","2020-02-12","0","0","0","0","0","."
"Crisp","2020-02-13","0","0","0","0","0","."
"Crisp","2020-02-14","0","0","0","0","0","0"
"Crisp","2020-02-15","0","0","0","0","0","0"
"Crisp","2020-02-16","0","0","0","0","0","0"
"Crisp","2020-02-17","0","0","0","0","0","0"
"Crisp","2020-02-18","0","0","0","0","0","0"
"Crisp","2020-02-19","0","0","0","0","0","0"
"Crisp","2020-02-20","0","0","0","0","0","0"
"Crisp","2020-02-21","0","0","0","0","0","0"
"Crisp","2020-02-22","0","0","0","0","0","0"
"Crisp","2020-02-23","0","0","0","0","0","0"
"Crisp","2020-02-24","0","0","0","0","0","0"
"Crisp","2020-02-25","0","0","0","0","0","0"
"Crisp","2020-02-26","0","0","0","0","0","0"
"Crisp","2020-02-27","0","0","0","0","0","0"
"Crisp","2020-02-28","0","0","0","0","0","0"
"Crisp","2020-02-29","0","0","0","0","0","0"
"Crisp","2020-03-01","0","0","0","0","0","0"
"Crisp","2020-03-02","0","0","0","0","0","0"
"Crisp","2020-03-03","0","0","0","0","0","0"
"Crisp","2020-03-04","0","0","0","0","0","0"
"Crisp","2020-03-05","0","0","0","0","0","0"
"Crisp","2020-03-06","0","0","0","0","0","0"
"Crisp","2020-03-07","0","0","0","0","0","0"
"Crisp","2020-03-08","0","0","0","0","0","0"
"Crisp","2020-03-09","0","0","0","0","0","0"
"Crisp","2020-03-10","0","0","0","0","0","0"
"Crisp","2020-03-11","1","1","0","0","0","0"
"Crisp","2020-03-12","0","1","0","0","0","0"
"Crisp","2020-03-13","1","2","0","0","0","0"
"Crisp","2020-03-14","0","2","0","0","0","0"
"Crisp","2020-03-15","0","2","0","0","0","0"
"Crisp","2020-03-16","4","6","1","1","3.6","1.8"
"Crisp","2020-03-17","4","10","2","3","10.7","5.4"
"Crisp","2020-03-18","4","14","0","3","10.7","5.4"
"Crisp","2020-03-19","3","17","1","4","15.5","7.7"
"Crisp","2020-03-20","8","25","1","5","17.3","8.6"
"Crisp","2020-03-21","1","26","0","5","17.3","8.6"
"Crisp","2020-03-22","3","29","0","5","17.3","8.6"
"Crisp","2020-03-23","12","41","4","9","18.5","11"
"Crisp","2020-03-24","9","50","2","11","14.5","12.6"
"Crisp","2020-03-25","13","63","3","14","17.8","14.2"
"Crisp","2020-03-26","5","68","2","16","18.7","17.1"
"Crisp","2020-03-27","8","76","2","18","20.5","18.9"
"Crisp","2020-03-28","10","86","6","24","29.1","23.2"
"Crisp","2020-03-29","5","91","4","28","40.5","28.9"
"Crisp","2020-03-30","11","102","4","32","41","29.7"
"Crisp","2020-03-31","10","112","4","36","43.5","29"
"Crisp","2020-04-01","16","128","5","41","44.7","31.2"
"Crisp","2020-04-02","18","146","5","46","42.9","30.8"
"Crisp","2020-04-03","11","157","2","48","41.9","31.2"
"Crisp","2020-04-04","1","158","0","48","33.4","31.2"
"Crisp","2020-04-05","2","160","0","48","21.9","31.2"
"Crisp","2020-04-06","16","176","4","52","20.3","30.6"
"Crisp","2020-04-07","26","202","9","61","19.5","31.5"
"Crisp","2020-04-08","9","211","2","63","18.3","31.5"
"Crisp","2020-04-09","15","226","7","70","21","31.9"
"Crisp","2020-04-10","17","243","5","75","22.6","32.2"
"Crisp","2020-04-11","4","247","1","76","26.1","29.7"
"Crisp","2020-04-12","7","254","2","78","30.2","26.1"
"Crisp","2020-04-13","27","281","14","92","34","27.2"
"Crisp","2020-04-14","25","306","5","97","32","25.8"
"Crisp","2020-04-15","18","324","6","103","33.5","25.9"
"Crisp","2020-04-16","25","349","7","110","30.9","25.9"
"Crisp","2020-04-17","30","379","5","115","29.1","25.8"
"Crisp","2020-04-18","10","389","4","119","31.2","28.7"
"Crisp","2020-04-19","4","393","1","120","30.7","30.5"
"Crisp","2020-04-20","27","420","7","127","27","30.5"
"Crisp","2020-04-21","36","456","12","139","28.9","30.4"
"Crisp","2020-04-22","39","495","9","148","27.4","30.5"
"Crisp","2020-04-23","9","504","4","152","29.8","30.3"
"Crisp","2020-04-24","29","533","5","157","29.9","29.5"
"Crisp","2020-04-25","7","540","1","158","26.2","28.7"
"Crisp","2020-04-26","7","547","1","159","24.7","27.7"
"Crisp","2020-04-27","40","587","8","167","23.8","25.4"
"Crisp","2020-04-28","37","624","8","175","22.1","25.5"
"Crisp","2020-04-29","20","644","3","178","21","24.2"
"Crisp","2020-04-30","27","671","1","179","15.2","22.5"
"Crisp","2020-05-01","22","693","4","183","15.3","22.6"
"Crisp","2020-05-02","13","706","3","186","16.6","21.4"
"Crisp","2020-05-03","4","710","1","187","18.1","21.4"
"Crisp","2020-05-04","18","728","1","188","16","19.9"
"Crisp","2020-05-05","28","756","3","191","14.5","18.3"
"Crisp","2020-05-06","33","789","4","195","14.1","17.5"
"Crisp","2020-05-07","30","819","3","198","14.9","15.1"
"Crisp","2020-05-08","25","844","2","200","13.5","14.4"
"Crisp","2020-05-09","16","860","0","200","10.2","13.4"
"Crisp","2020-05-10","7","867","5","205","16.8","17.5"
"Crisp","2020-05-11","76","943","8","213","17.5","16.8"
"Crisp","2020-05-12","41","984","0","213","16","15.2"
"Crisp","2020-05-13","29","1013","1","214","14.8","14.4"
"Crisp","2020-05-14","44","1057","4","218","14.6","14.8"
"Crisp","2020-05-15","31","1088","3","221","14.9","14.2"
"Crisp","2020-05-16","7","1095","1","222","16.9","13.6"
"Crisp","2020-05-17","52","1147","8","230","8.9","12.9"
"Crisp","2020-05-18","22","1169","2","232","8.7","13.1"
"Crisp","2020-05-19","63","1232","6","238","10.1","13"
"Crisp","2020-05-20","61","1293","5","243","10.8","12.8"
"Crisp","2020-05-21","33","1326","4","247","11.2","12.9"
"Crisp","2020-05-22","56","1382","1","248","10.1","12.5"
"Crisp","2020-05-23","4","1386","0","248","8","12.5"
"Crisp","2020-05-24","7","1393","2","250","9.9","9.4"
"Crisp","2020-05-25","6","1399","0","250","8.6","8.7"
"Crisp","2020-05-26","38","1437","9","259","10.6","10.3"
"Crisp","2020-05-27","34","1471","2","261","10.3","10.5"
"Crisp","2020-05-28","55","1526","2","263","9.1","10.1"
"Crisp","2020-05-29","33","1559","0","263","8.8","9.4"
"Crisp","2020-05-30","5","1564","1","264","11.7","9.8"
"Crisp","2020-05-31","14","1578","0","264","7.6","8.7"
"Crisp","2020-06-01","52","1630","5","269","9","8.8"
"Crisp","2020-06-02","51","1681","1","270","5.9","8.2"
"Crisp","2020-06-03","66","1747","1","271","5.2","7.8"
"Crisp","2020-06-04","33","1780","6","277","7.3","8.2"
"Crisp","2020-06-05","18","1798","0","277","7.3","8.1"
"Crisp","2020-06-06","4","1802","1","278","8","9.9"
"Crisp","2020-06-07","3","1805","2","280","17.6","12.6"
"Crisp","2020-06-08","56","1861","3","283","17","13"
"Crisp","2020-06-09","30","1891","0","283","16.7","11.3"
"Crisp","2020-06-10","53","1944","6","289","18.1","11.7"
"Crisp","2020-06-11","82","2026","2","291","15.8","11.6"
"Crisp","2020-06-12","48","2074","9","300","18.5","12.9"
"Crisp","2020-06-13","8","2082","1","301","16.7","12.4"
"Crisp","2020-06-14","5","2087","0","301","7.2","12.4"
"Crisp","2020-06-15","43","2130","2","303","7.1","12"
"Crisp","2020-06-16","37","2167","0","303","7.1","11.9"
"Crisp","2020-06-17","47","2214","1","304","5.8","11.9"
"Crisp","2020-06-18","28","2242","0","304","5.4","10.6"
"Crisp","2020-06-19","62","2304","4","308","3.7","11.1"
"Crisp","2020-06-20","8","2312","2","310","5.5","11.1"
"Crisp","2020-06-21","0","2312","0","310","5.5","6.3"
"Crisp","2020-06-22","40","2352","2","312","5.5","6.3"
"Crisp","2020-06-23","40","2392","2","314","6.2","6.7"
"Crisp","2020-06-24","26","2418","2","316","7","6.4"
"Crisp","2020-06-25","36","2454","4","320","8.6","7"
"Crisp","2020-06-26","34","2488","2","322","8.5","6.1"
"Crisp","2020-06-27","15","2503","3","325","7.8","6.6"
"Crisp","2020-06-28","9","2512","3","328","12.6","9"
"Crisp","2020-06-29","74","2586","4","332","12.6","9.1"
"Crisp","2020-06-30","71","2657","8","340","13.5","9.9"
"Crisp","2020-07-01","55","2712","4","344","13.5","10.2"
"Crisp","2020-07-02","58","2770","4","348","12.9","10.7"
"Crisp","2020-07-03","11","2781","0","348","12","10.3"
"Crisp","2020-07-04","5","2786","3","351","17.7","12.8"
"Crisp","2020-07-05","11","2797","4","355","18.2","15.4"
"Crisp","2020-07-06","80","2877","10","365","19.2","15.9"
"Crisp","2020-07-07","42","2919","2","367","18.3","15.9"
"Crisp","2020-07-08","44","2963","3","370","18.2","15.8"
"Crisp","2020-07-09","92","3055","4","374","17.8","15.3"
"Crisp","2020-07-10","59","3114","10","384","20.2","16.1"
"Crisp","2020-07-11","14","3128","2","386","13.7","15.7"
"Crisp","2020-07-12","5","3133","2","388","14.2","16.2"
"Crisp","2020-07-13","87","3220","6","394","13.4","16.3"
"Crisp","2020-07-14","61","3281","2","396","13.2","15.7"
"Crisp","2020-07-15","30","3311","2","398","13.2","15.7"
"Crisp","2020-07-16","47","3358","2","400","13.2","15.5"
"Crisp","2020-07-17","51","3409","3","403","11.6","15.9"
"Crisp","2020-07-18","11","3420","0","403","9.6","11.6"
"Crisp","2020-07-19","10","3430","1","404","5.3","9.8"
"Crisp","2020-07-20","49","3479","4","408","5.5","9.5"
"Crisp","2020-07-21","18","3497","2","410","6.6","9.9"
"Crisp","2020-07-22","62","3559","2","412","6.1","9.6"
"Crisp","2020-07-23","24","3583","2","414","6.7","9.9"
"Crisp","2020-07-24","56","3639","3","417","6.6","9.1"
"Crisp","2020-07-25","16","3655","2","419","8.4","9"
"Crisp","2020-07-26","5","3660","0","419","7","6.1"
"Crisp","2020-07-27","58","3718","3","422","6.5","6"
"Crisp","2020-07-28","29","3747","1","423","5.4","6"
"Crisp","2020-07-29","58","3805","0","423","5","5.5"
"Crisp","2020-07-30","9","3814","0","423","3.8","5.2"
"Crisp","2020-07-31","49","3863","2","425","3.6","5.1"
"Crisp","2020-08-01","8","3871","0","425","1.8","5.1"
"Crisp","2020-08-02","6","3877","0","425","1.8","4.4"
"Crisp","2020-08-03","38","3915","6","431","3.3","4.9"
"Crisp","2020-08-04","23","3938","6","437","6.6","6"
"Crisp","2020-08-05","40","3978","2","439","7.3","6.1"
"Crisp","2020-08-06","25","4003","0","439","7.3","5.5"
"Crisp","2020-08-07","30","4033","1","440","7.2","5.4"
"Crisp","2020-08-08","7","4040","1","441","9.2","5.5"
"Crisp","2020-08-09","13","4053","2","443","11.4","6.6"
"Crisp","2020-08-10","51","4104","7","450","11.1","7.2"
"Crisp","2020-08-11","19","4123","4","454","10.4","8.5"
"Crisp","2020-08-12","30","4153","4","458","11.6","9.4"
"Crisp","2020-08-13","15","4168","1","459","12.5","9.9"
"Crisp","2020-08-14","36","4204","1","460","12.5","9.8"
"Crisp","2020-08-15","11","4215","2","462","13","11.1"
"Crisp","2020-08-16","1","4216","0","462","10.8","11.1"
"Crisp","2020-08-17","10","4226","1","463","10.3","10.7"
"Crisp","2020-08-18","7","4233","2","465","11.4","10.9"
"Crisp","2020-08-19","69","4302","16","481","12.8","12.2"
"Crisp","2020-08-20","20","4322","0","481","11.8","12.2"
"Crisp","2020-08-21","44","4366","3","484","12.4","12.4"
"Crisp","2020-08-22","11","4377","4","488","15","14"
"Crisp","2020-08-23","2","4379","0","488","15","12.9"
"Crisp","2020-08-24","41","4420","5","493","15.3","12.8"
"Crisp","2020-08-25","21","4441","3","496","13.3","12.3"
"Crisp","2020-08-26","27","4468","0","496","10","11.4"
"Crisp","2020-08-27","21","4489","2","498","11.3","11.6"
"Crisp","2020-08-28","40","4529","8","506","13.2","12.8"
"Crisp","2020-08-29","15","4544","1","507","9","12"
"Crisp","2020-08-30","7","4551","0","507","9","12"
"Crisp","2020-08-31","65","4616","7","514","8.7","12"
"Crisp","2020-09-01","25","4641","2","516","7.9","10.6"
"Crisp","2020-09-02","56","4697","6","522","9.4","9.7"
"Crisp","2020-09-03","26","4723","0","522","8","9.7"
"Crisp","2020-09-04","63","4786","6","528","6.5","9.9"
"Crisp","2020-09-05","7","4793","0","528","5.6","7.3"
"Crisp","2020-09-06","8","4801","0","528","5.6","7.3"
"Crisp","2020-09-07","5","4806","0","528","4","6.4"
"Crisp","2020-09-08","22","4828","4","532","5.5","6.7"
"Crisp","2020-09-09","40","4868","3","535","5","7.2"
"Crisp","2020-09-10","38","4906","4","539","6.5","7.3"
"Crisp","2020-09-11","47","4953","8","547","7.6","7.1"
"Crisp","2020-09-12","8","4961","1","548","9.4","7.5"
"Crisp","2020-09-13","8","4969","2","550","13","9.3"
"Crisp","2020-09-14","41","5010","4","554","14.4","9.2"
"Crisp","2020-09-15","21","5031","1","555","12.4","9"
"Crisp","2020-09-16","46","5077","3","558","12.3","8.7"
"Crisp","2020-09-17","16","5093","0","558","10.8","8.7"
"Crisp","2020-09-18","37","5130","3","561","9.5","8.6"
"Crisp","2020-09-19","6","5136","1","562","10.1","9.8"
"Crisp","2020-09-20","4","5140","1","563","10.1","11.5"
"Crisp","2020-09-21","41","5181","3","566","9.8","12.1"
"Crisp","2020-09-22","14","5195","0","566","9.1","10.8"
"Crisp","2020-09-23","40","5235","8","574","11","11.7"
"Crisp","2020-09-24","20","5255","2","576","12.4","11.6"
"Crisp","2020-09-25","65","5320","9","585","13.3","11.4"
"Crisp","2020-09-26","17","5337","0","585","10.9","10.5"
"Crisp","2020-09-27","0","5337","0","585","7.3","8.7"
"Crisp","2020-09-28","49","5386","5","590","7.7","8.7"
"Crisp","2020-09-29","23","5409","1","591","8.3","8.7"
"Crisp","2020-09-30","62","5471","8","599","7.3","9.2"
"Crisp","2020-10-01","32","5503","1","600","6.3","9.4"
"Crisp","2020-10-02","47","5550","5","605","5.9","9.6"
"Crisp","2020-10-03","2","5552","0","605","5.9","8.4"
"Crisp","2020-10-04","2","5554","0","605","5.9","6.6"
"Crisp","2020-10-05","73","5627","5","610","5.4","6.6"
"Crisp","2020-10-06","56","5683","3","613","5.6","6.9"
"Crisp","2020-10-07","44","5727","2","615","4.4","5.8"
"Crisp","2020-10-08","26","5753","4","619","6.1","6.2"
"Crisp","2020-10-09","66","5819","4","623","5.5","5.7"
"Crisp","2020-10-10","4","5823","0","623","5.5","5.7"
"Crisp","2020-10-11","4","5827","0","623","5.5","5.7"
"Crisp","2020-10-12","13","5840","1","624","5.6","5.5"
"Crisp","2020-10-13","54","5894","4","628","5.9","5.7"
"Crisp","2020-10-14","50","5944","4","632","6.4","5.4"
"Crisp","2020-10-15","62","6006","6","638","5.5","5.8"
"Crisp","2020-10-16","43","6049","4","642","6","5.7"
"Crisp","2020-10-17","3","6052","0","642","6","5.7"
"Crisp","2020-10-18","0","6052","0","642","6","5.7"
"Crisp","2020-10-19","22","6074","1","643","5.6","5.6"
"Crisp","2020-10-20","33","6107","1","644","4.9","5.4"
"Crisp","2020-10-21","40","6147","1","645","4.2","5.3"
"Crisp","2020-10-22","28","6175","1","646","3.3","4.4"
"Crisp","2020-10-23","28","6203","1","647","2.5","4.2"
"Crisp","2020-10-24","7","6210","0","647","2.5","4.2"
"Crisp","2020-10-25","5","6215","0","647","2.5","4.2"
"Crisp","2020-10-26","47","6262","5","652","3.3","4.4"
"Crisp","2020-10-27","34","6296","3","655","4.2","4.5"
"Crisp","2020-10-28","36","6332","2","657","4.6","4.4"
"Crisp","2020-10-29","24","6356","8","665","8.8","6.1"
"Crisp","2020-10-30","33","6389","4","669","10.1","6.3"
"Crisp","2020-10-31","11","6400","2","671","12.7","7.6"
"Crisp","2020-11-01","4","6404","0","671","12.7","7.6"
"Crisp","2020-11-02","24","6428","2","673","12.3","7.8"
"Crisp","2020-11-03","29","6457","1","674","11.6","7.9"
"Crisp","2020-11-04","42","6499","1","675","11.1","7.9"
"Crisp","2020-11-05","44","6543","3","678","7.3","8.1"
"Crisp","2020-11-06","28","6571","1","679","6.1","8.1"
"Crisp","2020-11-07","5","6576","0","679","3.5","8.1"
"Crisp","2020-11-08","5","6581","0","679","3.5","8.1"
"Crisp","2020-11-09","55","6636","6","685","3.9","8.1"
"Crisp","2020-11-10","46","6682","0","685","3.4","7.5"
"Crisp","2020-11-11","15","6697","1","686","4","7.6"
"Crisp","2020-11-12","57","6754","3","689","3.8","5.5"
"Crisp","2020-11-13","43","6797","2","691","3.9","5"
"Crisp","2020-11-14","2","6799","0","691","3.9","3.7"
"Crisp","2020-11-15","4","6803","0","691","3.9","3.7"
"Crisp","2020-11-16","44","6847","0","691","2.4","3.1"
"Crisp","2020-11-17","39","6886","0","691","2.4","2.9"
"Crisp","2020-11-18","11","6897","0","691","1.4","2.7"
"Crisp","2020-11-19","44","6941","2","693","1.3","2.5"
"Crisp","2020-11-20","35","6976","1","694","1.1","2.5"
"Crisp","2020-11-21","9","6985","0","694","1.1","2.5"
"Crisp","2020-11-22","9","6994","1","695","2.6","3.3"
"Crisp","2020-11-23","60","7054","8","703","4.5","3.5"
"Crisp","2020-11-24","38","7092","4","707","6.1","4.2"
"Crisp","2020-11-25","48","7140","4","711","7.2","4.3"
"Crisp","2020-11-26","4","7144","0","711","6.6","4"
"Crisp","2020-11-27","10","7154","0","711","6.2","3.6"
"Crisp","2020-11-28","6","7160","0","711","6.2","3.6"
"Crisp","2020-11-29","12","7172","2","713","7","4.8"
"Crisp","2020-11-30","53","7225","4","717","6.2","5.4"
"Crisp","2020-12-01","32","7257","0","717","4.6","5.4"
"Crisp","2020-12-02","52","7309","2","719","4","5.6"
"Crisp","2020-12-03","62","7371","2","721","4.5","5.5"
"Crisp","2020-12-04","60","7431","5","726","5.7","5.9"
"Crisp","2020-12-05","14","7445","4","730","9.7","8"
"Crisp","2020-12-06","6","7451","2","732","12.1","9.6"
"Crisp","2020-12-07","64","7515","13","745","13.9","10"
"Crisp","2020-12-08","25","7540","1","746","14.5","9.6"
"Crisp","2020-12-09","27","7567","4","750","16.1","10"
"Crisp","2020-12-10","53","7620","15","765","19.7","12.1"
"Crisp","2020-12-11","67","7687","12","777","21","13.3"
"Crisp","2020-12-12","15","7702","2","779","18.9","14.3"
"Crisp","2020-12-13","4","7706","0","779","14.1","13.1"
"Crisp","2020-12-14","58","7764","7","786","12.9","13.4"
"Crisp","2020-12-15","82","7846","6","792","13.4","14"
"Crisp","2020-12-16","34","7880","7","799","14.2","15.2"
"Crisp","2020-12-17","70","7950","4","803","11","15.3"
"Crisp","2020-12-18","46","7996","8","811","10.9","16"
"Crisp","2020-12-19","15","8011","1","812","10","14.4"
"Crisp","2020-12-20","8","8019","2","814","13.5","13.8"
"Crisp","2020-12-21","90","8109","15","829","14.2","13.6"
"Crisp","2020-12-22","65","8174","8","837","14.9","14.1"
"Crisp","2020-12-23","61","8235","2","839","12.4","13.3"
"Crisp","2020-12-24","15","8250","4","843","15.4","13.2"
"Crisp","2020-12-25","3","8253","0","843","12.9","11.9"
"Crisp","2020-12-26","10","8263","3","846","16.3","13.1"
"Crisp","2020-12-27","4","8267","1","847","16.3","14.9"
"Crisp","2020-12-28","61","8328","6","853","15.3","14.7"
"Crisp","2020-12-29","76","8404","17","870","16.7","15.8"
"Crisp","2020-12-30","85","8489","25","895","20.5","16.5"
"Crisp","2020-12-31","40","8529","5","900","18.4","16.9"
"Crisp","2021-01-01","2","8531","0","900","18.4","15.7"
"Crisp","2021-01-02","6","8537","1","901","16.5","16.4"
"Crisp","2021-01-03","3","8540","2","903","22.5","19.4"
"Crisp","2021-01-04","140","8680","27","930","23.8","19.6"
"Crisp","2021-01-05","91","8771","14","944","22.8","19.8"
"Crisp","2021-01-06","33","8804","3","947","19.9","20.2"
"Crisp","2021-01-07","62","8866","8","955","20","19.2"
"Crisp","2021-01-08","60","8926","6","961","21.4","19.9"
"Crisp","2021-01-09","14","8940","4","965","23.1","19.8"
"Crisp","2021-01-10","10","8950","1","966","15","18.8"
"Crisp","2021-01-11","27","8977","5","971","14.9","19.4"
"Crisp","2021-01-12","78","9055","11","982","14.7","18.8"
"Crisp","2021-01-13","28","9083","7","989","17","18.5"
"Crisp","2021-01-14","62","9145","13","1002","18.2","19.1"
"Crisp","2021-01-15","65","9210","13","1015","19.6","20.5"
"Crisp","2021-01-16","10","9220","2","1017","18.4","20.7"
"Crisp","2021-01-17","6","9226","1","1018","19.3","17.2"
"Crisp","2021-01-18","17","9243","2","1020","18.4","16.6"
"Crisp","2021-01-19","59","9302","7","1027","18","16.4"
"Crisp","2021-01-20","54","9356","20","1047","19.8","18.4"
"Crisp","2021-01-21","28","9384","5","1052","19.3","18.7"
"Crisp","2021-01-22","17","9401","1","1053","17.3","18.4"
"Crisp","2021-01-23","12","9413","2","1055","16.8","17.6"
"Crisp","2021-01-24","3","9416","2","1057","24","21.6"
"Crisp","2021-01-25","7","9423","2","1059","26.4","22.4"
"Crisp","2021-01-26","2","9425","0","1059","24.7","21.4"
"Crisp","2021-01-27","0","9425","0","1059","19.4","19.6"
"Dade","2020-02-01","0","0","0","0",".","."
"Dade","2020-02-02","0","0","0","0",".","."
"Dade","2020-02-03","0","0","0","0",".","."
"Dade","2020-02-04","0","0","0","0",".","."
"Dade","2020-02-05","0","0","0","0",".","."
"Dade","2020-02-06","0","0","0","0",".","."
"Dade","2020-02-07","0","0","0","0","0","."
"Dade","2020-02-08","0","0","0","0","0","."
"Dade","2020-02-09","0","0","0","0","0","."
"Dade","2020-02-10","0","0","0","0","0","."
"Dade","2020-02-11","0","0","0","0","0","."
"Dade","2020-02-12","0","0","0","0","0","."
"Dade","2020-02-13","0","0","0","0","0","."
"Dade","2020-02-14","0","0","0","0","0","0"
"Dade","2020-02-15","0","0","0","0","0","0"
"Dade","2020-02-16","0","0","0","0","0","0"
"Dade","2020-02-17","0","0","0","0","0","0"
"Dade","2020-02-18","0","0","0","0","0","0"
"Dade","2020-02-19","0","0","0","0","0","0"
"Dade","2020-02-20","0","0","0","0","0","0"
"Dade","2020-02-21","0","0","0","0","0","0"
"Dade","2020-02-22","0","0","0","0","0","0"
"Dade","2020-02-23","0","0","0","0","0","0"
"Dade","2020-02-24","0","0","0","0","0","0"
"Dade","2020-02-25","0","0","0","0","0","0"
"Dade","2020-02-26","0","0","0","0","0","0"
"Dade","2020-02-27","0","0","0","0","0","0"
"Dade","2020-02-28","0","0","0","0","0","0"
"Dade","2020-02-29","0","0","0","0","0","0"
"Dade","2020-03-01","0","0","0","0","0","0"
"Dade","2020-03-02","0","0","0","0","0","0"
"Dade","2020-03-03","0","0","0","0","0","0"
"Dade","2020-03-04","0","0","0","0","0","0"
"Dade","2020-03-05","0","0","0","0","0","0"
"Dade","2020-03-06","0","0","0","0","0","0"
"Dade","2020-03-07","0","0","0","0","0","0"
"Dade","2020-03-08","0","0","0","0","0","0"
"Dade","2020-03-09","0","0","0","0","0","0"
"Dade","2020-03-10","2","2","0","0","0","0"
"Dade","2020-03-11","1","3","0","0","0","0"
"Dade","2020-03-12","0","3","0","0","0","0"
"Dade","2020-03-13","0","3","0","0","0","0"
"Dade","2020-03-14","0","3","0","0","0","0"
"Dade","2020-03-15","0","3","0","0","0","0"
"Dade","2020-03-16","8","11","0","0","0","0"
"Dade","2020-03-17","8","19","0","0","0","0"
"Dade","2020-03-18","6","25","0","0","0","0"
"Dade","2020-03-19","24","49","0","0","0","0"
"Dade","2020-03-20","2","51","0","0","0","0"
"Dade","2020-03-21","1","52","0","0","0","0"
"Dade","2020-03-22","0","52","0","0","0","0"
"Dade","2020-03-23","9","61","0","0","0","0"
"Dade","2020-03-24","9","70","0","0","0","0"
"Dade","2020-03-25","10","80","0","0","0","0"
"Dade","2020-03-26","13","93","0","0","0","0"
"Dade","2020-03-27","8","101","0","0","0","0"
"Dade","2020-03-28","0","101","0","0","0","0"
"Dade","2020-03-29","0","101","0","0","0","0"
"Dade","2020-03-30","5","106","0","0","0","0"
"Dade","2020-03-31","14","120","0","0","0","0"
"Dade","2020-04-01","11","131","0","0","0","0"
"Dade","2020-04-02","8","139","0","0","0","0"
"Dade","2020-04-03","0","139","0","0","0","0"
"Dade","2020-04-04","0","139","0","0","0","0"
"Dade","2020-04-05","0","139","0","0","0","0"
"Dade","2020-04-06","5","144","0","0","0","0"
"Dade","2020-04-07","3","147","0","0","0","0"
"Dade","2020-04-08","7","154","0","0","0","0"
"Dade","2020-04-09","6","160","0","0","0","0"
"Dade","2020-04-10","9","169","0","0","0","0"
"Dade","2020-04-11","0","169","0","0","0","0"
"Dade","2020-04-12","0","169","0","0","0","0"
"Dade","2020-04-13","1","170","0","0","0","0"
"Dade","2020-04-14","13","183","0","0","0","0"
"Dade","2020-04-15","6","189","0","0","0","0"
"Dade","2020-04-16","7","196","0","0","0","0"
"Dade","2020-04-17","1","197","0","0","0","0"
"Dade","2020-04-18","0","197","0","0","0","0"
"Dade","2020-04-19","1","198","0","0","0","0"
"Dade","2020-04-20","6","204","0","0","0","0"
"Dade","2020-04-21","0","204","0","0","0","0"
"Dade","2020-04-22","2","206","0","0","0","0"
"Dade","2020-04-23","4","210","0","0","0","0"
"Dade","2020-04-24","3","213","0","0","0","0"
"Dade","2020-04-25","0","213","0","0","0","0"
"Dade","2020-04-26","0","213","0","0","0","0"
"Dade","2020-04-27","7","220","0","0","0","0"
"Dade","2020-04-28","9","229","2","2","3.2","1.6"
"Dade","2020-04-29","5","234","0","2","3.2","1.6"
"Dade","2020-04-30","10","244","0","2","3.2","1.6"
"Dade","2020-05-01","5","249","0","2","3.2","1.6"
"Dade","2020-05-02","0","249","0","2","3.2","1.6"
"Dade","2020-05-03","0","249","0","2","3.2","1.6"
"Dade","2020-05-04","6","255","0","2","3.2","1.6"
"Dade","2020-05-05","7","262","0","2","0","1.6"
"Dade","2020-05-06","5","267","2","4","5.7","4.4"
"Dade","2020-05-07","6","273","0","4","5.7","4.4"
"Dade","2020-05-08","2","275","0","4","5.7","4.4"
"Dade","2020-05-09","0","275","0","4","5.7","4.4"
"Dade","2020-05-10","0","275","0","4","5.7","4.4"
"Dade","2020-05-11","11","286","2","6","8.3","5.7"
"Dade","2020-05-12","7","293","0","6","8.3","4.2"
"Dade","2020-05-13","15","308","1","7","3.5","4.6"
"Dade","2020-05-14","3","311","0","7","3.5","4.6"
"Dade","2020-05-15","4","315","0","7","3.5","4.6"
"Dade","2020-05-16","0","315","0","7","3.5","4.6"
"Dade","2020-05-17","1","316","0","7","3.5","4.6"
"Dade","2020-05-18","1","317","0","7","1","4.6"
"Dade","2020-05-19","5","322","1","8","3.8","6.1"
"Dade","2020-05-20","11","333","0","8","2.9","3.2"
"Dade","2020-05-21","7","340","1","9","4.9","4.2"
"Dade","2020-05-22","1","341","0","9","4.9","4.2"
"Dade","2020-05-23","1","342","0","9","4.9","4.2"
"Dade","2020-05-24","0","342","0","9","4.9","4.2"
"Dade","2020-05-25","1","343","0","9","4.9","2.9"
"Dade","2020-05-26","10","353","0","9","2","2.9"
"Dade","2020-05-27","4","357","0","9","2","2.4"
"Dade","2020-05-28","5","362","1","10","2.9","3.9"
"Dade","2020-05-29","1","363","0","10","2.9","3.9"
"Dade","2020-05-30","3","366","0","10","2.9","3.9"
"Dade","2020-05-31","2","368","0","10","2.9","3.9"
"Dade","2020-06-01","5","373","2","12","8.6","6.7"
"Dade","2020-06-02","7","380","0","12","8.6","5.3"
"Dade","2020-06-03","4","384","0","12","8.6","5.3"
"Dade","2020-06-04","3","387","0","12","5.7","4.3"
"Dade","2020-06-05","1","388","0","12","5.7","4.3"
"Dade","2020-06-06","1","389","0","12","5.7","4.3"
"Dade","2020-06-07","0","389","0","12","5.7","4.3"
"Dade","2020-06-08","7","396","0","12","0","4.3"
"Dade","2020-06-09","4","400","0","12","0","4.3"
"Dade","2020-06-10","6","406","0","12","0","4.3"
"Dade","2020-06-11","4","410","0","12","0","2.9"
"Dade","2020-06-12","5","415","0","12","0","2.9"
"Dade","2020-06-13","2","417","1","13","7.1","6.4"
"Dade","2020-06-14","0","417","0","13","7.1","6.4"
"Dade","2020-06-15","7","424","1","14","9.2","4.6"
"Dade","2020-06-16","7","431","1","15","11.2","5.6"
"Dade","2020-06-17","6","437","2","17","16","8"
"Dade","2020-06-18","10","447","0","17","16","8"
"Dade","2020-06-19","0","447","0","17","16","8"
"Dade","2020-06-20","2","449","0","17","8.8","8"
"Dade","2020-06-21","5","454","0","17","8.8","8"
"Dade","2020-06-22","11","465","0","17","6.8","8"
"Dade","2020-06-23","10","475","0","17","4.8","8"
"Dade","2020-06-24","2","477","0","17","0","8"
"Dade","2020-06-25","17","494","4","21","3.4","9.7"
"Dade","2020-06-26","1","495","1","22","17.6","16.8"
"Dade","2020-06-27","2","497","0","22","17.6","13.2"
"Dade","2020-06-28","3","500","1","23","22.4","15.6"
"Dade","2020-06-29","14","514","1","24","23.4","15.1"
"Dade","2020-06-30","13","527","0","24","23.4","14.1"
"Dade","2020-07-01","12","539","1","25","24.6","12.3"
"Dade","2020-07-02","22","561","0","25","21.3","12.3"
"Dade","2020-07-03","1","562","0","25","7","12.3"
"Dade","2020-07-04","1","563","0","25","7","12.3"
"Dade","2020-07-05","2","565","0","25","2.2","12.3"
"Dade","2020-07-06","13","578","1","26","2.3","12.9"
"Dade","2020-07-07","13","591","1","27","3.4","13.4"
"Dade","2020-07-08","7","598","0","27","2.2","13.4"
"Dade","2020-07-09","7","605","0","27","2.2","11.7"
"Dade","2020-07-10","5","610","0","27","2.2","4.6"
"Dade","2020-07-11","0","610","0","27","2.2","4.6"
"Dade","2020-07-12","1","611","0","27","2.2","2.2"
"Dade","2020-07-13","5","616","0","27","1.1","1.7"
"Dade","2020-07-14","6","622","0","27","0","1.7"
"Dade","2020-07-15","12","634","1","28","1.2","1.7"
"Dade","2020-07-16","4","638","0","28","1.2","1.7"
"Dade","2020-07-17","2","640","0","28","1.2","1.7"
"Dade","2020-07-18","0","640","0","28","1.2","1.7"
"Dade","2020-07-19","2","642","0","28","1.2","1.7"
"Dade","2020-07-20","5","647","3","31","9.8","5.4"
"Dade","2020-07-21","9","656","0","31","9.8","4.9"
"Dade","2020-07-22","6","662","0","31","8.6","4.9"
"Dade","2020-07-23","11","673","1","32","9.9","5.5"
"Dade","2020-07-24","6","679","1","33","12.3","6.7"
"Dade","2020-07-25","3","682","0","33","12.3","6.7"
"Dade","2020-07-26","2","684","0","33","12.3","6.7"
"Dade","2020-07-27","20","704","1","34","4.4","7.1"
"Dade","2020-07-28","8","712","2","36","8","8.9"
"Dade","2020-07-29","2","714","0","36","8","8.3"
"Dade","2020-07-30","14","728","0","36","6.7","8.3"
"Dade","2020-07-31","5","733","0","36","4.3","8.3"
"Dade","2020-08-01","0","733","0","36","4.3","8.3"
"Dade","2020-08-02","2","735","0","36","4.3","8.3"
"Dade","2020-08-03","13","748","1","37","4.7","4.5"
"Dade","2020-08-04","7","755","0","37","1.1","4.5"
"Dade","2020-08-05","8","763","0","37","1.1","4.5"
"Dade","2020-08-06","13","776","1","38","2.2","4.4"
"Dade","2020-08-07","10","786","2","40","5.1","4.7"
"Dade","2020-08-08","2","788","0","40","5.1","4.7"
"Dade","2020-08-09","4","792","1","41","8.6","6.5"
"Dade","2020-08-10","19","811","0","41","7.5","6.1"
"Dade","2020-08-11","22","833","3","44","9.5","5.3"
"Dade","2020-08-12","11","844","0","44","9.5","5.3"
"Dade","2020-08-13","24","868","1","45","9","5.6"
"Dade","2020-08-14","17","885","0","45","6.1","5.6"
"Dade","2020-08-15","2","887","0","45","6.1","5.6"
"Dade","2020-08-16","1","888","0","45","2.5","5.6"
"Dade","2020-08-17","6","894","2","47","7.3","7.4"
"Dade","2020-08-18","9","903","0","47","5.4","7.4"
"Dade","2020-08-19","6","909","0","47","5.4","7.4"
"Dade","2020-08-20","6","915","0","47","4.8","6.9"
"Dade","2020-08-21","4","919","0","47","4.8","5.4"
"Dade","2020-08-22","1","920","1","48","19","12.6"
"Dade","2020-08-23","1","921","0","48","19","10.8"
"Dade","2020-08-24","10","931","2","50","17.1","12.2"
"Dade","2020-08-25","8","939","1","51","18.9","12.1"
"Dade","2020-08-26","11","950","0","51","18.9","12.1"
"Dade","2020-08-27","12","962","2","53","21.3","13"
"Dade","2020-08-28","7","969","4","57","29.5","17.1"
"Dade","2020-08-29","5","974","1","58","18","18.5"
"Dade","2020-08-30","0","974","0","58","18","18.5"
"Dade","2020-08-31","16","990","1","59","16.1","16.6"
"Dade","2020-09-01","12","1002","1","60","15.5","17.2"
"Dade","2020-09-02","82","1084","10","70","17.2","18.1"
"Dade","2020-09-03","13","1097","1","71","15.9","18.6"
"Dade","2020-09-04","9","1106","0","71","7.8","18.6"
"Dade","2020-09-05","1","1107","0","71","4.9","11.5"
"Dade","2020-09-06","2","1109","0","71","4.9","11.5"
"Dade","2020-09-07","4","1113","0","71","4","10.1"
"Dade","2020-09-08","15","1128","3","74","5.7","10.6"
"Dade","2020-09-09","114","1242","4","78","4.5","10.8"
"Dade","2020-09-10","11","1253","1","79","4.7","10.3"
"Dade","2020-09-11","4","1257","0","79","4.7","6.2"
"Dade","2020-09-12","3","1260","0","79","4.7","4.8"
"Dade","2020-09-13","0","1260","0","79","4.7","4.8"
"Dade","2020-09-14","6","1266","1","80","7","5.5"
"Dade","2020-09-15","9","1275","0","80","4.2","4.9"
"Dade","2020-09-16","80","1355","3","83","4.2","4.3"
"Dade","2020-09-17","16","1371","1","84","3.8","4.2"
"Dade","2020-09-18","10","1381","0","84","3.8","4.2"
"Dade","2020-09-19","5","1386","0","84","3.8","4.2"
"Dade","2020-09-20","0","1386","0","84","3.8","4.2"
"Dade","2020-09-21","8","1394","0","84","1.4","4.2"
"Dade","2020-09-22","13","1407","0","84","1.4","2.8"
"Dade","2020-09-23","61","1468","0","84","0.9","2.6"
"Dade","2020-09-24","4","1472","1","85","3.6","3.7"
"Dade","2020-09-25","0","1472","0","85","3.6","3.7"
"Dade","2020-09-26","1","1473","0","85","3.6","3.7"
"Dade","2020-09-27","0","1473","0","85","3.6","3.7"
"Dade","2020-09-28","5","1478","2","87","9.3","5.4"
"Dade","2020-09-29","4","1482","0","87","9.3","5.4"
"Dade","2020-09-30","26","1508","2","89","10.4","5.6"
"Dade","2020-10-01","2","1510","0","89","6.8","5.2"
"Dade","2020-10-02","6","1516","0","89","6.8","5.2"
"Dade","2020-10-03","5","1521","2","91","12.5","8"
"Dade","2020-10-04","3","1524","0","91","12.5","8"
"Dade","2020-10-05","12","1536","0","91","6.8","8"
"Dade","2020-10-06","5","1541","2","93","12.5","10.9"
"Dade","2020-10-07","81","1622","0","93","11.4","10.9"
"Dade","2020-10-08","11","1633","0","93","11.4","9.1"
"Dade","2020-10-09","16","1649","1","94","12.3","9.6"
"Dade","2020-10-10","2","1651","0","94","6.6","9.6"
"Dade","2020-10-11","0","1651","0","94","6.6","9.6"
"Dade","2020-10-12","13","1664","0","94","6.6","6.7"
"Dade","2020-10-13","13","1677","0","94","0.9","6.7"
"Dade","2020-10-14","75","1752","7","101","2.2","6.8"
"Dade","2020-10-15","9","1761","0","101","2.2","6.8"
"Dade","2020-10-16","11","1772","0","101","1.3","6.8"
"Dade","2020-10-17","2","1774","0","101","1.3","4"
"Dade","2020-10-18","1","1775","0","101","1.3","4"
"Dade","2020-10-19","8","1783","1","102","3.1","4.9"
"Dade","2020-10-20","8","1791","1","103","4.9","2.9"
"Dade","2020-10-21","96","1887","5","108","4.3","3.3"
"Dade","2020-10-22","6","1893","1","109","6.7","4.5"
"Dade","2020-10-23","11","1904","2","111","9.3","5.3"
"Dade","2020-10-24","7","1911","3","114","15.4","8.4"
"Dade","2020-10-25","0","1911","0","114","15.4","8.4"
"Dade","2020-10-26","17","1928","0","114","13.6","8.4"
"Dade","2020-10-27","12","1940","0","114","11.8","8.4"
"Dade","2020-10-28","57","1997","7","121","12.9","8.6"
"Dade","2020-10-29","14","2011","1","122","11.5","9.1"
"Dade","2020-10-30","9","2020","0","122","8.9","9.1"
"Dade","2020-10-31","13","2033","4","126","7.2","11.3"
"Dade","2020-11-01","2","2035","0","126","7.2","11.3"
"Dade","2020-11-02","15","2050","2","128","9.1","11.4"
"Dade","2020-11-03","7","2057","2","130","13.2","12.5"
"Dade","2020-11-04","130","2187","16","146","13.2","13"
"Dade","2020-11-05","9","2196","0","146","12.1","11.8"
"Dade","2020-11-06","3","2199","1","147","16.9","12.9"
"Dade","2020-11-07","3","2202","0","147","12.5","9.8"
"Dade","2020-11-08","4","2206","1","148","16.1","11.6"
"Dade","2020-11-09","25","2231","3","151","15.9","12.5"
"Dade","2020-11-10","9","2240","0","151","11.8","12.5"
"Dade","2020-11-11","16","2256","0","151","10","11.6"
"Dade","2020-11-12","25","2281","4","155","12.3","12.2"
"Dade","2020-11-13","15","2296","1","156","8.5","12.7"
"Dade","2020-11-14","9","2305","1","157","10.1","11.3"
"Dade","2020-11-15","3","2308","1","158","11.3","13.7"
"Dade","2020-11-16","22","2330","1","159","10.2","13.1"
"Dade","2020-11-17","16","2346","0","159","10.2","11"
"Dade","2020-11-18","173","2519","12","171","11.2","10.6"
"Dade","2020-11-19","16","2535","3","174","11.6","12"
"Dade","2020-11-20","27","2562","2","176","11.7","10.1"
"Dade","2020-11-21","13","2575","0","176","10.1","10.1"
"Dade","2020-11-22","4","2579","1","177","8.9","10.1"
"Dade","2020-11-23","27","2606","2","179","9.4","9.8"
"Dade","2020-11-24","10","2616","0","179","9.4","9.8"
"Dade","2020-11-25","48","2664","9","188","11","11.1"
"Dade","2020-11-26","0","2664","0","188","8.4","10"
"Dade","2020-11-27","8","2672","0","188","7.3","9.5"
"Dade","2020-11-28","3","2675","0","188","7.3","8.7"
"Dade","2020-11-29","7","2682","2","190","7.8","8.4"
"Dade","2020-11-30","27","2709","3","193","8.3","8.9"
"Dade","2020-12-01","14","2723","1","194","9.4","9.4"
"Dade","2020-12-02","122","2845","7","201","7.5","9.3"
"Dade","2020-12-03","21","2866","1","202","8.2","8.3"
"Dade","2020-12-04","27","2893","1","203","8.7","8"
"Dade","2020-12-05","6","2899","1","204","11.1","9.2"
"Dade","2020-12-06","4","2903","0","204","7","7.4"
"Dade","2020-12-07","30","2933","1","205","5.9","7.1"
"Dade","2020-12-08","32","2965","3","208","6.2","7.8"
"Dade","2020-12-09","147","3112","14","222","6.8","7.1"
"Dade","2020-12-10","22","3134","0","222","6.1","7.1"
"Dade","2020-12-11","31","3165","3","225","6.9","7.8"
"Dade","2020-12-12","9","3174","2","227","7.7","9.4"
"Dade","2020-12-13","3","3177","1","228","12.5","9.8"
"Dade","2020-12-14","33","3210","5","233","14.2","10"
"Dade","2020-12-15","24","3234","4","237","15.2","10.7"
"Dade","2020-12-16","158","3392","15","252","15.2","11"
"Dade","2020-12-17","21","3413","1","253","15.9","11"
"Dade","2020-12-18","21","3434","1","254","15.2","11.1"
"Dade","2020-12-19","7","3441","0","254","12","9.9"
"Dade","2020-12-20","3","3444","1","255","12","12.3"
"Dade","2020-12-21","48","3492","7","262","11.9","13.1"
"Dade","2020-12-22","24","3516","2","264","10.8","13"
"Dade","2020-12-23","90","3606","17","281","12.1","13.7"
"Dade","2020-12-24","6","3612","1","282","13.8","14.8"
"Dade","2020-12-25","1","3613","0","282","13.1","14.2"
"Dade","2020-12-26","14","3627","5","287","18.2","15.1"
"Dade","2020-12-27","5","3632","0","287","13.5","12.7"
"Dade","2020-12-28","38","3670","3","290","12.5","12.2"
"Dade","2020-12-29","26","3696","1","291","11.9","11.3"
"Dade","2020-12-30","152","3848","22","313","11.2","11.7"
"Dade","2020-12-31","11","3859","2","315","11.4","12.6"
"Dade","2021-01-01","1","3860","0","315","11.4","12.3"
"Dade","2021-01-02","0","3860","0","315","6.3","12.3"
"Dade","2021-01-03","5","3865","3","318","14.9","14.2"
"Dade","2021-01-04","29","3894","8","326","17.7","15.1"
"Dade","2021-01-05","46","3940","4","330","18.4","15.1"
"Dade","2021-01-06","134","4074","18","348","18.3","14.7"
"Dade","2021-01-07","15","4089","0","348","15.7","13.6"
"Dade","2021-01-08","29","4118","2","350","16.7","14.1"
"Dade","2021-01-09","6","4124","2","352","21.4","13.9"
"Dade","2021-01-10","11","4135","1","353","14.1","14.5"
"Dade","2021-01-11","28","4163","4","357","12.2","15"
"Dade","2021-01-12","17","4180","0","357","11","14.7"
"Dade","2021-01-13","137","4317","20","377","11.2","14.7"
"Dade","2021-01-14","18","4335","2","379","12.8","14.2"
"Dade","2021-01-15","21","4356","3","382","13.8","15.2"
"Dade","2021-01-16","2","4358","2","384","23.3","22.4"
"Dade","2021-01-17","8","4366","3","387","27.4","20.8"
"Dade","2021-01-18","15","4381","0","387","25.4","18.8"
"Dade","2021-01-19","21","4402","3","390","27.4","19.2"
"Dade","2021-01-20","114","4516","8","398","26.3","18.7"
"Dade","2021-01-21","13","4529","0","398","24.7","18.7"
"Dade","2021-01-22","5","4534","0","398","22.7","18.3"
"Dade","2021-01-23","2","4536","1","399","15.5","19.4"
"Dade","2021-01-24","3","4539","0","399","10.2","18.8"
"Dade","2021-01-25","0","4539","0","399","10.2","17.8"
"Dade","2021-01-26","0","4539","0","399","8.1","17.8"
"Dade","2021-01-27","0","4539","0","399","7.1","16.7"
"Dawson","2020-02-01","0","0","0","0",".","."
"Dawson","2020-02-02","0","0","0","0",".","."
"Dawson","2020-02-03","0","0","0","0",".","."
"Dawson","2020-02-04","0","0","0","0",".","."
"Dawson","2020-02-05","0","0","0","0",".","."
"Dawson","2020-02-06","0","0","0","0",".","."
"Dawson","2020-02-07","0","0","0","0","0","."
"Dawson","2020-02-08","0","0","0","0","0","."
"Dawson","2020-02-09","0","0","0","0","0","."
"Dawson","2020-02-10","0","0","0","0","0","."
"Dawson","2020-02-11","0","0","0","0","0","."
"Dawson","2020-02-12","0","0","0","0","0","."
"Dawson","2020-02-13","0","0","0","0","0","."
"Dawson","2020-02-14","0","0","0","0","0","0"
"Dawson","2020-02-15","0","0","0","0","0","0"
"Dawson","2020-02-16","0","0","0","0","0","0"
"Dawson","2020-02-17","0","0","0","0","0","0"
"Dawson","2020-02-18","0","0","0","0","0","0"
"Dawson","2020-02-19","0","0","0","0","0","0"
"Dawson","2020-02-20","0","0","0","0","0","0"
"Dawson","2020-02-21","0","0","0","0","0","0"
"Dawson","2020-02-22","0","0","0","0","0","0"
"Dawson","2020-02-23","0","0","0","0","0","0"
"Dawson","2020-02-24","0","0","0","0","0","0"
"Dawson","2020-02-25","0","0","0","0","0","0"
"Dawson","2020-02-26","0","0","0","0","0","0"
"Dawson","2020-02-27","0","0","0","0","0","0"
"Dawson","2020-02-28","0","0","0","0","0","0"
"Dawson","2020-02-29","0","0","0","0","0","0"
"Dawson","2020-03-01","0","0","0","0","0","0"
"Dawson","2020-03-02","0","0","0","0","0","0"
"Dawson","2020-03-03","0","0","0","0","0","0"
"Dawson","2020-03-04","0","0","0","0","0","0"
"Dawson","2020-03-05","0","0","0","0","0","0"
"Dawson","2020-03-06","0","0","0","0","0","0"
"Dawson","2020-03-07","0","0","0","0","0","0"
"Dawson","2020-03-08","0","0","0","0","0","0"
"Dawson","2020-03-09","0","0","0","0","0","0"
"Dawson","2020-03-10","0","0","0","0","0","0"
"Dawson","2020-03-11","0","0","0","0","0","0"
"Dawson","2020-03-12","4","4","0","0","0","0"
"Dawson","2020-03-13","2","6","0","0","0","0"
"Dawson","2020-03-14","0","6","0","0","0","0"
"Dawson","2020-03-15","0","6","0","0","0","0"
"Dawson","2020-03-16","4","10","0","0","0","0"
"Dawson","2020-03-17","4","14","0","0","0","0"
"Dawson","2020-03-18","13","27","1","1","1.1","0.5"
"Dawson","2020-03-19","9","36","1","2","2.7","1.3"
"Dawson","2020-03-20","6","42","0","2","2.7","1.3"
"Dawson","2020-03-21","5","47","0","2","2.7","1.3"
"Dawson","2020-03-22","4","51","1","3","6.3","3.1"
"Dawson","2020-03-23","7","58","1","4","8.3","4.1"
"Dawson","2020-03-24","9","67","1","5","9.9","4.9"
"Dawson","2020-03-25","2","69","0","5","8.8","4.9"
"Dawson","2020-03-26","4","73","0","5","7.2","4.9"
"Dawson","2020-03-27","1","74","0","5","7.2","4.9"
"Dawson","2020-03-28","0","74","0","5","7.2","4.9"
"Dawson","2020-03-29","4","78","0","5","3.6","4.9"
"Dawson","2020-03-30","7","85","2","7","5.7","7"
"Dawson","2020-03-31","2","87","0","7","4.1","7"
"Dawson","2020-04-01","0","87","0","7","4.1","6.4"
"Dawson","2020-04-02","1","88","0","7","4.1","5.6"
"Dawson","2020-04-03","0","88","0","7","4.1","5.6"
"Dawson","2020-04-04","1","89","0","7","4.1","5.6"
"Dawson","2020-04-05","2","91","0","7","4.1","3.9"
"Dawson","2020-04-06","15","106","6","13","5.7","5.7"
"Dawson","2020-04-07","5","111","0","13","5.7","4.9"
"Dawson","2020-04-08","5","116","1","14","8.6","6.3"
"Dawson","2020-04-09","5","121","0","14","8.6","6.3"
"Dawson","2020-04-10","10","131","4","18","14.3","9.2"
"Dawson","2020-04-11","1","132","0","18","14.3","9.2"
"Dawson","2020-04-12","0","132","0","18","14.3","9.2"
"Dawson","2020-04-13","6","138","4","22","18.1","11.9"
"Dawson","2020-04-14","3","141","0","22","18.1","11.9"
"Dawson","2020-04-15","3","144","0","22","15.2","11.9"
"Dawson","2020-04-16","8","152","1","23","17","12.8"
"Dawson","2020-04-17","5","157","0","23","11.3","12.8"
"Dawson","2020-04-18","3","160","0","23","11.3","12.8"
"Dawson","2020-04-19","1","161","0","23","11.3","12.8"
"Dawson","2020-04-20","11","172","1","24","3.1","10.6"
"Dawson","2020-04-21","9","181","0","24","3.1","10.6"
"Dawson","2020-04-22","3","184","0","24","3.1","9.2"
"Dawson","2020-04-23","5","189","0","24","1.3","9.2"
"Dawson","2020-04-24","7","196","0","24","1.3","6.3"
"Dawson","2020-04-25","35","231","5","29","3.3","7.3"
"Dawson","2020-04-26","3","234","0","29","3.3","7.3"
"Dawson","2020-04-27","11","245","0","29","2","2.6"
"Dawson","2020-04-28","55","300","1","30","2.3","2.7"
"Dawson","2020-04-29","49","349","1","31","2.6","2.8"
"Dawson","2020-04-30","57","406","0","31","2.6","1.9"
"Dawson","2020-05-01","29","435","0","31","2.6","1.9"
"Dawson","2020-05-02","27","462","1","32","1.1","2.2"
"Dawson","2020-05-03","11","473","0","32","1.1","2.2"
"Dawson","2020-05-04","16","489","0","32","1.1","1.6"
"Dawson","2020-05-05","33","522","2","34","1.7","2"
"Dawson","2020-05-06","28","550","1","35","1.9","2.2"
"Dawson","2020-05-07","26","576","0","35","1.9","2.2"
"Dawson","2020-05-08","54","630","12","47","5.1","3.8"
"Dawson","2020-05-09","17","647","0","47","4.6","2.8"
"Dawson","2020-05-10","3","650","1","48","9.3","5.2"
"Dawson","2020-05-11","53","703","10","58","12","6.5"
"Dawson","2020-05-12","35","738","0","58","11.1","6.4"
"Dawson","2020-05-13","14","752","1","59","11.7","6.8"
"Dawson","2020-05-14","57","809","1","60","11.9","6.9"
"Dawson","2020-05-15","49","858","2","62","9.3","7.2"
"Dawson","2020-05-16","20","878","2","64","10.7","7.6"
"Dawson","2020-05-17","18","896","2","66","7.6","8.4"
"Dawson","2020-05-18","29","925","6","72","7.8","9.9"
"Dawson","2020-05-19","40","965","2","74","8.5","9.8"
"Dawson","2020-05-20","49","1014","1","75","7.8","9.7"
"Dawson","2020-05-21","29","1043","0","75","7.6","9.7"
"Dawson","2020-05-22","34","1077","2","77","7.8","8.6"
"Dawson","2020-05-23","6","1083","0","77","6.4","8.6"
"Dawson","2020-05-24","7","1090","0","77","4.8","6.2"
"Dawson","2020-05-25","3","1093","0","77","1.8","4.8"
"Dawson","2020-05-26","22","1115","0","77","1.1","4.8"
"Dawson","2020-05-27","42","1157","0","77","0.8","4.3"
"Dawson","2020-05-28","20","1177","0","77","0.8","4.2"
"Dawson","2020-05-29","30","1207","1","78","0.5","4.1"
"Dawson","2020-05-30","6","1213","0","78","0.5","3.4"
"Dawson","2020-05-31","6","1219","0","78","0.5","2.6"
"Dawson","2020-06-01","31","1250","0","78","0.5","1.2"
"Dawson","2020-06-02","18","1268","0","78","0.5","0.8"
"Dawson","2020-06-03","38","1306","0","78","0.5","0.7"
"Dawson","2020-06-04","36","1342","0","78","0.5","0.7"
"Dawson","2020-06-05","22","1364","0","78","0","0.2"
"Dawson","2020-06-06","1","1365","0","78","0","0.2"
"Dawson","2020-06-07","6","1371","0","78","0","0.2"
"Dawson","2020-06-08","13","1384","0","78","0","0.2"
"Dawson","2020-06-09","18","1402","0","78","0","0.2"
"Dawson","2020-06-10","15","1417","0","78","0","0.2"
"Dawson","2020-06-11","30","1447","1","79","0.5","0.5"
"Dawson","2020-06-12","18","1465","1","80","1.3","0.6"
"Dawson","2020-06-13","6","1471","0","80","1.3","0.6"
"Dawson","2020-06-14","6","1477","0","80","1.3","0.6"
"Dawson","2020-06-15","15","1492","0","80","1.3","0.6"
"Dawson","2020-06-16","29","1521","0","80","1.3","0.6"
"Dawson","2020-06-17","17","1538","0","80","1.3","0.6"
"Dawson","2020-06-18","15","1553","0","80","0.8","0.6"
"Dawson","2020-06-19","17","1570","0","80","0","0.6"
"Dawson","2020-06-20","2","1572","0","80","0","0.6"
"Dawson","2020-06-21","3","1575","0","80","0","0.6"
"Dawson","2020-06-22","25","1600","3","83","1.7","1.5"
"Dawson","2020-06-23","12","1612","0","83","1.7","1.5"
"Dawson","2020-06-24","25","1637","1","84","2.3","1.8"
"Dawson","2020-06-25","36","1673","3","87","3.5","2.1"
"Dawson","2020-06-26","37","1710","0","87","3.5","1.7"
"Dawson","2020-06-27","18","1728","2","89","5.1","2.5"
"Dawson","2020-06-28","5","1733","0","89","5.1","2.5"
"Dawson","2020-06-29","36","1769","3","92","4.5","3.1"
"Dawson","2020-06-30","35","1804","3","95","5.8","3.7"
"Dawson","2020-07-01","37","1841","2","97","6","4.1"
"Dawson","2020-07-02","30","1871","3","100","6.2","4.8"
"Dawson","2020-07-03","14","1885","2","102","8.2","5.9"
"Dawson","2020-07-04","14","1899","2","104","8.7","6.9"
"Dawson","2020-07-05","5","1904","0","104","8.7","6.9"
"Dawson","2020-07-06","56","1960","5","109","8.8","6.7"
"Dawson","2020-07-07","64","2024","5","114","8.7","7.2"
"Dawson","2020-07-08","55","2079","4","118","8.9","7.5"
"Dawson","2020-07-09","43","2122","3","121","8.5","7.4"
"Dawson","2020-07-10","40","2162","2","123","7.2","7.7"
"Dawson","2020-07-11","6","2168","0","123","5.1","6.9"
"Dawson","2020-07-12","5","2173","1","124","8","8.3"
"Dawson","2020-07-13","25","2198","4","128","9","8.9"
"Dawson","2020-07-14","34","2232","0","128","7.9","8.3"
"Dawson","2020-07-15","32","2264","2","130","7.7","8.3"
"Dawson","2020-07-16","49","2313","8","138","9.1","8.8"
"Dawson","2020-07-17","44","2357","3","141","9.3","8.3"
"Dawson","2020-07-18","10","2367","1","142","10.8","8"
"Dawson","2020-07-19","13","2380","0","142","7.9","8"
"Dawson","2020-07-20","49","2429","7","149","7.7","8.3"
"Dawson","2020-07-21","36","2465","2","151","8.5","8.2"
"Dawson","2020-07-22","48","2513","1","152","7.9","7.8"
"Dawson","2020-07-23","37","2550","3","155","6.7","7.9"
"Dawson","2020-07-24","50","2600","5","160","7.1","8.2"
"Dawson","2020-07-25","11","2611","1","161","7","8.9"
"Dawson","2020-07-26","11","2622","0","161","7","7.5"
"Dawson","2020-07-27","47","2669","8","169","7.4","7.5"
"Dawson","2020-07-28","33","2702","3","172","7.9","8.2"
"Dawson","2020-07-29","33","2735","7","179","10.6","9.3"
"Dawson","2020-07-30","32","2767","5","184","11.7","9.2"
"Dawson","2020-07-31","41","2808","4","188","11.7","9.4"
"Dawson","2020-08-01","27","2835","6","194","13.6","10.3"
"Dawson","2020-08-02","23","2858","7","201","17.9","12.5"
"Dawson","2020-08-03","29","2887","2","203","16.5","11.9"
"Dawson","2020-08-04","28","2915","7","210","18.7","13.3"
"Dawson","2020-08-05","31","2946","7","217","18.9","14.8"
"Dawson","2020-08-06","37","2983","1","218","17.1","14.4"
"Dawson","2020-08-07","46","3029","6","224","17.6","14.6"
"Dawson","2020-08-08","15","3044","1","225","15.3","14.4"
"Dawson","2020-08-09","22","3066","6","231","14.9","16.4"
"Dawson","2020-08-10","56","3122","6","237","15.4","15.9"
"Dawson","2020-08-11","29","3151","3","240","13.3","16"
"Dawson","2020-08-12","31","3182","6","246","12.9","15.9"
"Dawson","2020-08-13","69","3251","5","251","13.5","15.3"
"Dawson","2020-08-14","68","3319","3","254","12.3","14.9"
"Dawson","2020-08-15","10","3329","1","255","12.8","14"
"Dawson","2020-08-16","12","3341","3","258","12.4","13.7"
"Dawson","2020-08-17","21","3362","1","259","11.6","13.5"
"Dawson","2020-08-18","36","3398","3","262","11.3","12.3"
"Dawson","2020-08-19","42","3440","0","262","8.5","10.7"
"Dawson","2020-08-20","75","3515","11","273","9.6","11.6"
"Dawson","2020-08-21","56","3571","0","273","9","10.6"
"Dawson","2020-08-22","27","3598","2","275","8.6","10.7"
"Dawson","2020-08-23","13","3611","1","276","6.1","9.3"
"Dawson","2020-08-24","43","3654","5","281","7.1","9.3"
"Dawson","2020-08-25","29","3683","3","284","7.4","9.3"
"Dawson","2020-08-26","39","3722","2","286","8.1","8.3"
"Dawson","2020-08-27","30","3752","4","290","7.9","8.8"
"Dawson","2020-08-28","52","3804","2","292","8.5","8.7"
"Dawson","2020-08-29","17","3821","2","294","9.1","8.9"
"Dawson","2020-08-30","11","3832","3","297","11.9","9"
"Dawson","2020-08-31","41","3873","2","299","10.9","9"
"Dawson","2020-09-01","32","3905","0","299","9.5","8.4"
"Dawson","2020-09-02","23","3928","3","302","10.6","9.4"
"Dawson","2020-09-03","18","3946","3","305","11.1","9.5"
"Dawson","2020-09-04","40","3986","0","305","10.5","9.5"
"Dawson","2020-09-05","10","3996","1","306","10.3","9.7"
"Dawson","2020-09-06","7","4003","0","306","6.4","9.1"
"Dawson","2020-09-07","9","4012","1","307","7.3","9.1"
"Dawson","2020-09-08","52","4064","6","313","8.9","9.2"
"Dawson","2020-09-09","21","4085","0","313","7","8.8"
"Dawson","2020-09-10","26","4111","3","316","6.3","8.7"
"Dawson","2020-09-11","30","4141","0","316","6.3","8.4"
"Dawson","2020-09-12","4","4145","2","318","12","11.1"
"Dawson","2020-09-13","6","4151","1","319","14.4","10.4"
"Dawson","2020-09-14","32","4183","2","321","13.7","10.5"
"Dawson","2020-09-15","38","4221","3","324","13.2","11.1"
"Dawson","2020-09-16","34","4255","3","327","14.5","10.7"
"Dawson","2020-09-17","28","4283","0","327","12.8","9.6"
"Dawson","2020-09-18","39","4322","1","328","13.2","9.7"
"Dawson","2020-09-19","11","4333","3","331","9.9","11"
"Dawson","2020-09-20","5","4338","1","332","10.4","12.4"
"Dawson","2020-09-21","39","4377","1","333","9.9","11.8"
"Dawson","2020-09-22","34","4411","0","333","8.7","11"
"Dawson","2020-09-23","37","4448","0","333","7.5","11"
"Dawson","2020-09-24","19","4467","2","335","9","10.9"
"Dawson","2020-09-25","25","4492","1","336","9.2","11.2"
"Dawson","2020-09-26","4","4496","0","336","5.3","7.6"
"Dawson","2020-09-27","8","4504","1","337","4.2","7.3"
"Dawson","2020-09-28","37","4541","1","338","4.2","7.1"
"Dawson","2020-09-29","31","4572","2","340","5.2","7"
"Dawson","2020-09-30","25","4597","1","341","5.7","6.6"
"Dawson","2020-10-01","42","4639","2","343","4.9","7"
"Dawson","2020-10-02","45","4684","2","345","5","7.1"
"Dawson","2020-10-03","10","4694","1","346","6.4","5.9"
"Dawson","2020-10-04","11","4705","0","346","4.6","4.4"
"Dawson","2020-10-05","42","4747","1","347","4.6","4.4"
"Dawson","2020-10-06","38","4785","4","351","5.2","5.2"
"Dawson","2020-10-07","48","4833","2","353","5.2","5.5"
"Dawson","2020-10-08","32","4865","5","358","6.7","5.8"
"Dawson","2020-10-09","43","4908","0","358","6.1","5.5"
"Dawson","2020-10-10","17","4925","0","358","4.7","5.5"
"Dawson","2020-10-11","11","4936","3","361","8.6","6.6"
"Dawson","2020-10-12","40","4976","3","364","9.3","6.9"
"Dawson","2020-10-13","20","4996","2","366","9.2","7.2"
"Dawson","2020-10-14","37","5033","0","366","8.6","6.9"
"Dawson","2020-10-15","42","5075","1","367","6.7","6.7"
"Dawson","2020-10-16","51","5126","0","367","6.7","6.4"
"Dawson","2020-10-17","8","5134","1","368","8.5","6.6"
"Dawson","2020-10-18","10","5144","0","368","4.6","6.6"
"Dawson","2020-10-19","35","5179","0","368","3.6","6.4"
"Dawson","2020-10-20","41","5220","3","371","3.2","6.2"
"Dawson","2020-10-21","32","5252","2","373","4.1","6.3"
"Dawson","2020-10-22","49","5301","0","373","3.7","5.2"
"Dawson","2020-10-23","47","5348","1","374","4","5.4"
"Dawson","2020-10-24","23","5371","0","374","2.2","5.4"
"Dawson","2020-10-25","6","5377","3","377","9.4","7"
"Dawson","2020-10-26","39","5416","2","379","10.1","6.8"
"Dawson","2020-10-27","35","5451","0","379","9.1","6.1"
"Dawson","2020-10-28","39","5490","1","380","8.5","6.3"
"Dawson","2020-10-29","29","5519","1","381","9","6.4"
"Dawson","2020-10-30","50","5569","1","382","9","6.5"
"Dawson","2020-10-31","21","5590","1","383","9.7","6"
"Dawson","2020-11-01","12","5602","3","386","6.1","7.8"
"Dawson","2020-11-02","52","5654","4","390","6.5","8.3"
"Dawson","2020-11-03","37","5691","0","390","6.5","7.8"
"Dawson","2020-11-04","31","5722","0","390","6.1","7.3"
"Dawson","2020-11-05","49","5771","1","391","5.9","7.5"
"Dawson","2020-11-06","56","5827","4","395","6.7","7.8"
"Dawson","2020-11-07","19","5846","3","398","8.2","9"
"Dawson","2020-11-08","10","5856","1","399","6.1","6.1"
"Dawson","2020-11-09","51","5907","12","411","8.4","7.4"
"Dawson","2020-11-10","60","5967","6","417","9.8","8.1"
"Dawson","2020-11-11","35","6002","1","418","10.2","8.2"
"Dawson","2020-11-12","38","6040","7","425","12.5","9.2"
"Dawson","2020-11-13","70","6110","9","434","13.4","10"
"Dawson","2020-11-14","20","6130","2","436","12.5","10.4"
"Dawson","2020-11-15","16","6146","2","438","12.9","9.5"
"Dawson","2020-11-16","51","6197","7","445","11.5","9.9"
"Dawson","2020-11-17","64","6261","6","451","11.4","10.6"
"Dawson","2020-11-18","51","6312","5","456","12.4","11.3"
"Dawson","2020-11-19","79","6391","7","463","11","11.8"
"Dawson","2020-11-20","71","6462","13","476","11.8","12.6"
"Dawson","2020-11-21","14","6476","4","480","14.4","13.5"
"Dawson","2020-11-22","22","6498","1","481","13.3","13.1"
"Dawson","2020-11-23","43","6541","5","486","13","12.2"
"Dawson","2020-11-24","44","6585","2","488","12.3","11.9"
"Dawson","2020-11-25","51","6636","13","501","14.6","13.5"
"Dawson","2020-11-26","8","6644","3","504","18.7","14.8"
"Dawson","2020-11-27","66","6710","12","516","18.6","15.2"
"Dawson","2020-11-28","30","6740","5","521","16.9","15.7"
"Dawson","2020-11-29","23","6763","6","527","20","16.7"
"Dawson","2020-11-30","74","6837","11","538","20.5","16.7"
"Dawson","2020-12-01","73","6910","14","552","22.6","17.4"
"Dawson","2020-12-02","64","6974","16","568","22.5","18.5"
"Dawson","2020-12-03","65","7039","4","572","18","18.3"
"Dawson","2020-12-04","74","7113","10","582","17.4","18"
"Dawson","2020-12-05","18","7131","3","585","17.4","17.1"
"Dawson","2020-12-06","14","7145","1","586","14.6","17.3"
"Dawson","2020-12-07","74","7219","9","595","14.3","17.4"
"Dawson","2020-12-08","93","7312","22","617","14.9","18.7"
"Dawson","2020-12-09","90","7402","15","632","13.7","18.1"
"Dawson","2020-12-10","65","7467","11","643","15.2","16.6"
"Dawson","2020-12-11","91","7558","8","651","14.6","16"
"Dawson","2020-12-12","36","7594","9","660","15.8","16.6"
"Dawson","2020-12-13","27","7621","5","665","17.4","16"
"Dawson","2020-12-14","86","7707","20","685","19","16.6"
"Dawson","2020-12-15","108","7815","19","704","18.1","16.5"
"Dawson","2020-12-16","92","7907","25","729","19.6","16.7"
"Dawson","2020-12-17","84","7991","12","741","19.2","17.2"
"Dawson","2020-12-18","106","8097","14","755","19.9","17.2"
"Dawson","2020-12-19","19","8116","7","762","21.6","18.7"
"Dawson","2020-12-20","26","8142","6","768","22.2","19.8"
"Dawson","2020-12-21","92","8234","17","785","21.5","20.2"
"Dawson","2020-12-22","73","8307","19","804","22.7","20.4"
"Dawson","2020-12-23","83","8390","23","827","22.8","21.2"
"Dawson","2020-12-24","64","8454","12","839","23.4","21.3"
"Dawson","2020-12-25","13","8467","8","847","30.3","25.1"
"Dawson","2020-12-26","60","8527","25","872","31","26.3"
"Dawson","2020-12-27","32","8559","11","883","32.6","27.4"
"Dawson","2020-12-28","97","8656","23","906","33.4","27.5"
"Dawson","2020-12-29","78","8734","25","931","34.3","28.5"
"Dawson","2020-12-30","86","8820","15","946","32.8","27.8"
"Dawson","2020-12-31","79","8899","25","971","34.6","29"
"Dawson","2021-01-01","16","8915","7","978","32.1","31.2"
"Dawson","2021-01-02","27","8942","11","989","32","31.5"
"Dawson","2021-01-03","27","8969","8","997","31.3","32"
"Dawson","2021-01-04","92","9061","20","1017","31","32.2"
"Dawson","2021-01-05","94","9155","23","1040","29.9","32.1"
"Dawson","2021-01-06","117","9272","24","1064","30.4","31.6"
"Dawson","2021-01-07","104","9376","24","1088","29.1","31.9"
"Dawson","2021-01-08","71","9447","10","1098","24.9","28.5"
"Dawson","2021-01-09","40","9487","14","1112","24.1","28"
"Dawson","2021-01-10","27","9514","6","1118","23","27.1"
"Dawson","2021-01-11","91","9605","22","1140","23.4","27.2"
"Dawson","2021-01-12","76","9681","11","1151","21.9","25.9"
"Dawson","2021-01-13","77","9758","18","1169","22.3","26.3"
"Dawson","2021-01-14","94","9852","15","1184","21.3","25.2"
"Dawson","2021-01-15","50","9902","11","1195","22.5","23.7"
"Dawson","2021-01-16","39","9941","11","1206","21.5","22.8"
"Dawson","2021-01-17","30","9971","9","1215","22.6","22.8"
"Dawson","2021-01-18","49","10020","11","1226","22.4","22.9"
"Dawson","2021-01-19","90","10110","17","1243","23","22.5"
"Dawson","2021-01-20","55","10165","9","1252","22","22.2"
"Dawson","2021-01-21","77","10242","19","1271","23.2","22.3"
"Dawson","2021-01-22","95","10337","24","1295","23.7","23.1"
"Dawson","2021-01-23","27","10364","4","1299","21.8","21.6"
"Dawson","2021-01-24","16","10380","3","1302","20.2","21.4"
"Dawson","2021-01-25","15","10395","6","1308","22.7","22.5"
"Dawson","2021-01-26","1","10396","0","1308","20","21.5"
"Dawson","2021-01-27","0","10396","0","1308","17.6","19.8"
"Decatur","2020-02-01","0","0","0","0",".","."
"Decatur","2020-02-02","0","0","0","0",".","."
"Decatur","2020-02-03","0","0","0","0",".","."
"Decatur","2020-02-04","0","0","0","0",".","."
"Decatur","2020-02-05","0","0","0","0",".","."
"Decatur","2020-02-06","0","0","0","0",".","."
"Decatur","2020-02-07","0","0","0","0","0","."
"Decatur","2020-02-08","0","0","0","0","0","."
"Decatur","2020-02-09","0","0","0","0","0","."
"Decatur","2020-02-10","0","0","0","0","0","."
"Decatur","2020-02-11","0","0","0","0","0","."
"Decatur","2020-02-12","0","0","0","0","0","."
"Decatur","2020-02-13","0","0","0","0","0","."
"Decatur","2020-02-14","0","0","0","0","0","0"
"Decatur","2020-02-15","0","0","0","0","0","0"
"Decatur","2020-02-16","0","0","0","0","0","0"
"Decatur","2020-02-17","0","0","0","0","0","0"
"Decatur","2020-02-18","0","0","0","0","0","0"
"Decatur","2020-02-19","1","1","0","0","0","0"
"Decatur","2020-02-20","0","1","0","0","0","0"
"Decatur","2020-02-21","0","1","0","0","0","0"
"Decatur","2020-02-22","0","1","0","0","0","0"
"Decatur","2020-02-23","0","1","0","0","0","0"
"Decatur","2020-02-24","0","1","0","0","0","0"
"Decatur","2020-02-25","0","1","0","0","0","0"
"Decatur","2020-02-26","0","1","0","0","0","0"
"Decatur","2020-02-27","0","1","0","0","0","0"
"Decatur","2020-02-28","0","1","0","0","0","0"
"Decatur","2020-02-29","0","1","0","0","0","0"
"Decatur","2020-03-01","0","1","0","0","0","0"
"Decatur","2020-03-02","0","1","0","0","0","0"
"Decatur","2020-03-03","0","1","0","0","0","0"
"Decatur","2020-03-04","0","1","0","0","0","0"
"Decatur","2020-03-05","0","1","0","0","0","0"
"Decatur","2020-03-06","0","1","0","0","0","0"
"Decatur","2020-03-07","0","1","0","0","0","0"
"Decatur","2020-03-08","0","1","0","0","0","0"
"Decatur","2020-03-09","0","1","0","0","0","0"
"Decatur","2020-03-10","0","1","0","0","0","0"
"Decatur","2020-03-11","0","1","0","0","0","0"
"Decatur","2020-03-12","1","2","0","0","0","0"
"Decatur","2020-03-13","2","4","0","0","0","0"
"Decatur","2020-03-14","1","5","0","0","0","0"
"Decatur","2020-03-15","0","5","0","0","0","0"
"Decatur","2020-03-16","4","9","0","0","0","0"
"Decatur","2020-03-17","5","14","0","0","0","0"
"Decatur","2020-03-18","10","24","0","0","0","0"
"Decatur","2020-03-19","5","29","1","1","2.9","1.4"
"Decatur","2020-03-20","4","33","0","1","2.9","1.4"
"Decatur","2020-03-21","0","33","0","1","2.9","1.4"
"Decatur","2020-03-22","3","36","2","3","12.4","6.2"
"Decatur","2020-03-23","2","38","0","3","12.4","6.2"
"Decatur","2020-03-24","2","40","1","4","19.5","9.8"
"Decatur","2020-03-25","6","46","2","6","24.3","12.1"
"Decatur","2020-03-26","2","48","0","6","21.4","12.1"
"Decatur","2020-03-27","8","56","3","9","26.8","14.8"
"Decatur","2020-03-28","2","58","2","11","41.1","22"
"Decatur","2020-03-29","3","61","2","13","41.1","26.7"
"Decatur","2020-03-30","2","63","1","14","48.2","30.3"
"Decatur","2020-03-31","1","64","0","14","41.1","30.3"
"Decatur","2020-04-01","13","77","3","17","39.6","31.9"
"Decatur","2020-04-02","11","88","1","18","40.9","31.2"
"Decatur","2020-04-03","3","91","2","20","45.1","35.9"
"Decatur","2020-04-04","0","91","0","20","30.8","35.9"
"Decatur","2020-04-05","0","91","0","20","21.3","31.2"
"Decatur","2020-04-06","6","97","3","23","21.3","34.7"
"Decatur","2020-04-07","4","101","0","23","21.3","31.2"
"Decatur","2020-04-08","9","110","2","25","21.1","30.4"
"Decatur","2020-04-09","14","124","2","27","21.9","31.4"
"Decatur","2020-04-10","20","144","2","29","13.8","29.4"
"Decatur","2020-04-11","12","156","2","31","16.2","23.5"
"Decatur","2020-04-12","5","161","3","34","24.7","23"
"Decatur","2020-04-13","20","181","1","35","18.3","19.8"
"Decatur","2020-04-14","31","212","11","46","23.4","22.3"
"Decatur","2020-04-15","17","229","1","47","21","21.1"
"Decatur","2020-04-16","27","256","4","51","21.1","21.5"
"Decatur","2020-04-17","34","290","14","65","25.6","19.7"
"Decatur","2020-04-18","6","296","1","66","25.6","20.9"
"Decatur","2020-04-19","5","301","0","66","17","20.9"
"Decatur","2020-04-20","12","313","3","69","19.9","19.1"
"Decatur","2020-04-21","12","325","2","71","17.2","20.3"
"Decatur","2020-04-22","14","339","2","73","18.4","19.7"
"Decatur","2020-04-23","19","358","3","76","18.5","19.8"
"Decatur","2020-04-24","16","374","2","78","14.4","20"
"Decatur","2020-04-25","1","375","0","78","12","18.8"
"Decatur","2020-04-26","2","377","1","79","19.2","18.1"
"Decatur","2020-04-27","23","400","6","85","19.3","19.6"
"Decatur","2020-04-28","9","409","1","86","18.5","17.9"
"Decatur","2020-04-29","17","426","6","92","21.5","20"
"Decatur","2020-04-30","13","439","0","92","19.3","18.9"
"Decatur","2020-05-01","16","455","1","93","18.4","16.4"
"Decatur","2020-05-02","3","458","0","93","18.4","15.2"
"Decatur","2020-05-03","70","528","3","96","11.9","15.5"
"Decatur","2020-05-04","22","550","1","97","8.8","14.1"
"Decatur","2020-05-05","13","563","0","97","7.2","12.9"
"Decatur","2020-05-06","14","577","4","101","6.2","13.9"
"Decatur","2020-05-07","17","594","0","101","6.2","12.8"
"Decatur","2020-05-08","16","610","4","105","8.9","13.7"
"Decatur","2020-05-09","87","697","2","107","9.2","13.8"
"Decatur","2020-05-10","3","700","1","108","13.4","12.6"
"Decatur","2020-05-11","30","730","0","108","12.7","10.8"
"Decatur","2020-05-12","16","746","3","111","15.4","11.3"
"Decatur","2020-05-13","28","774","4","115","13.4","9.8"
"Decatur","2020-05-14","93","867","2","117","13.7","10"
"Decatur","2020-05-15","22","889","9","126","16","12.4"
"Decatur","2020-05-16","28","917","5","131","18.2","13.7"
"Decatur","2020-05-17","3","920","0","131","13.4","13.4"
"Decatur","2020-05-18","7","927","1","132","15.5","14.1"
"Decatur","2020-05-19","31","958","7","139","16","15.7"
"Decatur","2020-05-20","97","1055","17","156","16.5","14.9"
"Decatur","2020-05-21","15","1070","1","157","17.1","15.4"
"Decatur","2020-05-22","24","1094","2","159","12.5","14.2"
"Decatur","2020-05-23","85","1179","12","171","11.9","15.1"
"Decatur","2020-05-24","3","1182","2","173","21.5","17.4"
"Decatur","2020-05-25","1","1183","0","173","19.4","17.4"
"Decatur","2020-05-26","27","1210","3","176","17.8","16.9"
"Decatur","2020-05-27","147","1357","10","186","16.2","16.4"
"Decatur","2020-05-28","28","1385","9","195","19.9","18.5"
"Decatur","2020-05-29","64","1449","6","201","20","16.2"
"Decatur","2020-05-30","128","1577","7","208","18.8","15.4"
"Decatur","2020-05-31","2","1579","0","208","9.3","15.4"
"Decatur","2020-06-01","147","1726","6","214","9.9","14.6"
"Decatur","2020-06-02","42","1768","2","216","8.9","13.4"
"Decatur","2020-06-03","42","1810","6","222","10","13.1"
"Decatur","2020-06-04","156","1966","7","229","6.1","13"
"Decatur","2020-06-05","21","1987","5","234","8.1","14.1"
"Decatur","2020-06-06","119","2106","4","238","7.8","13.3"
"Decatur","2020-06-07","1","2107","0","238","7.8","8.5"
"Decatur","2020-06-08","24","2131","1","239","7.8","8.8"
"Decatur","2020-06-09","51","2182","2","241","7.7","8.3"
"Decatur","2020-06-10","99","2281","2","243","6","8"
"Decatur","2020-06-11","72","2353","9","252","7.1","6.6"
"Decatur","2020-06-12","11","2364","0","252","3.7","5.9"
"Decatur","2020-06-13","38","2402","3","255","4.4","6.1"
"Decatur","2020-06-14","36","2438","0","255","4.4","6.1"
"Decatur","2020-06-15","90","2528","1","256","3.9","5.9"
"Decatur","2020-06-16","55","2583","1","257","3.6","5.7"
"Decatur","2020-06-17","74","2657","2","259","3.7","4.8"
"Decatur","2020-06-18","46","2703","4","263","3.2","5.1"
"Decatur","2020-06-19","23","2726","0","263","3.2","3.4"
"Decatur","2020-06-20","31","2757","1","264","2.5","3.4"
"Decatur","2020-06-21","44","2801","0","264","2.5","3.4"
"Decatur","2020-06-22","21","2822","0","264","2.3","3.1"
"Decatur","2020-06-23","69","2891","3","267","2.7","3.2"
"Decatur","2020-06-24","20","2911","1","268","3","3.4"
"Decatur","2020-06-25","79","2990","5","273","2.7","2.9"
"Decatur","2020-06-26","13","3003","2","275","4.9","4"
"Decatur","2020-06-27","27","3030","2","277","5.5","4"
"Decatur","2020-06-28","6","3036","0","277","5.5","4"
"Decatur","2020-06-29","60","3096","2","279","6","4.2"
"Decatur","2020-06-30","49","3145","4","283","6.5","4.6"
"Decatur","2020-07-01","100","3245","6","289","6.7","4.8"
"Decatur","2020-07-02","56","3301","2","291","6.3","4.5"
"Decatur","2020-07-03","20","3321","2","293","5.5","5.2"
"Decatur","2020-07-04","31","3352","2","295","5.4","5.4"
"Decatur","2020-07-05","4","3356","1","296","8.9","7.2"
"Decatur","2020-07-06","34","3390","3","299","9.7","7.8"
"Decatur","2020-07-07","43","3433","13","312","12.9","9.7"
"Decatur","2020-07-08","161","3594","23","335","14.1","10.4"
"Decatur","2020-07-09","94","3688","13","348","15.5","10.9"
"Decatur","2020-07-10","73","3761","14","362","16.8","11.2"
"Decatur","2020-07-11","18","3779","3","365","18.3","11.8"
"Decatur","2020-07-12","81","3860","6","371","15.8","12.4"
"Decatur","2020-07-13","49","3909","11","382","17.7","13.7"
"Decatur","2020-07-14","167","4076","24","406","15.5","14.2"
"Decatur","2020-07-15","74","4150","11","417","15.5","14.8"
"Decatur","2020-07-16","194","4344","32","449","15.9","15.7"
"Decatur","2020-07-17","85","4429","8","457","14.5","15.7"
"Decatur","2020-07-18","20","4449","6","463","16.4","17.4"
"Decatur","2020-07-19","9","4458","1","464","17","16.4"
"Decatur","2020-07-20","214","4672","23","487","15.3","16.5"
"Decatur","2020-07-21","102","4774","17","504","15.6","15.5"
"Decatur","2020-07-22","254","5028","29","533","15.1","15.3"
"Decatur","2020-07-23","103","5131","14","547","14.7","15.3"
"Decatur","2020-07-24","129","5260","30","577","16.7","15.6"
"Decatur","2020-07-25","24","5284","13","590","20.1","18.3"
"Decatur","2020-07-26","149","5433","7","597","19.2","18.1"
"Decatur","2020-07-27","80","5513","16","613","20.5","17.9"
"Decatur","2020-07-28","268","5781","53","666","21","18.3"
"Decatur","2020-07-29","89","5870","13","679","21.4","18.3"
"Decatur","2020-07-30","226","6096","26","705","21.1","17.9"
"Decatur","2020-07-31","86","6182","15","720","20.3","18.5"
"Decatur","2020-08-01","18","6200","6","726","17.3","18.7"
"Decatur","2020-08-02","11","6211","3","729","20.6","19.9"
"Decatur","2020-08-03","252","6463","36","765","19.7","20.1"
"Decatur","2020-08-04","155","6618","19","784","18.7","19.8"
"Decatur","2020-08-05","90","6708","25","809","20.6","21"
"Decatur","2020-08-06","238","6946","13","822","19.7","20.4"
"Decatur","2020-08-07","62","7008","5","827","18.4","19.3"
"Decatur","2020-08-08","14","7022","9","836","22.8","20.1"
"Decatur","2020-08-09","31","7053","8","844","22.6","21.6"
"Decatur","2020-08-10","210","7263","18","862","21.7","20.7"
"Decatur","2020-08-11","81","7344","6","868","21.1","19.9"
"Decatur","2020-08-12","64","7408","6","874","18.4","19.5"
"Decatur","2020-08-13","224","7632","19","893","18.9","19.3"
"Decatur","2020-08-14","43","7675","6","899","19.7","19"
"Decatur","2020-08-15","12","7687","3","902","14.1","18.4"
"Decatur","2020-08-16","14","7701","6","908","16.5","19.5"
"Decatur","2020-08-17","120","7821","15","923","17.1","19.4"
"Decatur","2020-08-18","71","7892","10","933","18","19.5"
"Decatur","2020-08-19","50","7942","9","942","19.3","18.8"
"Decatur","2020-08-20","206","8148","21","963","19.5","19.2"
"Decatur","2020-08-21","40","8188","11","974","21.4","20.6"
"Decatur","2020-08-22","5","8193","3","977","26.4","20.3"
"Decatur","2020-08-23","45","8238","5","982","21.9","19.2"
"Decatur","2020-08-24","100","8338","16","998","22.4","19.7"
"Decatur","2020-08-25","64","8402","7","1005","22","20"
"Decatur","2020-08-26","88","8490","16","1021","22","20.6"
"Decatur","2020-08-27","185","8675","16","1037","21.8","20.6"
"Decatur","2020-08-28","36","8711","3","1040","19","20.2"
"Decatur","2020-08-29","11","8722","3","1043","14.4","20.4"
"Decatur","2020-08-30","7","8729","1","1044","14.8","18.4"
"Decatur","2020-08-31","113","8842","7","1051","13.4","17.9"
"Decatur","2020-09-01","96","8938","3","1054","12.3","17.1"
"Decatur","2020-09-02","82","9020","5","1059","10.6","16.3"
"Decatur","2020-09-03","147","9167","14","1073","10.7","16.2"
"Decatur","2020-09-04","165","9332","8","1081","10.2","14.6"
"Decatur","2020-09-05","15","9347","1","1082","7.2","10.8"
"Decatur","2020-09-06","10","9357","0","1082","5.2","10"
"Decatur","2020-09-07","39","9396","1","1083","4.7","9"
"Decatur","2020-09-08","117","9513","5","1088","4.9","8.6"
"Decatur","2020-09-09","72","9585","7","1095","5.4","8"
"Decatur","2020-09-10","117","9702","5","1100","4.6","7.7"
"Decatur","2020-09-11","100","9802","3","1103","4.4","7.3"
"Decatur","2020-09-12","11","9813","0","1103","3.4","5.3"
"Decatur","2020-09-13","20","9833","1","1104","4.1","4.7"
"Decatur","2020-09-14","285","10118","8","1112","4.2","4.4"
"Decatur","2020-09-15","68","10186","0","1112","3.5","4.2"
"Decatur","2020-09-16","79","10265","3","1115","2.7","4"
"Decatur","2020-09-17","150","10415","8","1123","2.8","3.7"
"Decatur","2020-09-18","87","10502","9","1132","3.9","4.1"
"Decatur","2020-09-19","29","10531","3","1135","5.4","4.4"
"Decatur","2020-09-20","10","10541","0","1135","4.7","4.4"
"Decatur","2020-09-21","165","10706","8","1143","5","4.6"
"Decatur","2020-09-22","181","10887","4","1147","5.3","4.4"
"Decatur","2020-09-23","111","10998","3","1150","5.1","3.9"
"Decatur","2020-09-24","159","11157","15","1165","5.7","4.3"
"Decatur","2020-09-25","65","11222","4","1169","5.1","4.5"
"Decatur","2020-09-26","33","11255","7","1176","6.7","6"
"Decatur","2020-09-27","12","11267","1","1177","7.8","6.3"
"Decatur","2020-09-28","112","11379","13","1190","8.8","6.9"
"Decatur","2020-09-29","174","11553","3","1193","8.7","7"
"Decatur","2020-09-30","73","11626","7","1200","9.7","7.4"
"Decatur","2020-10-01","144","11770","11","1211","9.5","7.6"
"Decatur","2020-10-02","108","11878","8","1219","9.6","7.4"
"Decatur","2020-10-03","44","11922","2","1221","7.3","7"
"Decatur","2020-10-04","10","11932","1","1222","7.5","7.7"
"Decatur","2020-10-05","140","12072","12","1234","7.1","7.9"
"Decatur","2020-10-06","111","12183","3","1237","7.2","8"
"Decatur","2020-10-07","66","12249","5","1242","6.9","8.3"
"Decatur","2020-10-08","49","12298","0","1242","5.8","7.6"
"Decatur","2020-10-09","119","12417","2","1244","5","7.3"
"Decatur","2020-10-10","39","12456","1","1245","4.7","6"
"Decatur","2020-10-11","13","12469","0","1245","3.3","5.4"
"Decatur","2020-10-12","150","12619","10","1255","3","5"
"Decatur","2020-10-13","76","12695","2","1257","3","5.1"
"Decatur","2020-10-14","75","12770","6","1263","3.1","5"
"Decatur","2020-10-15","47","12817","2","1265","3.7","4.8"
"Decatur","2020-10-16","56","12873","0","1265","3.4","4.2"
"Decatur","2020-10-17","8","12881","0","1265","3.1","3.9"
"Decatur","2020-10-18","19","12900","1","1266","3.8","3.6"
"Decatur","2020-10-19","134","13034","4","1270","3.3","3.2"
"Decatur","2020-10-20","42","13076","2","1272","3.6","3.3"
"Decatur","2020-10-21","107","13183","5","1277","3.1","3.1"
"Decatur","2020-10-22","61","13244","1","1278","2.8","3.2"
"Decatur","2020-10-23","44","13288","0","1278","2.8","3.1"
"Decatur","2020-10-24","42","13330","9","1287","5.8","4.5"
"Decatur","2020-10-25","8","13338","0","1287","5.1","4.5"
"Decatur","2020-10-26","145","13483","8","1295","5.4","4.4"
"Decatur","2020-10-27","79","13562","4","1299","5.5","4.5"
"Decatur","2020-10-28","46","13608","2","1301","5.4","4.3"
"Decatur","2020-10-29","44","13652","4","1305","6.5","4.6"
"Decatur","2020-10-30","37","13689","1","1306","6.9","4.8"
"Decatur","2020-10-31","9","13698","1","1307","5.4","5.6"
"Decatur","2020-11-01","5","13703","1","1308","8.3","6.7"
"Decatur","2020-11-02","101","13804","9","1317","8.7","7.1"
"Decatur","2020-11-03","74","13878","8","1325","9.6","7.5"
"Decatur","2020-11-04","92","13970","6","1331","9.9","7.7"
"Decatur","2020-11-05","88","14058","6","1337","9.6","8"
"Decatur","2020-11-06","46","14104","2","1339","9.8","8.3"
"Decatur","2020-11-07","9","14113","0","1339","8.2","6.8"
"Decatur","2020-11-08","7","14120","1","1340","7.4","7.8"
"Decatur","2020-11-09","83","14203","3","1343","6.6","7.7"
"Decatur","2020-11-10","113","14316","11","1354","6.5","8"
"Decatur","2020-11-11","61","14377","2","1356","6","7.9"
"Decatur","2020-11-12","48","14425","3","1359","5.9","7.7"
"Decatur","2020-11-13","107","14532","2","1361","5.6","7.7"
"Decatur","2020-11-14","22","14554","3","1364","7.5","7.9"
"Decatur","2020-11-15","10","14564","1","1365","6.9","7.1"
"Decatur","2020-11-16","70","14634","4","1369","7.2","6.9"
"Decatur","2020-11-17","126","14760","7","1376","6.6","6.5"
"Decatur","2020-11-18","40","14800","1","1377","6.5","6.3"
"Decatur","2020-11-19","56","14856","2","1379","6.1","6"
"Decatur","2020-11-20","56","14912","0","1379","5.9","5.7"
"Decatur","2020-11-21","14","14926","0","1379","3.9","5.7"
"Decatur","2020-11-22","8","14934","1","1380","4.3","5.6"
"Decatur","2020-11-23","90","15024","3","1383","3.9","5.6"
"Decatur","2020-11-24","99","15123","2","1385","3.4","5"
"Decatur","2020-11-25","49","15172","4","1389","4.2","5.4"
"Decatur","2020-11-26","6","15178","0","1389","3.7","4.9"
"Decatur","2020-11-27","40","15218","1","1390","4.1","5"
"Decatur","2020-11-28","17","15235","3","1393","6.6","5.3"
"Decatur","2020-11-29","11","15246","1","1394","6.1","5.2"
"Decatur","2020-11-30","126","15372","15","1409","7.3","5.6"
"Decatur","2020-12-01","65","15437","7","1416","8.6","6"
"Decatur","2020-12-02","77","15514","5","1421","8.3","6.3"
"Decatur","2020-12-03","177","15691","15","1436","9.6","6.6"
"Decatur","2020-12-04","58","15749","9","1445","11.4","7.7"
"Decatur","2020-12-05","22","15771","7","1452","13.4","10"
"Decatur","2020-12-06","9","15780","0","1452","12.1","9.1"
"Decatur","2020-12-07","62","15842","4","1456","11.4","9.3"
"Decatur","2020-12-08","58","15900","6","1462","11.3","9.9"
"Decatur","2020-12-09","106","16006","6","1468","11.2","9.8"
"Decatur","2020-12-10","166","16172","15","1483","11.3","10.4"
"Decatur","2020-12-11","87","16259","6","1489","10","10.7"
"Decatur","2020-12-12","34","16293","3","1492","6.7","10.1"
"Decatur","2020-12-13","12","16305","2","1494","9.1","10.6"
"Decatur","2020-12-14","81","16386","11","1505","10.1","10.8"
"Decatur","2020-12-15","79","16465","11","1516","10.7","11"
"Decatur","2020-12-16","62","16527","16","1532","13.5","12.4"
"Decatur","2020-12-17","204","16731","12","1544","13.1","12.2"
"Decatur","2020-12-18","52","16783","4","1548","13.2","11.6"
"Decatur","2020-12-19","20","16803","4","1552","14.8","10.8"
"Decatur","2020-12-20","14","16817","3","1555","15.5","12.3"
"Decatur","2020-12-21","68","16885","12","1567","16.1","13.1"
"Decatur","2020-12-22","62","16947","9","1576","16.1","13.4"
"Decatur","2020-12-23","123","17070","16","1592","14.3","13.9"
"Decatur","2020-12-24","35","17105","9","1601","17.1","15.1"
"Decatur","2020-12-25","5","17110","0","1601","16","14.6"
"Decatur","2020-12-26","18","17128","4","1605","16.4","15.6"
"Decatur","2020-12-27","23","17151","3","1608","15.2","15.3"
"Decatur","2020-12-28","90","17241","7","1615","13.8","14.9"
"Decatur","2020-12-29","144","17385","22","1637","13.9","15"
"Decatur","2020-12-30","115","17500","12","1649","13.5","13.9"
"Decatur","2020-12-31","118","17618","20","1669","12.2","14.7"
"Decatur","2021-01-01","7","17625","0","1669","12.2","14.1"
"Decatur","2021-01-02","21","17646","4","1673","11.8","14.1"
"Decatur","2021-01-03","4","17650","1","1674","13.5","14.3"
"Decatur","2021-01-04","129","17779","28","1702","15.5","14.6"
"Decatur","2021-01-05","139","17918","24","1726","15.8","14.8"
"Decatur","2021-01-06","157","18075","5","1731","14.7","14.1"
"Decatur","2021-01-07","78","18153","12","1743","14.5","13.4"
"Decatur","2021-01-08","211","18364","32","1775","16.7","14.5"
"Decatur","2021-01-09","23","18387","3","1778","15.8","13.8"
"Decatur","2021-01-10","15","18402","5","1783","17","15.3"
"Decatur","2021-01-11","98","18500","10","1793","15.4","15.4"
"Decatur","2021-01-12","119","18619","24","1817","15.8","15.8"
"Decatur","2021-01-13","54","18673","2","1819","15.9","15.3"
"Decatur","2021-01-14","96","18769","13","1832","15.6","15.1"
"Decatur","2021-01-15","276","19045","25","1857","14.7","15.7"
"Decatur","2021-01-16","30","19075","7","1864","16.2","16"
"Decatur","2021-01-17","11","19086","3","1867","15.3","16.2"
"Decatur","2021-01-18","67","19153","3","1870","14.5","14.9"
"Decatur","2021-01-19","58","19211","4","1874","12.6","14.2"
"Decatur","2021-01-20","84","19295","16","1890","14.8","15.3"
"Decatur","2021-01-21","125","19420","15","1905","14.6","15.1"
"Decatur","2021-01-22","238","19658","30","1935","15.1","14.9"
"Decatur","2021-01-23","15","19673","3","1938","14.6","15.4"
"Decatur","2021-01-24","5","19678","1","1939","13.6","14.5"
"Decatur","2021-01-25","4","19682","2","1941","20.1","17.3"
"Decatur","2021-01-26","1","19683","0","1941","19.1","15.9"
"Decatur","2021-01-27","0","19683","0","1941","16.4","15.6"
"DeKalb","2020-02-01","0","0","0","0",".","."
"DeKalb","2020-02-02","0","0","0","0",".","."
"DeKalb","2020-02-03","0","0","0","0",".","."
"DeKalb","2020-02-04","0","0","0","0",".","."
"DeKalb","2020-02-05","0","0","0","0",".","."
"DeKalb","2020-02-06","0","0","0","0",".","."
"DeKalb","2020-02-07","0","0","0","0","0","."
"DeKalb","2020-02-08","0","0","0","0","0","."
"DeKalb","2020-02-09","0","0","0","0","0","."
"DeKalb","2020-02-10","0","0","0","0","0","."
"DeKalb","2020-02-11","0","0","0","0","0","."
"DeKalb","2020-02-12","0","0","0","0","0","."
"DeKalb","2020-02-13","0","0","0","0","0","."
"DeKalb","2020-02-14","0","0","0","0","0","0"
"DeKalb","2020-02-15","0","0","0","0","0","0"
"DeKalb","2020-02-16","0","0","0","0","0","0"
"DeKalb","2020-02-17","0","0","0","0","0","0"
"DeKalb","2020-02-18","0","0","0","0","0","0"
"DeKalb","2020-02-19","0","0","0","0","0","0"
"DeKalb","2020-02-20","0","0","0","0","0","0"
"DeKalb","2020-02-21","0","0","0","0","0","0"
"DeKalb","2020-02-22","0","0","0","0","0","0"
"DeKalb","2020-02-23","0","0","0","0","0","0"
"DeKalb","2020-02-24","0","0","0","0","0","0"
"DeKalb","2020-02-25","1","1","0","0","0","0"
"DeKalb","2020-02-26","0","1","0","0","0","0"
"DeKalb","2020-02-27","0","1","0","0","0","0"
"DeKalb","2020-02-28","0","1","0","0","0","0"
"DeKalb","2020-02-29","0","1","0","0","0","0"
"DeKalb","2020-03-01","0","1","0","0","0","0"
"DeKalb","2020-03-02","1","2","0","0","0","0"
"DeKalb","2020-03-03","0","2","0","0","0","0"
"DeKalb","2020-03-04","0","2","0","0","0","0"
"DeKalb","2020-03-05","4","6","0","0","0","0"
"DeKalb","2020-03-06","1","7","0","0","0","0"
"DeKalb","2020-03-07","2","9","0","0","0","0"
"DeKalb","2020-03-08","3","12","1","1","4.8","2.4"
"DeKalb","2020-03-09","3","15","0","1","4.8","2.4"
"DeKalb","2020-03-10","6","21","1","2","7.1","3.6"
"DeKalb","2020-03-11","19","40","4","6","10.2","5.1"
"DeKalb","2020-03-12","32","72","3","9","11.5","5.7"
"DeKalb","2020-03-13","62","134","19","28","15.9","7.9"
"DeKalb","2020-03-14","59","193","16","44","19.7","9.9"
"DeKalb","2020-03-15","95","288","24","68","18.6","11.7"
"DeKalb","2020-03-16","176","464","31","99","21.1","12.9"
"DeKalb","2020-03-17","169","633","28","127","21.1","14.1"
"DeKalb","2020-03-18","140","773","23","150","20.4","15.3"
"DeKalb","2020-03-19","147","920","20","170","21","16.3"
"DeKalb","2020-03-20","182","1102","35","205","19.4","17.6"
"DeKalb","2020-03-21","69","1171","20","225","19.7","19.7"
"DeKalb","2020-03-22","103","1274","25","250","19.5","19.1"
"DeKalb","2020-03-23","176","1450","55","305","21.5","21.3"
"DeKalb","2020-03-24","197","1647","56","361","23.2","22.1"
"DeKalb","2020-03-25","220","1867","55","416","24.4","22.4"
"DeKalb","2020-03-26","212","2079","52","468","26","23.5"
"DeKalb","2020-03-27","225","2304","70","538","27.7","23.5"
"DeKalb","2020-03-28","77","2381","22","560","27.6","23.6"
"DeKalb","2020-03-29","67","2448","26","586","29.7","24.6"
"DeKalb","2020-03-30","228","2676","70","656","29.6","25.5"
"DeKalb","2020-03-31","206","2882","50","706","29","26.1"
"DeKalb","2020-04-01","172","3054","36","742","28.4","26.4"
"DeKalb","2020-04-02","193","3247","50","792","28.6","27.3"
"DeKalb","2020-04-03","192","3439","47","839","27.7","27.7"
"DeKalb","2020-04-04","89","3528","19","858","26.6","27.1"
"DeKalb","2020-04-05","50","3578","19","877","26.5","28.1"
"DeKalb","2020-04-06","314","3892","73","950","25.5","27.5"
"DeKalb","2020-04-07","447","4339","64","1014","24","26.5"
"DeKalb","2020-04-08","688","5027","87","1101","22.8","25.6"
"DeKalb","2020-04-09","472","5499","57","1158","20.9","24.7"
"DeKalb","2020-04-10","576","6075","75","1233","19.2","23.5"
"DeKalb","2020-04-11","342","6417","54","1287","18.4","22.5"
"DeKalb","2020-04-12","102","6519","15","1302","15.1","20.8"
"DeKalb","2020-04-13","660","7179","100","1402","14","19.7"
"DeKalb","2020-04-14","722","7901","75","1477","13.4","18.7"
"DeKalb","2020-04-15","670","8571","52","1529","12.7","17.8"
"DeKalb","2020-04-16","825","9396","78","1607","12.3","16.6"
"DeKalb","2020-04-17","924","10320","76","1683","11.6","15.4"
"DeKalb","2020-04-18","425","10745","65","1748","11.6","15"
"DeKalb","2020-04-19","261","11006","29","1777","11.1","13.1"
"DeKalb","2020-04-20","924","11930","81","1858","10.1","12.1"
"DeKalb","2020-04-21","674","12604","92","1950","10.6","12"
"DeKalb","2020-04-22","949","13553","90","2040","10.9","11.8"
"DeKalb","2020-04-23","823","14376","58","2098","10.5","11.4"
"DeKalb","2020-04-24","1146","15522","61","2159","10.1","10.9"
"DeKalb","2020-04-25","510","16032","32","2191","8.8","10.2"
"DeKalb","2020-04-26","242","16274","34","2225","9.2","10.1"
"DeKalb","2020-04-27","723","16997","72","2297","9.4","9.8"
"DeKalb","2020-04-28","842","17839","81","2378","8.8","9.7"
"DeKalb","2020-04-29","1174","19013","71","2449","8.3","9.6"
"DeKalb","2020-04-30","1013","20026","66","2515","8.3","9.4"
"DeKalb","2020-05-01","818","20844","59","2574","8.5","9.3"
"DeKalb","2020-05-02","696","21540","85","2659","9.4","9.1"
"DeKalb","2020-05-03","272","21812","19","2678","8.4","8.8"
"DeKalb","2020-05-04","720","22532","53","2731","8","8.7"
"DeKalb","2020-05-05","754","23286","61","2792","7.8","8.3"
"DeKalb","2020-05-06","1021","24307","46","2838","7.6","7.9"
"DeKalb","2020-05-07","726","25033","46","2884","7.5","7.9"
"DeKalb","2020-05-08","1156","26189","59","2943","7.2","7.9"
"DeKalb","2020-05-09","538","26727","41","2984","6.6","8"
"DeKalb","2020-05-10","239","26966","10","2994","6.2","7.3"
"DeKalb","2020-05-11","1924","28890","101","3095","5.9","6.9"
"DeKalb","2020-05-12","1182","30072","113","3208","6.1","6.9"
"DeKalb","2020-05-13","1057","31129","85","3293","6.6","7.1"
"DeKalb","2020-05-14","1392","32521","102","3395","6.7","7.1"
"DeKalb","2020-05-15","1652","34173","79","3474","6.7","7"
"DeKalb","2020-05-16","760","34933","71","3545","6.9","6.7"
"DeKalb","2020-05-17","391","35324","30","3575","7.4","6.8"
"DeKalb","2020-05-18","1027","36351","79","3654","7.8","6.8"
"DeKalb","2020-05-19","1291","37642","89","3743","7.4","6.7"
"DeKalb","2020-05-20","1275","38917","58","3801","6.9","6.7"
"DeKalb","2020-05-21","1091","40008","93","3894","7.1","6.9"
"DeKalb","2020-05-22","987","40995","95","3989","7.8","7.2"
"DeKalb","2020-05-23","472","41467","36","4025","7.5","7.2"
"DeKalb","2020-05-24","342","41809","37","4062","8","7.7"
"DeKalb","2020-05-25","275","42084","32","4094","8.5","8.1"
"DeKalb","2020-05-26","1566","43650","105","4199","8.5","7.9"
"DeKalb","2020-05-27","1371","45021","90","4289","8.8","7.8"
"DeKalb","2020-05-28","1147","46168","70","4359","8.4","7.8"
"DeKalb","2020-05-29","1165","47333","61","4420","7.8","7.8"
"DeKalb","2020-05-30","546","47879","25","4445","7.4","7.4"
"DeKalb","2020-05-31","413","48292","23","4468","6.6","7.3"
"DeKalb","2020-06-01","1148","49440","80","4548","6","7.2"
"DeKalb","2020-06-02","1325","50765","80","4628","5.9","7.2"
"DeKalb","2020-06-03","1395","52160","77","4705","5.7","7.3"
"DeKalb","2020-06-04","1356","53516","58","4763","5.5","6.9"
"DeKalb","2020-06-05","1140","54656","54","4817","5.4","6.6"
"DeKalb","2020-06-06","593","55249","42","4859","5.7","6.6"
"DeKalb","2020-06-07","324","55573","29","4888","6.2","6.4"
"DeKalb","2020-06-08","1235","56808","91","4979","6.3","6.1"
"DeKalb","2020-06-09","1424","58232","88","5067","6.3","6.1"
"DeKalb","2020-06-10","1464","59696","94","5161","6.4","6.1"
"DeKalb","2020-06-11","1503","61199","64","5225","6.4","5.9"
"DeKalb","2020-06-12","1348","62547","73","5298","6.5","6"
"DeKalb","2020-06-13","690","63237","44","5342","6.4","6.1"
"DeKalb","2020-06-14","369","63606","25","5367","6.1","6.2"
"DeKalb","2020-06-15","1762","65368","93","5460","5.8","6"
"DeKalb","2020-06-16","2005","67373","128","5588","5.8","6.1"
"DeKalb","2020-06-17","1736","69109","154","5742","6.2","6.3"
"DeKalb","2020-06-18","1732","70841","136","5878","6.7","6.6"
"DeKalb","2020-06-19","1673","72514","126","6004","7","6.8"
"DeKalb","2020-06-20","737","73251","92","6096","7.9","7.2"
"DeKalb","2020-06-21","345","73596","59","6155","9.4","7.7"
"DeKalb","2020-06-22","2413","76009","197","6352","9.8","7.8"
"DeKalb","2020-06-23","2213","78222","232","6584","10.4","8.1"
"DeKalb","2020-06-24","1958","80180","260","6844","11","8.6"
"DeKalb","2020-06-25","2728","82908","292","7136","11.4","9"
"DeKalb","2020-06-26","2495","85403","282","7418","11.9","9.5"
"DeKalb","2020-06-27","850","86253","105","7523","11.9","9.9"
"DeKalb","2020-06-28","534","86787","102","7625","12.2","10.8"
"DeKalb","2020-06-29","3003","89790","328","7953","12.6","11.2"
"DeKalb","2020-06-30","3526","93316","404","8357","12.7","11.5"
"DeKalb","2020-07-01","3198","96514","386","8743","12.6","11.8"
"DeKalb","2020-07-02","3347","99861","321","9064","12.4","11.9"
"DeKalb","2020-07-03","1013","100874","111","9175","12.4","12.1"
"DeKalb","2020-07-04","374","101248","84","9259","13.8","12.9"
"DeKalb","2020-07-05","535","101783","101","9360","13.8","13"
"DeKalb","2020-07-06","3381","105164","434","9794","14","13.3"
"DeKalb","2020-07-07","3372","108536","394","10188","14.1","13.4"
"DeKalb","2020-07-08","3516","112052","384","10572","13.9","13.2"
"DeKalb","2020-07-09","3774","115826","372","10944","13.9","13.2"
"DeKalb","2020-07-10","3247","119073","288","11232","13.6","13"
"DeKalb","2020-07-11","926","119999","129","11361","12.4","13.1"
"DeKalb","2020-07-12","618","120617","97","11458","12","12.9"
"DeKalb","2020-07-13","3275","123892","290","11748","11.4","12.7"
"DeKalb","2020-07-14","3093","126985","270","12018","11","12.5"
"DeKalb","2020-07-15","3035","130020","284","12302","10.8","12.3"
"DeKalb","2020-07-16","3048","133068","270","12572","10.6","12.3"
"DeKalb","2020-07-17","2726","135794","187","12759","10.3","12"
"DeKalb","2020-07-18","819","136613","102","12861","10.1","11.3"
"DeKalb","2020-07-19","750","137363","130","12991","10.3","11.2"
"DeKalb","2020-07-20","2960","140323","236","13227","10.2","10.8"
"DeKalb","2020-07-21","2743","143066","178","13405","9.9","10.4"
"DeKalb","2020-07-22","2711","145777","144","13549","9.3","10"
"DeKalb","2020-07-23","2691","148468","173","13722","9","9.8"
"DeKalb","2020-07-24","2816","151284","207","13929","9","9.7"
"DeKalb","2020-07-25","965","152249","99","14028","8.7","9.4"
"DeKalb","2020-07-26","510","152759","57","14085","7.9","9.1"
"DeKalb","2020-07-27","2652","155411","173","14258","7.6","8.9"
"DeKalb","2020-07-28","2592","158003","157","14415","7.6","8.7"
"DeKalb","2020-07-29","2457","160460","186","14601","7.9","8.6"
"DeKalb","2020-07-30","2548","163008","194","14795","8.1","8.5"
"DeKalb","2020-07-31","2670","165678","162","14957","7.9","8.5"
"DeKalb","2020-08-01","907","166585","91","15048","7.9","8.3"
"DeKalb","2020-08-02","421","167006","55","15103","8.1","8"
"DeKalb","2020-08-03","2737","169743","170","15273","8.1","7.9"
"DeKalb","2020-08-04","2552","172295","157","15430","8.1","7.8"
"DeKalb","2020-08-05","2268","174563","129","15559","7.8","7.9"
"DeKalb","2020-08-06","2048","176611","131","15690","7.7","7.9"
"DeKalb","2020-08-07","2370","178981","125","15815","7.5","7.7"
"DeKalb","2020-08-08","943","179924","73","15888","7.2","7.5"
"DeKalb","2020-08-09","504","180428","30","15918","6.2","7.2"
"DeKalb","2020-08-10","2618","183046","184","16102","6.3","7.2"
"DeKalb","2020-08-11","2540","185586","136","16238","6.2","7.2"
"DeKalb","2020-08-12","2206","187792","134","16372","6.3","7"
"DeKalb","2020-08-13","2128","189920","109","16481","6.1","6.9"
"DeKalb","2020-08-14","2475","192395","122","16603","6","6.8"
"DeKalb","2020-08-15","847","193242","57","16660","5.9","6.6"
"DeKalb","2020-08-16","743","193985","56","16716","6.1","6.2"
"DeKalb","2020-08-17","1684","195669","102","16818","6","6.1"
"DeKalb","2020-08-18","1933","197602","108","16926","6","6.1"
"DeKalb","2020-08-19","2097","199699","105","17031","5.9","6.1"
"DeKalb","2020-08-20","1807","201506","106","17137","6","6"
"DeKalb","2020-08-21","2015","203521","103","17240","6","6"
"DeKalb","2020-08-22","855","204376","54","17294","5.9","5.9"
"DeKalb","2020-08-23","537","204913","33","17327","5.7","5.9"
"DeKalb","2020-08-24","2071","206984","114","17441","5.6","5.8"
"DeKalb","2020-08-25","2215","209199","93","17534","5.4","5.7"
"DeKalb","2020-08-26","1736","210935","94","17628","5.5","5.7"
"DeKalb","2020-08-27","1810","212745","101","17729","5.5","5.7"
"DeKalb","2020-08-28","1967","214712","95","17824","5.4","5.7"
"DeKalb","2020-08-29","934","215646","50","17874","5.3","5.6"
"DeKalb","2020-08-30","517","216163","45","17919","5.7","5.7"
"DeKalb","2020-08-31","2274","218437","117","18036","5.6","5.6"
"DeKalb","2020-09-01","2268","220705","108","18144","5.7","5.6"
"DeKalb","2020-09-02","1888","222593","70","18214","5.4","5.5"
"DeKalb","2020-09-03","1809","224402","88","18302","5.3","5.4"
"DeKalb","2020-09-04","1896","226298","89","18391","5.3","5.4"
"DeKalb","2020-09-05","871","227169","26","18417","5","5.1"
"DeKalb","2020-09-06","558","227727","34","18451","4.6","5.1"
"DeKalb","2020-09-07","505","228232","30","18481","4.7","5.2"
"DeKalb","2020-09-08","2228","230460","85","18566","4.6","5.1"
"DeKalb","2020-09-09","1995","232455","74","18640","4.6","5"
"DeKalb","2020-09-10","2046","234501","74","18714","4.4","4.9"
"DeKalb","2020-09-11","2234","236735","62","18776","4.1","4.7"
"DeKalb","2020-09-12","811","237546","48","18824","4.6","4.8"
"DeKalb","2020-09-13","396","237942","27","18851","4.7","4.6"
"DeKalb","2020-09-14","2267","240209","86","18937","4.3","4.5"
"DeKalb","2020-09-15","2143","242352","64","19001","4.2","4.4"
"DeKalb","2020-09-16","1942","244294","56","19057","4.1","4.3"
"DeKalb","2020-09-17","1263","245557","47","19104","4.1","4.3"
"DeKalb","2020-09-18","2697","248254","87","19191","4.2","4.2"
"DeKalb","2020-09-19","985","249239","37","19228","3.9","4.2"
"DeKalb","2020-09-20","506","249745","30","19258","3.8","4.2"
"DeKalb","2020-09-21","2431","252176","92","19350","3.8","4.1"
"DeKalb","2020-09-22","1995","254171","59","19409","3.8","4"
"DeKalb","2020-09-23","2395","256566","80","19489","3.8","4"
"DeKalb","2020-09-24","1960","258526","74","19563","3.8","4"
"DeKalb","2020-09-25","2359","260885","67","19630","3.8","4"
"DeKalb","2020-09-26","898","261783","62","19692","4.2","4.1"
"DeKalb","2020-09-27","399","262182","12","19704","3.8","3.8"
"DeKalb","2020-09-28","2418","264600","89","19793","3.8","3.8"
"DeKalb","2020-09-29","2164","266764","55","19848","3.7","3.7"
"DeKalb","2020-09-30","2140","268904","84","19932","3.8","3.8"
"DeKalb","2020-10-01","2432","271336","72","20004","3.7","3.8"
"DeKalb","2020-10-02","2430","273766","69","20073","3.7","3.7"
"DeKalb","2020-10-03","1052","274818","45","20118","3.3","3.8"
"DeKalb","2020-10-04","503","275321","22","20140","3.5","3.7"
"DeKalb","2020-10-05","2610","277931","92","20232","3.5","3.6"
"DeKalb","2020-10-06","2656","280587","75","20307","3.5","3.6"
"DeKalb","2020-10-07","3005","283592","76","20383","3.3","3.6"
"DeKalb","2020-10-08","2631","286223","82","20465","3.4","3.5"
"DeKalb","2020-10-09","2626","288849","88","20553","3.4","3.6"
"DeKalb","2020-10-10","982","289831","52","20605","3.6","3.4"
"DeKalb","2020-10-11","408","290239","28","20633","3.9","3.7"
"DeKalb","2020-10-12","1894","292133","60","20693","3.9","3.7"
"DeKalb","2020-10-13","2850","294983","90","20783","3.9","3.7"
"DeKalb","2020-10-14","2306","297289","86","20869","4.1","3.7"
"DeKalb","2020-10-15","2406","299695","116","20985","4.3","3.8"
"DeKalb","2020-10-16","2533","302228","98","21083","4.4","3.9"
"DeKalb","2020-10-17","813","303041","54","21137","4.6","4.1"
"DeKalb","2020-10-18","416","303457","17","21154","4.2","4.1"
"DeKalb","2020-10-19","2797","306254","126","21280","4.4","4.1"
"DeKalb","2020-10-20","2533","308787","107","21387","4.6","4.2"
"DeKalb","2020-10-21","2484","311271","91","21478","4.5","4.3"
"DeKalb","2020-10-22","2443","313714","115","21593","4.5","4.4"
"DeKalb","2020-10-23","2936","316650","114","21707","4.5","4.5"
"DeKalb","2020-10-24","952","317602","62","21769","4.5","4.6"
"DeKalb","2020-10-25","717","318319","43","21812","4.8","4.5"
"DeKalb","2020-10-26","2968","321287","141","21953","4.8","4.6"
"DeKalb","2020-10-27","2850","324137","110","22063","4.8","4.7"
"DeKalb","2020-10-28","3255","327392","137","22200","4.8","4.7"
"DeKalb","2020-10-29","1669","329061","90","22290","4.9","4.7"
"DeKalb","2020-10-30","3417","332478","162","22452","5.1","4.8"
"DeKalb","2020-10-31","1048","333526","67","22519","5","4.8"
"DeKalb","2020-11-01","607","334133","50","22569","5.4","5.1"
"DeKalb","2020-11-02","3653","337786","209","22778","5.5","5.2"
"DeKalb","2020-11-03","2569","340355","121","22899","5.6","5.2"
"DeKalb","2020-11-04","3061","343416","163","23062","5.8","5.3"
"DeKalb","2020-11-05","3046","346462","167","23229","5.8","5.4"
"DeKalb","2020-11-06","3300","349762","202","23431","6","5.5"
"DeKalb","2020-11-07","1471","351233","90","23521","6","5.5"
"DeKalb","2020-11-08","790","352023","62","23583","5.9","5.6"
"DeKalb","2020-11-09","3599","355622","257","23840","6.1","5.8"
"DeKalb","2020-11-10","3603","359225","240","24080","6.4","6"
"DeKalb","2020-11-11","2653","361878","184","24264","6.6","6.2"
"DeKalb","2020-11-12","3589","365467","221","24485","6.7","6.3"
"DeKalb","2020-11-13","4185","369652","237","24722","6.6","6.3"
"DeKalb","2020-11-14","1982","371634","146","24868","6.8","6.4"
"DeKalb","2020-11-15","849","372483","79","24947","7","6.5"
"DeKalb","2020-11-16","4573","377056","270","25217","6.9","6.5"
"DeKalb","2020-11-17","4425","381481","213","25430","6.6","6.5"
"DeKalb","2020-11-18","4872","386353","245","25675","6.3","6.5"
"DeKalb","2020-11-19","5203","391556","234","25909","6.1","6.4"
"DeKalb","2020-11-20","5286","396842","192","26101","5.8","6.2"
"DeKalb","2020-11-21","2444","399286","126","26227","5.5","6.2"
"DeKalb","2020-11-22","1283","400569","74","26301","5","6"
"DeKalb","2020-11-23","5149","405718","219","26520","4.7","5.8"
"DeKalb","2020-11-24","4786","410504","280","26800","4.9","5.7"
"DeKalb","2020-11-25","3195","413699","205","27005","5.1","5.7"
"DeKalb","2020-11-26","537","414236","32","27037","5.3","5.7"
"DeKalb","2020-11-27","2004","416240","208","27245","6.3","6"
"DeKalb","2020-11-28","1259","417499","153","27398","7.3","6.4"
"DeKalb","2020-11-29","1107","418606","112","27510","7.9","6.4"
"DeKalb","2020-11-30","4624","423230","453","27963","8.7","6.7"
"DeKalb","2020-12-01","3946","427176","427","28390","9.4","7.1"
"DeKalb","2020-12-02","3791","430967","343","28733","9.8","7.4"
"DeKalb","2020-12-03","3795","434762","369","29102","10.3","7.8"
"DeKalb","2020-12-04","4425","439187","394","29496","10.1","8.2"
"DeKalb","2020-12-05","2039","441226","216","29712","9.9","8.6"
"DeKalb","2020-12-06","938","442164","88","29800","9.8","8.8"
"DeKalb","2020-12-07","4032","446196","424","30224","9.9","9.3"
"DeKalb","2020-12-08","3918","450114","363","30587","9.6","9.5"
"DeKalb","2020-12-09","4203","454317","398","30985","9.7","9.7"
"DeKalb","2020-12-10","3920","458237","410","31395","9.8","10"
"DeKalb","2020-12-11","4331","462568","439","31834","10","10"
"DeKalb","2020-12-12","2112","464680","277","32111","10.3","10.1"
"DeKalb","2020-12-13","940","465620","131","32242","11","10.4"
"DeKalb","2020-12-14","4512","470132","487","32729","11","10.4"
"DeKalb","2020-12-15","4168","474300","406","33135","11.1","10.4"
"DeKalb","2020-12-16","4070","478370","368","33503","11","10.4"
"DeKalb","2020-12-17","4961","483331","522","34025","11","10.4"
"DeKalb","2020-12-18","5095","488426","457","34482","10.9","10.4"
"DeKalb","2020-12-19","2649","491075","266","34748","10.4","10.4"
"DeKalb","2020-12-20","1346","492421","151","34899","10","10.5"
"DeKalb","2020-12-21","4975","497396","546","35445","10.1","10.5"
"DeKalb","2020-12-22","4862","502258","499","35944","10.1","10.6"
"DeKalb","2020-12-23","4083","506341","443","36387","10.4","10.7"
"DeKalb","2020-12-24","1626","507967","185","36572","10.5","10.8"
"DeKalb","2020-12-25","336","508303","38","36610","10.9","10.9"
"DeKalb","2020-12-26","1797","510100","327","36937","12","11.2"
"DeKalb","2020-12-27","1401","511501","261","37198","13.1","11.6"
"DeKalb","2020-12-28","4425","515926","608","37806","13.5","11.8"
"DeKalb","2020-12-29","3861","519787","594","38400","14.2","12.2"
"DeKalb","2020-12-30","4020","523807","506","38906","14.5","12.4"
"DeKalb","2020-12-31","2709","526516","310","39216","14.5","12.5"
"DeKalb","2021-01-01","410","526926","67","39283","15.2","13"
"DeKalb","2021-01-02","1897","528823","338","39621","15.1","13.6"
"DeKalb","2021-01-03","787","529610","108","39729","14.4","13.8"
"DeKalb","2021-01-04","3532","533142","563","40292","14.7","14.1"
"DeKalb","2021-01-05","4853","537995","684","40976","14.6","14.4"
"DeKalb","2021-01-06","3353","541348","436","41412","14.6","14.5"
"DeKalb","2021-01-07","4214","545562","674","42086","15.3","14.9"
"DeKalb","2021-01-08","3822","549384","501","42587","14.8","15"
"DeKalb","2021-01-09","2153","551537","376","42963","14.8","14.9"
"DeKalb","2021-01-10","1302","552839","214","43177","15.1","14.8"
"DeKalb","2021-01-11","3887","556726","517","43694","14.8","14.8"
"DeKalb","2021-01-12","3598","560324","513","44207","14.8","14.7"
"DeKalb","2021-01-13","3731","564055","369","44576","14.4","14.5"
"DeKalb","2021-01-14","4244","568299","528","45104","13.8","14.6"
"DeKalb","2021-01-15","3895","572194","487","45591","13.8","14.3"
"DeKalb","2021-01-16","2013","574207","278","45869","13.2","14"
"DeKalb","2021-01-17","1155","575362","198","46067","13.3","14.2"
"DeKalb","2021-01-18","2484","577846","252","46319","12.9","13.8"
"DeKalb","2021-01-19","3723","581569","397","46716","12.4","13.6"
"DeKalb","2021-01-20","3272","584841","341","47057","12.4","13.4"
"DeKalb","2021-01-21","3336","588177","427","47484","12.5","13.2"
"DeKalb","2021-01-22","3571","591748","377","47861","12.2","13"
"DeKalb","2021-01-23","1544","593292","227","48088","12.3","12.8"
"DeKalb","2021-01-24","827","594119","143","48231","12.4","12.9"
"DeKalb","2021-01-25","1937","596056","205","48436","12.4","12.7"
"DeKalb","2021-01-26","70","596126","3","48439","11.5","11.9"
"DeKalb","2021-01-27","0","596126","0","48439","10","11.2"
"Dodge","2020-02-01","0","0","0","0",".","."
"Dodge","2020-02-02","0","0","0","0",".","."
"Dodge","2020-02-03","0","0","0","0",".","."
"Dodge","2020-02-04","0","0","0","0",".","."
"Dodge","2020-02-05","0","0","0","0",".","."
"Dodge","2020-02-06","0","0","0","0",".","."
"Dodge","2020-02-07","0","0","0","0","0","."
"Dodge","2020-02-08","0","0","0","0","0","."
"Dodge","2020-02-09","0","0","0","0","0","."
"Dodge","2020-02-10","0","0","0","0","0","."
"Dodge","2020-02-11","0","0","0","0","0","."
"Dodge","2020-02-12","0","0","0","0","0","."
"Dodge","2020-02-13","0","0","0","0","0","."
"Dodge","2020-02-14","0","0","0","0","0","0"
"Dodge","2020-02-15","0","0","0","0","0","0"
"Dodge","2020-02-16","0","0","0","0","0","0"
"Dodge","2020-02-17","0","0","0","0","0","0"
"Dodge","2020-02-18","0","0","0","0","0","0"
"Dodge","2020-02-19","0","0","0","0","0","0"
"Dodge","2020-02-20","0","0","0","0","0","0"
"Dodge","2020-02-21","0","0","0","0","0","0"
"Dodge","2020-02-22","0","0","0","0","0","0"
"Dodge","2020-02-23","0","0","0","0","0","0"
"Dodge","2020-02-24","0","0","0","0","0","0"
"Dodge","2020-02-25","0","0","0","0","0","0"
"Dodge","2020-02-26","0","0","0","0","0","0"
"Dodge","2020-02-27","0","0","0","0","0","0"
"Dodge","2020-02-28","0","0","0","0","0","0"
"Dodge","2020-02-29","0","0","0","0","0","0"
"Dodge","2020-03-01","0","0","0","0","0","0"
"Dodge","2020-03-02","0","0","0","0","0","0"
"Dodge","2020-03-03","0","0","0","0","0","0"
"Dodge","2020-03-04","0","0","0","0","0","0"
"Dodge","2020-03-05","0","0","0","0","0","0"
"Dodge","2020-03-06","0","0","0","0","0","0"
"Dodge","2020-03-07","0","0","0","0","0","0"
"Dodge","2020-03-08","0","0","0","0","0","0"
"Dodge","2020-03-09","1","1","1","1","14.3","7.1"
"Dodge","2020-03-10","0","1","0","1","14.3","7.1"
"Dodge","2020-03-11","0","1","0","1","14.3","7.1"
"Dodge","2020-03-12","0","1","0","1","14.3","7.1"
"Dodge","2020-03-13","1","2","0","1","14.3","7.1"
"Dodge","2020-03-14","1","3","0","1","14.3","7.1"
"Dodge","2020-03-15","0","3","0","1","14.3","7.1"
"Dodge","2020-03-16","3","6","0","1","0","7.1"
"Dodge","2020-03-17","10","16","0","1","0","7.1"
"Dodge","2020-03-18","4","20","0","1","0","7.1"
"Dodge","2020-03-19","6","26","0","1","0","7.1"
"Dodge","2020-03-20","6","32","1","2","2.4","8.3"
"Dodge","2020-03-21","0","32","0","2","2.4","8.3"
"Dodge","2020-03-22","1","33","0","2","2.4","8.3"
"Dodge","2020-03-23","3","36","0","2","2.4","1.2"
"Dodge","2020-03-24","8","44","0","2","2.4","1.2"
"Dodge","2020-03-25","6","50","1","3","4.8","2.4"
"Dodge","2020-03-26","4","54","0","3","4.8","2.4"
"Dodge","2020-03-27","2","56","0","3","2.4","2.4"
"Dodge","2020-03-28","0","56","0","3","2.4","2.4"
"Dodge","2020-03-29","1","57","0","3","2.4","2.4"
"Dodge","2020-03-30","1","58","0","3","2.4","2.4"
"Dodge","2020-03-31","2","60","2","5","16.7","9.5"
"Dodge","2020-04-01","1","61","0","5","14.3","9.5"
"Dodge","2020-04-02","5","66","0","5","14.3","9.5"
"Dodge","2020-04-03","6","72","0","5","14.3","8.3"
"Dodge","2020-04-04","5","77","0","5","14.3","8.3"
"Dodge","2020-04-05","0","77","0","5","14.3","8.3"
"Dodge","2020-04-06","2","79","0","5","14.3","8.3"
"Dodge","2020-04-07","1","80","0","5","0","8.3"
"Dodge","2020-04-08","0","80","0","5","0","7.1"
"Dodge","2020-04-09","5","85","1","6","2.9","8.6"
"Dodge","2020-04-10","2","87","0","6","2.9","8.6"
"Dodge","2020-04-11","4","91","2","8","10","12.1"
"Dodge","2020-04-12","3","94","2","10","19.5","16.9"
"Dodge","2020-04-13","10","104","1","11","21","17.6"
"Dodge","2020-04-14","3","107","1","12","25.7","12.9"
"Dodge","2020-04-15","3","110","0","12","25.7","12.9"
"Dodge","2020-04-16","4","114","0","12","22.9","12.9"
"Dodge","2020-04-17","7","121","0","12","22.9","12.9"
"Dodge","2020-04-18","3","124","1","13","20.5","15.2"
"Dodge","2020-04-19","0","124","0","13","11","15.2"
"Dodge","2020-04-20","3","127","0","13","9.5","15.2"
"Dodge","2020-04-21","17","144","2","15","6.4","16.1"
"Dodge","2020-04-22","9","153","0","15","6.4","16.1"
"Dodge","2020-04-23","8","161","0","15","6.4","14.6"
"Dodge","2020-04-24","3","164","0","15","6.4","14.6"
"Dodge","2020-04-25","0","164","0","15","1.7","11.1"
"Dodge","2020-04-26","2","166","0","15","1.7","6.3"
"Dodge","2020-04-27","3","169","0","15","1.7","5.6"
"Dodge","2020-04-28","6","175","0","15","0","3.2"
"Dodge","2020-04-29","10","185","1","16","1.4","3.9"
"Dodge","2020-04-30","8","193","0","16","1.4","3.9"
"Dodge","2020-05-01","3","196","0","16","1.4","3.9"
"Dodge","2020-05-02","1","197","0","16","1.4","1.6"
"Dodge","2020-05-03","8","205","1","17","3.2","2.4"
"Dodge","2020-05-04","11","216","1","18","4.5","3.1"
"Dodge","2020-05-05","3","219","0","18","4.5","2.3"
"Dodge","2020-05-06","3","222","0","18","3.1","2.3"
"Dodge","2020-05-07","0","222","0","18","3.1","2.3"
"Dodge","2020-05-08","3","225","0","18","3.1","2.3"
"Dodge","2020-05-09","2","227","1","19","10.2","5.8"
"Dodge","2020-05-10","0","227","0","19","8.4","5.8"
"Dodge","2020-05-11","4","231","0","19","7.1","5.8"
"Dodge","2020-05-12","4","235","0","19","7.1","5.8"
"Dodge","2020-05-13","6","241","0","19","7.1","5.1"
"Dodge","2020-05-14","2","243","0","19","7.1","5.1"
"Dodge","2020-05-15","5","248","0","19","7.1","5.1"
"Dodge","2020-05-16","12","260","0","19","0","5.1"
"Dodge","2020-05-17","1","261","0","19","0","4.2"
"Dodge","2020-05-18","13","274","1","20","1.1","4.1"
"Dodge","2020-05-19","10","284","1","21","2.5","4.8"
"Dodge","2020-05-20","43","327","2","23","3.2","5.2"
"Dodge","2020-05-21","11","338","0","23","3.2","5.2"
"Dodge","2020-05-22","13","351","0","23","3.2","5.2"
"Dodge","2020-05-23","2","353","0","23","3.2","1.6"
"Dodge","2020-05-24","1","354","0","23","3.2","1.6"
"Dodge","2020-05-25","3","357","0","23","2.1","1.6"
"Dodge","2020-05-26","9","366","0","23","0.7","1.6"
"Dodge","2020-05-27","12","378","0","23","0","1.6"
"Dodge","2020-05-28","9","387","1","24","1.6","2.4"
"Dodge","2020-05-29","85","472","0","24","1.6","2.4"
"Dodge","2020-05-30","5","477","1","25","4.4","3.8"
"Dodge","2020-05-31","1","478","0","25","4.4","3.8"
"Dodge","2020-06-01","10","488","1","26","5.9","4"
"Dodge","2020-06-02","15","503","0","26","5.9","3.3"
"Dodge","2020-06-03","22","525","0","26","5.9","2.9"
"Dodge","2020-06-04","9","534","0","26","4.3","2.9"
"Dodge","2020-06-05","5","539","0","26","4.3","2.9"
"Dodge","2020-06-06","5","544","0","26","1.4","2.9"
"Dodge","2020-06-07","2","546","0","26","1.4","2.9"
"Dodge","2020-06-08","13","559","0","26","0","2.9"
"Dodge","2020-06-09","16","575","0","26","0","2.9"
"Dodge","2020-06-10","12","587","1","27","1.2","3.5"
"Dodge","2020-06-11","18","605","1","28","2","3.1"
"Dodge","2020-06-12","10","615","0","28","2","3.1"
"Dodge","2020-06-13","2","617","0","28","2","1.7"
"Dodge","2020-06-14","2","619","0","28","2","1.7"
"Dodge","2020-06-15","12","631","0","28","2","1"
"Dodge","2020-06-16","9","640","0","28","2","1"
"Dodge","2020-06-17","7","647","1","29","2.8","2"
"Dodge","2020-06-18","7","654","0","29","2","2"
"Dodge","2020-06-19","9","663","0","29","2","2"
"Dodge","2020-06-20","8","671","1","30","3.8","2.9"
"Dodge","2020-06-21","0","671","0","30","3.8","2.9"
"Dodge","2020-06-22","11","682","4","34","9","5.5"
"Dodge","2020-06-23","9","691","0","34","9","5.5"
"Dodge","2020-06-24","11","702","1","35","8.3","5.6"
"Dodge","2020-06-25","4","706","0","35","8.3","5.2"
"Dodge","2020-06-26","10","716","1","36","9.7","5.9"
"Dodge","2020-06-27","5","721","1","37","10.8","7.3"
"Dodge","2020-06-28","0","721","0","37","10.8","7.3"
"Dodge","2020-06-29","8","729","0","37","5.6","7.3"
"Dodge","2020-06-30","11","740","2","39","8.2","8.6"
"Dodge","2020-07-01","3","743","0","39","6.9","7.6"
"Dodge","2020-07-02","8","751","0","39","6.9","7.6"
"Dodge","2020-07-03","2","753","0","39","5.5","7.6"
"Dodge","2020-07-04","0","753","0","39","2.6","6.7"
"Dodge","2020-07-05","5","758","1","40","5.5","8.1"
"Dodge","2020-07-06","7","765","0","40","5.5","5.5"
"Dodge","2020-07-07","8","773","0","40","2.9","5.5"
"Dodge","2020-07-08","12","785","0","40","2.9","4.9"
"Dodge","2020-07-09","10","795","0","40","2.9","4.9"
"Dodge","2020-07-10","10","805","1","41","4.3","4.9"
"Dodge","2020-07-11","4","809","1","42","7.9","5.2"
"Dodge","2020-07-12","0","809","0","42","5","5.2"
"Dodge","2020-07-13","5","814","0","42","5","5.2"
"Dodge","2020-07-14","10","824","0","42","5","3.9"
"Dodge","2020-07-15","9","833","1","43","6.6","4.7"
"Dodge","2020-07-16","7","840","0","43","6.6","4.7"
"Dodge","2020-07-17","6","846","1","44","7.5","5.9"
"Dodge","2020-07-18","1","847","0","44","4","5.9"
"Dodge","2020-07-19","0","847","0","44","4","4.5"
"Dodge","2020-07-20","8","855","0","44","4","4.5"
"Dodge","2020-07-21","9","864","2","46","7.1","6.1"
"Dodge","2020-07-22","7","871","0","46","5.6","6.1"
"Dodge","2020-07-23","10","881","0","46","5.6","6.1"
"Dodge","2020-07-24","15","896","1","47","4.1","5.8"
"Dodge","2020-07-25","5","901","2","49","9.8","6.9"
"Dodge","2020-07-26","2","903","1","50","17","10.5"
"Dodge","2020-07-27","9","912","1","51","18.6","11.3"
"Dodge","2020-07-28","14","926","1","52","16.4","11.8"
"Dodge","2020-07-29","7","933","0","52","16.4","11"
"Dodge","2020-07-30","18","951","0","52","16.4","11"
"Dodge","2020-07-31","5","956","0","52","15.5","9.8"
"Dodge","2020-08-01","1","957","0","52","9.8","9.8"
"Dodge","2020-08-02","4","961","2","54","9.8","13.4"
"Dodge","2020-08-03","6","967","0","54","8.2","13.4"
"Dodge","2020-08-04","13","980","4","58","11.5","14"
"Dodge","2020-08-05","10","990","2","60","14.4","15.4"
"Dodge","2020-08-06","20","1010","6","66","18.7","17.5"
"Dodge","2020-08-07","37","1047","3","69","19.8","17.7"
"Dodge","2020-08-08","134","1181","6","75","20.5","15.1"
"Dodge","2020-08-09","6","1187","2","77","18.1","13.9"
"Dodge","2020-08-10","7","1194","1","78","20.1","14.2"
"Dodge","2020-08-11","8","1202","0","78","15.7","13.6"
"Dodge","2020-08-12","23","1225","12","90","20.3","17.4"
"Dodge","2020-08-13","8","1233","0","90","16.1","17.4"
"Dodge","2020-08-14","6","1239","1","91","17.3","18.6"
"Dodge","2020-08-15","8","1247","3","94","22","21.2"
"Dodge","2020-08-16","0","1247","0","94","17.2","17.7"
"Dodge","2020-08-17","9","1256","0","94","15.2","17.7"
"Dodge","2020-08-18","17","1273","1","95","16","15.9"
"Dodge","2020-08-19","19","1292","4","99","11.6","16"
"Dodge","2020-08-20","19","1311","5","104","15.3","15.7"
"Dodge","2020-08-21","13","1324","3","107","16.3","16.8"
"Dodge","2020-08-22","2","1326","1","108","18","20"
"Dodge","2020-08-23","5","1331","0","108","18","17.6"
"Dodge","2020-08-24","10","1341","3","111","22.3","18.8"
"Dodge","2020-08-25","25","1366","8","119","26.1","21"
"Dodge","2020-08-26","11","1377","2","121","25.7","18.6"
"Dodge","2020-08-27","22","1399","3","124","23.8","19.6"
"Dodge","2020-08-28","11","1410","1","125","21.8","19.1"
"Dodge","2020-08-29","8","1418","0","125","14.7","16.4"
"Dodge","2020-08-30","4","1422","1","126","18.3","18.2"
"Dodge","2020-08-31","91","1513","3","129","14.5","18.4"
"Dodge","2020-09-01","77","1590","2","131","10.3","18.2"
"Dodge","2020-09-02","10","1600","1","132","9.1","17.4"
"Dodge","2020-09-03","11","1611","2","134","9.7","16.8"
"Dodge","2020-09-04","7","1618","0","134","8.4","15.1"
"Dodge","2020-09-05","10","1628","0","134","8.4","11.6"
"Dodge","2020-09-06","140","1768","2","136","5.1","11.7"
"Dodge","2020-09-07","6","1774","1","137","7","10.7"
"Dodge","2020-09-08","7","1781","0","137","6.6","8.4"
"Dodge","2020-09-09","7","1788","3","140","11.3","10.2"
"Dodge","2020-09-10","50","1838","7","147","10.7","10.2"
"Dodge","2020-09-11","6","1844","1","148","13.1","10.8"
"Dodge","2020-09-12","12","1856","0","148","13.1","10.8"
"Dodge","2020-09-13","5","1861","1","149","15.7","10.4"
"Dodge","2020-09-14","10","1871","0","149","13.4","10.2"
"Dodge","2020-09-15","13","1884","2","151","15.6","11.1"
"Dodge","2020-09-16","11","1895","2","153","12","11.7"
"Dodge","2020-09-17","80","1975","1","154","10.2","10.5"
"Dodge","2020-09-18","78","2053","3","157","8.4","10.7"
"Dodge","2020-09-19","3","2056","0","157","8.4","10.7"
"Dodge","2020-09-20","1","2057","0","157","5.5","10.6"
"Dodge","2020-09-21","16","2073","2","159","7.3","10.3"
"Dodge","2020-09-22","8","2081","0","159","5.1","10.3"
"Dodge","2020-09-23","43","2124","1","160","2.8","7.4"
"Dodge","2020-09-24","61","2185","3","163","3.4","6.8"
"Dodge","2020-09-25","12","2197","0","163","2.8","5.6"
"Dodge","2020-09-26","5","2202","0","163","2.8","5.6"
"Dodge","2020-09-27","3","2205","1","164","7.6","6.6"
"Dodge","2020-09-28","12","2217","0","164","5.8","6.6"
"Dodge","2020-09-29","5","2222","0","164","5.8","5.5"
"Dodge","2020-09-30","9","2231","2","166","8.6","5.7"
"Dodge","2020-10-01","111","2342","3","169","8.3","5.8"
"Dodge","2020-10-02","10","2352","0","169","8.3","5.6"
"Dodge","2020-10-03","13","2365","2","171","10.5","6.7"
"Dodge","2020-10-04","67","2432","1","172","6","6.8"
"Dodge","2020-10-05","12","2444","3","175","9.5","7.7"
"Dodge","2020-10-06","28","2472","0","175","9.5","7.7"
"Dodge","2020-10-07","3","2475","1","176","11.1","9.9"
"Dodge","2020-10-08","53","2528","6","182","12.4","10.3"
"Dodge","2020-10-09","13","2541","0","182","12.4","10.3"
"Dodge","2020-10-10","7","2548","0","182","10.2","10.3"
"Dodge","2020-10-11","133","2681","12","194","11.2","8.6"
"Dodge","2020-10-12","15","2696","0","194","7.7","8.6"
"Dodge","2020-10-13","10","2706","1","195","9.1","9.3"
"Dodge","2020-10-14","112","2818","12","207","5.9","8.5"
"Dodge","2020-10-15","97","2915","15","222","6.5","9.4"
"Dodge","2020-10-16","7","2922","1","223","8.5","10.4"
"Dodge","2020-10-17","7","2929","1","224","10.5","10.4"
"Dodge","2020-10-18","6","2935","5","229","21.2","16.2"
"Dodge","2020-10-19","26","2961","2","231","22.3","15"
"Dodge","2020-10-20","28","2989","4","235","22.9","16"
"Dodge","2020-10-21","96","3085","17","252","23.9","14.9"
"Dodge","2020-10-22","89","3174","18","270","24.5","15.5"
"Dodge","2020-10-23","15","3189","2","272","24.4","16.5"
"Dodge","2020-10-24","38","3227","6","278","24.6","17.6"
"Dodge","2020-10-25","34","3261","5","283","14.8","18"
"Dodge","2020-10-26","21","3282","2","285","15.1","18.7"
"Dodge","2020-10-27","9","3291","1","286","14.6","18.7"
"Dodge","2020-10-28","46","3337","2","288","12.7","18.3"
"Dodge","2020-10-29","52","3389","5","293","11.2","17.9"
"Dodge","2020-10-30","10","3399","1","294","10.7","17.6"
"Dodge","2020-10-31","7","3406","1","295","10.5","17.6"
"Dodge","2020-11-01","24","3430","2","297","9.6","12.2"
"Dodge","2020-11-02","13","3443","0","297","8.2","11.7"
"Dodge","2020-11-03","22","3465","0","297","6.7","10.6"
"Dodge","2020-11-04","34","3499","0","297","6","9.4"
"Dodge","2020-11-05","47","3546","4","301","5.9","8.5"
"Dodge","2020-11-06","12","3558","0","301","4.4","7.6"
"Dodge","2020-11-07","16","3574","1","302","3.3","6.9"
"Dodge","2020-11-08","26","3600","2","304","3.2","6.4"
"Dodge","2020-11-09","16","3616","1","305","4.1","6.2"
"Dodge","2020-11-10","16","3632","0","305","4.1","5.4"
"Dodge","2020-11-11","5","3637","2","307","9.8","7.9"
"Dodge","2020-11-12","96","3733","4","311","9.2","7.5"
"Dodge","2020-11-13","7","3740","1","312","11.2","7.8"
"Dodge","2020-11-14","8","3748","2","314","13.9","8.6"
"Dodge","2020-11-15","46","3794","7","321","15","9.1"
"Dodge","2020-11-16","17","3811","2","323","15.8","9.9"
"Dodge","2020-11-17","15","3826","2","325","17.7","10.9"
"Dodge","2020-11-18","10","3836","1","326","13.4","11.6"
"Dodge","2020-11-19","50","3886","3","329","13.7","11.4"
"Dodge","2020-11-20","42","3928","3","332","12.6","11.9"
"Dodge","2020-11-21","3","3931","1","333","13.8","13.9"
"Dodge","2020-11-22","4","3935","1","334","15.2","15.1"
"Dodge","2020-11-23","10","3945","0","334","13.5","14.7"
"Dodge","2020-11-24","23","3968","2","336","12.9","15.3"
"Dodge","2020-11-25","45","4013","0","336","11.5","12.4"
"Dodge","2020-11-26","0","4013","0","336","10.6","12.1"
"Dodge","2020-11-27","8","4021","0","336","9.6","11.1"
"Dodge","2020-11-28","6","4027","1","337","7.2","10.5"
"Dodge","2020-11-29","10","4037","2","339","6.5","10.9"
"Dodge","2020-11-30","109","4146","1","340","6.6","10.1"
"Dodge","2020-12-01","21","4167","3","343","7.4","10.1"
"Dodge","2020-12-02","8","4175","1","344","9.2","10.3"
"Dodge","2020-12-03","116","4291","8","352","10.2","10.4"
"Dodge","2020-12-04","20","4311","3","355","12.3","10.9"
"Dodge","2020-12-05","3","4314","1","356","14.7","10.9"
"Dodge","2020-12-06","8","4322","2","358","15.4","10.9"
"Dodge","2020-12-07","9","4331","1","359","16.9","11.7"
"Dodge","2020-12-08","13","4344","3","362","18.1","12.8"
"Dodge","2020-12-09","52","4396","3","365","17.2","13.2"
"Dodge","2020-12-10","74","4470","13","378","18.7","14.4"
"Dodge","2020-12-11","18","4488","2","380","18.1","15.2"
"Dodge","2020-12-12","5","4493","2","382","19.1","16.9"
"Dodge","2020-12-13","7","4500","3","385","21.6","18.5"
"Dodge","2020-12-14","70","4570","3","388","20.7","18.8"
"Dodge","2020-12-15","25","4595","5","393","20.2","19.2"
"Dodge","2020-12-16","87","4682","3","396","19.9","18.5"
"Dodge","2020-12-17","109","4791","10","406","18.7","18.7"
"Dodge","2020-12-18","25","4816","6","412","20.5","19.3"
"Dodge","2020-12-19","9","4825","1","413","16.4","17.8"
"Dodge","2020-12-20","12","4837","4","417","15.1","18.3"
"Dodge","2020-12-21","20","4857","4","421","17.3","19"
"Dodge","2020-12-22","81","4938","13","434","16.7","18.5"
"Dodge","2020-12-23","43","4981","1","435","16.6","18.2"
"Dodge","2020-12-24","8","4989","2","437","18.8","18.8"
"Dodge","2020-12-25","2","4991","0","437","15.4","18"
"Dodge","2020-12-26","15","5006","7","444","20.5","18.4"
"Dodge","2020-12-27","6","5012","2","446","20.5","17.8"
"Dodge","2020-12-28","26","5038","6","452","20.9","19.1"
"Dodge","2020-12-29","18","5056","4","456","21.8","19.3"
"Dodge","2020-12-30","14","5070","4","460","25.6","21.1"
"Dodge","2020-12-31","158","5228","27","487","24.4","21.6"
"Dodge","2021-01-01","7","5235","1","488","26.5","20.9"
"Dodge","2021-01-02","23","5258","5","493","22.9","21.7"
"Dodge","2021-01-03","2","5260","1","494","25.3","22.9"
"Dodge","2021-01-04","23","5283","4","498","24.5","22.7"
"Dodge","2021-01-05","103","5386","9","507","22.5","22.2"
"Dodge","2021-01-06","50","5436","10","517","21.3","23.4"
"Dodge","2021-01-07","153","5589","17","534","20.5","22.4"
"Dodge","2021-01-08","19","5608","8","542","24.4","25.5"
"Dodge","2021-01-09","23","5631","4","546","23.8","23.4"
"Dodge","2021-01-10","10","5641","3","549","21","23.1"
"Dodge","2021-01-11","38","5679","5","554","20.4","22.4"
"Dodge","2021-01-12","97","5776","5","559","19.8","21.2"
"Dodge","2021-01-13","21","5797","0","559","17","19.2"
"Dodge","2021-01-14","26","5823","5","564","18.1","19.3"
"Dodge","2021-01-15","25","5848","1","565","12.7","18.6"
"Dodge","2021-01-16","10","5858","4","569","15.9","19.9"
"Dodge","2021-01-17","4","5862","1","570","15.2","18.1"
"Dodge","2021-01-18","13","5875","2","572","15.5","17.9"
"Dodge","2021-01-19","126","6001","2","574","15","17.4"
"Dodge","2021-01-20","67","6068","6","580","16.3","16.6"
"Dodge","2021-01-21","114","6182","9","589","14.7","16.4"
"Dodge","2021-01-22","19","6201","1","590","14.9","13.8"
"Dodge","2021-01-23","13","6214","1","591","10.3","13.1"
"Dodge","2021-01-24","4","6218","1","592","10.3","12.7"
"Dodge","2021-01-25","5","6223","1","593","10.9","13.2"
"Dodge","2021-01-26","1","6224","0","593","10.7","12.9"
"Dodge","2021-01-27","0","6224","0","593","9.4","12.9"
"Dooly","2020-02-01","0","0","0","0",".","."
"Dooly","2020-02-02","0","0","0","0",".","."
"Dooly","2020-02-03","0","0","0","0",".","."
"Dooly","2020-02-04","0","0","0","0",".","."
"Dooly","2020-02-05","0","0","0","0",".","."
"Dooly","2020-02-06","0","0","0","0",".","."
"Dooly","2020-02-07","0","0","0","0","0","."
"Dooly","2020-02-08","0","0","0","0","0","."
"Dooly","2020-02-09","0","0","0","0","0","."
"Dooly","2020-02-10","0","0","0","0","0","."
"Dooly","2020-02-11","0","0","0","0","0","."
"Dooly","2020-02-12","0","0","0","0","0","."
"Dooly","2020-02-13","0","0","0","0","0","."
"Dooly","2020-02-14","0","0","0","0","0","0"
"Dooly","2020-02-15","0","0","0","0","0","0"
"Dooly","2020-02-16","0","0","0","0","0","0"
"Dooly","2020-02-17","0","0","0","0","0","0"
"Dooly","2020-02-18","0","0","0","0","0","0"
"Dooly","2020-02-19","0","0","0","0","0","0"
"Dooly","2020-02-20","0","0","0","0","0","0"
"Dooly","2020-02-21","0","0","0","0","0","0"
"Dooly","2020-02-22","0","0","0","0","0","0"
"Dooly","2020-02-23","0","0","0","0","0","0"
"Dooly","2020-02-24","0","0","0","0","0","0"
"Dooly","2020-02-25","0","0","0","0","0","0"
"Dooly","2020-02-26","0","0","0","0","0","0"
"Dooly","2020-02-27","0","0","0","0","0","0"
"Dooly","2020-02-28","0","0","0","0","0","0"
"Dooly","2020-02-29","0","0","0","0","0","0"
"Dooly","2020-03-01","0","0","0","0","0","0"
"Dooly","2020-03-02","0","0","0","0","0","0"
"Dooly","2020-03-03","0","0","0","0","0","0"
"Dooly","2020-03-04","0","0","0","0","0","0"
"Dooly","2020-03-05","0","0","0","0","0","0"
"Dooly","2020-03-06","0","0","0","0","0","0"
"Dooly","2020-03-07","0","0","0","0","0","0"
"Dooly","2020-03-08","0","0","0","0","0","0"
"Dooly","2020-03-09","0","0","0","0","0","0"
"Dooly","2020-03-10","0","0","0","0","0","0"
"Dooly","2020-03-11","0","0","0","0","0","0"
"Dooly","2020-03-12","0","0","0","0","0","0"
"Dooly","2020-03-13","0","0","0","0","0","0"
"Dooly","2020-03-14","0","0","0","0","0","0"
"Dooly","2020-03-15","0","0","0","0","0","0"
"Dooly","2020-03-16","0","0","0","0","0","0"
"Dooly","2020-03-17","0","0","0","0","0","0"
"Dooly","2020-03-18","0","0","0","0","0","0"
"Dooly","2020-03-19","4","4","0","0","0","0"
"Dooly","2020-03-20","2","6","1","1","7.1","3.6"
"Dooly","2020-03-21","0","6","0","1","7.1","3.6"
"Dooly","2020-03-22","0","6","0","1","7.1","3.6"
"Dooly","2020-03-23","3","9","2","3","16.7","8.3"
"Dooly","2020-03-24","0","9","0","3","16.7","8.3"
"Dooly","2020-03-25","3","12","1","4","21.4","10.7"
"Dooly","2020-03-26","7","19","1","5","23.5","11.7"
"Dooly","2020-03-27","11","30","3","8","20.2","13.7"
"Dooly","2020-03-28","2","32","0","8","20.2","13.7"
"Dooly","2020-03-29","4","36","1","9","23.8","15.5"
"Dooly","2020-03-30","7","43","4","13","22.4","19.6"
"Dooly","2020-03-31","4","47","1","14","26","21.3"
"Dooly","2020-04-01","9","56","3","17","26","23.7"
"Dooly","2020-04-02","21","77","5","22","27.4","25.4"
"Dooly","2020-04-03","6","83","2","24","28.2","24.2"
"Dooly","2020-04-04","4","87","2","26","35.4","27.8"
"Dooly","2020-04-05","0","87","0","26","31.8","27.8"
"Dooly","2020-04-06","12","99","5","31","29.6","26"
"Dooly","2020-04-07","14","113","3","34","29.1","27.5"
"Dooly","2020-04-08","6","119","3","37","31.5","28.7"
"Dooly","2020-04-09","5","124","1","38","30.9","29.1"
"Dooly","2020-04-10","14","138","6","44","32.3","30.3"
"Dooly","2020-04-11","1","139","1","45","39.4","37.4"
"Dooly","2020-04-12","5","144","1","46","42.3","37"
"Dooly","2020-04-13","21","165","13","59","45.2","37.4"
"Dooly","2020-04-14","6","171","0","59","42.1","35.6"
"Dooly","2020-04-15","12","183","2","61","37.3","34.4"
"Dooly","2020-04-16","23","206","3","64","36.4","33.6"
"Dooly","2020-04-17","7","213","0","64","30.2","31.3"
"Dooly","2020-04-18","1","214","1","65","30.2","34.8"
"Dooly","2020-04-19","1","215","0","65","27.4","34.8"
"Dooly","2020-04-20","8","223","2","67","22.1","33.6"
"Dooly","2020-04-21","23","246","8","75","27.1","34.6"
"Dooly","2020-04-22","53","299","27","102","32","34.7"
"Dooly","2020-04-23","5","304","0","102","30.1","33.2"
"Dooly","2020-04-24","5","309","2","104","35.8","33"
"Dooly","2020-04-25","1","310","0","104","21.5","25.9"
"Dooly","2020-04-26","6","316","1","105","23.9","25.6"
"Dooly","2020-04-27","8","324","2","107","23.9","23"
"Dooly","2020-04-28","13","337","6","113","25.5","26.3"
"Dooly","2020-04-29","8","345","1","114","20","26"
"Dooly","2020-04-30","7","352","1","115","22.1","26.1"
"Dooly","2020-05-01","3","355","0","115","16.4","26.1"
"Dooly","2020-05-02","3","358","0","115","16.4","19"
"Dooly","2020-05-03","3","361","0","115","14","19"
"Dooly","2020-05-04","21","382","9","124","16.5","20.2"
"Dooly","2020-05-05","12","394","6","130","17.1","21.3"
"Dooly","2020-05-06","5","399","0","130","15.3","17.7"
"Dooly","2020-05-07","11","410","4","134","18.5","20.3"
"Dooly","2020-05-08","10","420","0","134","18.5","17.4"
"Dooly","2020-05-09","6","426","3","137","25.6","21"
"Dooly","2020-05-10","3","429","1","138","30.4","22.2"
"Dooly","2020-05-11","55","484","7","145","26.1","21.3"
"Dooly","2020-05-12","6","490","1","146","21.3","19.2"
"Dooly","2020-05-13","15","505","4","150","25.1","20.2"
"Dooly","2020-05-14","13","518","1","151","21","19.7"
"Dooly","2020-05-15","12","530","3","154","24.6","21.5"
"Dooly","2020-05-16","3","533","1","155","22.2","23.9"
"Dooly","2020-05-17","5","538","0","155","17.4","23.9"
"Dooly","2020-05-18","15","553","2","157","17.5","21.8"
"Dooly","2020-05-19","80","633","7","164","16.4","18.8"
"Dooly","2020-05-20","11","644","0","164","12.6","18.8"
"Dooly","2020-05-21","9","653","0","164","11.5","16.3"
"Dooly","2020-05-22","6","659","0","164","7.9","16.3"
"Dooly","2020-05-23","3","662","1","165","7.9","15.1"
"Dooly","2020-05-24","3","665","0","165","7.9","12.7"
"Dooly","2020-05-25","4","669","1","166","9.6","13.6"
"Dooly","2020-05-26","14","683","4","170","12.4","14.4"
"Dooly","2020-05-27","40","723","8","178","15.3","13.9"
"Dooly","2020-05-28","32","755","1","179","15.7","13.6"
"Dooly","2020-05-29","34","789","2","181","16.6","12.2"
"Dooly","2020-05-30","2","791","0","181","11.8","9.9"
"Dooly","2020-05-31","4","795","0","181","11.8","9.9"
"Dooly","2020-06-01","19","814","2","183","9.7","9.7"
"Dooly","2020-06-02","21","835","3","186","7.7","10.1"
"Dooly","2020-06-03","22","857","4","190","7.4","11.4"
"Dooly","2020-06-04","27","884","0","190","7","11.4"
"Dooly","2020-06-05","17","901","3","193","8.7","12.6"
"Dooly","2020-06-06","3","904","0","193","8.7","10.2"
"Dooly","2020-06-07","2","906","2","195","22.9","17.4"
"Dooly","2020-06-08","12","918","1","196","22.6","16.2"
"Dooly","2020-06-09","8","926","0","196","20.6","14.1"
"Dooly","2020-06-10","1","927","1","197","32.3","19.9"
"Dooly","2020-06-11","6","933","0","197","32.3","19.6"
"Dooly","2020-06-12","10","943","1","198","31.2","19.9"
"Dooly","2020-06-13","2","945","0","198","31.2","19.9"
"Dooly","2020-06-14","1","946","0","198","16.9","19.9"
"Dooly","2020-06-15","9","955","0","198","15.7","19.2"
"Dooly","2020-06-16","15","970","0","198","15.7","18.2"
"Dooly","2020-06-17","9","979","1","199","3","17.6"
"Dooly","2020-06-18","13","992","1","200","4.1","18.2"
"Dooly","2020-06-19","11","1003","2","202","5.3","18.2"
"Dooly","2020-06-20","3","1006","0","202","5.3","18.2"
"Dooly","2020-06-21","1","1007","0","202","5.3","11.1"
"Dooly","2020-06-22","18","1025","1","203","6.1","10.9"
"Dooly","2020-06-23","14","1039","1","204","7.1","11.4"
"Dooly","2020-06-24","17","1056","2","206","7.2","5.1"
"Dooly","2020-06-25","29","1085","3","209","7.6","5.8"
"Dooly","2020-06-26","40","1125","12","221","9.3","7.3"
"Dooly","2020-06-27","7","1132","2","223","13.3","9.3"
"Dooly","2020-06-28","4","1136","0","223","13.3","9.3"
"Dooly","2020-06-29","15","1151","4","227","16.4","11.2"
"Dooly","2020-06-30","9","1160","0","227","15.3","11.2"
"Dooly","2020-07-01","10","1170","0","227","13.7","10.4"
"Dooly","2020-07-02","4","1174","2","229","19.3","13.4"
"Dooly","2020-07-03","11","1185","0","229","15","12.1"
"Dooly","2020-07-04","1","1186","0","229","11","12.1"
"Dooly","2020-07-05","4","1190","0","229","11","12.1"
"Dooly","2020-07-06","18","1208","3","232","9.5","12.9"
"Dooly","2020-07-07","17","1225","2","234","11.2","13.3"
"Dooly","2020-07-08","9","1234","0","234","11.2","12.4"
"Dooly","2020-07-09","4","1238","0","234","4.1","11.7"
"Dooly","2020-07-10","15","1253","1","235","5","10"
"Dooly","2020-07-11","4","1257","1","236","8.6","9.8"
"Dooly","2020-07-12","2","1259","1","237","15.7","13.3"
"Dooly","2020-07-13","31","1290","4","241","15.2","12.4"
"Dooly","2020-07-14","9","1299","0","241","13.5","12.4"
"Dooly","2020-07-15","20","1319","3","244","15.7","13.4"
"Dooly","2020-07-16","18","1337","2","246","17.2","10.7"
"Dooly","2020-07-17","13","1350","2","248","18.5","11.7"
"Dooly","2020-07-18","0","1350","0","248","14.9","11.7"
"Dooly","2020-07-19","3","1353","0","248","7.8","11.7"
"Dooly","2020-07-20","28","1381","1","249","6.4","10.8"
"Dooly","2020-07-21","16","1397","0","249","6.4","10"
"Dooly","2020-07-22","21","1418","1","250","5","10.3"
"Dooly","2020-07-23","13","1431","0","250","3.4","10.3"
"Dooly","2020-07-24","19","1450","1","251","1.9","10.2"
"Dooly","2020-07-25","5","1455","3","254","10.5","12.7"
"Dooly","2020-07-26","1","1456","1","255","24.8","16.3"
"Dooly","2020-07-27","15","1471","6","261","30","18.2"
"Dooly","2020-07-28","23","1494","2","263","31.2","18.8"
"Dooly","2020-07-29","15","1509","0","263","30.6","17.8"
"Dooly","2020-07-30","19","1528","3","266","32.8","18.1"
"Dooly","2020-07-31","23","1551","2","268","33.3","17.6"
"Dooly","2020-08-01","4","1555","1","269","28.3","19.4"
"Dooly","2020-08-02","0","1555","0","269","14","19.4"
"Dooly","2020-08-03","33","1588","0","269","8.3","19.2"
"Dooly","2020-08-04","8","1596","2","271","10.6","20.9"
"Dooly","2020-08-05","23","1619","5","276","13.7","22.2"
"Dooly","2020-08-06","7","1626","0","276","11.5","22.2"
"Dooly","2020-08-07","18","1644","0","276","10.2","21.8"
"Dooly","2020-08-08","4","1648","0","276","6.7","17.5"
"Dooly","2020-08-09","2","1650","0","276","6.7","10.4"
"Dooly","2020-08-10","27","1677","2","278","7.7","8"
"Dooly","2020-08-11","12","1689","2","280","6.5","8.6"
"Dooly","2020-08-12","12","1701","1","281","4.6","9.2"
"Dooly","2020-08-13","12","1713","2","283","7","9.3"
"Dooly","2020-08-14","10","1723","2","285","9.9","10.1"
"Dooly","2020-08-15","5","1728","1","286","12.7","9.7"
"Dooly","2020-08-16","3","1731","0","286","12.7","9.7"
"Dooly","2020-08-17","8","1739","1","287","13.5","10.6"
"Dooly","2020-08-18","9","1748","0","287","11.1","8.8"
"Dooly","2020-08-19","37","1785","7","294","12.6","8.6"
"Dooly","2020-08-20","8","1793","1","295","12","9.5"
"Dooly","2020-08-21","19","1812","3","298","11.4","10.6"
"Dooly","2020-08-22","2","1814","0","298","8.5","10.6"
"Dooly","2020-08-23","0","1814","0","298","8.5","10.6"
"Dooly","2020-08-24","41","1855","4","302","8.1","10.8"
"Dooly","2020-08-25","8","1863","0","302","8.1","9.6"
"Dooly","2020-08-26","20","1883","1","303","6.1","9.4"
"Dooly","2020-08-27","18","1901","0","303","4.4","8.2"
"Dooly","2020-08-28","26","1927","5","308","4.9","8.1"
"Dooly","2020-08-29","9","1936","1","309","6.4","7.5"
"Dooly","2020-08-30","1","1937","0","309","6.4","7.5"
"Dooly","2020-08-31","17","1954","2","311","6.7","7.4"
"Dooly","2020-09-01","13","1967","1","312","7.8","8"
"Dooly","2020-09-02","15","1982","2","314","9","7.6"
"Dooly","2020-09-03","24","2006","2","316","10.2","7.3"
"Dooly","2020-09-04","31","2037","1","317","7.9","6.4"
"Dooly","2020-09-05","3","2040","0","317","6.3","6.4"
"Dooly","2020-09-06","4","2044","1","318","9.9","8.2"
"Dooly","2020-09-07","0","2044","0","318","8.2","7.5"
"Dooly","2020-09-08","29","2073","5","323","9.6","8.7"
"Dooly","2020-09-09","19","2092","2","325","9.2","9.1"
"Dooly","2020-09-10","15","2107","2","327","9.9","10.1"
"Dooly","2020-09-11","18","2125","2","329","11","9.5"
"Dooly","2020-09-12","4","2129","0","329","11","8.7"
"Dooly","2020-09-13","0","2129","0","329","7.5","8.7"
"Dooly","2020-09-14","28","2157","7","336","11","9.6"
"Dooly","2020-09-15","28","2185","5","341","11.1","10.4"
"Dooly","2020-09-16","14","2199","2","343","11.7","10.4"
"Dooly","2020-09-17","20","2219","0","343","9.8","9.8"
"Dooly","2020-09-18","17","2236","1","344","9","10"
"Dooly","2020-09-19","0","2236","0","344","9","10"
"Dooly","2020-09-20","4","2240","1","345","12.6","10"
"Dooly","2020-09-21","24","2264","4","349","11.4","11.2"
"Dooly","2020-09-22","12","2276","2","351","11.2","11.2"
"Dooly","2020-09-23","13","2289","2","353","11.4","11.5"
"Dooly","2020-09-24","11","2300","1","354","12.7","11.2"
"Dooly","2020-09-25","44","2344","0","354","11.8","10.4"
"Dooly","2020-09-26","3","2347","0","354","11.8","10.4"
"Dooly","2020-09-27","1","2348","0","354","8.3","10.4"
"Dooly","2020-09-28","28","2376","5","359","8.4","9.9"
"Dooly","2020-09-29","21","2397","2","361","7.4","9.3"
"Dooly","2020-09-30","17","2414","3","364","7.7","9.6"
"Dooly","2020-10-01","12","2426","1","365","7.6","10.1"
"Dooly","2020-10-02","17","2443","1","366","8.5","10.1"
"Dooly","2020-10-03","2","2445","1","367","15.6","13.7"
"Dooly","2020-10-04","0","2445","0","367","15.6","11.9"
"Dooly","2020-10-05","23","2468","2","369","14.3","11.4"
"Dooly","2020-10-06","21","2489","0","369","12.9","10.2"
"Dooly","2020-10-07","23","2512","1","370","11","9.4"
"Dooly","2020-10-08","14","2526","0","370","9.8","8.7"
"Dooly","2020-10-09","19","2545","1","371","9.8","9.1"
"Dooly","2020-10-10","3","2548","0","371","2.6","9.1"
"Dooly","2020-10-11","2","2550","0","371","2.6","9.1"
"Dooly","2020-10-12","7","2557","0","371","1.4","7.8"
"Dooly","2020-10-13","20","2577","3","374","3.5","8.2"
"Dooly","2020-10-14","17","2594","1","375","3.7","7.4"
"Dooly","2020-10-15","15","2609","1","376","4.7","7.3"
"Dooly","2020-10-16","14","2623","1","377","5","7.4"
"Dooly","2020-10-17","0","2623","0","377","5","3.8"
"Dooly","2020-10-18","2","2625","0","377","5","3.8"
"Dooly","2020-10-19","12","2637","4","381","9.7","5.5"
"Dooly","2020-10-20","7","2644","1","382","9.6","6.6"
"Dooly","2020-10-21","12","2656","3","385","12.3","8"
"Dooly","2020-10-22","12","2668","0","385","11.4","8"
"Dooly","2020-10-23","10","2678","0","385","10.4","7.7"
"Dooly","2020-10-24","2","2680","0","385","10.4","7.7"
"Dooly","2020-10-25","0","2680","0","385","10.4","7.7"
"Dooly","2020-10-26","25","2705","0","385","5.6","7.7"
"Dooly","2020-10-27","12","2717","1","386","4.8","7.2"
"Dooly","2020-10-28","15","2732","3","389","4","8.2"
"Dooly","2020-10-29","20","2752","1","390","4.8","8.1"
"Dooly","2020-10-30","14","2766","1","391","5.8","8.1"
"Dooly","2020-10-31","3","2769","0","391","5.8","8.1"
"Dooly","2020-11-01","3","2772","2","393","15.3","12.8"
"Dooly","2020-11-02","15","2787","1","394","16.3","10.9"
"Dooly","2020-11-03","23","2810","2","396","16.3","10.5"
"Dooly","2020-11-04","9","2819","2","398","16.6","10.3"
"Dooly","2020-11-05","16","2835","1","399","16.8","10.8"
"Dooly","2020-11-06","19","2854","2","401","17.3","11.5"
"Dooly","2020-11-07","1","2855","0","401","17.3","11.5"
"Dooly","2020-11-08","2","2857","0","401","7.8","11.5"
"Dooly","2020-11-09","19","2876","2","403","8.3","12.3"
"Dooly","2020-11-10","26","2902","4","407","9.3","12.8"
"Dooly","2020-11-11","7","2909","0","407","6.1","11.4"
"Dooly","2020-11-12","20","2929","2","409","6.6","11.7"
"Dooly","2020-11-13","7","2936","0","409","5.1","11.2"
"Dooly","2020-11-14","7","2943","0","409","5.1","11.2"
"Dooly","2020-11-15","1","2944","0","409","5.1","6.4"
"Dooly","2020-11-16","18","2962","2","411","5.2","6.8"
"Dooly","2020-11-17","37","2999","7","418","5.7","7.5"
"Dooly","2020-11-18","28","3027","2","420","6.7","6.4"
"Dooly","2020-11-19","4","3031","0","420","5.3","6"
"Dooly","2020-11-20","4","3035","0","420","5.3","5.2"
"Dooly","2020-11-21","3","3038","1","421","10.1","7.6"
"Dooly","2020-11-22","2","3040","0","421","10.1","7.6"
"Dooly","2020-11-23","32","3072","4","425","10.3","7.7"
"Dooly","2020-11-24","16","3088","0","425","7.6","6.6"
"Dooly","2020-11-25","29","3117","1","426","7","6.9"
"Dooly","2020-11-26","0","3117","0","426","7","6.2"
"Dooly","2020-11-27","5","3122","1","427","9.9","7.6"
"Dooly","2020-11-28","4","3126","0","427","5.1","7.6"
"Dooly","2020-11-29","2","3128","0","427","5.1","7.6"
"Dooly","2020-11-30","7","3135","0","427","3.3","6.8"
"Dooly","2020-12-01","21","3156","3","430","5.4","6.5"
"Dooly","2020-12-02","25","3181","7","437","8.9","8"
"Dooly","2020-12-03","25","3206","9","446","14","10.5"
"Dooly","2020-12-04","7","3213","2","448","15.3","12.6"
"Dooly","2020-12-05","4","3217","2","450","22.4","13.8"
"Dooly","2020-12-06","6","3223","0","450","22.4","13.8"
"Dooly","2020-12-07","26","3249","7","457","26.3","14.8"
"Dooly","2020-12-08","34","3283","2","459","25.1","15.2"
"Dooly","2020-12-09","37","3320","4","463","22.6","15.7"
"Dooly","2020-12-10","42","3362","6","469","19.5","16.8"
"Dooly","2020-12-11","118","3480","1","470","15.5","15.4"
"Dooly","2020-12-12","1","3481","0","470","8.4","15.4"
"Dooly","2020-12-13","1","3482","0","470","8.4","15.4"
"Dooly","2020-12-14","41","3523","13","483","9.1","17.7"
"Dooly","2020-12-15","36","3559","4","487","9.8","17.4"
"Dooly","2020-12-16","4","3563","1","488","11.9","17.2"
"Dooly","2020-12-17","164","3727","7","495","10.4","15"
"Dooly","2020-12-18","10","3737","1","496","11.7","13.6"
"Dooly","2020-12-19","6","3743","2","498","16.5","12.4"
"Dooly","2020-12-20","3","3746","1","499","21.3","14.8"
"Dooly","2020-12-21","31","3777","4","503","18.6","13.8"
"Dooly","2020-12-22","41","3818","8","511","19.8","14.8"
"Dooly","2020-12-23","5","3823","1","512","19.1","15.5"
"Dooly","2020-12-24","3","3826","2","514","28","19.2"
"Dooly","2020-12-25","1","3827","0","514","26.5","19.1"
"Dooly","2020-12-26","2","3829","1","515","28.9","22.7"
"Dooly","2020-12-27","1","3830","1","516","38.4","29.8"
"Dooly","2020-12-28","40","3870","5","521","38.4","28.5"
"Dooly","2020-12-29","32","3902","6","527","38.3","29"
"Dooly","2020-12-30","67","3969","16","543","38.8","28.9"
"Dooly","2020-12-31","12","3981","0","543","29.3","28.6"
"Dooly","2021-01-01","3","3984","2","545","38.8","32.7"
"Dooly","2021-01-02","5","3989","3","548","40.3","34.6"
"Dooly","2021-01-03","5","3994","2","550","31.7","35.1"
"Dooly","2021-01-04","85","4079","17","567","32.8","35.6"
"Dooly","2021-01-05","50","4129","9","576","32.6","35.5"
"Dooly","2021-01-06","33","4162","5","581","31.4","35.1"
"Dooly","2021-01-07","20","4182","5","586","35","32.1"
"Dooly","2021-01-08","13","4195","3","589","28.7","33.8"
"Dooly","2021-01-09","9","4204","4","593","26.5","33.4"
"Dooly","2021-01-10","5","4209","1","594","23.7","27.7"
"Dooly","2021-01-11","46","4255","8","602","23.3","28"
"Dooly","2021-01-12","34","4289","7","609","23.7","28.2"
"Dooly","2021-01-13","38","4327","6","615","23.8","27.6"
"Dooly","2021-01-14","15","4342","2","617","22.1","28.5"
"Dooly","2021-01-15","16","4358","1","618","19.7","24.2"
"Dooly","2021-01-16","7","4365","0","618","13.3","19.9"
"Dooly","2021-01-17","5","4370","2","620","16.2","19.9"
"Dooly","2021-01-18","11","4381","1","621","15","19.2"
"Dooly","2021-01-19","36","4417","9","630","15.6","19.7"
"Dooly","2021-01-20","20","4437","3","633","15.5","19.6"
"Dooly","2021-01-21","14","4451","6","639","19.7","20.9"
"Dooly","2021-01-22","13","4464","3","642","22.1","20.9"
"Dooly","2021-01-23","4","4468","3","645","32.9","23.1"
"Dooly","2021-01-24","0","4468","0","645","27.1","21.7"
"Dooly","2021-01-25","3","4471","1","646","30.6","22.8"
"Dooly","2021-01-26","0","4471","0","646","27","21.3"
"Dooly","2021-01-27","0","4471","0","646","24.9","20.2"
"Dougherty","2020-02-01","0","0","0","0",".","."
"Dougherty","2020-02-02","0","0","0","0",".","."
"Dougherty","2020-02-03","0","0","0","0",".","."
"Dougherty","2020-02-04","0","0","0","0",".","."
"Dougherty","2020-02-05","0","0","0","0",".","."
"Dougherty","2020-02-06","0","0","0","0",".","."
"Dougherty","2020-02-07","0","0","0","0","0","."
"Dougherty","2020-02-08","0","0","0","0","0","."
"Dougherty","2020-02-09","0","0","0","0","0","."
"Dougherty","2020-02-10","0","0","0","0","0","."
"Dougherty","2020-02-11","0","0","0","0","0","."
"Dougherty","2020-02-12","0","0","0","0","0","."
"Dougherty","2020-02-13","0","0","0","0","0","."
"Dougherty","2020-02-14","0","0","0","0","0","0"
"Dougherty","2020-02-15","0","0","0","0","0","0"
"Dougherty","2020-02-16","0","0","0","0","0","0"
"Dougherty","2020-02-17","0","0","0","0","0","0"
"Dougherty","2020-02-18","0","0","0","0","0","0"
"Dougherty","2020-02-19","0","0","0","0","0","0"
"Dougherty","2020-02-20","0","0","0","0","0","0"
"Dougherty","2020-02-21","0","0","0","0","0","0"
"Dougherty","2020-02-22","0","0","0","0","0","0"
"Dougherty","2020-02-23","0","0","0","0","0","0"
"Dougherty","2020-02-24","0","0","0","0","0","0"
"Dougherty","2020-02-25","0","0","0","0","0","0"
"Dougherty","2020-02-26","0","0","0","0","0","0"
"Dougherty","2020-02-27","0","0","0","0","0","0"
"Dougherty","2020-02-28","0","0","0","0","0","0"
"Dougherty","2020-02-29","0","0","0","0","0","0"
"Dougherty","2020-03-01","0","0","0","0","0","0"
"Dougherty","2020-03-02","0","0","0","0","0","0"
"Dougherty","2020-03-03","0","0","0","0","0","0"
"Dougherty","2020-03-04","0","0","0","0","0","0"
"Dougherty","2020-03-05","0","0","0","0","0","0"
"Dougherty","2020-03-06","0","0","0","0","0","0"
"Dougherty","2020-03-07","0","0","0","0","0","0"
"Dougherty","2020-03-08","1","1","1","1","14.3","7.1"
"Dougherty","2020-03-09","1","2","0","1","14.3","7.1"
"Dougherty","2020-03-10","0","2","0","1","14.3","7.1"
"Dougherty","2020-03-11","28","30","11","12","19.9","9.9"
"Dougherty","2020-03-12","30","60","11","23","25.1","12.6"
"Dougherty","2020-03-13","20","80","14","37","35.1","17.6"
"Dougherty","2020-03-14","18","98","13","50","45.5","22.7"
"Dougherty","2020-03-15","26","124","11","61","37.2","25.7"
"Dougherty","2020-03-16","78","202","32","93","43.1","28.7"
"Dougherty","2020-03-17","98","300","51","144","50.5","32.4"
"Dougherty","2020-03-18","77","377","33","177","51","35.5"
"Dougherty","2020-03-19","73","450","45","222","54.6","39.9"
"Dougherty","2020-03-20","88","538","38","260","50.8","42.9"
"Dougherty","2020-03-21","67","605","45","305","50","47.7"
"Dougherty","2020-03-22","49","654","30","335","52.7","45"
"Dougherty","2020-03-23","262","916","93","428","51.9","47.5"
"Dougherty","2020-03-24","245","1161","80","508","49.2","49.8"
"Dougherty","2020-03-25","191","1352","71","579","48.4","49.7"
"Dougherty","2020-03-26","143","1495","70","649","46.5","50.6"
"Dougherty","2020-03-27","189","1684","60","709","44.9","47.8"
"Dougherty","2020-03-28","101","1785","40","749","41","45.5"
"Dougherty","2020-03-29","61","1846","36","785","40.7","46.7"
"Dougherty","2020-03-30","208","2054","101","886","42.5","47.2"
"Dougherty","2020-03-31","104","2158","47","933","44.3","46.7"
"Dougherty","2020-04-01","196","2354","51","984","42.7","45.5"
"Dougherty","2020-04-02","188","2542","54","1038","39.8","43.2"
"Dougherty","2020-04-03","141","2683","42","1080","39.6","42.2"
"Dougherty","2020-04-04","59","2742","16","1096","37.8","39.4"
"Dougherty","2020-04-05","59","2801","23","1119","34.9","37.8"
"Dougherty","2020-04-06","289","3090","82","1201","32","37.3"
"Dougherty","2020-04-07","158","3248","34","1235","28.6","36.5"
"Dougherty","2020-04-08","222","3470","49","1284","28.1","35.4"
"Dougherty","2020-04-09","197","3667","46","1330","27.3","33.6"
"Dougherty","2020-04-10","275","3942","71","1401","26.7","33.2"
"Dougherty","2020-04-11","95","4037","12","1413","24.7","31.2"
"Dougherty","2020-04-12","28","4065","6","1419","22.2","28.5"
"Dougherty","2020-04-13","177","4242","35","1454","20.9","26.5"
"Dougherty","2020-04-14","199","4441","39","1493","20.7","24.7"
"Dougherty","2020-04-15","240","4681","46","1539","20.3","24.2"
"Dougherty","2020-04-16","301","4982","36","1575","18.6","23"
"Dougherty","2020-04-17","328","5310","38","1613","16.6","21.7"
"Dougherty","2020-04-18","176","5486","24","1637","16.7","20.7"
"Dougherty","2020-04-19","56","5542","3","1640","14.4","18.3"
"Dougherty","2020-04-20","393","5935","39","1679","13","17"
"Dougherty","2020-04-21","305","6240","37","1716","12","16.3"
"Dougherty","2020-04-22","260","6500","10","1726","9.8","15"
"Dougherty","2020-04-23","94","6594","18","1744","10.8","14.7"
"Dougherty","2020-04-24","302","6896","25","1769","10.3","13.5"
"Dougherty","2020-04-25","138","7034","6","1775","9","12.9"
"Dougherty","2020-04-26","61","7095","7","1782","9.9","12.2"
"Dougherty","2020-04-27","279","7374","22","1804","9.6","11.3"
"Dougherty","2020-04-28","342","7716","24","1828","8.9","10.4"
"Dougherty","2020-04-29","450","8166","26","1854","9.1","9.5"
"Dougherty","2020-04-30","283","8449","28","1882","7.8","9.3"
"Dougherty","2020-05-01","388","8837","25","1907","7.5","8.9"
"Dougherty","2020-05-02","263","9100","7","1914","7.3","8.2"
"Dougherty","2020-05-03","145","9245","9","1923","6.6","8.2"
"Dougherty","2020-05-04","258","9503","17","1940","6.4","8"
"Dougherty","2020-05-05","360","9863","21","1961","6.2","7.5"
"Dougherty","2020-05-06","333","10196","21","1982","6.3","7.7"
"Dougherty","2020-05-07","216","10412","18","2000","6.1","6.9"
"Dougherty","2020-05-08","222","10634","12","2012","5.9","6.7"
"Dougherty","2020-05-09","123","10757","5","2017","6.1","6.7"
"Dougherty","2020-05-10","23","10780","18","2035","16.4","11.5"
"Dougherty","2020-05-11","195","10975","10","2045","16.2","11.3"
"Dougherty","2020-05-12","216","11191","8","2053","15.9","11"
"Dougherty","2020-05-13","301","11492","11","2064","15.5","10.9"
"Dougherty","2020-05-14","389","11881","8","2072","14.6","10.3"
"Dougherty","2020-05-15","482","12363","32","2104","14.8","10.3"
"Dougherty","2020-05-16","167","12530","10","2114","15.1","10.6"
"Dougherty","2020-05-17","71","12601","2","2116","4.3","10.3"
"Dougherty","2020-05-18","204","12805","25","2141","5.3","10.7"
"Dougherty","2020-05-19","330","13135","26","2167","5.9","10.9"
"Dougherty","2020-05-20","259","13394","9","2176","5.9","10.7"
"Dougherty","2020-05-21","382","13776","11","2187","6","10.3"
"Dougherty","2020-05-22","340","14116","13","2200","5.6","10.2"
"Dougherty","2020-05-23","155","14271","6","2206","5.3","10.2"
"Dougherty","2020-05-24","57","14328","3","2209","5.6","5"
"Dougherty","2020-05-25","62","14390","5","2214","5","5.2"
"Dougherty","2020-05-26","252","14642","10","2224","4.5","5.2"
"Dougherty","2020-05-27","237","14879","6","2230","4.3","5.1"
"Dougherty","2020-05-28","187","15066","2","2232","4.1","5"
"Dougherty","2020-05-29","297","15363","10","2242","4","4.8"
"Dougherty","2020-05-30","110","15473","7","2249","4.4","4.8"
"Dougherty","2020-05-31","63","15536","3","2252","4.3","5"
"Dougherty","2020-06-01","285","15821","11","2263","3.7","4.4"
"Dougherty","2020-06-02","267","16088","8","2271","3.6","4"
"Dougherty","2020-06-03","279","16367","5","2276","3.5","3.9"
"Dougherty","2020-06-04","144","16511","3","2279","3.6","3.8"
"Dougherty","2020-06-05","338","16849","8","2287","3.5","3.7"
"Dougherty","2020-06-06","166","17015","14","2301","3.8","4.1"
"Dougherty","2020-06-07","45","17060","1","2302","3.4","3.8"
"Dougherty","2020-06-08","217","17277","5","2307","3.2","3.4"
"Dougherty","2020-06-09","198","17475","2","2309","2.9","3.2"
"Dougherty","2020-06-10","132","17607","5","2314","3.2","3.3"
"Dougherty","2020-06-11","221","17828","7","2321","3.3","3.5"
"Dougherty","2020-06-12","190","18018","9","2330","3.7","3.6"
"Dougherty","2020-06-13","102","18120","7","2337","3.4","3.6"
"Dougherty","2020-06-14","36","18156","1","2338","3.5","3.5"
"Dougherty","2020-06-15","173","18329","10","2348","4","3.6"
"Dougherty","2020-06-16","169","18498","7","2355","4.5","3.7"
"Dougherty","2020-06-17","101","18599","2","2357","4.2","3.7"
"Dougherty","2020-06-18","304","18903","10","2367","4.2","3.8"
"Dougherty","2020-06-19","212","19115","7","2374","4","3.8"
"Dougherty","2020-06-20","43","19158","1","2375","3.4","3.4"
"Dougherty","2020-06-21","112","19270","4","2379","3.5","3.5"
"Dougherty","2020-06-22","276","19546","13","2392","3.3","3.7"
"Dougherty","2020-06-23","174","19720","11","2403","3.6","4.1"
"Dougherty","2020-06-24","304","20024","23","2426","4.4","4.3"
"Dougherty","2020-06-25","102","20126","11","2437","5.5","4.9"
"Dougherty","2020-06-26","257","20383","24","2461","6.4","5.2"
"Dougherty","2020-06-27","177","20560","11","2472","6.9","5.2"
"Dougherty","2020-06-28","63","20623","3","2475","7.1","5.3"
"Dougherty","2020-06-29","161","20784","9","2484","7.2","5.3"
"Dougherty","2020-06-30","329","21113","35","2519","7.8","5.7"
"Dougherty","2020-07-01","322","21435","33","2552","8.2","6.3"
"Dougherty","2020-07-02","311","21746","27","2579","7.9","6.7"
"Dougherty","2020-07-03","52","21798","8","2587","8.8","7.6"
"Dougherty","2020-07-04","138","21936","12","2599","9.1","8"
"Dougherty","2020-07-05","58","21994","5","2604","9.7","8.4"
"Dougherty","2020-07-06","321","22315","51","2655","11.2","9.2"
"Dougherty","2020-07-07","345","22660","47","2702","11.6","9.7"
"Dougherty","2020-07-08","344","23004","31","2733","11.4","9.8"
"Dougherty","2020-07-09","164","23168","16","2749","11.6","9.7"
"Dougherty","2020-07-10","392","23560","31","2780","10.5","9.6"
"Dougherty","2020-07-11","95","23655","11","2791","10.9","10"
"Dougherty","2020-07-12","63","23718","7","2798","11.3","10.5"
"Dougherty","2020-07-13","393","24111","38","2836","10.4","10.8"
"Dougherty","2020-07-14","181","24292","15","2851","9.6","10.6"
"Dougherty","2020-07-15","379","24671","19","2870","9","10.2"
"Dougherty","2020-07-16","404","25075","48","2918","9.3","10.5"
"Dougherty","2020-07-17","398","25473","36","2954","9.5","10"
"Dougherty","2020-07-18","60","25533","6","2960","9.3","10.1"
"Dougherty","2020-07-19","63","25596","14","2974","10.9","11.1"
"Dougherty","2020-07-20","434","26030","30","3004","10.5","10.4"
"Dougherty","2020-07-21","158","26188","16","3020","10.7","10.2"
"Dougherty","2020-07-22","441","26629","32","3052","11.1","10.1"
"Dougherty","2020-07-23","389","27018","24","3076","10.2","9.8"
"Dougherty","2020-07-24","341","27359","20","3096","9.8","9.7"
"Dougherty","2020-07-25","39","27398","9","3105","11.7","10.5"
"Dougherty","2020-07-26","43","27441","6","3111","10.5","10.7"
"Dougherty","2020-07-27","412","27853","30","3141","10.5","10.5"
"Dougherty","2020-07-28","161","28014","13","3154","10.2","10.5"
"Dougherty","2020-07-29","387","28401","27","3181","10.2","10.6"
"Dougherty","2020-07-30","169","28570","21","3202","11.1","10.7"
"Dougherty","2020-07-31","324","28894","16","3218","11","10.4"
"Dougherty","2020-08-01","69","28963","7","3225","9.1","10.4"
"Dougherty","2020-08-02","55","29018","7","3232","8.9","9.7"
"Dougherty","2020-08-03","396","29414","30","3262","9","9.8"
"Dougherty","2020-08-04","197","29611","22","3284","9.4","9.8"
"Dougherty","2020-08-05","420","30031","21","3305","9.1","9.7"
"Dougherty","2020-08-06","273","30304","42","3347","9.6","10.3"
"Dougherty","2020-08-07","431","30735","24","3371","9.7","10.3"
"Dougherty","2020-08-08","162","30897","13","3384","9.3","9.2"
"Dougherty","2020-08-09","37","30934","4","3388","9.1","9"
"Dougherty","2020-08-10","313","31247","29","3417","9.3","9.1"
"Dougherty","2020-08-11","178","31425","14","3431","8.8","9.1"
"Dougherty","2020-08-12","288","31713","17","3448","9","9.1"
"Dougherty","2020-08-13","142","31855","8","3456","7.6","8.6"
"Dougherty","2020-08-14","359","32214","56","3512","9","9.3"
"Dougherty","2020-08-15","69","32283","7","3519","9.3","9.3"
"Dougherty","2020-08-16","97","32380","11","3530","9.4","9.2"
"Dougherty","2020-08-17","255","32635","17","3547","9","9.2"
"Dougherty","2020-08-18","142","32777","18","3565","9.7","9.3"
"Dougherty","2020-08-19","361","33138","23","3588","9.8","9.4"
"Dougherty","2020-08-20","151","33289","9","3597","9.8","8.7"
"Dougherty","2020-08-21","342","33631","20","3617","8.4","8.7"
"Dougherty","2020-08-22","114","33745","6","3623","7.7","8.5"
"Dougherty","2020-08-23","73","33818","7","3630","7.5","8.4"
"Dougherty","2020-08-24","260","34078","21","3651","7.7","8.4"
"Dougherty","2020-08-25","104","34182","4","3655","6.4","8.1"
"Dougherty","2020-08-26","355","34537","15","3670","6.1","7.9"
"Dougherty","2020-08-27","170","34707","7","3677","5.9","7.8"
"Dougherty","2020-08-28","265","34972","19","3696","6","7.2"
"Dougherty","2020-08-29","67","35039","3","3699","5.9","6.8"
"Dougherty","2020-08-30","98","35137","6","3705","5.4","6.5"
"Dougherty","2020-08-31","177","35314","17","3722","5.7","6.7"
"Dougherty","2020-09-01","232","35546","12","3734","5.8","6.1"
"Dougherty","2020-09-02","250","35796","12","3746","5.9","6"
"Dougherty","2020-09-03","106","35902","3","3749","5.7","5.8"
"Dougherty","2020-09-04","297","36199","17","3766","5.5","5.8"
"Dougherty","2020-09-05","181","36380","7","3773","5.4","5.7"
"Dougherty","2020-09-06","42","36422","5","3778","6.3","5.9"
"Dougherty","2020-09-07","134","36556","5","3783","5.4","5.5"
"Dougherty","2020-09-08","293","36849","17","3800","5.5","5.7"
"Dougherty","2020-09-09","253","37102","6","3806","5.2","5.5"
"Dougherty","2020-09-10","220","37322","9","3815","5.4","5.5"
"Dougherty","2020-09-11","226","37548","14","3829","5.4","5.5"
"Dougherty","2020-09-12","109","37657","6","3835","5.7","5.6"
"Dougherty","2020-09-13","35","37692","5","3840","6","6.1"
"Dougherty","2020-09-14","221","37913","17","3857","6.6","6"
"Dougherty","2020-09-15","222","38135","5","3862","6.1","5.8"
"Dougherty","2020-09-16","334","38469","7","3869","6","5.6"
"Dougherty","2020-09-17","277","38746","15","3884","6.2","5.8"
"Dougherty","2020-09-18","161","38907","4","3888","5.7","5.5"
"Dougherty","2020-09-19","109","39016","5","3893","5.5","5.6"
"Dougherty","2020-09-20","34","39050","1","3894","3.9","5"
"Dougherty","2020-09-21","172","39222","9","3903","3.6","5.1"
"Dougherty","2020-09-22","237","39459","10","3913","3.9","5"
"Dougherty","2020-09-23","244","39703","4","3917","3.8","4.9"
"Dougherty","2020-09-24","170","39873","6","3923","3.5","4.9"
"Dougherty","2020-09-25","238","40111","7","3930","3.6","4.6"
"Dougherty","2020-09-26","40","40151","5","3935","4.7","5.1"
"Dougherty","2020-09-27","30","40181","2","3937","5.2","4.6"
"Dougherty","2020-09-28","164","40345","3","3940","4.8","4.2"
"Dougherty","2020-09-29","133","40478","5","3945","4.7","4.3"
"Dougherty","2020-09-30","242","40720","3","3948","4.6","4.2"
"Dougherty","2020-10-01","124","40844","6","3954","4.8","4.2"
"Dougherty","2020-10-02","187","41031","3","3957","4.6","4.1"
"Dougherty","2020-10-03","144","41175","11","3968","3.9","4.3"
"Dougherty","2020-10-04","47","41222","1","3969","3.3","4.3"
"Dougherty","2020-10-05","143","41365","10","3979","4","4.4"
"Dougherty","2020-10-06","357","41722","5","3984","3.7","4.2"
"Dougherty","2020-10-07","328","42050","11","3995","4","4.3"
"Dougherty","2020-10-08","186","42236","4","3999","3.6","4.2"
"Dougherty","2020-10-09","209","42445","8","4007","3.9","4.3"
"Dougherty","2020-10-10","63","42508","3","4010","3.5","3.7"
"Dougherty","2020-10-11","30","42538","2","4012","4.2","3.7"
"Dougherty","2020-10-12","139","42677","6","4018","3.8","3.9"
"Dougherty","2020-10-13","393","43070","10","4028","3.9","3.8"
"Dougherty","2020-10-14","278","43348","3","4031","3.6","3.8"
"Dougherty","2020-10-15","123","43471","4","4035","3.8","3.7"
"Dougherty","2020-10-16","190","43661","4","4039","3.5","3.7"
"Dougherty","2020-10-17","64","43725","3","4042","3.5","3.5"
"Dougherty","2020-10-18","33","43758","3","4045","3.9","4"
"Dougherty","2020-10-19","190","43948","4","4049","3.6","3.7"
"Dougherty","2020-10-20","222","44170","7","4056","3.6","3.8"
"Dougherty","2020-10-21","311","44481","6","4062","3.8","3.7"
"Dougherty","2020-10-22","106","44587","5","4067","4","3.9"
"Dougherty","2020-10-23","189","44776","1","4068","3.7","3.6"
"Dougherty","2020-10-24","129","44905","1","4069","3.2","3.4"
"Dougherty","2020-10-25","41","44946","2","4071","2.6","3.2"
"Dougherty","2020-10-26","203","45149","9","4080","2.9","3.2"
"Dougherty","2020-10-27","156","45305","4","4084","2.8","3.2"
"Dougherty","2020-10-28","237","45542","5","4089","2.9","3.3"
"Dougherty","2020-10-29","297","45839","6","4095","2.5","3.2"
"Dougherty","2020-10-30","178","46017","7","4102","3","3.4"
"Dougherty","2020-10-31","126","46143","4","4106","3.3","3.2"
"Dougherty","2020-11-01","87","46230","4","4110","3.3","2.9"
"Dougherty","2020-11-02","149","46379","4","4114","3","3"
"Dougherty","2020-11-03","197","46576","2","4116","2.8","2.8"
"Dougherty","2020-11-04","215","46791","3","4119","2.7","2.8"
"Dougherty","2020-11-05","224","47015","6","4125","2.8","2.6"
"Dougherty","2020-11-06","159","47174","2","4127","2.4","2.7"
"Dougherty","2020-11-07","117","47291","2","4129","2.2","2.7"
"Dougherty","2020-11-08","43","47334","2","4131","2.2","2.7"
"Dougherty","2020-11-09","147","47481","6","4137","2.4","2.7"
"Dougherty","2020-11-10","236","47717","5","4142","2.6","2.7"
"Dougherty","2020-11-11","222","47939","6","4148","2.7","2.7"
"Dougherty","2020-11-12","187","48126","4","4152","2.7","2.7"
"Dougherty","2020-11-13","194","48320","7","4159","3","2.7"
"Dougherty","2020-11-14","191","48511","5","4164","3.1","2.7"
"Dougherty","2020-11-15","65","48576","5","4169","3.6","2.9"
"Dougherty","2020-11-16","150","48726","6","4175","3.6","3"
"Dougherty","2020-11-17","225","48951","6","4181","3.6","3.1"
"Dougherty","2020-11-18","311","49262","6","4187","3.5","3.1"
"Dougherty","2020-11-19","200","49462","11","4198","4","3.3"
"Dougherty","2020-11-20","265","49727","7","4205","3.9","3.4"
"Dougherty","2020-11-21","71","49798","3","4208","4.1","3.6"
"Dougherty","2020-11-22","39","49837","3","4211","4.1","3.8"
"Dougherty","2020-11-23","246","50083","13","4224","4.3","3.9"
"Dougherty","2020-11-24","155","50238","13","4237","5.1","4.4"
"Dougherty","2020-11-25","243","50481","11","4248","5.5","4.5"
"Dougherty","2020-11-26","323","50804","2","4250","4.8","4.4"
"Dougherty","2020-11-27","86","50890","9","4259","5.9","4.9"
"Dougherty","2020-11-28","107","50997","11","4270","6.8","5.4"
"Dougherty","2020-11-29","52","51049","6","4276","7.3","5.7"
"Dougherty","2020-11-30","187","51236","9","4285","7.2","5.8"
"Dougherty","2020-12-01","373","51609","29","4314","7.1","6.1"
"Dougherty","2020-12-02","501","52110","29","4343","7.3","6.4"
"Dougherty","2020-12-03","207","52317","16","4359","8.3","6.6"
"Dougherty","2020-12-04","286","52603","12","4371","7.4","6.7"
"Dougherty","2020-12-05","67","52670","12","4383","8.5","7.6"
"Dougherty","2020-12-06","56","52726","3","4386","7.7","7.5"
"Dougherty","2020-12-07","174","52900","13","4399","8","7.6"
"Dougherty","2020-12-08","293","53193","20","4419","7.9","7.5"
"Dougherty","2020-12-09","464","53657","22","4441","7.7","7.5"
"Dougherty","2020-12-10","266","53923","16","4457","7.5","7.9"
"Dougherty","2020-12-11","436","54359","30","4487","7.9","7.7"
"Dougherty","2020-12-12","267","54626","15","4502","6.1","7.3"
"Dougherty","2020-12-13","88","54714","12","4514","7.3","7.5"
"Dougherty","2020-12-14","399","55113","39","4553","7.6","7.8"
"Dougherty","2020-12-15","331","55444","43","4596","8.5","8.2"
"Dougherty","2020-12-16","474","55918","31","4627","8.8","8.3"
"Dougherty","2020-12-17","166","56084","19","4646","9.6","8.5"
"Dougherty","2020-12-18","543","56627","52","4698","9.9","8.9"
"Dougherty","2020-12-19","132","56759","15","4713","10.8","8.4"
"Dougherty","2020-12-20","44","56803","10","4723","12.1","9.7"
"Dougherty","2020-12-21","325","57128","41","4764","12.5","10.1"
"Dougherty","2020-12-22","335","57463","34","4798","12.1","10.3"
"Dougherty","2020-12-23","433","57896","26","4824","12","10.4"
"Dougherty","2020-12-24","171","58067","10","4834","11.2","10.4"
"Dougherty","2020-12-25","44","58111","7","4841","12.1","11"
"Dougherty","2020-12-26","160","58271","31","4872","13.2","12"
"Dougherty","2020-12-27","51","58322","13","4885","13.6","12.8"
"Dougherty","2020-12-28","295","58617","31","4916","13.3","12.9"
"Dougherty","2020-12-29","465","59082","49","4965","13.4","12.7"
"Dougherty","2020-12-30","394","59476","54","5019","14.5","13.2"
"Dougherty","2020-12-31","251","59727","36","5055","15.7","13.4"
"Dougherty","2021-01-01","59","59786","7","5062","15.1","13.6"
"Dougherty","2021-01-02","266","60052","44","5106","14.7","14"
"Dougherty","2021-01-03","60","60112","16","5122","14.9","14.3"
"Dougherty","2021-01-04","382","60494","65","5187","15.8","14.6"
"Dougherty","2021-01-05","606","61100","97","5284","16.6","15"
"Dougherty","2021-01-06","376","61476","55","5339","16.7","15.6"
"Dougherty","2021-01-07","249","61725","37","5376","16.8","16.2"
"Dougherty","2021-01-08","407","62132","69","5445","17.5","16.3"
"Dougherty","2021-01-09","87","62219","16","5461","17.8","16.3"
"Dougherty","2021-01-10","71","62290","12","5473","16.4","15.6"
"Dougherty","2021-01-11","364","62654","53","5526","16","15.9"
"Dougherty","2021-01-12","313","62967","40","5566","15.6","16.1"
"Dougherty","2021-01-13","374","63341","57","5623","15.7","16.2"
"Dougherty","2021-01-14","179","63520","25","5648","15.5","16.2"
"Dougherty","2021-01-15","330","63850","50","5698","15.3","16.4"
"Dougherty","2021-01-16","80","63930","14","5712","15.2","16.5"
"Dougherty","2021-01-17","62","63992","8","5720","14.6","15.5"
"Dougherty","2021-01-18","296","64288","49","5769","14.9","15.5"
"Dougherty","2021-01-19","337","64625","40","5809","14.7","15.2"
"Dougherty","2021-01-20","357","64982","36","5845","14","14.8"
"Dougherty","2021-01-21","153","65135","14","5859","13.3","14.4"
"Dougherty","2021-01-22","348","65483","41","5900","12.8","14.1"
"Dougherty","2021-01-23","135","65618","30","5930","13.5","14.3"
"Dougherty","2021-01-24","52","65670","12","5942","15","14.8"
"Dougherty","2021-01-25","149","65819","27","5969","15.2","15"
"Dougherty","2021-01-26","60","65879","9","5978","15.6","15.2"
"Dougherty","2021-01-27","0","65879","0","5978","14.2","14.1"
"Douglas","2020-02-01","0","0","0","0",".","."
"Douglas","2020-02-02","0","0","0","0",".","."
"Douglas","2020-02-03","0","0","0","0",".","."
"Douglas","2020-02-04","0","0","0","0",".","."
"Douglas","2020-02-05","0","0","0","0",".","."
"Douglas","2020-02-06","0","0","0","0",".","."
"Douglas","2020-02-07","0","0","0","0","0","."
"Douglas","2020-02-08","0","0","0","0","0","."
"Douglas","2020-02-09","0","0","0","0","0","."
"Douglas","2020-02-10","0","0","0","0","0","."
"Douglas","2020-02-11","0","0","0","0","0","."
"Douglas","2020-02-12","0","0","0","0","0","."
"Douglas","2020-02-13","0","0","0","0","0","."
"Douglas","2020-02-14","0","0","0","0","0","0"
"Douglas","2020-02-15","0","0","0","0","0","0"
"Douglas","2020-02-16","0","0","0","0","0","0"
"Douglas","2020-02-17","0","0","0","0","0","0"
"Douglas","2020-02-18","0","0","0","0","0","0"
"Douglas","2020-02-19","0","0","0","0","0","0"
"Douglas","2020-02-20","0","0","0","0","0","0"
"Douglas","2020-02-21","0","0","0","0","0","0"
"Douglas","2020-02-22","0","0","0","0","0","0"
"Douglas","2020-02-23","0","0","0","0","0","0"
"Douglas","2020-02-24","0","0","0","0","0","0"
"Douglas","2020-02-25","0","0","0","0","0","0"
"Douglas","2020-02-26","0","0","0","0","0","0"
"Douglas","2020-02-27","0","0","0","0","0","0"
"Douglas","2020-02-28","0","0","0","0","0","0"
"Douglas","2020-02-29","0","0","0","0","0","0"
"Douglas","2020-03-01","0","0","0","0","0","0"
"Douglas","2020-03-02","0","0","0","0","0","0"
"Douglas","2020-03-03","0","0","0","0","0","0"
"Douglas","2020-03-04","0","0","0","0","0","0"
"Douglas","2020-03-05","0","0","0","0","0","0"
"Douglas","2020-03-06","1","1","0","0","0","0"
"Douglas","2020-03-07","0","1","0","0","0","0"
"Douglas","2020-03-08","0","1","0","0","0","0"
"Douglas","2020-03-09","0","1","0","0","0","0"
"Douglas","2020-03-10","2","3","0","0","0","0"
"Douglas","2020-03-11","2","5","0","0","0","0"
"Douglas","2020-03-12","6","11","0","0","0","0"
"Douglas","2020-03-13","4","15","1","1","3.6","1.8"
"Douglas","2020-03-14","7","22","1","2","5.6","2.8"
"Douglas","2020-03-15","4","26","0","2","5.6","2.8"
"Douglas","2020-03-16","14","40","3","5","8.7","4.3"
"Douglas","2020-03-17","24","64","2","7","9.9","4.9"
"Douglas","2020-03-18","17","81","8","15","16.6","8.3"
"Douglas","2020-03-19","21","102","5","20","20","10"
"Douglas","2020-03-20","15","117","4","24","20.2","11.9"
"Douglas","2020-03-21","6","123","3","27","25.3","15.5"
"Douglas","2020-03-22","2","125","0","27","25.3","15.5"
"Douglas","2020-03-23","21","146","6","33","26.3","17.5"
"Douglas","2020-03-24","32","178","13","46","31","20.4"
"Douglas","2020-03-25","44","222","12","58","28.1","22.4"
"Douglas","2020-03-26","32","254","6","64","27.4","23.7"
"Douglas","2020-03-27","45","299","17","81","29","24.6"
"Douglas","2020-03-28","26","325","12","93","28.5","26.9"
"Douglas","2020-03-29","9","334","8","101","41.1","33.2"
"Douglas","2020-03-30","40","374","4","105","38.5","32.4"
"Douglas","2020-03-31","53","427","16","121","37","34"
"Douglas","2020-04-01","43","470","10","131","36.4","32.3"
"Douglas","2020-04-02","30","500","7","138","37.1","32.2"
"Douglas","2020-04-03","21","521","5","143","35.1","32"
"Douglas","2020-04-04","15","536","2","145","30.4","29.4"
"Douglas","2020-04-05","2","538","1","146","24.8","33"
"Douglas","2020-04-06","45","583","6","152","25.3","31.9"
"Douglas","2020-04-07","61","644","7","159","22.6","29.8"
"Douglas","2020-04-08","44","688","4","163","20.6","28.5"
"Douglas","2020-04-09","42","730","3","166","18.3","27.7"
"Douglas","2020-04-10","46","776","7","173","17.1","26.1"
"Douglas","2020-04-11","36","812","8","181","18.4","24.4"
"Douglas","2020-04-12","9","821","0","181","11.2","18"
"Douglas","2020-04-13","59","880","6","187","10.8","18"
"Douglas","2020-04-14","65","945","8","195","10.9","16.8"
"Douglas","2020-04-15","42","987","2","197","10.3","15.4"
"Douglas","2020-04-16","84","1071","4","201","9.9","14.1"
"Douglas","2020-04-17","78","1149","5","206","8.7","12.9"
"Douglas","2020-04-18","44","1193","8","214","8.1","13.2"
"Douglas","2020-04-19","24","1217","1","215","8.7","9.9"
"Douglas","2020-04-20","95","1312","12","227","9","9.9"
"Douglas","2020-04-21","95","1407","3","230","7.7","9.3"
"Douglas","2020-04-22","103","1510","6","236","7.9","9.1"
"Douglas","2020-04-23","35","1545","3","239","8.4","9.2"
"Douglas","2020-04-24","110","1655","9","248","8.7","8.7"
"Douglas","2020-04-25","53","1708","1","249","6.3","7.2"
"Douglas","2020-04-26","32","1740","4","253","7.5","8.1"
"Douglas","2020-04-27","90","1830","3","256","6.2","7.6"
"Douglas","2020-04-28","125","1955","9","265","6.8","7.3"
"Douglas","2020-04-29","88","2043","8","273","7.3","7.6"
"Douglas","2020-04-30","102","2145","4","277","6.6","7.5"
"Douglas","2020-05-01","73","2218","4","281","6.2","7.4"
"Douglas","2020-05-02","88","2306","2","283","6.3","6.3"
"Douglas","2020-05-03","22","2328","0","283","4.5","6"
"Douglas","2020-05-04","359","2687","49","332","5.9","6.1"
"Douglas","2020-05-05","97","2784","1","333","5.1","5.9"
"Douglas","2020-05-06","83","2867","6","339","4.8","6"
"Douglas","2020-05-07","78","2945","3","342","4.8","5.7"
"Douglas","2020-05-08","119","3064","6","348","4.7","5.5"
"Douglas","2020-05-09","139","3203","3","351","4.7","5.5"
"Douglas","2020-05-10","9","3212","1","352","6.3","5.4"
"Douglas","2020-05-11","145","3357","6","358","4.9","5.4"
"Douglas","2020-05-12","211","3568","6","364","5.2","5.1"
"Douglas","2020-05-13","212","3780","5","369","4.5","4.6"
"Douglas","2020-05-14","200","3980","3","372","4.2","4.5"
"Douglas","2020-05-15","161","4141","7","379","4.1","4.4"
"Douglas","2020-05-16","89","4230","6","385","4.7","4.7"
"Douglas","2020-05-17","45","4275","5","390","4.7","5.5"
"Douglas","2020-05-18","115","4390","6","396","4.9","4.9"
"Douglas","2020-05-19","189","4579","3","399","4.7","4.9"
"Douglas","2020-05-20","142","4721","4","403","4.8","4.6"
"Douglas","2020-05-21","162","4883","10","413","5.4","4.8"
"Douglas","2020-05-22","125","5008","5","418","5.4","4.7"
"Douglas","2020-05-23","114","5122","8","426","5.4","5.1"
"Douglas","2020-05-24","8","5130","0","426","3.8","4.3"
"Douglas","2020-05-25","8","5138","0","426","3.1","4"
"Douglas","2020-05-26","172","5310","11","437","3.8","4.2"
"Douglas","2020-05-27","143","5453","7","444","4.1","4.4"
"Douglas","2020-05-28","75","5528","7","451","4.5","5"
"Douglas","2020-05-29","210","5738","13","464","4.8","5.1"
"Douglas","2020-05-30","102","5840","3","467","4.3","4.8"
"Douglas","2020-05-31","38","5878","1","468","4.6","4.2"
"Douglas","2020-06-01","118","5996","8","476","5.6","4.3"
"Douglas","2020-06-02","114","6110","8","484","5.7","4.7"
"Douglas","2020-06-03","180","6290","17","501","6.3","5.2"
"Douglas","2020-06-04","140","6430","10","511","6","5.3"
"Douglas","2020-06-05","117","6547","7","518","6","5.4"
"Douglas","2020-06-06","143","6690","2","520","5.8","5"
"Douglas","2020-06-07","60","6750","4","524","6.3","5.5"
"Douglas","2020-06-08","99","6849","7","531","6.4","6"
"Douglas","2020-06-09","159","7008","16","547","6.8","6.3"
"Douglas","2020-06-10","195","7203","12","559","6.4","6.3"
"Douglas","2020-06-11","152","7355","12","571","6.5","6.2"
"Douglas","2020-06-12","218","7573","7","578","6.1","6"
"Douglas","2020-06-13","135","7708","11","589","7","6.4"
"Douglas","2020-06-14","41","7749","11","600","9.9","8.1"
"Douglas","2020-06-15","284","8033","11","611","9.5","7.9"
"Douglas","2020-06-16","153","8186","16","627","9.5","8.2"
"Douglas","2020-06-17","170","8356","21","648","10.4","8.4"
"Douglas","2020-06-18","202","8558","23","671","10.9","8.7"
"Douglas","2020-06-19","178","8736","15","686","11.6","8.9"
"Douglas","2020-06-20","126","8862","7","693","11.3","9.1"
"Douglas","2020-06-21","42","8904","5","698","9.1","9.5"
"Douglas","2020-06-22","229","9133","31","729","10.5","10"
"Douglas","2020-06-23","201","9334","21","750","10.5","10"
"Douglas","2020-06-24","192","9526","29","779","10.9","10.7"
"Douglas","2020-06-25","211","9737","29","808","11.2","11.1"
"Douglas","2020-06-26","271","10008","44","852","12.4","12"
"Douglas","2020-06-27","428","10436","47","899","13.1","12.2"
"Douglas","2020-06-28","66","10502","11","910","13.8","11.5"
"Douglas","2020-06-29","348","10850","40","950","13.5","12"
"Douglas","2020-06-30","322","11172","44","994","14","12.3"
"Douglas","2020-07-01","322","11494","37","1031","13.5","12.2"
"Douglas","2020-07-02","334","11828","48","1079","13.6","12.4"
"Douglas","2020-07-03","98","11926","16","1095","13.6","13"
"Douglas","2020-07-04","38","11964","5","1100","13.9","13.5"
"Douglas","2020-07-05","59","12023","9","1109","13.7","13.7"
"Douglas","2020-07-06","312","12335","37","1146","13.7","13.6"
"Douglas","2020-07-07","299","12634","42","1188","13.8","13.9"
"Douglas","2020-07-08","289","12923","33","1221","13.8","13.6"
"Douglas","2020-07-09","319","13242","35","1256","13.3","13.4"
"Douglas","2020-07-10","329","13571","54","1310","13.3","13.4"
"Douglas","2020-07-11","177","13748","24","1334","13.4","13.6"
"Douglas","2020-07-12","63","13811","12","1346","13.9","13.8"
"Douglas","2020-07-13","329","14140","46","1392","14.2","14"
"Douglas","2020-07-14","310","14450","50","1442","14.5","14.1"
"Douglas","2020-07-15","266","14716","30","1472","14.5","14.1"
"Douglas","2020-07-16","304","15020","27","1499","14.2","13.7"
"Douglas","2020-07-17","264","15284","26","1525","13.2","13.3"
"Douglas","2020-07-18","143","15427","11","1536","12.4","12.9"
"Douglas","2020-07-19","74","15501","10","1546","11.6","12.8"
"Douglas","2020-07-20","309","15810","29","1575","11","12.6"
"Douglas","2020-07-21","265","16075","30","1605","10.3","12.4"
"Douglas","2020-07-22","253","16328","23","1628","10","12.2"
"Douglas","2020-07-23","302","16630","29","1657","10.1","12.1"
"Douglas","2020-07-24","452","17082","38","1695","9.9","11.6"
"Douglas","2020-07-25","414","17496","24","1719","9.6","11"
"Douglas","2020-07-26","46","17542","4","1723","8.9","10.3"
"Douglas","2020-07-27","472","18014","34","1757","8.6","9.8"
"Douglas","2020-07-28","454","18468","46","1803","8.4","9.3"
"Douglas","2020-07-29","439","18907","36","1839","8.3","9.1"
"Douglas","2020-07-30","452","19359","31","1870","7.9","9"
"Douglas","2020-07-31","589","19948","37","1907","7.6","8.7"
"Douglas","2020-08-01","446","20394","21","1928","7.4","8.5"
"Douglas","2020-08-02","41","20435","4","1932","7.6","8.2"
"Douglas","2020-08-03","287","20722","18","1950","7.5","8"
"Douglas","2020-08-04","527","21249","52","2002","7.4","7.9"
"Douglas","2020-08-05","450","21699","34","2036","7.3","7.8"
"Douglas","2020-08-06","526","22225","43","2079","7.5","7.7"
"Douglas","2020-08-07","488","22713","26","2105","7.4","7.5"
"Douglas","2020-08-08","693","23406","46","2151","7.7","7.5"
"Douglas","2020-08-09","56","23462","7","2158","8","7.8"
"Douglas","2020-08-10","241","23703","16","2174","8.1","7.8"
"Douglas","2020-08-11","601","24304","43","2217","7.7","7.6"
"Douglas","2020-08-12","309","24613","21","2238","7.6","7.5"
"Douglas","2020-08-13","502","25115","34","2272","7.4","7.5"
"Douglas","2020-08-14","378","25493","26","2298","7.6","7.5"
"Douglas","2020-08-15","108","25601","9","2307","7.9","7.8"
"Douglas","2020-08-16","273","25874","11","2318","6.7","7.4"
"Douglas","2020-08-17","131","26005","13","2331","7.1","7.6"
"Douglas","2020-08-18","306","26311","22","2353","7.1","7.4"
"Douglas","2020-08-19","298","26609","19","2372","7.1","7.3"
"Douglas","2020-08-20","253","26862","13","2385","6.8","7.1"
"Douglas","2020-08-21","317","27179","28","2413","7.1","7.4"
"Douglas","2020-08-22","281","27460","14","2427","6.6","7.3"
"Douglas","2020-08-23","52","27512","4","2431","7.2","6.9"
"Douglas","2020-08-24","186","27698","12","2443","6.7","6.9"
"Douglas","2020-08-25","223","27921","16","2459","6.7","6.9"
"Douglas","2020-08-26","280","28201","14","2473","6.5","6.8"
"Douglas","2020-08-27","303","28504","19","2492","6.6","6.7"
"Douglas","2020-08-28","273","28777","10","2502","5.9","6.5"
"Douglas","2020-08-29","222","28999","10","2512","5.8","6.2"
"Douglas","2020-08-30","41","29040","3","2515","5.8","6.5"
"Douglas","2020-08-31","196","29236","7","2522","5.4","6"
"Douglas","2020-09-01","336","29572","21","2543","5.2","5.9"
"Douglas","2020-09-02","245","29817","12","2555","5.2","5.8"
"Douglas","2020-09-03","279","30096","18","2573","5.2","5.9"
"Douglas","2020-09-04","235","30331","24","2597","6.2","6"
"Douglas","2020-09-05","138","30469","12","2609","6.8","6.3"
"Douglas","2020-09-06","40","30509","5","2614","7.5","6.6"
"Douglas","2020-09-07","64","30573","9","2623","9","7.2"
"Douglas","2020-09-08","337","30910","21","2644","9","7.1"
"Douglas","2020-09-09","182","31092","14","2658","9.4","7.3"
"Douglas","2020-09-10","307","31399","26","2684","9.7","7.5"
"Douglas","2020-09-11","202","31601","12","2696","9.1","7.6"
"Douglas","2020-09-12","201","31802","10","2706","8.6","7.7"
"Douglas","2020-09-13","54","31856","3","2709","7.6","7.5"
"Douglas","2020-09-14","219","32075","19","2728","6.8","7.9"
"Douglas","2020-09-15","308","32383","16","2744","6.6","7.8"
"Douglas","2020-09-16","152","32535","6","2750","6.1","7.8"
"Douglas","2020-09-17","133","32668","9","2759","5.9","7.8"
"Douglas","2020-09-18","148","32816","19","2778","6.9","8"
"Douglas","2020-09-19","463","33279","17","2795","6.7","7.6"
"Douglas","2020-09-20","59","33338","4","2799","6.8","7.2"
"Douglas","2020-09-21","207","33545","19","2818","6.9","6.9"
"Douglas","2020-09-22","321","33866","17","2835","6.9","6.8"
"Douglas","2020-09-23","194","34060","21","2856","7.9","7"
"Douglas","2020-09-24","144","34204","4","2860","7.3","6.6"
"Douglas","2020-09-25","191","34395","14","2874","6.6","6.7"
"Douglas","2020-09-26","158","34553","10","2884","6.9","6.8"
"Douglas","2020-09-27","34","34587","4","2888","7.6","7.2"
"Douglas","2020-09-28","180","34767","22","2910","8.1","7.5"
"Douglas","2020-09-29","351","35118","19","2929","8.1","7.5"
"Douglas","2020-09-30","168","35286","13","2942","7.7","7.8"
"Douglas","2020-10-01","297","35583","21","2963","8.3","7.8"
"Douglas","2020-10-02","221","35804","18","2981","8.4","7.5"
"Douglas","2020-10-03","165","35969","10","2991","8.3","7.6"
"Douglas","2020-10-04","95","36064","7","2998","7.7","7.7"
"Douglas","2020-10-05","219","36283","22","3020","7.4","7.7"
"Douglas","2020-10-06","314","36597","16","3036","7.4","7.7"
"Douglas","2020-10-07","261","36858","11","3047","6.9","7.3"
"Douglas","2020-10-08","356","37214","22","3069","6.7","7.5"
"Douglas","2020-10-09","237","37451","22","3091","6.9","7.6"
"Douglas","2020-10-10","165","37616","15","3106","7.3","7.8"
"Douglas","2020-10-11","53","37669","2","3108","6.8","7.3"
"Douglas","2020-10-12","145","37814","9","3117","6.3","6.8"
"Douglas","2020-10-13","318","38132","14","3131","6.2","6.8"
"Douglas","2020-10-14","198","38330","15","3146","6.6","6.8"
"Douglas","2020-10-15","286","38616","23","3169","6.9","6.8"
"Douglas","2020-10-16","181","38797","13","3182","6.6","6.8"
"Douglas","2020-10-17","204","39001","25","3207","7.1","7.2"
"Douglas","2020-10-18","46","39047","5","3212","8.1","7.4"
"Douglas","2020-10-19","216","39263","22","3234","8.6","7.5"
"Douglas","2020-10-20","329","39592","13","3247","8.6","7.4"
"Douglas","2020-10-21","229","39821","20","3267","8.7","7.7"
"Douglas","2020-10-22","359","40180","26","3293","8.6","7.8"
"Douglas","2020-10-23","251","40431","16","3309","8.5","7.6"
"Douglas","2020-10-24","124","40555","11","3320","8","7.5"
"Douglas","2020-10-25","74","40629","9","3329","8.2","8.1"
"Douglas","2020-10-26","248","40877","25","3354","8.2","8.4"
"Douglas","2020-10-27","353","41230","28","3382","8.8","8.7"
"Douglas","2020-10-28","240","41470","26","3408","9.1","8.9"
"Douglas","2020-10-29","127","41597","10","3418","9.2","8.9"
"Douglas","2020-10-30","237","41834","11","3429","8.9","8.7"
"Douglas","2020-10-31","239","42073","31","3460","9.5","8.8"
"Douglas","2020-11-01","65","42138","14","3474","10.8","9.5"
"Douglas","2020-11-02","321","42459","31","3505","10.8","9.5"
"Douglas","2020-11-03","221","42680","21","3526","11","9.9"
"Douglas","2020-11-04","248","42928","25","3551","10.9","10"
"Douglas","2020-11-05","395","43323","21","3572","10.5","9.8"
"Douglas","2020-11-06","234","43557","14","3586","10.7","9.8"
"Douglas","2020-11-07","216","43773","22","3608","10.3","9.9"
"Douglas","2020-11-08","81","43854","5","3613","8.1","9.5"
"Douglas","2020-11-09","278","44132","29","3642","8.2","9.5"
"Douglas","2020-11-10","408","44540","36","3678","8.1","9.6"
"Douglas","2020-11-11","155","44695","17","3695","8.3","9.6"
"Douglas","2020-11-12","512","45207","29","3724","8.3","9.4"
"Douglas","2020-11-13","329","45536","35","3759","9","9.9"
"Douglas","2020-11-14","188","45724","21","3780","9.1","9.7"
"Douglas","2020-11-15","75","45799","5","3785","9.2","8.7"
"Douglas","2020-11-16","445","46244","48","3833","9.2","8.7"
"Douglas","2020-11-17","533","46777","45","3878","9.2","8.7"
"Douglas","2020-11-18","526","47303","41","3919","8.7","8.5"
"Douglas","2020-11-19","766","48069","40","3959","8.7","8.5"
"Douglas","2020-11-20","353","48422","41","4000","8.8","8.9"
"Douglas","2020-11-21","256","48678","19","4019","8.3","8.7"
"Douglas","2020-11-22","86","48764","11","4030","9.2","9.2"
"Douglas","2020-11-23","767","49531","55","4085","8.6","8.9"
"Douglas","2020-11-24","584","50115","37","4122","8.3","8.8"
"Douglas","2020-11-25","204","50319","17","4139","8.4","8.6"
"Douglas","2020-11-26","39","50358","5","4144","9.5","9.1"
"Douglas","2020-11-27","134","50492","17","4161","9.7","9.2"
"Douglas","2020-11-28","110","50602","21","4182","11.3","9.8"
"Douglas","2020-11-29","99","50701","21","4203","12.5","10.8"
"Douglas","2020-11-30","556","51257","84","4287","13.7","11.1"
"Douglas","2020-12-01","574","51831","81","4368","14.8","11.6"
"Douglas","2020-12-02","403","52234","65","4433","15.9","12.1"
"Douglas","2020-12-03","588","52822","73","4506","15.8","12.7"
"Douglas","2020-12-04","402","53224","57","4563","16","12.8"
"Douglas","2020-12-05","218","53442","28","4591","15.1","13.2"
"Douglas","2020-12-06","74","53516","9","4600","13.8","13.2"
"Douglas","2020-12-07","629","54145","82","4682","13.6","13.6"
"Douglas","2020-12-08","603","54748","70","4752","13.2","14"
"Douglas","2020-12-09","332","55080","37","4789","12.5","14.2"
"Douglas","2020-12-10","651","55731","75","4864","12.4","14.1"
"Douglas","2020-12-11","509","56240","61","4925","12","14"
"Douglas","2020-12-12","264","56504","28","4953","11.7","13.4"
"Douglas","2020-12-13","84","56588","11","4964","11.9","12.9"
"Douglas","2020-12-14","731","57319","107","5071","12.1","12.8"
"Douglas","2020-12-15","800","58119","102","5173","12.2","12.7"
"Douglas","2020-12-16","411","58530","54","5227","12.5","12.5"
"Douglas","2020-12-17","1129","59659","138","5365","12.6","12.5"
"Douglas","2020-12-18","1033","60692","136","5501","12.8","12.4"
"Douglas","2020-12-19","548","61240","66","5567","13","12.4"
"Douglas","2020-12-20","91","61331","16","5583","13.6","12.8"
"Douglas","2020-12-21","522","61853","81","5664","13.8","12.9"
"Douglas","2020-12-22","1338","63191","136","5800","13.4","12.8"
"Douglas","2020-12-23","1299","64490","173","5973","13.4","13"
"Douglas","2020-12-24","156","64646","37","6010","15.1","13.9"
"Douglas","2020-12-25","25","64671","2","6012","14.3","13.6"
"Douglas","2020-12-26","258","64929","64","6076","16.2","14.6"
"Douglas","2020-12-27","103","65032","20","6096","16.4","15"
"Douglas","2020-12-28","691","65723","126","6222","16.8","15.3"
"Douglas","2020-12-29","1409","67132","217","6439","17.6","15.5"
"Douglas","2020-12-30","881","68013","170","6609","18.4","15.9"
"Douglas","2020-12-31","655","68668","133","6742","17.9","16.5"
"Douglas","2021-01-01","44","68712","9","6751","19.7","17"
"Douglas","2021-01-02","306","69018","72","6823","19.5","17.8"
"Douglas","2021-01-03","94","69112","21","6844","19.9","18.2"
"Douglas","2021-01-04","765","69877","170","7014","20.5","18.7"
"Douglas","2021-01-05","2878","72755","505","7519","20.8","19.2"
"Douglas","2021-01-06","1020","73775","167","7686","20.4","19.4"
"Douglas","2021-01-07","1298","75073","227","7913","20","19"
"Douglas","2021-01-08","634","75707","105","8018","19.4","19.6"
"Douglas","2021-01-09","272","75979","44","8062","18.4","19"
"Douglas","2021-01-10","103","76082","21","8083","18.1","19"
"Douglas","2021-01-11","749","76831","134","8217","17.5","19"
"Douglas","2021-01-12","1571","78402","205","8422","16.8","18.8"
"Douglas","2021-01-13","1015","79417","131","8553","16.4","18.4"
"Douglas","2021-01-14","1280","80697","174","8727","15.8","17.9"
"Douglas","2021-01-15","1101","81798","139","8866","15.2","17.3"
"Douglas","2021-01-16","878","82676","135","9001","15.1","16.8"
"Douglas","2021-01-17","125","82801","29","9030","15.5","16.8"
"Douglas","2021-01-18","466","83267","83","9113","15.5","16.5"
"Douglas","2021-01-19","1313","84580","194","9307","15.8","16.3"
"Douglas","2021-01-20","769","85349","97","9404","15.7","16"
"Douglas","2021-01-21","981","86330","127","9531","15.6","15.7"
"Douglas","2021-01-22","512","86842","82","9613","16.1","15.7"
"Douglas","2021-01-23","323","87165","49","9662","16.1","15.6"
"Douglas","2021-01-24","58","87223","2","9664","13.3","14.4"
"Douglas","2021-01-25","245","87468","36","9700","12.8","14.2"
"Douglas","2021-01-26","24","87492","4","9704","13.1","14.4"
"Douglas","2021-01-27","0","87492","0","9704","11.3","13.5"
"Early","2020-02-01","0","0","0","0",".","."
"Early","2020-02-02","0","0","0","0",".","."
"Early","2020-02-03","0","0","0","0",".","."
"Early","2020-02-04","0","0","0","0",".","."
"Early","2020-02-05","0","0","0","0",".","."
"Early","2020-02-06","0","0","0","0",".","."
"Early","2020-02-07","0","0","0","0","0","."
"Early","2020-02-08","0","0","0","0","0","."
"Early","2020-02-09","0","0","0","0","0","."
"Early","2020-02-10","0","0","0","0","0","."
"Early","2020-02-11","0","0","0","0","0","."
"Early","2020-02-12","0","0","0","0","0","."
"Early","2020-02-13","0","0","0","0","0","."
"Early","2020-02-14","0","0","0","0","0","0"
"Early","2020-02-15","0","0","0","0","0","0"
"Early","2020-02-16","0","0","0","0","0","0"
"Early","2020-02-17","0","0","0","0","0","0"
"Early","2020-02-18","0","0","0","0","0","0"
"Early","2020-02-19","0","0","0","0","0","0"
"Early","2020-02-20","0","0","0","0","0","0"
"Early","2020-02-21","0","0","0","0","0","0"
"Early","2020-02-22","0","0","0","0","0","0"
"Early","2020-02-23","0","0","0","0","0","0"
"Early","2020-02-24","0","0","0","0","0","0"
"Early","2020-02-25","0","0","0","0","0","0"
"Early","2020-02-26","0","0","0","0","0","0"
"Early","2020-02-27","0","0","0","0","0","0"
"Early","2020-02-28","0","0","0","0","0","0"
"Early","2020-02-29","0","0","0","0","0","0"
"Early","2020-03-01","0","0","0","0","0","0"
"Early","2020-03-02","0","0","0","0","0","0"
"Early","2020-03-03","0","0","0","0","0","0"
"Early","2020-03-04","0","0","0","0","0","0"
"Early","2020-03-05","0","0","0","0","0","0"
"Early","2020-03-06","0","0","0","0","0","0"
"Early","2020-03-07","0","0","0","0","0","0"
"Early","2020-03-08","0","0","0","0","0","0"
"Early","2020-03-09","0","0","0","0","0","0"
"Early","2020-03-10","0","0","0","0","0","0"
"Early","2020-03-11","0","0","0","0","0","0"
"Early","2020-03-12","0","0","0","0","0","0"
"Early","2020-03-13","0","0","0","0","0","0"
"Early","2020-03-14","0","0","0","0","0","0"
"Early","2020-03-15","1","1","0","0","0","0"
"Early","2020-03-16","5","6","2","2","5.7","2.9"
"Early","2020-03-17","1","7","1","3","20","10"
"Early","2020-03-18","6","13","4","7","29.5","14.8"
"Early","2020-03-19","6","19","2","9","34.3","17.1"
"Early","2020-03-20","10","29","2","11","37.1","18.6"
"Early","2020-03-21","0","29","0","11","37.1","18.6"
"Early","2020-03-22","0","29","0","11","37.1","18.6"
"Early","2020-03-23","27","56","10","21","36.7","21.2"
"Early","2020-03-24","23","79","8","29","27.4","23.7"
"Early","2020-03-25","19","98","3","32","20.1","24.8"
"Early","2020-03-26","13","111","5","37","20.9","27.6"
"Early","2020-03-27","16","127","4","41","21.6","29.4"
"Early","2020-03-28","2","129","2","43","35.9","36.5"
"Early","2020-03-29","6","135","3","46","43","40.1"
"Early","2020-03-30","20","155","8","54","43.4","40.1"
"Early","2020-03-31","20","175","10","64","45.6","36.5"
"Early","2020-04-01","23","198","7","71","47.7","33.9"
"Early","2020-04-02","15","213","8","79","49.8","35.3"
"Early","2020-04-03","21","234","9","88","52.4","37"
"Early","2020-04-04","12","246","4","92","42.9","39.4"
"Early","2020-04-05","2","248","2","94","50","46.5"
"Early","2020-04-06","9","257","4","98","50.6","47"
"Early","2020-04-07","23","280","10","108","49.7","47.7"
"Early","2020-04-08","14","294","5","113","50.5","49.1"
"Early","2020-04-09","38","332","12","125","47.3","48.6"
"Early","2020-04-10","24","356","10","135","47.2","49.8"
"Early","2020-04-11","13","369","6","141","49","45.9"
"Early","2020-04-12","0","369","0","141","34.7","42.4"
"Early","2020-04-13","27","396","19","160","38.4","44.5"
"Early","2020-04-14","28","424","8","168","36.3","43"
"Early","2020-04-15","19","443","6","174","35.7","43.1"
"Early","2020-04-16","30","473","7","181","34.5","40.9"
"Early","2020-04-17","16","489","4","185","32.1","39.7"
"Early","2020-04-18","8","497","2","187","29.1","39.1"
"Early","2020-04-19","2","499","1","188","36.3","35.5"
"Early","2020-04-20","8","507","0","188","26.2","32.3"
"Early","2020-04-21","17","524","4","192","25.5","30.9"
"Early","2020-04-22","38","562","5","197","22.9","29.3"
"Early","2020-04-23","16","578","4","201","23.1","28.8"
"Early","2020-04-24","13","591","1","202","20.6","26.4"
"Early","2020-04-25","8","599","1","203","18.8","24"
"Early","2020-04-26","5","604","2","205","17.4","26.8"
"Early","2020-04-27","14","618","4","209","21.5","23.9"
"Early","2020-04-28","14","632","0","209","18.1","21.8"
"Early","2020-04-29","8","640","0","209","16.3","19.6"
"Early","2020-04-30","26","666","2","211","13.8","18.4"
"Early","2020-05-01","14","680","4","215","16.8","18.7"
"Early","2020-05-02","5","685","1","216","17.8","18.3"
"Early","2020-05-03","0","685","0","216","12.1","14.8"
"Early","2020-05-04","3","688","0","216","8","14.8"
"Early","2020-05-05","10","698","1","217","9.5","13.8"
"Early","2020-05-06","9","707","3","220","14.2","15.2"
"Early","2020-05-07","7","714","0","220","13.1","13.5"
"Early","2020-05-08","3","717","0","220","9","12.9"
"Early","2020-05-09","4","721","1","221","9.8","13.8"
"Early","2020-05-10","1","722","1","222","24","18.1"
"Early","2020-05-11","6","728","2","224","28.8","18.4"
"Early","2020-05-12","15","743","2","226","29.3","19.4"
"Early","2020-05-13","8","751","0","226","24.5","19.4"
"Early","2020-05-14","13","764","2","228","26.7","19.9"
"Early","2020-05-15","12","776","2","230","29.1","19.1"
"Early","2020-05-16","6","782","0","230","25.5","17.6"
"Early","2020-05-17","0","782","0","230","11.2","17.6"
"Early","2020-05-18","9","791","2","232","9.7","19.2"
"Early","2020-05-19","15","806","2","234","9.7","19.5"
"Early","2020-05-20","6","812","3","237","16.8","20.7"
"Early","2020-05-21","14","826","0","237","14.6","20.7"
"Early","2020-05-22","25","851","2","239","13.4","21.2"
"Early","2020-05-23","1","852","0","239","13.4","19.4"
"Early","2020-05-24","1","853","0","239","13.4","12.3"
"Early","2020-05-25","9","862","0","239","10.2","9.9"
"Early","2020-05-26","18","880","3","242","10.7","10.2"
"Early","2020-05-27","30","910","0","242","3.5","10.2"
"Early","2020-05-28","16","926","0","242","3.5","9.1"
"Early","2020-05-29","17","943","2","244","4.1","8.7"
"Early","2020-05-30","2","945","0","244","4.1","8.7"
"Early","2020-05-31","0","945","0","244","4.1","8.7"
"Early","2020-06-01","11","956","2","246","6.7","8.4"
"Early","2020-06-02","8","964","0","246","4.3","7.5"
"Early","2020-06-03","13","977","1","247","5.4","4.5"
"Early","2020-06-04","11","988","2","249","8","5.7"
"Early","2020-06-05","8","996","0","249","6.3","5.2"
"Early","2020-06-06","4","1000","0","249","6.3","5.2"
"Early","2020-06-07","1","1001","0","249","6.3","5.2"
"Early","2020-06-08","18","1019","1","250","4.5","5.6"
"Early","2020-06-09","12","1031","0","250","4.5","4.4"
"Early","2020-06-10","7","1038","1","251","5.4","5.4"
"Early","2020-06-11","65","1103","0","251","2.8","5.4"
"Early","2020-06-12","11","1114","1","252","4.1","5.2"
"Early","2020-06-13","0","1114","0","252","4.1","5.2"
"Early","2020-06-14","1","1115","0","252","4.1","5.2"
"Early","2020-06-15","11","1126","2","254","5.9","5.2"
"Early","2020-06-16","16","1142","0","254","5.9","5.2"
"Early","2020-06-17","12","1154","2","256","6.3","5.9"
"Early","2020-06-18","30","1184","5","261","8.7","5.7"
"Early","2020-06-19","28","1212","2","263","8.4","6.3"
"Early","2020-06-20","9","1221","1","264","10","7.1"
"Early","2020-06-21","1","1222","0","264","10","7.1"
"Early","2020-06-22","14","1236","1","265","8.4","7.2"
"Early","2020-06-23","9","1245","1","266","10","8"
"Early","2020-06-24","28","1273","4","270","9.6","8"
"Early","2020-06-25","5","1278","0","270","7.3","8"
"Early","2020-06-26","16","1294","3","273","8.9","8.6"
"Early","2020-06-27","1","1295","0","273","7.3","8.6"
"Early","2020-06-28","2","1297","0","273","7.3","8.6"
"Early","2020-06-29","9","1306","2","275","9.5","8.9"
"Early","2020-06-30","13","1319","3","278","11.2","10.6"
"Early","2020-07-01","20","1339","7","285","14.1","11.9"
"Early","2020-07-02","13","1352","4","289","18.5","12.9"
"Early","2020-07-03","17","1369","4","293","19.2","14.1"
"Early","2020-07-04","19","1388","5","298","23","15.2"
"Early","2020-07-05","2","1390","0","298","23","15.2"
"Early","2020-07-06","24","1414","4","302","22.2","15.8"
"Early","2020-07-07","7","1421","3","305","25","18.1"
"Early","2020-07-08","9","1430","1","306","21.6","17.9"
"Early","2020-07-09","35","1465","5","311","19.3","18.9"
"Early","2020-07-10","16","1481","2","313","17.7","18.5"
"Early","2020-07-11","66","1547","10","323","16.1","19.5"
"Early","2020-07-12","14","1561","0","323","16.1","19.5"
"Early","2020-07-13","25","1586","0","323","13.7","17.9"
"Early","2020-07-14","25","1611","5","328","10.4","17.7"
"Early","2020-07-15","21","1632","1","329","9.5","15.6"
"Early","2020-07-16","11","1643","4","333","12.7","16"
"Early","2020-07-17","13","1656","8","341","19.7","18.7"
"Early","2020-07-18","7","1663","2","343","21.6","18.8"
"Early","2020-07-19","0","1663","0","343","21.6","18.8"
"Early","2020-07-20","10","1673","5","348","28.7","21.2"
"Early","2020-07-21","23","1696","9","357","31.5","21"
"Early","2020-07-22","9","1705","1","358","32.4","21"
"Early","2020-07-23","11","1716","1","359","28.5","20.6"
"Early","2020-07-24","20","1736","1","360","20.4","20.1"
"Early","2020-07-25","14","1750","4","364","20.4","21"
"Early","2020-07-26","2","1752","0","364","20.4","21"
"Early","2020-07-27","16","1768","0","364","13.3","21"
"Early","2020-07-28","17","1785","4","368","11","21.3"
"Early","2020-07-29","16","1801","5","373","13.9","23.2"
"Early","2020-07-30","23","1824","5","378","15.7","22.1"
"Early","2020-07-31","16","1840","6","384","20.4","20.4"
"Early","2020-08-01","16","1856","1","385","17.2","18.8"
"Early","2020-08-02","2","1858","0","385","17.2","18.8"
"Early","2020-08-03","14","1872","0","385","17.2","15.2"
"Early","2020-08-04","35","1907","4","389","15.5","13.2"
"Early","2020-08-05","25","1932","0","389","11","12.5"
"Early","2020-08-06","15","1947","3","392","10.7","13.2"
"Early","2020-08-07","17","1964","2","394","7.1","13.7"
"Early","2020-08-08","9","1973","3","397","10.9","14.1"
"Early","2020-08-09","1","1974","0","397","10.9","14.1"
"Early","2020-08-10","16","1990","4","401","14.5","15.8"
"Early","2020-08-11","18","2008","4","405","16","15.7"
"Early","2020-08-12","16","2024","6","411","21.4","16.2"
"Early","2020-08-13","6","2030","0","411","18.5","14.6"
"Early","2020-08-14","6","2036","2","413","21.6","14.3"
"Early","2020-08-15","15","2051","5","418","21.6","16.3"
"Early","2020-08-16","2","2053","1","419","28.8","19.9"
"Early","2020-08-17","10","2063","2","421","28.1","21.3"
"Early","2020-08-18","17","2080","4","425","28.2","22.1"
"Early","2020-08-19","21","2101","4","429","25.6","23.5"
"Early","2020-08-20","22","2123","4","433","28.2","23.4"
"Early","2020-08-21","17","2140","1","434","24.3","23"
"Early","2020-08-22","5","2145","0","434","19.5","20.6"
"Early","2020-08-23","1","2146","0","434","12.4","20.6"
"Early","2020-08-24","10","2156","1","435","10.9","19.5"
"Early","2020-08-25","16","2172","2","437","9.4","18.8"
"Early","2020-08-26","14","2186","3","440","9.7","17.7"
"Early","2020-08-27","10","2196","1","441","8.5","18.4"
"Early","2020-08-28","17","2213","5","446","11.9","18.1"
"Early","2020-08-29","10","2223","2","448","14.8","17.1"
"Early","2020-08-30","0","2223","0","448","14.8","13.6"
"Early","2020-08-31","11","2234","3","451","17.2","14.1"
"Early","2020-09-01","17","2251","7","458","21.3","15.4"
"Early","2020-09-02","13","2264","5","463","23.8","16.7"
"Early","2020-09-03","16","2280","1","464","23.2","15.9"
"Early","2020-09-04","15","2295","3","467","21.9","16.9"
"Early","2020-09-05","8","2303","1","468","20.8","17.8"
"Early","2020-09-06","3","2306","1","469","25.6","20.2"
"Early","2020-09-07","2","2308","0","469","21.7","19.5"
"Early","2020-09-08","16","2324","2","471","17.6","19.5"
"Early","2020-09-09","32","2356","4","475","13.9","18.8"
"Early","2020-09-10","24","2380","5","480","16","19.6"
"Early","2020-09-11","43","2423","2","482","13.8","17.8"
"Early","2020-09-12","2","2425","0","482","12","16.4"
"Early","2020-09-13","0","2425","0","482","7.2","16.4"
"Early","2020-09-14","46","2471","3","485","8.1","14.9"
"Early","2020-09-15","19","2490","4","489","9.4","13.5"
"Early","2020-09-16","42","2532","3","492","8.6","11.2"
"Early","2020-09-17","42","2574","4","496","7","11.5"
"Early","2020-09-18","38","2612","2","498","7.1","10.4"
"Early","2020-09-19","10","2622","2","500","9.9","11"
"Early","2020-09-20","1","2623","0","500","9.9","8.6"
"Early","2020-09-21","51","2674","4","504","10.1","9.1"
"Early","2020-09-22","45","2719","2","506","7.7","8.6"
"Early","2020-09-23","50","2769","8","514","9","8.8"
"Early","2020-09-24","29","2798","3","517","9.1","8.1"
"Early","2020-09-25","45","2843","4","521","9.6","8.4"
"Early","2020-09-26","3","2846","1","522","11.6","10.7"
"Early","2020-09-27","0","2846","0","522","11.6","10.7"
"Early","2020-09-28","47","2893","0","522","10.4","10.3"
"Early","2020-09-29","31","2924","6","528","12.6","10.2"
"Early","2020-09-30","42","2966","2","530","11","10"
"Early","2020-10-01","33","2999","3","533","10.8","10"
"Early","2020-10-02","23","3022","1","534","10.1","9.9"
"Early","2020-10-03","7","3029","1","535","7.4","9.5"
"Early","2020-10-04","2","3031","0","535","7.4","9.5"
"Early","2020-10-05","40","3071","0","535","7.4","8.9"
"Early","2020-10-06","35","3106","2","537","5.5","9"
"Early","2020-10-07","29","3135","3","540","6.3","8.6"
"Early","2020-10-08","23","3158","2","542","6.2","8.5"
"Early","2020-10-09","16","3174","2","544","7.4","8.7"
"Early","2020-10-10","5","3179","0","544","5.3","6.4"
"Early","2020-10-11","1","3180","0","544","5.3","6.4"
"Early","2020-10-12","32","3212","0","544","5.3","6.4"
"Early","2020-10-13","17","3229","2","546","6.2","5.8"
"Early","2020-10-14","35","3264","2","548","5.5","5.9"
"Early","2020-10-15","6","3270","0","548","4.3","5.2"
"Early","2020-10-16","23","3293","4","552","5","6.2"
"Early","2020-10-17","5","3298","0","552","5","5.2"
"Early","2020-10-18","2","3300","2","554","19.3","12.3"
"Early","2020-10-19","41","3341","5","559","21","13.2"
"Early","2020-10-20","27","3368","2","561","20.4","13.3"
"Early","2020-10-21","34","3402","2","563","20.4","13"
"Early","2020-10-22","22","3424","3","566","22.4","13.3"
"Early","2020-10-23","24","3448","1","567","20.5","12.7"
"Early","2020-10-24","1","3449","0","567","20.5","12.7"
"Early","2020-10-25","4","3453","2","569","13.3","16.3"
"Early","2020-10-26","41","3494","2","571","12.3","16.6"
"Early","2020-10-27","19","3513","2","573","12.7","16.6"
"Early","2020-10-28","39","3552","2","575","12.6","16.5"
"Early","2020-10-29","32","3584","1","576","11.1","16.7"
"Early","2020-10-30","22","3606","3","579","12.5","16.5"
"Early","2020-10-31","2","3608","1","580","19.6","20"
"Early","2020-11-01","0","3608","0","580","12.5","12.9"
"Early","2020-11-02","45","3653","1","581","12.1","12.2"
"Early","2020-11-03","14","3667","2","583","12.6","12.7"
"Early","2020-11-04","29","3696","0","583","11.9","12.3"
"Early","2020-11-05","13","3709","4","587","15.8","13.5"
"Early","2020-11-06","18","3727","1","588","14.7","13.6"
"Early","2020-11-07","4","3731","0","588","7.5","13.6"
"Early","2020-11-08","0","3731","0","588","7.5","10"
"Early","2020-11-09","38","3769","3","591","8.4","10.2"
"Early","2020-11-10","20","3789","3","594","8.5","10.5"
"Early","2020-11-11","38","3827","6","600","10.7","11.3"
"Early","2020-11-12","21","3848","4","604","9","12.4"
"Early","2020-11-13","25","3873","2","606","9.4","12"
"Early","2020-11-14","7","3880","1","607","11.4","9.5"
"Early","2020-11-15","4","3884","1","608","15","11.3"
"Early","2020-11-16","42","3926","2","610","14.6","11.5"
"Early","2020-11-17","14","3940","0","610","12.4","10.4"
"Early","2020-11-18","32","3972","4","614","11.9","11.3"
"Early","2020-11-19","19","3991","4","618","12.2","10.6"
"Early","2020-11-20","15","4006","3","621","13.9","11.7"
"Early","2020-11-21","8","4014","5","626","20.8","16.1"
"Early","2020-11-22","1","4015","0","626","17.3","16.1"
"Early","2020-11-23","17","4032","0","626","16.6","15.6"
"Early","2020-11-24","6","4038","2","628","21.3","16.9"
"Early","2020-11-25","42","4080","1","629","19.9","15.9"
"Early","2020-11-26","2","4082","0","629","16.9","14.6"
"Early","2020-11-27","16","4098","1","630","14.9","14.4"
"Early","2020-11-28","8","4106","2","632","9.6","15.2"
"Early","2020-11-29","4","4110","2","634","16.7","17"
"Early","2020-11-30","41","4151","0","634","16.7","16.6"
"Early","2020-12-01","25","4176","1","635","12.5","16.9"
"Early","2020-12-02","43","4219","3","638","13.2","16.5"
"Early","2020-12-03","20","4239","8","646","18.9","17.9"
"Early","2020-12-04","22","4261","3","649","19.9","17.4"
"Early","2020-12-05","6","4267","2","651","21.1","15.4"
"Early","2020-12-06","1","4268","1","652","28.3","22.5"
"Early","2020-12-07","49","4317","2","654","28.9","22.8"
"Early","2020-12-08","25","4342","6","660","31.7","22.1"
"Early","2020-12-09","76","4418","1","661","30.9","22"
"Early","2020-12-10","34","4452","5","666","27.3","23.1"
"Early","2020-12-11","35","4487","3","669","26.6","23.3"
"Early","2020-12-12","21","4508","3","672","23.9","22.5"
"Early","2020-12-13","4","4512","2","674","16.7","22.5"
"Early","2020-12-14","36","4548","2","676","16.9","22.9"
"Early","2020-12-15","57","4605","9","685","15.7","23.7"
"Early","2020-12-16","35","4640","6","691","18","24.5"
"Early","2020-12-17","17","4657","4","695","19.3","23.3"
"Early","2020-12-18","15","4672","5","700","22.8","24.7"
"Early","2020-12-19","15","4687","4","704","24.6","24.2"
"Early","2020-12-20","0","4687","0","704","17.4","17.1"
"Early","2020-12-21","10","4697","1","705","18.1","17.5"
"Early","2020-12-22","35","4732","8","713","19.1","17.4"
"Early","2020-12-23","34","4766","11","724","21.2","19.6"
"Early","2020-12-24","13","4779","2","726","20.1","19.7"
"Early","2020-12-25","0","4779","0","726","15.3","19.1"
"Early","2020-12-26","2","4781","1","727","18.7","21.6"
"Early","2020-12-27","1","4782","1","728","32.9","25.2"
"Early","2020-12-28","7","4789","0","728","31.5","24.8"
"Early","2020-12-29","30","4819","10","738","33","26"
"Early","2020-12-30","48","4867","17","755","33.4","27.3"
"Early","2020-12-31","43","4910","11","766","34.9","27.5"
"Early","2021-01-01","1","4911","1","767","49.2","32.3"
"Early","2021-01-02","0","4911","0","767","42","30.4"
"Early","2021-01-03","7","4918","4","771","35.9","34.4"
"Early","2021-01-04","49","4967","7","778","38","34.7"
"Early","2021-01-05","64","5031","19","797","37.4","35.2"
"Early","2021-01-06","73","5104","15","812","35.3","34.4"
"Early","2021-01-07","41","5145","8","820","34.5","34.7"
"Early","2021-01-08","44","5189","6","826","22.1","35.7"
"Early","2021-01-09","21","5210","8","834","27.6","34.8"
"Early","2021-01-10","11","5221","2","836","22","29"
"Early","2021-01-11","43","5264","6","842","21.9","30"
"Early","2021-01-12","48","5312","9","851","20.4","28.9"
"Early","2021-01-13","73","5385","7","858","18.8","27.1"
"Early","2021-01-14","63","5448","9","867","18.1","26.3"
"Early","2021-01-15","75","5523","12","879","18.4","20.3"
"Early","2021-01-16","25","5548","12","891","19.8","23.7"
"Early","2021-01-17","3","5551","2","893","26.7","24.4"
"Early","2021-01-18","40","5591","2","895","25.5","23.7"
"Early","2021-01-19","44","5635","9","904","25.7","23"
"Early","2021-01-20","57","5692","8","912","26.3","22.6"
"Early","2021-01-21","69","5761","6","918","25.6","21.8"
"Early","2021-01-22","43","5804","6","924","25.3","21.8"
"Early","2021-01-23","16","5820","4","928","22","20.9"
"Early","2021-01-24","1","5821","0","928","12.4","19.6"
"Early","2021-01-25","1","5822","0","928","11.7","18.6"
"Early","2021-01-26","2","5824","0","928","8.8","17.3"
"Early","2021-01-27","0","5824","0","928","6.8","16.6"
"Echols","2020-02-01","0","0","0","0",".","."
"Echols","2020-02-02","0","0","0","0",".","."
"Echols","2020-02-03","0","0","0","0",".","."
"Echols","2020-02-04","0","0","0","0",".","."
"Echols","2020-02-05","0","0","0","0",".","."
"Echols","2020-02-06","0","0","0","0",".","."
"Echols","2020-02-07","0","0","0","0","0","."
"Echols","2020-02-08","0","0","0","0","0","."
"Echols","2020-02-09","0","0","0","0","0","."
"Echols","2020-02-10","0","0","0","0","0","."
"Echols","2020-02-11","0","0","0","0","0","."
"Echols","2020-02-12","0","0","0","0","0","."
"Echols","2020-02-13","0","0","0","0","0","."
"Echols","2020-02-14","0","0","0","0","0","0"
"Echols","2020-02-15","0","0","0","0","0","0"
"Echols","2020-02-16","0","0","0","0","0","0"
"Echols","2020-02-17","0","0","0","0","0","0"
"Echols","2020-02-18","0","0","0","0","0","0"
"Echols","2020-02-19","0","0","0","0","0","0"
"Echols","2020-02-20","0","0","0","0","0","0"
"Echols","2020-02-21","0","0","0","0","0","0"
"Echols","2020-02-22","0","0","0","0","0","0"
"Echols","2020-02-23","0","0","0","0","0","0"
"Echols","2020-02-24","0","0","0","0","0","0"
"Echols","2020-02-25","0","0","0","0","0","0"
"Echols","2020-02-26","0","0","0","0","0","0"
"Echols","2020-02-27","0","0","0","0","0","0"
"Echols","2020-02-28","0","0","0","0","0","0"
"Echols","2020-02-29","0","0","0","0","0","0"
"Echols","2020-03-01","0","0","0","0","0","0"
"Echols","2020-03-02","0","0","0","0","0","0"
"Echols","2020-03-03","0","0","0","0","0","0"
"Echols","2020-03-04","0","0","0","0","0","0"
"Echols","2020-03-05","0","0","0","0","0","0"
"Echols","2020-03-06","0","0","0","0","0","0"
"Echols","2020-03-07","0","0","0","0","0","0"
"Echols","2020-03-08","0","0","0","0","0","0"
"Echols","2020-03-09","0","0","0","0","0","0"
"Echols","2020-03-10","0","0","0","0","0","0"
"Echols","2020-03-11","0","0","0","0","0","0"
"Echols","2020-03-12","0","0","0","0","0","0"
"Echols","2020-03-13","0","0","0","0","0","0"
"Echols","2020-03-14","0","0","0","0","0","0"
"Echols","2020-03-15","0","0","0","0","0","0"
"Echols","2020-03-16","0","0","0","0","0","0"
"Echols","2020-03-17","0","0","0","0","0","0"
"Echols","2020-03-18","0","0","0","0","0","0"
"Echols","2020-03-19","0","0","0","0","0","0"
"Echols","2020-03-20","0","0","0","0","0","0"
"Echols","2020-03-21","0","0","0","0","0","0"
"Echols","2020-03-22","0","0","0","0","0","0"
"Echols","2020-03-23","0","0","0","0","0","0"
"Echols","2020-03-24","0","0","0","0","0","0"
"Echols","2020-03-25","0","0","0","0","0","0"
"Echols","2020-03-26","0","0","0","0","0","0"
"Echols","2020-03-27","1","1","0","0","0","0"
"Echols","2020-03-28","0","1","0","0","0","0"
"Echols","2020-03-29","0","1","0","0","0","0"
"Echols","2020-03-30","0","1","0","0","0","0"
"Echols","2020-03-31","1","2","0","0","0","0"
"Echols","2020-04-01","1","3","0","0","0","0"
"Echols","2020-04-02","2","5","0","0","0","0"
"Echols","2020-04-03","1","6","0","0","0","0"
"Echols","2020-04-04","2","8","0","0","0","0"
"Echols","2020-04-05","1","9","0","0","0","0"
"Echols","2020-04-06","2","11","1","1","7.1","3.6"
"Echols","2020-04-07","1","12","0","1","7.1","3.6"
"Echols","2020-04-08","1","13","0","1","7.1","3.6"
"Echols","2020-04-09","1","14","1","2","21.4","10.7"
"Echols","2020-04-10","0","14","0","2","21.4","10.7"
"Echols","2020-04-11","0","14","0","2","21.4","10.7"
"Echols","2020-04-12","0","14","0","2","21.4","10.7"
"Echols","2020-04-13","1","15","1","3","28.6","17.9"
"Echols","2020-04-14","1","16","1","4","42.9","25"
"Echols","2020-04-15","1","17","0","4","42.9","25"
"Echols","2020-04-16","1","18","0","4","28.6","25"
"Echols","2020-04-17","5","23","1","5","31.4","26.4"
"Echols","2020-04-18","1","24","1","6","45.7","33.6"
"Echols","2020-04-19","1","25","1","7","60","40.7"
"Echols","2020-04-20","1","26","0","7","45.7","37.1"
"Echols","2020-04-21","1","27","0","7","31.4","37.1"
"Echols","2020-04-22","1","28","0","7","31.4","37.1"
"Echols","2020-04-23","0","28","0","7","31.4","30"
"Echols","2020-04-24","0","28","0","7","28.6","30"
"Echols","2020-04-25","0","28","0","7","14.3","30"
"Echols","2020-04-26","0","28","0","7","0","30"
"Echols","2020-04-27","2","30","0","7","0","22.9"
"Echols","2020-04-28","0","30","0","7","0","15.7"
"Echols","2020-04-29","0","30","0","7","0","15.7"
"Echols","2020-04-30","1","31","1","8","14.3","22.9"
"Echols","2020-05-01","4","35","3","11","25","26.8"
"Echols","2020-05-02","0","35","0","11","25","19.6"
"Echols","2020-05-03","0","35","0","11","25","12.5"
"Echols","2020-05-04","5","40","2","13","30.7","15.4"
"Echols","2020-05-05","4","44","0","13","30.7","15.4"
"Echols","2020-05-06","12","56","0","13","30.7","15.4"
"Echols","2020-05-07","6","62","3","16","23.6","18.9"
"Echols","2020-05-08","2","64","0","16","12.9","18.9"
"Echols","2020-05-09","2","66","0","16","12.9","18.9"
"Echols","2020-05-10","0","66","0","16","12.9","18.9"
"Echols","2020-05-11","3","69","1","17","11.9","21.3"
"Echols","2020-05-12","0","69","0","17","11.9","21.3"
"Echols","2020-05-13","17","86","16","33","25.4","28"
"Echols","2020-05-14","13","99","9","42","28.1","25.8"
"Echols","2020-05-15","3","102","2","44","37.6","25.2"
"Echols","2020-05-16","0","102","0","44","37.6","25.2"
"Echols","2020-05-17","0","102","0","44","37.6","25.2"
"Echols","2020-05-18","13","115","7","51","40.6","26.2"
"Echols","2020-05-19","2","117","1","52","47.7","29.8"
"Echols","2020-05-20","27","144","2","54","35.3","30.3"
"Echols","2020-05-21","46","190","13","67","29.5","28.8"
"Echols","2020-05-22","4","194","1","68","23.5","30.6"
"Echols","2020-05-23","0","194","0","68","23.5","30.6"
"Echols","2020-05-24","0","194","0","68","23.5","30.6"
"Echols","2020-05-25","0","194","0","68","15.8","28.2"
"Echols","2020-05-26","14","208","5","73","13.8","30.7"
"Echols","2020-05-27","21","229","6","79","16.8","26"
"Echols","2020-05-28","22","251","6","85","16.7","23.1"
"Echols","2020-05-29","6","257","2","87","17.8","20.7"
"Echols","2020-05-30","0","257","0","87","17.8","20.7"
"Echols","2020-05-31","0","257","0","87","17.8","20.7"
"Echols","2020-06-01","2","259","0","87","17.8","16.8"
"Echols","2020-06-02","8","267","2","89","16.3","15"
"Echols","2020-06-03","66","333","20","109","16.6","16.7"
"Echols","2020-06-04","13","346","3","112","16","16.3"
"Echols","2020-06-05","3","349","0","112","11.2","14.5"
"Echols","2020-06-06","2","351","0","112","11.2","14.5"
"Echols","2020-06-07","3","354","2","114","20.7","19.3"
"Echols","2020-06-08","10","364","0","114","20.7","19.3"
"Echols","2020-06-09","15","379","3","117","20","18.2"
"Echols","2020-06-10","81","460","58","175","25.9","21.2"
"Echols","2020-06-11","68","528","11","186","24.9","20.4"
"Echols","2020-06-12","6","534","3","189","32.1","21.6"
"Echols","2020-06-13","4","538","4","193","46.3","28.8"
"Echols","2020-06-14","3","541","2","195","46.3","33.5"
"Echols","2020-06-15","9","550","2","197","49.5","35.1"
"Echols","2020-06-16","4","554","2","199","53.8","36.9"
"Echols","2020-06-17","41","595","10","209","47.1","36.5"
"Echols","2020-06-18","43","638","4","213","46.1","35.5"
"Echols","2020-06-19","7","645","3","216","45.1","38.6"
"Echols","2020-06-20","0","645","0","216","30.8","38.6"
"Echols","2020-06-21","0","645","0","216","21.3","33.8"
"Echols","2020-06-22","6","651","0","216","18.1","33.8"
"Echols","2020-06-23","1","652","0","216","10.9","32.4"
"Echols","2020-06-24","34","686","6","222","10","28.5"
"Echols","2020-06-25","28","714","0","222","8.6","27.4"
"Echols","2020-06-26","2","716","2","224","16.8","30.9"
"Echols","2020-06-27","0","716","0","224","16.8","23.8"
"Echols","2020-06-28","1","717","1","225","31.1","26.2"
"Echols","2020-06-29","8","725","0","225","31.1","24.6"
"Echols","2020-06-30","15","740","0","225","31.1","21"
"Echols","2020-07-01","24","764","0","225","28.6","19.3"
"Echols","2020-07-02","22","786","4","229","31.2","19.9"
"Echols","2020-07-03","0","786","0","229","16.9","16.8"
"Echols","2020-07-04","0","786","0","229","16.9","16.8"
"Echols","2020-07-05","1","787","0","229","2.6","16.8"
"Echols","2020-07-06","10","797","5","234","9.7","20.4"
"Echols","2020-07-07","14","811","5","239","14.8","23"
"Echols","2020-07-08","47","858","6","245","16.7","22.6"
"Echols","2020-07-09","29","887","4","249","16","23.6"
"Echols","2020-07-10","2","889","0","249","16","16.5"
"Echols","2020-07-11","3","892","1","250","20.8","18.8"
"Echols","2020-07-12","1","893","1","251","35.1","18.8"
"Echols","2020-07-13","6","899","0","251","27.9","18.8"
"Echols","2020-07-14","4","903","0","251","22.8","18.8"
"Echols","2020-07-15","49","952","6","257","22.8","19.7"
"Echols","2020-07-16","29","981","4","261","22.8","19.4"
"Echols","2020-07-17","6","987","0","261","22.8","19.4"
"Echols","2020-07-18","2","989","0","261","18","19.4"
"Echols","2020-07-19","2","991","0","261","3.7","19.4"
"Echols","2020-07-20","10","1001","0","261","3.7","15.8"
"Echols","2020-07-21","2","1003","0","261","3.7","13.3"
"Echols","2020-07-22","13","1016","0","261","2","12.4"
"Echols","2020-07-23","14","1030","1","262","1","11.9"
"Echols","2020-07-24","6","1036","0","262","1","11.9"
"Echols","2020-07-25","0","1036","0","262","1","9.5"
"Echols","2020-07-26","3","1039","2","264","10.5","7.1"
"Echols","2020-07-27","8","1047","4","268","17.7","10.7"
"Echols","2020-07-28","7","1054","0","268","17.7","10.7"
"Echols","2020-07-29","12","1066","2","270","20.1","11"
"Echols","2020-07-30","1","1067","0","270","19","10"
"Echols","2020-07-31","6","1073","3","273","26.2","13.6"
"Echols","2020-08-01","1","1074","1","274","40.5","20.7"
"Echols","2020-08-02","3","1077","0","274","31","20.7"
"Echols","2020-08-03","5","1082","0","274","23.8","20.7"
"Echols","2020-08-04","1","1083","0","274","23.8","20.7"
"Echols","2020-08-05","19","1102","3","277","23.7","21.9"
"Echols","2020-08-06","2","1104","0","277","23.7","21.4"
"Echols","2020-08-07","7","1111","2","279","20.6","23.4"
"Echols","2020-08-08","0","1111","0","279","6.3","23.4"
"Echols","2020-08-09","0","1111","0","279","6.3","18.6"
"Echols","2020-08-10","4","1115","2","281","13.5","18.6"
"Echols","2020-08-11","0","1115","0","281","13.5","18.6"
"Echols","2020-08-12","15","1130","0","281","11.2","17.5"
"Echols","2020-08-13","2","1132","0","281","11.2","17.5"
"Echols","2020-08-14","2","1134","0","281","7.1","13.9"
"Echols","2020-08-15","2","1136","0","281","7.1","6.7"
"Echols","2020-08-16","0","1136","0","281","7.1","6.7"
"Echols","2020-08-17","6","1142","4","285","9.5","11.5"
"Echols","2020-08-18","1","1143","0","285","9.5","11.5"
"Echols","2020-08-19","10","1153","0","285","9.5","10.4"
"Echols","2020-08-20","7","1160","2","287","13.6","12.4"
"Echols","2020-08-21","2","1162","0","287","13.6","10.4"
"Echols","2020-08-22","0","1162","0","287","13.6","10.4"
"Echols","2020-08-23","0","1162","0","287","13.6","10.4"
"Echols","2020-08-24","3","1165","2","289","13.6","11.6"
"Echols","2020-08-25","3","1168","0","289","13.6","11.6"
"Echols","2020-08-26","10","1178","1","290","15","12.3"
"Echols","2020-08-27","15","1193","3","293","13.8","13.7"
"Echols","2020-08-28","4","1197","1","294","17.4","15.5"
"Echols","2020-08-29","0","1197","0","294","17.4","15.5"
"Echols","2020-08-30","0","1197","0","294","17.4","15.5"
"Echols","2020-08-31","7","1204","1","295","9.9","11.8"
"Echols","2020-09-01","7","1211","2","297","14","13.8"
"Echols","2020-09-02","5","1216","0","297","12.6","13.8"
"Echols","2020-09-03","4","1220","0","297","9.7","11.8"
"Echols","2020-09-04","0","1220","0","297","6.1","11.8"
"Echols","2020-09-05","0","1220","0","297","6.1","11.8"
"Echols","2020-09-06","0","1220","0","297","6.1","11.8"
"Echols","2020-09-07","4","1224","0","297","4.1","7"
"Echols","2020-09-08","4","1228","0","297","0","7"
"Echols","2020-09-09","4","1232","1","298","3.6","8.1"
"Echols","2020-09-10","5","1237","0","298","3.6","6.6"
"Echols","2020-09-11","0","1237","0","298","3.6","4.8"
"Echols","2020-09-12","0","1237","0","298","3.6","4.8"
"Echols","2020-09-13","1","1238","0","298","3.6","4.8"
"Echols","2020-09-14","6","1244","0","298","3.6","3.8"
"Echols","2020-09-15","5","1249","0","298","3.6","1.8"
"Echols","2020-09-16","10","1259","0","298","0","1.8"
"Echols","2020-09-17","2","1261","2","300","14.3","8.9"
"Echols","2020-09-18","1","1262","0","300","14.3","8.9"
"Echols","2020-09-19","0","1262","0","300","14.3","8.9"
"Echols","2020-09-20","2","1264","0","300","14.3","8.9"
"Echols","2020-09-21","9","1273","0","300","14.3","8.9"
"Echols","2020-09-22","3","1276","0","300","14.3","8.9"
"Echols","2020-09-23","9","1285","1","301","15.9","7.9"
"Echols","2020-09-24","4","1289","0","301","1.6","7.9"
"Echols","2020-09-25","0","1289","0","301","1.6","7.9"
"Echols","2020-09-26","0","1289","0","301","1.6","7.9"
"Echols","2020-09-27","0","1289","0","301","1.6","7.9"
"Echols","2020-09-28","4","1293","1","302","5.2","9.7"
"Echols","2020-09-29","1","1294","0","302","5.2","9.7"
"Echols","2020-09-30","7","1301","1","303","5.6","10.7"
"Echols","2020-10-01","3","1304","0","303","5.6","3.6"
"Echols","2020-10-02","7","1311","0","303","5.6","3.6"
"Echols","2020-10-03","1","1312","0","303","5.6","3.6"
"Echols","2020-10-04","0","1312","0","303","5.6","3.6"
"Echols","2020-10-05","2","1314","2","305","16.3","10.7"
"Echols","2020-10-06","7","1321","0","305","16.3","10.7"
"Echols","2020-10-07","3","1324","0","305","14.3","9.9"
"Echols","2020-10-08","1","1325","0","305","14.3","9.9"
"Echols","2020-10-09","3","1328","0","305","14.3","9.9"
"Echols","2020-10-10","1","1329","0","305","14.3","9.9"
"Echols","2020-10-11","0","1329","0","305","14.3","9.9"
"Echols","2020-10-12","1","1330","0","305","0","8.2"
"Echols","2020-10-13","1","1331","0","305","0","8.2"
"Echols","2020-10-14","4","1335","0","305","0","7.1"
"Echols","2020-10-15","1","1336","0","305","0","7.1"
"Echols","2020-10-16","2","1338","0","305","0","7.1"
"Echols","2020-10-17","2","1340","0","305","0","7.1"
"Echols","2020-10-18","0","1340","0","305","0","7.1"
"Echols","2020-10-19","3","1343","0","305","0","0"
"Echols","2020-10-20","2","1345","1","306","7.1","3.6"
"Echols","2020-10-21","3","1348","0","306","7.1","3.6"
"Echols","2020-10-22","2","1350","0","306","7.1","3.6"
"Echols","2020-10-23","4","1354","1","307","10.7","5.4"
"Echols","2020-10-24","1","1355","1","308","25","12.5"
"Echols","2020-10-25","1","1356","0","308","25","12.5"
"Echols","2020-10-26","6","1362","0","308","25","12.5"
"Echols","2020-10-27","0","1362","0","308","17.9","12.5"
"Echols","2020-10-28","5","1367","0","308","17.9","12.5"
"Echols","2020-10-29","0","1367","0","308","17.9","12.5"
"Echols","2020-10-30","1","1368","0","308","14.3","12.5"
"Echols","2020-10-31","0","1368","0","308","0","12.5"
"Echols","2020-11-01","0","1368","0","308","0","12.5"
"Echols","2020-11-02","0","1368","0","308","0","12.5"
"Echols","2020-11-03","2","1370","0","308","0","8.9"
"Echols","2020-11-04","4","1374","0","308","0","8.9"
"Echols","2020-11-05","1","1375","0","308","0","8.9"
"Echols","2020-11-06","1","1376","0","308","0","7.1"
"Echols","2020-11-07","1","1377","1","309","14.3","7.1"
"Echols","2020-11-08","1","1378","0","309","14.3","7.1"
"Echols","2020-11-09","5","1383","1","310","17.1","8.6"
"Echols","2020-11-10","1","1384","0","310","17.1","8.6"
"Echols","2020-11-11","1","1385","0","310","17.1","8.6"
"Echols","2020-11-12","12","1397","1","311","18.3","9.2"
"Echols","2020-11-13","3","1400","1","312","23.1","11.5"
"Echols","2020-11-14","0","1400","0","312","8.8","11.5"
"Echols","2020-11-15","0","1400","0","312","8.8","11.5"
"Echols","2020-11-16","4","1404","1","313","9.5","13.3"
"Echols","2020-11-17","3","1407","1","314","14.3","15.7"
"Echols","2020-11-18","2","1409","0","314","14.3","15.7"
"Echols","2020-11-19","3","1412","2","316","22.6","20.5"
"Echols","2020-11-20","4","1416","2","318","25","24"
"Echols","2020-11-21","0","1416","0","318","25","16.9"
"Echols","2020-11-22","0","1416","0","318","25","16.9"
"Echols","2020-11-23","2","1418","1","319","28.6","19"
"Echols","2020-11-24","5","1423","2","321","29.5","21.9"
"Echols","2020-11-25","3","1426","1","322","34.3","24.3"
"Echols","2020-11-26","0","1426","0","322","24.8","23.7"
"Echols","2020-11-27","1","1427","0","322","17.6","21.3"
"Echols","2020-11-28","1","1428","0","322","17.6","21.3"
"Echols","2020-11-29","0","1428","0","322","17.6","21.3"
"Echols","2020-11-30","19","1447","6","328","15","21.8"
"Echols","2020-12-01","9","1456","3","331","14","21.8"
"Echols","2020-12-02","12","1468","4","335","14","24.2"
"Echols","2020-12-03","2","1470","0","335","14","19.4"
"Echols","2020-12-04","1","1471","1","336","28.3","23"
"Echols","2020-12-05","0","1471","0","336","28.3","23"
"Echols","2020-12-06","0","1471","0","336","28.3","23"
"Echols","2020-12-07","13","1484","2","338","26","20.5"
"Echols","2020-12-08","5","1489","1","339","24.1","19.1"
"Echols","2020-12-09","16","1505","3","342","22","18"
"Echols","2020-12-10","5","1510","2","344","27.7","20.9"
"Echols","2020-12-11","9","1519","2","346","16.6","22.5"
"Echols","2020-12-12","0","1519","0","346","16.6","22.5"
"Echols","2020-12-13","0","1519","0","346","16.6","22.5"
"Echols","2020-12-14","13","1532","3","349","17.7","21.9"
"Echols","2020-12-15","0","1532","0","349","14.9","19.5"
"Echols","2020-12-16","15","1547","1","350","13.1","17.6"
"Echols","2020-12-17","7","1554","5","355","17.6","22.7"
"Echols","2020-12-18","3","1557","3","358","28.7","22.7"
"Echols","2020-12-19","0","1557","0","358","28.7","22.7"
"Echols","2020-12-20","0","1557","0","358","28.7","22.7"
"Echols","2020-12-21","4","1561","2","360","32.6","25.2"
"Echols","2020-12-22","3","1564","0","360","32.6","23.7"
"Echols","2020-12-23","29","1593","4","364","33.6","23.4"
"Echols","2020-12-24","1","1594","0","364","23.4","20.5"
"Echols","2020-12-25","1","1595","1","365","23.4","26.1"
"Echols","2020-12-26","1","1596","1","366","37.7","33.2"
"Echols","2020-12-27","1","1597","0","366","37.7","33.2"
"Echols","2020-12-28","1","1598","0","366","30.5","31.6"
"Echols","2020-12-29","0","1598","0","366","30.5","31.6"
"Echols","2020-12-30","25","1623","4","370","30.9","32.2"
"Echols","2020-12-31","0","1623","0","370","30.9","27.1"
"Echols","2021-01-01","0","1623","0","370","16.6","20"
"Echols","2021-01-02","1","1624","0","370","2.3","20"
"Echols","2021-01-03","1","1625","0","370","2.3","20"
"Echols","2021-01-04","7","1632","2","372","6.4","18.5"
"Echols","2021-01-05","5","1637","1","373","9.2","19.9"
"Echols","2021-01-06","34","1671","6","379","9.5","20.2"
"Echols","2021-01-07","10","1681","1","380","10.9","20.9"
"Echols","2021-01-08","5","1686","1","381","13.7","15.2"
"Echols","2021-01-09","7","1693","5","386","23.9","13.1"
"Echols","2021-01-10","2","1695","1","387","31.1","16.7"
"Echols","2021-01-11","0","1695","0","387","27","16.7"
"Echols","2021-01-12","1","1696","0","387","24.2","16.7"
"Echols","2021-01-13","35","1731","1","388","22","15.8"
"Echols","2021-01-14","7","1738","1","389","22.7","16.8"
"Echols","2021-01-15","5","1743","0","389","19.8","16.8"
"Echols","2021-01-16","3","1746","0","389","9.6","16.8"
"Echols","2021-01-17","0","1746","0","389","2.4","16.8"
"Echols","2021-01-18","3","1749","1","390","7.2","17.1"
"Echols","2021-01-19","4","1753","1","391","10.8","17.5"
"Echols","2021-01-20","14","1767","2","393","12.4","17.2"
"Echols","2021-01-21","4","1771","0","393","10.4","16.5"
"Echols","2021-01-22","3","1774","1","394","15.1","17.5"
"Echols","2021-01-23","4","1778","1","395","18.7","14.1"
"Echols","2021-01-24","4","1782","3","398","29.4","15.9"
"Echols","2021-01-25","2","1784","0","398","24.7","15.9"
"Echols","2021-01-26","0","1784","0","398","21.1","15.9"
"Echols","2021-01-27","0","1784","0","398","19","15.7"
"Effingham","2020-02-01","0","0","0","0",".","."
"Effingham","2020-02-02","0","0","0","0",".","."
"Effingham","2020-02-03","0","0","0","0",".","."
"Effingham","2020-02-04","0","0","0","0",".","."
"Effingham","2020-02-05","0","0","0","0",".","."
"Effingham","2020-02-06","0","0","0","0",".","."
"Effingham","2020-02-07","0","0","0","0","0","."
"Effingham","2020-02-08","0","0","0","0","0","."
"Effingham","2020-02-09","0","0","0","0","0","."
"Effingham","2020-02-10","0","0","0","0","0","."
"Effingham","2020-02-11","0","0","0","0","0","."
"Effingham","2020-02-12","0","0","0","0","0","."
"Effingham","2020-02-13","0","0","0","0","0","."
"Effingham","2020-02-14","0","0","0","0","0","0"
"Effingham","2020-02-15","0","0","0","0","0","0"
"Effingham","2020-02-16","0","0","0","0","0","0"
"Effingham","2020-02-17","0","0","0","0","0","0"
"Effingham","2020-02-18","0","0","0","0","0","0"
"Effingham","2020-02-19","0","0","0","0","0","0"
"Effingham","2020-02-20","0","0","0","0","0","0"
"Effingham","2020-02-21","0","0","0","0","0","0"
"Effingham","2020-02-22","0","0","0","0","0","0"
"Effingham","2020-02-23","0","0","0","0","0","0"
"Effingham","2020-02-24","0","0","0","0","0","0"
"Effingham","2020-02-25","0","0","0","0","0","0"
"Effingham","2020-02-26","0","0","0","0","0","0"
"Effingham","2020-02-27","0","0","0","0","0","0"
"Effingham","2020-02-28","0","0","0","0","0","0"
"Effingham","2020-02-29","0","0","0","0","0","0"
"Effingham","2020-03-01","0","0","0","0","0","0"
"Effingham","2020-03-02","0","0","0","0","0","0"
"Effingham","2020-03-03","0","0","0","0","0","0"
"Effingham","2020-03-04","0","0","0","0","0","0"
"Effingham","2020-03-05","0","0","0","0","0","0"
"Effingham","2020-03-06","0","0","0","0","0","0"
"Effingham","2020-03-07","0","0","0","0","0","0"
"Effingham","2020-03-08","0","0","0","0","0","0"
"Effingham","2020-03-09","0","0","0","0","0","0"
"Effingham","2020-03-10","0","0","0","0","0","0"
"Effingham","2020-03-11","3","3","0","0","0","0"
"Effingham","2020-03-12","1","4","0","0","0","0"
"Effingham","2020-03-13","0","4","0","0","0","0"
"Effingham","2020-03-14","5","9","0","0","0","0"
"Effingham","2020-03-15","10","19","2","2","2.9","1.4"
"Effingham","2020-03-16","17","36","0","2","2.9","1.4"
"Effingham","2020-03-17","34","70","1","3","3.3","1.6"
"Effingham","2020-03-18","16","86","0","3","3.3","1.6"
"Effingham","2020-03-19","6","92","1","4","5.7","2.8"
"Effingham","2020-03-20","13","105","0","4","5.7","2.8"
"Effingham","2020-03-21","1","106","0","4","5.7","2.8"
"Effingham","2020-03-22","1","107","1","5","17.1","10"
"Effingham","2020-03-23","18","125","0","5","17.1","10"
"Effingham","2020-03-24","26","151","0","5","16.7","10"
"Effingham","2020-03-25","18","169","2","7","18.3","10.8"
"Effingham","2020-03-26","10","179","1","8","17.3","11.5"
"Effingham","2020-03-27","15","194","2","10","19.2","12.4"
"Effingham","2020-03-28","3","197","2","12","28.7","17.2"
"Effingham","2020-03-29","0","197","0","12","14.4","15.8"
"Effingham","2020-03-30","14","211","3","15","17.5","17.3"
"Effingham","2020-03-31","11","222","1","16","18.8","17.7"
"Effingham","2020-04-01","15","237","1","17","18.2","18.2"
"Effingham","2020-04-02","16","253","1","18","17.6","17.5"
"Effingham","2020-04-03","21","274","1","19","16.4","17.8"
"Effingham","2020-04-04","3","277","0","19","6.9","17.8"
"Effingham","2020-04-05","5","282","0","19","6.9","10.7"
"Effingham","2020-04-06","30","312","1","20","4.3","10.9"
"Effingham","2020-04-07","18","330","0","20","3","10.9"
"Effingham","2020-04-08","21","351","0","20","2","10.1"
"Effingham","2020-04-09","29","380","1","21","1.6","9.6"
"Effingham","2020-04-10","17","397","3","24","3.5","9.9"
"Effingham","2020-04-11","8","405","1","25","5.3","6.1"
"Effingham","2020-04-12","0","405","0","25","5.3","6.1"
"Effingham","2020-04-13","18","423","2","27","6.4","5.3"
"Effingham","2020-04-14","33","456","1","28","6.8","4.9"
"Effingham","2020-04-15","14","470","0","28","6.8","4.4"
"Effingham","2020-04-16","17","487","1","29","7.2","4.4"
"Effingham","2020-04-17","24","511","4","33","7","5.3"
"Effingham","2020-04-18","11","522","1","34","6.5","5.9"
"Effingham","2020-04-19","4","526","0","34","6.5","5.9"
"Effingham","2020-04-20","22","548","2","36","6.3","6.3"
"Effingham","2020-04-21","52","600","3","39","6.6","6.7"
"Effingham","2020-04-22","40","640","1","40","7","6.9"
"Effingham","2020-04-23","34","674","1","41","6.6","6.9"
"Effingham","2020-04-24","22","696","0","41","4.2","5.6"
"Effingham","2020-04-25","6","702","0","41","2.9","4.7"
"Effingham","2020-04-26","4","706","0","41","2.9","4.7"
"Effingham","2020-04-27","15","721","0","41","1.6","3.9"
"Effingham","2020-04-28","19","740","0","41","0.8","3.7"
"Effingham","2020-04-29","33","773","1","42","0.9","3.9"
"Effingham","2020-04-30","20","793","0","42","0.4","3.5"
"Effingham","2020-05-01","17","810","2","44","2.1","3.2"
"Effingham","2020-05-02","9","819","0","44","2.1","2.5"
"Effingham","2020-05-03","8","827","0","44","2.1","2.5"
"Effingham","2020-05-04","19","846","0","44","2.1","1.9"
"Effingham","2020-05-05","9","855","0","44","2.1","1.4"
"Effingham","2020-05-06","19","874","0","44","1.7","1.3"
"Effingham","2020-05-07","12","886","0","44","1.7","1.1"
"Effingham","2020-05-08","268","1154","6","50","0.3","1.2"
"Effingham","2020-05-09","4","1158","0","50","0.3","1.2"
"Effingham","2020-05-10","4","1162","0","50","0.3","1.2"
"Effingham","2020-05-11","15","1177","0","50","0.3","1.2"
"Effingham","2020-05-12","26","1203","0","50","0.3","1.2"
"Effingham","2020-05-13","19","1222","0","50","0.3","1"
"Effingham","2020-05-14","38","1260","0","50","0.3","1"
"Effingham","2020-05-15","215","1475","10","60","0.7","0.5"
"Effingham","2020-05-16","5","1480","0","60","0.7","0.5"
"Effingham","2020-05-17","6","1486","0","60","0.7","0.5"
"Effingham","2020-05-18","16","1502","0","60","0.7","0.5"
"Effingham","2020-05-19","22","1524","2","62","2","1.1"
"Effingham","2020-05-20","25","1549","0","62","2","1.1"
"Effingham","2020-05-21","25","1574","0","62","2","1.1"
"Effingham","2020-05-22","103","1677","13","75","3.1","1.9"
"Effingham","2020-05-23","10","1687","0","75","3.1","1.9"
"Effingham","2020-05-24","1","1688","0","75","3.1","1.9"
"Effingham","2020-05-25","8","1696","0","75","3.1","1.9"
"Effingham","2020-05-26","42","1738","1","76","2.1","2.1"
"Effingham","2020-05-27","22","1760","0","76","2.1","2.1"
"Effingham","2020-05-28","27","1787","1","77","2.7","2.3"
"Effingham","2020-05-29","42","1829","0","77","0.9","2"
"Effingham","2020-05-30","8","1837","0","77","0.9","2"
"Effingham","2020-05-31","14","1851","0","77","0.9","2"
"Effingham","2020-06-01","40","1891","0","77","0.9","2"
"Effingham","2020-06-02","37","1928","2","79","1.3","1.7"
"Effingham","2020-06-03","20","1948","1","80","2","2.1"
"Effingham","2020-06-04","29","1977","0","80","1.5","2.1"
"Effingham","2020-06-05","17","1994","0","80","1.5","1.2"
"Effingham","2020-06-06","7","2001","0","80","1.5","1.2"
"Effingham","2020-06-07","7","2008","0","80","1.5","1.2"
"Effingham","2020-06-08","30","2038","3","83","2.9","1.9"
"Effingham","2020-06-09","24","2062","1","84","2.7","2"
"Effingham","2020-06-10","17","2079","1","85","2.9","2.4"
"Effingham","2020-06-11","36","2115","3","88","4.1","2.8"
"Effingham","2020-06-12","25","2140","2","90","5.2","3.3"
"Effingham","2020-06-13","15","2155","0","90","5.2","3.3"
"Effingham","2020-06-14","11","2166","0","90","5.2","3.3"
"Effingham","2020-06-15","37","2203","3","93","4.9","3.9"
"Effingham","2020-06-16","48","2251","4","97","5.5","4.1"
"Effingham","2020-06-17","31","2282","4","101","6.5","4.7"
"Effingham","2020-06-18","42","2324","2","103","6","5"
"Effingham","2020-06-19","40","2364","2","105","5.6","5.4"
"Effingham","2020-06-20","70","2434","1","106","5.8","5.5"
"Effingham","2020-06-21","15","2449","4","110","9.6","7.4"
"Effingham","2020-06-22","91","2540","11","121","10.2","7.5"
"Effingham","2020-06-23","59","2599","10","131","11.4","8.5"
"Effingham","2020-06-24","97","2696","8","139","10.7","8.6"
"Effingham","2020-06-25","116","2812","6","145","10.8","8.4"
"Effingham","2020-06-26","71","2883","6","151","11.3","8.4"
"Effingham","2020-06-27","41","2924","7","158","13.5","9.7"
"Effingham","2020-06-28","17","2941","1","159","10.6","10.1"
"Effingham","2020-06-29","85","3026","11","170","10.7","10.4"
"Effingham","2020-06-30","114","3140","17","187","10.4","10.9"
"Effingham","2020-07-01","78","3218","9","196","10.9","10.8"
"Effingham","2020-07-02","102","3320","13","209","11.9","11.4"
"Effingham","2020-07-03","44","3364","7","216","13","12.1"
"Effingham","2020-07-04","18","3382","3","219","12.9","13.2"
"Effingham","2020-07-05","30","3412","4","223","14","12.3"
"Effingham","2020-07-06","205","3617","20","243","13.6","12.1"
"Effingham","2020-07-07","163","3780","24","267","13.5","12"
"Effingham","2020-07-08","141","3921","14","281","13.3","12.1"
"Effingham","2020-07-09","163","4084","57","338","16.5","14.2"
"Effingham","2020-07-10","145","4229","12","350","15.4","14.2"
"Effingham","2020-07-11","26","4255","10","360","18.5","15.7"
"Effingham","2020-07-12","29","4284","6","366","19.5","16.8"
"Effingham","2020-07-13","109","4393","18","384","20.5","17"
"Effingham","2020-07-14","122","4515","18","402","20.5","17"
"Effingham","2020-07-15","173","4688","22","424","20.9","17.1"
"Effingham","2020-07-16","106","4794","21","445","18.7","17.6"
"Effingham","2020-07-17","157","4951","15","460","18.9","17.2"
"Effingham","2020-07-18","30","4981","7","467","16.8","17.6"
"Effingham","2020-07-19","38","5019","5","472","15.7","17.6"
"Effingham","2020-07-20","170","5189","18","490","14.8","17.7"
"Effingham","2020-07-21","88","5277","10","500","14.4","17.4"
"Effingham","2020-07-22","171","5448","13","513","13.6","17.3"
"Effingham","2020-07-23","57","5505","11","524","13.6","16.2"
"Effingham","2020-07-24","159","5664","10","534","13.1","16"
"Effingham","2020-07-25","44","5708","10","544","13","14.9"
"Effingham","2020-07-26","23","5731","7","551","15.5","15.6"
"Effingham","2020-07-27","99","5830","20","571","16.8","15.8"
"Effingham","2020-07-28","77","5907","19","590","18.7","16.6"
"Effingham","2020-07-29","146","6053","14","604","19","16.3"
"Effingham","2020-07-30","82","6135","19","623","19.6","16.6"
"Effingham","2020-07-31","129","6264","13","636","20.1","16.6"
"Effingham","2020-08-01","38","6302","5","641","18.8","15.9"
"Effingham","2020-08-02","34","6336","3","644","15.7","15.6"
"Effingham","2020-08-03","100","6436","23","667","16.1","16.5"
"Effingham","2020-08-04","49","6485","13","680","16.3","17.5"
"Effingham","2020-08-05","149","6634","11","691","16","17.5"
"Effingham","2020-08-06","94","6728","13","704","14.7","17.1"
"Effingham","2020-08-07","181","6909","19","723","14.7","17.4"
"Effingham","2020-08-08","36","6945","5","728","14.9","16.8"
"Effingham","2020-08-09","21","6966","5","733","17","16.3"
"Effingham","2020-08-10","99","7065","19","752","16.4","16.3"
"Effingham","2020-08-11","108","7173","12","764","14.2","15.3"
"Effingham","2020-08-12","165","7338","18","782","14.7","15.4"
"Effingham","2020-08-13","82","7420","12","794","14.9","14.8"
"Effingham","2020-08-14","163","7583","11","805","14.3","14.5"
"Effingham","2020-08-15","26","7609","4","809","14.5","14.7"
"Effingham","2020-08-16","31","7640","10","819","15.7","16.4"
"Effingham","2020-08-17","100","7740","19","838","15.7","16.1"
"Effingham","2020-08-18","84","7824","14","852","16.5","15.4"
"Effingham","2020-08-19","230","8054","28","880","16.7","15.7"
"Effingham","2020-08-20","99","8153","15","895","16.8","15.8"
"Effingham","2020-08-21","174","8327","19","914","17.4","15.8"
"Effingham","2020-08-22","32","8359","6","920","17.8","16.2"
"Effingham","2020-08-23","34","8393","3","923","14.5","15.1"
"Effingham","2020-08-24","96","8489","8","931","13","14.3"
"Effingham","2020-08-25","70","8559","10","941","12.6","14.6"
"Effingham","2020-08-26","165","8724","24","965","13","14.8"
"Effingham","2020-08-27","75","8799","5","970","11.8","14.3"
"Effingham","2020-08-28","194","8993","15","985","11.3","14.3"
"Effingham","2020-08-29","19","9012","6","991","13.1","15.5"
"Effingham","2020-08-30","36","9048","9","1000","15.4","15"
"Effingham","2020-08-31","84","9132","18","1018","17.3","15.1"
"Effingham","2020-09-01","73","9205","9","1027","17","14.8"
"Effingham","2020-09-02","162","9367","19","1046","16.6","14.8"
"Effingham","2020-09-03","55","9422","7","1053","17.5","14.6"
"Effingham","2020-09-04","134","9556","17","1070","18.2","14.8"
"Effingham","2020-09-05","24","9580","2","1072","14.9","14"
"Effingham","2020-09-06","19","9599","7","1079","16.6","16"
"Effingham","2020-09-07","15","9614","2","1081","15.4","16.4"
"Effingham","2020-09-08","89","9703","8","1089","14.9","16"
"Effingham","2020-09-09","172","9875","19","1108","14.9","15.7"
"Effingham","2020-09-10","64","9939","7","1115","14.6","16"
"Effingham","2020-09-11","107","10046","10","1125","14.1","16.2"
"Effingham","2020-09-12","34","10080","5","1130","15","15"
"Effingham","2020-09-13","45","10125","8","1138","12.3","14.4"
"Effingham","2020-09-14","101","10226","8","1146","11.5","13.5"
"Effingham","2020-09-15","62","10288","5","1151","11.4","13.2"
"Effingham","2020-09-16","62","10350","6","1157","11.2","13"
"Effingham","2020-09-17","78","10428","10","1167","11.5","13"
"Effingham","2020-09-18","156","10584","8","1175","10.9","12.5"
"Effingham","2020-09-19","26","10610","3","1178","10.4","12.7"
"Effingham","2020-09-20","16","10626","3","1181","10.6","11.4"
"Effingham","2020-09-21","89","10715","8","1189","10.7","11.1"
"Effingham","2020-09-22","63","10778","4","1193","10.5","10.9"
"Effingham","2020-09-23","127","10905","18","1211","11.1","11.2"
"Effingham","2020-09-24","56","10961","4","1215","10.3","10.9"
"Effingham","2020-09-25","107","11068","9","1224","10.8","10.8"
"Effingham","2020-09-26","17","11085","2","1226","10.8","10.6"
"Effingham","2020-09-27","9","11094","3","1229","12.9","11.7"
"Effingham","2020-09-28","79","11173","5","1234","12.5","11.6"
"Effingham","2020-09-29","61","11234","12","1246","14.4","12.4"
"Effingham","2020-09-30","127","11361","23","1269","15","13"
"Effingham","2020-10-01","67","11428","6","1275","15.2","12.8"
"Effingham","2020-10-02","109","11537","9","1284","15.2","13"
"Effingham","2020-10-03","51","11588","1","1285","13.8","12.3"
"Effingham","2020-10-04","15","11603","3","1288","11.9","12.4"
"Effingham","2020-10-05","85","11688","6","1294","12","12.3"
"Effingham","2020-10-06","107","11795","7","1301","10.1","12.3"
"Effingham","2020-10-07","156","11951","13","1314","8.7","11.8"
"Effingham","2020-10-08","76","12027","7","1321","8.8","12"
"Effingham","2020-10-09","223","12250","29","1350","9.4","12.3"
"Effingham","2020-10-10","42","12292","9","1359","12.2","13"
"Effingham","2020-10-11","19","12311","3","1362","11.6","11.8"
"Effingham","2020-10-12","78","12389","8","1370","12.1","12"
"Effingham","2020-10-13","111","12500","10","1380","12.4","11.3"
"Effingham","2020-10-14","70","12570","16","1396","14.5","11.6"
"Effingham","2020-10-15","89","12659","13","1409","15.3","12"
"Effingham","2020-10-16","179","12838","16","1425","14.7","12.1"
"Effingham","2020-10-17","24","12862","3","1428","13.4","12.8"
"Effingham","2020-10-18","29","12891","6","1434","14.1","12.9"
"Effingham","2020-10-19","103","12994","6","1440","13.5","12.8"
"Effingham","2020-10-20","105","13099","12","1452","13.8","13.1"
"Effingham","2020-10-21","66","13165","10","1462","12.7","13.6"
"Effingham","2020-10-22","93","13258","7","1469","11.7","13.5"
"Effingham","2020-10-23","155","13413","14","1483","11.7","13.2"
"Effingham","2020-10-24","27","13440","5","1488","12.6","13"
"Effingham","2020-10-25","34","13474","7","1495","12.6","13.4"
"Effingham","2020-10-26","87","13561","6","1501","12.7","13.1"
"Effingham","2020-10-27","89","13650","8","1509","12.4","13.1"
"Effingham","2020-10-28","78","13728","5","1514","11.1","11.9"
"Effingham","2020-10-29","94","13822","8","1522","11.3","11.5"
"Effingham","2020-10-30","178","14000","7","1529","10.5","11.1"
"Effingham","2020-10-31","34","14034","3","1532","9.2","10.9"
"Effingham","2020-11-01","18","14052","3","1535","8.6","10.6"
"Effingham","2020-11-02","65","14117","6","1541","8.9","10.8"
"Effingham","2020-11-03","119","14236","8","1549","8.6","10.5"
"Effingham","2020-11-04","67","14303","10","1559","9.8","10.5"
"Effingham","2020-11-05","87","14390","7","1566","9.8","10.5"
"Effingham","2020-11-06","153","14543","6","1572","9.8","10.2"
"Effingham","2020-11-07","28","14571","6","1578","11.6","10.4"
"Effingham","2020-11-08","33","14604","3","1581","10.5","9.5"
"Effingham","2020-11-09","102","14706","14","1595","11.1","10"
"Effingham","2020-11-10","90","14796","10","1605","11.7","10.2"
"Effingham","2020-11-11","56","14852","6","1611","11.1","10.5"
"Effingham","2020-11-12","120","14972","11","1622","11.3","10.5"
"Effingham","2020-11-13","168","15140","7","1629","11.3","10.6"
"Effingham","2020-11-14","42","15182","4","1633","9.6","10.6"
"Effingham","2020-11-15","31","15213","7","1640","11.6","11"
"Effingham","2020-11-16","109","15322","12","1652","11.2","11.2"
"Effingham","2020-11-17","120","15442","7","1659","10.4","11.1"
"Effingham","2020-11-18","72","15514","8","1667","10.5","10.8"
"Effingham","2020-11-19","82","15596","9","1676","10.7","11"
"Effingham","2020-11-20","216","15812","8","1684","10.7","11"
"Effingham","2020-11-21","35","15847","4","1688","10.9","10.3"
"Effingham","2020-11-22","36","15883","4","1692","9.3","10.4"
"Effingham","2020-11-23","94","15977","5","1697","8.5","9.8"
"Effingham","2020-11-24","67","16044","10","1707","9.8","10.1"
"Effingham","2020-11-25","99","16143","8","1715","9.4","9.9"
"Effingham","2020-11-26","12","16155","2","1717","10.2","10.5"
"Effingham","2020-11-27","49","16204","13","1730","13.4","12.1"
"Effingham","2020-11-28","36","16240","7","1737","14.6","12.8"
"Effingham","2020-11-29","33","16273","2","1739","13.9","11.6"
"Effingham","2020-11-30","98","16371","8","1747","14.3","11.4"
"Effingham","2020-12-01","79","16450","8","1755","13.6","11.7"
"Effingham","2020-12-02","117","16567","6","1761","13.2","11.3"
"Effingham","2020-12-03","66","16633","5","1766","11.9","11"
"Effingham","2020-12-04","145","16778","17","1783","9.7","11.6"
"Effingham","2020-12-05","41","16819","5","1788","8.7","11.6"
"Effingham","2020-12-06","38","16857","9","1797","11.2","12.5"
"Effingham","2020-12-07","86","16943","10","1807","11.7","13"
"Effingham","2020-12-08","99","17042","7","1814","11.3","12.4"
"Effingham","2020-12-09","109","17151","8","1822","11.6","12.4"
"Effingham","2020-12-10","88","17239","7","1829","11.7","11.8"
"Effingham","2020-12-11","191","17430","15","1844","11.1","10.4"
"Effingham","2020-12-12","66","17496","13","1857","12.2","10.4"
"Effingham","2020-12-13","45","17541","6","1863","10.7","11"
"Effingham","2020-12-14","160","17701","18","1881","10.6","11.2"
"Effingham","2020-12-15","128","17829","21","1902","12","11.6"
"Effingham","2020-12-16","154","17983","13","1915","12.1","11.9"
"Effingham","2020-12-17","111","18094","12","1927","12.5","12.1"
"Effingham","2020-12-18","208","18302","21","1948","12.9","12"
"Effingham","2020-12-19","44","18346","5","1953","11.7","11.9"
"Effingham","2020-12-20","39","18385","7","1960","12.3","11.5"
"Effingham","2020-12-21","129","18514","26","1986","13.6","12.1"
"Effingham","2020-12-22","96","18610","10","1996","12.7","12.4"
"Effingham","2020-12-23","122","18732","17","2013","13.5","12.8"
"Effingham","2020-12-24","67","18799","11","2024","14.3","13.4"
"Effingham","2020-12-25","20","18819","3","2027","15","13.9"
"Effingham","2020-12-26","62","18881","10","2037","15.7","13.7"
"Effingham","2020-12-27","45","18926","11","2048","16.6","14.5"
"Effingham","2020-12-28","118","19044","21","2069","16.3","15"
"Effingham","2020-12-29","219","19263","24","2093","16.4","14.6"
"Effingham","2020-12-30","136","19399","27","2120","17.2","15.4"
"Effingham","2020-12-31","88","19487","9","2129","16.3","15.3"
"Effingham","2021-01-01","27","19514","12","2141","20.6","17.8"
"Effingham","2021-01-02","41","19555","8","2149","21","18.4"
"Effingham","2021-01-03","39","19594","15","2164","23","19.8"
"Effingham","2021-01-04","89","19683","18","2182","23.4","19.8"
"Effingham","2021-01-05","137","19820","27","2209","24.6","20.5"
"Effingham","2021-01-06","133","19953","21","2230","24.1","20.6"
"Effingham","2021-01-07","174","20127","28","2258","24.9","20.6"
"Effingham","2021-01-08","305","20432","28","2286","19.9","20.2"
"Effingham","2021-01-09","68","20500","17","2303","20.6","20.8"
"Effingham","2021-01-10","55","20555","8","2311","17.2","20.1"
"Effingham","2021-01-11","152","20707","29","2340","17.1","20.2"
"Effingham","2021-01-12","189","20896","33","2373","16.7","20.7"
"Effingham","2021-01-13","189","21085","25","2398","16.4","20.2"
"Effingham","2021-01-14","131","21216","22","2420","16.5","20.7"
"Effingham","2021-01-15","245","21461","29","2449","16.8","18.4"
"Effingham","2021-01-16","64","21525","16","2465","16.8","18.7"
"Effingham","2021-01-17","51","21576","9","2474","17.3","17.3"
"Effingham","2021-01-18","184","21760","19","2493","16","16.5"
"Effingham","2021-01-19","142","21902","24","2517","16","16.3"
"Effingham","2021-01-20","202","22104","16","2533","15.2","15.8"
"Effingham","2021-01-21","135","22239","18","2551","14.7","15.6"
"Effingham","2021-01-22","284","22523","28","2579","14.4","15.6"
"Effingham","2021-01-23","70","22593","19","2598","14.7","15.8"
"Effingham","2021-01-24","31","22624","15","2613","19.1","18.2"
"Effingham","2021-01-25","68","22692","18","2631","21.4","18.7"
"Effingham","2021-01-26","3","22695","1","2632","23.8","19.9"
"Effingham","2021-01-27","0","22695","0","2632","22.6","18.9"
"Elbert","2020-02-01","0","0","0","0",".","."
"Elbert","2020-02-02","0","0","0","0",".","."
"Elbert","2020-02-03","0","0","0","0",".","."
"Elbert","2020-02-04","0","0","0","0",".","."
"Elbert","2020-02-05","0","0","0","0",".","."
"Elbert","2020-02-06","0","0","0","0",".","."
"Elbert","2020-02-07","0","0","0","0","0","."
"Elbert","2020-02-08","0","0","0","0","0","."
"Elbert","2020-02-09","0","0","0","0","0","."
"Elbert","2020-02-10","0","0","0","0","0","."
"Elbert","2020-02-11","0","0","0","0","0","."
"Elbert","2020-02-12","0","0","0","0","0","."
"Elbert","2020-02-13","0","0","0","0","0","."
"Elbert","2020-02-14","0","0","0","0","0","0"
"Elbert","2020-02-15","0","0","0","0","0","0"
"Elbert","2020-02-16","0","0","0","0","0","0"
"Elbert","2020-02-17","0","0","0","0","0","0"
"Elbert","2020-02-18","0","0","0","0","0","0"
"Elbert","2020-02-19","0","0","0","0","0","0"
"Elbert","2020-02-20","0","0","0","0","0","0"
"Elbert","2020-02-21","0","0","0","0","0","0"
"Elbert","2020-02-22","0","0","0","0","0","0"
"Elbert","2020-02-23","0","0","0","0","0","0"
"Elbert","2020-02-24","0","0","0","0","0","0"
"Elbert","2020-02-25","0","0","0","0","0","0"
"Elbert","2020-02-26","0","0","0","0","0","0"
"Elbert","2020-02-27","0","0","0","0","0","0"
"Elbert","2020-02-28","0","0","0","0","0","0"
"Elbert","2020-02-29","0","0","0","0","0","0"
"Elbert","2020-03-01","0","0","0","0","0","0"
"Elbert","2020-03-02","0","0","0","0","0","0"
"Elbert","2020-03-03","0","0","0","0","0","0"
"Elbert","2020-03-04","0","0","0","0","0","0"
"Elbert","2020-03-05","0","0","0","0","0","0"
"Elbert","2020-03-06","0","0","0","0","0","0"
"Elbert","2020-03-07","0","0","0","0","0","0"
"Elbert","2020-03-08","0","0","0","0","0","0"
"Elbert","2020-03-09","1","1","0","0","0","0"
"Elbert","2020-03-10","0","1","0","0","0","0"
"Elbert","2020-03-11","0","1","0","0","0","0"
"Elbert","2020-03-12","0","1","0","0","0","0"
"Elbert","2020-03-13","0","1","0","0","0","0"
"Elbert","2020-03-14","0","1","0","0","0","0"
"Elbert","2020-03-15","0","1","0","0","0","0"
"Elbert","2020-03-16","4","5","0","0","0","0"
"Elbert","2020-03-17","2","7","0","0","0","0"
"Elbert","2020-03-18","13","20","0","0","0","0"
"Elbert","2020-03-19","4","24","0","0","0","0"
"Elbert","2020-03-20","6","30","0","0","0","0"
"Elbert","2020-03-21","0","30","0","0","0","0"
"Elbert","2020-03-22","0","30","0","0","0","0"
"Elbert","2020-03-23","2","32","0","0","0","0"
"Elbert","2020-03-24","4","36","0","0","0","0"
"Elbert","2020-03-25","7","43","0","0","0","0"
"Elbert","2020-03-26","6","49","0","0","0","0"
"Elbert","2020-03-27","6","55","1","1","2.4","1.2"
"Elbert","2020-03-28","6","61","0","1","2.4","1.2"
"Elbert","2020-03-29","4","65","0","1","2.4","1.2"
"Elbert","2020-03-30","1","66","0","1","2.4","1.2"
"Elbert","2020-03-31","4","70","0","1","2.4","1.2"
"Elbert","2020-04-01","3","73","1","2","7.1","3.6"
"Elbert","2020-04-02","3","76","0","2","7.1","3.6"
"Elbert","2020-04-03","6","82","0","2","4.8","3.6"
"Elbert","2020-04-04","4","86","0","2","4.8","3.6"
"Elbert","2020-04-05","3","89","0","2","4.8","3.6"
"Elbert","2020-04-06","2","91","0","2","4.8","3.6"
"Elbert","2020-04-07","7","98","3","5","10.9","6.6"
"Elbert","2020-04-08","1","99","0","5","6.1","6.6"
"Elbert","2020-04-09","2","101","0","5","6.1","6.6"
"Elbert","2020-04-10","1","102","0","5","6.1","5.4"
"Elbert","2020-04-11","2","104","0","5","6.1","5.4"
"Elbert","2020-04-12","1","105","0","5","6.1","5.4"
"Elbert","2020-04-13","5","110","1","6","9","6.9"
"Elbert","2020-04-14","5","115","0","6","2.9","6.9"
"Elbert","2020-04-15","10","125","0","6","2.9","4.5"
"Elbert","2020-04-16","2","127","0","6","2.9","4.5"
"Elbert","2020-04-17","7","134","1","7","4.9","5.5"
"Elbert","2020-04-18","1","135","0","7","4.9","5.5"
"Elbert","2020-04-19","3","138","0","7","4.9","5.5"
"Elbert","2020-04-20","9","147","3","10","6.8","7.9"
"Elbert","2020-04-21","7","154","2","12","10.9","6.9"
"Elbert","2020-04-22","9","163","1","13","12.5","7.7"
"Elbert","2020-04-23","5","168","1","14","15.3","9.1"
"Elbert","2020-04-24","12","180","3","17","16.9","10.9"
"Elbert","2020-04-25","4","184","0","17","16.9","10.9"
"Elbert","2020-04-26","2","186","0","17","16.9","10.9"
"Elbert","2020-04-27","12","198","5","22","18","12.4"
"Elbert","2020-04-28","6","204","0","22","14","12.4"
"Elbert","2020-04-29","9","213","0","22","12.4","12.4"
"Elbert","2020-04-30","22","235","7","29","14.1","14.7"
"Elbert","2020-05-01","12","247","0","29","10.5","13.7"
"Elbert","2020-05-02","1","248","0","29","10.5","13.7"
"Elbert","2020-05-03","2","250","1","30","17.6","17.3"
"Elbert","2020-05-04","25","275","0","30","11.7","14.9"
"Elbert","2020-05-05","29","304","1","31","12.2","13.1"
"Elbert","2020-05-06","22","326","2","33","13.5","12.9"
"Elbert","2020-05-07","12","338","0","33","8.9","11.5"
"Elbert","2020-05-08","9","347","1","34","10.5","10.5"
"Elbert","2020-05-09","5","352","0","34","10.5","10.5"
"Elbert","2020-05-10","2","354","1","35","10.5","14.1"
"Elbert","2020-05-11","15","369","2","37","12.4","12.1"
"Elbert","2020-05-12","30","399","2","39","12.9","12.5"
"Elbert","2020-05-13","10","409","0","39","11.6","12.5"
"Elbert","2020-05-14","14","423","1","40","12.6","10.8"
"Elbert","2020-05-15","15","438","1","41","12","11.2"
"Elbert","2020-05-16","1","439","0","41","12","11.2"
"Elbert","2020-05-17","2","441","0","41","4.8","7.7"
"Elbert","2020-05-18","18","459","1","42","3.7","8.1"
"Elbert","2020-05-19","20","479","1","43","3.5","8.2"
"Elbert","2020-05-20","18","497","2","45","5.1","8.3"
"Elbert","2020-05-21","12","509","1","46","5.2","8.9"
"Elbert","2020-05-22","13","522","0","46","4.3","8.1"
"Elbert","2020-05-23","3","525","0","46","4.3","8.1"
"Elbert","2020-05-24","8","533","3","49","9.6","7.2"
"Elbert","2020-05-25","4","537","0","49","8.8","6.3"
"Elbert","2020-05-26","19","556","0","49","8.1","5.8"
"Elbert","2020-05-27","23","579","0","49","6.5","5.8"
"Elbert","2020-05-28","19","598","1","50","6.1","5.7"
"Elbert","2020-05-29","9","607","0","50","6.1","5.2"
"Elbert","2020-05-30","6","613","1","51","8.5","6.4"
"Elbert","2020-05-31","4","617","0","51","3.1","6.4"
"Elbert","2020-06-01","16","633","0","51","3.1","6"
"Elbert","2020-06-02","23","656","0","51","3.1","5.6"
"Elbert","2020-06-03","15","671","1","52","4.1","5.3"
"Elbert","2020-06-04","13","684","2","54","5.5","5.8"
"Elbert","2020-06-05","14","698","1","55","6.6","6.3"
"Elbert","2020-06-06","5","703","0","55","4.2","6.3"
"Elbert","2020-06-07","12","715","0","55","4.2","3.7"
"Elbert","2020-06-08","12","727","0","55","4.2","3.7"
"Elbert","2020-06-09","7","734","0","55","4.2","3.7"
"Elbert","2020-06-10","8","742","0","55","3.2","3.7"
"Elbert","2020-06-11","10","752","0","55","1","3.3"
"Elbert","2020-06-12","11","763","0","55","0","3.3"
"Elbert","2020-06-13","2","765","0","55","0","2.1"
"Elbert","2020-06-14","1","766","0","55","0","2.1"
"Elbert","2020-06-15","18","784","1","56","0.8","2.5"
"Elbert","2020-06-16","10","794","0","56","0.8","2.5"
"Elbert","2020-06-17","17","811","1","57","1.6","2.4"
"Elbert","2020-06-18","16","827","2","59","3.4","2.2"
"Elbert","2020-06-19","10","837","0","59","3.4","1.7"
"Elbert","2020-06-20","7","844","0","59","3.4","1.7"
"Elbert","2020-06-21","6","850","0","59","3.4","1.7"
"Elbert","2020-06-22","18","868","1","60","3.4","2.1"
"Elbert","2020-06-23","17","885","2","62","5.1","2.9"
"Elbert","2020-06-24","18","903","0","62","4.3","2.9"
"Elbert","2020-06-25","21","924","3","65","4.5","4"
"Elbert","2020-06-26","18","942","3","68","6.9","5.2"
"Elbert","2020-06-27","6","948","3","71","14","8.7"
"Elbert","2020-06-28","4","952","0","71","14","8.7"
"Elbert","2020-06-29","19","971","0","71","13.2","8.3"
"Elbert","2020-06-30","14","985","1","72","12.6","8.8"
"Elbert","2020-07-01","9","994","1","73","14.2","9.2"
"Elbert","2020-07-02","9","1003","2","75","15.3","9.9"
"Elbert","2020-07-03","9","1012","0","75","12.9","9.9"
"Elbert","2020-07-04","2","1014","0","75","5.8","9.9"
"Elbert","2020-07-05","9","1023","2","77","9","11.5"
"Elbert","2020-07-06","27","1050","3","80","10.5","11.9"
"Elbert","2020-07-07","29","1079","4","84","11.5","12"
"Elbert","2020-07-08","17","1096","3","87","12.4","13.3"
"Elbert","2020-07-09","18","1114","1","88","10","12.7"
"Elbert","2020-07-10","8","1122","0","88","10","11.5"
"Elbert","2020-07-11","6","1128","1","89","12.4","9.1"
"Elbert","2020-07-12","7","1135","0","89","9.3","9.1"
"Elbert","2020-07-13","18","1153","2","91","9.3","9.9"
"Elbert","2020-07-14","21","1174","4","95","10","10.7"
"Elbert","2020-07-15","16","1190","1","96","8.4","10.4"
"Elbert","2020-07-16","15","1205","5","101","12.3","11.2"
"Elbert","2020-07-17","22","1227","5","106","15.6","12.8"
"Elbert","2020-07-18","3","1230","0","106","13.2","12.8"
"Elbert","2020-07-19","4","1234","0","106","13.2","11.2"
"Elbert","2020-07-20","25","1259","1","107","12.2","10.7"
"Elbert","2020-07-21","19","1278","2","109","11","10.5"
"Elbert","2020-07-22","24","1302","0","109","10.1","9.2"
"Elbert","2020-07-23","18","1320","2","111","6.9","9.6"
"Elbert","2020-07-24","27","1347","4","115","5.8","10.7"
"Elbert","2020-07-25","10","1357","5","120","12.9","13.1"
"Elbert","2020-07-26","9","1366","3","123","17.7","15.4"
"Elbert","2020-07-27","20","1386","3","126","19.3","15.7"
"Elbert","2020-07-28","15","1401","3","129","20.6","15.8"
"Elbert","2020-07-29","21","1422","3","132","22.6","16.4"
"Elbert","2020-07-30","19","1441","6","138","25.6","16.2"
"Elbert","2020-07-31","13","1454","2","140","25.7","15.7"
"Elbert","2020-08-01","15","1469","4","144","22.3","17.6"
"Elbert","2020-08-02","6","1475","1","145","19.9","18.8"
"Elbert","2020-08-03","13","1488","5","150","23.3","21.3"
"Elbert","2020-08-04","19","1507","2","152","21.9","21.3"
"Elbert","2020-08-05","21","1528","2","154","21.3","22"
"Elbert","2020-08-06","11","1539","1","155","18","21.8"
"Elbert","2020-08-07","15","1554","2","157","17.8","21.7"
"Elbert","2020-08-08","5","1559","1","158","16.8","19.6"
"Elbert","2020-08-09","9","1568","0","158","14.4","17.2"
"Elbert","2020-08-10","11","1579","0","158","8.9","16.1"
"Elbert","2020-08-11","8","1587","2","160","11","16.5"
"Elbert","2020-08-12","11","1598","3","163","13.5","17.4"
"Elbert","2020-08-13","16","1614","3","166","14.9","16.5"
"Elbert","2020-08-14","21","1635","8","174","18.4","18.1"
"Elbert","2020-08-15","6","1641","0","174","15.6","16.2"
"Elbert","2020-08-16","10","1651","1","175","17","15.7"
"Elbert","2020-08-17","14","1665","1","176","18","13.5"
"Elbert","2020-08-18","10","1675","3","179","18.8","14.9"
"Elbert","2020-08-19","44","1719","0","179","14.9","14.2"
"Elbert","2020-08-20","44","1763","2","181","12.8","13.9"
"Elbert","2020-08-21","23","1786","2","183","8.6","13.5"
"Elbert","2020-08-22","6","1792","0","183","8.6","12.1"
"Elbert","2020-08-23","10","1802","0","183","7.2","12.1"
"Elbert","2020-08-24","26","1828","6","189","9.5","13.8"
"Elbert","2020-08-25","20","1848","2","191","6.6","12.7"
"Elbert","2020-08-26","92","1940","6","197","7.5","11.2"
"Elbert","2020-08-27","22","1962","1","198","7.5","10.2"
"Elbert","2020-08-28","39","2001","11","209","10.3","9.5"
"Elbert","2020-08-29","9","2010","2","211","13.5","11.1"
"Elbert","2020-08-30","11","2021","1","212","14.8","11"
"Elbert","2020-08-31","21","2042","4","216","14.2","11.9"
"Elbert","2020-09-01","76","2118","20","236","16.6","11.6"
"Elbert","2020-09-02","34","2152","7","243","18.6","13.1"
"Elbert","2020-09-03","24","2176","4","247","20.3","13.9"
"Elbert","2020-09-04","18","2194","2","249","17.9","14.1"
"Elbert","2020-09-05","40","2234","1","250","15","14.3"
"Elbert","2020-09-06","24","2258","4","254","16.1","15.5"
"Elbert","2020-09-07","15","2273","3","257","16.3","15.2"
"Elbert","2020-09-08","26","2299","5","262","15.3","15.9"
"Elbert","2020-09-09","62","2361","22","284","17.4","18"
"Elbert","2020-09-10","19","2380","5","289","18.8","19.5"
"Elbert","2020-09-11","23","2403","1","290","17.8","17.8"
"Elbert","2020-09-12","26","2429","0","290","17.4","16.2"
"Elbert","2020-09-13","8","2437","2","292","18.6","17.4"
"Elbert","2020-09-14","21","2458","4","296","18.5","17.4"
"Elbert","2020-09-15","13","2471","2","298","17.9","16.6"
"Elbert","2020-09-16","16","2487","3","301","15.5","16.5"
"Elbert","2020-09-17","14","2501","1","302","12.8","15.8"
"Elbert","2020-09-18","20","2521","2","304","13.6","15.7"
"Elbert","2020-09-19","8","2529","1","305","15.4","16.4"
"Elbert","2020-09-20","3","2532","0","305","11.8","15.2"
"Elbert","2020-09-21","13","2545","3","308","12.4","15.4"
"Elbert","2020-09-22","16","2561","1","309","11.1","14.5"
"Elbert","2020-09-23","17","2578","1","310","9.3","12.4"
"Elbert","2020-09-24","19","2597","1","311","9","10.9"
"Elbert","2020-09-25","31","2628","0","311","7.6","10.6"
"Elbert","2020-09-26","12","2640","3","314","9.4","12.4"
"Elbert","2020-09-27","7","2647","2","316","13.4","12.6"
"Elbert","2020-09-28","16","2663","3","319","12.8","12.6"
"Elbert","2020-09-29","39","2702","3","322","13","12.1"
"Elbert","2020-09-30","12","2714","0","322","12.2","10.7"
"Elbert","2020-10-01","12","2726","1","323","12.6","10.8"
"Elbert","2020-10-02","25","2751","2","325","13.8","10.7"
"Elbert","2020-10-03","33","2784","1","326","10.6","10"
"Elbert","2020-10-04","33","2817","3","329","7.8","10.6"
"Elbert","2020-10-05","19","2836","1","330","5.9","9.4"
"Elbert","2020-10-06","20","2856","2","332","6.2","9.6"
"Elbert","2020-10-07","20","2876","2","334","7.7","9.9"
"Elbert","2020-10-08","62","2938","4","338","7.4","10"
"Elbert","2020-10-09","21","2959","5","343","9.7","11.7"
"Elbert","2020-10-10","16","2975","4","347","12.8","11.7"
"Elbert","2020-10-11","35","3010","1","348","11.9","9.9"
"Elbert","2020-10-12","18","3028","2","350","12.7","9.3"
"Elbert","2020-10-13","26","3054","3","353","13","9.6"
"Elbert","2020-10-14","20","3074","1","354","12.3","10"
"Elbert","2020-10-15","24","3098","5","359","14.3","10.9"
"Elbert","2020-10-16","44","3142","5","364","12.5","11.1"
"Elbert","2020-10-17","6","3148","1","365","11.3","12.1"
"Elbert","2020-10-18","75","3223","1","366","11.1","11.5"
"Elbert","2020-10-19","46","3269","5","371","11.1","11.9"
"Elbert","2020-10-20","47","3316","6","377","11.3","12.1"
"Elbert","2020-10-21","38","3354","6","383","12.8","12.5"
"Elbert","2020-10-22","56","3410","1","384","10.1","12.2"
"Elbert","2020-10-23","68","3478","1","385","8.7","10.6"
"Elbert","2020-10-24","5","3483","1","386","9.1","10.2"
"Elbert","2020-10-25","6","3489","1","387","11.3","11.2"
"Elbert","2020-10-26","54","3543","5","392","11.1","11.1"
"Elbert","2020-10-27","69","3612","7","399","10.7","11"
"Elbert","2020-10-28","48","3660","4","403","9.7","11.2"
"Elbert","2020-10-29","17","3677","0","403","9.4","9.7"
"Elbert","2020-10-30","89","3766","6","409","10.2","9.4"
"Elbert","2020-10-31","9","3775","0","409","7.3","8.2"
"Elbert","2020-11-01","34","3809","3","412","6.2","8.8"
"Elbert","2020-11-02","21","3830","7","419","9.6","10.4"
"Elbert","2020-11-03","15","3845","7","426","14.8","12.8"
"Elbert","2020-11-04","30","3875","5","431","16","12.8"
"Elbert","2020-11-05","30","3905","6","437","18.9","14.2"
"Elbert","2020-11-06","44","3949","6","443","19.9","15"
"Elbert","2020-11-07","59","4008","6","449","21.3","14.3"
"Elbert","2020-11-08","37","4045","3","452","21.2","13.7"
"Elbert","2020-11-09","41","4086","6","458","18.6","14.1"
"Elbert","2020-11-10","45","4131","10","468","15.1","15"
"Elbert","2020-11-11","19","4150","4","472","15.7","15.9"
"Elbert","2020-11-12","28","4178","6","478","15.9","17.4"
"Elbert","2020-11-13","84","4262","1","479","14.1","17"
"Elbert","2020-11-14","15","4277","2","481","14.6","17.9"
"Elbert","2020-11-15","14","4291","1","482","14.4","17.8"
"Elbert","2020-11-16","37","4328","5","487","14.3","16.4"
"Elbert","2020-11-17","60","4388","8","495","13","14"
"Elbert","2020-11-18","23","4411","4","499","12.5","14.1"
"Elbert","2020-11-19","52","4463","6","505","11.1","13.5"
"Elbert","2020-11-20","18","4481","2","507","12.5","13.3"
"Elbert","2020-11-21","21","4502","3","510","12.6","13.6"
"Elbert","2020-11-22","46","4548","5","515","13.1","13.8"
"Elbert","2020-11-23","26","4574","6","521","14.5","14.4"
"Elbert","2020-11-24","24","4598","2","523","13.8","13.4"
"Elbert","2020-11-25","21","4619","2","525","12.7","12.6"
"Elbert","2020-11-26","16","4635","0","525","11","11"
"Elbert","2020-11-27","21","4656","3","528","11.5","12"
"Elbert","2020-11-28","13","4669","7","535","17.1","14.9"
"Elbert","2020-11-29","13","4682","1","536","16.7","14.9"
"Elbert","2020-11-30","34","4716","6","542","15.9","15.2"
"Elbert","2020-12-01","17","4733","1","543","15.6","14.7"
"Elbert","2020-12-02","21","4754","0","543","14.2","13.4"
"Elbert","2020-12-03","50","4804","2","545","14.8","12.9"
"Elbert","2020-12-04","26","4830","5","550","15.5","13.5"
"Elbert","2020-12-05","11","4841","2","552","10.4","13.8"
"Elbert","2020-12-06","9","4850","4","556","15.6","16.2"
"Elbert","2020-12-07","27","4877","6","562","16.3","16.1"
"Elbert","2020-12-08","59","4936","9","571","17.6","16.6"
"Elbert","2020-12-09","35","4971","7","578","20.5","17.3"
"Elbert","2020-12-10","38","5009","9","587","23.3","19"
"Elbert","2020-12-11","47","5056","15","602","25.1","20.3"
"Elbert","2020-12-12","19","5075","9","611","29.3","19.8"
"Elbert","2020-12-13","13","5088","5","616","28.4","22"
"Elbert","2020-12-14","40","5128","8","624","28.1","22.2"
"Elbert","2020-12-15","33","5161","9","633","29.8","23.7"
"Elbert","2020-12-16","61","5222","13","646","30","25.2"
"Elbert","2020-12-17","55","5277","9","655","29","26.1"
"Elbert","2020-12-18","20","5297","6","661","28.7","26.9"
"Elbert","2020-12-19","14","5311","2","663","24","26.6"
"Elbert","2020-12-20","19","5330","3","666","20.7","24.6"
"Elbert","2020-12-21","29","5359","7","673","21.3","24.7"
"Elbert","2020-12-22","61","5420","5","678","18.6","24.2"
"Elbert","2020-12-23","38","5458","9","687","18.9","24.5"
"Elbert","2020-12-24","57","5515","8","695","18.6","23.8"
"Elbert","2020-12-25","5","5520","3","698","22.9","25.8"
"Elbert","2020-12-26","19","5539","8","706","26.8","25.4"
"Elbert","2020-12-27","16","5555","5","711","29.1","24.9"
"Elbert","2020-12-28","30","5585","8","719","29.4","25.4"
"Elbert","2020-12-29","32","5617","12","731","33.6","26.1"
"Elbert","2020-12-30","49","5666","9","740","32.8","25.9"
"Elbert","2020-12-31","42","5708","9","749","33.9","26.2"
"Elbert","2021-01-01","8","5716","2","751","28.9","25.9"
"Elbert","2021-01-02","24","5740","10","761","28.8","27.8"
"Elbert","2021-01-03","17","5757","3","764","26.9","28"
"Elbert","2021-01-04","36","5793","7","771","25.9","27.6"
"Elbert","2021-01-05","38","5831","10","781","24.3","28.9"
"Elbert","2021-01-06","50","5881","5","786","23.1","28"
"Elbert","2021-01-07","38","5919","7","793","22.6","28.3"
"Elbert","2021-01-08","35","5954","7","800","21.9","25.4"
"Elbert","2021-01-09","24","5978","7","807","20.1","24.5"
"Elbert","2021-01-10","23","6001","7","814","22","24.4"
"Elbert","2021-01-11","55","6056","11","825","22","24"
"Elbert","2021-01-12","56","6112","21","846","23.6","24"
"Elbert","2021-01-13","33","6145","10","856","26.5","24.8"
"Elbert","2021-01-14","43","6188","6","862","25.9","24.3"
"Elbert","2021-01-15","35","6223","8","870","26.3","24.1"
"Elbert","2021-01-16","18","6241","9","879","29.3","24.7"
"Elbert","2021-01-17","12","6253","5","884","30.9","26.4"
"Elbert","2021-01-18","45","6298","7","891","30.3","26.2"
"Elbert","2021-01-19","34","6332","11","902","29.5","26.6"
"Elbert","2021-01-20","34","6366","5","907","27.3","26.9"
"Elbert","2021-01-21","33","6399","7","914","28.3","27.1"
"Elbert","2021-01-22","33","6432","10","924","29.4","27.9"
"Elbert","2021-01-23","22","6454","8","932","27.5","28.4"
"Elbert","2021-01-24","13","6467","4","936","25.9","28.4"
"Elbert","2021-01-25","12","6479","2","938","26.1","28.2"
"Elbert","2021-01-26","9","6488","2","940","24.6","27.1"
"Elbert","2021-01-27","0","6488","0","940","22.5","24.9"
"Emanuel","2020-02-01","0","0","0","0",".","."
"Emanuel","2020-02-02","0","0","0","0",".","."
"Emanuel","2020-02-03","0","0","0","0",".","."
"Emanuel","2020-02-04","0","0","0","0",".","."
"Emanuel","2020-02-05","0","0","0","0",".","."
"Emanuel","2020-02-06","0","0","0","0",".","."
"Emanuel","2020-02-07","0","0","0","0","0","."
"Emanuel","2020-02-08","0","0","0","0","0","."
"Emanuel","2020-02-09","0","0","0","0","0","."
"Emanuel","2020-02-10","0","0","0","0","0","."
"Emanuel","2020-02-11","0","0","0","0","0","."
"Emanuel","2020-02-12","0","0","0","0","0","."
"Emanuel","2020-02-13","0","0","0","0","0","."
"Emanuel","2020-02-14","0","0","0","0","0","0"
"Emanuel","2020-02-15","0","0","0","0","0","0"
"Emanuel","2020-02-16","0","0","0","0","0","0"
"Emanuel","2020-02-17","0","0","0","0","0","0"
"Emanuel","2020-02-18","0","0","0","0","0","0"
"Emanuel","2020-02-19","0","0","0","0","0","0"
"Emanuel","2020-02-20","0","0","0","0","0","0"
"Emanuel","2020-02-21","0","0","0","0","0","0"
"Emanuel","2020-02-22","0","0","0","0","0","0"
"Emanuel","2020-02-23","0","0","0","0","0","0"
"Emanuel","2020-02-24","0","0","0","0","0","0"
"Emanuel","2020-02-25","0","0","0","0","0","0"
"Emanuel","2020-02-26","0","0","0","0","0","0"
"Emanuel","2020-02-27","0","0","0","0","0","0"
"Emanuel","2020-02-28","0","0","0","0","0","0"
"Emanuel","2020-02-29","0","0","0","0","0","0"
"Emanuel","2020-03-01","0","0","0","0","0","0"
"Emanuel","2020-03-02","0","0","0","0","0","0"
"Emanuel","2020-03-03","0","0","0","0","0","0"
"Emanuel","2020-03-04","0","0","0","0","0","0"
"Emanuel","2020-03-05","0","0","0","0","0","0"
"Emanuel","2020-03-06","0","0","0","0","0","0"
"Emanuel","2020-03-07","0","0","0","0","0","0"
"Emanuel","2020-03-08","0","0","0","0","0","0"
"Emanuel","2020-03-09","0","0","0","0","0","0"
"Emanuel","2020-03-10","0","0","0","0","0","0"
"Emanuel","2020-03-11","2","2","0","0","0","0"
"Emanuel","2020-03-12","0","2","0","0","0","0"
"Emanuel","2020-03-13","0","2","0","0","0","0"
"Emanuel","2020-03-14","0","2","0","0","0","0"
"Emanuel","2020-03-15","1","3","0","0","0","0"
"Emanuel","2020-03-16","9","12","0","0","0","0"
"Emanuel","2020-03-17","1","13","0","0","0","0"
"Emanuel","2020-03-18","5","18","0","0","0","0"
"Emanuel","2020-03-19","4","22","1","1","3.6","1.8"
"Emanuel","2020-03-20","4","26","0","1","3.6","1.8"
"Emanuel","2020-03-21","0","26","0","1","3.6","1.8"
"Emanuel","2020-03-22","1","27","0","1","3.6","1.8"
"Emanuel","2020-03-23","2","29","0","1","3.6","1.8"
"Emanuel","2020-03-24","4","33","0","1","3.6","1.8"
"Emanuel","2020-03-25","2","35","0","1","3.6","1.8"
"Emanuel","2020-03-26","2","37","0","1","0","1.8"
"Emanuel","2020-03-27","0","37","0","1","0","1.8"
"Emanuel","2020-03-28","1","38","0","1","0","1.8"
"Emanuel","2020-03-29","0","38","0","1","0","1.8"
"Emanuel","2020-03-30","3","41","0","1","0","1.8"
"Emanuel","2020-03-31","2","43","0","1","0","1.8"
"Emanuel","2020-04-01","7","50","1","2","2","2.8"
"Emanuel","2020-04-02","3","53","1","3","6.8","3.4"
"Emanuel","2020-04-03","1","54","0","3","6.8","3.4"
"Emanuel","2020-04-04","1","55","0","3","6.8","3.4"
"Emanuel","2020-04-05","2","57","0","3","6.8","3.4"
"Emanuel","2020-04-06","8","65","0","3","6.8","3.4"
"Emanuel","2020-04-07","8","73","0","3","6.8","3.4"
"Emanuel","2020-04-08","7","80","1","4","6.8","4.4"
"Emanuel","2020-04-09","6","86","0","4","2","4.4"
"Emanuel","2020-04-10","10","96","0","4","2","4.4"
"Emanuel","2020-04-11","1","97","0","4","2","4.4"
"Emanuel","2020-04-12","4","101","1","5","5.6","6.2"
"Emanuel","2020-04-13","6","107","1","6","8","7.4"
"Emanuel","2020-04-14","6","113","2","8","12.8","9.8"
"Emanuel","2020-04-15","4","117","1","9","14.3","10.5"
"Emanuel","2020-04-16","15","132","2","11","16.2","9.1"
"Emanuel","2020-04-17","12","144","0","11","16.2","9.1"
"Emanuel","2020-04-18","0","144","0","11","16.2","9.1"
"Emanuel","2020-04-19","7","151","1","12","14.7","10.1"
"Emanuel","2020-04-20","8","159","0","12","12.3","10.1"
"Emanuel","2020-04-21","11","170","0","12","7.5","10.1"
"Emanuel","2020-04-22","4","174","0","12","3.9","9.1"
"Emanuel","2020-04-23","8","182","0","12","2","9.1"
"Emanuel","2020-04-24","6","188","0","12","2","9.1"
"Emanuel","2020-04-25","2","190","0","12","2","9.1"
"Emanuel","2020-04-26","2","192","0","12","0","7.3"
"Emanuel","2020-04-27","6","198","2","14","4.8","8.5"
"Emanuel","2020-04-28","2","200","1","15","11.9","9.7"
"Emanuel","2020-04-29","9","209","0","15","11.9","7.9"
"Emanuel","2020-04-30","5","214","0","15","11.9","7"
"Emanuel","2020-05-01","10","224","0","15","11.9","7"
"Emanuel","2020-05-02","5","229","0","15","11.9","7"
"Emanuel","2020-05-03","3","232","0","15","11.9","6"
"Emanuel","2020-05-04","21","253","0","15","7.1","6"
"Emanuel","2020-05-05","9","262","0","15","0","6"
"Emanuel","2020-05-06","8","270","1","16","1.8","6.8"
"Emanuel","2020-05-07","10","280","0","16","1.8","6.8"
"Emanuel","2020-05-08","96","376","0","16","1.8","6.8"
"Emanuel","2020-05-09","6","382","0","16","1.8","6.8"
"Emanuel","2020-05-10","0","382","0","16","1.8","6.8"
"Emanuel","2020-05-11","15","397","0","16","1.8","4.5"
"Emanuel","2020-05-12","13","410","0","16","1.8","0.9"
"Emanuel","2020-05-13","14","424","0","16","0","0.9"
"Emanuel","2020-05-14","4","428","0","16","0","0.9"
"Emanuel","2020-05-15","12","440","2","18","2.4","2.1"
"Emanuel","2020-05-16","4","444","0","18","2.4","2.1"
"Emanuel","2020-05-17","3","447","0","18","2.4","2.1"
"Emanuel","2020-05-18","11","458","1","19","3.7","2.7"
"Emanuel","2020-05-19","11","469","0","19","3.7","2.7"
"Emanuel","2020-05-20","14","483","0","19","3.7","1.8"
"Emanuel","2020-05-21","21","504","0","19","3.7","1.8"
"Emanuel","2020-05-22","19","523","0","19","1.3","1.8"
"Emanuel","2020-05-23","12","535","1","20","2.5","2.4"
"Emanuel","2020-05-24","5","540","0","20","2.5","2.4"
"Emanuel","2020-05-25","1","541","0","20","1.2","2.4"
"Emanuel","2020-05-26","6","547","0","20","1.2","2.4"
"Emanuel","2020-05-27","6","553","0","20","1.2","2.4"
"Emanuel","2020-05-28","20","573","1","21","1.9","2.8"
"Emanuel","2020-05-29","13","586","0","21","1.9","1.6"
"Emanuel","2020-05-30","2","588","0","21","0.7","1.6"
"Emanuel","2020-05-31","0","588","0","21","0.7","1.6"
"Emanuel","2020-06-01","8","596","1","22","2.5","1.8"
"Emanuel","2020-06-02","19","615","0","22","2.5","1.8"
"Emanuel","2020-06-03","5","620","1","23","5.4","3.3"
"Emanuel","2020-06-04","10","630","2","25","7.5","4.7"
"Emanuel","2020-06-05","6","636","0","25","7.5","4.7"
"Emanuel","2020-06-06","1","637","0","25","7.5","4.1"
"Emanuel","2020-06-07","2","639","0","25","7.5","4.1"
"Emanuel","2020-06-08","10","649","0","25","5.7","4.1"
"Emanuel","2020-06-09","8","657","0","25","5.7","4.1"
"Emanuel","2020-06-10","21","678","3","28","4.9","5.1"
"Emanuel","2020-06-11","12","690","3","31","5.6","6.6"
"Emanuel","2020-06-12","19","709","7","38","10.9","9.2"
"Emanuel","2020-06-13","10","719","0","38","10.9","9.2"
"Emanuel","2020-06-14","5","724","0","38","10.9","9.2"
"Emanuel","2020-06-15","20","744","4","42","13.7","9.7"
"Emanuel","2020-06-16","22","766","6","48","17.6","11.7"
"Emanuel","2020-06-17","13","779","4","52","20","12.4"
"Emanuel","2020-06-18","23","802","4","56","18.9","12.3"
"Emanuel","2020-06-19","20","822","1","57","14.3","12.6"
"Emanuel","2020-06-20","9","831","2","59","17.5","14.2"
"Emanuel","2020-06-21","12","843","2","61","19.9","15.4"
"Emanuel","2020-06-22","50","893","13","74","20.8","17.2"
"Emanuel","2020-06-23","36","929","2","76","17.7","17.6"
"Emanuel","2020-06-24","54","983","14","90","17","18.5"
"Emanuel","2020-06-25","49","1032","16","106","19.1","19"
"Emanuel","2020-06-26","28","1060","3","109","20","17.2"
"Emanuel","2020-06-27","23","1083","3","112","18.7","18.1"
"Emanuel","2020-06-28","5","1088","1","113","19.1","19.5"
"Emanuel","2020-06-29","51","1139","4","117","16.5","18.6"
"Emanuel","2020-06-30","142","1281","10","127","16.7","17.2"
"Emanuel","2020-07-01","64","1345","8","135","14.8","15.9"
"Emanuel","2020-07-02","62","1407","13","148","13.2","16.2"
"Emanuel","2020-07-03","22","1429","5","153","14.9","17.4"
"Emanuel","2020-07-04","20","1449","6","159","17.3","18"
"Emanuel","2020-07-05","13","1462","1","160","15.5","17.3"
"Emanuel","2020-07-06","49","1511","12","172","17.9","17.2"
"Emanuel","2020-07-07","37","1548","3","175","18.1","17.4"
"Emanuel","2020-07-08","49","1597","8","183","18.6","16.7"
"Emanuel","2020-07-09","50","1647","3","186","16.5","14.8"
"Emanuel","2020-07-10","100","1747","5","191","13.9","14.4"
"Emanuel","2020-07-11","14","1761","2","193","11.7","14.5"
"Emanuel","2020-07-12","5","1766","1","194","13.5","14.5"
"Emanuel","2020-07-13","40","1806","6","200","12.1","15"
"Emanuel","2020-07-14","54","1860","4","204","12","15"
"Emanuel","2020-07-15","55","1915","8","212","11.7","15.2"
"Emanuel","2020-07-16","68","1983","5","217","11.9","14.2"
"Emanuel","2020-07-17","45","2028","7","224","13.4","13.7"
"Emanuel","2020-07-18","24","2052","2","226","12.6","12.1"
"Emanuel","2020-07-19","4","2056","1","227","13.3","13.4"
"Emanuel","2020-07-20","10","2066","3","230","15.5","13.8"
"Emanuel","2020-07-21","145","2211","41","271","18.4","15.2"
"Emanuel","2020-07-22","68","2279","19","290","20.4","16"
"Emanuel","2020-07-23","44","2323","4","294","20.6","16.3"
"Emanuel","2020-07-24","52","2375","14","308","22.2","17.8"
"Emanuel","2020-07-25","143","2518","17","325","22.7","17.7"
"Emanuel","2020-07-26","8","2526","0","325","19.2","16.2"
"Emanuel","2020-07-27","33","2559","6","331","17.5","16.5"
"Emanuel","2020-07-28","70","2629","38","369","21.2","19.8"
"Emanuel","2020-07-29","97","2726","27","396","21.2","20.8"
"Emanuel","2020-07-30","59","2785","18","414","24.2","22.4"
"Emanuel","2020-07-31","55","2840","17","431","24.8","23.5"
"Emanuel","2020-08-01","61","2901","21","452","28","25.4"
"Emanuel","2020-08-02","28","2929","3","455","29.6","24.4"
"Emanuel","2020-08-03","16","2945","7","462","33.2","25.3"
"Emanuel","2020-08-04","37","2982","7","469","28.2","24.7"
"Emanuel","2020-08-05","107","3089","45","514","30.2","25.7"
"Emanuel","2020-08-06","52","3141","19","533","31","27.6"
"Emanuel","2020-08-07","48","3189","11","544","29.9","27.4"
"Emanuel","2020-08-08","31","3220","9","553","29.1","28.6"
"Emanuel","2020-08-09","8","3228","1","554","29.4","29.5"
"Emanuel","2020-08-10","21","3249","4","558","25.9","29.5"
"Emanuel","2020-08-11","23","3272","5","563","26.3","27.2"
"Emanuel","2020-08-12","46","3318","7","570","22.4","26.3"
"Emanuel","2020-08-13","50","3368","6","576","18.9","25"
"Emanuel","2020-08-14","54","3422","16","592","19.9","24.9"
"Emanuel","2020-08-15","64","3486","6","598","17.1","23.1"
"Emanuel","2020-08-16","10","3496","1","599","16.7","23.1"
"Emanuel","2020-08-17","13","3509","3","602","17.3","21.6"
"Emanuel","2020-08-18","52","3561","7","609","16.1","21.2"
"Emanuel","2020-08-19","70","3631","7","616","15.4","18.9"
"Emanuel","2020-08-20","72","3703","10","626","15.6","17.3"
"Emanuel","2020-08-21","55","3758","9","635","13.7","16.8"
"Emanuel","2020-08-22","29","3787","6","641","15.4","16.2"
"Emanuel","2020-08-23","12","3799","1","642","15.1","15.9"
"Emanuel","2020-08-24","53","3852","7","649","13.7","15.5"
"Emanuel","2020-08-25","43","3895","4","653","13.1","14.6"
"Emanuel","2020-08-26","42","3937","11","664","15.4","15.4"
"Emanuel","2020-08-27","60","3997","14","678","16.8","16.2"
"Emanuel","2020-08-28","108","4105","22","700","17.3","15.5"
"Emanuel","2020-08-29","48","4153","13","713","18.3","16.8"
"Emanuel","2020-08-30","24","4177","3","716","18.9","17"
"Emanuel","2020-08-31","39","4216","11","727","21","17.4"
"Emanuel","2020-09-01","92","4308","20","747","22.8","17.9"
"Emanuel","2020-09-02","33","4341","10","757","23.4","19.4"
"Emanuel","2020-09-03","65","4406","13","770","22.9","19.8"
"Emanuel","2020-09-04","120","4526","23","793","22.7","20"
"Emanuel","2020-09-05","41","4567","15","808","24.1","21.2"
"Emanuel","2020-09-06","15","4582","5","813","27","23"
"Emanuel","2020-09-07","10","4592","1","814","24.4","22.7"
"Emanuel","2020-09-08","82","4674","18","832","24.5","23.6"
"Emanuel","2020-09-09","40","4714","9","841","23.4","23.4"
"Emanuel","2020-09-10","56","4770","13","854","23.8","23.4"
"Emanuel","2020-09-11","91","4861","12","866","23","22.8"
"Emanuel","2020-09-12","29","4890","11","877","23.2","23.6"
"Emanuel","2020-09-13","8","4898","3","880","23.8","25.4"
"Emanuel","2020-09-14","47","4945","7","887","24.5","24.5"
"Emanuel","2020-09-15","96","5041","14","901","23.4","23.9"
"Emanuel","2020-09-16","44","5085","4","905","21.5","22.4"
"Emanuel","2020-09-17","35","5120","10","915","22.3","23"
"Emanuel","2020-09-18","68","5188","18","933","24.1","23.6"
"Emanuel","2020-09-19","27","5215","6","939","21.9","22.5"
"Emanuel","2020-09-20","6","5221","0","939","16.5","20.2"
"Emanuel","2020-09-21","30","5251","5","944","16.8","20.6"
"Emanuel","2020-09-22","87","5338","12","956","16.7","20"
"Emanuel","2020-09-23","17","5355","1","957","16.2","18.9"
"Emanuel","2020-09-24","29","5384","2","959","13.1","17.7"
"Emanuel","2020-09-25","85","5469","17","976","12.2","18.2"
"Emanuel","2020-09-26","10","5479","1","977","10.5","16.2"
"Emanuel","2020-09-27","5","5484","0","977","10.5","13.5"
"Emanuel","2020-09-28","29","5513","4","981","10.1","13.4"
"Emanuel","2020-09-29","67","5580","12","993","10.6","13.7"
"Emanuel","2020-09-30","17","5597","5","998","14","15.1"
"Emanuel","2020-10-01","25","5622","3","1001","14.7","13.9"
"Emanuel","2020-10-02","83","5705","12","1013","13.9","13.1"
"Emanuel","2020-10-03","10","5715","2","1015","15.4","12.9"
"Emanuel","2020-10-04","4","5719","0","1015","15.4","12.9"
"Emanuel","2020-10-05","29","5748","4","1019","15.4","12.7"
"Emanuel","2020-10-06","66","5814","6","1025","14.1","12.4"
"Emanuel","2020-10-07","26","5840","4","1029","12.1","13.1"
"Emanuel","2020-10-08","24","5864","5","1034","13.4","14"
"Emanuel","2020-10-09","43","5907","3","1037","12.3","13.1"
"Emanuel","2020-10-10","13","5920","2","1039","11.6","13.5"
"Emanuel","2020-10-11","3","5923","1","1040","16.4","15.9"
"Emanuel","2020-10-12","11","5934","3","1043","18.3","16.8"
"Emanuel","2020-10-13","49","5983","4","1047","18.2","16.2"
"Emanuel","2020-10-14","24","6007","2","1049","17.2","14.6"
"Emanuel","2020-10-15","26","6033","7","1056","18.1","15.7"
"Emanuel","2020-10-16","46","6079","7","1063","19.2","15.8"
"Emanuel","2020-10-17","19","6098","4","1067","20","15.8"
"Emanuel","2020-10-18","4","6102","2","1069","22.4","19.4"
"Emanuel","2020-10-19","13","6115","0","1069","18.5","18.4"
"Emanuel","2020-10-20","45","6160","10","1079","20.5","19.4"
"Emanuel","2020-10-21","25","6185","4","1083","21.6","19.4"
"Emanuel","2020-10-22","27","6212","9","1092","22.5","20.3"
"Emanuel","2020-10-23","27","6239","5","1097","23","21.1"
"Emanuel","2020-10-24","49","6288","26","1123","27.6","23.8"
"Emanuel","2020-10-25","3","6291","0","1123","20.4","21.4"
"Emanuel","2020-10-26","22","6313","1","1124","21.1","19.8"
"Emanuel","2020-10-27","46","6359","6","1130","19.8","20.2"
"Emanuel","2020-10-28","16","6375","1","1131","18.4","20"
"Emanuel","2020-10-29","13","6388","2","1133","15.8","19.2"
"Emanuel","2020-10-30","34","6422","3","1136","14.4","18.7"
"Emanuel","2020-10-31","5","6427","2","1138","12.6","20.1"
"Emanuel","2020-11-01","4","6431","0","1138","12.6","16.5"
"Emanuel","2020-11-02","21","6452","2","1140","13.3","17.2"
"Emanuel","2020-11-03","31","6483","3","1143","12.8","16.3"
"Emanuel","2020-11-04","17","6500","2","1145","13.6","16"
"Emanuel","2020-11-05","15","6515","2","1147","13.3","14.6"
"Emanuel","2020-11-06","48","6563","7","1154","14.1","14.3"
"Emanuel","2020-11-07","7","6570","2","1156","12.5","12.5"
"Emanuel","2020-11-08","7","6577","2","1158","16.6","14.6"
"Emanuel","2020-11-09","17","6594","1","1159","16.1","14.7"
"Emanuel","2020-11-10","38","6632","2","1161","15.4","14.1"
"Emanuel","2020-11-11","18","6650","0","1161","13.7","13.7"
"Emanuel","2020-11-12","6","6656","0","1161","11.8","12.6"
"Emanuel","2020-11-13","41","6697","2","1163","10.5","12.3"
"Emanuel","2020-11-14","2","6699","0","1163","6.4","9.4"
"Emanuel","2020-11-15","7","6706","1","1164","4.3","10.5"
"Emanuel","2020-11-16","13","6719","0","1164","3.5","9.8"
"Emanuel","2020-11-17","48","6767","2","1166","3.3","9.4"
"Emanuel","2020-11-18","20","6787","2","1168","4.8","9.3"
"Emanuel","2020-11-19","15","6802","1","1169","5.7","8.8"
"Emanuel","2020-11-20","48","6850","1","1170","5.3","7.9"
"Emanuel","2020-11-21","7","6857","0","1170","5.3","5.8"
"Emanuel","2020-11-22","6","6863","1","1171","5.7","5"
"Emanuel","2020-11-23","22","6885","0","1171","5.7","4.6"
"Emanuel","2020-11-24","33","6918","2","1173","5.9","4.6"
"Emanuel","2020-11-25","10","6928","1","1174","5.9","5.3"
"Emanuel","2020-11-26","7","6935","0","1174","5","5.3"
"Emanuel","2020-11-27","14","6949","2","1176","6.7","6"
"Emanuel","2020-11-28","8","6957","3","1179","12.1","8.7"
"Emanuel","2020-11-29","5","6962","2","1181","15.4","10.5"
"Emanuel","2020-11-30","12","6974","2","1183","17.8","11.7"
"Emanuel","2020-12-01","50","7024","5","1188","18.4","12.1"
"Emanuel","2020-12-02","11","7035","3","1191","20.8","13.4"
"Emanuel","2020-12-03","7","7042","0","1191","20.8","12.9"
"Emanuel","2020-12-04","35","7077","4","1195","20.4","13.6"
"Emanuel","2020-12-05","10","7087","3","1198","19.3","15.7"
"Emanuel","2020-12-06","1","7088","0","1198","13.6","14.5"
"Emanuel","2020-12-07","30","7118","3","1201","12.7","15.2"
"Emanuel","2020-12-08","59","7177","6","1207","12.7","15.5"
"Emanuel","2020-12-09","21","7198","3","1210","10.8","15.8"
"Emanuel","2020-12-10","21","7219","2","1212","12.2","16.5"
"Emanuel","2020-12-11","30","7249","2","1214","11.5","16"
"Emanuel","2020-12-12","10","7259","0","1214","7.2","13.3"
"Emanuel","2020-12-13","6","7265","3","1217","14.4","14"
"Emanuel","2020-12-14","22","7287","5","1222","16.2","14.4"
"Emanuel","2020-12-15","81","7368","4","1226","15.4","14.1"
"Emanuel","2020-12-16","36","7404","9","1235","17","13.9"
"Emanuel","2020-12-17","34","7438","4","1239","17.3","14.8"
"Emanuel","2020-12-18","22","7460","4","1243","18.9","15.2"
"Emanuel","2020-12-19","7","7467","2","1245","23","15.1"
"Emanuel","2020-12-20","9","7476","3","1248","20.6","17.5"
"Emanuel","2020-12-21","48","7524","12","1260","21","18.6"
"Emanuel","2020-12-22","94","7618","19","1279","23.2","19.3"
"Emanuel","2020-12-23","70","7688","6","1285","20.8","18.9"
"Emanuel","2020-12-24","4","7692","1","1286","22.7","20"
"Emanuel","2020-12-25","2","7694","0","1286","20.1","19.5"
"Emanuel","2020-12-26","14","7708","6","1292","22.1","22.6"
"Emanuel","2020-12-27","10","7718","4","1296","23.1","21.9"
"Emanuel","2020-12-28","89","7807","16","1312","22.1","21.5"
"Emanuel","2020-12-29","132","7939","29","1341","22.3","22.7"
"Emanuel","2020-12-30","50","7989","9","1350","23.7","22.2"
"Emanuel","2020-12-31","44","8033","4","1354","21.4","22.1"
"Emanuel","2021-01-01","10","8043","1","1355","22.8","21.5"
"Emanuel","2021-01-02","14","8057","6","1361","22.8","22.5"
"Emanuel","2021-01-03","15","8072","6","1367","22.8","23"
"Emanuel","2021-01-04","43","8115","8","1375","22.9","22.5"
"Emanuel","2021-01-05","235","8350","45","1420","22.5","22.4"
"Emanuel","2021-01-06","25","8375","5","1425","22.8","23.3"
"Emanuel","2021-01-07","26","8401","6","1431","24.8","23.1"
"Emanuel","2021-01-08","24","8425","6","1437","27","24.9"
"Emanuel","2021-01-09","9","8434","1","1438","22.4","22.6"
"Emanuel","2021-01-10","12","8446","6","1444","23.8","23.3"
"Emanuel","2021-01-11","31","8477","11","1455","26.3","24.6"
"Emanuel","2021-01-12","30","8507","6","1461","26.4","24.5"
"Emanuel","2021-01-13","64","8571","6","1467","24.9","23.8"
"Emanuel","2021-01-14","33","8604","7","1474","24.6","24.7"
"Emanuel","2021-01-15","38","8642","3","1477","22.2","24.6"
"Emanuel","2021-01-16","9","8651","2","1479","23.7","23.1"
"Emanuel","2021-01-17","10","8661","1","1480","18","20.9"
"Emanuel","2021-01-18","9","8670","0","1480","13","19.6"
"Emanuel","2021-01-19","27","8697","1","1481","10.6","18.5"
"Emanuel","2021-01-20","45","8742","8","1489","11.8","18.3"
"Emanuel","2021-01-21","41","8783","5","1494","10.5","17.6"
"Emanuel","2021-01-22","45","8828","6","1500","11.3","16.7"
"Emanuel","2021-01-23","8","8836","2","1502","11.7","17.7"
"Emanuel","2021-01-24","12","8848","1","1503","11.5","14.8"
"Emanuel","2021-01-25","7","8855","0","1503","11.5","12.2"
"Emanuel","2021-01-26","5","8860","0","1503","10.9","10.8"
"Emanuel","2021-01-27","0","8860","0","1503","8.4","10.1"
"Evans","2020-02-01","0","0","0","0",".","."
"Evans","2020-02-02","0","0","0","0",".","."
"Evans","2020-02-03","0","0","0","0",".","."
"Evans","2020-02-04","0","0","0","0",".","."
"Evans","2020-02-05","0","0","0","0",".","."
"Evans","2020-02-06","0","0","0","0",".","."
"Evans","2020-02-07","0","0","0","0","0","."
"Evans","2020-02-08","0","0","0","0","0","."
"Evans","2020-02-09","0","0","0","0","0","."
"Evans","2020-02-10","0","0","0","0","0","."
"Evans","2020-02-11","0","0","0","0","0","."
"Evans","2020-02-12","0","0","0","0","0","."
"Evans","2020-02-13","0","0","0","0","0","."
"Evans","2020-02-14","0","0","0","0","0","0"
"Evans","2020-02-15","0","0","0","0","0","0"
"Evans","2020-02-16","0","0","0","0","0","0"
"Evans","2020-02-17","0","0","0","0","0","0"
"Evans","2020-02-18","0","0","0","0","0","0"
"Evans","2020-02-19","0","0","0","0","0","0"
"Evans","2020-02-20","0","0","0","0","0","0"
"Evans","2020-02-21","0","0","0","0","0","0"
"Evans","2020-02-22","0","0","0","0","0","0"
"Evans","2020-02-23","0","0","0","0","0","0"
"Evans","2020-02-24","0","0","0","0","0","0"
"Evans","2020-02-25","0","0","0","0","0","0"
"Evans","2020-02-26","0","0","0","0","0","0"
"Evans","2020-02-27","0","0","0","0","0","0"
"Evans","2020-02-28","0","0","0","0","0","0"
"Evans","2020-02-29","0","0","0","0","0","0"
"Evans","2020-03-01","0","0","0","0","0","0"
"Evans","2020-03-02","0","0","0","0","0","0"
"Evans","2020-03-03","0","0","0","0","0","0"
"Evans","2020-03-04","0","0","0","0","0","0"
"Evans","2020-03-05","0","0","0","0","0","0"
"Evans","2020-03-06","7","7","0","0","0","0"
"Evans","2020-03-07","0","7","0","0","0","0"
"Evans","2020-03-08","8","15","0","0","0","0"
"Evans","2020-03-09","0","15","0","0","0","0"
"Evans","2020-03-10","0","15","0","0","0","0"
"Evans","2020-03-11","0","15","0","0","0","0"
"Evans","2020-03-12","0","15","0","0","0","0"
"Evans","2020-03-13","0","15","0","0","0","0"
"Evans","2020-03-14","0","15","0","0","0","0"
"Evans","2020-03-15","0","15","0","0","0","0"
"Evans","2020-03-16","1","16","0","0","0","0"
"Evans","2020-03-17","1","17","0","0","0","0"
"Evans","2020-03-18","1","18","0","0","0","0"
"Evans","2020-03-19","0","18","0","0","0","0"
"Evans","2020-03-20","1","19","0","0","0","0"
"Evans","2020-03-21","0","19","0","0","0","0"
"Evans","2020-03-22","0","19","0","0","0","0"
"Evans","2020-03-23","0","19","0","0","0","0"
"Evans","2020-03-24","6","25","0","0","0","0"
"Evans","2020-03-25","4","29","0","0","0","0"
"Evans","2020-03-26","6","35","0","0","0","0"
"Evans","2020-03-27","1","36","0","0","0","0"
"Evans","2020-03-28","0","36","0","0","0","0"
"Evans","2020-03-29","0","36","0","0","0","0"
"Evans","2020-03-30","5","41","0","0","0","0"
"Evans","2020-03-31","0","41","0","0","0","0"
"Evans","2020-04-01","0","41","0","0","0","0"
"Evans","2020-04-02","9","50","0","0","0","0"
"Evans","2020-04-03","1","51","0","0","0","0"
"Evans","2020-04-04","3","54","0","0","0","0"
"Evans","2020-04-05","2","56","0","0","0","0"
"Evans","2020-04-06","2","58","0","0","0","0"
"Evans","2020-04-07","6","64","0","0","0","0"
"Evans","2020-04-08","4","68","0","0","0","0"
"Evans","2020-04-09","8","76","1","1","1.8","0.9"
"Evans","2020-04-10","5","81","0","1","1.8","0.9"
"Evans","2020-04-11","2","83","0","1","1.8","0.9"
"Evans","2020-04-12","0","83","0","1","1.8","0.9"
"Evans","2020-04-13","0","83","0","1","1.8","0.9"
"Evans","2020-04-14","11","94","1","2","3.1","1.5"
"Evans","2020-04-15","4","98","0","2","3.1","1.5"
"Evans","2020-04-16","9","107","0","2","1.3","1.5"
"Evans","2020-04-17","6","113","1","3","3.7","2.7"
"Evans","2020-04-18","3","116","0","3","3.7","2.7"
"Evans","2020-04-19","0","116","0","3","3.7","2.7"
"Evans","2020-04-20","2","118","0","3","3.7","2.7"
"Evans","2020-04-21","14","132","0","3","2.4","2.7"
"Evans","2020-04-22","9","141","0","3","2.4","2.7"
"Evans","2020-04-23","4","145","0","3","2.4","1.8"
"Evans","2020-04-24","6","151","0","3","0","1.8"
"Evans","2020-04-25","6","157","0","3","0","1.8"
"Evans","2020-04-26","0","157","0","3","0","1.8"
"Evans","2020-04-27","3","160","0","3","0","1.8"
"Evans","2020-04-28","5","165","0","3","0","1.2"
"Evans","2020-04-29","5","170","0","3","0","1.2"
"Evans","2020-04-30","12","182","0","3","0","1.2"
"Evans","2020-05-01","7","189","0","3","0","0"
"Evans","2020-05-02","2","191","0","3","0","0"
"Evans","2020-05-03","0","191","0","3","0","0"
"Evans","2020-05-04","5","196","0","3","0","0"
"Evans","2020-05-05","4","200","0","3","0","0"
"Evans","2020-05-06","19","219","0","3","0","0"
"Evans","2020-05-07","1","220","0","3","0","0"
"Evans","2020-05-08","5","225","0","3","0","0"
"Evans","2020-05-09","2","227","0","3","0","0"
"Evans","2020-05-10","1","228","0","3","0","0"
"Evans","2020-05-11","4","232","0","3","0","0"
"Evans","2020-05-12","4","236","0","3","0","0"
"Evans","2020-05-13","6","242","0","3","0","0"
"Evans","2020-05-14","4","246","0","3","0","0"
"Evans","2020-05-15","8","254","0","3","0","0"
"Evans","2020-05-16","44","298","0","3","0","0"
"Evans","2020-05-17","0","298","0","3","0","0"
"Evans","2020-05-18","6","304","0","3","0","0"
"Evans","2020-05-19","5","309","0","3","0","0"
"Evans","2020-05-20","8","317","0","3","0","0"
"Evans","2020-05-21","10","327","0","3","0","0"
"Evans","2020-05-22","5","332","0","3","0","0"
"Evans","2020-05-23","1","333","0","3","0","0"
"Evans","2020-05-24","0","333","0","3","0","0"
"Evans","2020-05-25","0","333","0","3","0","0"
"Evans","2020-05-26","2","335","0","3","0","0"
"Evans","2020-05-27","4","339","0","3","0","0"
"Evans","2020-05-28","1","340","0","3","0","0"
"Evans","2020-05-29","13","353","0","3","0","0"
"Evans","2020-05-30","5","358","0","3","0","0"
"Evans","2020-05-31","0","358","0","3","0","0"
"Evans","2020-06-01","6","364","0","3","0","0"
"Evans","2020-06-02","2","366","0","3","0","0"
"Evans","2020-06-03","7","373","0","3","0","0"
"Evans","2020-06-04","7","380","0","3","0","0"
"Evans","2020-06-05","4","384","0","3","0","0"
"Evans","2020-06-06","2","386","0","3","0","0"
"Evans","2020-06-07","2","388","0","3","0","0"
"Evans","2020-06-08","9","397","1","4","1.6","0.8"
"Evans","2020-06-09","5","402","0","4","1.6","0.8"
"Evans","2020-06-10","3","405","1","5","6.3","3.2"
"Evans","2020-06-11","14","419","0","5","6.3","3.2"
"Evans","2020-06-12","2","421","0","5","6.3","3.2"
"Evans","2020-06-13","1","422","0","5","6.3","3.2"
"Evans","2020-06-14","0","422","0","5","6.3","3.2"
"Evans","2020-06-15","5","427","0","5","4.8","3.2"
"Evans","2020-06-16","39","466","1","6","5.1","3.4"
"Evans","2020-06-17","10","476","0","6","0.4","3.4"
"Evans","2020-06-18","33","509","1","7","0.8","3.6"
"Evans","2020-06-19","7","516","0","7","0.8","3.6"
"Evans","2020-06-20","2","518","0","7","0.8","3.6"
"Evans","2020-06-21","2","520","1","8","7.9","7.1"
"Evans","2020-06-22","11","531","1","9","9.2","7"
"Evans","2020-06-23","12","543","0","9","8.9","7"
"Evans","2020-06-24","16","559","0","9","8.9","4.6"
"Evans","2020-06-25","7","566","0","9","8.4","4.6"
"Evans","2020-06-26","11","577","0","9","8.4","4.6"
"Evans","2020-06-27","4","581","0","9","8.4","4.6"
"Evans","2020-06-28","4","585","2","11","8.4","8.2"
"Evans","2020-06-29","10","595","1","12","8.6","8.9"
"Evans","2020-06-30","13","608","2","14","10.8","9.8"
"Evans","2020-07-01","13","621","1","15","11.9","10.4"
"Evans","2020-07-02","13","634","0","15","11.9","10.2"
"Evans","2020-07-03","12","646","2","17","14.2","11.3"
"Evans","2020-07-04","9","655","1","18","15.8","12.1"
"Evans","2020-07-05","4","659","2","20","15.8","12.1"
"Evans","2020-07-06","10","669","5","25","21.6","15.1"
"Evans","2020-07-07","11","680","1","26","20.7","15.7"
"Evans","2020-07-08","29","709","10","36","24.5","18.2"
"Evans","2020-07-09","16","725","5","41","28.9","20.4"
"Evans","2020-07-10","14","739","7","48","33.7","24"
"Evans","2020-07-11","7","746","2","50","36.2","26"
"Evans","2020-07-12","7","753","5","55","39.3","27.5"
"Evans","2020-07-13","22","775","5","60","35.4","28.5"
"Evans","2020-07-14","16","791","4","64","37.6","29.1"
"Evans","2020-07-15","11","802","4","68","37.9","31.2"
"Evans","2020-07-16","29","831","11","79","38.9","33.9"
"Evans","2020-07-17","7","838","1","80","33.8","33.7"
"Evans","2020-07-18","3","841","1","81","34.4","35.3"
"Evans","2020-07-19","1","842","0","81","24.2","31.7"
"Evans","2020-07-20","30","872","11","92","26.2","30.8"
"Evans","2020-07-21","37","909","13","105","27.7","32.7"
"Evans","2020-07-22","17","926","7","112","28.4","33.1"
"Evans","2020-07-23","17","943","2","114","24.6","31.7"
"Evans","2020-07-24","24","967","10","124","28.5","31.1"
"Evans","2020-07-25","9","976","4","128","30.1","32.3"
"Evans","2020-07-26","4","980","3","131","40.8","32.5"
"Evans","2020-07-27","17","997","3","134","38.1","32.2"
"Evans","2020-07-28","13","1010","3","137","36.4","32"
"Evans","2020-07-29","11","1021","2","139","33.1","30.7"
"Evans","2020-07-30","17","1038","7","146","37.3","31"
"Evans","2020-07-31","12","1050","3","149","34.9","31.7"
"Evans","2020-08-01","1","1051","1","150","42.9","36.5"
"Evans","2020-08-02","4","1055","3","153","42.9","41.9"
"Evans","2020-08-03","10","1065","2","155","43.2","40.7"
"Evans","2020-08-04","30","1095","3","158","41.3","38.9"
"Evans","2020-08-05","11","1106","2","160","41.3","37.2"
"Evans","2020-08-06","11","1117","3","163","39.4","38.3"
"Evans","2020-08-07","10","1127","3","166","40.1","37.5"
"Evans","2020-08-08","4","1131","2","168","32.9","37.9"
"Evans","2020-08-09","5","1136","1","169","25.1","34"
"Evans","2020-08-10","10","1146","4","173","27.9","35.6"
"Evans","2020-08-11","11","1157","4","177","31.7","36.5"
"Evans","2020-08-12","14","1171","3","180","32.2","36.7"
"Evans","2020-08-13","15","1186","3","183","31.1","35.2"
"Evans","2020-08-14","16","1202","1","184","27.7","33.9"
"Evans","2020-08-15","6","1208","1","185","23","27.9"
"Evans","2020-08-16","2","1210","0","185","20.1","22.6"
"Evans","2020-08-17","10","1220","2","187","17.2","22.6"
"Evans","2020-08-18","16","1236","1","188","12.9","22.3"
"Evans","2020-08-19","9","1245","2","190","13.1","22.6"
"Evans","2020-08-20","10","1255","1","191","11.6","21.4"
"Evans","2020-08-21","11","1266","1","192","12","19.9"
"Evans","2020-08-22","6","1272","3","195","16.8","19.9"
"Evans","2020-08-23","6","1278","0","195","16.8","18.4"
"Evans","2020-08-24","10","1288","0","195","13.9","15.6"
"Evans","2020-08-25","12","1300","2","197","15.4","14.2"
"Evans","2020-08-26","7","1307","2","199","16.3","14.7"
"Evans","2020-08-27","9","1316","1","200","16.5","14.1"
"Evans","2020-08-28","20","1336","3","203","17.3","14.7"
"Evans","2020-08-29","7","1343","1","204","12.2","14.5"
"Evans","2020-08-30","8","1351","1","205","14","15.4"
"Evans","2020-08-31","12","1363","2","207","16.4","15.2"
"Evans","2020-09-01","7","1370","2","209","18.1","16.8"
"Evans","2020-09-02","6","1376","2","211","18.8","17.6"
"Evans","2020-09-03","11","1387","0","211","17.2","16.8"
"Evans","2020-09-04","8","1395","2","213","18.6","18"
"Evans","2020-09-05","8","1403","1","214","18.4","15.3"
"Evans","2020-09-06","4","1407","0","214","16.6","15.3"
"Evans","2020-09-07","4","1411","0","214","14.2","15.3"
"Evans","2020-09-08","15","1426","4","218","13.9","16"
"Evans","2020-09-09","8","1434","0","218","9.2","14"
"Evans","2020-09-10","16","1450","1","219","10.1","13.6"
"Evans","2020-09-11","10","1460","0","219","6.5","12.6"
"Evans","2020-09-12","5","1465","0","219","4.7","11.5"
"Evans","2020-09-13","6","1471","1","220","7.1","11.8"
"Evans","2020-09-14","13","1484","0","220","7.1","10.6"
"Evans","2020-09-15","13","1497","1","221","4.4","9.2"
"Evans","2020-09-16","15","1512","0","221","4.4","6.8"
"Evans","2020-09-17","16","1528","2","223","5.3","7.7"
"Evans","2020-09-18","12","1540","1","224","6.5","6.5"
"Evans","2020-09-19","6","1546","0","224","6.5","5.6"
"Evans","2020-09-20","4","1550","0","224","4.1","5.6"
"Evans","2020-09-21","11","1561","0","224","4.1","5.6"
"Evans","2020-09-22","12","1573","2","226","5.4","4.9"
"Evans","2020-09-23","60","1633","2","228","5.8","5.1"
"Evans","2020-09-24","5","1638","2","230","9.8","7.5"
"Evans","2020-09-25","7","1645","1","231","10.6","8.5"
"Evans","2020-09-26","0","1645","0","231","10.6","8.5"
"Evans","2020-09-27","1","1646","0","231","10.6","7.3"
"Evans","2020-09-28","12","1658","3","234","14.2","9.1"
"Evans","2020-09-29","4","1662","0","234","11.8","8.6"
"Evans","2020-09-30","7","1669","0","234","11.3","8.6"
"Evans","2020-10-01","19","1688","0","234","5.6","7.7"
"Evans","2020-10-02","15","1703","0","234","3.6","7.1"
"Evans","2020-10-03","4","1707","0","234","3.6","7.1"
"Evans","2020-10-04","5","1712","0","234","3.6","7.1"
"Evans","2020-10-05","24","1736","1","235","0.6","7.4"
"Evans","2020-10-06","5","1741","0","235","0.6","6.2"
"Evans","2020-10-07","18","1759","1","236","1.4","6.4"
"Evans","2020-10-08","16","1775","4","240","5","5.3"
"Evans","2020-10-09","11","1786","1","241","6.3","4.9"
"Evans","2020-10-10","10","1796","0","241","6.3","4.9"
"Evans","2020-10-11","8","1804","1","242","8","5.8"
"Evans","2020-10-12","11","1815","1","243","8.7","4.7"
"Evans","2020-10-13","15","1830","7","250","15.4","8"
"Evans","2020-10-14","10","1840","0","250","14.6","8"
"Evans","2020-10-15","10","1850","2","252","13.9","9.4"
"Evans","2020-10-16","4","1854","0","252","12.6","9.4"
"Evans","2020-10-17","7","1861","3","255","18.7","12.5"
"Evans","2020-10-18","4","1865","0","255","16.9","12.5"
"Evans","2020-10-19","10","1875","3","258","19.9","14.3"
"Evans","2020-10-20","13","1888","4","262","17.7","16.5"
"Evans","2020-10-21","12","1900","0","262","17.7","16.1"
"Evans","2020-10-22","4","1904","0","262","14.8","14.4"
"Evans","2020-10-23","6","1910","1","263","17.2","14.9"
"Evans","2020-10-24","4","1914","0","263","11.1","14.9"
"Evans","2020-10-25","8","1922","1","264","12.8","14.9"
"Evans","2020-10-26","9","1931","1","265","10.1","15"
"Evans","2020-10-27","5","1936","1","266","8.6","13.1"
"Evans","2020-10-28","12","1948","2","268","11","14.3"
"Evans","2020-10-29","42","1990","1","269","11.3","13.1"
"Evans","2020-10-30","21","2011","0","269","9","13.1"
"Evans","2020-10-31","4","2015","2","271","16.1","13.6"
"Evans","2020-11-01","1","2016","0","271","14.3","13.6"
"Evans","2020-11-02","5","2021","0","271","12.7","11.4"
"Evans","2020-11-03","5","2026","1","272","12.7","10.7"
"Evans","2020-11-04","10","2036","2","274","13.2","12.1"
"Evans","2020-11-05","8","2044","1","275","14.6","13"
"Evans","2020-11-06","7","2051","1","276","16.7","12.8"
"Evans","2020-11-07","3","2054","0","276","9.5","12.8"
"Evans","2020-11-08","0","2054","0","276","9.5","11.9"
"Evans","2020-11-09","7","2061","0","276","9.5","11.1"
"Evans","2020-11-10","6","2067","0","276","6.7","9.7"
"Evans","2020-11-11","11","2078","1","277","5.1","9.2"
"Evans","2020-11-12","5","2083","1","278","6.2","10.4"
"Evans","2020-11-13","11","2094","0","278","4.2","10.4"
"Evans","2020-11-14","4","2098","0","278","4.2","6.8"
"Evans","2020-11-15","2","2100","1","279","11.3","10.4"
"Evans","2020-11-16","14","2114","3","282","14.4","12"
"Evans","2020-11-17","6","2120","2","284","19.1","12.9"
"Evans","2020-11-18","6","2126","0","284","17.8","11.5"
"Evans","2020-11-19","13","2139","3","287","18.3","12.2"
"Evans","2020-11-20","6","2145","0","287","18.3","11.2"
"Evans","2020-11-21","2","2147","0","287","18.3","11.2"
"Evans","2020-11-22","8","2155","1","288","12.9","12.1"
"Evans","2020-11-23","4","2159","0","288","9.8","12.1"
"Evans","2020-11-24","9","2168","0","288","5.1","12.1"
"Evans","2020-11-25","4","2172","0","288","5.1","11.5"
"Evans","2020-11-26","3","2175","0","288","1.8","10"
"Evans","2020-11-27","4","2179","0","288","1.8","10"
"Evans","2020-11-28","4","2183","0","288","1.8","10"
"Evans","2020-11-29","5","2188","1","289","2.9","7.9"
"Evans","2020-11-30","17","2205","1","290","3.7","6.8"
"Evans","2020-12-01","6","2211","1","291","6.1","5.6"
"Evans","2020-12-02","5","2216","0","291","6.1","5.6"
"Evans","2020-12-03","6","2222","0","291","6.1","3.9"
"Evans","2020-12-04","4","2226","0","291","6.1","3.9"
"Evans","2020-12-05","3","2229","2","293","15.6","8.7"
"Evans","2020-12-06","8","2237","0","293","12.7","7.8"
"Evans","2020-12-07","9","2246","2","295","15.1","9.4"
"Evans","2020-12-08","7","2253","0","295","12.7","9.4"
"Evans","2020-12-09","6","2259","1","296","15.1","10.6"
"Evans","2020-12-10","14","2273","1","297","16.1","11.1"
"Evans","2020-12-11","8","2281","0","297","16.1","11.1"
"Evans","2020-12-12","5","2286","2","299","12.3","13.9"
"Evans","2020-12-13","2","2288","0","299","12.3","12.5"
"Evans","2020-12-14","17","2305","3","302","11.6","13.4"
"Evans","2020-12-15","19","2324","5","307","15.4","14"
"Evans","2020-12-16","10","2334","0","307","13","14"
"Evans","2020-12-17","16","2350","5","312","16.5","16.3"
"Evans","2020-12-18","10","2360","2","314","19.3","17.7"
"Evans","2020-12-19","10","2370","1","315","15","13.7"
"Evans","2020-12-20","7","2377","0","315","15","13.7"
"Evans","2020-12-21","14","2391","1","316","13.5","12.6"
"Evans","2020-12-22","18","2409","5","321","13.7","14.6"
"Evans","2020-12-23","11","2420","2","323","16.3","14.7"
"Evans","2020-12-24","3","2423","0","323","11.9","14.2"
"Evans","2020-12-25","0","2423","0","323","9","14.2"
"Evans","2020-12-26","5","2428","0","323","7.6","11.3"
"Evans","2020-12-27","1","2429","0","323","7.6","11.3"
"Evans","2020-12-28","7","2436","1","324","8.6","11.1"
"Evans","2020-12-29","13","2449","1","325","5.7","9.7"
"Evans","2020-12-30","8","2457","3","328","8.5","12.4"
"Evans","2020-12-31","4","2461","3","331","19.2","15.5"
"Evans","2021-01-01","0","2461","0","331","19.2","14.1"
"Evans","2021-01-02","1","2462","0","331","19.2","13.4"
"Evans","2021-01-03","1","2463","0","331","19.2","13.4"
"Evans","2021-01-04","7","2470","2","333","21.3","14.9"
"Evans","2021-01-05","10","2480","2","335","23","14.4"
"Evans","2021-01-06","8","2488","1","336","19.4","14"
"Evans","2021-01-07","12","2500","3","339","12.3","15.8"
"Evans","2021-01-08","10","2510","3","342","16.6","17.9"
"Evans","2021-01-09","1","2511","1","343","30.9","25"
"Evans","2021-01-10","5","2516","0","343","30.9","25"
"Evans","2021-01-11","18","2534","4","347","30","25.6"
"Evans","2021-01-12","15","2549","2","349","29","26"
"Evans","2021-01-13","15","2564","2","351","29.1","24.3"
"Evans","2021-01-14","5","2569","1","352","28.4","20.4"
"Evans","2021-01-15","6","2575","1","353","26.5","21.5"
"Evans","2021-01-16","0","2575","0","353","12.2","21.5"
"Evans","2021-01-17","4","2579","1","354","15.8","23.3"
"Evans","2021-01-18","10","2589","0","354","12.6","21.3"
"Evans","2021-01-19","9","2598","2","356","13.9","21.4"
"Evans","2021-01-20","25","2623","7","363","16","22.6"
"Evans","2021-01-21","9","2632","0","363","13.1","20.8"
"Evans","2021-01-22","10","2642","3","366","15","20.8"
"Evans","2021-01-23","4","2646","0","366","15","13.6"
"Evans","2021-01-24","3","2649","2","368","21","18.4"
"Evans","2021-01-25","6","2655","2","370","25.7","19.2"
"Evans","2021-01-26","1","2656","1","371","36.9","25.4"
"Evans","2021-01-27","0","2656","0","371","32.9","24.4"
"Fannin","2020-02-01","0","0","0","0",".","."
"Fannin","2020-02-02","0","0","0","0",".","."
"Fannin","2020-02-03","0","0","0","0",".","."
"Fannin","2020-02-04","0","0","0","0",".","."
"Fannin","2020-02-05","0","0","0","0",".","."
"Fannin","2020-02-06","0","0","0","0",".","."
"Fannin","2020-02-07","0","0","0","0","0","."
"Fannin","2020-02-08","0","0","0","0","0","."
"Fannin","2020-02-09","0","0","0","0","0","."
"Fannin","2020-02-10","0","0","0","0","0","."
"Fannin","2020-02-11","0","0","0","0","0","."
"Fannin","2020-02-12","0","0","0","0","0","."
"Fannin","2020-02-13","0","0","0","0","0","."
"Fannin","2020-02-14","0","0","0","0","0","0"
"Fannin","2020-02-15","0","0","0","0","0","0"
"Fannin","2020-02-16","0","0","0","0","0","0"
"Fannin","2020-02-17","0","0","0","0","0","0"
"Fannin","2020-02-18","0","0","0","0","0","0"
"Fannin","2020-02-19","0","0","0","0","0","0"
"Fannin","2020-02-20","0","0","0","0","0","0"
"Fannin","2020-02-21","0","0","0","0","0","0"
"Fannin","2020-02-22","0","0","0","0","0","0"
"Fannin","2020-02-23","0","0","0","0","0","0"
"Fannin","2020-02-24","0","0","0","0","0","0"
"Fannin","2020-02-25","0","0","0","0","0","0"
"Fannin","2020-02-26","0","0","0","0","0","0"
"Fannin","2020-02-27","0","0","0","0","0","0"
"Fannin","2020-02-28","0","0","0","0","0","0"
"Fannin","2020-02-29","0","0","0","0","0","0"
"Fannin","2020-03-01","0","0","0","0","0","0"
"Fannin","2020-03-02","0","0","0","0","0","0"
"Fannin","2020-03-03","0","0","0","0","0","0"
"Fannin","2020-03-04","0","0","0","0","0","0"
"Fannin","2020-03-05","0","0","0","0","0","0"
"Fannin","2020-03-06","0","0","0","0","0","0"
"Fannin","2020-03-07","0","0","0","0","0","0"
"Fannin","2020-03-08","0","0","0","0","0","0"
"Fannin","2020-03-09","0","0","0","0","0","0"
"Fannin","2020-03-10","1","1","0","0","0","0"
"Fannin","2020-03-11","0","1","0","0","0","0"
"Fannin","2020-03-12","2","3","0","0","0","0"
"Fannin","2020-03-13","3","6","0","0","0","0"
"Fannin","2020-03-14","0","6","0","0","0","0"
"Fannin","2020-03-15","2","8","0","0","0","0"
"Fannin","2020-03-16","1","9","0","0","0","0"
"Fannin","2020-03-17","5","14","1","1","2.9","1.4"
"Fannin","2020-03-18","1","15","0","1","2.9","1.4"
"Fannin","2020-03-19","1","16","0","1","2.9","1.4"
"Fannin","2020-03-20","6","22","1","2","5.2","2.6"
"Fannin","2020-03-21","1","23","0","2","5.2","2.6"
"Fannin","2020-03-22","1","24","0","2","5.2","2.6"
"Fannin","2020-03-23","5","29","1","3","8.1","4"
"Fannin","2020-03-24","4","33","0","3","5.2","4"
"Fannin","2020-03-25","11","44","0","3","5.2","4"
"Fannin","2020-03-26","13","57","0","3","5.2","4"
"Fannin","2020-03-27","10","67","0","3","2.9","4"
"Fannin","2020-03-28","1","68","0","3","2.9","4"
"Fannin","2020-03-29","5","73","2","5","8.6","6.9"
"Fannin","2020-03-30","3","76","0","5","5.7","6.9"
"Fannin","2020-03-31","4","80","0","5","5.7","5.5"
"Fannin","2020-04-01","3","83","0","5","5.7","5.5"
"Fannin","2020-04-02","7","90","0","5","5.7","5.5"
"Fannin","2020-04-03","12","102","0","5","5.7","4.3"
"Fannin","2020-04-04","5","107","1","6","8.6","5.7"
"Fannin","2020-04-05","1","108","0","6","2.9","5.7"
"Fannin","2020-04-06","5","113","1","7","5.7","5.7"
"Fannin","2020-04-07","8","121","3","10","11.1","8.4"
"Fannin","2020-04-08","5","126","0","10","11.1","8.4"
"Fannin","2020-04-09","3","129","1","11","15.8","10.8"
"Fannin","2020-04-10","2","131","1","12","23","14.3"
"Fannin","2020-04-11","5","136","0","12","20.1","14.3"
"Fannin","2020-04-12","2","138","0","12","20.1","11.5"
"Fannin","2020-04-13","3","141","0","12","17.3","11.5"
"Fannin","2020-04-14","5","146","0","12","11.9","11.5"
"Fannin","2020-04-15","5","151","0","12","11.9","11.5"
"Fannin","2020-04-16","10","161","0","12","7.1","11.5"
"Fannin","2020-04-17","7","168","0","12","0","11.5"
"Fannin","2020-04-18","6","174","0","12","0","10.1"
"Fannin","2020-04-19","8","182","0","12","0","10.1"
"Fannin","2020-04-20","5","187","0","12","0","8.6"
"Fannin","2020-04-21","11","198","0","12","0","6"
"Fannin","2020-04-22","10","208","0","12","0","6"
"Fannin","2020-04-23","14","222","0","12","0","3.6"
"Fannin","2020-04-24","22","244","0","12","0","0"
"Fannin","2020-04-25","13","257","0","12","0","0"
"Fannin","2020-04-26","5","262","1","13","2.9","1.4"
"Fannin","2020-04-27","19","281","0","13","2.9","1.4"
"Fannin","2020-04-28","23","304","0","13","2.9","1.4"
"Fannin","2020-04-29","19","323","0","13","2.9","1.4"
"Fannin","2020-04-30","15","338","1","14","3.8","1.9"
"Fannin","2020-05-01","13","351","0","14","3.8","1.9"
"Fannin","2020-05-02","4","355","0","14","3.8","1.9"
"Fannin","2020-05-03","4","359","0","14","1","1.9"
"Fannin","2020-05-04","18","377","0","14","1","1.9"
"Fannin","2020-05-05","11","388","0","14","1","1.9"
"Fannin","2020-05-06","21","409","2","16","2.3","2.6"
"Fannin","2020-05-07","14","423","0","16","1.4","2.6"
"Fannin","2020-05-08","17","440","0","16","1.4","2.6"
"Fannin","2020-05-09","8","448","0","16","1.4","2.6"
"Fannin","2020-05-10","5","453","0","16","1.4","1.2"
"Fannin","2020-05-11","14","467","0","16","1.4","1.2"
"Fannin","2020-05-12","39","506","2","18","2.1","1.5"
"Fannin","2020-05-13","14","520","0","18","0.7","1.5"
"Fannin","2020-05-14","14","534","0","18","0.7","1"
"Fannin","2020-05-15","23","557","1","19","1.4","1.4"
"Fannin","2020-05-16","3","560","0","19","1.4","1.4"
"Fannin","2020-05-17","8","568","0","19","1.4","1.4"
"Fannin","2020-05-18","13","581","0","19","1.4","1.4"
"Fannin","2020-05-19","35","616","0","19","0.6","1.4"
"Fannin","2020-05-20","23","639","0","19","0.6","0.7"
"Fannin","2020-05-21","31","670","0","19","0.6","0.7"
"Fannin","2020-05-22","31","701","0","19","0","0.7"
"Fannin","2020-05-23","3","704","0","19","0","0.7"
"Fannin","2020-05-24","7","711","0","19","0","0.7"
"Fannin","2020-05-25","5","716","0","19","0","0.7"
"Fannin","2020-05-26","30","746","1","20","0.5","0.5"
"Fannin","2020-05-27","33","779","2","22","1.3","1"
"Fannin","2020-05-28","29","808","0","22","1.3","1"
"Fannin","2020-05-29","16","824","0","22","1.3","0.7"
"Fannin","2020-05-30","2","826","1","23","8.5","4.2"
"Fannin","2020-05-31","12","838","2","25","10.9","5.4"
"Fannin","2020-06-01","18","856","1","26","11.7","5.8"
"Fannin","2020-06-02","31","887","0","26","11.2","5.8"
"Fannin","2020-06-03","17","904","0","26","10.3","5.8"
"Fannin","2020-06-04","27","931","2","28","11.4","6.4"
"Fannin","2020-06-05","24","955","2","30","12.6","7"
"Fannin","2020-06-06","18","973","2","32","7","7.7"
"Fannin","2020-06-07","3","976","0","32","4.6","7.7"
"Fannin","2020-06-08","25","1001","2","34","5","8.3"
"Fannin","2020-06-09","34","1035","2","36","5.8","8.5"
"Fannin","2020-06-10","19","1054","2","38","7.3","8.8"
"Fannin","2020-06-11","27","1081","0","38","6.3","8.8"
"Fannin","2020-06-12","24","1105","1","39","5.7","9.1"
"Fannin","2020-06-13","3","1108","0","39","4.1","5.5"
"Fannin","2020-06-14","0","1108","0","39","4.1","4.4"
"Fannin","2020-06-15","22","1130","2","41","4.2","4.6"
"Fannin","2020-06-16","21","1151","1","42","4.1","4.9"
"Fannin","2020-06-17","20","1171","2","44","4","5.7"
"Fannin","2020-06-18","17","1188","1","45","4.8","5.6"
"Fannin","2020-06-19","12","1200","0","45","4.2","5"
"Fannin","2020-06-20","0","1200","0","45","4.2","4.2"
"Fannin","2020-06-21","2","1202","0","45","4.2","4.2"
"Fannin","2020-06-22","17","1219","1","46","3.8","4"
"Fannin","2020-06-23","24","1243","0","46","3.1","3.6"
"Fannin","2020-06-24","26","1269","2","48","2.8","3.4"
"Fannin","2020-06-25","22","1291","1","49","2.6","3.7"
"Fannin","2020-06-26","21","1312","0","49","2.6","3.4"
"Fannin","2020-06-27","18","1330","2","51","4.2","4.2"
"Fannin","2020-06-28","4","1334","0","51","4.2","4.2"
"Fannin","2020-06-29","17","1351","2","53","5","4.4"
"Fannin","2020-06-30","30","1381","4","57","6.9","5"
"Fannin","2020-07-01","13","1394","0","57","5.8","4.3"
"Fannin","2020-07-02","18","1412","0","57","5.2","3.9"
"Fannin","2020-07-03","15","1427","0","57","5.2","3.9"
"Fannin","2020-07-04","6","1433","0","57","3.6","3.9"
"Fannin","2020-07-05","5","1438","0","57","3.6","3.9"
"Fannin","2020-07-06","33","1471","2","59","2.8","3.9"
"Fannin","2020-07-07","22","1493","1","60","1.5","4.2"
"Fannin","2020-07-08","19","1512","3","63","3.8","4.8"
"Fannin","2020-07-09","31","1543","4","67","5.6","5.4"
"Fannin","2020-07-10","50","1593","2","69","6.2","5.7"
"Fannin","2020-07-11","4","1597","1","70","9.8","6.7"
"Fannin","2020-07-12","4","1601","1","71","13.3","8.5"
"Fannin","2020-07-13","47","1648","4","75","13.7","8.2"
"Fannin","2020-07-14","26","1674","7","82","16.9","9.2"
"Fannin","2020-07-15","26","1700","4","86","16.8","10.3"
"Fannin","2020-07-16","35","1735","4","90","16.6","11.1"
"Fannin","2020-07-17","36","1771","7","97","18.8","12.5"
"Fannin","2020-07-18","0","1771","0","97","15.2","12.5"
"Fannin","2020-07-19","7","1778","1","98","13.7","13.5"
"Fannin","2020-07-20","47","1825","4","102","13.7","13.7"
"Fannin","2020-07-21","19","1844","2","104","11.4","14.1"
"Fannin","2020-07-22","34","1878","2","106","10","13.4"
"Fannin","2020-07-23","21","1899","0","106","8.4","12.5"
"Fannin","2020-07-24","32","1931","4","110","7.4","13.1"
"Fannin","2020-07-25","6","1937","3","113","14.5","14.9"
"Fannin","2020-07-26","4","1941","0","113","12.5","13.1"
"Fannin","2020-07-27","20","1961","2","115","12.7","13.2"
"Fannin","2020-07-28","22","1983","3","118","13.1","12.3"
"Fannin","2020-07-29","10","1993","1","119","13.7","11.9"
"Fannin","2020-07-30","32","2025","3","122","15.1","11.7"
"Fannin","2020-07-31","18","2043","1","123","14.1","10.7"
"Fannin","2020-08-01","5","2048","0","123","6.9","10.7"
"Fannin","2020-08-02","4","2052","0","123","6.9","9.7"
"Fannin","2020-08-03","32","2084","2","125","6.4","9.6"
"Fannin","2020-08-04","28","2112","1","126","5","9.1"
"Fannin","2020-08-05","20","2132","2","128","5","9.3"
"Fannin","2020-08-06","22","2154","3","131","5.6","10.3"
"Fannin","2020-08-07","33","2187","1","132","5.2","9.6"
"Fannin","2020-08-08","4","2191","0","132","5.2","6.1"
"Fannin","2020-08-09","7","2198","0","132","5.2","6.1"
"Fannin","2020-08-10","22","2220","2","134","5.6","6"
"Fannin","2020-08-11","23","2243","3","137","7","6"
"Fannin","2020-08-12","33","2276","2","139","6.4","5.7"
"Fannin","2020-08-13","33","2309","6","145","7.1","6.3"
"Fannin","2020-08-14","34","2343","1","146","7","6.1"
"Fannin","2020-08-15","11","2354","0","146","7","6.1"
"Fannin","2020-08-16","11","2365","1","147","8.3","6.8"
"Fannin","2020-08-17","33","2398","2","149","7.9","6.8"
"Fannin","2020-08-18","20","2418","0","149","6","6.5"
"Fannin","2020-08-19","51","2469","2","151","5.7","6.1"
"Fannin","2020-08-20","41","2510","1","152","3.5","5.3"
"Fannin","2020-08-21","71","2581","2","154","3.5","5.3"
"Fannin","2020-08-22","6","2587","0","154","3.5","5.3"
"Fannin","2020-08-23","5","2592","1","155","5","6.7"
"Fannin","2020-08-24","30","2622","3","158","5.6","6.8"
"Fannin","2020-08-25","19","2641","2","160","7.1","6.6"
"Fannin","2020-08-26","62","2703","3","163","7.2","6.5"
"Fannin","2020-08-27","24","2727","1","164","7.5","5.5"
"Fannin","2020-08-28","36","2763","4","168","8.7","6.1"
"Fannin","2020-08-29","22","2785","7","175","13.2","8.3"
"Fannin","2020-08-30","87","2872","18","193","13.3","9.2"
"Fannin","2020-08-31","35","2907","3","196","13.1","9.3"
"Fannin","2020-09-01","46","2953","4","200","12.8","10"
"Fannin","2020-09-02","41","2994","8","208","14.9","11.1"
"Fannin","2020-09-03","21","3015","0","208","14.3","10.9"
"Fannin","2020-09-04","86","3101","18","226","15.7","12.2"
"Fannin","2020-09-05","16","3117","2","228","13","13.1"
"Fannin","2020-09-06","7","3124","0","228","10","11.7"
"Fannin","2020-09-07","4","3128","2","230","15.9","14.5"
"Fannin","2020-09-08","43","3171","3","233","15.7","14.3"
"Fannin","2020-09-09","10","3181","2","235","15.8","15.4"
"Fannin","2020-09-10","18","3199","1","236","16.6","15.5"
"Fannin","2020-09-11","48","3247","10","246","16.6","16.1"
"Fannin","2020-09-12","23","3270","7","253","19.1","16"
"Fannin","2020-09-13","8","3278","1","254","20.9","15.5"
"Fannin","2020-09-14","37","3315","3","257","14.9","15.4"
"Fannin","2020-09-15","17","3332","5","262","18.1","16.9"
"Fannin","2020-09-16","44","3376","2","264","15.9","15.8"
"Fannin","2020-09-17","51","3427","13","277","18.8","17.7"
"Fannin","2020-09-18","56","3483","4","281","16.8","16.7"
"Fannin","2020-09-19","8","3491","0","281","12.5","15.8"
"Fannin","2020-09-20","10","3501","1","282","12.1","16.5"
"Fannin","2020-09-21","35","3536","3","285","12.2","13.5"
"Fannin","2020-09-22","25","3561","3","288","9.7","13.9"
"Fannin","2020-09-23","21","3582","1","289","9.7","12.8"
"Fannin","2020-09-24","34","3616","3","292","7.3","13"
"Fannin","2020-09-25","62","3678","2","294","6.8","11.8"
"Fannin","2020-09-26","14","3692","0","294","6.8","9.6"
"Fannin","2020-09-27","7","3699","1","295","7.4","9.7"
"Fannin","2020-09-28","32","3731","2","297","7","9.6"
"Fannin","2020-09-29","23","3754","5","302","8.4","9.1"
"Fannin","2020-09-30","32","3786","3","305","9.1","9.4"
"Fannin","2020-10-01","30","3816","1","306","8.3","7.8"
"Fannin","2020-10-02","39","3855","3","309","9","7.9"
"Fannin","2020-10-03","7","3862","3","312","15.1","10.9"
"Fannin","2020-10-04","4","3866","1","313","16.6","12"
"Fannin","2020-10-05","59","3925","4","317","16.7","11.9"
"Fannin","2020-10-06","26","3951","3","320","15.2","11.8"
"Fannin","2020-10-07","15","3966","2","322","15.8","12.4"
"Fannin","2020-10-08","29","3995","6","328","18.3","13.3"
"Fannin","2020-10-09","35","4030","1","329","17.6","13.3"
"Fannin","2020-10-10","8","4038","3","332","16.8","15.9"
"Fannin","2020-10-11","5","4043","1","333","16.1","16.4"
"Fannin","2020-10-12","54","4097","0","333","15.1","15.9"
"Fannin","2020-10-13","23","4120","3","336","15.3","15.3"
"Fannin","2020-10-14","20","4140","1","337","14.2","15"
"Fannin","2020-10-15","30","4170","4","341","13.1","15.7"
"Fannin","2020-10-16","36","4206","0","341","12.7","15.1"
"Fannin","2020-10-17","1","4207","0","341","7.3","12.1"
"Fannin","2020-10-18","5","4212","1","342","7.3","11.7"
"Fannin","2020-10-19","41","4253","4","346","8.7","11.9"
"Fannin","2020-10-20","25","4278","1","347","7.4","11.4"
"Fannin","2020-10-21","19","4297","2","349","8.2","11.2"
"Fannin","2020-10-22","43","4340","4","353","7.7","10.4"
"Fannin","2020-10-23","28","4368","4","357","9.7","11.2"
"Fannin","2020-10-24","3","4371","0","357","9.7","8.5"
"Fannin","2020-10-25","6","4377","1","358","9.2","8.3"
"Fannin","2020-10-26","29","4406","3","361","9.3","9"
"Fannin","2020-10-27","30","4436","3","364","10.2","8.8"
"Fannin","2020-10-28","22","4458","1","365","9.3","8.8"
"Fannin","2020-10-29","24","4482","1","366","8.6","8.1"
"Fannin","2020-10-30","43","4525","0","366","6.5","8.1"
"Fannin","2020-10-31","8","4533","0","366","6.5","8.1"
"Fannin","2020-11-01","9","4542","1","367","5.7","7.5"
"Fannin","2020-11-02","31","4573","4","371","6.1","7.7"
"Fannin","2020-11-03","21","4594","3","374","6.7","8.4"
"Fannin","2020-11-04","20","4614","0","374","6.1","7.7"
"Fannin","2020-11-05","30","4644","0","374","5.5","7"
"Fannin","2020-11-06","33","4677","0","374","5.5","6"
"Fannin","2020-11-07","7","4684","3","377","11.6","9.1"
"Fannin","2020-11-08","9","4693","0","377","10","7.9"
"Fannin","2020-11-09","49","4742","0","377","8.2","7.1"
"Fannin","2020-11-10","53","4795","7","384","8","7.4"
"Fannin","2020-11-11","25","4820","3","387","9.7","7.9"
"Fannin","2020-11-12","68","4888","19","406","13.7","9.6"
"Fannin","2020-11-13","52","4940","7","413","15.6","10.6"
"Fannin","2020-11-14","10","4950","1","414","10.9","11.3"
"Fannin","2020-11-15","6","4956","0","414","10.9","10.5"
"Fannin","2020-11-16","77","5033","6","420","12.1","10.1"
"Fannin","2020-11-17","27","5060","2","422","11.2","9.6"
"Fannin","2020-11-18","55","5115","5","427","10.8","10.3"
"Fannin","2020-11-19","73","5188","6","433","8","10.9"
"Fannin","2020-11-20","47","5235","1","434","6.4","11"
"Fannin","2020-11-21","15","5250","2","436","6.9","8.9"
"Fannin","2020-11-22","12","5262","0","436","6.9","8.9"
"Fannin","2020-11-23","68","5330","7","443","7.2","9.6"
"Fannin","2020-11-24","50","5380","3","446","7","9.1"
"Fannin","2020-11-25","60","5440","7","453","7.4","9.1"
"Fannin","2020-11-26","6","5446","0","453","6.2","7.1"
"Fannin","2020-11-27","43","5489","4","457","7.2","6.8"
"Fannin","2020-11-28","18","5507","2","459","6.9","6.9"
"Fannin","2020-11-29","10","5517","2","461","9.8","8.3"
"Fannin","2020-11-30","69","5586","5","466","9.3","8.3"
"Fannin","2020-12-01","80","5666","5","471","9.4","8.2"
"Fannin","2020-12-02","65","5731","16","487","11.2","9.3"
"Fannin","2020-12-03","69","5800","10","497","13.3","9.7"
"Fannin","2020-12-04","65","5865","11","508","14.4","10.8"
"Fannin","2020-12-05","18","5883","1","509","13.6","10.2"
"Fannin","2020-12-06","7","5890","0","509","10.7","10.2"
"Fannin","2020-12-07","79","5969","14","523","12.2","10.8"
"Fannin","2020-12-08","54","6023","12","535","14.5","11.9"
"Fannin","2020-12-09","157","6180","6","541","11.5","11.4"
"Fannin","2020-12-10","61","6241","7","548","11.1","12.2"
"Fannin","2020-12-11","71","6312","13","561","11.3","12.8"
"Fannin","2020-12-12","20","6332","7","568","15.5","14.5"
"Fannin","2020-12-13","7","6339","2","570","19.6","15.2"
"Fannin","2020-12-14","83","6422","8","578","18.4","15.3"
"Fannin","2020-12-15","68","6490","5","583","16.3","15.4"
"Fannin","2020-12-16","174","6664","17","600","17.2","14.3"
"Fannin","2020-12-17","88","6752","10","610","17.1","14.1"
"Fannin","2020-12-18","34","6786","5","615","16.6","14"
"Fannin","2020-12-19","12","6798","0","615","11.6","13.6"
"Fannin","2020-12-20","15","6813","3","618","10.4","15"
"Fannin","2020-12-21","102","6915","9","627","10.3","14.4"
"Fannin","2020-12-22","56","6971","7","634","11","13.7"
"Fannin","2020-12-23","156","7127","9","643","10.5","13.8"
"Fannin","2020-12-24","33","7160","6","649","11.4","14.3"
"Fannin","2020-12-25","5","7165","1","650","12.2","14.4"
"Fannin","2020-12-26","8","7173","2","652","15.8","13.7"
"Fannin","2020-12-27","4","7177","1","653","16.5","13.4"
"Fannin","2020-12-28","81","7258","14","667","17.7","14"
"Fannin","2020-12-29","49","7307","13","680","19.7","15.4"
"Fannin","2020-12-30","63","7370","21","701","23.6","17"
"Fannin","2020-12-31","71","7441","15","716","24","17.7"
"Fannin","2021-01-01","11","7452","2","718","23.8","18"
"Fannin","2021-01-02","4","7456","2","720","27.4","21.6"
"Fannin","2021-01-03","6","7462","1","721","26.2","21.3"
"Fannin","2021-01-04","83","7545","15","736","26.3","22"
"Fannin","2021-01-05","101","7646","16","752","24.7","22.2"
"Fannin","2021-01-06","98","7744","17","769","22.5","23"
"Fannin","2021-01-07","96","7840","18","787","22.1","23.1"
"Fannin","2021-01-08","51","7891","13","800","23.2","23.5"
"Fannin","2021-01-09","12","7903","2","802","18.4","22.9"
"Fannin","2021-01-10","12","7915","2","804","18.4","22.3"
"Fannin","2021-01-11","76","7991","21","825","19.8","23"
"Fannin","2021-01-12","63","8054","17","842","21.4","23.1"
"Fannin","2021-01-13","65","8119","24","866","24.2","23.3"
"Fannin","2021-01-14","63","8182","16","882","25.1","23.6"
"Fannin","2021-01-15","58","8240","12","894","24.4","23.8"
"Fannin","2021-01-16","20","8260","5","899","25.6","22"
"Fannin","2021-01-17","11","8271","2","901","25.8","22.1"
"Fannin","2021-01-18","88","8359","22","923","25.5","22.6"
"Fannin","2021-01-19","66","8425","13","936","24.4","22.9"
"Fannin","2021-01-20","63","8488","8","944","21","22.6"
"Fannin","2021-01-21","49","8537","9","953","19.9","22.5"
"Fannin","2021-01-22","42","8579","7","960","19.4","21.9"
"Fannin","2021-01-23","9","8588","2","962","19","22.3"
"Fannin","2021-01-24","6","8594","0","962","16.4","21.1"
"Fannin","2021-01-25","7","8601","3","965","18.9","22.2"
"Fannin","2021-01-26","1","8602","0","965","16.1","20.3"
"Fannin","2021-01-27","0","8602","0","965","14.3","17.6"
"Fayette","2020-02-01","0","0","0","0",".","."
"Fayette","2020-02-02","0","0","0","0",".","."
"Fayette","2020-02-03","0","0","0","0",".","."
"Fayette","2020-02-04","0","0","0","0",".","."
"Fayette","2020-02-05","0","0","0","0",".","."
"Fayette","2020-02-06","0","0","0","0",".","."
"Fayette","2020-02-07","0","0","0","0","0","."
"Fayette","2020-02-08","0","0","0","0","0","."
"Fayette","2020-02-09","0","0","0","0","0","."
"Fayette","2020-02-10","0","0","0","0","0","."
"Fayette","2020-02-11","0","0","0","0","0","."
"Fayette","2020-02-12","0","0","0","0","0","."
"Fayette","2020-02-13","0","0","0","0","0","."
"Fayette","2020-02-14","0","0","0","0","0","0"
"Fayette","2020-02-15","0","0","0","0","0","0"
"Fayette","2020-02-16","0","0","0","0","0","0"
"Fayette","2020-02-17","0","0","0","0","0","0"
"Fayette","2020-02-18","0","0","0","0","0","0"
"Fayette","2020-02-19","0","0","0","0","0","0"
"Fayette","2020-02-20","0","0","0","0","0","0"
"Fayette","2020-02-21","0","0","0","0","0","0"
"Fayette","2020-02-22","0","0","0","0","0","0"
"Fayette","2020-02-23","0","0","0","0","0","0"
"Fayette","2020-02-24","0","0","0","0","0","0"
"Fayette","2020-02-25","0","0","0","0","0","0"
"Fayette","2020-02-26","0","0","0","0","0","0"
"Fayette","2020-02-27","0","0","0","0","0","0"
"Fayette","2020-02-28","0","0","0","0","0","0"
"Fayette","2020-02-29","0","0","0","0","0","0"
"Fayette","2020-03-01","0","0","0","0","0","0"
"Fayette","2020-03-02","0","0","0","0","0","0"
"Fayette","2020-03-03","0","0","0","0","0","0"
"Fayette","2020-03-04","0","0","0","0","0","0"
"Fayette","2020-03-05","0","0","0","0","0","0"
"Fayette","2020-03-06","0","0","0","0","0","0"
"Fayette","2020-03-07","0","0","0","0","0","0"
"Fayette","2020-03-08","4","4","4","4","14.3","7.1"
"Fayette","2020-03-09","1","5","0","4","14.3","7.1"
"Fayette","2020-03-10","1","6","1","5","28.6","14.3"
"Fayette","2020-03-11","1","7","0","5","28.6","14.3"
"Fayette","2020-03-12","8","15","0","5","28.6","14.3"
"Fayette","2020-03-13","11","26","0","5","28.6","14.3"
"Fayette","2020-03-14","4","30","0","5","28.6","14.3"
"Fayette","2020-03-15","2","32","2","7","28.6","21.4"
"Fayette","2020-03-16","13","45","3","10","31.9","23.1"
"Fayette","2020-03-17","18","63","4","14","20.8","24.7"
"Fayette","2020-03-18","23","86","3","17","22.6","25.6"
"Fayette","2020-03-19","20","106","3","20","24.8","26.7"
"Fayette","2020-03-20","43","149","12","32","28.7","28.7"
"Fayette","2020-03-21","6","155","2","34","33.5","31"
"Fayette","2020-03-22","3","158","2","36","28.7","28.7"
"Fayette","2020-03-23","39","197","3","39","26.6","29.2"
"Fayette","2020-03-24","52","249","8","47","25.6","23.2"
"Fayette","2020-03-25","45","294","8","55","26.3","24.4"
"Fayette","2020-03-26","36","330","7","62","26.9","25.8"
"Fayette","2020-03-27","20","350","3","65","25","26.9"
"Fayette","2020-03-28","15","365","6","71","26","29.8"
"Fayette","2020-03-29","4","369","3","74","27.2","28"
"Fayette","2020-03-30","44","413","5","79","27.7","27.1"
"Fayette","2020-03-31","26","439","3","82","27.2","26.4"
"Fayette","2020-04-01","41","480","11","93","28.5","27.4"
"Fayette","2020-04-02","33","513","5","98","27.8","27.4"
"Fayette","2020-04-03","52","565","11","109","28.7","26.9"
"Fayette","2020-04-04","7","572","1","110","25","25.5"
"Fayette","2020-04-05","6","578","2","112","19.1","23.1"
"Fayette","2020-04-06","23","601","3","115","19.3","23.5"
"Fayette","2020-04-07","42","643","6","121","19.7","23.4"
"Fayette","2020-04-08","48","691","2","123","16.5","22.5"
"Fayette","2020-04-09","48","739","6","129","16.1","22"
"Fayette","2020-04-10","66","805","9","138","15","21.9"
"Fayette","2020-04-11","19","824","2","140","14.5","19.8"
"Fayette","2020-04-12","10","834","1","141","11.2","15.1"
"Fayette","2020-04-13","23","857","5","146","12.4","15.9"
"Fayette","2020-04-14","47","904","3","149","11.3","15.5"
"Fayette","2020-04-15","52","956","4","153","11.8","14.1"
"Fayette","2020-04-16","49","1005","5","158","11.5","13.8"
"Fayette","2020-04-17","49","1054","4","162","10.7","12.9"
"Fayette","2020-04-18","23","1077","2","164","10.4","12.5"
"Fayette","2020-04-19","6","1083","0","164","9","10.1"
"Fayette","2020-04-20","40","1123","3","167","6.9","9.7"
"Fayette","2020-04-21","46","1169","2","169","6.7","9"
"Fayette","2020-04-22","60","1229","2","171","6","8.9"
"Fayette","2020-04-23","38","1267","0","171","4.6","8"
"Fayette","2020-04-24","51","1318","4","175","4.5","7.6"
"Fayette","2020-04-25","30","1348","0","175","3.3","6.9"
"Fayette","2020-04-26","27","1375","3","178","4.9","6.9"
"Fayette","2020-04-27","91","1466","2","180","4.1","5.5"
"Fayette","2020-04-28","67","1533","1","181","3.7","5.2"
"Fayette","2020-04-29","69","1602","4","185","4.1","5"
"Fayette","2020-04-30","62","1664","1","186","4.3","4.4"
"Fayette","2020-05-01","61","1725","4","190","4.1","4.3"
"Fayette","2020-05-02","28","1753","0","190","4.1","3.7"
"Fayette","2020-05-03","18","1771","0","190","2.5","3.7"
"Fayette","2020-05-04","70","1841","1","191","2.4","3.3"
"Fayette","2020-05-05","78","1919","1","192","2.4","3"
"Fayette","2020-05-06","76","1995","3","195","2.1","3.1"
"Fayette","2020-05-07","65","2060","2","197","2.3","3.3"
"Fayette","2020-05-08","54","2114","1","198","1.7","2.9"
"Fayette","2020-05-09","23","2137","1","199","2.3","3.2"
"Fayette","2020-05-10","22","2159","0","199","2.3","2.4"
"Fayette","2020-05-11","86","2245","2","201","2.4","2.4"
"Fayette","2020-05-12","79","2324","2","203","2.6","2.5"
"Fayette","2020-05-13","107","2431","5","208","2.7","2.4"
"Fayette","2020-05-14","84","2515","3","211","2.8","2.5"
"Fayette","2020-05-15","84","2599","1","212","2.7","2.2"
"Fayette","2020-05-16","35","2634","3","215","3.3","2.8"
"Fayette","2020-05-17","23","2657","0","215","3.3","2.8"
"Fayette","2020-05-18","105","2762","1","216","3.1","2.7"
"Fayette","2020-05-19","96","2858","1","217","2.9","2.7"
"Fayette","2020-05-20","106","2964","1","218","2.3","2.5"
"Fayette","2020-05-21","45","3009","3","221","2.8","2.8"
"Fayette","2020-05-22","74","3083","2","223","3","2.8"
"Fayette","2020-05-23","47","3130","0","223","1.8","2.5"
"Fayette","2020-05-24","25","3155","1","224","2.3","2.8"
"Fayette","2020-05-25","17","3172","0","224","2.2","2.6"
"Fayette","2020-05-26","135","3307","3","227","2.4","2.6"
"Fayette","2020-05-27","101","3408","1","228","2.4","2.3"
"Fayette","2020-05-28","59","3467","1","229","1.7","2.2"
"Fayette","2020-05-29","94","3561","5","234","2","2.5"
"Fayette","2020-05-30","25","3586","0","234","2","1.9"
"Fayette","2020-05-31","27","3613","1","235","2","2.2"
"Fayette","2020-06-01","104","3717","1","236","2.1","2.2"
"Fayette","2020-06-02","133","3850","1","237","1.9","2.1"
"Fayette","2020-06-03","74","3924","0","237","1.8","2.1"
"Fayette","2020-06-04","56","3980","1","238","1.8","1.7"
"Fayette","2020-06-05","94","4074","3","241","1.5","1.8"
"Fayette","2020-06-06","33","4107","1","242","1.9","2"
"Fayette","2020-06-07","39","4146","1","243","1.8","1.9"
"Fayette","2020-06-08","109","4255","2","245","1.9","2"
"Fayette","2020-06-09","108","4363","0","245","1.8","1.8"
"Fayette","2020-06-10","94","4457","0","245","1.8","1.8"
"Fayette","2020-06-11","71","4528","1","246","1.7","1.8"
"Fayette","2020-06-12","83","4611","0","246","1.3","1.4"
"Fayette","2020-06-13","31","4642","0","246","0.8","1.4"
"Fayette","2020-06-14","37","4679","4","250","2","1.9"
"Fayette","2020-06-15","129","4808","10","260","2.9","2.4"
"Fayette","2020-06-16","126","4934","7","267","3.6","2.7"
"Fayette","2020-06-17","108","5042","8","275","4.7","3.2"
"Fayette","2020-06-18","79","5121","5","280","5.4","3.6"
"Fayette","2020-06-19","99","5220","6","286","6.3","3.8"
"Fayette","2020-06-20","47","5267","7","293","8.4","4.6"
"Fayette","2020-06-21","36","5303","2","295","7.7","4.8"
"Fayette","2020-06-22","242","5545","14","309","7.4","5.1"
"Fayette","2020-06-23","146","5691","4","313","7","5.3"
"Fayette","2020-06-24","177","5868","4","317","6.2","5.5"
"Fayette","2020-06-25","153","6021","3","320","5.6","5.5"
"Fayette","2020-06-26","203","6224","9","329","5.4","5.8"
"Fayette","2020-06-27","51","6275","5","334","4.6","6.5"
"Fayette","2020-06-28","30","6305","2","336","4.8","6.2"
"Fayette","2020-06-29","187","6492","13","349","5","6.2"
"Fayette","2020-06-30","211","6703","11","360","5.3","6.1"
"Fayette","2020-07-01","154","6857","10","370","5.9","6.1"
"Fayette","2020-07-02","145","7002","12","382","6.8","6.2"
"Fayette","2020-07-03","75","7077","6","388","7.3","6.4"
"Fayette","2020-07-04","28","7105","4","392","8","6.3"
"Fayette","2020-07-05","41","7146","13","405","11.6","8.2"
"Fayette","2020-07-06","173","7319","18","423","12.1","8.5"
"Fayette","2020-07-07","205","7524","17","440","12.5","8.9"
"Fayette","2020-07-08","154","7678","14","454","12.9","9.4"
"Fayette","2020-07-09","187","7865","24","478","13.5","10.2"
"Fayette","2020-07-10","175","8040","16","494","13.7","10.5"
"Fayette","2020-07-11","50","8090","9","503","14.2","11.1"
"Fayette","2020-07-12","37","8127","2","505","10.5","11"
"Fayette","2020-07-13","175","8302","15","520","10.2","11.1"
"Fayette","2020-07-14","223","8525","10","530","9.6","11.1"
"Fayette","2020-07-15","191","8716","15","545","9.5","11.2"
"Fayette","2020-07-16","163","8879","11","556","8.6","11.1"
"Fayette","2020-07-17","146","9025","11","567","8.4","11"
"Fayette","2020-07-18","53","9078","6","573","7.4","10.8"
"Fayette","2020-07-19","48","9126","5","578","8.1","9.3"
"Fayette","2020-07-20","151","9277","10","588","7.9","9"
"Fayette","2020-07-21","100","9377","16","604","9.5","9.6"
"Fayette","2020-07-22","151","9528","14","618","9.7","9.6"
"Fayette","2020-07-23","186","9714","14","632","9.8","9.2"
"Fayette","2020-07-24","154","9868","14","646","10","9.2"
"Fayette","2020-07-25","50","9918","2","648","9","8.2"
"Fayette","2020-07-26","38","9956","10","658","11.3","9.7"
"Fayette","2020-07-27","213","10169","16","674","11.4","9.6"
"Fayette","2020-07-28","166","10335","15","689","10.4","9.9"
"Fayette","2020-07-29","154","10489","9","698","9.9","9.8"
"Fayette","2020-07-30","124","10613","16","714","10.7","10.2"
"Fayette","2020-07-31","160","10773","8","722","10.1","10.1"
"Fayette","2020-08-01","82","10855","6","728","10.6","9.8"
"Fayette","2020-08-02","43","10898","3","731","7.8","9.5"
"Fayette","2020-08-03","163","11061","13","744","7.9","9.6"
"Fayette","2020-08-04","148","11209","15","759","8","9.2"
"Fayette","2020-08-05","148","11357","7","766","7.9","8.9"
"Fayette","2020-08-06","151","11508","6","772","6.6","8.6"
"Fayette","2020-08-07","170","11678","12","784","6.9","8.5"
"Fayette","2020-08-08","102","11780","6","790","6.7","8.6"
"Fayette","2020-08-09","66","11846","12","802","8.3","8"
"Fayette","2020-08-10","166","12012","8","810","7.8","7.8"
"Fayette","2020-08-11","191","12203","12","822","7.3","7.6"
"Fayette","2020-08-12","209","12412","11","833","7.4","7.6"
"Fayette","2020-08-13","208","12620","6","839","7.2","6.9"
"Fayette","2020-08-14","321","12941","14","853","6.8","6.8"
"Fayette","2020-08-15","141","13082","8","861","6.8","6.7"
"Fayette","2020-08-16","68","13150","4","865","5","6.7"
"Fayette","2020-08-17","193","13343","7","872","4.9","6.3"
"Fayette","2020-08-18","174","13517","9","881","4.7","6"
"Fayette","2020-08-19","194","13711","8","889","4.5","5.9"
"Fayette","2020-08-20","144","13855","9","898","5","6.1"
"Fayette","2020-08-21","167","14022","7","905","5","5.9"
"Fayette","2020-08-22","51","14073","0","905","4.2","5.5"
"Fayette","2020-08-23","46","14119","6","911","5.2","5.1"
"Fayette","2020-08-24","172","14291","11","922","5.6","5.2"
"Fayette","2020-08-25","151","14442","8","930","5.6","5.2"
"Fayette","2020-08-26","124","14566","7","937","5.8","5.2"
"Fayette","2020-08-27","175","14741","9","946","5.7","5.3"
"Fayette","2020-08-28","150","14891","11","957","6.1","5.6"
"Fayette","2020-08-29","84","14975","3","960","6.6","5.4"
"Fayette","2020-08-30","36","15011","3","963","6","5.6"
"Fayette","2020-08-31","147","15158","11","974","6.1","5.9"
"Fayette","2020-09-01","139","15297","6","980","6","5.8"
"Fayette","2020-09-02","129","15426","6","986","5.8","5.8"
"Fayette","2020-09-03","132","15558","5","991","5.6","5.7"
"Fayette","2020-09-04","145","15703","7","998","5.3","5.7"
"Fayette","2020-09-05","76","15779","4","1002","5.5","6.1"
"Fayette","2020-09-06","47","15826","2","1004","4.9","5.5"
"Fayette","2020-09-07","37","15863","0","1004","3.9","5"
"Fayette","2020-09-08","130","15993","5","1009","3.8","4.9"
"Fayette","2020-09-09","172","16165","3","1012","3.4","4.6"
"Fayette","2020-09-10","184","16349","7","1019","3.4","4.5"
"Fayette","2020-09-11","158","16507","7","1026","3.3","4.3"
"Fayette","2020-09-12","51","16558","3","1029","3.4","4.5"
"Fayette","2020-09-13","55","16613","2","1031","3.3","4.1"
"Fayette","2020-09-14","161","16774","10","1041","4.2","4"
"Fayette","2020-09-15","156","16930","7","1048","4.3","4.1"
"Fayette","2020-09-16","162","17092","7","1055","4.7","4"
"Fayette","2020-09-17","118","17210","6","1061","4.9","4.1"
"Fayette","2020-09-18","133","17343","5","1066","4.8","4.1"
"Fayette","2020-09-19","71","17414","6","1072","5.1","4.3"
"Fayette","2020-09-20","37","17451","2","1074","5.4","4.4"
"Fayette","2020-09-21","165","17616","4","1078","4.8","4.5"
"Fayette","2020-09-22","254","17870","12","1090","4.9","4.6"
"Fayette","2020-09-23","180","18050","8","1098","4.9","4.8"
"Fayette","2020-09-24","127","18177","4","1102","4.6","4.7"
"Fayette","2020-09-25","243","18420","6","1108","4.4","4.6"
"Fayette","2020-09-26","47","18467","2","1110","3.8","4.5"
"Fayette","2020-09-27","46","18513","1","1111","3.4","4.4"
"Fayette","2020-09-28","134","18647","8","1119","3.9","4.4"
"Fayette","2020-09-29","225","18872","6","1125","3.6","4.2"
"Fayette","2020-09-30","159","19031","11","1136","3.9","4.4"
"Fayette","2020-10-01","134","19165","4","1140","3.9","4.3"
"Fayette","2020-10-02","229","19394","9","1149","4.1","4.3"
"Fayette","2020-10-03","60","19454","2","1151","4","3.9"
"Fayette","2020-10-04","60","19514","1","1152","3.9","3.7"
"Fayette","2020-10-05","200","19714","3","1155","3.3","3.6"
"Fayette","2020-10-06","296","20010","4","1159","3.1","3.3"
"Fayette","2020-10-07","203","20213","6","1165","2.5","3.2"
"Fayette","2020-10-08","190","20403","8","1173","2.7","3.3"
"Fayette","2020-10-09","361","20764","7","1180","2.4","3.3"
"Fayette","2020-10-10","90","20854","2","1182","2.3","3.1"
"Fayette","2020-10-11","64","20918","3","1185","2.7","3.3"
"Fayette","2020-10-12","193","21111","9","1194","3.1","3.2"
"Fayette","2020-10-13","192","21303","8","1202","3.5","3.3"
"Fayette","2020-10-14","162","21465","5","1207","3.6","3"
"Fayette","2020-10-15","210","21675","22","1229","4.5","3.6"
"Fayette","2020-10-16","206","21881","7","1236","4.7","3.5"
"Fayette","2020-10-17","81","21962","6","1242","5.4","3.8"
"Fayette","2020-10-18","41","22003","1","1243","5.1","3.9"
"Fayette","2020-10-19","180","22183","6","1249","4.9","4"
"Fayette","2020-10-20","244","22427","8","1257","4.8","4.2"
"Fayette","2020-10-21","222","22649","10","1267","5","4.3"
"Fayette","2020-10-22","239","22888","7","1274","3.9","4.2"
"Fayette","2020-10-23","214","23102","15","1289","4.4","4.5"
"Fayette","2020-10-24","84","23186","7","1296","4.5","5"
"Fayette","2020-10-25","68","23254","3","1299","4.8","5"
"Fayette","2020-10-26","262","23516","4","1303","4.6","4.7"
"Fayette","2020-10-27","348","23864","14","1317","4.7","4.7"
"Fayette","2020-10-28","214","24078","17","1334","5.2","5.1"
"Fayette","2020-10-29","289","24367","14","1348","5.4","4.7"
"Fayette","2020-10-30","263","24630","13","1361","5.1","4.8"
"Fayette","2020-10-31","103","24733","9","1370","5.2","4.9"
"Fayette","2020-11-01","68","24801","3","1373","5.2","5"
"Fayette","2020-11-02","246","25047","9","1382","5.5","5"
"Fayette","2020-11-03","247","25294","11","1393","5.6","5.1"
"Fayette","2020-11-04","223","25517","16","1409","5.5","5.3"
"Fayette","2020-11-05","259","25776","8","1417","5.2","5.3"
"Fayette","2020-11-06","286","26062","12","1429","5.1","5.1"
"Fayette","2020-11-07","129","26191","12","1441","5.2","5.2"
"Fayette","2020-11-08","74","26265","3","1444","5.1","5.2"
"Fayette","2020-11-09","312","26577","23","1467","5.7","5.6"
"Fayette","2020-11-10","364","26941","18","1485","5.7","5.7"
"Fayette","2020-11-11","245","27186","18","1503","5.8","5.6"
"Fayette","2020-11-12","340","27526","24","1527","6.3","5.8"
"Fayette","2020-11-13","270","27796","14","1541","6.5","5.8"
"Fayette","2020-11-14","158","27954","11","1552","6.1","5.7"
"Fayette","2020-11-15","94","28048","11","1563","7.2","6.2"
"Fayette","2020-11-16","361","28409","15","1578","6.8","6.2"
"Fayette","2020-11-17","347","28756","19","1597","6.8","6.3"
"Fayette","2020-11-18","411","29167","36","1633","7","6.4"
"Fayette","2020-11-19","446","29613","18","1651","6.6","6.5"
"Fayette","2020-11-20","498","30111","28","1679","6.7","6.6"
"Fayette","2020-11-21","184","30295","12","1691","6.6","6.4"
"Fayette","2020-11-22","134","30429","9","1700","5.9","6.6"
"Fayette","2020-11-23","442","30871","33","1733","6.4","6.6"
"Fayette","2020-11-24","363","31234","27","1760","6.7","6.7"
"Fayette","2020-11-25","423","31657","42","1802","6.8","6.9"
"Fayette","2020-11-26","23","31680","3","1805","8.1","7.4"
"Fayette","2020-11-27","214","31894","34","1839","9.6","8.1"
"Fayette","2020-11-28","140","32034","22","1861","10.9","8.7"
"Fayette","2020-11-29","141","32175","19","1880","11.9","8.9"
"Fayette","2020-11-30","424","32599","50","1930","12.5","9.4"
"Fayette","2020-12-01","412","33011","34","1964","12.6","9.6"
"Fayette","2020-12-02","423","33434","30","1994","12.2","9.5"
"Fayette","2020-12-03","331","33765","25","2019","11.4","9.8"
"Fayette","2020-12-04","422","34187","44","2063","10.6","10.1"
"Fayette","2020-12-05","205","34392","23","2086","10","10.4"
"Fayette","2020-12-06","103","34495","14","2100","10","10.9"
"Fayette","2020-12-07","410","34905","36","2136","9.6","11"
"Fayette","2020-12-08","455","35360","42","2178","9.7","11.1"
"Fayette","2020-12-09","358","35718","30","2208","9.9","11"
"Fayette","2020-12-10","336","36054","39","2247","10.5","10.9"
"Fayette","2020-12-11","382","36436","25","2272","9.9","10.3"
"Fayette","2020-12-12","219","36655","23","2295","9.8","9.9"
"Fayette","2020-12-13","111","36766","16","2311","9.9","10"
"Fayette","2020-12-14","473","37239","38","2349","9.8","9.7"
"Fayette","2020-12-15","374","37613","44","2393","10.2","9.9"
"Fayette","2020-12-16","411","38024","38","2431","10.3","10.1"
"Fayette","2020-12-17","418","38442","54","2485","10.5","10.5"
"Fayette","2020-12-18","401","38843","57","2542","11.6","10.7"
"Fayette","2020-12-19","205","39048","29","2571","12.1","11"
"Fayette","2020-12-20","142","39190","25","2596","12.6","11.2"
"Fayette","2020-12-21","419","39609","49","2645","13.1","11.5"
"Fayette","2020-12-22","365","39974","40","2685","13","11.6"
"Fayette","2020-12-23","361","40335","47","2732","13.5","11.9"
"Fayette","2020-12-24","258","40593","38","2770","13.8","12.1"
"Fayette","2020-12-25","65","40658","8","2778","13.5","12.5"
"Fayette","2020-12-26","185","40843","26","2804","13.5","12.8"
"Fayette","2020-12-27","142","40985","39","2843","14.9","13.7"
"Fayette","2020-12-28","510","41495","77","2920","15.4","14.2"
"Fayette","2020-12-29","400","41895","72","2992","16.4","14.7"
"Fayette","2020-12-30","383","42278","51","3043","16.4","15"
"Fayette","2020-12-31","350","42628","39","3082","15.9","14.8"
"Fayette","2021-01-01","70","42698","12","3094","16.6","15"
"Fayette","2021-01-02","238","42936","26","3120","16.2","14.8"
"Fayette","2021-01-03","175","43111","36","3156","15.2","15"
"Fayette","2021-01-04","451","43562","71","3227","15.3","15.3"
"Fayette","2021-01-05","565","44127","78","3305","14.7","15.5"
"Fayette","2021-01-06","561","44688","82","3387","14.8","15.6"
"Fayette","2021-01-07","523","45211","72","3459","15.2","15.6"
"Fayette","2021-01-08","403","45614","54","3513","14.7","15.6"
"Fayette","2021-01-09","189","45803","38","3551","16","16.1"
"Fayette","2021-01-10","141","45944","27","3578","15.8","15.5"
"Fayette","2021-01-11","448","46392","51","3629","15.2","15.2"
"Fayette","2021-01-12","493","46885","48","3677","14.6","14.6"
"Fayette","2021-01-13","449","47334","36","3713","13.7","14.3"
"Fayette","2021-01-14","496","47830","53","3766","13.2","14.2"
"Fayette","2021-01-15","400","48230","45","3811","12.9","13.8"
"Fayette","2021-01-16","251","48481","32","3843","11.9","13.9"
"Fayette","2021-01-17","148","48629","26","3869","11.6","13.7"
"Fayette","2021-01-18","372","49001","32","3901","11.2","13.2"
"Fayette","2021-01-19","453","49454","51","3952","11.4","13"
"Fayette","2021-01-20","463","49917","38","3990","11.5","12.6"
"Fayette","2021-01-21","393","50310","39","4029","11.4","12.3"
"Fayette","2021-01-22","400","50710","43","4072","11.3","12.1"
"Fayette","2021-01-23","127","50837","11","4083","10.7","11.3"
"Fayette","2021-01-24","67","50904","17","4100","11.8","11.7"
"Fayette","2021-01-25","174","51078","14","4114","11.7","11.5"
"Fayette","2021-01-26","9","51087","0","4114","10.1","10.8"
"Fayette","2021-01-27","0","51087","0","4114","9","10.2"
"Floyd","2020-02-01","0","0","0","0",".","."
"Floyd","2020-02-02","0","0","0","0",".","."
"Floyd","2020-02-03","0","0","0","0",".","."
"Floyd","2020-02-04","0","0","0","0",".","."
"Floyd","2020-02-05","0","0","0","0",".","."
"Floyd","2020-02-06","0","0","0","0",".","."
"Floyd","2020-02-07","0","0","0","0","0","."
"Floyd","2020-02-08","0","0","0","0","0","."
"Floyd","2020-02-09","0","0","0","0","0","."
"Floyd","2020-02-10","0","0","0","0","0","."
"Floyd","2020-02-11","0","0","0","0","0","."
"Floyd","2020-02-12","0","0","0","0","0","."
"Floyd","2020-02-13","0","0","0","0","0","."
"Floyd","2020-02-14","0","0","0","0","0","0"
"Floyd","2020-02-15","0","0","0","0","0","0"
"Floyd","2020-02-16","0","0","0","0","0","0"
"Floyd","2020-02-17","0","0","0","0","0","0"
"Floyd","2020-02-18","0","0","0","0","0","0"
"Floyd","2020-02-19","0","0","0","0","0","0"
"Floyd","2020-02-20","0","0","0","0","0","0"
"Floyd","2020-02-21","0","0","0","0","0","0"
"Floyd","2020-02-22","0","0","0","0","0","0"
"Floyd","2020-02-23","0","0","0","0","0","0"
"Floyd","2020-02-24","0","0","0","0","0","0"
"Floyd","2020-02-25","0","0","0","0","0","0"
"Floyd","2020-02-26","0","0","0","0","0","0"
"Floyd","2020-02-27","0","0","0","0","0","0"
"Floyd","2020-02-28","0","0","0","0","0","0"
"Floyd","2020-02-29","0","0","0","0","0","0"
"Floyd","2020-03-01","0","0","0","0","0","0"
"Floyd","2020-03-02","0","0","0","0","0","0"
"Floyd","2020-03-03","0","0","0","0","0","0"
"Floyd","2020-03-04","0","0","0","0","0","0"
"Floyd","2020-03-05","0","0","0","0","0","0"
"Floyd","2020-03-06","10","10","2","2","2.9","1.4"
"Floyd","2020-03-07","2","12","0","2","2.9","1.4"
"Floyd","2020-03-08","1","13","0","2","2.9","1.4"
"Floyd","2020-03-09","10","23","1","3","4.3","2.1"
"Floyd","2020-03-10","9","32","2","5","7.5","3.7"
"Floyd","2020-03-11","29","61","4","9","9.4","4.7"
"Floyd","2020-03-12","45","106","6","15","11.3","5.7"
"Floyd","2020-03-13","23","129","3","18","10.3","6.6"
"Floyd","2020-03-14","3","132","0","18","10.3","6.6"
"Floyd","2020-03-15","10","142","1","19","11.8","7.3"
"Floyd","2020-03-16","34","176","1","20","10.8","7.5"
"Floyd","2020-03-17","38","214","2","22","8.3","7.9"
"Floyd","2020-03-18","25","239","5","27","9.2","9.3"
"Floyd","2020-03-19","34","273","3","30","8.6","10"
"Floyd","2020-03-20","39","312","1","31","7.1","8.7"
"Floyd","2020-03-21","12","324","1","32","8.3","9.3"
"Floyd","2020-03-22","21","345","2","34","8.2","10"
"Floyd","2020-03-23","45","390","6","40","9.7","10.2"
"Floyd","2020-03-24","30","420","5","45","11.3","9.8"
"Floyd","2020-03-25","27","447","4","49","10.6","9.9"
"Floyd","2020-03-26","108","555","14","63","11.2","9.9"
"Floyd","2020-03-27","18","573","0","63","10.8","8.9"
"Floyd","2020-03-28","24","597","5","68","12.6","10.4"
"Floyd","2020-03-29","22","619","5","73","14.5","11.3"
"Floyd","2020-03-30","63","682","6","79","13.9","11.8"
"Floyd","2020-03-31","47","729","8","87","14","12.7"
"Floyd","2020-04-01","53","782","11","98","14.8","12.7"
"Floyd","2020-04-02","49","831","4","102","14.1","12.7"
"Floyd","2020-04-03","53","884","6","108","15.8","13.3"
"Floyd","2020-04-04","35","919","4","112","14.4","13.5"
"Floyd","2020-04-05","15","934","2","114","13.1","13.8"
"Floyd","2020-04-06","27","961","3","117","13.3","13.6"
"Floyd","2020-04-07","57","1018","5","122","12.1","13.1"
"Floyd","2020-04-08","54","1072","7","129","11","12.9"
"Floyd","2020-04-09","47","1119","4","133","11.1","12.6"
"Floyd","2020-04-10","41","1160","3","136","10.5","13.1"
"Floyd","2020-04-11","17","1177","1","137","9.7","12.1"
"Floyd","2020-04-12","9","1186","0","137","7.8","10.4"
"Floyd","2020-04-13","20","1206","1","138","6.9","10.1"
"Floyd","2020-04-14","26","1232","3","141","7.3","9.7"
"Floyd","2020-04-15","91","1323","6","147","6.4","8.7"
"Floyd","2020-04-16","89","1412","5","152","6","8.5"
"Floyd","2020-04-17","99","1511","13","165","6.8","8.7"
"Floyd","2020-04-18","46","1557","1","166","6.3","8"
"Floyd","2020-04-19","10","1567","0","166","6.3","7"
"Floyd","2020-04-20","145","1712","4","170","6","6.4"
"Floyd","2020-04-21","71","1783","6","176","5.5","6.4"
"Floyd","2020-04-22","81","1864","4","180","5.3","5.9"
"Floyd","2020-04-23","29","1893","0","180","4.5","5.2"
"Floyd","2020-04-24","101","1994","5","185","3.3","5.1"
"Floyd","2020-04-25","60","2054","5","190","4.2","5.2"
"Floyd","2020-04-26","5","2059","0","190","4.2","5.2"
"Floyd","2020-04-27","106","2165","6","196","4.6","5.3"
"Floyd","2020-04-28","176","2341","34","230","6.2","5.9"
"Floyd","2020-04-29","54","2395","5","235","6.8","6"
"Floyd","2020-04-30","195","2590","5","240","7.2","5.8"
"Floyd","2020-05-01","70","2660","2","242","6.9","5.1"
"Floyd","2020-05-02","152","2812","4","246","6","5.1"
"Floyd","2020-05-03","9","2821","1","247","7.6","5.9"
"Floyd","2020-05-04","37","2858","5","252","8.8","6.7"
"Floyd","2020-05-05","81","2939","3","255","6.5","6.3"
"Floyd","2020-05-06","127","3066","5","260","5.8","6.3"
"Floyd","2020-05-07","155","3221","3","263","5.7","6.4"
"Floyd","2020-05-08","119","3340","2","265","5.5","6.2"
"Floyd","2020-05-09","136","3476","3","268","5.4","5.7"
"Floyd","2020-05-10","9","3485","0","268","3.9","5.7"
"Floyd","2020-05-11","171","3656","11","279","2.8","5.8"
"Floyd","2020-05-12","168","3824","2","281","2.5","4.5"
"Floyd","2020-05-13","201","4025","18","299","3.2","4.5"
"Floyd","2020-05-14","201","4226","20","319","4.3","5"
"Floyd","2020-05-15","171","4397","7","326","4.7","5.1"
"Floyd","2020-05-16","83","4480","3","329","4.9","5.2"
"Floyd","2020-05-17","2","4482","0","329","4.9","4.4"
"Floyd","2020-05-18","251","4733","10","339","4.5","3.7"
"Floyd","2020-05-19","278","5011","4","343","4.6","3.5"
"Floyd","2020-05-20","213","5224","9","352","3.9","3.6"
"Floyd","2020-05-21","495","5719","9","361","2.7","3.5"
"Floyd","2020-05-22","452","6171","7","368","2.4","3.5"
"Floyd","2020-05-23","306","6477","7","375","2.2","3.5"
"Floyd","2020-05-24","7","6484","0","375","2.2","3.5"
"Floyd","2020-05-25","52","6536","0","375","1.6","3.1"
"Floyd","2020-05-26","327","6863","24","399","2.5","3.5"
"Floyd","2020-05-27","337","7200","10","409","2.3","3.1"
"Floyd","2020-05-28","368","7568","12","421","2.5","2.6"
"Floyd","2020-05-29","421","7989","19","440","2.9","2.6"
"Floyd","2020-05-30","175","8164","6","446","3.1","2.6"
"Floyd","2020-05-31","16","8180","0","446","3.1","2.6"
"Floyd","2020-06-01","484","8664","30","476","4","2.8"
"Floyd","2020-06-02","464","9128","30","506","3.8","3.1"
"Floyd","2020-06-03","338","9466","12","518","3.9","3.1"
"Floyd","2020-06-04","385","9851","18","536","4.1","3.3"
"Floyd","2020-06-05","408","10259","12","548","3.9","3.4"
"Floyd","2020-06-06","182","10441","10","558","4.2","3.6"
"Floyd","2020-06-07","21","10462","3","561","6.2","4.7"
"Floyd","2020-06-08","469","10931","49","610","6.8","5.4"
"Floyd","2020-06-09","344","11275","18","628","6.7","5.2"
"Floyd","2020-06-10","304","11579","25","653","7.3","5.6"
"Floyd","2020-06-11","350","11929","16","669","7.3","5.7"
"Floyd","2020-06-12","318","12247","26","695","8.1","6"
"Floyd","2020-06-13","77","12324","5","700","8.2","6.2"
"Floyd","2020-06-14","18","12342","0","700","6.2","6.2"
"Floyd","2020-06-15","490","12832","32","732","5.6","6.2"
"Floyd","2020-06-16","331","13163","15","747","5.5","6.1"
"Floyd","2020-06-17","401","13564","35","782","5.6","6.5"
"Floyd","2020-06-18","344","13908","30","812","6.2","6.7"
"Floyd","2020-06-19","325","14233","23","835","6","7"
"Floyd","2020-06-20","165","14398","19","854","6.7","7.5"
"Floyd","2020-06-21","24","14422","1","855","7.3","6.7"
"Floyd","2020-06-22","515","14937","34","889","7.3","6.5"
"Floyd","2020-06-23","451","15388","31","920","7.7","6.6"
"Floyd","2020-06-24","466","15854","46","966","7.8","6.7"
"Floyd","2020-06-25","571","16425","56","1022","8","7.1"
"Floyd","2020-06-26","509","16934","44","1066","8.2","7.1"
"Floyd","2020-06-27","220","17154","21","1087","7.9","7.3"
"Floyd","2020-06-28","38","17192","3","1090","8.5","7.9"
"Floyd","2020-06-29","931","18123","101","1191","9.1","8.2"
"Floyd","2020-06-30","658","18781","79","1270","9.8","8.7"
"Floyd","2020-07-01","836","19617","71","1341","9.6","8.7"
"Floyd","2020-07-02","889","20506","78","1419","9.5","8.7"
"Floyd","2020-07-03","307","20813","26","1445","9.4","8.8"
"Floyd","2020-07-04","32","20845","9","1454","12.1","10"
"Floyd","2020-07-05","30","20875","8","1462","14.8","11.6"
"Floyd","2020-07-06","867","21742","103","1565","14.9","12"
"Floyd","2020-07-07","1091","22833","86","1651","14.3","12.1"
"Floyd","2020-07-08","931","23764","72","1723","14.2","11.9"
"Floyd","2020-07-09","699","24463","64","1787","14.3","11.9"
"Floyd","2020-07-10","673","25136","55","1842","14.2","11.8"
"Floyd","2020-07-11","125","25261","19","1861","12.4","12.2"
"Floyd","2020-07-12","34","25295","10","1871","12.8","13.8"
"Floyd","2020-07-13","794","26089","84","1955","12.6","13.8"
"Floyd","2020-07-14","860","26949","108","2063","13.3","13.8"
"Floyd","2020-07-15","749","27698","75","2138","13.6","13.9"
"Floyd","2020-07-16","761","28459","82","2220","13.8","14"
"Floyd","2020-07-17","742","29201","67","2287","13.9","14.1"
"Floyd","2020-07-18","279","29480","30","2317","13.3","12.8"
"Floyd","2020-07-19","33","29513","11","2328","13.9","13.3"
"Floyd","2020-07-20","694","30207","78","2406","14","13.3"
"Floyd","2020-07-21","651","30858","79","2485","13.9","13.6"
"Floyd","2020-07-22","513","31371","53","2538","13.9","13.8"
"Floyd","2020-07-23","638","32009","86","2624","14.3","14.1"
"Floyd","2020-07-24","643","32652","65","2689","14.5","14.2"
"Floyd","2020-07-25","151","32803","24","2713","15.2","14.3"
"Floyd","2020-07-26","63","32866","24","2737","15.9","14.9"
"Floyd","2020-07-27","691","33557","69","2806","15.7","14.8"
"Floyd","2020-07-28","622","34179","69","2875","15.6","14.7"
"Floyd","2020-07-29","484","34663","53","2928","15.7","14.8"
"Floyd","2020-07-30","477","35140","45","2973","15.1","14.7"
"Floyd","2020-07-31","500","35640","30","3003","14.5","14.5"
"Floyd","2020-08-01","222","35862","19","3022","13.4","14.3"
"Floyd","2020-08-02","36","35898","2","3024","8.8","12.3"
"Floyd","2020-08-03","591","36489","70","3094","9.1","12.4"
"Floyd","2020-08-04","575","37064","64","3158","9.1","12.3"
"Floyd","2020-08-05","549","37613","83","3241","9.7","12.7"
"Floyd","2020-08-06","475","38088","65","3306","10.3","12.7"
"Floyd","2020-08-07","671","38759","79","3385","11.1","12.8"
"Floyd","2020-08-08","253","39012","31","3416","11.6","12.5"
"Floyd","2020-08-09","74","39086","19","3435","14.5","11.6"
"Floyd","2020-08-10","824","39910","110","3545","14.7","11.9"
"Floyd","2020-08-11","620","40530","42","3587","14.1","11.6"
"Floyd","2020-08-12","526","41056","55","3642","13.4","11.5"
"Floyd","2020-08-13","512","41568","43","3685","12.7","11.5"
"Floyd","2020-08-14","573","42141","59","3744","12.5","11.8"
"Floyd","2020-08-15","208","42349","17","3761","11.9","11.7"
"Floyd","2020-08-16","81","42430","8","3769","9.6","12.1"
"Floyd","2020-08-17","247","42677","21","3790","8.9","11.8"
"Floyd","2020-08-18","634","43311","71","3861","9.6","11.8"
"Floyd","2020-08-19","606","43917","45","3906","9.1","11.3"
"Floyd","2020-08-20","666","44583","57","3963","9.1","10.9"
"Floyd","2020-08-21","740","45323","51","4014","8.7","10.6"
"Floyd","2020-08-22","157","45480","21","4035","9.4","10.6"
"Floyd","2020-08-23","53","45533","5","4040","9.3","9.5"
"Floyd","2020-08-24","679","46212","59","4099","9.4","9.1"
"Floyd","2020-08-25","427","46639","39","4138","9.1","9.3"
"Floyd","2020-08-26","706","47345","34","4172","8.7","8.9"
"Floyd","2020-08-27","716","48061","58","4230","8.6","8.9"
"Floyd","2020-08-28","552","48613","47","4277","8.9","8.8"
"Floyd","2020-08-29","122","48735","14","4291","8.6","9"
"Floyd","2020-08-30","34","48769","7","4298","10.2","9.8"
"Floyd","2020-08-31","547","49316","70","4368","10.8","10.1"
"Floyd","2020-09-01","192","49508","30","4398","11.7","10.4"
"Floyd","2020-09-02","392","49900","40","4438","12.5","10.6"
"Floyd","2020-09-03","376","50276","32","4470","12.5","10.6"
"Floyd","2020-09-04","379","50655","47","4517","13.1","11"
"Floyd","2020-09-05","220","50875","16","4533","12.5","10.5"
"Floyd","2020-09-06","29","50904","5","4538","12","11.1"
"Floyd","2020-09-07","22","50926","5","4543","13.4","12.1"
"Floyd","2020-09-08","131","51057","23","4566","13.7","12.7"
"Floyd","2020-09-09","445","51502","36","4602","13.4","12.9"
"Floyd","2020-09-10","343","51845","34","4636","13.6","13.1"
"Floyd","2020-09-11","317","52162","57","4693","14.4","13.7"
"Floyd","2020-09-12","96","52258","15","4708","15.6","14"
"Floyd","2020-09-13","40","52298","7","4715","15.6","13.8"
"Floyd","2020-09-14","364","52662","53","4768","14.5","13.9"
"Floyd","2020-09-15","219","52881","29","4797","13.8","13.8"
"Floyd","2020-09-16","308","53189","38","4835","14.5","13.9"
"Floyd","2020-09-17","95","53284","10","4845","14.5","14.1"
"Floyd","2020-09-18","387","53671","51","4896","13.9","14.1"
"Floyd","2020-09-19","157","53828","22","4918","13.6","14.6"
"Floyd","2020-09-20","37","53865","10","4928","15","15.3"
"Floyd","2020-09-21","334","54199","40","4968","14.6","14.5"
"Floyd","2020-09-22","132","54331","11","4979","13.9","13.9"
"Floyd","2020-09-23","346","54677","27","5006","13.3","13.9"
"Floyd","2020-09-24","255","54932","26","5032","13.2","13.9"
"Floyd","2020-09-25","285","55217","26","5058","12.6","13.2"
"Floyd","2020-09-26","68","55285","7","5065","12.1","12.9"
"Floyd","2020-09-27","28","55313","8","5073","12.3","13.7"
"Floyd","2020-09-28","248","55561","39","5112","12.9","13.7"
"Floyd","2020-09-29","100","55661","13","5125","13.5","13.7"
"Floyd","2020-09-30","344","56005","14","5139","13","13.1"
"Floyd","2020-10-01","287","56292","25","5164","12.8","13"
"Floyd","2020-10-02","328","56620","27","5191","12.7","12.6"
"Floyd","2020-10-03","243","56863","11","5202","11.8","12"
"Floyd","2020-10-04","134","56997","6","5208","8.4","10.4"
"Floyd","2020-10-05","257","57254","25","5233","7.5","10.2"
"Floyd","2020-10-06","309","57563","13","5246","6.3","9.9"
"Floyd","2020-10-07","465","58028","34","5280","6.7","9.9"
"Floyd","2020-10-08","392","58420","32","5312","6.7","9.7"
"Floyd","2020-10-09","366","58786","23","5335","6.4","9.5"
"Floyd","2020-10-10","107","58893","13","5348","7.5","9.7"
"Floyd","2020-10-11","44","58937","13","5361","11.1","9.7"
"Floyd","2020-10-12","120","59057","16","5377","11.6","9.6"
"Floyd","2020-10-13","154","59211","14","5391","12.3","9.3"
"Floyd","2020-10-14","552","59763","48","5439","12.5","9.6"
"Floyd","2020-10-15","318","60081","40","5479","13.1","9.9"
"Floyd","2020-10-16","354","60435","51","5530","14.3","10.3"
"Floyd","2020-10-17","130","60565","17","5547","14.4","10.9"
"Floyd","2020-10-18","53","60618","14","5561","13.9","12.5"
"Floyd","2020-10-19","253","60871","54","5615","15.1","13.3"
"Floyd","2020-10-20","195","61066","24","5639","15.5","13.9"
"Floyd","2020-10-21","463","61529","41","5680","15.6","14"
"Floyd","2020-10-22","298","61827","32","5712","15.3","14.2"
"Floyd","2020-10-23","393","62220","52","5764","15.1","14.7"
"Floyd","2020-10-24","139","62359","18","5782","15.1","14.8"
"Floyd","2020-10-25","60","62419","9","5791","13.5","13.7"
"Floyd","2020-10-26","352","62771","60","5851","12.9","14"
"Floyd","2020-10-27","204","62975","29","5880","13.1","14.3"
"Floyd","2020-10-28","452","63427","49","5929","13.4","14.5"
"Floyd","2020-10-29","175","63602","23","5952","13.8","14.5"
"Floyd","2020-10-30","327","63929","37","5989","13.5","14.3"
"Floyd","2020-10-31","148","64077","17","6006","13.3","14.2"
"Floyd","2020-11-01","73","64150","14","6020","13.9","13.7"
"Floyd","2020-11-02","331","64481","57","6077","13.9","13.4"
"Floyd","2020-11-03","167","64648","22","6099","13.8","13.5"
"Floyd","2020-11-04","383","65031","41","6140","13.7","13.6"
"Floyd","2020-11-05","309","65340","44","6184","13.9","13.8"
"Floyd","2020-11-06","277","65617","39","6223","14.3","13.9"
"Floyd","2020-11-07","134","65751","18","6241","14.6","13.9"
"Floyd","2020-11-08","50","65801","15","6256","16.1","15"
"Floyd","2020-11-09","367","66168","48","6304","15.5","14.7"
"Floyd","2020-11-10","174","66342","26","6330","15.8","14.8"
"Floyd","2020-11-11","227","66569","33","6363","16.3","15"
"Floyd","2020-11-12","464","67033","61","6424","16.2","15"
"Floyd","2020-11-13","489","67522","57","6481","15.8","15.1"
"Floyd","2020-11-14","121","67643","20","6501","16.3","15.4"
"Floyd","2020-11-15","80","67723","23","6524","16.1","16.1"
"Floyd","2020-11-16","348","68071","44","6568","16","15.8"
"Floyd","2020-11-17","146","68217","17","6585","15.6","15.7"
"Floyd","2020-11-18","566","68783","56","6641","14.9","15.6"
"Floyd","2020-11-19","384","69167","43","6684","14.6","15.4"
"Floyd","2020-11-20","515","69682","48","6732","14.3","15.1"
"Floyd","2020-11-21","174","69856","27","6759","14.1","15.2"
"Floyd","2020-11-22","74","69930","24","6783","14.7","15.4"
"Floyd","2020-11-23","519","70449","60","6843","14.5","15.3"
"Floyd","2020-11-24","178","70627","16","6859","14.1","14.8"
"Floyd","2020-11-25","433","71060","89","6948","15.7","15.3"
"Floyd","2020-11-26","73","71133","11","6959","16.2","15.4"
"Floyd","2020-11-27","191","71324","35","6994","17.5","15.9"
"Floyd","2020-11-28","133","71457","33","7027","18.8","16.5"
"Floyd","2020-11-29","76","71533","19","7046","17.8","16.2"
"Floyd","2020-11-30","563","72096","69","7115","17.9","16.2"
"Floyd","2020-12-01","243","72339","38","7153","18.8","16.5"
"Floyd","2020-12-02","541","72880","61","7214","17.5","16.6"
"Floyd","2020-12-03","455","73335","76","7290","17.7","17"
"Floyd","2020-12-04","280","73615","23","7313","16.3","16.9"
"Floyd","2020-12-05","185","73800","39","7352","15.7","17.3"
"Floyd","2020-12-06","96","73896","25","7377","15.9","16.8"
"Floyd","2020-12-07","576","74472","99","7476","16.6","17.2"
"Floyd","2020-12-08","359","74831","37","7513","15.8","17.3"
"Floyd","2020-12-09","607","75438","94","7607","16.4","17"
"Floyd","2020-12-10","439","75877","64","7671","16.1","16.9"
"Floyd","2020-12-11","617","76494","64","7735","16.4","16.4"
"Floyd","2020-12-12","265","76759","39","7774","15.5","15.6"
"Floyd","2020-12-13","95","76854","25","7799","15.6","15.7"
"Floyd","2020-12-14","551","77405","98","7897","15.7","16.1"
"Floyd","2020-12-15","425","77830","55","7952","16","15.9"
"Floyd","2020-12-16","665","78495","118","8070","16.4","16.4"
"Floyd","2020-12-17","534","79029","68","8138","16.1","16.1"
"Floyd","2020-12-18","546","79575","83","8221","16.8","16.6"
"Floyd","2020-12-19","254","79829","45","8266","17.2","16.4"
"Floyd","2020-12-20","98","79927","25","8291","17.1","16.3"
"Floyd","2020-12-21","612","80539","117","8408","17.3","16.5"
"Floyd","2020-12-22","381","80920","74","8482","18.2","17.1"
"Floyd","2020-12-23","719","81639","119","8601","18","17.2"
"Floyd","2020-12-24","301","81940","73","8674","19.7","17.9"
"Floyd","2020-12-25","50","81990","12","8686","20.9","18.9"
"Floyd","2020-12-26","168","82158","60","8746","23.5","20.4"
"Floyd","2020-12-27","133","82291","39","8785","24.1","20.6"
"Floyd","2020-12-28","941","83232","175","8960","24","20.6"
"Floyd","2020-12-29","280","83512","77","9037","25.1","21.7"
"Floyd","2020-12-30","868","84380","148","9185","25.2","21.6"
"Floyd","2020-12-31","716","85096","128","9313","24.3","22"
"Floyd","2021-01-01","101","85197","34","9347","25.7","23.3"
"Floyd","2021-01-02","85","85282","23","9370","24.4","24"
"Floyd","2021-01-03","111","85393","29","9399","24","24"
"Floyd","2021-01-04","831","86224","164","9563","24.1","24.1"
"Floyd","2021-01-05","350","86574","97","9660","24.2","24.7"
"Floyd","2021-01-06","615","87189","115","9775","24.4","24.8"
"Floyd","2021-01-07","612","87801","100","9875","24.2","24.2"
"Floyd","2021-01-08","661","88462","78","9953","21.1","23.4"
"Floyd","2021-01-09","257","88719","41","9994","19.5","22"
"Floyd","2021-01-10","108","88827","27","10021","19.3","21.7"
"Floyd","2021-01-11","219","89046","51","10072","19.8","22"
"Floyd","2021-01-12","424","89470","33","10105","17","20.6"
"Floyd","2021-01-13","477","89947","77","10182","16.6","20.5"
"Floyd","2021-01-14","543","90490","45","10227","15.5","19.8"
"Floyd","2021-01-15","656","91146","74","10301","15.4","18.2"
"Floyd","2021-01-16","167","91313","29","10330","15.6","17.5"
"Floyd","2021-01-17","94","91407","20","10350","15.1","17.2"
"Floyd","2021-01-18","262","91669","24","10374","13","16.4"
"Floyd","2021-01-19","279","91948","24","10398","13.2","15.1"
"Floyd","2021-01-20","564","92512","56","10454","12.3","14.4"
"Floyd","2021-01-21","218","92730","34","10488","13.3","14.4"
"Floyd","2021-01-22","347","93077","35","10523","13.1","14.3"
"Floyd","2021-01-23","183","93260","22","10545","12.4","14"
"Floyd","2021-01-24","78","93338","6","10551","10.4","12.8"
"Floyd","2021-01-25","154","93492","12","10563","10.2","11.6"
"Floyd","2021-01-26","5","93497","1","10564","11.9","12.5"
"Floyd","2021-01-27","0","93497","0","10564","10.5","11.4"
"Forsyth","2020-02-01","0","0","0","0",".","."
"Forsyth","2020-02-02","0","0","0","0",".","."
"Forsyth","2020-02-03","0","0","0","0",".","."
"Forsyth","2020-02-04","0","0","0","0",".","."
"Forsyth","2020-02-05","0","0","0","0",".","."
"Forsyth","2020-02-06","0","0","0","0",".","."
"Forsyth","2020-02-07","0","0","0","0","0","."
"Forsyth","2020-02-08","0","0","0","0","0","."
"Forsyth","2020-02-09","0","0","0","0","0","."
"Forsyth","2020-02-10","0","0","0","0","0","."
"Forsyth","2020-02-11","0","0","0","0","0","."
"Forsyth","2020-02-12","0","0","0","0","0","."
"Forsyth","2020-02-13","0","0","0","0","0","."
"Forsyth","2020-02-14","0","0","0","0","0","0"
"Forsyth","2020-02-15","0","0","0","0","0","0"
"Forsyth","2020-02-16","0","0","0","0","0","0"
"Forsyth","2020-02-17","0","0","0","0","0","0"
"Forsyth","2020-02-18","0","0","0","0","0","0"
"Forsyth","2020-02-19","0","0","0","0","0","0"
"Forsyth","2020-02-20","0","0","0","0","0","0"
"Forsyth","2020-02-21","0","0","0","0","0","0"
"Forsyth","2020-02-22","0","0","0","0","0","0"
"Forsyth","2020-02-23","0","0","0","0","0","0"
"Forsyth","2020-02-24","0","0","0","0","0","0"
"Forsyth","2020-02-25","0","0","0","0","0","0"
"Forsyth","2020-02-26","0","0","0","0","0","0"
"Forsyth","2020-02-27","0","0","0","0","0","0"
"Forsyth","2020-02-28","0","0","0","0","0","0"
"Forsyth","2020-02-29","0","0","0","0","0","0"
"Forsyth","2020-03-01","0","0","0","0","0","0"
"Forsyth","2020-03-02","0","0","0","0","0","0"
"Forsyth","2020-03-03","0","0","0","0","0","0"
"Forsyth","2020-03-04","2","2","0","0","0","0"
"Forsyth","2020-03-05","0","2","0","0","0","0"
"Forsyth","2020-03-06","1","3","0","0","0","0"
"Forsyth","2020-03-07","1","4","1","1","14.3","7.1"
"Forsyth","2020-03-08","0","4","0","1","14.3","7.1"
"Forsyth","2020-03-09","4","8","0","1","14.3","7.1"
"Forsyth","2020-03-10","3","11","0","1","14.3","7.1"
"Forsyth","2020-03-11","8","19","1","2","16.1","8"
"Forsyth","2020-03-12","29","48","1","3","16.6","8.3"
"Forsyth","2020-03-13","17","65","0","3","16.6","8.3"
"Forsyth","2020-03-14","5","70","0","3","2.3","8.3"
"Forsyth","2020-03-15","5","75","1","4","5.1","9.7"
"Forsyth","2020-03-16","41","116","3","7","6.2","10.2"
"Forsyth","2020-03-17","56","172","3","10","6.9","10.6"
"Forsyth","2020-03-18","37","209","3","13","6.3","11.2"
"Forsyth","2020-03-19","33","242","1","14","6.3","11.4"
"Forsyth","2020-03-20","46","288","6","20","8.1","12.3"
"Forsyth","2020-03-21","6","294","1","21","10.5","6.4"
"Forsyth","2020-03-22","8","302","2","23","11.2","8.2"
"Forsyth","2020-03-23","26","328","3","26","11.8","9"
"Forsyth","2020-03-24","48","376","6","32","12.8","9.9"
"Forsyth","2020-03-25","38","414","0","32","11.7","9"
"Forsyth","2020-03-26","41","455","7","39","13.7","10"
"Forsyth","2020-03-27","24","479","5","44","14.8","11.5"
"Forsyth","2020-03-28","19","498","6","50","16.9","13.7"
"Forsyth","2020-03-29","9","507","1","51","14.9","13.1"
"Forsyth","2020-03-30","52","559","7","58","15.2","13.5"
"Forsyth","2020-03-31","35","594","9","67","17.1","15"
"Forsyth","2020-04-01","25","619","5","72","20","15.8"
"Forsyth","2020-04-02","18","637","2","74","19.1","16.4"
"Forsyth","2020-04-03","30","667","6","80","19","16.9"
"Forsyth","2020-04-04","4","671","0","80","14.5","15.7"
"Forsyth","2020-04-05","5","676","2","82","18.6","16.8"
"Forsyth","2020-04-06","35","711","6","88","19.1","17.2"
"Forsyth","2020-04-07","34","745","3","91","16.7","16.9"
"Forsyth","2020-04-08","46","791","5","96","15.4","17.7"
"Forsyth","2020-04-09","53","844","8","104","16","17.6"
"Forsyth","2020-04-10","45","889","6","110","15","17"
"Forsyth","2020-04-11","21","910","2","112","16.4","15.4"
"Forsyth","2020-04-12","13","923","3","115","14","16.3"
"Forsyth","2020-04-13","42","965","4","119","12.9","16"
"Forsyth","2020-04-14","55","1020","6","125","13.2","15"
"Forsyth","2020-04-15","50","1070","4","129","12.8","14.1"
"Forsyth","2020-04-16","64","1134","9","138","12.6","14.3"
"Forsyth","2020-04-17","80","1214","3","141","11.3","13.2"
"Forsyth","2020-04-18","43","1257","3","144","10.9","13.6"
"Forsyth","2020-04-19","35","1292","5","149","9.6","11.8"
"Forsyth","2020-04-20","72","1364","4","153","9.1","11"
"Forsyth","2020-04-21","65","1429","5","158","8.6","10.9"
"Forsyth","2020-04-22","89","1518","10","168","9.1","10.9"
"Forsyth","2020-04-23","90","1608","6","174","8","10.3"
"Forsyth","2020-04-24","111","1719","4","178","8","9.6"
"Forsyth","2020-04-25","66","1785","0","178","7","9"
"Forsyth","2020-04-26","41","1826","3","181","6","7.8"
"Forsyth","2020-04-27","86","1912","11","192","7","8.1"
"Forsyth","2020-04-28","107","2019","10","202","7.3","7.9"
"Forsyth","2020-04-29","107","2126","8","210","6.7","7.9"
"Forsyth","2020-04-30","101","2227","3","213","6.2","7.1"
"Forsyth","2020-05-01","116","2343","3","216","6.1","7"
"Forsyth","2020-05-02","65","2408","3","219","6.7","6.9"
"Forsyth","2020-05-03","50","2458","3","222","6.5","6.3"
"Forsyth","2020-05-04","145","2603","7","229","5.4","6.2"
"Forsyth","2020-05-05","138","2741","3","232","4.4","5.8"
"Forsyth","2020-05-06","132","2873","4","236","3.7","5.2"
"Forsyth","2020-05-07","99","2972","6","242","4.2","5.2"
"Forsyth","2020-05-08","292","3264","14","256","4.5","5.3"
"Forsyth","2020-05-09","275","3539","11","267","4.4","5.6"
"Forsyth","2020-05-10","40","3579","1","268","3.9","5.2"
"Forsyth","2020-05-11","177","3756","19","287","4.8","5.1"
"Forsyth","2020-05-12","192","3948","6","293","4.9","4.6"
"Forsyth","2020-05-13","243","4191","3","296","4.6","4.2"
"Forsyth","2020-05-14","149","4340","7","303","4.4","4.3"
"Forsyth","2020-05-15","326","4666","11","314","4.2","4.4"
"Forsyth","2020-05-16","92","4758","5","319","4.4","4.4"
"Forsyth","2020-05-17","52","4810","3","322","4.9","4.4"
"Forsyth","2020-05-18","275","5085","18","340","4.3","4.5"
"Forsyth","2020-05-19","373","5458","12","352","4.3","4.6"
"Forsyth","2020-05-20","172","5630","8","360","4.8","4.7"
"Forsyth","2020-05-21","272","5902","7","367","4.5","4.5"
"Forsyth","2020-05-22","231","6133","5","372","4.3","4.3"
"Forsyth","2020-05-23","95","6228","9","381","4.9","4.7"
"Forsyth","2020-05-24","79","6307","0","381","4.1","4.5"
"Forsyth","2020-05-25","64","6371","0","381","3.2","3.7"
"Forsyth","2020-05-26","262","6633","12","393","3.3","3.8"
"Forsyth","2020-05-27","252","6885","7","400","3.1","3.9"
"Forsyth","2020-05-28","185","7070","2","402","2.9","3.7"
"Forsyth","2020-05-29","193","7263","6","408","3","3.7"
"Forsyth","2020-05-30","67","7330","1","409","1.9","3.4"
"Forsyth","2020-05-31","55","7385","1","410","2.1","3.1"
"Forsyth","2020-06-01","219","7604","11","421","2.8","3"
"Forsyth","2020-06-02","169","7773","10","431","3","3.2"
"Forsyth","2020-06-03","396","8169","7","438","2.9","3"
"Forsyth","2020-06-04","217","8386","12","450","3.5","3.2"
"Forsyth","2020-06-05","190","8576","7","457","3.6","3.3"
"Forsyth","2020-06-06","96","8672","4","461","4","2.9"
"Forsyth","2020-06-07","44","8716","4","465","5","3.6"
"Forsyth","2020-06-08","186","8902","7","472","4.8","3.8"
"Forsyth","2020-06-09","210","9112","7","479","4.5","3.8"
"Forsyth","2020-06-10","186","9298","3","482","4.5","3.7"
"Forsyth","2020-06-11","254","9552","6","488","4","3.8"
"Forsyth","2020-06-12","216","9768","6","494","3.9","3.7"
"Forsyth","2020-06-13","100","9868","6","500","4.1","4.1"
"Forsyth","2020-06-14","46","9914","2","502","3.5","4.2"
"Forsyth","2020-06-15","254","10168","14","516","3.7","4.3"
"Forsyth","2020-06-16","234","10402","22","538","4.6","4.5"
"Forsyth","2020-06-17","212","10614","20","558","5.7","5.1"
"Forsyth","2020-06-18","283","10897","24","582","6.6","5.3"
"Forsyth","2020-06-19","288","11185","16","598","7","5.4"
"Forsyth","2020-06-20","120","11305","8","606","7.1","5.6"
"Forsyth","2020-06-21","75","11380","10","616","8.3","5.9"
"Forsyth","2020-06-22","335","11715","55","671","9.9","6.8"
"Forsyth","2020-06-23","245","11960","36","707","10.7","7.6"
"Forsyth","2020-06-24","257","12217","25","732","10.7","8.2"
"Forsyth","2020-06-25","386","12603","40","772","11","8.8"
"Forsyth","2020-06-26","502","13105","36","808","11.2","9.1"
"Forsyth","2020-06-27","177","13282","17","825","11.6","9.3"
"Forsyth","2020-06-28","79","13361","16","841","12.6","10.5"
"Forsyth","2020-06-29","409","13770","42","883","11.7","10.8"
"Forsyth","2020-06-30","428","14198","51","934","11.3","11"
"Forsyth","2020-07-01","612","14810","67","1001","11.5","11.1"
"Forsyth","2020-07-02","556","15366","55","1056","11.4","11.2"
"Forsyth","2020-07-03","187","15553","22","1078","12.1","11.6"
"Forsyth","2020-07-04","113","15666","12","1090","12.2","11.9"
"Forsyth","2020-07-05","97","15763","18","1108","12","12.3"
"Forsyth","2020-07-06","480","16243","60","1168","12.3","12"
"Forsyth","2020-07-07","511","16754","60","1228","12.3","11.8"
"Forsyth","2020-07-08","1058","17812","101","1329","12.1","11.8"
"Forsyth","2020-07-09","498","18310","49","1378","12.1","11.8"
"Forsyth","2020-07-10","575","18885","73","1451","12.2","12.2"
"Forsyth","2020-07-11","128","19013","14","1465","12.3","12.2"
"Forsyth","2020-07-12","102","19115","19","1484","12.3","12.1"
"Forsyth","2020-07-13","445","19560","42","1526","11.8","12.1"
"Forsyth","2020-07-14","441","20001","41","1567","11.5","11.9"
"Forsyth","2020-07-15","403","20404","50","1617","11.9","12"
"Forsyth","2020-07-16","619","21023","98","1715","12.7","12.4"
"Forsyth","2020-07-17","446","21469","33","1748","12","12.1"
"Forsyth","2020-07-18","213","21682","40","1788","13.1","12.7"
"Forsyth","2020-07-19","161","21843","17","1805","12","12.1"
"Forsyth","2020-07-20","432","22275","73","1878","13","12.4"
"Forsyth","2020-07-21","407","22682","68","1946","14.1","12.8"
"Forsyth","2020-07-22","817","23499","52","1998","13.2","12.6"
"Forsyth","2020-07-23","528","24027","71","2069","12.9","12.8"
"Forsyth","2020-07-24","387","24414","48","2117","13.6","12.8"
"Forsyth","2020-07-25","180","24594","32","2149","13.5","13.3"
"Forsyth","2020-07-26","95","24689","7","2156","13","12.5"
"Forsyth","2020-07-27","492","25181","57","2213","12.2","12.6"
"Forsyth","2020-07-28","426","25607","40","2253","11.2","12.6"
"Forsyth","2020-07-29","709","26316","63","2316","11.6","12.4"
"Forsyth","2020-07-30","365","26681","33","2349","10.9","11.9"
"Forsyth","2020-07-31","357","27038","23","2372","10.1","11.8"
"Forsyth","2020-08-01","173","27211","28","2400","9.8","11.6"
"Forsyth","2020-08-02","118","27329","15","2415","10.6","11.8"
"Forsyth","2020-08-03","388","27717","42","2457","10.5","11.4"
"Forsyth","2020-08-04","337","28054","38","2495","10.8","11"
"Forsyth","2020-08-05","758","28812","53","2548","10.5","11"
"Forsyth","2020-08-06","420","29232","46","2594","10.8","10.8"
"Forsyth","2020-08-07","358","29590","28","2622","11","10.5"
"Forsyth","2020-08-08","128","29718","12","2634","10","9.9"
"Forsyth","2020-08-09","128","29846","17","2651","10.1","10.3"
"Forsyth","2020-08-10","504","30350","42","2693","9.7","10.1"
"Forsyth","2020-08-11","453","30803","57","2750","9.9","10.3"
"Forsyth","2020-08-12","726","31529","54","2804","10","10.2"
"Forsyth","2020-08-13","349","31878","18","2822","9.1","10"
"Forsyth","2020-08-14","475","32353","24","2846","8.7","9.9"
"Forsyth","2020-08-15","136","32489","12","2858","8.7","9.3"
"Forsyth","2020-08-16","119","32608","8","2866","7.7","8.9"
"Forsyth","2020-08-17","421","33029","37","2903","7.8","8.8"
"Forsyth","2020-08-18","404","33433","29","2932","7","8.5"
"Forsyth","2020-08-19","666","34099","42","2974","6.9","8.4"
"Forsyth","2020-08-20","465","34564","32","3006","7.1","8.1"
"Forsyth","2020-08-21","504","35068","33","3039","7.3","8"
"Forsyth","2020-08-22","191","35259","21","3060","7.6","8.1"
"Forsyth","2020-08-23","147","35406","13","3073","7.9","7.8"
"Forsyth","2020-08-24","429","35835","28","3101","7.6","7.7"
"Forsyth","2020-08-25","561","36396","33","3134","7.4","7.2"
"Forsyth","2020-08-26","494","36890","43","3177","7.8","7.3"
"Forsyth","2020-08-27","430","37320","39","3216","8.1","7.6"
"Forsyth","2020-08-28","448","37768","30","3246","8.1","7.7"
"Forsyth","2020-08-29","179","37947","22","3268","8.3","8"
"Forsyth","2020-08-30","114","38061","4","3272","7.5","7.7"
"Forsyth","2020-08-31","503","38564","41","3313","7.8","7.7"
"Forsyth","2020-09-01","454","39018","48","3361","8.4","7.9"
"Forsyth","2020-09-02","634","39652","37","3398","8","7.9"
"Forsyth","2020-09-03","456","40108","27","3425","7.6","7.8"
"Forsyth","2020-09-04","437","40545","34","3459","7.7","7.9"
"Forsyth","2020-09-05","152","40697","17","3476","7.6","7.9"
"Forsyth","2020-09-06","87","40784","15","3491","9.5","8.5"
"Forsyth","2020-09-07","85","40869","8","3499","9.7","8.7"
"Forsyth","2020-09-08","692","41561","39","3538","9","8.7"
"Forsyth","2020-09-09","678","42239","30","3568","8.8","8.4"
"Forsyth","2020-09-10","418","42657","27","3595","8.9","8.2"
"Forsyth","2020-09-11","396","43053","27","3622","8.7","8.2"
"Forsyth","2020-09-12","141","43194","15","3637","8.7","8.1"
"Forsyth","2020-09-13","139","43333","15","3652","7.7","8.6"
"Forsyth","2020-09-14","486","43819","20","3672","7","8.3"
"Forsyth","2020-09-15","394","44213","28","3700","7.2","8.1"
"Forsyth","2020-09-16","532","44745","30","3730","7.4","8.1"
"Forsyth","2020-09-17","447","45192","18","3748","7","7.9"
"Forsyth","2020-09-18","441","45633","18","3766","6.6","7.7"
"Forsyth","2020-09-19","147","45780","11","3777","6.2","7.4"
"Forsyth","2020-09-20","136","45916","17","3794","6.4","7.1"
"Forsyth","2020-09-21","457","46373","18","3812","6.4","6.7"
"Forsyth","2020-09-22","371","46744","20","3832","6.2","6.7"
"Forsyth","2020-09-23","485","47229","20","3852","5.9","6.7"
"Forsyth","2020-09-24","336","47565","19","3871","6.2","6.6"
"Forsyth","2020-09-25","366","47931","15","3886","6.2","6.4"
"Forsyth","2020-09-26","113","48044","12","3898","6.6","6.4"
"Forsyth","2020-09-27","120","48164","9","3907","5.9","6.2"
"Forsyth","2020-09-28","416","48580","23","3930","6.1","6.3"
"Forsyth","2020-09-29","383","48963","12","3942","5.8","6"
"Forsyth","2020-09-30","496","49459","23","3965","5.9","5.9"
"Forsyth","2020-10-01","362","49821","10","3975","5.5","5.8"
"Forsyth","2020-10-02","396","50217","17","3992","5.5","5.8"
"Forsyth","2020-10-03","172","50389","12","4004","5","5.8"
"Forsyth","2020-10-04","88","50477","4","4008","4.6","5.2"
"Forsyth","2020-10-05","463","50940","16","4024","4.3","5.2"
"Forsyth","2020-10-06","437","51377","13","4037","4.2","5"
"Forsyth","2020-10-07","598","51975","33","4070","4.4","5.1"
"Forsyth","2020-10-08","354","52329","12","4082","4.5","5"
"Forsyth","2020-10-09","381","52710","24","4106","4.7","5.1"
"Forsyth","2020-10-10","126","52836","7","4113","4.5","4.8"
"Forsyth","2020-10-11","113","52949","4","4117","4.4","4.5"
"Forsyth","2020-10-12","406","53355","22","4139","4.7","4.5"
"Forsyth","2020-10-13","390","53745","22","4161","5.1","4.6"
"Forsyth","2020-10-14","568","54313","23","4184","4.8","4.6"
"Forsyth","2020-10-15","349","54662","21","4205","5.2","4.8"
"Forsyth","2020-10-16","357","55019","17","4222","5","4.9"
"Forsyth","2020-10-17","126","55145","8","4230","5.1","4.8"
"Forsyth","2020-10-18","96","55241","5","4235","5.3","4.9"
"Forsyth","2020-10-19","436","55677","21","4256","5.3","5"
"Forsyth","2020-10-20","456","56133","10","4266","4.8","4.9"
"Forsyth","2020-10-21","681","56814","40","4306","5","4.9"
"Forsyth","2020-10-22","499","57313","26","4332","4.9","5.1"
"Forsyth","2020-10-23","571","57884","37","4369","5.2","5.1"
"Forsyth","2020-10-24","157","58041","18","4387","5.9","5.5"
"Forsyth","2020-10-25","186","58227","21","4408","6.8","6.1"
"Forsyth","2020-10-26","526","58753","19","4427","6.6","5.9"
"Forsyth","2020-10-27","473","59226","21","4448","6.9","5.8"
"Forsyth","2020-10-28","700","59926","40","4488","6.9","6"
"Forsyth","2020-10-29","486","60412","34","4522","7.1","6"
"Forsyth","2020-10-30","528","60940","36","4558","7.2","6.2"
"Forsyth","2020-10-31","268","61208","23","4581","6.8","6.3"
"Forsyth","2020-11-01","175","61383","13","4594","6.2","6.5"
"Forsyth","2020-11-02","564","61947","42","4636","6.8","6.7"
"Forsyth","2020-11-03","492","62439","28","4664","7","6.9"
"Forsyth","2020-11-04","641","63080","45","4709","7.1","7"
"Forsyth","2020-11-05","577","63657","40","4749","7.1","7.1"
"Forsyth","2020-11-06","551","64208","37","4786","7.1","7.2"
"Forsyth","2020-11-07","263","64471","33","4819","7.7","7.2"
"Forsyth","2020-11-08","196","64667","23","4842","8.3","7.3"
"Forsyth","2020-11-09","693","65360","70","4912","8.7","7.7"
"Forsyth","2020-11-10","640","66000","50","4962","9","8"
"Forsyth","2020-11-11","491","66491","46","5008","9.3","8.2"
"Forsyth","2020-11-12","626","67117","61","5069","9.7","8.4"
"Forsyth","2020-11-13","717","67834","84","5153","10.4","8.8"
"Forsyth","2020-11-14","334","68168","38","5191","10.3","9"
"Forsyth","2020-11-15","217","68385","38","5229","11.1","9.7"
"Forsyth","2020-11-16","696","69081","59","5288","10.9","9.8"
"Forsyth","2020-11-17","851","69932","58","5346","10.7","9.8"
"Forsyth","2020-11-18","1135","71067","95","5441","10.6","9.9"
"Forsyth","2020-11-19","805","71872","57","5498","10.2","10"
"Forsyth","2020-11-20","691","72563","56","5554","9.7","10.1"
"Forsyth","2020-11-21","415","72978","61","5615","10.2","10.2"
"Forsyth","2020-11-22","296","73274","28","5643","9","10"
"Forsyth","2020-11-23","735","74009","73","5716","9.2","10"
"Forsyth","2020-11-24","544","74553","51","5767","9.6","10.1"
"Forsyth","2020-11-25","1075","75628","126","5893","10.1","10.3"
"Forsyth","2020-11-26","112","75740","36","5929","13.6","11.9"
"Forsyth","2020-11-27","630","76370","88","6017","14.5","12.1"
"Forsyth","2020-11-28","314","76684","70","6087","15.6","12.9"
"Forsyth","2020-11-29","268","76952","48","6135","16.8","12.9"
"Forsyth","2020-11-30","842","77794","115","6250","17.3","13.3"
"Forsyth","2020-12-01","706","78500","89","6339","17.8","13.7"
"Forsyth","2020-12-02","969","79469","155","6494","18.4","14.2"
"Forsyth","2020-12-03","711","80180","88","6582","15.5","14.6"
"Forsyth","2020-12-04","703","80883","92","6674","15.4","14.9"
"Forsyth","2020-12-05","323","81206","40","6714","14","14.8"
"Forsyth","2020-12-06","276","81482","50","6764","14","15.4"
"Forsyth","2020-12-07","894","82376","89","6853","13.5","15.4"
"Forsyth","2020-12-08","848","83224","155","7008","14.3","16"
"Forsyth","2020-12-09","1039","84263","142","7150","14","16.2"
"Forsyth","2020-12-10","772","85035","103","7253","14.1","14.8"
"Forsyth","2020-12-11","989","86024","114","7367","13.9","14.7"
"Forsyth","2020-12-12","516","86540","67","7434","14","14"
"Forsyth","2020-12-13","248","86788","44","7478","13.9","14"
"Forsyth","2020-12-14","1048","87836","146","7624","14.5","14"
"Forsyth","2020-12-15","917","88753","143","7767","14.1","14.2"
"Forsyth","2020-12-16","1056","89809","137","7904","14","14"
"Forsyth","2020-12-17","904","90713","129","8033","14.1","14.1"
"Forsyth","2020-12-18","981","91694","142","8175","14.6","14.2"
"Forsyth","2020-12-19","393","92087","68","8243","15.2","14.6"
"Forsyth","2020-12-20","338","92425","62","8305","15.3","14.6"
"Forsyth","2020-12-21","909","93334","178","8483","16.1","15.3"
"Forsyth","2020-12-22","926","94260","137","8620","16","15"
"Forsyth","2020-12-23","989","95249","160","8780","16.4","15.2"
"Forsyth","2020-12-24","513","95762","99","8879","17.1","15.6"
"Forsyth","2020-12-25","61","95823","22","8901","20.2","17.4"
"Forsyth","2020-12-26","351","96174","87","8988","21.3","18.2"
"Forsyth","2020-12-27","319","96493","91","9079","22.7","19"
"Forsyth","2020-12-28","1130","97623","228","9307","22.8","19.5"
"Forsyth","2020-12-29","773","98396","185","9492","24.1","20.1"
"Forsyth","2020-12-30","951","99347","171","9663","24.4","20.4"
"Forsyth","2020-12-31","646","99993","142","9805","24.8","21"
"Forsyth","2021-01-01","135","100128","48","9853","24.7","22.5"
"Forsyth","2021-01-02","251","100379","74","9927","25.4","23.3"
"Forsyth","2021-01-03","347","100726","97","10024","25.3","24"
"Forsyth","2021-01-04","1075","101801","251","10275","25.7","24.3"
"Forsyth","2021-01-05","1087","102888","202","10477","25","24.6"
"Forsyth","2021-01-06","1019","103907","214","10691","25.4","24.9"
"Forsyth","2021-01-07","1021","104928","169","10860","24.6","24.7"
"Forsyth","2021-01-08","928","105856","177","11037","22.3","23.5"
"Forsyth","2021-01-09","459","106315","106","11143","21.4","23.4"
"Forsyth","2021-01-10","321","106636","73","11216","20.6","23"
"Forsyth","2021-01-11","1029","107665","179","11395","19.8","22.8"
"Forsyth","2021-01-12","1046","108711","194","11589","19.8","22.4"
"Forsyth","2021-01-13","974","109685","158","11747","19.1","22.3"
"Forsyth","2021-01-14","1008","110693","188","11935","19.4","22"
"Forsyth","2021-01-15","854","111547","167","12102","19.5","20.9"
"Forsyth","2021-01-16","440","111987","97","12199","19.3","20.3"
"Forsyth","2021-01-17","310","112297","59","12258","18.8","19.7"
"Forsyth","2021-01-18","841","113138","132","12390","18.5","19.2"
"Forsyth","2021-01-19","953","114091","159","12549","18.3","19"
"Forsyth","2021-01-20","862","114953","150","12699","18.4","18.8"
"Forsyth","2021-01-21","826","115779","114","12813","17.7","18.6"
"Forsyth","2021-01-22","804","116583","120","12933","17.1","18.3"
"Forsyth","2021-01-23","325","116908","65","12998","16.8","18"
"Forsyth","2021-01-24","131","117039","21","13019","16.4","17.6"
"Forsyth","2021-01-25","291","117330","59","13078","17","17.8"
"Forsyth","2021-01-26","20","117350","3","13081","16.8","17.5"
"Forsyth","2021-01-27","0","117350","0","13081","14.3","16.4"
"Franklin","2020-02-01","0","0","0","0",".","."
"Franklin","2020-02-02","0","0","0","0",".","."
"Franklin","2020-02-03","0","0","0","0",".","."
"Franklin","2020-02-04","0","0","0","0",".","."
"Franklin","2020-02-05","0","0","0","0",".","."
"Franklin","2020-02-06","0","0","0","0",".","."
"Franklin","2020-02-07","1","1","0","0","0","."
"Franklin","2020-02-08","0","1","0","0","0","."
"Franklin","2020-02-09","0","1","0","0","0","."
"Franklin","2020-02-10","0","1","0","0","0","."
"Franklin","2020-02-11","0","1","0","0","0","."
"Franklin","2020-02-12","0","1","0","0","0","."
"Franklin","2020-02-13","0","1","0","0","0","."
"Franklin","2020-02-14","0","1","0","0","0","0"
"Franklin","2020-02-15","0","1","0","0","0","0"
"Franklin","2020-02-16","0","1","0","0","0","0"
"Franklin","2020-02-17","0","1","0","0","0","0"
"Franklin","2020-02-18","0","1","0","0","0","0"
"Franklin","2020-02-19","0","1","0","0","0","0"
"Franklin","2020-02-20","0","1","0","0","0","0"
"Franklin","2020-02-21","0","1","0","0","0","0"
"Franklin","2020-02-22","0","1","0","0","0","0"
"Franklin","2020-02-23","0","1","0","0","0","0"
"Franklin","2020-02-24","0","1","0","0","0","0"
"Franklin","2020-02-25","0","1","0","0","0","0"
"Franklin","2020-02-26","0","1","0","0","0","0"
"Franklin","2020-02-27","0","1","0","0","0","0"
"Franklin","2020-02-28","0","1","0","0","0","0"
"Franklin","2020-02-29","0","1","0","0","0","0"
"Franklin","2020-03-01","0","1","0","0","0","0"
"Franklin","2020-03-02","0","1","0","0","0","0"
"Franklin","2020-03-03","0","1","0","0","0","0"
"Franklin","2020-03-04","0","1","0","0","0","0"
"Franklin","2020-03-05","0","1","0","0","0","0"
"Franklin","2020-03-06","0","1","0","0","0","0"
"Franklin","2020-03-07","0","1","0","0","0","0"
"Franklin","2020-03-08","0","1","0","0","0","0"
"Franklin","2020-03-09","0","1","0","0","0","0"
"Franklin","2020-03-10","0","1","0","0","0","0"
"Franklin","2020-03-11","2","3","0","0","0","0"
"Franklin","2020-03-12","4","7","0","0","0","0"
"Franklin","2020-03-13","3","10","0","0","0","0"
"Franklin","2020-03-14","0","10","0","0","0","0"
"Franklin","2020-03-15","1","11","0","0","0","0"
"Franklin","2020-03-16","1","12","0","0","0","0"
"Franklin","2020-03-17","2","14","0","0","0","0"
"Franklin","2020-03-18","0","14","0","0","0","0"
"Franklin","2020-03-19","4","18","0","0","0","0"
"Franklin","2020-03-20","1","19","0","0","0","0"
"Franklin","2020-03-21","4","23","0","0","0","0"
"Franklin","2020-03-22","1","24","0","0","0","0"
"Franklin","2020-03-23","5","29","2","2","5.7","2.9"
"Franklin","2020-03-24","2","31","0","2","5.7","2.9"
"Franklin","2020-03-25","5","36","1","3","8.6","4.3"
"Franklin","2020-03-26","14","50","2","5","10.6","5.3"
"Franklin","2020-03-27","3","53","0","5","10.6","5.3"
"Franklin","2020-03-28","0","53","0","5","10.6","5.3"
"Franklin","2020-03-29","1","54","0","5","10.6","5.3"
"Franklin","2020-03-30","1","55","0","5","4.9","5.3"
"Franklin","2020-03-31","2","57","0","5","4.9","5.3"
"Franklin","2020-04-01","5","62","0","5","2","5.3"
"Franklin","2020-04-02","1","63","0","5","0","5.3"
"Franklin","2020-04-03","2","65","0","5","0","5.3"
"Franklin","2020-04-04","2","67","0","5","0","5.3"
"Franklin","2020-04-05","0","67","0","5","0","5.3"
"Franklin","2020-04-06","2","69","1","6","7.1","6"
"Franklin","2020-04-07","2","71","0","6","7.1","6"
"Franklin","2020-04-08","0","71","0","6","7.1","4.6"
"Franklin","2020-04-09","1","72","0","6","7.1","3.6"
"Franklin","2020-04-10","3","75","0","6","7.1","3.6"
"Franklin","2020-04-11","1","76","0","6","7.1","3.6"
"Franklin","2020-04-12","0","76","0","6","7.1","3.6"
"Franklin","2020-04-13","1","77","0","6","0","3.6"
"Franklin","2020-04-14","0","77","0","6","0","3.6"
"Franklin","2020-04-15","2","79","1","7","7.1","7.1"
"Franklin","2020-04-16","10","89","0","7","7.1","7.1"
"Franklin","2020-04-17","3","92","2","9","16.7","11.9"
"Franklin","2020-04-18","3","95","0","9","16.7","11.9"
"Franklin","2020-04-19","0","95","0","9","16.7","11.9"
"Franklin","2020-04-20","1","96","0","9","16.7","8.3"
"Franklin","2020-04-21","3","99","0","9","16.7","8.3"
"Franklin","2020-04-22","8","107","0","9","9.5","8.3"
"Franklin","2020-04-23","4","111","1","10","13.1","10.1"
"Franklin","2020-04-24","5","116","2","12","9.3","13"
"Franklin","2020-04-25","0","116","0","12","9.3","13"
"Franklin","2020-04-26","0","116","0","12","9.3","13"
"Franklin","2020-04-27","5","121","0","12","9.3","13"
"Franklin","2020-04-28","4","125","0","12","9.3","13"
"Franklin","2020-04-29","10","135","2","14","12.1","10.8"
"Franklin","2020-04-30","7","142","2","16","12.7","12.9"
"Franklin","2020-05-01","5","147","0","16","6.9","8.1"
"Franklin","2020-05-02","3","150","0","16","6.9","8.1"
"Franklin","2020-05-03","1","151","0","16","6.9","8.1"
"Franklin","2020-05-04","11","162","0","16","6.9","8.1"
"Franklin","2020-05-05","2","164","0","16","6.9","8.1"
"Franklin","2020-05-06","3","167","0","16","4.1","8.1"
"Franklin","2020-05-07","8","175","0","16","0","6.3"
"Franklin","2020-05-08","113","288","2","18","0.3","3.6"
"Franklin","2020-05-09","4","292","0","18","0.3","3.6"
"Franklin","2020-05-10","4","296","0","18","0.3","3.6"
"Franklin","2020-05-11","6","302","0","18","0.3","3.6"
"Franklin","2020-05-12","82","384","2","20","0.6","3.8"
"Franklin","2020-05-13","5","389","0","20","0.6","2.3"
"Franklin","2020-05-14","5","394","0","20","0.6","0.3"
"Franklin","2020-05-15","59","453","3","23","1.1","0.7"
"Franklin","2020-05-16","3","456","0","23","1.1","0.7"
"Franklin","2020-05-17","3","459","0","23","1.1","0.7"
"Franklin","2020-05-18","13","472","1","24","2.2","1.2"
"Franklin","2020-05-19","46","518","1","25","2.1","1.4"
"Franklin","2020-05-20","5","523","0","25","2.1","1.4"
"Franklin","2020-05-21","5","528","1","26","5","2.8"
"Franklin","2020-05-22","51","579","10","36","7.1","4.1"
"Franklin","2020-05-23","1","580","0","36","7.1","4.1"
"Franklin","2020-05-24","1","581","0","36","7.1","4.1"
"Franklin","2020-05-25","1","582","0","36","6","4.1"
"Franklin","2020-05-26","54","636","15","51","9.6","5.9"
"Franklin","2020-05-27","15","651","0","51","9.6","5.9"
"Franklin","2020-05-28","90","741","14","65","9","7"
"Franklin","2020-05-29","11","752","0","65","6.2","6.6"
"Franklin","2020-05-30","5","757","1","66","9","8.1"
"Franklin","2020-05-31","12","769","0","66","9","8.1"
"Franklin","2020-06-01","6","775","0","66","9","7.5"
"Franklin","2020-06-02","161","936","5","71","5.5","7.6"
"Franklin","2020-06-03","14","950","0","71","5.5","7.6"
"Franklin","2020-06-04","12","962","0","71","3.3","6.1"
"Franklin","2020-06-05","6","968","0","71","3.3","4.7"
"Franklin","2020-06-06","7","975","0","71","0.4","4.7"
"Franklin","2020-06-07","4","979","0","71","0.4","4.7"
"Franklin","2020-06-08","9","988","0","71","0.4","4.7"
"Franklin","2020-06-09","79","1067","5","76","0.9","3.2"
"Franklin","2020-06-10","5","1072","0","76","0.9","3.2"
"Franklin","2020-06-11","17","1089","3","79","3.4","3.4"
"Franklin","2020-06-12","79","1168","4","83","4.1","3.7"
"Franklin","2020-06-13","4","1172","0","83","4.1","2.3"
"Franklin","2020-06-14","15","1187","1","84","5.1","2.8"
"Franklin","2020-06-15","14","1201","0","84","5.1","2.8"
"Franklin","2020-06-16","47","1248","5","89","5.7","3.3"
"Franklin","2020-06-17","15","1263","0","89","5.7","3.3"
"Franklin","2020-06-18","19","1282","3","92","5.5","4.4"
"Franklin","2020-06-19","65","1347","3","95","5.4","4.8"
"Franklin","2020-06-20","3","1350","1","96","10.1","7.1"
"Franklin","2020-06-21","7","1357","1","97","11.2","8.2"
"Franklin","2020-06-22","15","1372","0","97","11.2","8.2"
"Franklin","2020-06-23","83","1455","3","100","10.2","8"
"Franklin","2020-06-24","17","1472","2","102","11.9","8.8"
"Franklin","2020-06-25","16","1488","1","103","10.6","8"
"Franklin","2020-06-26","140","1628","5","108","10.4","7.9"
"Franklin","2020-06-27","10","1638","1","109","7.1","8.6"
"Franklin","2020-06-28","6","1644","1","110","7.4","9.3"
"Franklin","2020-06-29","29","1673","2","112","8.4","9.8"
"Franklin","2020-06-30","148","1821","16","128","9.4","9.8"
"Franklin","2020-07-01","19","1840","2","130","9.2","10.6"
"Franklin","2020-07-02","161","2001","16","146","9.8","10.2"
"Franklin","2020-07-03","9","2010","0","146","9.3","9.8"
"Franklin","2020-07-04","8","2018","0","146","7.8","7.5"
"Franklin","2020-07-05","12","2030","0","146","5.5","6.4"
"Franklin","2020-07-06","12","2042","1","147","5.7","7"
"Franklin","2020-07-07","186","2228","15","162","5.3","7.3"
"Franklin","2020-07-08","23","2251","1","163","4.4","6.8"
"Franklin","2020-07-09","13","2264","1","164","4.1","6.9"
"Franklin","2020-07-10","172","2436","6","170","4.6","6.9"
"Franklin","2020-07-11","13","2449","4","174","9","8.4"
"Franklin","2020-07-12","8","2457","1","175","10.7","8.1"
"Franklin","2020-07-13","14","2471","3","178","12.6","9.1"
"Franklin","2020-07-14","216","2687","18","196","12.7","9"
"Franklin","2020-07-15","34","2721","4","200","13.7","9"
"Franklin","2020-07-16","16","2737","4","204","16.2","10.1"
"Franklin","2020-07-17","20","2757","2","206","17.1","10.8"
"Franklin","2020-07-18","12","2769","7","213","21.1","15"
"Franklin","2020-07-19","14","2783","4","217","23.3","17"
"Franklin","2020-07-20","19","2802","3","220","22.5","17.6"
"Franklin","2020-07-21","220","3022","14","234","22.3","17.5"
"Franklin","2020-07-22","30","3052","3","237","22","17.9"
"Franklin","2020-07-23","26","3078","7","244","22.3","19.2"
"Franklin","2020-07-24","15","3093","5","249","25.6","21.4"
"Franklin","2020-07-25","18","3111","4","253","20.5","20.8"
"Franklin","2020-07-26","20","3131","5","258","19.9","21.6"
"Franklin","2020-07-27","16","3147","2","260","19.5","21"
"Franklin","2020-07-28","255","3402","14","274","19.4","20.8"
"Franklin","2020-07-29","23","3425","4","278","20.4","21.2"
"Franklin","2020-07-30","18","3443","5","283","20.5","21.4"
"Franklin","2020-07-31","19","3462","5","288","19.5","22.6"
"Franklin","2020-08-01","27","3489","8","296","20.6","20.5"
"Franklin","2020-08-02","8","3497","2","298","20.6","20.3"
"Franklin","2020-08-03","21","3518","5","303","22.2","20.8"
"Franklin","2020-08-04","210","3728","9","312","22","20.7"
"Franklin","2020-08-05","27","3755","1","313","20.1","20.2"
"Franklin","2020-08-06","13","3768","4","317","20.5","20.5"
"Franklin","2020-08-07","156","3924","23","340","18.8","19.2"
"Franklin","2020-08-08","18","3942","3","343","17","18.8"
"Franklin","2020-08-09","11","3953","1","344","14.7","17.7"
"Franklin","2020-08-10","22","3975","2","346","12.6","17.4"
"Franklin","2020-08-11","106","4081","8","354","13.1","17.6"
"Franklin","2020-08-12","12","4093","5","359","18.5","19.3"
"Franklin","2020-08-13","19","4112","4","363","17.1","18.8"
"Franklin","2020-08-14","121","4233","13","376","16.6","17.7"
"Franklin","2020-08-15","7","4240","0","376","14.2","15.6"
"Franklin","2020-08-16","16","4256","2","378","14.7","14.7"
"Franklin","2020-08-17","17","4273","2","380","15","13.8"
"Franklin","2020-08-18","110","4383","12","392","15.5","14.3"
"Franklin","2020-08-19","32","4415","7","399","12.7","15.6"
"Franklin","2020-08-20","18","4433","6","405","14.4","15.8"
"Franklin","2020-08-21","115","4548","15","420","14.8","15.7"
"Franklin","2020-08-22","17","4565","4","424","18.1","16.2"
"Franklin","2020-08-23","15","4580","4","428","20.2","17.4"
"Franklin","2020-08-24","19","4599","1","429","19.2","17.1"
"Franklin","2020-08-25","155","4754","15","444","19.1","17.3"
"Franklin","2020-08-26","28","4782","3","447","17.5","15.1"
"Franklin","2020-08-27","24","4806","3","450","14.5","14.5"
"Franklin","2020-08-28","198","5004","11","461","13.4","14.1"
"Franklin","2020-08-29","6","5010","0","461","10.1","14.1"
"Franklin","2020-08-30","11","5021","1","462","7.5","13.9"
"Franklin","2020-08-31","31","5052","3","465","8.2","13.7"
"Franklin","2020-09-01","173","5225","20","485","8.4","13.7"
"Franklin","2020-09-02","19","5244","3","488","9.2","13.3"
"Franklin","2020-09-03","21","5265","7","495","12.1","13.3"
"Franklin","2020-09-04","237","5502","29","524","13.1","13.3"
"Franklin","2020-09-05","19","5521","7","531","18.4","14.2"
"Franklin","2020-09-06","15","5536","3","534","19.9","13.7"
"Franklin","2020-09-07","15","5551","2","536","20.4","14.3"
"Franklin","2020-09-08","186","5737","19","555","20.2","14.3"
"Franklin","2020-09-09","34","5771","4","559","19.7","14.4"
"Franklin","2020-09-10","22","5793","1","560","15.6","13.9"
"Franklin","2020-09-11","172","5965","13","573","14.9","14"
"Franklin","2020-09-12","20","5985","4","577","12.5","15.4"
"Franklin","2020-09-13","11","5996","1","578","10.9","15.4"
"Franklin","2020-09-14","44","6040","5","583","10.6","15.5"
"Franklin","2020-09-15","135","6175","17","600","11","15.6"
"Franklin","2020-09-16","25","6200","5","605","12.2","15.9"
"Franklin","2020-09-17","30","6230","1","606","12","13.8"
"Franklin","2020-09-18","200","6430","14","620","11.9","13.4"
"Franklin","2020-09-19","9","6439","2","622","12.2","12.4"
"Franklin","2020-09-20","23","6462","5","627","14","12.5"
"Franklin","2020-09-21","103","6565","3","630","12.8","11.7"
"Franklin","2020-09-22","190","6755","19","649","12.5","11.7"
"Franklin","2020-09-23","17","6772","2","651","11.3","11.7"
"Franklin","2020-09-24","24","6796","3","654","12.6","12.3"
"Franklin","2020-09-25","166","6962","8","662","12.3","12.1"
"Franklin","2020-09-26","10","6972","0","662","9.1","10.7"
"Franklin","2020-09-27","8","6980","0","662","6","10"
"Franklin","2020-09-28","17","6997","1","663","6.4","9.6"
"Franklin","2020-09-29","139","7136","8","671","5.8","9.1"
"Franklin","2020-09-30","20","7156","0","671","4.1","7.7"
"Franklin","2020-10-01","13","7169","2","673","4.5","8.6"
"Franklin","2020-10-02","135","7304","6","679","4.5","8.4"
"Franklin","2020-10-03","11","7315","1","680","5.8","7.4"
"Franklin","2020-10-04","16","7331","3","683","8.5","7.2"
"Franklin","2020-10-05","80","7411","2","685","8","7.2"
"Franklin","2020-10-06","153","7564","13","698","8.4","7.1"
"Franklin","2020-10-07","22","7586","3","701","10.3","7.2"
"Franklin","2020-10-08","25","7611","3","704","9.8","7.2"
"Franklin","2020-10-09","142","7753","13","717","10.5","7.5"
"Franklin","2020-10-10","12","7765","1","718","10.4","8.1"
"Franklin","2020-10-11","6","7771","0","718","7.7","8.1"
"Franklin","2020-10-12","35","7806","5","723","9.4","8.7"
"Franklin","2020-10-13","102","7908","11","734","9.7","9.1"
"Franklin","2020-10-14","25","7933","5","739","10.7","10.5"
"Franklin","2020-10-15","58","7991","11","750","11.6","10.7"
"Franklin","2020-10-16","131","8122","20","770","12.5","11.5"
"Franklin","2020-10-17","10","8132","0","770","11.3","10.9"
"Franklin","2020-10-18","17","8149","3","773","13.8","10.8"
"Franklin","2020-10-19","76","8225","20","793","15.6","12.5"
"Franklin","2020-10-20","75","8300","13","806","16.5","13.1"
"Franklin","2020-10-21","42","8342","3","809","14.7","12.7"
"Franklin","2020-10-22","29","8371","4","813","13.9","12.8"
"Franklin","2020-10-23","108","8479","9","822","12.9","12.7"
"Franklin","2020-10-24","14","8493","7","829","20.1","15.7"
"Franklin","2020-10-25","9","8502","1","830","19.1","16.5"
"Franklin","2020-10-26","24","8526","0","830","15.4","15.5"
"Franklin","2020-10-27","101","8627","20","850","15.7","16.1"
"Franklin","2020-10-28","27","8654","6","856","17.9","16.3"
"Franklin","2020-10-29","28","8682","4","860","18","15.9"
"Franklin","2020-10-30","111","8793","17","877","19","16"
"Franklin","2020-10-31","14","8807","3","880","14.9","17.5"
"Franklin","2020-11-01","14","8821","2","882","15.3","17.2"
"Franklin","2020-11-02","40","8861","10","892","18.9","17.1"
"Franklin","2020-11-03","118","8979","14","906","17.8","16.8"
"Franklin","2020-11-04","20","8999","6","912","18.9","18.4"
"Franklin","2020-11-05","40","9039","3","915","17.9","17.9"
"Franklin","2020-11-06","99","9138","12","927","17.5","18.2"
"Franklin","2020-11-07","34","9172","6","933","16.9","15.9"
"Franklin","2020-11-08","12","9184","1","934","16.1","15.7"
"Franklin","2020-11-09","42","9226","4","938","13.9","16.4"
"Franklin","2020-11-10","111","9337","10","948","13.4","15.6"
"Franklin","2020-11-11","30","9367","5","953","11.5","15.2"
"Franklin","2020-11-12","36","9403","11","964","14.8","16.4"
"Franklin","2020-11-13","131","9534","16","980","14.8","16.2"
"Franklin","2020-11-14","21","9555","8","988","17.8","17.3"
"Franklin","2020-11-15","16","9571","8","996","23.7","19.9"
"Franklin","2020-11-16","60","9631","6","1002","23.8","18.8"
"Franklin","2020-11-17","132","9763","14","1016","24","18.7"
"Franklin","2020-11-18","52","9815","7","1023","23.6","17.6"
"Franklin","2020-11-19","59","9874","5","1028","20.4","17.6"
"Franklin","2020-11-20","134","10008","15","1043","20.3","17.6"
"Franklin","2020-11-21","28","10036","3","1046","16.4","17.1"
"Franklin","2020-11-22","15","10051","7","1053","15.9","19.8"
"Franklin","2020-11-23","55","10106","10","1063","17","20.4"
"Franklin","2020-11-24","141","10247","28","1091","18.4","21.2"
"Franklin","2020-11-25","45","10292","8","1099","19","21.3"
"Franklin","2020-11-26","18","10310","3","1102","20.2","20.3"
"Franklin","2020-11-27","30","10340","8","1110","22.4","21.3"
"Franklin","2020-11-28","27","10367","5","1115","23.5","19.9"
"Franklin","2020-11-29","12","10379","3","1118","20.4","18.1"
"Franklin","2020-11-30","51","10430","8","1126","20","18.5"
"Franklin","2020-12-01","119","10549","26","1152","20.3","19.3"
"Franklin","2020-12-02","58","10607","12","1164","20.7","19.9"
"Franklin","2020-12-03","98","10705","10","1174","19.8","20"
"Franklin","2020-12-04","140","10845","23","1197","18.3","20.4"
"Franklin","2020-12-05","30","10875","9","1206","20","21.7"
"Franklin","2020-12-06","19","10894","6","1212","20.9","20.7"
"Franklin","2020-12-07","57","10951","10","1222","21.2","20.6"
"Franklin","2020-12-08","196","11147","35","1257","20.6","20.5"
"Franklin","2020-12-09","35","11182","4","1261","19.3","20"
"Franklin","2020-12-10","82","11264","7","1268","19.1","19.4"
"Franklin","2020-12-11","165","11429","39","1307","20.1","19.2"
"Franklin","2020-12-12","34","11463","8","1315","19.2","19.6"
"Franklin","2020-12-13","14","11477","6","1321","20.8","20.8"
"Franklin","2020-12-14","75","11552","17","1338","21.5","21.3"
"Franklin","2020-12-15","135","11687","30","1368","22.1","21.4"
"Franklin","2020-12-16","49","11736","12","1380","24","21.6"
"Franklin","2020-12-17","69","11805","19","1399","26.7","22.9"
"Franklin","2020-12-18","154","11959","33","1432","26.4","23.2"
"Franklin","2020-12-19","24","11983","9","1441","28.4","23.8"
"Franklin","2020-12-20","28","12011","9","1450","26.9","23.8"
"Franklin","2020-12-21","58","12069","19","1469","28.3","24.9"
"Franklin","2020-12-22","157","12226","44","1513","29.1","25.6"
"Franklin","2020-12-23","81","12307","15","1528","28.3","26.1"
"Franklin","2020-12-24","91","12398","18","1546","27.2","26.9"
"Franklin","2020-12-25","8","12406","3","1549","29.5","27.9"
"Franklin","2020-12-26","30","12436","13","1562","30.3","29.3"
"Franklin","2020-12-27","34","12470","8","1570","29.1","28"
"Franklin","2020-12-28","62","12532","23","1593","29.7","29"
"Franklin","2020-12-29","207","12739","32","1625","27.9","28.5"
"Franklin","2020-12-30","60","12799","10","1635","27.6","27.9"
"Franklin","2020-12-31","114","12913","21","1656","27.4","27.3"
"Franklin","2021-01-01","23","12936","9","1665","27.7","28.6"
"Franklin","2021-01-02","44","12980","23","1688","28.9","29.6"
"Franklin","2021-01-03","29","13009","16","1704","33.5","31.3"
"Franklin","2021-01-04","63","13072","22","1726","33.1","31.4"
"Franklin","2021-01-05","303","13375","53","1779","33.4","30.7"
"Franklin","2021-01-06","173","13548","26","1805","33.2","30.4"
"Franklin","2021-01-07","137","13685","16","1821","32.2","29.8"
"Franklin","2021-01-08","134","13819","21","1842","28.9","28.3"
"Franklin","2021-01-09","35","13854","14","1856","27.1","28"
"Franklin","2021-01-10","34","13888","7","1863","22.2","27.8"
"Franklin","2021-01-11","68","13956","21","1884","21.6","27.4"
"Franklin","2021-01-12","118","14074","12","1896","20.6","27"
"Franklin","2021-01-13","88","14162","12","1908","20.4","26.8"
"Franklin","2021-01-14","91","14253","18","1926","21.5","26.9"
"Franklin","2021-01-15","53","14306","12","1938","22.5","25.7"
"Franklin","2021-01-16","35","14341","7","1945","19.7","23.4"
"Franklin","2021-01-17","20","14361","3","1948","18.9","20.5"
"Franklin","2021-01-18","49","14410","11","1959","17.7","19.6"
"Franklin","2021-01-19","115","14525","16","1975","18.2","19.4"
"Franklin","2021-01-20","125","14650","19","1994","18.4","19.4"
"Franklin","2021-01-21","54","14704","12","2006","18.8","20.2"
"Franklin","2021-01-22","59","14763","6","2012","17","19.8"
"Franklin","2021-01-23","19","14782","5","2017","17.9","18.8"
"Franklin","2021-01-24","9","14791","1","2018","17.3","18.1"
"Franklin","2021-01-25","13","14804","2","2020","16.3","17"
"Franklin","2021-01-26","3","14807","1","2021","19.1","18.7"
"Franklin","2021-01-27","0","14807","0","2021","16.9","17.7"
"Fulton","2020-02-01","0","0","0","0",".","."
"Fulton","2020-02-02","0","0","0","0",".","."
"Fulton","2020-02-03","0","0","0","0",".","."
"Fulton","2020-02-04","0","0","0","0",".","."
"Fulton","2020-02-05","0","0","0","0",".","."
"Fulton","2020-02-06","0","0","0","0",".","."
"Fulton","2020-02-07","0","0","0","0","0","."
"Fulton","2020-02-08","0","0","0","0","0","."
"Fulton","2020-02-09","0","0","0","0","0","."
"Fulton","2020-02-10","0","0","0","0","0","."
"Fulton","2020-02-11","0","0","0","0","0","."
"Fulton","2020-02-12","0","0","0","0","0","."
"Fulton","2020-02-13","0","0","0","0","0","."
"Fulton","2020-02-14","0","0","0","0","0","0"
"Fulton","2020-02-15","0","0","0","0","0","0"
"Fulton","2020-02-16","0","0","0","0","0","0"
"Fulton","2020-02-17","0","0","0","0","0","0"
"Fulton","2020-02-18","0","0","0","0","0","0"
"Fulton","2020-02-19","0","0","0","0","0","0"
"Fulton","2020-02-20","0","0","0","0","0","0"
"Fulton","2020-02-21","0","0","0","0","0","0"
"Fulton","2020-02-22","0","0","0","0","0","0"
"Fulton","2020-02-23","0","0","0","0","0","0"
"Fulton","2020-02-24","0","0","0","0","0","0"
"Fulton","2020-02-25","0","0","0","0","0","0"
"Fulton","2020-02-26","0","0","0","0","0","0"
"Fulton","2020-02-27","1","1","0","0","0","0"
"Fulton","2020-02-28","0","1","0","0","0","0"
"Fulton","2020-02-29","1","2","0","0","0","0"
"Fulton","2020-03-01","0","2","0","0","0","0"
"Fulton","2020-03-02","0","2","0","0","0","0"
"Fulton","2020-03-03","3","5","2","2","9.5","4.8"
"Fulton","2020-03-04","8","13","0","2","9.5","4.8"
"Fulton","2020-03-05","9","22","4","6","15.9","7.9"
"Fulton","2020-03-06","3","25","0","6","15.9","7.9"
"Fulton","2020-03-07","5","30","0","6","15.9","7.9"
"Fulton","2020-03-08","5","35","0","6","15.9","7.9"
"Fulton","2020-03-09","109","144","2","8","16.1","8.1"
"Fulton","2020-03-10","70","214","9","17","8.4","9"
"Fulton","2020-03-11","70","284","13","30","11.1","10.3"
"Fulton","2020-03-12","78","362","8","38","6.2","11"
"Fulton","2020-03-13","106","468","24","62","9.5","12.7"
"Fulton","2020-03-14","34","502","11","73","14.1","15"
"Fulton","2020-03-15","46","548","16","89","19","17.5"
"Fulton","2020-03-16","204","752","46","135","22","19.1"
"Fulton","2020-03-17","270","1022","45","180","22.5","15.5"
"Fulton","2020-03-18","224","1246","54","234","23.3","17.2"
"Fulton","2020-03-19","251","1497","53","287","24.9","15.6"
"Fulton","2020-03-20","263","1760","71","358","25.5","17.5"
"Fulton","2020-03-21","75","1835","20","378","24.7","19.4"
"Fulton","2020-03-22","124","1959","27","405","22.8","20.9"
"Fulton","2020-03-23","363","2322","103","508","23.7","22.8"
"Fulton","2020-03-24","354","2676","95","603","25.1","23.8"
"Fulton","2020-03-25","379","3055","115","718","26","24.7"
"Fulton","2020-03-26","306","3361","76","794","26.5","25.7"
"Fulton","2020-03-27","311","3672","82","876","26.5","26"
"Fulton","2020-03-28","118","3790","36","912","27","25.9"
"Fulton","2020-03-29","120","3910","41","953","28.8","25.8"
"Fulton","2020-03-30","392","4302","101","1054","28.4","26"
"Fulton","2020-03-31","425","4727","111","1165","28.3","26.7"
"Fulton","2020-04-01","447","5174","113","1278","27.6","26.8"
"Fulton","2020-04-02","355","5529","67","1345","26.7","26.6"
"Fulton","2020-04-03","284","5813","87","1432","27.3","26.9"
"Fulton","2020-04-04","118","5931","25","1457","26","26.5"
"Fulton","2020-04-05","99","6030","17","1474","23.6","26.2"
"Fulton","2020-04-06","484","6514","73","1547","22","25.2"
"Fulton","2020-04-07","575","7089","106","1653","21","24.6"
"Fulton","2020-04-08","541","7630","83","1736","19.5","23.6"
"Fulton","2020-04-09","553","8183","77","1813","18.8","22.8"
"Fulton","2020-04-10","589","8772","70","1883","16.1","21.7"
"Fulton","2020-04-11","441","9213","51","1934","14.8","20.4"
"Fulton","2020-04-12","155","9368","32","1966","15.3","19.4"
"Fulton","2020-04-13","681","10049","67","2033","14.5","18.3"
"Fulton","2020-04-14","619","10668","64","2097","13.4","17.2"
"Fulton","2020-04-15","617","11285","42","2139","12.1","15.8"
"Fulton","2020-04-16","513","11798","66","2205","12","15.4"
"Fulton","2020-04-17","676","12474","81","2286","12","14.1"
"Fulton","2020-04-18","378","12852","41","2327","11.9","13.3"
"Fulton","2020-04-19","453","13305","210","2537","15.6","15.4"
"Fulton","2020-04-20","797","14102","56","2593","15.2","14.8"
"Fulton","2020-04-21","1650","15752","95","2688","14.5","13.9"
"Fulton","2020-04-22","1138","16890","90","2778","14.7","13.4"
"Fulton","2020-04-23","1010","17900","91","2869","14.1","13.1"
"Fulton","2020-04-24","1490","19390","71","2940","13.1","12.6"
"Fulton","2020-04-25","856","20246","34","2974","12.1","12"
"Fulton","2020-04-26","268","20514","46","3020","7.9","11.8"
"Fulton","2020-04-27","698","21212","52","3072","8","11.6"
"Fulton","2020-04-28","1783","22995","92","3164","7.9","11.2"
"Fulton","2020-04-29","2203","25198","179","3343","7.9","11.3"
"Fulton","2020-04-30","2023","27221","72","3415","7.2","10.6"
"Fulton","2020-05-01","2265","29486","167","3582","7.5","10.3"
"Fulton","2020-05-02","1032","30518","52","3634","7.7","9.9"
"Fulton","2020-05-03","754","31272","47","3681","6.1","7"
"Fulton","2020-05-04","2317","33589","228","3909","6.5","7.2"
"Fulton","2020-05-05","1858","35447","75","3984","6.3","7.1"
"Fulton","2020-05-06","2092","37539","82","4066","5.7","6.8"
"Fulton","2020-05-07","1409","38948","75","4141","6","6.6"
"Fulton","2020-05-08","1492","40440","39","4180","5.3","6.4"
"Fulton","2020-05-09","592","41032","37","4217","5.5","6.6"
"Fulton","2020-05-10","337","41369","29","4246","5.8","6"
"Fulton","2020-05-11","1608","42977","59","4305","4.9","5.7"
"Fulton","2020-05-12","1725","44702","90","4395","5.1","5.7"
"Fulton","2020-05-13","1566","46268","52","4447","5","5.4"
"Fulton","2020-05-14","1650","47918","116","4563","5.2","5.6"
"Fulton","2020-05-15","1931","49849","51","4614","5.2","5.3"
"Fulton","2020-05-16","873","50722","28","4642","4.8","5.1"
"Fulton","2020-05-17","480","51202","30","4672","4.5","5.1"
"Fulton","2020-05-18","1579","52781","71","4743","4.6","4.8"
"Fulton","2020-05-19","1665","54446","59","4802","4.4","4.7"
"Fulton","2020-05-20","2015","56461","58","4860","4.3","4.6"
"Fulton","2020-05-21","1330","57791","43","4903","3.8","4.5"
"Fulton","2020-05-22","1655","59446","60","4963","3.9","4.6"
"Fulton","2020-05-23","940","60386","40","5003","4","4.4"
"Fulton","2020-05-24","446","60832","31","5034","4.1","4.3"
"Fulton","2020-05-25","234","61066","15","5049","4.4","4.5"
"Fulton","2020-05-26","2563","63629","94","5143","4.4","4.4"
"Fulton","2020-05-27","2116","65745","73","5216","4.5","4.4"
"Fulton","2020-05-28","2056","67801","55","5271","4.4","4.1"
"Fulton","2020-05-29","1762","69563","51","5322","4.3","4.1"
"Fulton","2020-05-30","534","70097","9","5331","4","4"
"Fulton","2020-05-31","327","70424","15","5346","3.6","3.9"
"Fulton","2020-06-01","1283","71707","61","5407","3.4","3.9"
"Fulton","2020-06-02","1679","73386","63","5470","3.4","3.9"
"Fulton","2020-06-03","1888","75274","78","5548","3.5","4"
"Fulton","2020-06-04","1776","77050","47","5595","3.5","4"
"Fulton","2020-06-05","1731","78781","60","5655","3.6","4"
"Fulton","2020-06-06","1250","80031","60","5715","4","4"
"Fulton","2020-06-07","553","80584","27","5742","4.1","3.8"
"Fulton","2020-06-08","1673","82257","55","5797","3.9","3.6"
"Fulton","2020-06-09","2049","84306","71","5868","3.8","3.6"
"Fulton","2020-06-10","1965","86271","93","5961","3.9","3.7"
"Fulton","2020-06-11","2167","88438","80","6041","4","3.8"
"Fulton","2020-06-12","1894","90332","72","6113","4.1","3.8"
"Fulton","2020-06-13","1224","91556","60","6173","4.1","4.1"
"Fulton","2020-06-14","510","92066","29","6202","4.2","4.1"
"Fulton","2020-06-15","2480","94546","105","6307","4.4","4.1"
"Fulton","2020-06-16","2525","97071","169","6476","4.8","4.3"
"Fulton","2020-06-17","2301","99372","162","6638","5.1","4.5"
"Fulton","2020-06-18","2244","101616","186","6824","5.8","4.9"
"Fulton","2020-06-19","2563","104179","181","7005","6.3","5.2"
"Fulton","2020-06-20","1624","105803","139","7144","6.8","5.5"
"Fulton","2020-06-21","564","106367","73","7217","7.8","6"
"Fulton","2020-06-22","2896","109263","306","7523","8.7","6.5"
"Fulton","2020-06-23","3096","112359","309","7832","9.2","7"
"Fulton","2020-06-24","3098","115457","338","8170","9.8","7.5"
"Fulton","2020-06-25","3435","118892","415","8585","10.3","8.1"
"Fulton","2020-06-26","5275","124167","557","9142","10.8","8.5"
"Fulton","2020-06-27","2535","126702","302","9444","11.3","9"
"Fulton","2020-06-28","1251","127953","207","9651","11.8","9.8"
"Fulton","2020-06-29","5336","133289","621","10272","11.9","10.3"
"Fulton","2020-06-30","5378","138667","632","10904","12.2","10.7"
"Fulton","2020-07-01","5169","143836","613","11517","12.3","11"
"Fulton","2020-07-02","5606","149442","707","12224","12.4","11.4"
"Fulton","2020-07-03","2375","151817","290","12514","12.6","11.7"
"Fulton","2020-07-04","531","152348","75","12589","13","12.1"
"Fulton","2020-07-05","600","152948","129","12718","13.7","12.7"
"Fulton","2020-07-06","6160","159108","835","13553","13.9","12.9"
"Fulton","2020-07-07","6087","165195","787","14340","14.1","13.2"
"Fulton","2020-07-08","5661","170856","745","15085","14.3","13.3"
"Fulton","2020-07-09","4724","175580","628","15713","14.4","13.4"
"Fulton","2020-07-10","4766","180346","680","16393","14.7","13.7"
"Fulton","2020-07-11","2256","182602","356","16749","14.9","13.9"
"Fulton","2020-07-12","1901","184503","248","16997","13.7","13.7"
"Fulton","2020-07-13","6751","191254","946","17943","13.8","13.9"
"Fulton","2020-07-14","5566","196820","733","18676","13.8","14"
"Fulton","2020-07-15","5425","202245","708","19384","13.8","14.1"
"Fulton","2020-07-16","6415","208660","888","20272","13.9","14.1"
"Fulton","2020-07-17","5748","214408","617","20889","13.4","14"
"Fulton","2020-07-18","2746","217154","361","21250","13","14"
"Fulton","2020-07-19","845","217999","96","21346","12.8","13.2"
"Fulton","2020-07-20","5880","223879","754","22100","12.6","13.2"
"Fulton","2020-07-21","4951","228830","647","22747","12.6","13.2"
"Fulton","2020-07-22","5353","234183","757","23504","12.7","13.3"
"Fulton","2020-07-23","5718","239901","599","24103","12.2","13.1"
"Fulton","2020-07-24","5098","244999","669","24772","12.6","13"
"Fulton","2020-07-25","2183","247182","271","25043","12.5","12.7"
"Fulton","2020-07-26","695","247877","55","25098","12","12.4"
"Fulton","2020-07-27","5288","253165","513","25611","11.5","12.1"
"Fulton","2020-07-28","4660","257825","504","26115","11.2","11.9"
"Fulton","2020-07-29","4729","262554","555","26670","10.9","11.8"
"Fulton","2020-07-30","4518","267072","495","27165","11","11.6"
"Fulton","2020-07-31","4288","271360","457","27622","10.6","11.6"
"Fulton","2020-08-01","2000","273360","240","27862","10.5","11.5"
"Fulton","2020-08-02","658","274018","66","27928","10.8","11.4"
"Fulton","2020-08-03","4358","278376","412","28340","10.8","11.2"
"Fulton","2020-08-04","4546","282922","408","28748","10.5","10.9"
"Fulton","2020-08-05","4739","287661","439","29187","10.2","10.5"
"Fulton","2020-08-06","4457","292118","379","29566","9.8","10.4"
"Fulton","2020-08-07","4182","296300","306","29872","9.4","10"
"Fulton","2020-08-08","2079","298379","166","30038","8.8","9.7"
"Fulton","2020-08-09","779","299158","71","30109","8.7","9.8"
"Fulton","2020-08-10","4108","303266","292","30401","8.3","9.6"
"Fulton","2020-08-11","3276","306542","196","30597","7.9","9.2"
"Fulton","2020-08-12","2893","309435","173","30770","7.4","8.8"
"Fulton","2020-08-13","2988","312423","155","30925","7","8.4"
"Fulton","2020-08-14","4116","316539","194","31119","6.6","8"
"Fulton","2020-08-15","1820","318359","109","31228","6.3","7.5"
"Fulton","2020-08-16","1413","319772","121","31349","6.2","7.4"
"Fulton","2020-08-17","2904","322676","196","31545","6.2","7.2"
"Fulton","2020-08-18","3111","325787","155","31700","6","7"
"Fulton","2020-08-19","3591","329378","190","31890","5.9","6.7"
"Fulton","2020-08-20","2808","332186","158","32048","6","6.5"
"Fulton","2020-08-21","3233","335419","172","32220","6.1","6.3"
"Fulton","2020-08-22","1637","337056","95","32315","6","6.2"
"Fulton","2020-08-23","773","337829","65","32380","6","6.1"
"Fulton","2020-08-24","3227","341056","178","32558","5.8","6"
"Fulton","2020-08-25","2900","343956","173","32731","6","6"
"Fulton","2020-08-26","2772","346728","161","32892","6.1","6"
"Fulton","2020-08-27","3274","350002","142","33034","5.9","5.9"
"Fulton","2020-08-28","2942","352944","142","33176","5.8","5.9"
"Fulton","2020-08-29","2021","354965","105","33281","5.7","5.9"
"Fulton","2020-08-30","682","355647","51","33332","5.6","5.8"
"Fulton","2020-08-31","2955","358602","155","33487","5.6","5.7"
"Fulton","2020-09-01","3538","362140","145","33632","5.3","5.6"
"Fulton","2020-09-02","3610","365750","170","33802","5.1","5.6"
"Fulton","2020-09-03","3374","369124","164","33966","5.2","5.5"
"Fulton","2020-09-04","2988","372112","137","34103","5.2","5.5"
"Fulton","2020-09-05","1194","373306","71","34174","5.3","5.5"
"Fulton","2020-09-06","674","373980","47","34221","5.2","5.4"
"Fulton","2020-09-07","732","374712","40","34261","5.2","5.4"
"Fulton","2020-09-08","3725","378437","179","34440","5.3","5.3"
"Fulton","2020-09-09","3555","381992","161","34601","5.3","5.2"
"Fulton","2020-09-10","3416","385408","130","34731","5.2","5.2"
"Fulton","2020-09-11","3180","388588","123","34854","5.1","5.1"
"Fulton","2020-09-12","1571","390159","62","34916","4.8","5"
"Fulton","2020-09-13","753","390912","60","34976","4.9","5.1"
"Fulton","2020-09-14","3436","394348","160","35136","4.8","5"
"Fulton","2020-09-15","3146","397494","124","35260","4.7","5"
"Fulton","2020-09-16","3252","400746","114","35374","4.5","4.9"
"Fulton","2020-09-17","2507","403253","90","35464","4.5","4.8"
"Fulton","2020-09-18","2996","406249","104","35568","4.4","4.7"
"Fulton","2020-09-19","1553","407802","63","35631","4.5","4.6"
"Fulton","2020-09-20","501","408303","29","35660","4.1","4.5"
"Fulton","2020-09-21","3267","411570","129","35789","4","4.4"
"Fulton","2020-09-22","2900","414470","97","35886","4","4.3"
"Fulton","2020-09-23","3364","417834","91","35977","3.8","4.2"
"Fulton","2020-09-24","3044","420878","101","36078","3.8","4.2"
"Fulton","2020-09-25","3046","423924","107","36185","3.8","4.1"
"Fulton","2020-09-26","1363","425287","56","36241","3.8","4.1"
"Fulton","2020-09-27","548","425835","21","36262","3.5","3.8"
"Fulton","2020-09-28","3118","428953","107","36369","3.5","3.8"
"Fulton","2020-09-29","3146","432099","89","36458","3.4","3.7"
"Fulton","2020-09-30","3429","435528","123","36581","3.5","3.7"
"Fulton","2020-10-01","3527","439055","79","36660","3.4","3.6"
"Fulton","2020-10-02","3323","442378","114","36774","3.4","3.6"
"Fulton","2020-10-03","1796","444174","66","36840","3.3","3.6"
"Fulton","2020-10-04","760","444934","38","36878","3.5","3.5"
"Fulton","2020-10-05","3916","448850","143","37021","3.5","3.5"
"Fulton","2020-10-06","3985","452835","107","37128","3.5","3.4"
"Fulton","2020-10-07","4228","457063","129","37257","3.4","3.5"
"Fulton","2020-10-08","3664","460727","111","37368","3.5","3.4"
"Fulton","2020-10-09","3631","464358","134","37502","3.5","3.4"
"Fulton","2020-10-10","1792","466150","58","37560","3.5","3.4"
"Fulton","2020-10-11","671","466821","46","37606","3.7","3.6"
"Fulton","2020-10-12","2442","469263","102","37708","3.8","3.7"
"Fulton","2020-10-13","3846","473109","163","37871","4","3.8"
"Fulton","2020-10-14","3491","476600","136","38007","4.2","3.8"
"Fulton","2020-10-15","3396","479996","137","38144","4.3","3.9"
"Fulton","2020-10-16","3334","483330","167","38311","4.5","4"
"Fulton","2020-10-17","1616","484946","86","38397","4.8","4.1"
"Fulton","2020-10-18","709","485655","39","38436","4.6","4.2"
"Fulton","2020-10-19","3929","489584","183","38619","4.7","4.2"
"Fulton","2020-10-20","3729","493313","181","38800","4.8","4.4"
"Fulton","2020-10-21","4359","497672","194","38994","4.8","4.5"
"Fulton","2020-10-22","3615","501287","190","39184","5","4.7"
"Fulton","2020-10-23","3820","505107","194","39378","5","4.8"
"Fulton","2020-10-24","1983","507090","110","39488","5","4.9"
"Fulton","2020-10-25","1382","508472","81","39569","5.1","4.8"
"Fulton","2020-10-26","4148","512620","215","39784","5.2","4.9"
"Fulton","2020-10-27","4389","517009","151","39935","5","4.9"
"Fulton","2020-10-28","4284","521293","192","40127","5","4.9"
"Fulton","2020-10-29","3109","524402","145","40272","4.9","5"
"Fulton","2020-10-30","3809","528211","185","40457","4.9","4.9"
"Fulton","2020-10-31","1956","530167","117","40574","4.9","5"
"Fulton","2020-11-01","1132","531299","93","40667","5.3","5.2"
"Fulton","2020-11-02","4429","535728","243","40910","5.3","5.2"
"Fulton","2020-11-03","4150","539878","206","41116","5.5","5.2"
"Fulton","2020-11-04","4036","543914","224","41340","5.7","5.3"
"Fulton","2020-11-05","4380","548294","235","41575","5.8","5.3"
"Fulton","2020-11-06","4234","552528","218","41793","5.8","5.3"
"Fulton","2020-11-07","2430","554958","190","41983","6.1","5.5"
"Fulton","2020-11-08","1145","556103","115","42098","6.3","5.8"
"Fulton","2020-11-09","4875","560978","317","42415","6.5","5.9"
"Fulton","2020-11-10","5068","566046","280","42695","6.6","6"
"Fulton","2020-11-11","4348","570394","284","42979","6.7","6.2"
"Fulton","2020-11-12","5185","575579","279","43258","6.7","6.2"
"Fulton","2020-11-13","5793","581372","322","43580","6.8","6.3"
"Fulton","2020-11-14","3040","584412","201","43781","6.6","6.3"
"Fulton","2020-11-15","1289","585701","119","43900","6.5","6.4"
"Fulton","2020-11-16","5900","591601","346","44246","6.4","6.4"
"Fulton","2020-11-17","6403","598004","322","44568","6.3","6.4"
"Fulton","2020-11-18","7585","605589","329","44897","6","6.4"
"Fulton","2020-11-19","7439","613028","356","45253","5.9","6.3"
"Fulton","2020-11-20","7733","620761","345","45598","5.8","6.3"
"Fulton","2020-11-21","4520","625281","227","45825","5.5","6.1"
"Fulton","2020-11-22","1862","627143","107","45932","5","5.8"
"Fulton","2020-11-23","8206","635349","394","46326","4.9","5.6"
"Fulton","2020-11-24","7373","642722","401","46727","4.9","5.6"
"Fulton","2020-11-25","5822","648544","415","47142","5.3","5.7"
"Fulton","2020-11-26","798","649342","54","47196","5.6","5.8"
"Fulton","2020-11-27","2624","651966","265","47461","6.4","6.1"
"Fulton","2020-11-28","2298","654264","239","47700","7.2","6.4"
"Fulton","2020-11-29","2078","656342","204","47904","7.8","6.4"
"Fulton","2020-11-30","6493","662835","597","48501","8.4","6.6"
"Fulton","2020-12-01","6006","668841","471","48972","8.7","6.8"
"Fulton","2020-12-02","5826","674667","498","49470","9","7.1"
"Fulton","2020-12-03","5854","680521","517","49987","9.2","7.4"
"Fulton","2020-12-04","5787","686308","478","50465","9","7.7"
"Fulton","2020-12-05","3320","689628","301","50766","8.8","8"
"Fulton","2020-12-06","1376","691004","158","50924","9","8.4"
"Fulton","2020-12-07","6128","697132","604","51528","9.1","8.8"
"Fulton","2020-12-08","6084","703216","520","52048","9.2","9"
"Fulton","2020-12-09","6386","709602","555","52603","9.2","9.1"
"Fulton","2020-12-10","5983","715585","559","53162","9.3","9.3"
"Fulton","2020-12-11","6318","721903","557","53719","9.4","9.2"
"Fulton","2020-12-12","3485","725388","335","54054","9.5","9.1"
"Fulton","2020-12-13","1525","726913","185","54239","9.6","9.3"
"Fulton","2020-12-14","7791","734704","854","55093","9.7","9.4"
"Fulton","2020-12-15","7862","742566","723","55816","9.8","9.5"
"Fulton","2020-12-16","7831","750397","707","56523","9.9","9.6"
"Fulton","2020-12-17","8012","758409","763","57286","9.9","9.6"
"Fulton","2020-12-18","8037","766446","728","58014","9.9","9.7"
"Fulton","2020-12-19","4657","771103","429","58443","9.9","9.7"
"Fulton","2020-12-20","2065","773168","221","58664","9.7","9.6"
"Fulton","2020-12-21","9894","783062","947","59611","9.5","9.6"
"Fulton","2020-12-22","8536","791598","869","60480","9.6","9.7"
"Fulton","2020-12-23","7204","798802","703","61183","9.7","9.8"
"Fulton","2020-12-24","2636","801438","328","61511","10.1","10"
"Fulton","2020-12-25","612","802050","96","61607","11.1","10.5"
"Fulton","2020-12-26","2834","804884","439","62046","12","10.9"
"Fulton","2020-12-27","1863","806747","316","62362","12.9","11.3"
"Fulton","2020-12-28","8487","815234","1148","63510","13.4","11.5"
"Fulton","2020-12-29","7138","822372","935","64445","13.9","11.7"
"Fulton","2020-12-30","6834","829206","877","65322","14.3","12"
"Fulton","2020-12-31","3433","832639","435","65757","14.3","12.2"
"Fulton","2021-01-01","682","833321","110","65867","14.4","12.7"
"Fulton","2021-01-02","3391","836712","574","66441","14.6","13.3"
"Fulton","2021-01-03","1302","838014","219","66660","14.6","13.7"
"Fulton","2021-01-04","7810","845824","1260","67920","14.9","14.2"
"Fulton","2021-01-05","9286","855110","1327","69247","15.1","14.5"
"Fulton","2021-01-06","7426","862536","960","70207","15.1","14.7"
"Fulton","2021-01-07","7139","869675","1036","71243","15.4","14.9"
"Fulton","2021-01-08","6131","875806","765","72008","14.9","14.6"
"Fulton","2021-01-09","3777","879583","541","72549","14.5","14.5"
"Fulton","2021-01-10","1655","881238","291","72840","14.6","14.6"
"Fulton","2021-01-11","7086","888324","923","73763","14.2","14.6"
"Fulton","2021-01-12","7466","895790","839","74602","13.7","14.4"
"Fulton","2021-01-13","6810","902600","798","75400","13.6","14.3"
"Fulton","2021-01-14","6113","908713","794","76194","13.3","14.4"
"Fulton","2021-01-15","6241","914954","717","76911","13.2","14"
"Fulton","2021-01-16","3681","918635","491","77402","13.1","13.8"
"Fulton","2021-01-17","1709","920344","258","77660","12.7","13.7"
"Fulton","2021-01-18","4274","924618","490","78150","12.5","13.3"
"Fulton","2021-01-19","7107","931725","764","78914","12.4","13.1"
"Fulton","2021-01-20","6756","938481","749","79663","12.3","12.9"
"Fulton","2021-01-21","5740","944221","642","80305","12.1","12.7"
"Fulton","2021-01-22","5782","950003","636","80941","12","12.6"
"Fulton","2021-01-23","2391","952394","335","81276","12.1","12.6"
"Fulton","2021-01-24","1096","953490","178","81454","12.2","12.5"
"Fulton","2021-01-25","2543","956033","278","81732","12.2","12.3"
"Fulton","2021-01-26","267","956300","25","81757","12","12.2"
"Fulton","2021-01-27","0","956300","0","81757","10.4","11.4"
"Gilmer","2020-02-01","0","0","0","0",".","."
"Gilmer","2020-02-02","0","0","0","0",".","."
"Gilmer","2020-02-03","0","0","0","0",".","."
"Gilmer","2020-02-04","0","0","0","0",".","."
"Gilmer","2020-02-05","0","0","0","0",".","."
"Gilmer","2020-02-06","0","0","0","0",".","."
"Gilmer","2020-02-07","0","0","0","0","0","."
"Gilmer","2020-02-08","0","0","0","0","0","."
"Gilmer","2020-02-09","0","0","0","0","0","."
"Gilmer","2020-02-10","0","0","0","0","0","."
"Gilmer","2020-02-11","0","0","0","0","0","."
"Gilmer","2020-02-12","0","0","0","0","0","."
"Gilmer","2020-02-13","0","0","0","0","0","."
"Gilmer","2020-02-14","0","0","0","0","0","0"
"Gilmer","2020-02-15","0","0","0","0","0","0"
"Gilmer","2020-02-16","0","0","0","0","0","0"
"Gilmer","2020-02-17","0","0","0","0","0","0"
"Gilmer","2020-02-18","0","0","0","0","0","0"
"Gilmer","2020-02-19","0","0","0","0","0","0"
"Gilmer","2020-02-20","0","0","0","0","0","0"
"Gilmer","2020-02-21","0","0","0","0","0","0"
"Gilmer","2020-02-22","0","0","0","0","0","0"
"Gilmer","2020-02-23","0","0","0","0","0","0"
"Gilmer","2020-02-24","0","0","0","0","0","0"
"Gilmer","2020-02-25","0","0","0","0","0","0"
"Gilmer","2020-02-26","0","0","0","0","0","0"
"Gilmer","2020-02-27","0","0","0","0","0","0"
"Gilmer","2020-02-28","0","0","0","0","0","0"
"Gilmer","2020-02-29","0","0","0","0","0","0"
"Gilmer","2020-03-01","0","0","0","0","0","0"
"Gilmer","2020-03-02","0","0","0","0","0","0"
"Gilmer","2020-03-03","0","0","0","0","0","0"
"Gilmer","2020-03-04","0","0","0","0","0","0"
"Gilmer","2020-03-05","0","0","0","0","0","0"
"Gilmer","2020-03-06","0","0","0","0","0","0"
"Gilmer","2020-03-07","0","0","0","0","0","0"
"Gilmer","2020-03-08","0","0","0","0","0","0"
"Gilmer","2020-03-09","0","0","0","0","0","0"
"Gilmer","2020-03-10","0","0","0","0","0","0"
"Gilmer","2020-03-11","0","0","0","0","0","0"
"Gilmer","2020-03-12","0","0","0","0","0","0"
"Gilmer","2020-03-13","1","1","0","0","0","0"
"Gilmer","2020-03-14","0","1","0","0","0","0"
"Gilmer","2020-03-15","0","1","0","0","0","0"
"Gilmer","2020-03-16","0","1","0","0","0","0"
"Gilmer","2020-03-17","0","1","0","0","0","0"
"Gilmer","2020-03-18","2","3","0","0","0","0"
"Gilmer","2020-03-19","4","7","1","1","3.6","1.8"
"Gilmer","2020-03-20","7","14","0","1","3.6","1.8"
"Gilmer","2020-03-21","2","16","0","1","3.6","1.8"
"Gilmer","2020-03-22","1","17","0","1","3.6","1.8"
"Gilmer","2020-03-23","3","20","0","1","3.6","1.8"
"Gilmer","2020-03-24","4","24","0","1","3.6","1.8"
"Gilmer","2020-03-25","4","28","0","1","3.6","1.8"
"Gilmer","2020-03-26","2","30","0","1","0","1.8"
"Gilmer","2020-03-27","7","37","0","1","0","1.8"
"Gilmer","2020-03-28","2","39","0","1","0","1.8"
"Gilmer","2020-03-29","0","39","0","1","0","1.8"
"Gilmer","2020-03-30","5","44","0","1","0","1.8"
"Gilmer","2020-03-31","4","48","0","1","0","1.8"
"Gilmer","2020-04-01","2","50","0","1","0","1.8"
"Gilmer","2020-04-02","2","52","0","1","0","0"
"Gilmer","2020-04-03","5","57","0","1","0","0"
"Gilmer","2020-04-04","0","57","0","1","0","0"
"Gilmer","2020-04-05","3","60","0","1","0","0"
"Gilmer","2020-04-06","5","65","0","1","0","0"
"Gilmer","2020-04-07","6","71","2","3","4.8","2.4"
"Gilmer","2020-04-08","9","80","1","4","6.3","3.2"
"Gilmer","2020-04-09","7","87","2","6","10.4","5.2"
"Gilmer","2020-04-10","6","93","2","8","15.2","7.6"
"Gilmer","2020-04-11","4","97","0","8","15.2","7.6"
"Gilmer","2020-04-12","0","97","0","8","15.2","7.6"
"Gilmer","2020-04-13","6","103","0","8","15.2","7.6"
"Gilmer","2020-04-14","8","111","1","9","12.2","8.5"
"Gilmer","2020-04-15","5","116","0","9","10.6","8.5"
"Gilmer","2020-04-16","8","124","0","9","6.5","8.5"
"Gilmer","2020-04-17","10","134","3","12","6.1","10.6"
"Gilmer","2020-04-18","7","141","1","13","8.1","11.7"
"Gilmer","2020-04-19","3","144","2","15","17.6","16.4"
"Gilmer","2020-04-20","8","152","0","15","17.6","16.4"
"Gilmer","2020-04-21","17","169","2","17","17.5","14.9"
"Gilmer","2020-04-22","10","179","2","19","20.4","15.5"
"Gilmer","2020-04-23","13","192","2","21","22.6","14.6"
"Gilmer","2020-04-24","24","216","0","21","18.3","12.2"
"Gilmer","2020-04-25","8","224","3","24","21.6","14.9"
"Gilmer","2020-04-26","12","236","0","24","12.1","14.9"
"Gilmer","2020-04-27","9","245","2","26","15.3","16.5"
"Gilmer","2020-04-28","16","261","3","29","16.3","16.9"
"Gilmer","2020-04-29","19","280","3","32","15.7","18"
"Gilmer","2020-04-30","13","293","2","34","15.7","19.1"
"Gilmer","2020-05-01","13","306","0","34","15.7","17"
"Gilmer","2020-05-02","5","311","0","34","10.3","16"
"Gilmer","2020-05-03","13","324","0","34","10.3","11.2"
"Gilmer","2020-05-04","11","335","0","34","7.1","11.2"
"Gilmer","2020-05-05","21","356","1","35","5.1","10.7"
"Gilmer","2020-05-06","39","395","6","41","5.1","10.4"
"Gilmer","2020-05-07","40","435","3","44","3.9","9.8"
"Gilmer","2020-05-08","42","477","2","46","4.6","10.1"
"Gilmer","2020-05-09","1","478","0","46","4.6","7.5"
"Gilmer","2020-05-10","15","493","0","46","4.6","7.5"
"Gilmer","2020-05-11","62","555","3","49","5.3","6.2"
"Gilmer","2020-05-12","61","616","5","54","5.8","5.5"
"Gilmer","2020-05-13","34","650","2","56","4.5","4.8"
"Gilmer","2020-05-14","31","681","3","59","4.8","4.4"
"Gilmer","2020-05-15","38","719","1","60","4.5","4.5"
"Gilmer","2020-05-16","5","724","1","61","7.3","6"
"Gilmer","2020-05-17","12","736","1","62","8.5","6.6"
"Gilmer","2020-05-18","27","763","0","62","7.8","6.6"
"Gilmer","2020-05-19","40","803","6","68","8.8","7.3"
"Gilmer","2020-05-20","51","854","4","72","9.1","6.8"
"Gilmer","2020-05-21","67","921","7","79","9.2","7"
"Gilmer","2020-05-22","40","961","2","81","9.5","7"
"Gilmer","2020-05-23","13","974","1","82","7.8","7.5"
"Gilmer","2020-05-24","5","979","1","83","9.4","9"
"Gilmer","2020-05-25","7","986","0","83","9.4","8.6"
"Gilmer","2020-05-26","59","1045","3","86","8","8.4"
"Gilmer","2020-05-27","61","1106","2","88","7.4","8.2"
"Gilmer","2020-05-28","56","1162","2","90","6.4","7.8"
"Gilmer","2020-05-29","24","1186","0","90","5.7","7.6"
"Gilmer","2020-05-30","12","1198","2","92","6.9","7.4"
"Gilmer","2020-05-31","13","1211","0","92","4.1","6.8"
"Gilmer","2020-06-01","41","1252","0","92","4.1","6.8"
"Gilmer","2020-06-02","38","1290","3","95","4.5","6.2"
"Gilmer","2020-06-03","48","1338","3","98","4.9","6.1"
"Gilmer","2020-06-04","47","1385","1","99","4.7","5.5"
"Gilmer","2020-06-05","20","1405","0","99","4.7","5.2"
"Gilmer","2020-06-06","8","1413","1","100","4.1","5.5"
"Gilmer","2020-06-07","8","1421","0","100","4.1","4.1"
"Gilmer","2020-06-08","35","1456","3","103","5.3","4.7"
"Gilmer","2020-06-09","30","1486","0","103","4.2","4.3"
"Gilmer","2020-06-10","23","1509","1","104","3.9","4.4"
"Gilmer","2020-06-11","26","1535","2","106","4.7","4.7"
"Gilmer","2020-06-12","69","1604","1","107","4.9","4.8"
"Gilmer","2020-06-13","11","1615","0","107","3.2","3.6"
"Gilmer","2020-06-14","12","1627","0","107","3.2","3.6"
"Gilmer","2020-06-15","22","1649","0","107","1.9","3.6"
"Gilmer","2020-06-16","24","1673","1","108","2.5","3.4"
"Gilmer","2020-06-17","27","1700","0","108","1.9","2.9"
"Gilmer","2020-06-18","19","1719","0","108","0.8","2.8"
"Gilmer","2020-06-19","29","1748","3","111","2.1","3.5"
"Gilmer","2020-06-20","5","1753","0","111","2.1","2.6"
"Gilmer","2020-06-21","8","1761","0","111","2.1","2.6"
"Gilmer","2020-06-22","28","1789","0","111","2.1","2"
"Gilmer","2020-06-23","18","1807","0","111","1.5","2"
"Gilmer","2020-06-24","32","1839","0","111","1.5","1.7"
"Gilmer","2020-06-25","24","1863","0","111","1.5","1.1"
"Gilmer","2020-06-26","26","1889","0","111","0","1"
"Gilmer","2020-06-27","9","1898","0","111","0","1"
"Gilmer","2020-06-28","9","1907","1","112","1.6","1.8"
"Gilmer","2020-06-29","48","1955","3","115","2.5","2.3"
"Gilmer","2020-06-30","23","1978","2","117","3.7","2.6"
"Gilmer","2020-07-01","31","2009","0","117","3.7","2.6"
"Gilmer","2020-07-02","31","2040","4","121","5.6","3.5"
"Gilmer","2020-07-03","12","2052","0","121","5.6","2.8"
"Gilmer","2020-07-04","8","2060","0","121","5.6","2.8"
"Gilmer","2020-07-05","10","2070","0","121","4","2.8"
"Gilmer","2020-07-06","38","2108","6","127","5.3","3.9"
"Gilmer","2020-07-07","41","2149","9","136","7.2","5.5"
"Gilmer","2020-07-08","54","2203","8","144","9.4","6.5"
"Gilmer","2020-07-09","33","2236","6","150","10.1","7.8"
"Gilmer","2020-07-10","45","2281","2","152","10.7","8.2"
"Gilmer","2020-07-11","7","2288","2","154","14.8","10.2"
"Gilmer","2020-07-12","16","2304","4","158","18.4","11.2"
"Gilmer","2020-07-13","40","2344","6","164","18.3","11.8"
"Gilmer","2020-07-14","49","2393","8","172","17.5","12.4"
"Gilmer","2020-07-15","30","2423","4","176","17.3","13.3"
"Gilmer","2020-07-16","38","2461","6","182","16.9","13.5"
"Gilmer","2020-07-17","53","2514","11","193","19.3","15"
"Gilmer","2020-07-18","17","2531","10","203","23.6","19.2"
"Gilmer","2020-07-19","7","2538","1","204","22","20.2"
"Gilmer","2020-07-20","55","2593","12","216","23","20.6"
"Gilmer","2020-07-21","41","2634","14","230","25.6","21.5"
"Gilmer","2020-07-22","23","2657","4","234","26.1","21.7"
"Gilmer","2020-07-23","42","2699","2","236","24.6","20.7"
"Gilmer","2020-07-24","36","2735","5","241","23.6","21.4"
"Gilmer","2020-07-25","15","2750","1","242","16.1","19.9"
"Gilmer","2020-07-26","13","2763","5","247","19.6","20.8"
"Gilmer","2020-07-27","54","2817","3","250","17.3","20.1"
"Gilmer","2020-07-28","31","2848","6","256","15.2","20.4"
"Gilmer","2020-07-29","22","2870","3","259","14.6","20.4"
"Gilmer","2020-07-30","51","2921","6","265","15.6","20.1"
"Gilmer","2020-07-31","33","2954","5","270","15.8","19.7"
"Gilmer","2020-08-01","19","2973","6","276","19.4","17.7"
"Gilmer","2020-08-02","32","3005","4","280","15.6","17.6"
"Gilmer","2020-08-03","82","3087","3","283","15.4","16.3"
"Gilmer","2020-08-04","27","3114","4","287","14.7","14.9"
"Gilmer","2020-08-05","37","3151","1","288","13.2","13.9"
"Gilmer","2020-08-06","29","3180","6","294","14.4","15"
"Gilmer","2020-08-07","25","3205","2","296","13.4","14.6"
"Gilmer","2020-08-08","10","3215","2","298","11.8","15.6"
"Gilmer","2020-08-09","24","3239","2","300","11.2","13.4"
"Gilmer","2020-08-10","45","3284","7","307","12.9","14.1"
"Gilmer","2020-08-11","35","3319","3","310","12","13.4"
"Gilmer","2020-08-12","128","3447","10","320","12.7","12.9"
"Gilmer","2020-08-13","40","3487","4","324","11.2","12.8"
"Gilmer","2020-08-14","58","3545","2","326","10.5","12"
"Gilmer","2020-08-15","7","3552","0","326","7.7","9.7"
"Gilmer","2020-08-16","8","3560","1","327","8.3","9.7"
"Gilmer","2020-08-17","45","3605","2","329","6.7","9.8"
"Gilmer","2020-08-18","18","3623","4","333","8.6","10.3"
"Gilmer","2020-08-19","29","3652","3","336","9","10.9"
"Gilmer","2020-08-20","38","3690","1","337","7.9","9.6"
"Gilmer","2020-08-21","17","3707","2","339","9.1","9.8"
"Gilmer","2020-08-22","11","3718","3","342","13","10.4"
"Gilmer","2020-08-23","36","3754","2","344","12","10.2"
"Gilmer","2020-08-24","61","3815","2","346","11.9","9.3"
"Gilmer","2020-08-25","39","3854","2","348","9.4","9"
"Gilmer","2020-08-26","25","3879","2","350","9.1","9"
"Gilmer","2020-08-27","24","3903","0","350","8.7","8.3"
"Gilmer","2020-08-28","35","3938","0","350","7","8.1"
"Gilmer","2020-08-29","9","3947","1","351","4.7","8.9"
"Gilmer","2020-08-30","36","3983","0","351","3.9","8"
"Gilmer","2020-08-31","56","4039","3","354","4.2","8"
"Gilmer","2020-09-01","38","4077","3","357","4.6","7"
"Gilmer","2020-09-02","15","4092","2","359","5.4","7.2"
"Gilmer","2020-09-03","66","4158","1","360","5.6","7.2"
"Gilmer","2020-09-04","56","4214","2","362","6.1","6.6"
"Gilmer","2020-09-05","17","4231","0","362","4.5","4.6"
"Gilmer","2020-09-06","11","4242","0","362","4.5","4.2"
"Gilmer","2020-09-07","13","4255","0","362","3.8","4"
"Gilmer","2020-09-08","67","4322","3","365","3.3","3.9"
"Gilmer","2020-09-09","36","4358","1","366","1.8","3.6"
"Gilmer","2020-09-10","36","4394","3","369","2.7","4.2"
"Gilmer","2020-09-11","50","4444","0","369","2.2","4.2"
"Gilmer","2020-09-12","2","4446","0","369","2.2","3.4"
"Gilmer","2020-09-13","11","4457","1","370","3.5","4"
"Gilmer","2020-09-14","69","4526","1","371","3.7","3.7"
"Gilmer","2020-09-15","34","4560","1","372","3.5","3.4"
"Gilmer","2020-09-16","35","4595","0","372","3.1","2.4"
"Gilmer","2020-09-17","27","4622","2","374","3","2.9"
"Gilmer","2020-09-18","56","4678","2","376","3.5","2.9"
"Gilmer","2020-09-19","52","4730","0","376","3.5","2.9"
"Gilmer","2020-09-20","14","4744","0","376","2.2","2.9"
"Gilmer","2020-09-21","36","4780","3","379","3.2","3.5"
"Gilmer","2020-09-22","29","4809","0","379","2.8","3.1"
"Gilmer","2020-09-23","30","4839","1","380","3.2","3.2"
"Gilmer","2020-09-24","40","4879","1","381","2.5","2.8"
"Gilmer","2020-09-25","23","4902","1","382","2.6","3.1"
"Gilmer","2020-09-26","10","4912","1","383","4.1","3.8"
"Gilmer","2020-09-27","8","4920","0","383","4.1","3.1"
"Gilmer","2020-09-28","37","4957","3","386","4","3.6"
"Gilmer","2020-09-29","25","4982","1","387","4.6","3.7"
"Gilmer","2020-09-30","32","5014","1","388","4.6","3.9"
"Gilmer","2020-10-01","36","5050","1","389","4.6","3.6"
"Gilmer","2020-10-02","107","5157","7","396","4.9","3.8"
"Gilmer","2020-10-03","32","5189","4","400","5.3","4.7"
"Gilmer","2020-10-04","41","5230","8","408","8.1","6.1"
"Gilmer","2020-10-05","48","5278","3","411","7.8","5.9"
"Gilmer","2020-10-06","36","5314","4","415","8.8","6.7"
"Gilmer","2020-10-07","82","5396","9","424","10","7.3"
"Gilmer","2020-10-08","91","5487","8","432","10.8","7.7"
"Gilmer","2020-10-09","55","5542","3","435","10.7","7.8"
"Gilmer","2020-10-10","12","5554","2","437","11.3","8.3"
"Gilmer","2020-10-11","10","5564","1","438","9.9","9"
"Gilmer","2020-10-12","49","5613","3","441","9.9","8.8"
"Gilmer","2020-10-13","76","5689","4","445","9","8.9"
"Gilmer","2020-10-14","40","5729","8","453","10.3","10.1"
"Gilmer","2020-10-15","38","5767","3","456","10.2","10.5"
"Gilmer","2020-10-16","45","5812","2","458","10.1","10.4"
"Gilmer","2020-10-17","23","5835","0","458","7.7","9.5"
"Gilmer","2020-10-18","7","5842","3","461","12.4","11.1"
"Gilmer","2020-10-19","44","5886","1","462","11.8","10.8"
"Gilmer","2020-10-20","38","5924","0","462","11.1","10.1"
"Gilmer","2020-10-21","81","6005","12","474","10.3","10.3"
"Gilmer","2020-10-22","28","6033","2","476","10.2","10.2"
"Gilmer","2020-10-23","42","6075","4","480","10.9","10.5"
"Gilmer","2020-10-24","11","6086","1","481","12.2","10"
"Gilmer","2020-10-25","14","6100","0","481","6.1","9.2"
"Gilmer","2020-10-26","59","6159","7","488","7.5","9.7"
"Gilmer","2020-10-27","33","6192","0","488","7.5","9.3"
"Gilmer","2020-10-28","35","6227","2","490","6.2","8.3"
"Gilmer","2020-10-29","48","6275","7","497","7.3","8.7"
"Gilmer","2020-10-30","53","6328","2","499","6.4","8.7"
"Gilmer","2020-10-31","16","6344","4","503","8.7","10.5"
"Gilmer","2020-11-01","12","6356","4","507","13.5","9.8"
"Gilmer","2020-11-02","41","6397","2","509","12.5","10"
"Gilmer","2020-11-03","33","6430","2","511","13.3","10.4"
"Gilmer","2020-11-04","47","6477","3","514","13.4","9.8"
"Gilmer","2020-11-05","77","6554","3","517","11.9","9.6"
"Gilmer","2020-11-06","43","6597","2","519","12","9.2"
"Gilmer","2020-11-07","12","6609","2","521","10.8","9.8"
"Gilmer","2020-11-08","11","6620","2","523","8.7","11.1"
"Gilmer","2020-11-09","37","6657","4","527","9.5","11"
"Gilmer","2020-11-10","46","6703","3","530","9.6","11.5"
"Gilmer","2020-11-11","59","6762","11","541","11.3","12.4"
"Gilmer","2020-11-12","85","6847","5","546","11.6","11.8"
"Gilmer","2020-11-13","39","6886","2","548","11.7","11.9"
"Gilmer","2020-11-14","26","6912","1","549","9.9","10.3"
"Gilmer","2020-11-15","12","6924","1","550","8.5","8.6"
"Gilmer","2020-11-16","61","6985","5","555","8.1","8.8"
"Gilmer","2020-11-17","93","7078","3","558","7.6","8.6"
"Gilmer","2020-11-18","58","7136","3","561","5.7","8.5"
"Gilmer","2020-11-19","80","7216","2","563","5.2","8.4"
"Gilmer","2020-11-20","38","7254","2","565","5.2","8.5"
"Gilmer","2020-11-21","24","7278","1","566","5.3","7.6"
"Gilmer","2020-11-22","18","7296","1","567","4.9","6.7"
"Gilmer","2020-11-23","42","7338","7","574","6.1","7.1"
"Gilmer","2020-11-24","104","7442","10","584","7","7.3"
"Gilmer","2020-11-25","59","7501","8","592","8.2","6.9"
"Gilmer","2020-11-26","31","7532","2","594","8.8","7"
"Gilmer","2020-11-27","63","7595","7","601","9.6","7.4"
"Gilmer","2020-11-28","37","7632","7","608","11.7","8.5"
"Gilmer","2020-11-29","20","7652","7","615","15.9","10.4"
"Gilmer","2020-11-30","83","7735","15","630","16.1","11.1"
"Gilmer","2020-12-01","65","7800","12","642","17.4","12.2"
"Gilmer","2020-12-02","67","7867","10","652","17.6","12.9"
"Gilmer","2020-12-03","54","7921","6","658","18.2","13.5"
"Gilmer","2020-12-04","71","7992","12","670","19.1","14.3"
"Gilmer","2020-12-05","30","8022","5","675","18.7","15.2"
"Gilmer","2020-12-06","26","8048","6","681","17","16.5"
"Gilmer","2020-12-07","83","8131","15","696","17","16.6"
"Gilmer","2020-12-08","50","8181","12","708","17.8","17.6"
"Gilmer","2020-12-09","87","8268","11","719","17.5","17.5"
"Gilmer","2020-12-10","74","8342","9","728","17.6","17.9"
"Gilmer","2020-12-11","94","8436","9","737","16.6","17.8"
"Gilmer","2020-12-12","79","8515","7","744","15.5","17.1"
"Gilmer","2020-12-13","50","8565","5","749","13.6","15.3"
"Gilmer","2020-12-14","135","8700","9","758","12","14.5"
"Gilmer","2020-12-15","79","8779","22","780","12.5","15.2"
"Gilmer","2020-12-16","100","8879","15","795","12.9","15.2"
"Gilmer","2020-12-17","49","8928","8","803","13.5","15.6"
"Gilmer","2020-12-18","133","9061","16","819","13.8","15.2"
"Gilmer","2020-12-19","82","9143","5","824","13.4","14.5"
"Gilmer","2020-12-20","25","9168","6","830","15.4","14.5"
"Gilmer","2020-12-21","128","9296","15","845","16.1","14.1"
"Gilmer","2020-12-22","72","9368","14","859","14.9","13.7"
"Gilmer","2020-12-23","94","9462","22","881","16.1","14.5"
"Gilmer","2020-12-24","99","9561","10","891","15.3","14.4"
"Gilmer","2020-12-25","12","9573","7","898","21.9","17.8"
"Gilmer","2020-12-26","24","9597","6","904","24.6","19"
"Gilmer","2020-12-27","34","9631","13","917","26.6","21"
"Gilmer","2020-12-28","87","9718","21","938","28.4","22.3"
"Gilmer","2020-12-29","97","9815","15","953","27.8","21.4"
"Gilmer","2020-12-30","63","9878","16","969","28.1","22.1"
"Gilmer","2020-12-31","88","9966","23","992","30.4","22.8"
"Gilmer","2021-01-01","13","9979","6","998","28.6","25.3"
"Gilmer","2021-01-02","11","9990","5","1003","31.6","28.1"
"Gilmer","2021-01-03","35","10025","7","1010","29","27.8"
"Gilmer","2021-01-04","71","10096","21","1031","29.7","29.1"
"Gilmer","2021-01-05","88","10184","19","1050","30.6","29.2"
"Gilmer","2021-01-06","102","10286","25","1075","30.5","29.3"
"Gilmer","2021-01-07","73","10359","24","1099","31.5","30.9"
"Gilmer","2021-01-08","61","10420","24","1123","30.5","29.6"
"Gilmer","2021-01-09","28","10448","10","1133","29.1","30.3"
"Gilmer","2021-01-10","36","10484","6","1139","28.6","28.8"
"Gilmer","2021-01-11","82","10566","19","1158","27.7","28.7"
"Gilmer","2021-01-12","128","10694","16","1174","26.4","28.5"
"Gilmer","2021-01-13","69","10763","20","1194","27","28.8"
"Gilmer","2021-01-14","168","10931","14","1208","23.5","27.5"
"Gilmer","2021-01-15","87","11018","20","1228","21.2","25.8"
"Gilmer","2021-01-16","39","11057","14","1242","21.2","25.2"
"Gilmer","2021-01-17","30","11087","7","1249","22.2","25.4"
"Gilmer","2021-01-18","78","11165","19","1268","22.3","25"
"Gilmer","2021-01-19","125","11290","15","1283","22.3","24.3"
"Gilmer","2021-01-20","156","11446","17","1300","19.7","23.4"
"Gilmer","2021-01-21","74","11520","13","1313","21","22.3"
"Gilmer","2021-01-22","64","11584","7","1320","19.3","20.2"
"Gilmer","2021-01-23","38","11622","12","1332","18.7","19.9"
"Gilmer","2021-01-24","6","11628","1","1333","17.7","19.9"
"Gilmer","2021-01-25","21","11649","6","1339","18.3","20.3"
"Gilmer","2021-01-26","1","11650","0","1339","16.6","19.4"
"Gilmer","2021-01-27","0","11650","0","1339","15","17.4"
"Glascock","2020-02-01","0","0","0","0",".","."
"Glascock","2020-02-02","0","0","0","0",".","."
"Glascock","2020-02-03","0","0","0","0",".","."
"Glascock","2020-02-04","0","0","0","0",".","."
"Glascock","2020-02-05","0","0","0","0",".","."
"Glascock","2020-02-06","0","0","0","0",".","."
"Glascock","2020-02-07","0","0","0","0","0","."
"Glascock","2020-02-08","0","0","0","0","0","."
"Glascock","2020-02-09","0","0","0","0","0","."
"Glascock","2020-02-10","0","0","0","0","0","."
"Glascock","2020-02-11","0","0","0","0","0","."
"Glascock","2020-02-12","0","0","0","0","0","."
"Glascock","2020-02-13","0","0","0","0","0","."
"Glascock","2020-02-14","0","0","0","0","0","0"
"Glascock","2020-02-15","0","0","0","0","0","0"
"Glascock","2020-02-16","0","0","0","0","0","0"
"Glascock","2020-02-17","0","0","0","0","0","0"
"Glascock","2020-02-18","0","0","0","0","0","0"
"Glascock","2020-02-19","0","0","0","0","0","0"
"Glascock","2020-02-20","0","0","0","0","0","0"
"Glascock","2020-02-21","0","0","0","0","0","0"
"Glascock","2020-02-22","0","0","0","0","0","0"
"Glascock","2020-02-23","0","0","0","0","0","0"
"Glascock","2020-02-24","0","0","0","0","0","0"
"Glascock","2020-02-25","0","0","0","0","0","0"
"Glascock","2020-02-26","0","0","0","0","0","0"
"Glascock","2020-02-27","0","0","0","0","0","0"
"Glascock","2020-02-28","0","0","0","0","0","0"
"Glascock","2020-02-29","0","0","0","0","0","0"
"Glascock","2020-03-01","0","0","0","0","0","0"
"Glascock","2020-03-02","0","0","0","0","0","0"
"Glascock","2020-03-03","0","0","0","0","0","0"
"Glascock","2020-03-04","0","0","0","0","0","0"
"Glascock","2020-03-05","0","0","0","0","0","0"
"Glascock","2020-03-06","0","0","0","0","0","0"
"Glascock","2020-03-07","0","0","0","0","0","0"
"Glascock","2020-03-08","0","0","0","0","0","0"
"Glascock","2020-03-09","0","0","0","0","0","0"
"Glascock","2020-03-10","0","0","0","0","0","0"
"Glascock","2020-03-11","0","0","0","0","0","0"
"Glascock","2020-03-12","0","0","0","0","0","0"
"Glascock","2020-03-13","0","0","0","0","0","0"
"Glascock","2020-03-14","0","0","0","0","0","0"
"Glascock","2020-03-15","0","0","0","0","0","0"
"Glascock","2020-03-16","0","0","0","0","0","0"
"Glascock","2020-03-17","0","0","0","0","0","0"
"Glascock","2020-03-18","0","0","0","0","0","0"
"Glascock","2020-03-19","1","1","0","0","0","0"
"Glascock","2020-03-20","1","2","0","0","0","0"
"Glascock","2020-03-21","0","2","0","0","0","0"
"Glascock","2020-03-22","1","3","0","0","0","0"
"Glascock","2020-03-23","0","3","0","0","0","0"
"Glascock","2020-03-24","0","3","0","0","0","0"
"Glascock","2020-03-25","1","4","0","0","0","0"
"Glascock","2020-03-26","0","4","0","0","0","0"
"Glascock","2020-03-27","2","6","0","0","0","0"
"Glascock","2020-03-28","0","6","0","0","0","0"
"Glascock","2020-03-29","0","6","0","0","0","0"
"Glascock","2020-03-30","1","7","0","0","0","0"
"Glascock","2020-03-31","0","7","0","0","0","0"
"Glascock","2020-04-01","1","8","0","0","0","0"
"Glascock","2020-04-02","0","8","0","0","0","0"
"Glascock","2020-04-03","0","8","0","0","0","0"
"Glascock","2020-04-04","0","8","0","0","0","0"
"Glascock","2020-04-05","1","9","0","0","0","0"
"Glascock","2020-04-06","0","9","0","0","0","0"
"Glascock","2020-04-07","1","10","0","0","0","0"
"Glascock","2020-04-08","0","10","0","0","0","0"
"Glascock","2020-04-09","0","10","0","0","0","0"
"Glascock","2020-04-10","0","10","0","0","0","0"
"Glascock","2020-04-11","0","10","0","0","0","0"
"Glascock","2020-04-12","0","10","0","0","0","0"
"Glascock","2020-04-13","1","11","0","0","0","0"
"Glascock","2020-04-14","2","13","0","0","0","0"
"Glascock","2020-04-15","1","14","0","0","0","0"
"Glascock","2020-04-16","1","15","0","0","0","0"
"Glascock","2020-04-17","0","15","0","0","0","0"
"Glascock","2020-04-18","0","15","0","0","0","0"
"Glascock","2020-04-19","0","15","0","0","0","0"
"Glascock","2020-04-20","1","16","0","0","0","0"
"Glascock","2020-04-21","2","18","0","0","0","0"
"Glascock","2020-04-22","1","19","0","0","0","0"
"Glascock","2020-04-23","1","20","0","0","0","0"
"Glascock","2020-04-24","0","20","0","0","0","0"
"Glascock","2020-04-25","2","22","0","0","0","0"
"Glascock","2020-04-26","1","23","0","0","0","0"
"Glascock","2020-04-27","0","23","0","0","0","0"
"Glascock","2020-04-28","0","23","0","0","0","0"
"Glascock","2020-04-29","0","23","0","0","0","0"
"Glascock","2020-04-30","0","23","0","0","0","0"
"Glascock","2020-05-01","10","33","0","0","0","0"
"Glascock","2020-05-02","1","34","0","0","0","0"
"Glascock","2020-05-03","0","34","0","0","0","0"
"Glascock","2020-05-04","2","36","0","0","0","0"
"Glascock","2020-05-05","3","39","0","0","0","0"
"Glascock","2020-05-06","0","39","0","0","0","0"
"Glascock","2020-05-07","2","41","0","0","0","0"
"Glascock","2020-05-08","1","42","0","0","0","0"
"Glascock","2020-05-09","0","42","0","0","0","0"
"Glascock","2020-05-10","0","42","0","0","0","0"
"Glascock","2020-05-11","0","42","0","0","0","0"
"Glascock","2020-05-12","4","46","0","0","0","0"
"Glascock","2020-05-13","0","46","0","0","0","0"
"Glascock","2020-05-14","0","46","0","0","0","0"
"Glascock","2020-05-15","2","48","0","0","0","0"
"Glascock","2020-05-16","2","50","0","0","0","0"
"Glascock","2020-05-17","0","50","0","0","0","0"
"Glascock","2020-05-18","0","50","0","0","0","0"
"Glascock","2020-05-19","0","50","0","0","0","0"
"Glascock","2020-05-20","1","51","0","0","0","0"
"Glascock","2020-05-21","1","52","0","0","0","0"
"Glascock","2020-05-22","1","53","0","0","0","0"
"Glascock","2020-05-23","0","53","0","0","0","0"
"Glascock","2020-05-24","2","55","0","0","0","0"
"Glascock","2020-05-25","0","55","0","0","0","0"
"Glascock","2020-05-26","4","59","0","0","0","0"
"Glascock","2020-05-27","0","59","0","0","0","0"
"Glascock","2020-05-28","1","60","0","0","0","0"
"Glascock","2020-05-29","0","60","0","0","0","0"
"Glascock","2020-05-30","0","60","0","0","0","0"
"Glascock","2020-05-31","1","61","0","0","0","0"
"Glascock","2020-06-01","0","61","0","0","0","0"
"Glascock","2020-06-02","1","62","1","1","14.3","7.1"
"Glascock","2020-06-03","0","62","0","1","14.3","7.1"
"Glascock","2020-06-04","4","66","0","1","14.3","7.1"
"Glascock","2020-06-05","0","66","0","1","14.3","7.1"
"Glascock","2020-06-06","0","66","0","1","14.3","7.1"
"Glascock","2020-06-07","0","66","0","1","14.3","7.1"
"Glascock","2020-06-08","0","66","0","1","14.3","7.1"
"Glascock","2020-06-09","0","66","0","1","0","7.1"
"Glascock","2020-06-10","2","68","0","1","0","7.1"
"Glascock","2020-06-11","1","69","0","1","0","7.1"
"Glascock","2020-06-12","0","69","0","1","0","7.1"
"Glascock","2020-06-13","0","69","0","1","0","7.1"
"Glascock","2020-06-14","0","69","0","1","0","7.1"
"Glascock","2020-06-15","1","70","0","1","0","7.1"
"Glascock","2020-06-16","1","71","1","2","14.3","7.1"
"Glascock","2020-06-17","3","74","0","2","14.3","7.1"
"Glascock","2020-06-18","3","77","0","2","14.3","7.1"
"Glascock","2020-06-19","2","79","0","2","14.3","7.1"
"Glascock","2020-06-20","1","80","0","2","14.3","7.1"
"Glascock","2020-06-21","2","82","0","2","14.3","7.1"
"Glascock","2020-06-22","0","82","0","2","14.3","7.1"
"Glascock","2020-06-23","1","83","0","2","0","7.1"
"Glascock","2020-06-24","3","86","0","2","0","7.1"
"Glascock","2020-06-25","5","91","0","2","0","7.1"
"Glascock","2020-06-26","1","92","0","2","0","7.1"
"Glascock","2020-06-27","1","93","0","2","0","7.1"
"Glascock","2020-06-28","5","98","1","3","2.9","8.6"
"Glascock","2020-06-29","8","106","0","3","2.9","8.6"
"Glascock","2020-06-30","6","112","1","4","5.2","2.6"
"Glascock","2020-07-01","2","114","1","5","12.4","6.2"
"Glascock","2020-07-02","0","114","0","5","12.4","6.2"
"Glascock","2020-07-03","0","114","0","5","12.4","6.2"
"Glascock","2020-07-04","2","116","0","5","12.4","6.2"
"Glascock","2020-07-05","2","118","0","5","9.5","6.2"
"Glascock","2020-07-06","3","121","0","5","9.5","6.2"
"Glascock","2020-07-07","3","124","0","5","7.1","6.2"
"Glascock","2020-07-08","6","130","0","5","0","6.2"
"Glascock","2020-07-09","0","130","0","5","0","6.2"
"Glascock","2020-07-10","4","134","0","5","0","6.2"
"Glascock","2020-07-11","3","137","0","5","0","6.2"
"Glascock","2020-07-12","3","140","0","5","0","4.8"
"Glascock","2020-07-13","3","143","1","6","4.8","7.1"
"Glascock","2020-07-14","3","146","0","6","4.8","6"
"Glascock","2020-07-15","5","151","0","6","4.8","2.4"
"Glascock","2020-07-16","1","152","0","6","4.8","2.4"
"Glascock","2020-07-17","1","153","0","6","4.8","2.4"
"Glascock","2020-07-18","1","154","0","6","4.8","2.4"
"Glascock","2020-07-19","1","155","0","6","4.8","2.4"
"Glascock","2020-07-20","0","155","0","6","0","2.4"
"Glascock","2020-07-21","2","157","0","6","0","2.4"
"Glascock","2020-07-22","1","158","0","6","0","2.4"
"Glascock","2020-07-23","1","159","0","6","0","2.4"
"Glascock","2020-07-24","1","160","0","6","0","2.4"
"Glascock","2020-07-25","1","161","1","7","14.3","9.5"
"Glascock","2020-07-26","1","162","0","7","14.3","9.5"
"Glascock","2020-07-27","1","163","0","7","14.3","7.1"
"Glascock","2020-07-28","2","165","0","7","14.3","7.1"
"Glascock","2020-07-29","1","166","1","8","28.6","14.3"
"Glascock","2020-07-30","0","166","0","8","28.6","14.3"
"Glascock","2020-07-31","3","169","1","9","33.3","16.7"
"Glascock","2020-08-01","4","173","0","9","19","16.7"
"Glascock","2020-08-02","0","173","0","9","19","16.7"
"Glascock","2020-08-03","2","175","0","9","19","16.7"
"Glascock","2020-08-04","3","178","1","10","23.8","19"
"Glascock","2020-08-05","0","178","0","10","9.5","19"
"Glascock","2020-08-06","1","179","0","10","9.5","19"
"Glascock","2020-08-07","2","181","1","11","11.9","22.6"
"Glascock","2020-08-08","2","183","0","11","11.9","15.5"
"Glascock","2020-08-09","3","186","0","11","11.9","15.5"
"Glascock","2020-08-10","2","188","0","11","11.9","15.5"
"Glascock","2020-08-11","2","190","0","11","7.1","15.5"
"Glascock","2020-08-12","4","194","1","12","10.7","10.1"
"Glascock","2020-08-13","1","195","0","12","10.7","10.1"
"Glascock","2020-08-14","3","198","0","12","3.6","7.7"
"Glascock","2020-08-15","4","202","0","12","3.6","7.7"
"Glascock","2020-08-16","0","202","0","12","3.6","7.7"
"Glascock","2020-08-17","3","205","3","15","17.9","14.9"
"Glascock","2020-08-18","3","208","0","15","17.9","12.5"
"Glascock","2020-08-19","1","209","0","15","14.3","12.5"
"Glascock","2020-08-20","3","212","1","16","19","14.9"
"Glascock","2020-08-21","2","214","0","16","19","11.3"
"Glascock","2020-08-22","2","216","0","16","19","11.3"
"Glascock","2020-08-23","2","218","0","16","19","11.3"
"Glascock","2020-08-24","1","219","0","16","4.8","11.3"
"Glascock","2020-08-25","3","222","0","16","4.8","11.3"
"Glascock","2020-08-26","2","224","0","16","4.8","9.5"
"Glascock","2020-08-27","5","229","1","17","2.9","11"
"Glascock","2020-08-28","3","232","1","18","7.6","13.3"
"Glascock","2020-08-29","0","232","0","18","7.6","13.3"
"Glascock","2020-08-30","1","233","0","18","7.6","13.3"
"Glascock","2020-08-31","3","236","0","18","7.6","6.2"
"Glascock","2020-09-01","2","238","0","18","7.6","6.2"
"Glascock","2020-09-02","2","240","0","18","7.6","6.2"
"Glascock","2020-09-03","4","244","2","20","11.9","7.4"
"Glascock","2020-09-04","0","244","0","20","7.1","7.4"
"Glascock","2020-09-05","1","245","0","20","7.1","7.4"
"Glascock","2020-09-06","3","248","0","20","7.1","7.4"
"Glascock","2020-09-07","0","248","0","20","7.1","7.4"
"Glascock","2020-09-08","0","248","0","20","7.1","7.4"
"Glascock","2020-09-09","3","251","0","20","7.1","7.4"
"Glascock","2020-09-10","4","255","0","20","0","6"
"Glascock","2020-09-11","1","256","0","20","0","3.6"
"Glascock","2020-09-12","0","256","0","20","0","3.6"
"Glascock","2020-09-13","0","256","0","20","0","3.6"
"Glascock","2020-09-14","6","262","1","21","2.4","4.8"
"Glascock","2020-09-15","1","263","0","21","2.4","4.8"
"Glascock","2020-09-16","0","263","0","21","2.4","4.8"
"Glascock","2020-09-17","2","265","0","21","2.4","1.2"
"Glascock","2020-09-18","2","267","0","21","2.4","1.2"
"Glascock","2020-09-19","1","268","0","21","2.4","1.2"
"Glascock","2020-09-20","0","268","0","21","2.4","1.2"
"Glascock","2020-09-21","7","275","0","21","0","1.2"
"Glascock","2020-09-22","8","283","0","21","0","1.2"
"Glascock","2020-09-23","3","286","0","21","0","1.2"
"Glascock","2020-09-24","0","286","0","21","0","1.2"
"Glascock","2020-09-25","0","286","0","21","0","1.2"
"Glascock","2020-09-26","0","286","0","21","0","1.2"
"Glascock","2020-09-27","0","286","0","21","0","1.2"
"Glascock","2020-09-28","1","287","0","21","0","0"
"Glascock","2020-09-29","1","288","0","21","0","0"
"Glascock","2020-09-30","1","289","1","22","14.3","7.1"
"Glascock","2020-10-01","0","289","0","22","14.3","7.1"
"Glascock","2020-10-02","1","290","0","22","14.3","7.1"
"Glascock","2020-10-03","1","291","0","22","14.3","7.1"
"Glascock","2020-10-04","2","293","0","22","14.3","7.1"
"Glascock","2020-10-05","6","299","0","22","14.3","7.1"
"Glascock","2020-10-06","14","313","0","22","14.3","7.1"
"Glascock","2020-10-07","1","314","0","22","0","7.1"
"Glascock","2020-10-08","2","316","0","22","0","7.1"
"Glascock","2020-10-09","4","320","0","22","0","7.1"
"Glascock","2020-10-10","1","321","0","22","0","7.1"
"Glascock","2020-10-11","2","323","0","22","0","7.1"
"Glascock","2020-10-12","4","327","0","22","0","7.1"
"Glascock","2020-10-13","5","332","0","22","0","7.1"
"Glascock","2020-10-14","3","335","1","23","4.8","2.4"
"Glascock","2020-10-15","5","340","1","24","7.6","3.8"
"Glascock","2020-10-16","4","344","1","25","11.2","5.6"
"Glascock","2020-10-17","1","345","0","25","11.2","5.6"
"Glascock","2020-10-18","1","346","0","25","11.2","5.6"
"Glascock","2020-10-19","1","347","0","25","11.2","5.6"
"Glascock","2020-10-20","62","409","4","29","12.1","6.1"
"Glascock","2020-10-21","1","410","0","29","7.4","6.1"
"Glascock","2020-10-22","4","414","0","29","4.5","6.1"
"Glascock","2020-10-23","2","416","0","29","0.9","6.1"
"Glascock","2020-10-24","3","419","0","29","0.9","6.1"
"Glascock","2020-10-25","0","419","0","29","0.9","6.1"
"Glascock","2020-10-26","1","420","0","29","0.9","6.1"
"Glascock","2020-10-27","61","481","1","30","0.2","6.2"
"Glascock","2020-10-28","5","486","0","30","0.2","3.8"
"Glascock","2020-10-29","66","552","0","30","0.2","2.4"
"Glascock","2020-10-30","1","553","0","30","0.2","0.6"
"Glascock","2020-10-31","4","557","0","30","0.2","0.6"
"Glascock","2020-11-01","1","558","0","30","0.2","0.6"
"Glascock","2020-11-02","8","566","1","31","2","1.5"
"Glascock","2020-11-03","72","638","0","31","1.8","1"
"Glascock","2020-11-04","1","639","0","31","1.8","1"
"Glascock","2020-11-05","2","641","1","32","8.9","4.6"
"Glascock","2020-11-06","1","642","0","32","8.9","4.6"
"Glascock","2020-11-07","2","644","0","32","8.9","4.6"
"Glascock","2020-11-08","2","646","1","33","16.1","8.2"
"Glascock","2020-11-09","5","651","2","35","20","11"
"Glascock","2020-11-10","6","657","2","37","24.8","13.3"
"Glascock","2020-11-11","3","660","2","39","34.3","18"
"Glascock","2020-11-12","6","666","1","40","29.5","19.2"
"Glascock","2020-11-13","2","668","0","40","29.5","19.2"
"Glascock","2020-11-14","1","669","0","40","29.5","19.2"
"Glascock","2020-11-15","0","669","0","40","22.4","19.2"
"Glascock","2020-11-16","2","671","0","40","16.7","18.3"
"Glascock","2020-11-17","63","734","1","41","12.1","18.4"
"Glascock","2020-11-18","0","734","0","41","2.6","18.4"
"Glascock","2020-11-19","2","736","0","41","0.2","14.9"
"Glascock","2020-11-20","0","736","0","41","0.2","14.9"
"Glascock","2020-11-21","2","738","0","41","0.2","14.9"
"Glascock","2020-11-22","2","740","0","41","0.2","11.3"
"Glascock","2020-11-23","3","743","0","41","0.2","8.4"
"Glascock","2020-11-24","5","748","0","41","0","6.1"
"Glascock","2020-11-25","1","749","0","41","0","1.3"
"Glascock","2020-11-26","0","749","0","41","0","0.1"
"Glascock","2020-11-27","3","752","0","41","0","0.1"
"Glascock","2020-11-28","0","752","0","41","0","0.1"
"Glascock","2020-11-29","0","752","0","41","0","0.1"
"Glascock","2020-11-30","3","755","0","41","0","0.1"
"Glascock","2020-12-01","7","762","1","42","2","1"
"Glascock","2020-12-02","3","765","1","43","6.8","3.4"
"Glascock","2020-12-03","3","768","0","43","6.8","3.4"
"Glascock","2020-12-04","6","774","1","44","9.2","4.6"
"Glascock","2020-12-05","0","774","0","44","9.2","4.6"
"Glascock","2020-12-06","1","775","0","44","9.2","4.6"
"Glascock","2020-12-07","1","776","1","45","23.5","11.7"
"Glascock","2020-12-08","6","782","1","46","23.8","12.9"
"Glascock","2020-12-09","1","783","1","47","33.3","20.1"
"Glascock","2020-12-10","6","789","1","48","35.7","21.3"
"Glascock","2020-12-11","11","800","0","48","33.3","21.3"
"Glascock","2020-12-12","0","800","0","48","33.3","21.3"
"Glascock","2020-12-13","2","802","2","50","47.6","28.4"
"Glascock","2020-12-14","5","807","3","53","41.9","32.7"
"Glascock","2020-12-15","5","812","1","54","42.4","33.1"
"Glascock","2020-12-16","1","813","0","54","28.1","30.7"
"Glascock","2020-12-17","3","816","1","55","30.5","33.1"
"Glascock","2020-12-18","7","823","1","56","32.5","32.9"
"Glascock","2020-12-19","1","824","0","56","32.5","32.9"
"Glascock","2020-12-20","0","824","0","56","18.2","32.9"
"Glascock","2020-12-21","12","836","3","59","13.2","27.6"
"Glascock","2020-12-22","5","841","2","61","16.1","29.2"
"Glascock","2020-12-23","1","842","0","61","16.1","22.1"
"Glascock","2020-12-24","1","843","1","62","25.6","28"
"Glascock","2020-12-25","0","843","0","62","23.6","28"
"Glascock","2020-12-26","3","846","0","62","23.6","28"
"Glascock","2020-12-27","2","848","1","63","30.7","24.5"
"Glascock","2020-12-28","6","854","0","63","27.1","20.2"
"Glascock","2020-12-29","1","855","1","64","35.7","25.9"
"Glascock","2020-12-30","10","865","2","66","38.6","27.3"
"Glascock","2020-12-31","6","871","2","68","29","27.3"
"Glascock","2021-01-01","0","871","0","68","29","26.3"
"Glascock","2021-01-02","0","871","0","68","29","26.3"
"Glascock","2021-01-03","1","872","1","69","36.2","33.5"
"Glascock","2021-01-04","1","873","1","70","50.5","38.8"
"Glascock","2021-01-05","2","875","0","70","36.2","36"
"Glascock","2021-01-06","4","879","0","70","33.3","36"
"Glascock","2021-01-07","8","887","3","73","33.9","31.5"
"Glascock","2021-01-08","0","887","0","73","33.9","31.5"
"Glascock","2021-01-09","1","888","0","73","33.9","31.5"
"Glascock","2021-01-10","0","888","0","73","19.6","27.9"
"Glascock","2021-01-11","6","894","3","76","12.5","31.5"
"Glascock","2021-01-12","5","899","0","76","12.5","24.3"
"Glascock","2021-01-13","4","903","2","78","19.6","26.5"
"Glascock","2021-01-14","6","909","2","80","19","26.5"
"Glascock","2021-01-15","3","912","1","81","23.8","28.9"
"Glascock","2021-01-16","2","914","0","81","23.8","28.9"
"Glascock","2021-01-17","3","917","1","82","28.6","24.1"
"Glascock","2021-01-18","4","921","2","84","28.6","20.5"
"Glascock","2021-01-19","3","924","1","85","33.3","22.9"
"Glascock","2021-01-20","9","933","0","85","26.2","22.9"
"Glascock","2021-01-21","2","935","0","85","21.4","20.2"
"Glascock","2021-01-22","5","940","2","87","22.4","23.1"
"Glascock","2021-01-23","1","941","0","87","22.4","23.1"
"Glascock","2021-01-24","2","943","0","87","17.6","23.1"
"Glascock","2021-01-25","5","948","1","88","13.3","21"
"Glascock","2021-01-26","1","949","1","89","22.9","28.1"
"Glascock","2021-01-27","0","949","0","89","22.9","24.5"
"Glynn","2020-02-01","0","0","0","0",".","."
"Glynn","2020-02-02","0","0","0","0",".","."
"Glynn","2020-02-03","0","0","0","0",".","."
"Glynn","2020-02-04","0","0","0","0",".","."
"Glynn","2020-02-05","0","0","0","0",".","."
"Glynn","2020-02-06","0","0","0","0",".","."
"Glynn","2020-02-07","0","0","0","0","0","."
"Glynn","2020-02-08","0","0","0","0","0","."
"Glynn","2020-02-09","0","0","0","0","0","."
"Glynn","2020-02-10","0","0","0","0","0","."
"Glynn","2020-02-11","0","0","0","0","0","."
"Glynn","2020-02-12","0","0","0","0","0","."
"Glynn","2020-02-13","0","0","0","0","0","."
"Glynn","2020-02-14","0","0","0","0","0","0"
"Glynn","2020-02-15","0","0","0","0","0","0"
"Glynn","2020-02-16","0","0","0","0","0","0"
"Glynn","2020-02-17","0","0","0","0","0","0"
"Glynn","2020-02-18","0","0","0","0","0","0"
"Glynn","2020-02-19","0","0","0","0","0","0"
"Glynn","2020-02-20","0","0","0","0","0","0"
"Glynn","2020-02-21","0","0","0","0","0","0"
"Glynn","2020-02-22","0","0","0","0","0","0"
"Glynn","2020-02-23","0","0","0","0","0","0"
"Glynn","2020-02-24","0","0","0","0","0","0"
"Glynn","2020-02-25","0","0","0","0","0","0"
"Glynn","2020-02-26","0","0","0","0","0","0"
"Glynn","2020-02-27","0","0","0","0","0","0"
"Glynn","2020-02-28","0","0","0","0","0","0"
"Glynn","2020-02-29","0","0","0","0","0","0"
"Glynn","2020-03-01","0","0","0","0","0","0"
"Glynn","2020-03-02","1","1","0","0","0","0"
"Glynn","2020-03-03","0","1","0","0","0","0"
"Glynn","2020-03-04","0","1","0","0","0","0"
"Glynn","2020-03-05","0","1","0","0","0","0"
"Glynn","2020-03-06","0","1","0","0","0","0"
"Glynn","2020-03-07","0","1","0","0","0","0"
"Glynn","2020-03-08","11","12","0","0","0","0"
"Glynn","2020-03-09","0","12","0","0","0","0"
"Glynn","2020-03-10","15","27","0","0","0","0"
"Glynn","2020-03-11","2","29","0","0","0","0"
"Glynn","2020-03-12","4","33","0","0","0","0"
"Glynn","2020-03-13","4","37","0","0","0","0"
"Glynn","2020-03-14","0","37","0","0","0","0"
"Glynn","2020-03-15","8","45","1","1","1.8","0.9"
"Glynn","2020-03-16","2","47","0","1","1.8","0.9"
"Glynn","2020-03-17","17","64","2","3","3.5","1.7"
"Glynn","2020-03-18","11","75","0","3","3.5","1.7"
"Glynn","2020-03-19","38","113","0","3","3.5","1.7"
"Glynn","2020-03-20","41","154","1","4","3.8","1.9"
"Glynn","2020-03-21","7","161","0","4","3.8","1.9"
"Glynn","2020-03-22","10","171","0","4","2","1.9"
"Glynn","2020-03-23","29","200","2","6","3","2.4"
"Glynn","2020-03-24","27","227","0","6","1.3","2.4"
"Glynn","2020-03-25","30","257","2","8","2.3","2.9"
"Glynn","2020-03-26","27","284","2","10","3.3","3.4"
"Glynn","2020-03-27","20","304","0","10","3","3.4"
"Glynn","2020-03-28","8","312","0","10","3","3.4"
"Glynn","2020-03-29","8","320","0","10","3","2.5"
"Glynn","2020-03-30","25","345","0","10","2","2.5"
"Glynn","2020-03-31","23","368","0","10","2","1.7"
"Glynn","2020-04-01","18","386","1","11","1.9","2.1"
"Glynn","2020-04-02","18","404","0","11","0.8","2.1"
"Glynn","2020-04-03","14","418","0","11","0.8","1.9"
"Glynn","2020-04-04","2","420","0","11","0.8","1.9"
"Glynn","2020-04-05","6","426","0","11","0.8","1.9"
"Glynn","2020-04-06","6","432","0","11","0.8","1.4"
"Glynn","2020-04-07","12","444","0","11","0.8","1.4"
"Glynn","2020-04-08","11","455","0","11","0","0.9"
"Glynn","2020-04-09","4","459","1","12","3.6","2.2"
"Glynn","2020-04-10","9","468","0","12","3.6","2.2"
"Glynn","2020-04-11","9","477","0","12","3.6","2.2"
"Glynn","2020-04-12","16","493","4","16","7.1","4"
"Glynn","2020-04-13","9","502","1","17","8.7","4.8"
"Glynn","2020-04-14","20","522","0","17","8.7","4.8"
"Glynn","2020-04-15","14","536","1","18","9.8","4.9"
"Glynn","2020-04-16","29","565","0","18","6.2","4.9"
"Glynn","2020-04-17","30","595","1","19","6.7","5.1"
"Glynn","2020-04-18","17","612","1","20","7.5","5.5"
"Glynn","2020-04-19","11","623","2","22","6.5","6.8"
"Glynn","2020-04-20","60","683","0","22","4.9","6.8"
"Glynn","2020-04-21","35","718","0","22","4.9","6.8"
"Glynn","2020-04-22","22","740","0","22","3.9","6.8"
"Glynn","2020-04-23","178","918","1","23","4","5.1"
"Glynn","2020-04-24","87","1005","4","27","4.2","5.4"
"Glynn","2020-04-25","12","1017","0","27","3.3","5.4"
"Glynn","2020-04-26","6","1023","0","27","0.7","3.6"
"Glynn","2020-04-27","48","1071","0","27","0.7","2.8"
"Glynn","2020-04-28","162","1233","2","29","0.9","2.9"
"Glynn","2020-04-29","70","1303","0","29","0.9","2.4"
"Glynn","2020-04-30","132","1435","1","30","0.9","2.5"
"Glynn","2020-05-01","62","1497","0","30","0.3","2.2"
"Glynn","2020-05-02","38","1535","0","30","0.3","1.8"
"Glynn","2020-05-03","9","1544","0","30","0.3","0.5"
"Glynn","2020-05-04","57","1601","3","33","1","0.9"
"Glynn","2020-05-05","156","1757","0","33","0.9","0.9"
"Glynn","2020-05-06","147","1904","0","33","0.9","0.9"
"Glynn","2020-05-07","108","2012","0","33","0.8","0.8"
"Glynn","2020-05-08","117","2129","0","33","0.8","0.5"
"Glynn","2020-05-09","80","2209","0","33","0.8","0.5"
"Glynn","2020-05-10","6","2215","0","33","0.8","0.5"
"Glynn","2020-05-11","176","2391","2","35","0.2","0.6"
"Glynn","2020-05-12","331","2722","3","38","0.3","0.6"
"Glynn","2020-05-13","140","2862","2","40","0.5","0.7"
"Glynn","2020-05-14","165","3027","1","41","0.6","0.7"
"Glynn","2020-05-15","99","3126","1","42","0.7","0.7"
"Glynn","2020-05-16","31","3157","0","42","0.7","0.7"
"Glynn","2020-05-17","9","3166","0","42","0.7","0.7"
"Glynn","2020-05-18","131","3297","3","45","0.9","0.5"
"Glynn","2020-05-19","95","3392","1","46","0.9","0.6"
"Glynn","2020-05-20","70","3462","1","47","0.9","0.7"
"Glynn","2020-05-21","59","3521","1","48","1.1","0.8"
"Glynn","2020-05-22","121","3642","8","56","1.9","1.3"
"Glynn","2020-05-23","163","3805","4","60","2.2","1.5"
"Glynn","2020-05-24","9","3814","2","62","5.4","3.1"
"Glynn","2020-05-25","26","3840","0","62","5.1","3"
"Glynn","2020-05-26","202","4042","8","70","5.5","3.2"
"Glynn","2020-05-27","111","4153","1","71","5.4","3.2"
"Glynn","2020-05-28","141","4294","3","74","5.5","3.3"
"Glynn","2020-05-29","191","4485","7","81","5","3.5"
"Glynn","2020-05-30","155","4640","14","95","6","4.1"
"Glynn","2020-05-31","11","4651","0","95","2.8","4.1"
"Glynn","2020-06-01","181","4832","3","98","3","4.1"
"Glynn","2020-06-02","154","4986","7","105","3.1","4.3"
"Glynn","2020-06-03","223","5209","9","114","3.6","4.5"
"Glynn","2020-06-04","119","5328","7","121","4.1","4.8"
"Glynn","2020-06-05","197","5525","9","130","4.2","4.6"
"Glynn","2020-06-06","118","5643","4","134","3.4","4.7"
"Glynn","2020-06-07","6","5649","0","134","3.4","3.1"
"Glynn","2020-06-08","356","6005","17","151","3.9","3.5"
"Glynn","2020-06-09","154","6159","3","154","3.5","3.3"
"Glynn","2020-06-10","316","6475","7","161","3.3","3.4"
"Glynn","2020-06-11","264","6739","25","186","3.8","3.9"
"Glynn","2020-06-12","209","6948","11","197","3.9","4.1"
"Glynn","2020-06-13","91","7039","3","200","3.9","3.6"
"Glynn","2020-06-14","20","7059","1","201","4.6","4"
"Glynn","2020-06-15","423","7482","23","224","4.7","4.3"
"Glynn","2020-06-16","288","7770","29","253","5.8","4.7"
"Glynn","2020-06-17","290","8060","27","280","6.8","5"
"Glynn","2020-06-18","332","8392","69","349","8.5","6.1"
"Glynn","2020-06-19","513","8905","70","419","9.6","6.8"
"Glynn","2020-06-20","200","9105","33","452","11.5","7.7"
"Glynn","2020-06-21","30","9135","5","457","13.2","8.9"
"Glynn","2020-06-22","740","9875","120","577","14.7","9.7"
"Glynn","2020-06-23","1031","10906","90","667","14.6","10.2"
"Glynn","2020-06-24","637","11543","88","755","15.2","11"
"Glynn","2020-06-25","565","12108","90","845","14.5","11.5"
"Glynn","2020-06-26","654","12762","80","925","14.3","12"
"Glynn","2020-06-27","205","12967","28","953","13.9","12.7"
"Glynn","2020-06-28","36","13003","1","954","11.9","12.6"
"Glynn","2020-06-29","715","13718","86","1040","11.3","13"
"Glynn","2020-06-30","822","14540","76","1116","11.4","13"
"Glynn","2020-07-01","453","14993","71","1187","11.6","13.4"
"Glynn","2020-07-02","354","15347","43","1230","11.1","12.8"
"Glynn","2020-07-03","53","15400","4","1234","10.4","12.4"
"Glynn","2020-07-04","26","15426","4","1238","10.7","12.3"
"Glynn","2020-07-05","28","15454","5","1243","12.8","12.4"
"Glynn","2020-07-06","419","15873","65","1308","13.3","12.3"
"Glynn","2020-07-07","401","16274","37","1345","13.3","12.4"
"Glynn","2020-07-08","588","16862","38","1383","12","11.8"
"Glynn","2020-07-09","326","17188","43","1426","12.2","11.6"
"Glynn","2020-07-10","436","17624","35","1461","12.2","11.3"
"Glynn","2020-07-11","257","17881","27","1488","11.5","11.1"
"Glynn","2020-07-12","71","17952","23","1511","13.6","13.2"
"Glynn","2020-07-13","431","18383","60","1571","13.4","13.4"
"Glynn","2020-07-14","558","18941","55","1626","13.5","13.4"
"Glynn","2020-07-15","498","19439","53","1679","14.1","13"
"Glynn","2020-07-16","364","19803","46","1725","14","13.1"
"Glynn","2020-07-17","396","20199","38","1763","14.2","13.2"
"Glynn","2020-07-18","147","20346","40","1803","16.6","14.1"
"Glynn","2020-07-19","70","20416","13","1816","14.6","14.1"
"Glynn","2020-07-20","449","20865","38","1854","13.9","13.6"
"Glynn","2020-07-21","426","21291","46","1900","14","13.7"
"Glynn","2020-07-22","459","21750","30","1930","13.4","13.7"
"Glynn","2020-07-23","305","22055","24","1954","12.7","13.4"
"Glynn","2020-07-24","354","22409","34","1988","12.7","13.5"
"Glynn","2020-07-25","160","22569","18","2006","10.4","13.5"
"Glynn","2020-07-26","36","22605","7","2013","10.6","12.6"
"Glynn","2020-07-27","336","22941","25","2038","10.4","12.1"
"Glynn","2020-07-28","484","23425","66","2104","10.8","12.4"
"Glynn","2020-07-29","371","23796","33","2137","11.2","12.3"
"Glynn","2020-07-30","254","24050","43","2180","12.5","12.6"
"Glynn","2020-07-31","266","24316","21","2201","12.2","12.5"
"Glynn","2020-08-01","116","24432","13","2214","12.2","11.3"
"Glynn","2020-08-02","53","24485","13","2227","12.9","11.7"
"Glynn","2020-08-03","190","24675","27","2254","13.9","12.2"
"Glynn","2020-08-04","586","25261","57","2311","13.3","12.1"
"Glynn","2020-08-05","498","25759","40","2351","13.2","12.2"
"Glynn","2020-08-06","279","26038","31","2382","12.4","12.4"
"Glynn","2020-08-07","318","26356","24","2406","12.3","12.3"
"Glynn","2020-08-08","196","26552","20","2426","12.2","12.2"
"Glynn","2020-08-09","63","26615","12","2438","11.4","12.2"
"Glynn","2020-08-10","344","26959","28","2466","10.5","12.2"
"Glynn","2020-08-11","342","27301","22","2488","10.1","11.7"
"Glynn","2020-08-12","433","27734","29","2517","9.9","11.6"
"Glynn","2020-08-13","270","28004","13","2530","9","10.7"
"Glynn","2020-08-14","253","28257","24","2554","9.3","10.8"
"Glynn","2020-08-15","125","28382","12","2566","9.2","10.7"
"Glynn","2020-08-16","42","28424","7","2573","8.8","10.1"
"Glynn","2020-08-17","116","28540","11","2584","9","9.8"
"Glynn","2020-08-18","330","28870","36","2620","9.7","9.9"
"Glynn","2020-08-19","358","29228","22","2642","9.6","9.7"
"Glynn","2020-08-20","282","29510","32","2674","10.5","9.8"
"Glynn","2020-08-21","183","29693","10","2684","9.9","9.6"
"Glynn","2020-08-22","182","29875","20","2704","10.1","9.7"
"Glynn","2020-08-23","67","29942","5","2709","8.8","8.8"
"Glynn","2020-08-24","346","30288","33","2742","8.8","8.9"
"Glynn","2020-08-25","347","30635","40","2782","8.9","9.3"
"Glynn","2020-08-26","385","31020","31","2813","9.2","9.4"
"Glynn","2020-08-27","364","31384","42","2855","9.2","9.9"
"Glynn","2020-08-28","276","31660","23","2878","9.6","9.8"
"Glynn","2020-08-29","100","31760","14","2892","10.1","10.1"
"Glynn","2020-08-30","50","31810","11","2903","12.1","10.5"
"Glynn","2020-08-31","388","32198","38","2941","12.2","10.5"
"Glynn","2020-09-01","348","32546","31","2972","11.8","10.4"
"Glynn","2020-09-02","388","32934","29","3001","11.7","10.5"
"Glynn","2020-09-03","376","33310","30","3031","11.2","10.2"
"Glynn","2020-09-04","299","33609","19","3050","10.9","10.3"
"Glynn","2020-09-05","111","33720","9","3059","10.1","10.1"
"Glynn","2020-09-06","85","33805","6","3065","8","10"
"Glynn","2020-09-07","174","33979","19","3084","8.1","10.1"
"Glynn","2020-09-08","499","34478","22","3106","7.5","9.6"
"Glynn","2020-09-09","381","34859","17","3123","7","9.4"
"Glynn","2020-09-10","434","35293","24","3147","6.7","9"
"Glynn","2020-09-11","286","35579","12","3159","6.4","8.7"
"Glynn","2020-09-12","158","35737","10","3169","6.1","8.1"
"Glynn","2020-09-13","52","35789","5","3174","6.5","7.2"
"Glynn","2020-09-14","338","36127","21","3195","5.8","7"
"Glynn","2020-09-15","291","36418","21","3216","6.2","6.8"
"Glynn","2020-09-16","241","36659","9","3225","6.1","6.6"
"Glynn","2020-09-17","332","36991","12","3237","5.8","6.3"
"Glynn","2020-09-18","190","37181","6","3243","5.7","6"
"Glynn","2020-09-19","113","37294","0","3243","4.8","5.5"
"Glynn","2020-09-20","43","37337","4","3247","4.7","5.6"
"Glynn","2020-09-21","263","37600","11","3258","4.5","5.1"
"Glynn","2020-09-22","179","37779","7","3265","4","5.1"
"Glynn","2020-09-23","219","37998","8","3273","4","5"
"Glynn","2020-09-24","221","38219","9","3282","4","4.9"
"Glynn","2020-09-25","170","38389","6","3288","4.1","4.9"
"Glynn","2020-09-26","127","38516","10","3298","5.2","5"
"Glynn","2020-09-27","38","38554","5","3303","5.8","5.3"
"Glynn","2020-09-28","245","38799","12","3315","5.9","5.2"
"Glynn","2020-09-29","120","38919","4","3319","5.8","4.9"
"Glynn","2020-09-30","168","39087","2","3321","5.4","4.7"
"Glynn","2020-10-01","240","39327","8","3329","5.3","4.7"
"Glynn","2020-10-02","210","39537","12","3341","5.6","4.9"
"Glynn","2020-10-03","88","39625","1","3342","4.7","4.9"
"Glynn","2020-10-04","45","39670","2","3344","3.4","4.6"
"Glynn","2020-10-05","269","39939","8","3352","3.2","4.5"
"Glynn","2020-10-06","197","40136","8","3360","3.3","4.5"
"Glynn","2020-10-07","247","40383","6","3366","3.4","4.4"
"Glynn","2020-10-08","270","40653","11","3377","3.5","4.4"
"Glynn","2020-10-09","158","40811","8","3385","3.5","4.5"
"Glynn","2020-10-10","137","40948","4","3389","3.7","4.2"
"Glynn","2020-10-11","34","40982","0","3389","3.1","3.3"
"Glynn","2020-10-12","188","41170","5","3394","3","3.1"
"Glynn","2020-10-13","219","41389","17","3411","3.6","3.4"
"Glynn","2020-10-14","257","41646","11","3422","3.8","3.6"
"Glynn","2020-10-15","319","41965","13","3435","3.8","3.7"
"Glynn","2020-10-16","232","42197","9","3444","3.7","3.6"
"Glynn","2020-10-17","86","42283","1","3445","3.4","3.6"
"Glynn","2020-10-18","39","42322","2","3447","4.1","3.6"
"Glynn","2020-10-19","328","42650","15","3462","4.4","3.7"
"Glynn","2020-10-20","151","42801","14","3476","4.6","4.1"
"Glynn","2020-10-21","205","43006","19","3495","5.3","4.6"
"Glynn","2020-10-22","300","43306","21","3516","5.8","4.8"
"Glynn","2020-10-23","220","43526","8","3524","5.7","4.7"
"Glynn","2020-10-24","165","43691","12","3536","6.6","5"
"Glynn","2020-10-25","45","43736","8","3544","8.4","6.3"
"Glynn","2020-10-26","287","44023","21","3565","8.8","6.6"
"Glynn","2020-10-27","164","44187","8","3573","8.2","6.4"
"Glynn","2020-10-28","284","44471","16","3589","7.6","6.5"
"Glynn","2020-10-29","331","44802","19","3608","7.5","6.6"
"Glynn","2020-10-30","307","45109","14","3622","7.6","6.7"
"Glynn","2020-10-31","89","45198","6","3628","7.5","7.1"
"Glynn","2020-11-01","46","45244","5","3633","6.5","7.5"
"Glynn","2020-11-02","269","45513","12","3645","6.1","7.5"
"Glynn","2020-11-03","156","45669","9","3654","6.3","7.2"
"Glynn","2020-11-04","230","45899","24","3678","6.9","7.3"
"Glynn","2020-11-05","384","46283","17","3695","6.8","7.1"
"Glynn","2020-11-06","238","46521","13","3708","6.9","7.2"
"Glynn","2020-11-07","114","46635","4","3712","6.4","7"
"Glynn","2020-11-08","35","46670","4","3716","6.5","6.5"
"Glynn","2020-11-09","317","46987","21","3737","6.8","6.5"
"Glynn","2020-11-10","216","47203","14","3751","6.9","6.6"
"Glynn","2020-11-11","257","47460","15","3766","6.3","6.6"
"Glynn","2020-11-12","393","47853","28","3794","6.6","6.7"
"Glynn","2020-11-13","213","48066","18","3812","7.1","7"
"Glynn","2020-11-14","183","48249","9","3821","7.3","6.8"
"Glynn","2020-11-15","46","48295","4","3825","6.9","6.7"
"Glynn","2020-11-16","338","48633","19","3844","6.7","6.8"
"Glynn","2020-11-17","268","48901","20","3864","6.9","6.9"
"Glynn","2020-11-18","358","49259","15","3879","6.6","6.4"
"Glynn","2020-11-19","476","49735","19","3898","6.2","6.4"
"Glynn","2020-11-20","312","50047","21","3919","5.9","6.5"
"Glynn","2020-11-21","84","50131","2","3921","5.6","6.4"
"Glynn","2020-11-22","74","50205","10","3931","6.3","6.6"
"Glynn","2020-11-23","429","50634","23","3954","6.2","6.5"
"Glynn","2020-11-24","261","50895","18","3972","6.2","6.5"
"Glynn","2020-11-25","305","51200","16","3988","6.3","6.5"
"Glynn","2020-11-26","68","51268","3","3991","6.4","6.3"
"Glynn","2020-11-27","118","51386","5","3996","6","6"
"Glynn","2020-11-28","106","51492","6","4002","6.5","6"
"Glynn","2020-11-29","52","51544","4","4006","5.6","6"
"Glynn","2020-11-30","395","51939","30","4036","6","6.1"
"Glynn","2020-12-01","189","52128","5","4041","5.4","5.8"
"Glynn","2020-12-02","309","52437","20","4061","5.5","5.9"
"Glynn","2020-12-03","304","52741","21","4082","5.9","6.1"
"Glynn","2020-12-04","240","52981","11","4093","5.9","6"
"Glynn","2020-12-05","100","53081","10","4103","6.6","6.5"
"Glynn","2020-12-06","48","53129","2","4105","6.1","5.8"
"Glynn","2020-12-07","349","53478","26","4131","6","6"
"Glynn","2020-12-08","242","53720","16","4147","6.6","6"
"Glynn","2020-12-09","327","54047","12","4159","6.2","5.9"
"Glynn","2020-12-10","237","54284","19","4178","6.4","6.1"
"Glynn","2020-12-11","227","54511","16","4194","6.7","6.3"
"Glynn","2020-12-12","200","54711","18","4212","6.6","6.6"
"Glynn","2020-12-13","51","54762","5","4217","7.4","6.7"
"Glynn","2020-12-14","376","55138","37","4254","7.7","6.9"
"Glynn","2020-12-15","323","55461","34","4288","8.3","7.4"
"Glynn","2020-12-16","427","55888","26","4314","8.6","7.4"
"Glynn","2020-12-17","519","56407","36","4350","8.5","7.4"
"Glynn","2020-12-18","367","56774","36","4386","8.9","7.8"
"Glynn","2020-12-19","88","56862","8","4394","8.9","7.7"
"Glynn","2020-12-20","86","56948","14","4408","9.8","8.6"
"Glynn","2020-12-21","634","57582","62","4470","9.8","8.8"
"Glynn","2020-12-22","416","57998","37","4507","9.6","8.9"
"Glynn","2020-12-23","463","58461","47","4554","10.1","9.4"
"Glynn","2020-12-24","109","58570","7","4561","10.1","9.3"
"Glynn","2020-12-25","47","58617","6","4567","10.5","9.7"
"Glynn","2020-12-26","202","58819","37","4604","11.8","10.3"
"Glynn","2020-12-27","69","58888","14","4618","12.4","11.1"
"Glynn","2020-12-28","521","59409","67","4685","12.8","11.3"
"Glynn","2020-12-29","408","59817","44","4729","13.1","11.3"
"Glynn","2020-12-30","541","60358","48","4777","12.9","11.5"
"Glynn","2020-12-31","424","60782","49","4826","13.6","11.8"
"Glynn","2021-01-01","65","60847","12","4838","14.4","12.5"
"Glynn","2021-01-02","94","60941","14","4852","14","12.9"
"Glynn","2021-01-03","72","61013","12","4864","13.4","12.9"
"Glynn","2021-01-04","712","61725","119","4983","14","13.4"
"Glynn","2021-01-05","595","62320","71","5054","14.2","13.6"
"Glynn","2021-01-06","437","62757","46","5100","14.4","13.6"
"Glynn","2021-01-07","486","63243","43","5143","14","13.8"
"Glynn","2021-01-08","419","63662","45","5188","12.9","13.7"
"Glynn","2021-01-09","195","63857","24","5212","12.5","13.2"
"Glynn","2021-01-10","48","63905","3","5215","11","12.2"
"Glynn","2021-01-11","573","64478","48","5263","9.9","11.9"
"Glynn","2021-01-12","487","64965","39","5302","9.3","11.7"
"Glynn","2021-01-13","435","65400","40","5342","9.1","11.7"
"Glynn","2021-01-14","509","65909","49","5391","9.2","11.6"
"Glynn","2021-01-15","501","66410","38","5429","8.8","10.8"
"Glynn","2021-01-16","122","66532","11","5440","8.3","10.4"
"Glynn","2021-01-17","63","66595","11","5451","9.9","10.5"
"Glynn","2021-01-18","513","67108","61","5512","10.4","10.1"
"Glynn","2021-01-19","434","67542","43","5555","10.7","10"
"Glynn","2021-01-20","579","68121","53","5608","10.7","9.9"
"Glynn","2021-01-21","479","68600","30","5638","10.2","9.7"
"Glynn","2021-01-22","442","69042","40","5678","10.4","9.6"
"Glynn","2021-01-23","260","69302","23","5701","10.4","9.3"
"Glynn","2021-01-24","62","69364","12","5713","10.6","10.3"
"Glynn","2021-01-25","185","69549","11","5724","9.8","10.1"
"Glynn","2021-01-26","3","69552","0","5724","8.4","9.5"
"Glynn","2021-01-27","0","69552","0","5724","7.1","8.9"
"Gordon","2020-02-01","0","0","0","0",".","."
"Gordon","2020-02-02","0","0","0","0",".","."
"Gordon","2020-02-03","0","0","0","0",".","."
"Gordon","2020-02-04","0","0","0","0",".","."
"Gordon","2020-02-05","0","0","0","0",".","."
"Gordon","2020-02-06","0","0","0","0",".","."
"Gordon","2020-02-07","0","0","0","0","0","."
"Gordon","2020-02-08","0","0","0","0","0","."
"Gordon","2020-02-09","0","0","0","0","0","."
"Gordon","2020-02-10","0","0","0","0","0","."
"Gordon","2020-02-11","0","0","0","0","0","."
"Gordon","2020-02-12","0","0","0","0","0","."
"Gordon","2020-02-13","0","0","0","0","0","."
"Gordon","2020-02-14","0","0","0","0","0","0"
"Gordon","2020-02-15","0","0","0","0","0","0"
"Gordon","2020-02-16","0","0","0","0","0","0"
"Gordon","2020-02-17","0","0","0","0","0","0"
"Gordon","2020-02-18","0","0","0","0","0","0"
"Gordon","2020-02-19","0","0","0","0","0","0"
"Gordon","2020-02-20","0","0","0","0","0","0"
"Gordon","2020-02-21","0","0","0","0","0","0"
"Gordon","2020-02-22","0","0","0","0","0","0"
"Gordon","2020-02-23","0","0","0","0","0","0"
"Gordon","2020-02-24","0","0","0","0","0","0"
"Gordon","2020-02-25","0","0","0","0","0","0"
"Gordon","2020-02-26","0","0","0","0","0","0"
"Gordon","2020-02-27","0","0","0","0","0","0"
"Gordon","2020-02-28","0","0","0","0","0","0"
"Gordon","2020-02-29","0","0","0","0","0","0"
"Gordon","2020-03-01","0","0","0","0","0","0"
"Gordon","2020-03-02","1","1","1","1","14.3","7.1"
"Gordon","2020-03-03","0","1","0","1","14.3","7.1"
"Gordon","2020-03-04","0","1","0","1","14.3","7.1"
"Gordon","2020-03-05","0","1","0","1","14.3","7.1"
"Gordon","2020-03-06","0","1","0","1","14.3","7.1"
"Gordon","2020-03-07","0","1","0","1","14.3","7.1"
"Gordon","2020-03-08","4","5","2","3","21.4","10.7"
"Gordon","2020-03-09","4","9","0","3","7.1","10.7"
"Gordon","2020-03-10","3","12","0","3","7.1","10.7"
"Gordon","2020-03-11","10","22","1","4","8.6","11.4"
"Gordon","2020-03-12","9","31","0","4","8.6","11.4"
"Gordon","2020-03-13","10","41","4","8","14.3","14.3"
"Gordon","2020-03-14","2","43","0","8","14.3","14.3"
"Gordon","2020-03-15","10","53","2","10","10","15.7"
"Gordon","2020-03-16","19","72","1","11","10.8","8.9"
"Gordon","2020-03-17","7","79","1","12","12.8","10"
"Gordon","2020-03-18","3","82","0","12","11.4","10"
"Gordon","2020-03-19","12","94","4","16","16.1","12.3"
"Gordon","2020-03-20","14","108","6","22","16.5","15.4"
"Gordon","2020-03-21","4","112","0","22","16.5","15.4"
"Gordon","2020-03-22","8","120","2","24","17.2","13.6"
"Gordon","2020-03-23","17","137","0","24","16.5","13.6"
"Gordon","2020-03-24","4","141","0","24","14.5","13.6"
"Gordon","2020-03-25","12","153","0","24","14.5","12.9"
"Gordon","2020-03-26","12","165","0","24","9.7","12.9"
"Gordon","2020-03-27","11","176","0","24","3.6","10.1"
"Gordon","2020-03-28","11","187","3","27","7.5","12"
"Gordon","2020-03-29","3","190","0","27","3.9","10.6"
"Gordon","2020-03-30","4","194","0","27","3.9","10.2"
"Gordon","2020-03-31","13","207","1","28","5","9.7"
"Gordon","2020-04-01","9","216","2","30","8.2","11.3"
"Gordon","2020-04-02","11","227","0","30","8.2","8.9"
"Gordon","2020-04-03","7","234","1","31","10.2","6.9"
"Gordon","2020-04-04","6","240","0","31","6.3","6.9"
"Gordon","2020-04-05","2","242","0","31","6.3","5.1"
"Gordon","2020-04-06","12","254","1","32","7.5","5.7"
"Gordon","2020-04-07","7","261","0","32","6.4","5.7"
"Gordon","2020-04-08","29","290","11","43","8.7","8.4"
"Gordon","2020-04-09","8","298","2","45","12.2","10.2"
"Gordon","2020-04-10","9","307","2","47","13.4","11.8"
"Gordon","2020-04-11","6","313","0","47","13.4","9.8"
"Gordon","2020-04-12","6","319","1","48","15.7","11"
"Gordon","2020-04-13","10","329","0","48","14.5","11"
"Gordon","2020-04-14","20","349","3","51","16.7","11.5"
"Gordon","2020-04-15","37","386","7","58","14","11.3"
"Gordon","2020-04-16","24","410","3","61","12.2","12.2"
"Gordon","2020-04-17","35","445","2","63","9.8","11.6"
"Gordon","2020-04-18","8","453","2","65","13.4","13.4"
"Gordon","2020-04-19","4","457","1","66","14.6","15.2"
"Gordon","2020-04-20","32","489","2","68","15.5","15"
"Gordon","2020-04-21","29","518","4","72","15.3","16"
"Gordon","2020-04-22","32","550","3","75","13.9","14"
"Gordon","2020-04-23","23","573","2","77","13.4","12.8"
"Gordon","2020-04-24","145","718","1","78","12.7","11.3"
"Gordon","2020-04-25","116","834","2","80","9.4","11.4"
"Gordon","2020-04-26","32","866","0","80","5.8","10.2"
"Gordon","2020-04-27","199","1065","0","80","4.9","10.2"
"Gordon","2020-04-28","65","1130","5","85","4","9.7"
"Gordon","2020-04-29","127","1257","3","88","3","8.5"
"Gordon","2020-04-30","143","1400","32","120","5","9.2"
"Gordon","2020-05-01","71","1471","1","121","5.1","8.9"
"Gordon","2020-05-02","16","1487","1","122","5.7","7.5"
"Gordon","2020-05-03","8","1495","0","122","5.7","5.8"
"Gordon","2020-05-04","27","1522","0","122","5.7","5.3"
"Gordon","2020-05-05","33","1555","3","125","5.9","5"
"Gordon","2020-05-06","32","1587","1","126","6","4.5"
"Gordon","2020-05-07","16","1603","0","126","2.8","3.9"
"Gordon","2020-05-08","30","1633","3","129","4.1","4.6"
"Gordon","2020-05-09","27","1660","1","130","3.7","4.7"
"Gordon","2020-05-10","11","1671","1","131","5","5.4"
"Gordon","2020-05-11","54","1725","1","132","5.3","5.5"
"Gordon","2020-05-12","48","1773","1","133","4.3","5.1"
"Gordon","2020-05-13","44","1817","2","135","4.5","5.3"
"Gordon","2020-05-14","29","1846","2","137","5.5","4.1"
"Gordon","2020-05-15","28","1874","0","137","4","4"
"Gordon","2020-05-16","16","1890","0","137","3.5","3.6"
"Gordon","2020-05-17","6","1896","0","137","2.2","3.6"
"Gordon","2020-05-18","32","1928","1","138","2.4","3.8"
"Gordon","2020-05-19","61","1989","0","138","2.1","3.2"
"Gordon","2020-05-20","39","2028","1","139","1.8","3.1"
"Gordon","2020-05-21","42","2070","3","142","1.8","3.6"
"Gordon","2020-05-22","35","2105","3","145","3.1","3.5"
"Gordon","2020-05-23","21","2126","0","145","3.1","3.3"
"Gordon","2020-05-24","12","2138","1","146","4.2","3.2"
"Gordon","2020-05-25","10","2148","1","147","5.2","3.8"
"Gordon","2020-05-26","63","2211","4","151","6.1","4.1"
"Gordon","2020-05-27","54","2265","1","152","6","3.9"
"Gordon","2020-05-28","40","2305","7","159","7.5","4.7"
"Gordon","2020-05-29","51","2356","4","163","7.4","5.2"
"Gordon","2020-05-30","22","2378","1","164","8.1","5.6"
"Gordon","2020-05-31","16","2394","1","165","7.8","6"
"Gordon","2020-06-01","76","2470","3","168","6.9","6.1"
"Gordon","2020-06-02","62","2532","1","169","6.2","6.2"
"Gordon","2020-06-03","74","2606","8","177","7.5","6.8"
"Gordon","2020-06-04","61","2667","3","180","5.7","6.6"
"Gordon","2020-06-05","64","2731","6","186","5.9","6.7"
"Gordon","2020-06-06","18","2749","2","188","6.9","7.5"
"Gordon","2020-06-07","11","2760","2","190","8.6","8.2"
"Gordon","2020-06-08","65","2825","9","199","10","8.4"
"Gordon","2020-06-09","83","2908","4","203","10.4","8.3"
"Gordon","2020-06-10","46","2954","5","208","10.4","9"
"Gordon","2020-06-11","59","3013","2","210","10.2","8"
"Gordon","2020-06-12","42","3055","3","213","9.9","7.9"
"Gordon","2020-06-13","21","3076","2","215","9.7","8.3"
"Gordon","2020-06-14","10","3086","2","217","9.9","9.3"
"Gordon","2020-06-15","30","3116","5","222","10.3","10.2"
"Gordon","2020-06-16","79","3195","3","225","10.2","10.3"
"Gordon","2020-06-17","91","3286","7","232","9.7","10.1"
"Gordon","2020-06-18","42","3328","1","233","9.6","9.9"
"Gordon","2020-06-19","57","3385","5","238","9.8","9.9"
"Gordon","2020-06-20","15","3400","0","238","8.5","9.1"
"Gordon","2020-06-21","20","3420","6","244","9.9","9.9"
"Gordon","2020-06-22","47","3467","5","249","9","9.7"
"Gordon","2020-06-23","85","3552","8","257","9.8","10"
"Gordon","2020-06-24","63","3615","8","265","10.6","10.2"
"Gordon","2020-06-25","53","3668","6","271","11.8","10.7"
"Gordon","2020-06-26","58","3726","5","276","11.8","10.8"
"Gordon","2020-06-27","20","3746","3","279","14","11.2"
"Gordon","2020-06-28","24","3770","6","285","13.2","11.6"
"Gordon","2020-06-29","60","3830","10","295","14.1","11.6"
"Gordon","2020-06-30","63","3893","9","304","14.8","12.3"
"Gordon","2020-07-01","55","3948","8","312","15.1","12.8"
"Gordon","2020-07-02","63","4011","4","316","14.4","13.1"
"Gordon","2020-07-03","39","4050","4","320","14.6","13.2"
"Gordon","2020-07-04","15","4065","2","322","14.3","14.2"
"Gordon","2020-07-05","16","4081","3","325","13.5","13.3"
"Gordon","2020-07-06","221","4302","21","346","12.4","13.3"
"Gordon","2020-07-07","192","4494","18","364","11.7","13.3"
"Gordon","2020-07-08","197","4691","15","379","10.7","12.9"
"Gordon","2020-07-09","180","4871","27","406","12","13.2"
"Gordon","2020-07-10","136","5007","17","423","12.3","13.4"
"Gordon","2020-07-11","27","5034","4","427","12.5","13.4"
"Gordon","2020-07-12","25","5059","7","434","13.8","13.6"
"Gordon","2020-07-13","105","5164","23","457","15.6","14"
"Gordon","2020-07-14","101","5265","14","471","16.2","14"
"Gordon","2020-07-15","79","5344","16","487","18","14.4"
"Gordon","2020-07-16","92","5436","14","501","18.1","15"
"Gordon","2020-07-17","84","5520","12","513","18.3","15.3"
"Gordon","2020-07-18","57","5577","18","531","20.7","16.6"
"Gordon","2020-07-19","21","5598","3","534","18.8","16.3"
"Gordon","2020-07-20","222","5820","44","578","18.5","17"
"Gordon","2020-07-21","124","5944","24","602","19.3","17.7"
"Gordon","2020-07-22","134","6078","25","627","19","18.5"
"Gordon","2020-07-23","207","6285","31","658","19","18.5"
"Gordon","2020-07-24","192","6477","26","684","18.9","18.6"
"Gordon","2020-07-25","60","6537","17","701","18.4","19.6"
"Gordon","2020-07-26","22","6559","5","706","19.6","19.2"
"Gordon","2020-07-27","225","6784","26","732","18.4","18.5"
"Gordon","2020-07-28","212","6996","39","771","18.3","18.8"
"Gordon","2020-07-29","173","7169","31","802","18.2","18.6"
"Gordon","2020-07-30","177","7346","23","825","17.9","18.5"
"Gordon","2020-07-31","175","7521","24","849","17.9","18.4"
"Gordon","2020-08-01","39","7560","8","857","16.8","17.6"
"Gordon","2020-08-02","29","7589","7","864","17","18.3"
"Gordon","2020-08-03","187","7776","19","883","16.8","17.6"
"Gordon","2020-08-04","306","8082","36","919","15.9","17.1"
"Gordon","2020-08-05","275","8357","44","963","15.6","16.9"
"Gordon","2020-08-06","137","8494","10","973","14.8","16.4"
"Gordon","2020-08-07","174","8668","16","989","14.2","16.1"
"Gordon","2020-08-08","33","8701","6","995","13.8","15.3"
"Gordon","2020-08-09","29","8730","6","1001","13.3","15.2"
"Gordon","2020-08-10","209","8939","23","1024","13.4","15.1"
"Gordon","2020-08-11","199","9138","16","1040","12.9","14.4"
"Gordon","2020-08-12","168","9306","10","1050","11.5","13.5"
"Gordon","2020-08-13","166","9472","13","1063","11.6","13.2"
"Gordon","2020-08-14","170","9642","12","1075","11.3","12.7"
"Gordon","2020-08-15","44","9686","3","1078","9.6","11.7"
"Gordon","2020-08-16","35","9721","9","1087","10.3","11.8"
"Gordon","2020-08-17","89","9810","17","1104","11.5","12.5"
"Gordon","2020-08-18","234","10044","15","1119","11.3","12.1"
"Gordon","2020-08-19","188","10232","10","1129","11.2","11.3"
"Gordon","2020-08-20","193","10425","6","1135","10.5","11"
"Gordon","2020-08-21","189","10614","11","1146","10.3","10.8"
"Gordon","2020-08-22","58","10672","3","1149","10.1","9.9"
"Gordon","2020-08-23","23","10695","6","1155","10.1","10.2"
"Gordon","2020-08-24","171","10866","11","1166","8.3","9.9"
"Gordon","2020-08-25","242","11108","11","1177","8.1","9.7"
"Gordon","2020-08-26","173","11281","11","1188","8.2","9.7"
"Gordon","2020-08-27","170","11451","16","1204","9.1","9.8"
"Gordon","2020-08-28","165","11616","18","1222","9.8","10.1"
"Gordon","2020-08-29","35","11651","2","1224","9.9","10"
"Gordon","2020-08-30","18","11669","5","1229","10.2","10.2"
"Gordon","2020-08-31","157","11826","13","1242","10.4","9.4"
"Gordon","2020-09-01","243","12069","14","1256","10.6","9.3"
"Gordon","2020-09-02","202","12271","11","1267","10.5","9.3"
"Gordon","2020-09-03","78","12349","8","1275","10.6","9.9"
"Gordon","2020-09-04","96","12445","8","1283","10.2","10"
"Gordon","2020-09-05","52","12497","4","1287","10.5","10.2"
"Gordon","2020-09-06","19","12516","2","1289","8","9.1"
"Gordon","2020-09-07","23","12539","4","1293","9.3","9.9"
"Gordon","2020-09-08","227","12766","31","1324","10.5","10.5"
"Gordon","2020-09-09","174","12940","17","1341","11.1","10.8"
"Gordon","2020-09-10","112","13052","10","1351","10.9","10.7"
"Gordon","2020-09-11","127","13179","8","1359","10.6","10.4"
"Gordon","2020-09-12","25","13204","2","1361","10.7","10.6"
"Gordon","2020-09-13","29","13233","4","1365","11.1","9.6"
"Gordon","2020-09-14","115","13348","8","1373","9.6","9.5"
"Gordon","2020-09-15","276","13624","19","1392","8.7","9.6"
"Gordon","2020-09-16","186","13810","13","1405","8.3","9.7"
"Gordon","2020-09-17","116","13926","4","1409","7.5","9.2"
"Gordon","2020-09-18","118","14044","4","1413","7.1","8.8"
"Gordon","2020-09-19","58","14102","5","1418","7.2","8.9"
"Gordon","2020-09-20","19","14121","4","1422","8.2","9.7"
"Gordon","2020-09-21","85","14206","8","1430","8.5","9.1"
"Gordon","2020-09-22","294","14500","18","1448","8.4","8.5"
"Gordon","2020-09-23","157","14657","13","1461","8.6","8.4"
"Gordon","2020-09-24","90","14747","5","1466","8.9","8.2"
"Gordon","2020-09-25","90","14837","6","1472","9.4","8.2"
"Gordon","2020-09-26","48","14885","10","1482","11.1","9.1"
"Gordon","2020-09-27","24","14909","2","1484","9.3","8.8"
"Gordon","2020-09-28","91","15000","11","1495","9.7","9.1"
"Gordon","2020-09-29","244","15244","12","1507","9.5","9"
"Gordon","2020-09-30","142","15386","9","1516","9.2","8.9"
"Gordon","2020-10-01","78","15464","6","1522","9.6","9.2"
"Gordon","2020-10-02","93","15557","4","1526","9.2","9.3"
"Gordon","2020-10-03","60","15617","2","1528","6.7","8.9"
"Gordon","2020-10-04","24","15641","0","1528","5.5","7.4"
"Gordon","2020-10-05","93","15734","6","1534","4.7","7.2"
"Gordon","2020-10-06","258","15992","27","1561","5.5","7.5"
"Gordon","2020-10-07","181","16173","12","1573","5.6","7.4"
"Gordon","2020-10-08","143","16316","19","1592","6.4","8"
"Gordon","2020-10-09","122","16438","17","1609","7.7","8.5"
"Gordon","2020-10-10","99","16537","17","1626","9.7","8.2"
"Gordon","2020-10-11","43","16580","8","1634","12.4","8.9"
"Gordon","2020-10-12","138","16718","27","1661","14.2","9.5"
"Gordon","2020-10-13","362","17080","44","1705","14.5","10"
"Gordon","2020-10-14","266","17346","36","1741","15.5","10.5"
"Gordon","2020-10-15","109","17455","14","1755","15.4","10.9"
"Gordon","2020-10-16","152","17607","18","1773","15.1","11.4"
"Gordon","2020-10-17","71","17678","15","1788","15.7","12.7"
"Gordon","2020-10-18","37","17715","13","1801","18","15.2"
"Gordon","2020-10-19","107","17822","20","1821","17.9","16.1"
"Gordon","2020-10-20","386","18208","50","1871","18","16.2"
"Gordon","2020-10-21","263","18471","34","1905","17.9","16.7"
"Gordon","2020-10-22","112","18583","18","1923","18.4","16.9"
"Gordon","2020-10-23","138","18721","15","1938","18.3","16.7"
"Gordon","2020-10-24","67","18788","12","1950","17.8","16.7"
"Gordon","2020-10-25","51","18839","9","1959","15.3","16.7"
"Gordon","2020-10-26","125","18964","19","1978","14.8","16.4"
"Gordon","2020-10-27","346","19310","33","2011","14.3","16.2"
"Gordon","2020-10-28","276","19586","30","2041","14","16"
"Gordon","2020-10-29","157","19743","24","2065","13.9","16.1"
"Gordon","2020-10-30","118","19861","6","2071","13.1","15.7"
"Gordon","2020-10-31","56","19917","9","2080","12.8","15.3"
"Gordon","2020-11-01","37","19954","5","2085","12.2","13.8"
"Gordon","2020-11-02","114","20068","16","2101","12.1","13.4"
"Gordon","2020-11-03","245","20313","23","2124","12","13.2"
"Gordon","2020-11-04","209","20522","22","2146","12","13"
"Gordon","2020-11-05","122","20644","7","2153","10.6","12.3"
"Gordon","2020-11-06","134","20778","10","2163","11","12"
"Gordon","2020-11-07","71","20849","11","2174","10.9","11.8"
"Gordon","2020-11-08","40","20889","7","2181","11.4","11.8"
"Gordon","2020-11-09","137","21026","27","2208","12.3","12.2"
"Gordon","2020-11-10","275","21301","56","2264","13.8","12.9"
"Gordon","2020-11-11","242","21543","36","2300","14.4","13.2"
"Gordon","2020-11-12","153","21696","15","2315","15","12.8"
"Gordon","2020-11-13","134","21830","12","2327","15.2","13.1"
"Gordon","2020-11-14","113","21943","14","2341","14.8","12.8"
"Gordon","2020-11-15","44","21987","12","2353","16.2","13.8"
"Gordon","2020-11-16","116","22103","23","2376","16.2","14.2"
"Gordon","2020-11-17","396","22499","61","2437","15.5","14.7"
"Gordon","2020-11-18","280","22779","43","2480","15.6","15"
"Gordon","2020-11-19","115","22894","14","2494","15.9","15.5"
"Gordon","2020-11-20","158","23052","17","2511","16.2","15.7"
"Gordon","2020-11-21","68","23120","13","2524","17.1","16"
"Gordon","2020-11-22","57","23177","8","2532","15.2","15.7"
"Gordon","2020-11-23","121","23298","14","2546","14.1","15.1"
"Gordon","2020-11-24","452","23750","69","2615","14","14.8"
"Gordon","2020-11-25","332","24082","51","2666","14","14.8"
"Gordon","2020-11-26","25","24107","2","2668","13.4","14.7"
"Gordon","2020-11-27","73","24180","17","2685","15.2","15.7"
"Gordon","2020-11-28","82","24262","13","2698","14.8","15.9"
"Gordon","2020-11-29","55","24317","12","2710","15.9","15.6"
"Gordon","2020-11-30","163","24480","24","2734","16.3","15.2"
"Gordon","2020-12-01","355","24835","43","2777","15.9","15"
"Gordon","2020-12-02","300","25135","45","2822","15.8","14.9"
"Gordon","2020-12-03","168","25303","25","2847","16.8","15.1"
"Gordon","2020-12-04","179","25482","22","2869","15.2","15.2"
"Gordon","2020-12-05","59","25541","11","2880","15.6","15.2"
"Gordon","2020-12-06","63","25604","13","2893","15.5","15.7"
"Gordon","2020-12-07","164","25768","29","2922","15.9","16.1"
"Gordon","2020-12-08","390","26158","52","2974","16.1","16"
"Gordon","2020-12-09","336","26494","34","3008","15.4","15.6"
"Gordon","2020-12-10","170","26664","16","3024","14.6","15.7"
"Gordon","2020-12-11","127","26791","23","3047","15.4","15.3"
"Gordon","2020-12-12","86","26877","14","3061","15.1","15.4"
"Gordon","2020-12-13","56","26933","13","3074","15.5","15.5"
"Gordon","2020-12-14","130","27063","18","3092","14.9","15.4"
"Gordon","2020-12-15","453","27516","50","3142","14.6","15.3"
"Gordon","2020-12-16","396","27912","63","3205","15.4","15.4"
"Gordon","2020-12-17","106","28018","15","3220","16.1","15.3"
"Gordon","2020-12-18","121","28139","21","3241","16","15.7"
"Gordon","2020-12-19","70","28209","14","3255","16.5","15.8"
"Gordon","2020-12-20","53","28262","16","3271","17.5","16.5"
"Gordon","2020-12-21","125","28387","18","3289","17.6","16.2"
"Gordon","2020-12-22","457","28844","70","3359","18.2","16.4"
"Gordon","2020-12-23","333","29177","55","3414","18.3","16.8"
"Gordon","2020-12-24","50","29227","8","3422","18.5","17.3"
"Gordon","2020-12-25","30","29257","12","3434","21.8","18.9"
"Gordon","2020-12-26","71","29328","21","3455","23.1","19.8"
"Gordon","2020-12-27","79","29407","24","3479","23.2","20.3"
"Gordon","2020-12-28","174","29581","39","3518","24.3","20.9"
"Gordon","2020-12-29","530","30111","102","3620","24.9","21.5"
"Gordon","2020-12-30","394","30505","72","3692","25.1","21.7"
"Gordon","2020-12-31","97","30602","19","3711","25.6","22.1"
"Gordon","2021-01-01","42","30644","25","3736","28.4","25.1"
"Gordon","2021-01-02","60","30704","15","3751","27.8","25.5"
"Gordon","2021-01-03","52","30756","14","3765","27.3","25.2"
"Gordon","2021-01-04","78","30834","15","3780","26.8","25.6"
"Gordon","2021-01-05","642","31476","121","3901","26.8","25.8"
"Gordon","2021-01-06","399","31875","52","3953","26","25.6"
"Gordon","2021-01-07","123","31998","18","3971","25.3","25.5"
"Gordon","2021-01-08","127","32125","19","3990","18.9","23.7"
"Gordon","2021-01-09","60","32185","20","4010","20.1","24"
"Gordon","2021-01-10","69","32254","20","4030","20.4","23.9"
"Gordon","2021-01-11","121","32375","24","4054","20.5","23.7"
"Gordon","2021-01-12","440","32815","66","4120","20","23.4"
"Gordon","2021-01-13","428","33243","55","4175","19.9","23"
"Gordon","2021-01-14","116","33359","19","4194","20.2","22.8"
"Gordon","2021-01-15","127","33486","25","4219","20.9","19.9"
"Gordon","2021-01-16","79","33565","13","4232","18.5","19.3"
"Gordon","2021-01-17","47","33612","10","4242","17.4","18.9"
"Gordon","2021-01-18","121","33733","24","4266","17.4","18.9"
"Gordon","2021-01-19","446","34179","58","4324","17.1","18.5"
"Gordon","2021-01-20","132","34311","20","4344","17.4","18.7"
"Gordon","2021-01-21","105","34416","11","4355","16.6","18.4"
"Gordon","2021-01-22","123","34539","16","4371","15.6","18.2"
"Gordon","2021-01-23","65","34604","10","4381","15.4","17"
"Gordon","2021-01-24","60","34664","15","4396","16","16.7"
"Gordon","2021-01-25","46","34710","5","4401","14.7","16"
"Gordon","2021-01-26","0","34710","0","4401","12.8","15"
"Gordon","2021-01-27","0","34710","0","4401","10.7","14"
"Grady","2020-02-01","0","0","0","0",".","."
"Grady","2020-02-02","0","0","0","0",".","."
"Grady","2020-02-03","0","0","0","0",".","."
"Grady","2020-02-04","0","0","0","0",".","."
"Grady","2020-02-05","0","0","0","0",".","."
"Grady","2020-02-06","0","0","0","0",".","."
"Grady","2020-02-07","0","0","0","0","0","."
"Grady","2020-02-08","0","0","0","0","0","."
"Grady","2020-02-09","0","0","0","0","0","."
"Grady","2020-02-10","0","0","0","0","0","."
"Grady","2020-02-11","0","0","0","0","0","."
"Grady","2020-02-12","0","0","0","0","0","."
"Grady","2020-02-13","0","0","0","0","0","."
"Grady","2020-02-14","0","0","0","0","0","0"
"Grady","2020-02-15","0","0","0","0","0","0"
"Grady","2020-02-16","0","0","0","0","0","0"
"Grady","2020-02-17","0","0","0","0","0","0"
"Grady","2020-02-18","0","0","0","0","0","0"
"Grady","2020-02-19","0","0","0","0","0","0"
"Grady","2020-02-20","0","0","0","0","0","0"
"Grady","2020-02-21","0","0","0","0","0","0"
"Grady","2020-02-22","0","0","0","0","0","0"
"Grady","2020-02-23","0","0","0","0","0","0"
"Grady","2020-02-24","0","0","0","0","0","0"
"Grady","2020-02-25","0","0","0","0","0","0"
"Grady","2020-02-26","0","0","0","0","0","0"
"Grady","2020-02-27","0","0","0","0","0","0"
"Grady","2020-02-28","0","0","0","0","0","0"
"Grady","2020-02-29","0","0","0","0","0","0"
"Grady","2020-03-01","0","0","0","0","0","0"
"Grady","2020-03-02","0","0","0","0","0","0"
"Grady","2020-03-03","0","0","0","0","0","0"
"Grady","2020-03-04","0","0","0","0","0","0"
"Grady","2020-03-05","0","0","0","0","0","0"
"Grady","2020-03-06","0","0","0","0","0","0"
"Grady","2020-03-07","0","0","0","0","0","0"
"Grady","2020-03-08","0","0","0","0","0","0"
"Grady","2020-03-09","0","0","0","0","0","0"
"Grady","2020-03-10","0","0","0","0","0","0"
"Grady","2020-03-11","0","0","0","0","0","0"
"Grady","2020-03-12","0","0","0","0","0","0"
"Grady","2020-03-13","0","0","0","0","0","0"
"Grady","2020-03-14","0","0","0","0","0","0"
"Grady","2020-03-15","0","0","0","0","0","0"
"Grady","2020-03-16","1","1","0","0","0","0"
"Grady","2020-03-17","1","2","0","0","0","0"
"Grady","2020-03-18","0","2","0","0","0","0"
"Grady","2020-03-19","2","4","0","0","0","0"
"Grady","2020-03-20","2","6","0","0","0","0"
"Grady","2020-03-21","0","6","0","0","0","0"
"Grady","2020-03-22","0","6","0","0","0","0"
"Grady","2020-03-23","2","8","0","0","0","0"
"Grady","2020-03-24","0","8","0","0","0","0"
"Grady","2020-03-25","1","9","0","0","0","0"
"Grady","2020-03-26","3","12","0","0","0","0"
"Grady","2020-03-27","0","12","0","0","0","0"
"Grady","2020-03-28","0","12","0","0","0","0"
"Grady","2020-03-29","3","15","3","3","14.3","7.1"
"Grady","2020-03-30","3","18","2","5","23.8","11.9"
"Grady","2020-03-31","10","28","4","9","29.5","14.8"
"Grady","2020-04-01","3","31","2","11","39","19.5"
"Grady","2020-04-02","4","35","3","14","49.8","24.9"
"Grady","2020-04-03","6","41","3","17","56.9","28.5"
"Grady","2020-04-04","2","43","2","19","71.2","35.6"
"Grady","2020-04-05","1","44","1","20","71.2","42.7"
"Grady","2020-04-06","3","47","2","22","71.2","47.5"
"Grady","2020-04-07","7","54","5","27","75.7","52.6"
"Grady","2020-04-08","6","60","3","30","73.3","56.2"
"Grady","2020-04-09","24","84","10","40","68.5","59.1"
"Grady","2020-04-10","4","88","2","42","68.5","62.7"
"Grady","2020-04-11","1","89","0","42","54.3","62.7"
"Grady","2020-04-12","3","92","3","45","54.3","62.7"
"Grady","2020-04-13","3","95","2","47","54.3","62.7"
"Grady","2020-04-14","25","120","6","53","47.5","61.6"
"Grady","2020-04-15","3","123","1","54","45.1","59.2"
"Grady","2020-04-16","5","128","3","57","47.7","58.1"
"Grady","2020-04-17","4","132","4","61","54.9","61.7"
"Grady","2020-04-18","2","134","1","62","62","58.1"
"Grady","2020-04-19","0","134","0","62","47.7","51"
"Grady","2020-04-20","1","135","1","63","52.5","53.4"
"Grady","2020-04-21","0","135","0","63","49","48.3"
"Grady","2020-04-22","3","138","1","64","49","47.1"
"Grady","2020-04-23","1","139","0","64","40.5","44.1"
"Grady","2020-04-24","4","143","2","66","33.3","44.1"
"Grady","2020-04-25","1","144","1","67","40.5","51.2"
"Grady","2020-04-26","0","144","0","67","40.5","44.1"
"Grady","2020-04-27","6","150","1","68","28.6","40.5"
"Grady","2020-04-28","3","153","1","69","33.3","41.2"
"Grady","2020-04-29","1","154","0","69","28.6","38.8"
"Grady","2020-04-30","3","157","0","69","28.6","34.5"
"Grady","2020-05-01","2","159","0","69","21.4","27.4"
"Grady","2020-05-02","48","207","0","69","7.1","23.8"
"Grady","2020-05-03","1","208","1","70","21.4","31"
"Grady","2020-05-04","2","210","2","72","33.3","31"
"Grady","2020-05-05","4","214","2","74","35.7","34.5"
"Grady","2020-05-06","1","215","0","74","35.7","32.1"
"Grady","2020-05-07","4","219","2","76","42.9","35.7"
"Grady","2020-05-08","0","219","0","76","42.9","32.1"
"Grady","2020-05-09","0","219","0","76","42.9","25"
"Grady","2020-05-10","100","319","4","80","29.1","25.3"
"Grady","2020-05-11","2","321","0","80","14.9","24.1"
"Grady","2020-05-12","93","414","3","83","8.2","21.9"
"Grady","2020-05-13","1","415","0","83","8.2","21.9"
"Grady","2020-05-14","5","420","0","83","1","21.9"
"Grady","2020-05-15","3","423","2","85","10.6","26.7"
"Grady","2020-05-16","3","426","2","87","20.1","31.5"
"Grady","2020-05-17","0","426","0","87","19.5","24.3"
"Grady","2020-05-18","2","428","0","87","19.5","17.2"
"Grady","2020-05-19","28","456","3","90","20.6","14.4"
"Grady","2020-05-20","6","462","0","90","20.6","14.4"
"Grady","2020-05-21","32","494","4","94","22.4","11.7"
"Grady","2020-05-22","11","505","0","94","12.8","11.7"
"Grady","2020-05-23","49","554","6","100","5.1","12.6"
"Grady","2020-05-24","1","555","0","100","5.1","12.3"
"Grady","2020-05-25","2","557","0","100","5.1","12.3"
"Grady","2020-05-26","30","587","9","109","7.8","14.2"
"Grady","2020-05-27","0","587","0","109","7.8","14.2"
"Grady","2020-05-28","53","640","6","115","7.7","15"
"Grady","2020-05-29","4","644","3","118","18.4","15.6"
"Grady","2020-05-30","1","645","0","118","16.6","10.8"
"Grady","2020-05-31","53","698","1","119","16.9","11"
"Grady","2020-06-01","8","706","2","121","20.5","12.8"
"Grady","2020-06-02","55","761","6","127","17.7","12.8"
"Grady","2020-06-03","33","794","1","128","18.2","13"
"Grady","2020-06-04","14","808","0","128","16.5","12.1"
"Grady","2020-06-05","59","867","0","128","5.8","12.1"
"Grady","2020-06-06","8","875","0","128","5.8","11.2"
"Grady","2020-06-07","6","881","0","128","5.6","11.2"
"Grady","2020-06-08","52","933","3","131","2.8","11.6"
"Grady","2020-06-09","25","958","0","131","1.3","9.5"
"Grady","2020-06-10","17","975","1","132","1.7","9.9"
"Grady","2020-06-11","18","993","0","132","1.7","9.1"
"Grady","2020-06-12","23","1016","1","133","2.3","4.1"
"Grady","2020-06-13","2","1018","0","133","2.3","4.1"
"Grady","2020-06-14","8","1026","2","135","5.9","5.7"
"Grady","2020-06-15","31","1057","0","135","5","3.9"
"Grady","2020-06-16","12","1069","1","136","6.2","3.7"
"Grady","2020-06-17","22","1091","1","137","6","3.8"
"Grady","2020-06-18","10","1101","0","137","6","3.8"
"Grady","2020-06-19","32","1133","3","140","6.8","4.5"
"Grady","2020-06-20","7","1140","0","140","6.8","4.5"
"Grady","2020-06-21","2","1142","0","140","3.2","4.5"
"Grady","2020-06-22","30","1172","0","140","3.2","4.1"
"Grady","2020-06-23","12","1184","0","140","2","4.1"
"Grady","2020-06-24","25","1209","1","141","1.9","4"
"Grady","2020-06-25","28","1237","3","144","3.4","4.7"
"Grady","2020-06-26","26","1263","3","147","3.8","5.3"
"Grady","2020-06-27","4","1267","0","147","3.8","5.3"
"Grady","2020-06-28","3","1270","0","147","3.8","3.5"
"Grady","2020-06-29","26","1296","0","147","3.8","3.5"
"Grady","2020-06-30","24","1320","0","147","3.8","2.9"
"Grady","2020-07-01","16","1336","1","148","4.1","3"
"Grady","2020-07-02","23","1359","1","149","3.2","3.3"
"Grady","2020-07-03","13","1372","0","149","1.5","2.6"
"Grady","2020-07-04","7","1379","0","149","1.5","2.6"
"Grady","2020-07-05","19","1398","1","150","2.3","3"
"Grady","2020-07-06","25","1423","2","152","3.4","3.6"
"Grady","2020-07-07","37","1460","2","154","4.2","4"
"Grady","2020-07-08","51","1511","3","157","4.1","4.1"
"Grady","2020-07-09","37","1548","1","158","3.9","3.5"
"Grady","2020-07-10","32","1580","4","162","5.7","3.6"
"Grady","2020-07-11","5","1585","0","162","5.7","3.6"
"Grady","2020-07-12","6","1591","2","164","9.7","6"
"Grady","2020-07-13","22","1613","4","168","11.1","7.3"
"Grady","2020-07-14","32","1645","14","182","16.6","10.4"
"Grady","2020-07-15","25","1670","1","183","16.4","10.2"
"Grady","2020-07-16","27","1697","3","186","17.6","10.7"
"Grady","2020-07-17","35","1732","5","191","17.8","11.7"
"Grady","2020-07-18","6","1738","2","193","22.6","14.1"
"Grady","2020-07-19","5","1743","1","194","20.7","15.2"
"Grady","2020-07-20","39","1782","8","202","21","16.1"
"Grady","2020-07-21","26","1808","3","205","16.4","16.5"
"Grady","2020-07-22","27","1835","4","209","17.9","17.1"
"Grady","2020-07-23","28","1863","2","211","17.4","17.5"
"Grady","2020-07-24","28","1891","3","214","16.9","17.3"
"Grady","2020-07-25","16","1907","5","219","16.6","19.6"
"Grady","2020-07-26","1","1908","1","220","28","24.3"
"Grady","2020-07-27","35","1943","2","222","25.9","23.4"
"Grady","2020-07-28","39","1982","10","232","27.9","22.1"
"Grady","2020-07-29","19","2001","3","235","28","23"
"Grady","2020-07-30","33","2034","7","242","30","23.7"
"Grady","2020-07-31","35","2069","11","253","33","24.9"
"Grady","2020-08-01","12","2081","5","258","34.5","25.5"
"Grady","2020-08-02","4","2085","1","259","23.8","25.9"
"Grady","2020-08-03","31","2116","3","262","24.3","25.1"
"Grady","2020-08-04","35","2151","8","270","23.9","25.9"
"Grady","2020-08-05","43","2194","3","273","22.7","25.4"
"Grady","2020-08-06","27","2221","4","277","21.8","25.9"
"Grady","2020-08-07","27","2248","6","283","20.5","26.7"
"Grady","2020-08-08","16","2264","4","287","18.1","26.3"
"Grady","2020-08-09","20","2284","4","291","17.4","20.6"
"Grady","2020-08-10","26","2310","3","294","17.6","21"
"Grady","2020-08-11","27","2337","4","298","16.5","20.2"
"Grady","2020-08-12","26","2363","1","299","16","19.4"
"Grady","2020-08-13","21","2384","4","303","16.6","19.2"
"Grady","2020-08-14","57","2441","11","314","16.2","18.3"
"Grady","2020-08-15","7","2448","2","316","16.7","17.4"
"Grady","2020-08-16","10","2458","2","318","16.7","17"
"Grady","2020-08-17","24","2482","3","321","16.9","17.2"
"Grady","2020-08-18","26","2508","7","328","18.6","17.5"
"Grady","2020-08-19","24","2532","4","332","20.4","18.2"
"Grady","2020-08-20","22","2554","2","334","19","17.8"
"Grady","2020-08-21","26","2580","3","337","17.9","17.1"
"Grady","2020-08-22","5","2585","2","339","19.5","18.1"
"Grady","2020-08-23","10","2595","2","341","19.5","18.1"
"Grady","2020-08-24","18","2613","2","343","19.3","18.1"
"Grady","2020-08-25","18","2631","7","350","21","19.8"
"Grady","2020-08-26","19","2650","3","353","20.9","20.7"
"Grady","2020-08-27","18","2668","5","358","23.6","21.3"
"Grady","2020-08-28","11","2679","0","358","21.9","19.9"
"Grady","2020-08-29","3","2682","1","359","21","20.3"
"Grady","2020-08-30","4","2686","1","360","21.7","20.6"
"Grady","2020-08-31","18","2704","1","361","20.9","20.1"
"Grady","2020-09-01","20","2724","3","364","17.5","19.3"
"Grady","2020-09-02","27","2751","6","370","18.4","19.7"
"Grady","2020-09-03","26","2777","4","374","16.6","20.1"
"Grady","2020-09-04","8","2785","1","375","18.4","20.2"
"Grady","2020-09-05","3","2788","0","375","13.7","17.3"
"Grady","2020-09-06","6","2794","2","377","14.9","18.3"
"Grady","2020-09-07","9","2803","3","380","18.8","19.9"
"Grady","2020-09-08","25","2828","2","382","17.8","17.7"
"Grady","2020-09-09","16","2844","1","383","15.5","17"
"Grady","2020-09-10","17","2861","4","387","16.7","16.7"
"Grady","2020-09-11","14","2875","3","390","18","18.2"
"Grady","2020-09-12","9","2884","1","391","19.6","16.6"
"Grady","2020-09-13","8","2892","0","391","14.8","14.8"
"Grady","2020-09-14","43","2935","8","399","12.7","15.8"
"Grady","2020-09-15","17","2952","2","401","13.2","15.5"
"Grady","2020-09-16","32","2984","1","402","12.8","14.2"
"Grady","2020-09-17","24","3008","2","404","10.6","13.7"
"Grady","2020-09-18","19","3027","0","404","7.6","12.8"
"Grady","2020-09-19","6","3033","0","404","6","12.8"
"Grady","2020-09-20","4","3037","1","405","9.5","12.2"
"Grady","2020-09-21","35","3072","0","405","6.9","9.8"
"Grady","2020-09-22","25","3097","2","407","6.4","9.8"
"Grady","2020-09-23","27","3124","3","410","7.5","10.1"
"Grady","2020-09-24","29","3153","0","410","6.3","8.5"
"Grady","2020-09-25","14","3167","1","411","7.3","7.4"
"Grady","2020-09-26","6","3173","0","411","7.3","6.6"
"Grady","2020-09-27","8","3181","4","415","10.9","10.2"
"Grady","2020-09-28","22","3203","1","416","11.5","9.2"
"Grady","2020-09-29","19","3222","2","418","11.9","9.1"
"Grady","2020-09-30","34","3256","2","420","11.2","9.3"
"Grady","2020-10-01","25","3281","2","422","12.3","9.3"
"Grady","2020-10-02","34","3315","4","426","13","10.1"
"Grady","2020-10-03","12","3327","3","429","16.5","11.9"
"Grady","2020-10-04","9","3336","2","431","12.6","11.7"
"Grady","2020-10-05","30","3366","1","432","12.4","12"
"Grady","2020-10-06","32","3398","0","432","10.9","11.4"
"Grady","2020-10-07","16","3414","0","432","10","10.6"
"Grady","2020-10-08","24","3438","0","432","8.9","10.6"
"Grady","2020-10-09","16","3454","2","434","9","11"
"Grady","2020-10-10","6","3460","1","435","7.8","12.2"
"Grady","2020-10-11","0","3460","0","435","4.6","8.6"
"Grady","2020-10-12","24","3484","3","438","6","9.2"
"Grady","2020-10-13","17","3501","1","439","6.8","8.8"
"Grady","2020-10-14","10","3511","0","439","6.8","8.4"
"Grady","2020-10-15","17","3528","1","440","7.6","8.3"
"Grady","2020-10-16","10","3538","1","441","7.3","8.1"
"Grady","2020-10-17","2","3540","0","441","4.9","6.4"
"Grady","2020-10-18","1","3541","0","441","4.9","4.8"
"Grady","2020-10-19","15","3556","0","441","3.1","4.5"
"Grady","2020-10-20","12","3568","2","443","4.6","5.7"
"Grady","2020-10-21","16","3584","0","443","4.6","5.7"
"Grady","2020-10-22","18","3602","1","444","4.6","6.1"
"Grady","2020-10-23","16","3618","2","446","5","6.1"
"Grady","2020-10-24","4","3622","0","446","5","4.9"
"Grady","2020-10-25","8","3630","1","447","6.7","5.8"
"Grady","2020-10-26","23","3653","0","447","6.7","4.9"
"Grady","2020-10-27","15","3668","1","448","5.3","5"
"Grady","2020-10-28","10","3678","2","450","8.2","6.4"
"Grady","2020-10-29","12","3690","0","450","7.4","6"
"Grady","2020-10-30","11","3701","2","452","8.2","6.6"
"Grady","2020-10-31","6","3707","2","454","13","9"
"Grady","2020-11-01","3","3710","1","455","15.9","11.3"
"Grady","2020-11-02","18","3728","1","456","16.7","11.7"
"Grady","2020-11-03","11","3739","2","458","18.4","11.8"
"Grady","2020-11-04","23","3762","0","458","15.5","11.8"
"Grady","2020-11-05","16","3778","0","458","15.5","11.4"
"Grady","2020-11-06","12","3790","1","459","14.1","11.1"
"Grady","2020-11-07","8","3798","0","459","9.3","11.1"
"Grady","2020-11-08","4","3802","0","459","4.6","10.3"
"Grady","2020-11-09","17","3819","1","460","4.6","10.7"
"Grady","2020-11-10","15","3834","1","461","3","10.7"
"Grady","2020-11-11","13","3847","1","462","4.1","9.8"
"Grady","2020-11-12","18","3865","0","462","4.1","9.8"
"Grady","2020-11-13","22","3887","1","463","3.5","8.8"
"Grady","2020-11-14","7","3894","1","464","5.6","7.5"
"Grady","2020-11-15","5","3899","0","464","5.6","5.1"
"Grady","2020-11-16","21","3920","1","465","5.4","5"
"Grady","2020-11-17","17","3937","2","467","6.2","4.6"
"Grady","2020-11-18","18","3955","3","470","7.4","5.8"
"Grady","2020-11-19","19","3974","1","471","8.2","6.1"
"Grady","2020-11-20","17","3991","2","473","9.2","6.4"
"Grady","2020-11-21","8","3999","3","476","12.5","9.1"
"Grady","2020-11-22","2","4001","2","478","26.8","16.2"
"Grady","2020-11-23","19","4020","0","478","26.1","15.8"
"Grady","2020-11-24","20","4040","2","480","25.9","16"
"Grady","2020-11-25","25","4065","1","481","24.1","15.8"
"Grady","2020-11-26","5","4070","0","481","23.3","15.8"
"Grady","2020-11-27","8","4078","0","481","21.6","15.4"
"Grady","2020-11-28","10","4088","0","481","16.3","14.4"
"Grady","2020-11-29","11","4099","1","482","3.3","15.1"
"Grady","2020-11-30","28","4127","2","484","4.3","15.2"
"Grady","2020-12-01","16","4143","0","484","2.9","14.4"
"Grady","2020-12-02","14","4157","2","486","4.4","14.2"
"Grady","2020-12-03","20","4177","4","490","7.2","15.3"
"Grady","2020-12-04","15","4192","0","490","7.2","14.4"
"Grady","2020-12-05","7","4199","4","494","15.4","15.8"
"Grady","2020-12-06","8","4207","3","497","19.4","11.4"
"Grady","2020-12-07","22","4229","3","500","20.4","12.3"
"Grady","2020-12-08","40","4269","2","502","21.1","12"
"Grady","2020-12-09","18","4287","2","504","20.6","12.5"
"Grady","2020-12-10","16","4303","1","505","18.7","12.9"
"Grady","2020-12-11","31","4334","3","508","20","13.6"
"Grady","2020-12-12","5","4339","1","509","14.7","15.1"
"Grady","2020-12-13","9","4348","2","511","12.6","16"
"Grady","2020-12-14","37","4385","2","513","11.4","15.9"
"Grady","2020-12-15","31","4416","5","518","13","17"
"Grady","2020-12-16","21","4437","5","523","14.8","17.7"
"Grady","2020-12-17","24","4461","8","531","18.7","18.7"
"Grady","2020-12-18","27","4488","4","535","19.4","19.7"
"Grady","2020-12-19","13","4501","2","537","18.7","16.7"
"Grady","2020-12-20","4","4505","2","539","22.7","17.6"
"Grady","2020-12-21","39","4544","8","547","24.9","18.1"
"Grady","2020-12-22","40","4584","6","553","24.7","18.8"
"Grady","2020-12-23","20","4604","3","556","23.4","19.1"
"Grady","2020-12-24","9","4613","2","558","21.8","20.3"
"Grady","2020-12-25","8","4621","3","561","25.1","22.2"
"Grady","2020-12-26","13","4634","6","567","29.5","24.1"
"Grady","2020-12-27","14","4648","3","570","25.4","24"
"Grady","2020-12-28","41","4689","15","585","27.7","26.3"
"Grady","2020-12-29","33","4722","9","594","29.5","27.1"
"Grady","2020-12-30","51","4773","10","604","30.1","26.8"
"Grady","2020-12-31","19","4792","5","609","30.7","26.3"
"Grady","2021-01-01","14","4806","6","615","31.5","28.3"
"Grady","2021-01-02","16","4822","6","621","30.2","29.9"
"Grady","2021-01-03","26","4848","11","632","33.2","29.3"
"Grady","2021-01-04","60","4908","22","654","33.2","30.5"
"Grady","2021-01-05","51","4959","13","667","33","31.2"
"Grady","2021-01-06","47","5006","13","680","34.1","32.1"
"Grady","2021-01-07","40","5046","14","694","35.4","33"
"Grady","2021-01-08","36","5082","10","704","33.2","32.3"
"Grady","2021-01-09","23","5105","6","710","31.6","30.9"
"Grady","2021-01-10","13","5118","5","715","31","32.1"
"Grady","2021-01-11","46","5164","7","722","28","30.6"
"Grady","2021-01-12","38","5202","7","729","26.9","30"
"Grady","2021-01-13","53","5255","11","740","26","30"
"Grady","2021-01-14","34","5289","4","744","22.6","29"
"Grady","2021-01-15","21","5310","3","747","20.7","27"
"Grady","2021-01-16","20","5330","7","754","22","26.8"
"Grady","2021-01-17","6","5336","2","756","21.3","26.1"
"Grady","2021-01-18","48","5384","11","767","22.4","25.2"
"Grady","2021-01-19","33","5417","1","768","20.2","23.6"
"Grady","2021-01-20","41","5458","5","773","18.9","22.4"
"Grady","2021-01-21","33","5491","6","779","19.8","21.2"
"Grady","2021-01-22","22","5513","4","783","20.4","20.6"
"Grady","2021-01-23","4","5517","0","783","15.4","18.7"
"Grady","2021-01-24","5","5522","1","784","13.5","17.4"
"Grady","2021-01-25","22","5544","8","792","15.4","18.9"
"Grady","2021-01-26","6","5550","1","793","17.4","18.8"
"Grady","2021-01-27","0","5550","0","793","15.6","17.3"
"Greene","2020-02-01","0","0","0","0",".","."
"Greene","2020-02-02","0","0","0","0",".","."
"Greene","2020-02-03","0","0","0","0",".","."
"Greene","2020-02-04","0","0","0","0",".","."
"Greene","2020-02-05","0","0","0","0",".","."
"Greene","2020-02-06","0","0","0","0",".","."
"Greene","2020-02-07","0","0","0","0","0","."
"Greene","2020-02-08","0","0","0","0","0","."
"Greene","2020-02-09","0","0","0","0","0","."
"Greene","2020-02-10","0","0","0","0","0","."
"Greene","2020-02-11","0","0","0","0","0","."
"Greene","2020-02-12","0","0","0","0","0","."
"Greene","2020-02-13","0","0","0","0","0","."
"Greene","2020-02-14","0","0","0","0","0","0"
"Greene","2020-02-15","0","0","0","0","0","0"
"Greene","2020-02-16","0","0","0","0","0","0"
"Greene","2020-02-17","0","0","0","0","0","0"
"Greene","2020-02-18","0","0","0","0","0","0"
"Greene","2020-02-19","0","0","0","0","0","0"
"Greene","2020-02-20","0","0","0","0","0","0"
"Greene","2020-02-21","0","0","0","0","0","0"
"Greene","2020-02-22","0","0","0","0","0","0"
"Greene","2020-02-23","0","0","0","0","0","0"
"Greene","2020-02-24","0","0","0","0","0","0"
"Greene","2020-02-25","0","0","0","0","0","0"
"Greene","2020-02-26","0","0","0","0","0","0"
"Greene","2020-02-27","0","0","0","0","0","0"
"Greene","2020-02-28","0","0","0","0","0","0"
"Greene","2020-02-29","0","0","0","0","0","0"
"Greene","2020-03-01","0","0","0","0","0","0"
"Greene","2020-03-02","0","0","0","0","0","0"
"Greene","2020-03-03","0","0","0","0","0","0"
"Greene","2020-03-04","0","0","0","0","0","0"
"Greene","2020-03-05","0","0","0","0","0","0"
"Greene","2020-03-06","0","0","0","0","0","0"
"Greene","2020-03-07","0","0","0","0","0","0"
"Greene","2020-03-08","0","0","0","0","0","0"
"Greene","2020-03-09","0","0","0","0","0","0"
"Greene","2020-03-10","0","0","0","0","0","0"
"Greene","2020-03-11","0","0","0","0","0","0"
"Greene","2020-03-12","2","2","0","0","0","0"
"Greene","2020-03-13","2","4","0","0","0","0"
"Greene","2020-03-14","2","6","0","0","0","0"
"Greene","2020-03-15","3","9","1","1","4.8","2.4"
"Greene","2020-03-16","3","12","0","1","4.8","2.4"
"Greene","2020-03-17","5","17","2","3","10.5","5.2"
"Greene","2020-03-18","7","24","0","3","10.5","5.2"
"Greene","2020-03-19","2","26","0","3","10.5","5.2"
"Greene","2020-03-20","4","30","0","3","10.5","5.2"
"Greene","2020-03-21","1","31","1","4","24.8","12.4"
"Greene","2020-03-22","0","31","0","4","20","12.4"
"Greene","2020-03-23","7","38","1","5","22","13.4"
"Greene","2020-03-24","6","44","2","7","21.1","15.8"
"Greene","2020-03-25","11","55","2","9","23.7","17.1"
"Greene","2020-03-26","6","61","5","14","35.6","23"
"Greene","2020-03-27","3","64","0","14","35.6","23"
"Greene","2020-03-28","2","66","1","15","28.4","26.6"
"Greene","2020-03-29","1","67","1","16","42.7","31.4"
"Greene","2020-03-30","21","88","4","20","43.4","32.7"
"Greene","2020-03-31","4","92","2","22","45.8","33.4"
"Greene","2020-04-01","3","95","0","22","43.2","33.4"
"Greene","2020-04-02","4","99","0","22","31.3","33.4"
"Greene","2020-04-03","0","99","0","22","31.3","33.4"
"Greene","2020-04-04","0","99","0","22","24.1","26.3"
"Greene","2020-04-05","0","99","0","22","9.9","26.3"
"Greene","2020-04-06","2","101","1","23","14.3","28.8"
"Greene","2020-04-07","5","106","2","25","12.9","29.3"
"Greene","2020-04-08","9","115","1","26","14.4","28.8"
"Greene","2020-04-09","8","123","0","26","14.4","22.9"
"Greene","2020-04-10","5","128","1","27","17.3","24.3"
"Greene","2020-04-11","0","128","0","27","17.3","20.7"
"Greene","2020-04-12","0","128","0","27","17.3","13.6"
"Greene","2020-04-13","6","134","1","28","12.5","13.4"
"Greene","2020-04-14","8","142","4","32","14","13.4"
"Greene","2020-04-15","7","149","4","36","20.5","17.5"
"Greene","2020-04-16","7","156","1","37","22.6","18.5"
"Greene","2020-04-17","2","158","2","39","34","25.7"
"Greene","2020-04-18","1","159","1","40","48.3","32.8"
"Greene","2020-04-19","3","162","0","40","48.3","32.8"
"Greene","2020-04-20","8","170","0","40","45.9","29.2"
"Greene","2020-04-21","17","187","0","40","38.8","26.4"
"Greene","2020-04-22","6","193","2","42","35.4","28"
"Greene","2020-04-23","9","202","2","44","36.5","29.5"
"Greene","2020-04-24","5","207","2","46","27.9","31"
"Greene","2020-04-25","11","218","1","47","14.9","31.6"
"Greene","2020-04-26","2","220","1","48","22.1","35.2"
"Greene","2020-04-27","8","228","0","48","22.1","34"
"Greene","2020-04-28","8","236","0","48","22.1","30.4"
"Greene","2020-04-29","9","245","2","50","20.5","27.9"
"Greene","2020-04-30","20","265","1","51","18","27.3"
"Greene","2020-05-01","3","268","0","51","12.3","20.1"
"Greene","2020-05-02","1","269","0","51","11","13"
"Greene","2020-05-03","4","273","0","51","3.9","13"
"Greene","2020-05-04","12","285","0","51","3.9","13"
"Greene","2020-05-05","8","293","0","51","3.9","13"
"Greene","2020-05-06","4","297","0","51","0.7","10.6"
"Greene","2020-05-07","7","304","0","51","0","9"
"Greene","2020-05-08","5","309","0","51","0","6.2"
"Greene","2020-05-09","3","312","1","52","4.8","7.9"
"Greene","2020-05-10","1","313","0","52","4.8","4.3"
"Greene","2020-05-11","12","325","0","52","4.8","4.3"
"Greene","2020-05-12","9","334","2","54","7.9","5.9"
"Greene","2020-05-13","8","342","0","54","7.9","4.3"
"Greene","2020-05-14","5","347","0","54","7.9","4"
"Greene","2020-05-15","10","357","2","56","10.8","5.4"
"Greene","2020-05-16","3","360","0","56","6","5.4"
"Greene","2020-05-17","3","363","0","56","6","5.4"
"Greene","2020-05-18","10","373","0","56","6","5.4"
"Greene","2020-05-19","9","382","0","56","2.9","5.4"
"Greene","2020-05-20","5","387","0","56","2.9","5.4"
"Greene","2020-05-21","4","391","0","56","2.9","5.4"
"Greene","2020-05-22","5","396","0","56","0","5.4"
"Greene","2020-05-23","2","398","0","56","0","3"
"Greene","2020-05-24","3","401","0","56","0","3"
"Greene","2020-05-25","0","401","0","56","0","3"
"Greene","2020-05-26","11","412","1","57","1.3","2.1"
"Greene","2020-05-27","17","429","0","57","1.3","2.1"
"Greene","2020-05-28","16","445","1","58","2.2","2.5"
"Greene","2020-05-29","14","459","0","58","2.2","1.1"
"Greene","2020-05-30","10","469","0","58","2.2","1.1"
"Greene","2020-05-31","7","476","0","58","2.2","1.1"
"Greene","2020-06-01","13","489","1","59","3.3","1.6"
"Greene","2020-06-02","18","507","2","61","3.6","2.4"
"Greene","2020-06-03","26","533","1","62","4.1","2.7"
"Greene","2020-06-04","18","551","3","65","5.6","3.9"
"Greene","2020-06-05","16","567","2","67","7.4","4.8"
"Greene","2020-06-06","5","572","2","69","13.1","7.7"
"Greene","2020-06-07","8","580","0","69","13.1","7.7"
"Greene","2020-06-08","8","588","2","71","15.6","9.4"
"Greene","2020-06-09","24","612","0","71","14","8.8"
"Greene","2020-06-10","11","623","0","71","13.5","8.8"
"Greene","2020-06-11","36","659","0","71","11.1","8.3"
"Greene","2020-06-12","16","675","0","71","9.3","8.3"
"Greene","2020-06-13","5","680","0","71","3.6","8.3"
"Greene","2020-06-14","4","684","1","72","7.1","10.1"
"Greene","2020-06-15","17","701","0","72","3.6","9.6"
"Greene","2020-06-16","16","717","2","74","5.4","9.7"
"Greene","2020-06-17","6","723","0","74","5.4","9.4"
"Greene","2020-06-18","18","741","2","76","6.9","9"
"Greene","2020-06-19","19","760","0","76","6.9","8.1"
"Greene","2020-06-20","8","768","2","78","10.5","7"
"Greene","2020-06-21","3","771","0","78","6.9","7"
"Greene","2020-06-22","20","791","0","78","6.9","5.3"
"Greene","2020-06-23","20","811","1","79","5.9","5.6"
"Greene","2020-06-24","40","851","4","83","7.3","6.3"
"Greene","2020-06-25","23","874","1","84","6.3","6.6"
"Greene","2020-06-26","15","889","1","85","7.3","7.1"
"Greene","2020-06-27","7","896","5","90","13.9","12.2"
"Greene","2020-06-28","5","901","1","91","16.8","11.9"
"Greene","2020-06-29","24","925","1","92","17.4","12.2"
"Greene","2020-06-30","22","947","1","93","17.3","11.6"
"Greene","2020-07-01","23","970","3","96","17.7","12.5"
"Greene","2020-07-02","23","993","5","101","20.2","13.3"
"Greene","2020-07-03","10","1003","3","104","23.6","15.4"
"Greene","2020-07-04","8","1011","3","107","18.7","16.3"
"Greene","2020-07-05","16","1027","3","110","18.5","17.7"
"Greene","2020-07-06","45","1072","7","117","20.2","18.8"
"Greene","2020-07-07","34","1106","5","122","21.6","19.5"
"Greene","2020-07-08","39","1145","7","129","22.3","20"
"Greene","2020-07-09","27","1172","6","135","22.4","21.3"
"Greene","2020-07-10","24","1196","0","135","18.1","20.8"
"Greene","2020-07-11","11","1207","3","138","16.6","17.7"
"Greene","2020-07-12","7","1214","2","140","18","18.3"
"Greene","2020-07-13","39","1253","11","151","19.8","20"
"Greene","2020-07-14","34","1287","4","155","19.4","20.5"
"Greene","2020-07-15","24","1311","4","159","19.2","20.8"
"Greene","2020-07-16","24","1335","2","161","17.3","19.8"
"Greene","2020-07-17","28","1363","3","164","18.8","18.4"
"Greene","2020-07-18","14","1377","5","169","20","18.3"
"Greene","2020-07-19","30","1407","2","171","16.9","17.5"
"Greene","2020-07-20","34","1441","3","174","14.1","17"
"Greene","2020-07-21","21","1462","5","179","15.8","17.6"
"Greene","2020-07-22","32","1494","12","191","18.8","19"
"Greene","2020-07-23","42","1536","11","202","21.3","19.3"
"Greene","2020-07-24","16","1552","2","204","21.6","20.2"
"Greene","2020-07-25","50","1602","6","210","18.2","19.1"
"Greene","2020-07-26","14","1616","4","214","21.3","19.1"
"Greene","2020-07-27","31","1647","4","218","21.9","18"
"Greene","2020-07-28","21","1668","4","222","21.2","18.5"
"Greene","2020-07-29","21","1689","8","230","21.3","20.1"
"Greene","2020-07-30","25","1714","4","234","19.9","20.6"
"Greene","2020-07-31","17","1731","7","241","24","22.8"
"Greene","2020-08-01","47","1778","7","248","24.4","21.3"
"Greene","2020-08-02","19","1797","8","256","26.3","23.8"
"Greene","2020-08-03","33","1830","8","264","27.9","24.9"
"Greene","2020-08-04","12","1842","5","269","31.2","26.2"
"Greene","2020-08-05","37","1879","9","278","29.2","25.3"
"Greene","2020-08-06","18","1897","4","282","30.1","25"
"Greene","2020-08-07","36","1933","8","290","27.4","25.7"
"Greene","2020-08-08","39","1972","3","293","26.4","25.4"
"Greene","2020-08-09","17","1989","2","295","22","24.2"
"Greene","2020-08-10","50","2039","9","304","21.1","24.5"
"Greene","2020-08-11","28","2067","8","312","19.3","25.2"
"Greene","2020-08-12","21","2088","4","316","18.5","23.9"
"Greene","2020-08-13","39","2127","8","324","18.3","24.2"
"Greene","2020-08-14","32","2159","2","326","16","21.7"
"Greene","2020-08-15","17","2176","2","328","16.6","21.5"
"Greene","2020-08-16","15","2191","2","330","16.8","19.4"
"Greene","2020-08-17","24","2215","6","336","17.8","19.5"
"Greene","2020-08-18","23","2238","4","340","16.2","17.7"
"Greene","2020-08-19","16","2254","4","344","17","17.8"
"Greene","2020-08-20","19","2273","4","348","17.1","17.7"
"Greene","2020-08-21","51","2324","2","350","16.8","16.4"
"Greene","2020-08-22","20","2344","5","355","18.7","17.6"
"Greene","2020-08-23","9","2353","0","355","16.8","16.8"
"Greene","2020-08-24","26","2379","4","359","15.4","16.6"
"Greene","2020-08-25","8","2387","1","360","14.7","15.4"
"Greene","2020-08-26","17","2404","3","363","13.6","15.3"
"Greene","2020-08-27","11","2415","2","365","13.2","15.2"
"Greene","2020-08-28","29","2444","1","366","13.2","15"
"Greene","2020-08-29","12","2456","1","367","10.8","14.7"
"Greene","2020-08-30","9","2465","2","369","14","15.4"
"Greene","2020-08-31","23","2488","6","375","15.5","15.4"
"Greene","2020-09-01","24","2512","4","379","16.1","15.4"
"Greene","2020-09-02","15","2527","1","380","14.5","14.1"
"Greene","2020-09-03","24","2551","4","384","14.3","13.8"
"Greene","2020-09-04","49","2600","4","388","15","14.1"
"Greene","2020-09-05","17","2617","1","389","14.6","12.7"
"Greene","2020-09-06","9","2626","0","389","11.4","12.7"
"Greene","2020-09-07","15","2641","3","392","10.6","13"
"Greene","2020-09-08","37","2678","2","394","9","12.5"
"Greene","2020-09-09","26","2704","1","395","8.6","11.5"
"Greene","2020-09-10","34","2738","3","398","7.4","10.9"
"Greene","2020-09-11","42","2780","3","401","7.3","11.1"
"Greene","2020-09-12","7","2787","1","402","8.5","11.6"
"Greene","2020-09-13","9","2796","0","402","8.5","10"
"Greene","2020-09-14","28","2824","2","404","6.7","8.6"
"Greene","2020-09-15","32","2856","1","405","6.3","7.7"
"Greene","2020-09-16","26","2882","1","406","6.3","7.5"
"Greene","2020-09-17","32","2914","1","407","5.5","6.5"
"Greene","2020-09-18","70","2984","0","407","4.5","5.9"
"Greene","2020-09-19","19","3003","0","407","2.5","5.5"
"Greene","2020-09-20","8","3011","1","408","4.2","6.4"
"Greene","2020-09-21","36","3047","0","408","3.2","4.9"
"Greene","2020-09-22","15","3062","1","409","3.7","5"
"Greene","2020-09-23","29","3091","0","409","3.2","4.8"
"Greene","2020-09-24","12","3103","0","409","2.7","4.1"
"Greene","2020-09-25","26","3129","2","411","3.8","4.2"
"Greene","2020-09-26","4","3133","2","413","11","6.7"
"Greene","2020-09-27","5","3138","0","413","9.2","6.7"
"Greene","2020-09-28","11","3149","1","414","10.5","6.9"
"Greene","2020-09-29","28","3177","0","414","9.5","6.6"
"Greene","2020-09-30","31","3208","0","414","9.5","6.4"
"Greene","2020-10-01","18","3226","2","416","11.1","6.9"
"Greene","2020-10-02","40","3266","2","418","10.7","7.3"
"Greene","2020-10-03","55","3321","1","419","3.9","7.4"
"Greene","2020-10-04","9","3330","1","420","5.4","7.3"
"Greene","2020-10-05","33","3363","3","423","5.4","8"
"Greene","2020-10-06","57","3420","1","424","5.7","7.6"
"Greene","2020-10-07","31","3451","0","424","5.7","7.6"
"Greene","2020-10-08","45","3496","2","426","4.7","7.9"
"Greene","2020-10-09","26","3522","1","427","4.6","7.7"
"Greene","2020-10-10","43","3565","1","428","4.7","4.3"
"Greene","2020-10-11","7","3572","3","431","9.2","7.3"
"Greene","2020-10-12","39","3611","2","433","8.6","7"
"Greene","2020-10-13","26","3637","1","434","8.9","7.3"
"Greene","2020-10-14","18","3655","0","434","8.9","7.3"
"Greene","2020-10-15","19","3674","0","434","8.3","6.5"
"Greene","2020-10-16","57","3731","0","434","7.7","6.2"
"Greene","2020-10-17","4","3735","0","434","7.4","6"
"Greene","2020-10-18","6","3741","0","434","1.3","5.2"
"Greene","2020-10-19","19","3760","3","437","2.8","5.7"
"Greene","2020-10-20","26","3786","2","439","3.4","6.1"
"Greene","2020-10-21","40","3826","3","442","4.4","6.7"
"Greene","2020-10-22","37","3863","1","443","4.8","6.5"
"Greene","2020-10-23","15","3878","1","444","5.8","6.8"
"Greene","2020-10-24","19","3897","2","446","7.3","7.3"
"Greene","2020-10-25","8","3905","2","448","10.8","6.1"
"Greene","2020-10-26","34","3939","1","449","9","5.9"
"Greene","2020-10-27","22","3961","1","450","8.6","6"
"Greene","2020-10-28","22","3983","0","450","7.5","6"
"Greene","2020-10-29","18","4001","3","453","9.5","7.1"
"Greene","2020-10-30","46","4047","4","457","9.8","7.8"
"Greene","2020-10-31","32","4079","2","459","9.2","8.2"
"Greene","2020-11-01","18","4097","2","461","7.2","9"
"Greene","2020-11-02","25","4122","2","463","7.9","8.4"
"Greene","2020-11-03","26","4148","3","466","8.9","8.7"
"Greene","2020-11-04","64","4212","1","467","9.1","8.3"
"Greene","2020-11-05","11","4223","0","467","6.7","8.1"
"Greene","2020-11-06","25","4248","0","467","5.5","7.6"
"Greene","2020-11-07","17","4265","3","470","7.1","8.1"
"Greene","2020-11-08","6","4271","0","470","5.5","6.4"
"Greene","2020-11-09","34","4305","4","474","6.1","7"
"Greene","2020-11-10","41","4346","3","477","5.5","7.2"
"Greene","2020-11-11","43","4389","1","478","5.6","7.3"
"Greene","2020-11-12","18","4407","1","479","6.4","6.6"
"Greene","2020-11-13","36","4443","0","479","6.4","5.9"
"Greene","2020-11-14","30","4473","0","479","3.9","5.5"
"Greene","2020-11-15","15","4488","1","480","4.8","5.2"
"Greene","2020-11-16","79","4567","10","490","4.9","5.5"
"Greene","2020-11-17","47","4614","2","492","4.5","5"
"Greene","2020-11-18","52","4666","5","497","5.5","5.6"
"Greene","2020-11-19","70","4736","1","498","4.9","5.7"
"Greene","2020-11-20","104","4840","5","503","5.6","6"
"Greene","2020-11-21","20","4860","1","504","6.3","5.1"
"Greene","2020-11-22","10","4870","2","506","8.3","6.5"
"Greene","2020-11-23","158","5028","11","517","7.4","6.2"
"Greene","2020-11-24","77","5105","8","525","8.3","6.4"
"Greene","2020-11-25","84","5189","9","534","8.5","7"
"Greene","2020-11-26","5","5194","0","534","8.3","6.6"
"Greene","2020-11-27","44","5238","1","535","7.9","6.8"
"Greene","2020-11-28","19","5257","5","540","11","8.6"
"Greene","2020-11-29","16","5273","3","543","10.8","9.5"
"Greene","2020-11-30","83","5356","5","548","10.6","9"
"Greene","2020-12-01","43","5399","9","557","12.1","10.2"
"Greene","2020-12-02","47","5446","7","564","12.7","10.6"
"Greene","2020-12-03","60","5506","11","575","15.4","11.8"
"Greene","2020-12-04","77","5583","8","583","16.5","12.2"
"Greene","2020-12-05","25","5608","3","586","14.5","12.7"
"Greene","2020-12-06","18","5626","2","588","13.4","12.1"
"Greene","2020-12-07","52","5678","9","597","15","12.8"
"Greene","2020-12-08","54","5732","6","603","13.6","12.9"
"Greene","2020-12-09","44","5776","4","607","12.8","12.8"
"Greene","2020-12-10","35","5811","5","612","12.2","13.8"
"Greene","2020-12-11","30","5841","4","616","12.6","14.6"
"Greene","2020-12-12","62","5903","12","628","13.7","14.1"
"Greene","2020-12-13","31","5934","5","633","14.4","13.9"
"Greene","2020-12-14","104","6038","14","647","13.8","14.4"
"Greene","2020-12-15","126","6164","30","677","15.6","14.6"
"Greene","2020-12-16","71","6235","9","686","16.2","14.5"
"Greene","2020-12-17","44","6279","8","694","16.7","14.4"
"Greene","2020-12-18","63","6342","13","707","17.7","15.2"
"Greene","2020-12-19","50","6392","8","715","17.3","15.5"
"Greene","2020-12-20","29","6421","5","720","17.4","15.9"
"Greene","2020-12-21","84","6505","27","747","20.1","17"
"Greene","2020-12-22","59","6564","13","760","19.8","17.7"
"Greene","2020-12-23","72","6636","23","783","22.6","19.4"
"Greene","2020-12-24","77","6713","11","794","22","19.4"
"Greene","2020-12-25","7","6720","4","798","27.3","22.5"
"Greene","2020-12-26","46","6766","12","810","28.7","23"
"Greene","2020-12-27","44","6810","18","828","32.1","24.8"
"Greene","2020-12-28","68","6878","18","846","31.3","25.7"
"Greene","2020-12-29","55","6933","14","860","31.8","25.8"
"Greene","2020-12-30","51","6984","11","871","30.3","26.4"
"Greene","2020-12-31","41","7025","14","885","33.1","27.6"
"Greene","2021-01-01","9","7034","5","890","32.9","30.1"
"Greene","2021-01-02","18","7052","9","899","36.3","32.5"
"Greene","2021-01-03","42","7094","7","906","32.8","32.5"
"Greene","2021-01-04","39","7133","11","917","33.1","32.2"
"Greene","2021-01-05","64","7197","16","933","33","32.4"
"Greene","2021-01-06","70","7267","13","946","32.6","31.4"
"Greene","2021-01-07","79","7346","14","960","30.2","31.7"
"Greene","2021-01-08","65","7411","14","974","25.4","29.1"
"Greene","2021-01-09","43","7454","19","993","24.6","30.4"
"Greene","2021-01-10","27","7481","6","999","25.3","29.1"
"Greene","2021-01-11","62","7543","14","1013","24.5","28.8"
"Greene","2021-01-12","103","7646","19","1032","23.6","28.3"
"Greene","2021-01-13","74","7720","17","1049","24.2","28.4"
"Greene","2021-01-14","50","7770","13","1062","25.4","27.8"
"Greene","2021-01-15","51","7821","7","1069","24.3","24.8"
"Greene","2021-01-16","44","7865","12","1081","21.9","23.2"
"Greene","2021-01-17","19","7884","4","1085","21.7","23.5"
"Greene","2021-01-18","67","7951","9","1094","20.4","22.5"
"Greene","2021-01-19","54","8005","10","1104","20.4","22"
"Greene","2021-01-20","48","8053","8","1112","19.5","21.9"
"Greene","2021-01-21","42","8095","8","1120","18.5","22"
"Greene","2021-01-22","71","8166","15","1135","19.6","21.9"
"Greene","2021-01-23","51","8217","11","1146","18.8","20.3"
"Greene","2021-01-24","12","8229","3","1149","19.3","20.5"
"Greene","2021-01-25","30","8259","7","1156","20.8","20.6"
"Greene","2021-01-26","13","8272","4","1160","22.5","21.5"
"Greene","2021-01-27","0","8272","0","1160","20.1","19.8"
"Gwinnett","2020-02-01","0","0","0","0",".","."
"Gwinnett","2020-02-02","0","0","0","0",".","."
"Gwinnett","2020-02-03","0","0","0","0",".","."
"Gwinnett","2020-02-04","0","0","0","0",".","."
"Gwinnett","2020-02-05","0","0","0","0",".","."
"Gwinnett","2020-02-06","0","0","0","0",".","."
"Gwinnett","2020-02-07","0","0","0","0","0","."
"Gwinnett","2020-02-08","0","0","0","0","0","."
"Gwinnett","2020-02-09","0","0","0","0","0","."
"Gwinnett","2020-02-10","0","0","0","0","0","."
"Gwinnett","2020-02-11","0","0","0","0","0","."
"Gwinnett","2020-02-12","0","0","0","0","0","."
"Gwinnett","2020-02-13","0","0","0","0","0","."
"Gwinnett","2020-02-14","0","0","0","0","0","0"
"Gwinnett","2020-02-15","0","0","0","0","0","0"
"Gwinnett","2020-02-16","0","0","0","0","0","0"
"Gwinnett","2020-02-17","0","0","0","0","0","0"
"Gwinnett","2020-02-18","0","0","0","0","0","0"
"Gwinnett","2020-02-19","0","0","0","0","0","0"
"Gwinnett","2020-02-20","0","0","0","0","0","0"
"Gwinnett","2020-02-21","0","0","0","0","0","0"
"Gwinnett","2020-02-22","0","0","0","0","0","0"
"Gwinnett","2020-02-23","0","0","0","0","0","0"
"Gwinnett","2020-02-24","0","0","0","0","0","0"
"Gwinnett","2020-02-25","1","1","0","0","0","0"
"Gwinnett","2020-02-26","0","1","0","0","0","0"
"Gwinnett","2020-02-27","0","1","0","0","0","0"
"Gwinnett","2020-02-28","0","1","0","0","0","0"
"Gwinnett","2020-02-29","0","1","0","0","0","0"
"Gwinnett","2020-03-01","0","1","0","0","0","0"
"Gwinnett","2020-03-02","0","1","0","0","0","0"
"Gwinnett","2020-03-03","0","1","0","0","0","0"
"Gwinnett","2020-03-04","4","5","2","2","7.1","3.6"
"Gwinnett","2020-03-05","0","5","0","2","7.1","3.6"
"Gwinnett","2020-03-06","2","7","0","2","7.1","3.6"
"Gwinnett","2020-03-07","6","13","4","6","16.7","8.3"
"Gwinnett","2020-03-08","0","13","0","6","16.7","8.3"
"Gwinnett","2020-03-09","8","21","0","6","16.7","8.3"
"Gwinnett","2020-03-10","11","32","1","7","18","9"
"Gwinnett","2020-03-11","9","41","0","7","10.8","9"
"Gwinnett","2020-03-12","35","76","4","11","12.5","9.8"
"Gwinnett","2020-03-13","31","107","2","13","13.4","10.3"
"Gwinnett","2020-03-14","25","132","3","16","5.6","11.1"
"Gwinnett","2020-03-15","15","147","1","17","6.5","11.6"
"Gwinnett","2020-03-16","89","236","6","23","7.5","12.1"
"Gwinnett","2020-03-17","135","371","16","39","7.9","12.9"
"Gwinnett","2020-03-18","155","526","17","56","9.4","10.1"
"Gwinnett","2020-03-19","128","654","18","74","9.8","11.1"
"Gwinnett","2020-03-20","152","806","16","90","10.4","11.9"
"Gwinnett","2020-03-21","54","860","12","102","11.9","8.7"
"Gwinnett","2020-03-22","20","880","3","105","13.1","9.8"
"Gwinnett","2020-03-23","188","1068","22","127","13.8","10.6"
"Gwinnett","2020-03-24","134","1202","26","153","14.8","11.4"
"Gwinnett","2020-03-25","126","1328","19","172","15.4","12.4"
"Gwinnett","2020-03-26","148","1476","19","191","15.3","12.5"
"Gwinnett","2020-03-27","163","1639","21","212","15.6","13"
"Gwinnett","2020-03-28","30","1669","10","222","17.2","14.5"
"Gwinnett","2020-03-29","33","1702","7","229","18.1","15.6"
"Gwinnett","2020-03-30","178","1880","34","263","19.1","16.4"
"Gwinnett","2020-03-31","144","2024","32","295","19.5","17.2"
"Gwinnett","2020-04-01","151","2175","31","326","20.3","17.9"
"Gwinnett","2020-04-02","143","2318","22","348","20.7","18"
"Gwinnett","2020-04-03","164","2482","22","370","20.7","18.2"
"Gwinnett","2020-04-04","47","2529","3","373","16.9","17"
"Gwinnett","2020-04-05","23","2552","1","374","14.5","16.3"
"Gwinnett","2020-04-06","229","2781","40","414","14.2","16.7"
"Gwinnett","2020-04-07","241","3022","31","445","12.9","16.2"
"Gwinnett","2020-04-08","274","3296","45","490","12.3","16.3"
"Gwinnett","2020-04-09","295","3591","55","545","12.8","16.7"
"Gwinnett","2020-04-10","289","3880","46","591","13.1","16.9"
"Gwinnett","2020-04-11","178","4058","23","614","14.1","15.5"
"Gwinnett","2020-04-12","76","4134","23","637","17.8","16.1"
"Gwinnett","2020-04-13","322","4456","67","704","18.3","16.3"
"Gwinnett","2020-04-14","399","4855","52","756","18.3","15.6"
"Gwinnett","2020-04-15","406","5261","75","831","18.6","15.5"
"Gwinnett","2020-04-16","335","5596","52","883","18.1","15.5"
"Gwinnett","2020-04-17","507","6103","82","965","18.2","15.7"
"Gwinnett","2020-04-18","273","6376","55","1020","19.2","16.6"
"Gwinnett","2020-04-19","127","6503","33","1053","18.6","18.2"
"Gwinnett","2020-04-20","821","7324","84","1137","17.1","17.7"
"Gwinnett","2020-04-21","577","7901","117","1254","18.1","18.2"
"Gwinnett","2020-04-22","1125","9026","137","1391","17.2","17.9"
"Gwinnett","2020-04-23","460","9486","88","1479","17.7","17.9"
"Gwinnett","2020-04-24","612","10098","80","1559","17.3","17.7"
"Gwinnett","2020-04-25","311","10409","42","1601","16.3","17.8"
"Gwinnett","2020-04-26","180","10589","22","1623","14.4","16.5"
"Gwinnett","2020-04-27","737","11326","77","1700","14.4","15.7"
"Gwinnett","2020-04-28","618","11944","100","1800","13.8","16"
"Gwinnett","2020-04-29","609","12553","76","1876","13.9","15.5"
"Gwinnett","2020-04-30","990","13543","87","1963","12.4","15.1"
"Gwinnett","2020-05-01","800","14343","90","2053","12.1","14.7"
"Gwinnett","2020-05-02","409","14752","40","2093","11.6","14"
"Gwinnett","2020-05-03","189","14941","43","2136","13.1","13.7"
"Gwinnett","2020-05-04","677","15618","111","2247","13.9","14.2"
"Gwinnett","2020-05-05","672","16290","93","2340","13.6","13.7"
"Gwinnett","2020-05-06","674","16964","89","2429","13.7","13.8"
"Gwinnett","2020-05-07","737","17701","55","2484","13.5","13"
"Gwinnett","2020-05-08","1562","19263","87","2571","12.7","12.4"
"Gwinnett","2020-05-09","335","19598","51","2622","13.5","12.5"
"Gwinnett","2020-05-10","221","19819","24","2646","11.8","12.4"
"Gwinnett","2020-05-11","822","20641","69","2715","10.7","12.3"
"Gwinnett","2020-05-12","881","21522","66","2781","9.7","11.7"
"Gwinnett","2020-05-13","907","22429","82","2863","9.1","11.4"
"Gwinnett","2020-05-14","1020","23449","91","2954","9.4","11.4"
"Gwinnett","2020-05-15","1157","24606","88","3042","9.6","11.2"
"Gwinnett","2020-05-16","658","25264","59","3101","8.8","11.1"
"Gwinnett","2020-05-17","308","25572","30","3131","8.6","10.2"
"Gwinnett","2020-05-18","1167","26739","102","3233","8.6","9.6"
"Gwinnett","2020-05-19","1156","27895","97","3330","8.8","9.3"
"Gwinnett","2020-05-20","1194","29089","119","3449","8.9","9"
"Gwinnett","2020-05-21","1254","30343","86","3535","8.6","9"
"Gwinnett","2020-05-22","1394","31737","132","3667","8.9","9.3"
"Gwinnett","2020-05-23","997","32734","84","3751","8.8","8.8"
"Gwinnett","2020-05-24","646","33380","51","3802","8.5","8.6"
"Gwinnett","2020-05-25","684","34064","36","3838","8","8.3"
"Gwinnett","2020-05-26","1716","35780","151","3989","8.1","8.4"
"Gwinnett","2020-05-27","1733","37513","163","4152","8","8.5"
"Gwinnett","2020-05-28","1572","39085","111","4263","8","8.3"
"Gwinnett","2020-05-29","1434","40519","112","4375","7.8","8.3"
"Gwinnett","2020-05-30","941","41460","80","4455","7.8","8.3"
"Gwinnett","2020-05-31","506","41966","39","4494","7.8","8.2"
"Gwinnett","2020-06-01","1550","43516","142","4636","8.3","8.2"
"Gwinnett","2020-06-02","1646","45162","165","4801","8.5","8.3"
"Gwinnett","2020-06-03","1713","46875","129","4930","8.3","8.1"
"Gwinnett","2020-06-04","1690","48565","148","5078","8.5","8.3"
"Gwinnett","2020-06-05","1286","49851","123","5201","8.7","8.3"
"Gwinnett","2020-06-06","1046","50897","113","5314","9.1","8.4"
"Gwinnett","2020-06-07","555","51452","71","5385","9.8","8.8"
"Gwinnett","2020-06-08","1611","53063","171","5556","10","9.2"
"Gwinnett","2020-06-09","1546","54609","139","5695","9.9","9.2"
"Gwinnett","2020-06-10","1846","56455","165","5860","10.1","9.2"
"Gwinnett","2020-06-11","1772","58227","183","6043","10.3","9.4"
"Gwinnett","2020-06-12","1701","59928","146","6189","10.2","9.4"
"Gwinnett","2020-06-13","1141","61069","151","6340","10.5","9.8"
"Gwinnett","2020-06-14","661","61730","99","6439","10.8","10.3"
"Gwinnett","2020-06-15","2060","63790","266","6705","11.1","10.6"
"Gwinnett","2020-06-16","1733","65523","219","6924","11.7","10.8"
"Gwinnett","2020-06-17","1751","67274","288","7212","12.7","11.4"
"Gwinnett","2020-06-18","1616","68890","253","7465","13.5","11.9"
"Gwinnett","2020-06-19","1806","70696","260","7725","14.3","12.2"
"Gwinnett","2020-06-20","907","71603","196","7921","15.5","13"
"Gwinnett","2020-06-21","399","72002","100","8021","17","13.9"
"Gwinnett","2020-06-22","2266","74268","415","8436","17.7","14.4"
"Gwinnett","2020-06-23","1729","75997","325","8761","18.6","15.1"
"Gwinnett","2020-06-24","1670","77667","296","9057","18.8","15.8"
"Gwinnett","2020-06-25","2080","79747","389","9446","19.2","16.4"
"Gwinnett","2020-06-26","1932","81679","335","9781","19.6","17"
"Gwinnett","2020-06-27","1197","82876","210","9991","19.1","17.3"
"Gwinnett","2020-06-28","516","83392","81","10072","17.7","17.3"
"Gwinnett","2020-06-29","2194","85586","307","10379","17.1","17.4"
"Gwinnett","2020-06-30","2172","87758","342","10721","16.7","17.6"
"Gwinnett","2020-07-01","2078","89836","326","11047","16.4","17.6"
"Gwinnett","2020-07-02","2355","92191","345","11392","15.8","17.5"
"Gwinnett","2020-07-03","1247","93438","212","11604","15.8","17.7"
"Gwinnett","2020-07-04","614","94052","110","11714","15.8","17.4"
"Gwinnett","2020-07-05","676","94728","135","11849","16.4","17.1"
"Gwinnett","2020-07-06","2421","97149","444","12293","17","17.1"
"Gwinnett","2020-07-07","2626","99775","409","12702","17","16.8"
"Gwinnett","2020-07-08","2496","102271","363","13065","16.9","16.6"
"Gwinnett","2020-07-09","2458","104729","356","13421","16.8","16.3"
"Gwinnett","2020-07-10","2332","107061","343","13764","16.5","16.1"
"Gwinnett","2020-07-11","1107","108168","225","13989","16.8","16.3"
"Gwinnett","2020-07-12","375","108543","70","14059","16.7","16.5"
"Gwinnett","2020-07-13","2512","111055","313","14372","15.8","16.4"
"Gwinnett","2020-07-14","2132","113187","317","14689","15.7","16.4"
"Gwinnett","2020-07-15","2340","115527","304","14993","15.5","16.2"
"Gwinnett","2020-07-16","2805","118332","389","15382","15.4","16.1"
"Gwinnett","2020-07-17","2195","120527","272","15654","15.1","15.8"
"Gwinnett","2020-07-18","1348","121875","187","15841","14.2","15.5"
"Gwinnett","2020-07-19","547","122422","97","15938","14","15.3"
"Gwinnett","2020-07-20","2432","124854","306","16244","14","14.9"
"Gwinnett","2020-07-21","2167","127021","282","16526","13.8","14.8"
"Gwinnett","2020-07-22","2398","129419","283","16809","13.6","14.6"
"Gwinnett","2020-07-23","2198","131617","280","17089","13.4","14.4"
"Gwinnett","2020-07-24","2029","133646","242","17331","13.4","14.2"
"Gwinnett","2020-07-25","1279","134925","172","17503","13.3","13.7"
"Gwinnett","2020-07-26","445","135370","43","17546","12.2","13.1"
"Gwinnett","2020-07-27","2243","137613","269","17815","12.1","13.1"
"Gwinnett","2020-07-28","1904","139517","230","18045","12","12.9"
"Gwinnett","2020-07-29","2039","141556","238","18283","11.9","12.8"
"Gwinnett","2020-07-30","2234","143790","256","18539","11.7","12.6"
"Gwinnett","2020-07-31","2077","145867","186","18725","11.3","12.4"
"Gwinnett","2020-08-01","1493","147360","160","18885","10.9","12.1"
"Gwinnett","2020-08-02","563","147923","76","18961","11.5","11.8"
"Gwinnett","2020-08-03","2096","150019","207","19168","11.2","11.6"
"Gwinnett","2020-08-04","1936","151955","210","19378","11","11.5"
"Gwinnett","2020-08-05","1928","153883","197","19575","10.8","11.4"
"Gwinnett","2020-08-06","2059","155942","219","19794","10.7","11.2"
"Gwinnett","2020-08-07","1831","157773","170","19964","10.7","11"
"Gwinnett","2020-08-08","1163","158936","104","20068","10.5","10.7"
"Gwinnett","2020-08-09","612","159548","54","20122","9.8","10.6"
"Gwinnett","2020-08-10","2250","161798","223","20345","9.8","10.5"
"Gwinnett","2020-08-11","1723","163521","162","20507","9.6","10.3"
"Gwinnett","2020-08-12","1799","165320","161","20668","9.4","10.1"
"Gwinnett","2020-08-13","1674","166994","127","20795","9","9.8"
"Gwinnett","2020-08-14","2021","169015","158","20953","8.8","9.8"
"Gwinnett","2020-08-15","1211","170226","114","21067","8.8","9.7"
"Gwinnett","2020-08-16","594","170820","68","21135","9.2","9.5"
"Gwinnett","2020-08-17","1809","172629","153","21288","9","9.4"
"Gwinnett","2020-08-18","1798","174427","154","21442","8.9","9.2"
"Gwinnett","2020-08-19","1760","176187","126","21568","8.6","9"
"Gwinnett","2020-08-20","1846","178033","136","21704","8.6","8.8"
"Gwinnett","2020-08-21","1785","179818","151","21855","8.7","8.7"
"Gwinnett","2020-08-22","1275","181093","85","21940","8.3","8.6"
"Gwinnett","2020-08-23","487","181580","36","21976","7.7","8.5"
"Gwinnett","2020-08-24","1742","183322","125","22101","7.5","8.3"
"Gwinnett","2020-08-25","1585","184907","111","22212","7.3","8.1"
"Gwinnett","2020-08-26","1602","186509","130","22342","7.5","8"
"Gwinnett","2020-08-27","1720","188229","112","22454","7.3","8"
"Gwinnett","2020-08-28","1712","189941","106","22560","7","7.9"
"Gwinnett","2020-08-29","1186","191127","75","22635","7","7.6"
"Gwinnett","2020-08-30","592","191719","35","22670","6.7","7.2"
"Gwinnett","2020-08-31","1814","193533","113","22783","6.6","7.1"
"Gwinnett","2020-09-01","1684","195217","105","22888","6.5","6.9"
"Gwinnett","2020-09-02","1664","196881","118","23006","6.4","6.9"
"Gwinnett","2020-09-03","1746","198627","105","23111","6.3","6.8"
"Gwinnett","2020-09-04","1756","200383","115","23226","6.3","6.7"
"Gwinnett","2020-09-05","980","201363","64","23290","6.4","6.7"
"Gwinnett","2020-09-06","473","201836","32","23322","6.5","6.6"
"Gwinnett","2020-09-07","706","202542","55","23377","6.7","6.7"
"Gwinnett","2020-09-08","1902","204444","120","23497","6.7","6.6"
"Gwinnett","2020-09-09","1634","206078","107","23604","6.6","6.5"
"Gwinnett","2020-09-10","1948","208026","129","23733","6.7","6.5"
"Gwinnett","2020-09-11","1717","209743","94","23827","6.6","6.5"
"Gwinnett","2020-09-12","1035","210778","49","23876","6.3","6.3"
"Gwinnett","2020-09-13","336","211114","23","23899","6.3","6.4"
"Gwinnett","2020-09-14","1796","212910","94","23993","6","6.3"
"Gwinnett","2020-09-15","1485","214395","75","24068","5.8","6.3"
"Gwinnett","2020-09-16","1574","215969","79","24147","5.6","6.1"
"Gwinnett","2020-09-17","1280","217249","70","24217","5.4","6.1"
"Gwinnett","2020-09-18","1222","218471","60","24277","5.3","6"
"Gwinnett","2020-09-19","1271","219742","72","24349","5.5","5.9"
"Gwinnett","2020-09-20","292","220034","22","24371","5.6","5.9"
"Gwinnett","2020-09-21","1805","221839","80","24451","5.4","5.7"
"Gwinnett","2020-09-22","1548","223387","80","24531","5.5","5.6"
"Gwinnett","2020-09-23","1738","225125","79","24610","5.4","5.5"
"Gwinnett","2020-09-24","1887","227012","81","24691","5.2","5.3"
"Gwinnett","2020-09-25","1714","228726","83","24774","5.2","5.3"
"Gwinnett","2020-09-26","870","229596","69","24843","5.5","5.5"
"Gwinnett","2020-09-27","578","230174","40","24883","5.4","5.5"
"Gwinnett","2020-09-28","1872","232046","75","24958","5.4","5.4"
"Gwinnett","2020-09-29","1405","233451","80","25038","5.5","5.5"
"Gwinnett","2020-09-30","1851","235302","100","25138","5.6","5.5"
"Gwinnett","2020-10-01","2183","237485","96","25234","5.6","5.4"
"Gwinnett","2020-10-02","1804","239289","80","25314","5.5","5.4"
"Gwinnett","2020-10-03","1471","240760","50","25364","4.9","5.2"
"Gwinnett","2020-10-04","578","241338","37","25401","4.8","5.1"
"Gwinnett","2020-10-05","1737","243075","99","25500","5.1","5.2"
"Gwinnett","2020-10-06","2121","245196","85","25585","4.8","5.1"
"Gwinnett","2020-10-07","2188","247384","113","25698","4.8","5.2"
"Gwinnett","2020-10-08","2114","249498","102","25800","4.8","5.2"
"Gwinnett","2020-10-09","1955","251453","94","25894","4.9","5.2"
"Gwinnett","2020-10-10","1490","252943","64","25958","5","5"
"Gwinnett","2020-10-11","425","253368","41","25999","5.5","5.2"
"Gwinnett","2020-10-12","1796","255164","75","26074","5.3","5.2"
"Gwinnett","2020-10-13","2061","257225","118","26192","5.5","5.2"
"Gwinnett","2020-10-14","1958","259183","102","26294","5.5","5.2"
"Gwinnett","2020-10-15","2393","261576","152","26446","5.7","5.3"
"Gwinnett","2020-10-16","2026","263602","116","26562","5.9","5.4"
"Gwinnett","2020-10-17","1516","265118","68","26630","5.9","5.5"
"Gwinnett","2020-10-18","596","265714","62","26692","6","5.8"
"Gwinnett","2020-10-19","2121","267835","90","26782","6","5.6"
"Gwinnett","2020-10-20","2102","269937","129","26911","6.1","5.8"
"Gwinnett","2020-10-21","2764","272701","149","27060","6.1","5.8"
"Gwinnett","2020-10-22","2040","274741","120","27180","6","5.9"
"Gwinnett","2020-10-23","1829","276570","130","27310","6.2","6.1"
"Gwinnett","2020-10-24","1609","278179","99","27409","6.5","6.2"
"Gwinnett","2020-10-25","793","278972","75","27484","6.3","6.2"
"Gwinnett","2020-10-26","2116","281088","134","27618","6.6","6.3"
"Gwinnett","2020-10-27","2435","283523","138","27756","6.6","6.3"
"Gwinnett","2020-10-28","2730","286253","155","27911","6.6","6.4"
"Gwinnett","2020-10-29","1975","288228","145","28056","6.8","6.4"
"Gwinnett","2020-10-30","2167","290395","153","28209","6.8","6.5"
"Gwinnett","2020-10-31","1693","292088","134","28343","7.1","6.8"
"Gwinnett","2020-11-01","698","292786","71","28414","7.2","6.8"
"Gwinnett","2020-11-02","2656","295442","148","28562","7.1","6.8"
"Gwinnett","2020-11-03","2137","297579","182","28744","7.5","7"
"Gwinnett","2020-11-04","2134","299713","148","28892","7.6","7.1"
"Gwinnett","2020-11-05","2713","302426","186","29078","7.6","7.2"
"Gwinnett","2020-11-06","2675","305101","193","29271","7.6","7.2"
"Gwinnett","2020-11-07","1829","306930","161","29432","7.7","7.4"
"Gwinnett","2020-11-08","805","307735","106","29538","8.2","7.7"
"Gwinnett","2020-11-09","2711","310446","245","29783","8.6","7.9"
"Gwinnett","2020-11-10","2943","313389","241","30024","8.6","8"
"Gwinnett","2020-11-11","2375","315764","199","30223","8.8","8.2"
"Gwinnett","2020-11-12","2938","318702","255","30478","9.1","8.3"
"Gwinnett","2020-11-13","3097","321799","259","30737","9.2","8.4"
"Gwinnett","2020-11-14","1471","323270","164","30901","9.6","8.6"
"Gwinnett","2020-11-15","1003","324273","118","31019","9.4","8.8"
"Gwinnett","2020-11-16","3262","327535","264","31283","9.2","8.9"
"Gwinnett","2020-11-17","2918","330453","238","31521","9.2","8.9"
"Gwinnett","2020-11-18","2968","333421","209","31730","9","8.9"
"Gwinnett","2020-11-19","3484","336905","259","31989","8.9","9"
"Gwinnett","2020-11-20","3409","340314","297","32286","8.9","9.1"
"Gwinnett","2020-11-21","2237","342551","189","32475","8.5","9"
"Gwinnett","2020-11-22","1280","343831","108","32583","8","8.7"
"Gwinnett","2020-11-23","3429","347260","296","32879","8.1","8.7"
"Gwinnett","2020-11-24","3108","350368","350","33229","8.6","8.9"
"Gwinnett","2020-11-25","3326","353694","319","33548","8.9","9"
"Gwinnett","2020-11-26","405","354099","45","33593","9.5","9.2"
"Gwinnett","2020-11-27","2650","356749","412","34005","10.4","9.7"
"Gwinnett","2020-11-28","1812","358561","332","34337","11.8","10.2"
"Gwinnett","2020-11-29","1236","359797","245","34582","13.5","10.8"
"Gwinnett","2020-11-30","4195","363992","589","35171","14.2","11.2"
"Gwinnett","2020-12-01","4058","368050","594","35765","14.7","11.6"
"Gwinnett","2020-12-02","3495","371545","480","36245","15.3","12.1"
"Gwinnett","2020-12-03","4016","375561","545","36790","15.7","12.6"
"Gwinnett","2020-12-04","3940","379501","553","37343","15.5","12.9"
"Gwinnett","2020-12-05","2218","381719","343","37686","15","13.4"
"Gwinnett","2020-12-06","1286","383005","249","37935","15","14.2"
"Gwinnett","2020-12-07","4286","387291","639","38574","15.1","14.7"
"Gwinnett","2020-12-08","4011","391302","667","39241","15.4","15.1"
"Gwinnett","2020-12-09","4065","395367","568","39809","15.4","15.4"
"Gwinnett","2020-12-10","4466","399833","693","40502","15.7","15.7"
"Gwinnett","2020-12-11","4068","403901","684","41186","16.1","15.8"
"Gwinnett","2020-12-12","3098","406999","526","41712","16.3","15.7"
"Gwinnett","2020-12-13","1486","408485","316","42028","16.6","15.8"
"Gwinnett","2020-12-14","4692","413177","778","42806","16.8","16"
"Gwinnett","2020-12-15","4691","417868","761","43567","16.8","16.1"
"Gwinnett","2020-12-16","3779","421647","582","44149","17","16.2"
"Gwinnett","2020-12-17","5011","426658","910","45059","17.3","16.5"
"Gwinnett","2020-12-18","4913","431571","812","45871","17.3","16.7"
"Gwinnett","2020-12-19","3476","435047","632","46503","17.5","16.9"
"Gwinnett","2020-12-20","1950","436997","511","47014","18.2","17.4"
"Gwinnett","2020-12-21","5118","442115","982","47996","18.6","17.7"
"Gwinnett","2020-12-22","4732","446847","895","48891","18.9","17.9"
"Gwinnett","2020-12-23","3937","450784","669","49560","19.2","18.1"
"Gwinnett","2020-12-24","3072","453856","538","50098","19.1","18.2"
"Gwinnett","2020-12-25","374","454230","69","50167","19.3","18.3"
"Gwinnett","2020-12-26","2799","457029","757","50924","20.6","19"
"Gwinnett","2020-12-27","1923","458952","558","51482","21","19.6"
"Gwinnett","2020-12-28","4961","463913","1078","52560","21.4","20"
"Gwinnett","2020-12-29","4868","468781","1232","53792","22.3","20.6"
"Gwinnett","2020-12-30","3836","472617","859","54651","23.1","21.1"
"Gwinnett","2020-12-31","3320","475937","608","55259","23.2","21.1"
"Gwinnett","2021-01-01","866","476803","218","55477","24.1","21.7"
"Gwinnett","2021-01-02","2980","479783","772","56249","24","22.3"
"Gwinnett","2021-01-03","1091","480874","279","56528","23.5","22.3"
"Gwinnett","2021-01-04","5181","486055","1229","57757","23.8","22.6"
"Gwinnett","2021-01-05","6129","492184","1438","59195","23.5","22.9"
"Gwinnett","2021-01-06","4005","496189","841","60036","23.3","23.2"
"Gwinnett","2021-01-07","5906","502095","1483","61519","24.3","23.7"
"Gwinnett","2021-01-08","4671","506766","1062","62581","23.9","24"
"Gwinnett","2021-01-09","3361","510127","878","63459","24","24"
"Gwinnett","2021-01-10","1971","512098","516","63975","24","23.8"
"Gwinnett","2021-01-11","4927","517025","1105","65080","23.9","23.8"
"Gwinnett","2021-01-12","4605","521630","933","66013","23.4","23.5"
"Gwinnett","2021-01-13","3367","524997","479","66492","22.4","22.9"
"Gwinnett","2021-01-14","4418","529415","966","67458","22","23.1"
"Gwinnett","2021-01-15","4297","533712","888","68346","21.7","22.8"
"Gwinnett","2021-01-16","2427","536139","644","68990","21.7","22.8"
"Gwinnett","2021-01-17","1774","537913","520","69510","22.2","23.1"
"Gwinnett","2021-01-18","3848","541761","732","70242","21.7","22.8"
"Gwinnett","2021-01-19","4094","545855","719","70961","21.3","22.4"
"Gwinnett","2021-01-20","3199","549054","442","71403","21.3","21.8"
"Gwinnett","2021-01-21","4116","553170","739","72142","20.7","21.3"
"Gwinnett","2021-01-22","4017","557187","662","72804","20.1","20.9"
"Gwinnett","2021-01-23","2102","559289","494","73298","19.7","20.7"
"Gwinnett","2021-01-24","1453","560742","367","73665","19.1","20.6"
"Gwinnett","2021-01-25","1955","562697","344","74009","18.9","20.3"
"Gwinnett","2021-01-26","31","562728","3","74012","17.8","19.5"
"Gwinnett","2021-01-27","0","562728","0","74012","15.8","18.5"
"Habersham","2020-02-01","0","0","0","0",".","."
"Habersham","2020-02-02","0","0","0","0",".","."
"Habersham","2020-02-03","0","0","0","0",".","."
"Habersham","2020-02-04","0","0","0","0",".","."
"Habersham","2020-02-05","0","0","0","0",".","."
"Habersham","2020-02-06","0","0","0","0",".","."
"Habersham","2020-02-07","0","0","0","0","0","."
"Habersham","2020-02-08","0","0","0","0","0","."
"Habersham","2020-02-09","0","0","0","0","0","."
"Habersham","2020-02-10","0","0","0","0","0","."
"Habersham","2020-02-11","0","0","0","0","0","."
"Habersham","2020-02-12","0","0","0","0","0","."
"Habersham","2020-02-13","0","0","0","0","0","."
"Habersham","2020-02-14","0","0","0","0","0","0"
"Habersham","2020-02-15","0","0","0","0","0","0"
"Habersham","2020-02-16","0","0","0","0","0","0"
"Habersham","2020-02-17","0","0","0","0","0","0"
"Habersham","2020-02-18","0","0","0","0","0","0"
"Habersham","2020-02-19","0","0","0","0","0","0"
"Habersham","2020-02-20","0","0","0","0","0","0"
"Habersham","2020-02-21","0","0","0","0","0","0"
"Habersham","2020-02-22","0","0","0","0","0","0"
"Habersham","2020-02-23","0","0","0","0","0","0"
"Habersham","2020-02-24","0","0","0","0","0","0"
"Habersham","2020-02-25","0","0","0","0","0","0"
"Habersham","2020-02-26","0","0","0","0","0","0"
"Habersham","2020-02-27","0","0","0","0","0","0"
"Habersham","2020-02-28","0","0","0","0","0","0"
"Habersham","2020-02-29","0","0","0","0","0","0"
"Habersham","2020-03-01","0","0","0","0","0","0"
"Habersham","2020-03-02","0","0","0","0","0","0"
"Habersham","2020-03-03","0","0","0","0","0","0"
"Habersham","2020-03-04","0","0","0","0","0","0"
"Habersham","2020-03-05","0","0","0","0","0","0"
"Habersham","2020-03-06","0","0","0","0","0","0"
"Habersham","2020-03-07","0","0","0","0","0","0"
"Habersham","2020-03-08","0","0","0","0","0","0"
"Habersham","2020-03-09","0","0","0","0","0","0"
"Habersham","2020-03-10","1","1","0","0","0","0"
"Habersham","2020-03-11","1","2","0","0","0","0"
"Habersham","2020-03-12","1","3","0","0","0","0"
"Habersham","2020-03-13","0","3","0","0","0","0"
"Habersham","2020-03-14","0","3","0","0","0","0"
"Habersham","2020-03-15","0","3","0","0","0","0"
"Habersham","2020-03-16","4","7","0","0","0","0"
"Habersham","2020-03-17","4","11","0","0","0","0"
"Habersham","2020-03-18","9","20","0","0","0","0"
"Habersham","2020-03-19","14","34","0","0","0","0"
"Habersham","2020-03-20","6","40","0","0","0","0"
"Habersham","2020-03-21","7","47","0","0","0","0"
"Habersham","2020-03-22","10","57","0","0","0","0"
"Habersham","2020-03-23","12","69","0","0","0","0"
"Habersham","2020-03-24","10","79","0","0","0","0"
"Habersham","2020-03-25","8","87","0","0","0","0"
"Habersham","2020-03-26","4","91","0","0","0","0"
"Habersham","2020-03-27","2","93","0","0","0","0"
"Habersham","2020-03-28","0","93","0","0","0","0"
"Habersham","2020-03-29","0","93","0","0","0","0"
"Habersham","2020-03-30","3","96","0","0","0","0"
"Habersham","2020-03-31","5","101","0","0","0","0"
"Habersham","2020-04-01","3","104","0","0","0","0"
"Habersham","2020-04-02","1","105","0","0","0","0"
"Habersham","2020-04-03","5","110","0","0","0","0"
"Habersham","2020-04-04","0","110","0","0","0","0"
"Habersham","2020-04-05","0","110","0","0","0","0"
"Habersham","2020-04-06","3","113","1","1","4.8","2.4"
"Habersham","2020-04-07","3","116","0","1","4.8","2.4"
"Habersham","2020-04-08","4","120","0","1","4.8","2.4"
"Habersham","2020-04-09","1","121","1","2","19","9.5"
"Habersham","2020-04-10","8","129","1","3","20.8","10.4"
"Habersham","2020-04-11","0","129","0","3","20.8","10.4"
"Habersham","2020-04-12","0","129","0","3","20.8","10.4"
"Habersham","2020-04-13","3","132","1","4","20.8","12.8"
"Habersham","2020-04-14","12","144","3","7","24.4","14.6"
"Habersham","2020-04-15","5","149","3","10","33","18.9"
"Habersham","2020-04-16","17","166","8","18","25.4","22.2"
"Habersham","2020-04-17","21","187","11","29","31.1","26"
"Habersham","2020-04-18","2","189","1","30","38.3","29.5"
"Habersham","2020-04-19","0","189","0","30","38.3","29.5"
"Habersham","2020-04-20","18","207","2","32","35.1","28"
"Habersham","2020-04-21","13","220","3","35","34.8","29.6"
"Habersham","2020-04-22","19","239","1","36","27","30"
"Habersham","2020-04-23","15","254","5","41","25","25.2"
"Habersham","2020-04-24","17","271","2","43","19.2","25.2"
"Habersham","2020-04-25","2","273","0","43","12.1","25.2"
"Habersham","2020-04-26","2","275","1","44","19.2","28.7"
"Habersham","2020-04-27","18","293","2","46","19.2","27.2"
"Habersham","2020-04-28","62","355","10","56","18.2","26.5"
"Habersham","2020-04-29","247","602","49","105","20.3","23.6"
"Habersham","2020-04-30","279","881","56","161","18.4","21.7"
"Habersham","2020-05-01","22","903","3","164","18.7","19"
"Habersham","2020-05-02","8","911","0","164","18.7","15.4"
"Habersham","2020-05-03","17","928","0","164","11.5","15.4"
"Habersham","2020-05-04","11","939","0","164","10","14.6"
"Habersham","2020-05-05","28","967","0","164","7.6","12.9"
"Habersham","2020-05-06","15","982","1","165","5.8","13"
"Habersham","2020-05-07","23","1005","1","166","3.5","11"
"Habersham","2020-05-08","35","1040","1","167","2","10.3"
"Habersham","2020-05-09","8","1048","0","167","2","10.3"
"Habersham","2020-05-10","0","1048","0","167","2","6.8"
"Habersham","2020-05-11","20","1068","3","170","4.1","7"
"Habersham","2020-05-12","17","1085","2","172","5.8","6.7"
"Habersham","2020-05-13","13","1098","3","175","8.1","7"
"Habersham","2020-05-14","17","1115","4","179","10.9","7.2"
"Habersham","2020-05-15","111","1226","84","263","21.3","11.6"
"Habersham","2020-05-16","9","1235","0","263","21.3","11.6"
"Habersham","2020-05-17","9","1244","0","263","21.3","11.6"
"Habersham","2020-05-18","45","1289","1","264","19.5","11.8"
"Habersham","2020-05-19","71","1360","7","271","19.2","12.5"
"Habersham","2020-05-20","49","1409","4","275","17.1","12.6"
"Habersham","2020-05-21","55","1464","8","283","15.8","13.3"
"Habersham","2020-05-22","61","1525","8","291","6.8","14.1"
"Habersham","2020-05-23","13","1538","1","292","7.9","14.6"
"Habersham","2020-05-24","2","1540","1","293","15.1","18.2"
"Habersham","2020-05-25","1","1541","0","293","14.8","17.1"
"Habersham","2020-05-26","22","1563","4","297","16","17.6"
"Habersham","2020-05-27","15","1578","4","301","18.6","17.8"
"Habersham","2020-05-28","31","1609","2","303","17.4","16.6"
"Habersham","2020-05-29","14","1623","0","303","15.6","11.2"
"Habersham","2020-05-30","9","1632","1","304","16.1","12"
"Habersham","2020-05-31","5","1637","1","305","11.8","13.4"
"Habersham","2020-06-01","18","1655","2","307","13.4","14.1"
"Habersham","2020-06-02","25","1680","1","308","11.3","13.6"
"Habersham","2020-06-03","30","1710","6","314","10.4","14.5"
"Habersham","2020-06-04","26","1736","7","321","13.3","15.4"
"Habersham","2020-06-05","16","1752","4","325","16.9","16.2"
"Habersham","2020-06-06","16","1768","2","327","17.1","16.6"
"Habersham","2020-06-07","5","1773","3","330","22.8","17.3"
"Habersham","2020-06-08","70","1843","19","349","25.1","19.2"
"Habersham","2020-06-09","39","1882","1","350","24.9","18.1"
"Habersham","2020-06-10","15","1897","7","357","28.7","19.5"
"Habersham","2020-06-11","20","1917","4","361","27.7","20.5"
"Habersham","2020-06-12","24","1941","4","365","26.5","21.7"
"Habersham","2020-06-13","10","1951","0","365","24.7","20.9"
"Habersham","2020-06-14","3","1954","0","365","16.1","19.5"
"Habersham","2020-06-15","68","2022","7","372","13.7","19.4"
"Habersham","2020-06-16","25","2047","2","374","14.5","19.7"
"Habersham","2020-06-17","23","2070","8","382","12.8","20.8"
"Habersham","2020-06-18","29","2099","4","386","11.9","19.8"
"Habersham","2020-06-19","28","2127","4","390","11.6","19"
"Habersham","2020-06-20","19","2146","1","391","12.3","18.5"
"Habersham","2020-06-21","2","2148","0","391","12.3","14.2"
"Habersham","2020-06-22","25","2173","4","395","13.2","13.5"
"Habersham","2020-06-23","28","2201","0","395","12","13.3"
"Habersham","2020-06-24","32","2233","12","407","12.4","12.6"
"Habersham","2020-06-25","62","2295","25","432","16.2","14.1"
"Habersham","2020-06-26","18","2313","6","438","18.9","15.3"
"Habersham","2020-06-27","21","2334","6","444","22.2","17.3"
"Habersham","2020-06-28","25","2359","8","452","26.8","19.6"
"Habersham","2020-06-29","50","2409","14","466","28.5","20.8"
"Habersham","2020-06-30","42","2451","7","473","30.9","21.5"
"Habersham","2020-07-01","22","2473","3","476","27.5","20"
"Habersham","2020-07-02","33","2506","2","478","22.6","19.4"
"Habersham","2020-07-03","34","2540","6","484","20.4","19.6"
"Habersham","2020-07-04","26","2566","3","487","17.9","20.1"
"Habersham","2020-07-05","26","2592","3","490","15","20.9"
"Habersham","2020-07-06","41","2633","6","496","13.1","20.8"
"Habersham","2020-07-07","65","2698","8","504","12.5","21.7"
"Habersham","2020-07-08","62","2760","14","518","13.8","20.6"
"Habersham","2020-07-09","67","2827","11","529","15.2","18.9"
"Habersham","2020-07-10","34","2861","9","538","16.5","18.4"
"Habersham","2020-07-11","49","2910","22","560","21.3","19.6"
"Habersham","2020-07-12","48","2958","13","573","23.5","19.2"
"Habersham","2020-07-13","28","2986","13","586","28","20.6"
"Habersham","2020-07-14","59","3045","12","598","29.2","20.8"
"Habersham","2020-07-15","106","3151","18","616","28.4","21.1"
"Habersham","2020-07-16","65","3216","15","631","29.3","22.3"
"Habersham","2020-07-17","60","3276","9","640","27.7","22.1"
"Habersham","2020-07-18","22","3298","3","643","23.2","22.2"
"Habersham","2020-07-19","29","3327","4","647","21.3","22.4"
"Habersham","2020-07-20","48","3375","9","656","17.4","22.7"
"Habersham","2020-07-21","88","3463","25","681","18.5","23.8"
"Habersham","2020-07-22","64","3527","10","691","18.3","23.4"
"Habersham","2020-07-23","67","3594","14","705","18","23.7"
"Habersham","2020-07-24","64","3658","24","729","21.2","24.5"
"Habersham","2020-07-25","39","3697","14","743","24.4","23.8"
"Habersham","2020-07-26","25","3722","6","749","25.9","23.6"
"Habersham","2020-07-27","42","3764","15","764","28.3","22.8"
"Habersham","2020-07-28","74","3838","16","780","27.3","22.9"
"Habersham","2020-07-29","93","3931","23","803","28.6","23.5"
"Habersham","2020-07-30","70","4001","15","818","28.7","23.4"
"Habersham","2020-07-31","60","4061","9","827","25.5","23.4"
"Habersham","2020-08-01","41","4102","12","839","24.5","24.5"
"Habersham","2020-08-02","11","4113","4","843","26.3","26.1"
"Habersham","2020-08-03","27","4140","10","853","26.5","27.4"
"Habersham","2020-08-04","67","4207","12","865","26","26.6"
"Habersham","2020-08-05","83","4290","16","881","25.2","26.9"
"Habersham","2020-08-06","52","4342","2","883","22.7","25.7"
"Habersham","2020-08-07","61","4403","12","895","23.3","24.4"
"Habersham","2020-08-08","11","4414","1","896","20.5","22.5"
"Habersham","2020-08-09","30","4444","6","902","18.1","22.2"
"Habersham","2020-08-10","46","4490","9","911","15.6","21.1"
"Habersham","2020-08-11","52","4542","8","919","15.3","20.6"
"Habersham","2020-08-12","60","4602","9","928","14.7","19.9"
"Habersham","2020-08-13","48","4650","3","931","15","18.8"
"Habersham","2020-08-14","26","4676","2","933","13.3","18.3"
"Habersham","2020-08-15","12","4688","1","934","13.2","16.8"
"Habersham","2020-08-16","30","4718","6","940","13.2","15.6"
"Habersham","2020-08-17","36","4754","2","942","11.2","13.4"
"Habersham","2020-08-18","50","4804","8","950","11.3","13.3"
"Habersham","2020-08-19","106","4910","11","961","10.6","12.6"
"Habersham","2020-08-20","37","4947","2","963","10.5","12.7"
"Habersham","2020-08-21","46","4993","2","965","10","11.6"
"Habersham","2020-08-22","61","5054","6","971","10.2","11.7"
"Habersham","2020-08-23","15","5069","1","972","8.3","10.7"
"Habersham","2020-08-24","42","5111","8","980","10.2","10.7"
"Habersham","2020-08-25","32","5143","3","983","9.3","10.3"
"Habersham","2020-08-26","126","5269","11","994","9.1","9.8"
"Habersham","2020-08-27","70","5339","9","1003","10.1","10.3"
"Habersham","2020-08-28","57","5396","4","1007","10.5","10.3"
"Habersham","2020-08-29","86","5482","13","1020","11.3","10.7"
"Habersham","2020-08-30","54","5536","4","1024","11.4","9.8"
"Habersham","2020-08-31","53","5589","7","1031","10.5","10.4"
"Habersham","2020-09-01","50","5639","6","1037","10.9","10.1"
"Habersham","2020-09-02","74","5713","5","1042","10.6","9.8"
"Habersham","2020-09-03","58","5771","5","1047","10","10.1"
"Habersham","2020-09-04","66","5837","2","1049","9.4","10"
"Habersham","2020-09-05","93","5930","6","1055","8.2","9.7"
"Habersham","2020-09-06","38","5968","6","1061","9.4","10.4"
"Habersham","2020-09-07","27","5995","4","1065","9.6","10.1"
"Habersham","2020-09-08","52","6047","7","1072","9.8","10.4"
"Habersham","2020-09-09","71","6118","17","1089","12.3","11.5"
"Habersham","2020-09-10","59","6177","9","1098","13.2","11.6"
"Habersham","2020-09-11","83","6260","16","1114","15.6","12.5"
"Habersham","2020-09-12","65","6325","11","1125","17.1","12.6"
"Habersham","2020-09-13","25","6350","3","1128","16.5","13"
"Habersham","2020-09-14","80","6430","18","1146","17.6","13.6"
"Habersham","2020-09-15","68","6498","10","1156","17.8","13.8"
"Habersham","2020-09-16","87","6585","7","1163","15.5","13.9"
"Habersham","2020-09-17","49","6634","8","1171","15.7","14.5"
"Habersham","2020-09-18","84","6718","12","1183","15","15.3"
"Habersham","2020-09-19","78","6796","10","1193","14.4","15.7"
"Habersham","2020-09-20","12","6808","3","1196","16.2","16.4"
"Habersham","2020-09-21","72","6880","13","1209","15.6","16.6"
"Habersham","2020-09-22","92","6972","20","1229","16.6","17.2"
"Habersham","2020-09-23","86","7058","15","1244","18","16.7"
"Habersham","2020-09-24","45","7103","9","1253","18.5","17.1"
"Habersham","2020-09-25","60","7163","10","1263","18.8","16.9"
"Habersham","2020-09-26","90","7253","13","1276","19","16.7"
"Habersham","2020-09-27","16","7269","2","1278","17.3","16.8"
"Habersham","2020-09-28","85","7354","17","1295","17.5","16.6"
"Habersham","2020-09-29","79","7433","15","1310","17.1","16.9"
"Habersham","2020-09-30","68","7501","17","1327","18.2","18.1"
"Habersham","2020-10-01","82","7583","16","1343","18.2","18.3"
"Habersham","2020-10-02","79","7662","17","1360","18.9","18.8"
"Habersham","2020-10-03","77","7739","8","1368","18.3","18.7"
"Habersham","2020-10-04","30","7769","6","1374","19.3","18.3"
"Habersham","2020-10-05","87","7856","10","1384","18.1","17.8"
"Habersham","2020-10-06","102","7958","10","1394","16.8","17"
"Habersham","2020-10-07","118","8076","7","1401","14.1","16.2"
"Habersham","2020-10-08","64","8140","9","1410","13.3","15.7"
"Habersham","2020-10-09","85","8225","2","1412","10.6","14.7"
"Habersham","2020-10-10","56","8281","3","1415","9.9","14.1"
"Habersham","2020-10-11","8","8289","3","1418","12.4","15.9"
"Habersham","2020-10-12","47","8336","5","1423","12.2","15.2"
"Habersham","2020-10-13","88","8424","4","1427","11.5","14.2"
"Habersham","2020-10-14","45","8469","4","1431","11.9","13"
"Habersham","2020-10-15","57","8526","6","1437","11.4","12.4"
"Habersham","2020-10-16","40","8566","0","1437","11.1","10.8"
"Habersham","2020-10-17","44","8610","5","1442","11.9","10.9"
"Habersham","2020-10-18","8","8618","1","1443","8.4","10.4"
"Habersham","2020-10-19","46","8664","10","1453","9.9","11.1"
"Habersham","2020-10-20","59","8723","4","1457","10.3","10.9"
"Habersham","2020-10-21","95","8818","8","1465","10.2","11"
"Habersham","2020-10-22","58","8876","5","1470","9.9","10.7"
"Habersham","2020-10-23","42","8918","2","1472","10.6","10.8"
"Habersham","2020-10-24","40","8958","5","1477","10.8","11.3"
"Habersham","2020-10-25","16","8974","3","1480","11.7","10"
"Habersham","2020-10-26","54","9028","4","1484","9.6","9.8"
"Habersham","2020-10-27","44","9072","5","1489","10.3","10.3"
"Habersham","2020-10-28","53","9125","4","1493","10.1","10.2"
"Habersham","2020-10-29","44","9169","9","1502","11.8","10.9"
"Habersham","2020-10-30","37","9206","3","1505","12.3","11.5"
"Habersham","2020-10-31","17","9223","3","1508","13","11.9"
"Habersham","2020-11-01","17","9240","1","1509","11.2","11.4"
"Habersham","2020-11-02","61","9301","8","1517","12","10.8"
"Habersham","2020-11-03","52","9353","0","1517","10.4","10.3"
"Habersham","2020-11-04","49","9402","5","1522","10.8","10.5"
"Habersham","2020-11-05","43","9445","3","1525","8.8","10.3"
"Habersham","2020-11-06","44","9489","6","1531","9.6","11"
"Habersham","2020-11-07","16","9505","3","1534","9.8","11.4"
"Habersham","2020-11-08","16","9521","3","1537","11.6","11.4"
"Habersham","2020-11-09","76","9597","17","1554","13","12.5"
"Habersham","2020-11-10","88","9685","30","1584","17.8","14.1"
"Habersham","2020-11-11","74","9759","13","1597","18.9","14.8"
"Habersham","2020-11-12","63","9822","15","1612","21.3","15.1"
"Habersham","2020-11-13","70","9892","13","1625","22","15.8"
"Habersham","2020-11-14","46","9938","11","1636","22.7","16.3"
"Habersham","2020-11-15","19","9957","3","1639","22.3","17"
"Habersham","2020-11-16","112","10069","37","1676","23.8","18.4"
"Habersham","2020-11-17","94","10163","14","1690","21.1","19.5"
"Habersham","2020-11-18","113","10276","22","1712","21.4","20.1"
"Habersham","2020-11-19","120","10396","24","1736","20.8","21"
"Habersham","2020-11-20","90","10486","12","1748","20.1","21"
"Habersham","2020-11-21","40","10526","6","1754","18.8","20.8"
"Habersham","2020-11-22","113","10639","8","1762","17.5","19.9"
"Habersham","2020-11-23","100","10739","19","1781","15.5","19.7"
"Habersham","2020-11-24","178","10917","35","1816","16.2","18.7"
"Habersham","2020-11-25","119","11036","32","1848","17.3","19.3"
"Habersham","2020-11-26","19","11055","2","1850","15.9","18.4"
"Habersham","2020-11-27","88","11143","26","1876","18.2","19.2"
"Habersham","2020-11-28","72","11215","15","1891","19.1","18.9"
"Habersham","2020-11-29","50","11265","22","1913","24.4","20.9"
"Habersham","2020-11-30","137","11402","27","1940","24.5","20"
"Habersham","2020-12-01","222","11624","23","1963","23.1","19.7"
"Habersham","2020-12-02","190","11814","30","1993","21.5","19.4"
"Habersham","2020-12-03","159","11973","22","2015","22","19"
"Habersham","2020-12-04","128","12101","34","2049","21.6","19.9"
"Habersham","2020-12-05","82","12183","20","2069","22.1","20.6"
"Habersham","2020-12-06","49","12232","18","2087","21.1","22.7"
"Habersham","2020-12-07","300","12532","50","2137","20.6","22.5"
"Habersham","2020-12-08","182","12714","21","2158","20.8","22"
"Habersham","2020-12-09","170","12884","29","2187","21","21.3"
"Habersham","2020-12-10","221","13105","26","2213","20.7","21.3"
"Habersham","2020-12-11","104","13209","19","2232","19.5","20.5"
"Habersham","2020-12-12","108","13317","27","2259","19.6","20.8"
"Habersham","2020-12-13","61","13378","16","2275","18.1","19.6"
"Habersham","2020-12-14","264","13642","37","2312","17.7","19.2"
"Habersham","2020-12-15","216","13858","35","2347","18.4","19.6"
"Habersham","2020-12-16","253","14111","40","2387","18.2","19.6"
"Habersham","2020-12-17","127","14238","37","2424","20.7","20.7"
"Habersham","2020-12-18","135","14373","25","2449","20.7","20.1"
"Habersham","2020-12-19","136","14509","25","2474","19.8","19.7"
"Habersham","2020-12-20","60","14569","14","2488","19.3","18.7"
"Habersham","2020-12-21","230","14799","49","2537","20.4","19"
"Habersham","2020-12-22","180","14979","34","2571","20.8","19.6"
"Habersham","2020-12-23","200","15179","57","2628","22.6","20.4"
"Habersham","2020-12-24","148","15327","26","2654","20.9","20.8"
"Habersham","2020-12-25","10","15337","4","2658","24","22.3"
"Habersham","2020-12-26","86","15423","21","2679","24.9","22.3"
"Habersham","2020-12-27","49","15472","18","2697","26.8","23.1"
"Habersham","2020-12-28","172","15644","46","2743","27.6","24"
"Habersham","2020-12-29","272","15916","56","2799","27.8","24.3"
"Habersham","2020-12-30","174","16090","40","2839","27","24.8"
"Habersham","2020-12-31","206","16296","39","2878","27.2","24.1"
"Habersham","2021-01-01","38","16334","9","2887","24.9","24.4"
"Habersham","2021-01-02","22","16356","6","2893","25.3","25.1"
"Habersham","2021-01-03","93","16449","25","2918","23.9","25.3"
"Habersham","2021-01-04","221","16670","38","2956","22.5","25"
"Habersham","2021-01-05","189","16859","60","3016","24.1","25.9"
"Habersham","2021-01-06","243","17102","55","3071","24","25.5"
"Habersham","2021-01-07","199","17301","40","3111","24.2","25.7"
"Habersham","2021-01-08","133","17434","37","3148","24.8","24.8"
"Habersham","2021-01-09","82","17516","20","3168","24.4","24.8"
"Habersham","2021-01-10","115","17631","15","3183","22.4","23.1"
"Habersham","2021-01-11","93","17724","27","3210","24.1","23.3"
"Habersham","2021-01-12","168","17892","31","3241","22.2","23.2"
"Habersham","2021-01-13","195","18087","22","3263","20.6","22.3"
"Habersham","2021-01-14","92","18179","24","3287","21.4","22.8"
"Habersham","2021-01-15","85","18264","14","3301","19.8","22.3"
"Habersham","2021-01-16","58","18322","11","3312","19","21.7"
"Habersham","2021-01-17","23","18345","7","3319","21.5","22"
"Habersham","2021-01-18","79","18424","12","3331","19.6","21.8"
"Habersham","2021-01-19","93","18517","12","3343","18.8","20.5"
"Habersham","2021-01-20","202","18719","16","3359","18.3","19.4"
"Habersham","2021-01-21","76","18795","10","3369","16.4","18.9"
"Habersham","2021-01-22","67","18862","11","3380","16.4","18.1"
"Habersham","2021-01-23","42","18904","4","3384","15.1","17.1"
"Habersham","2021-01-24","8","18912","3","3387","16.1","18.8"
"Habersham","2021-01-25","18","18930","4","3391","17.1","18.3"
"Habersham","2021-01-26","1","18931","0","3391","15.2","17"
"Habersham","2021-01-27","0","18931","0","3391","14.1","16.2"
"Hall","2020-02-01","0","0","0","0",".","."
"Hall","2020-02-02","0","0","0","0",".","."
"Hall","2020-02-03","0","0","0","0",".","."
"Hall","2020-02-04","0","0","0","0",".","."
"Hall","2020-02-05","0","0","0","0",".","."
"Hall","2020-02-06","0","0","0","0",".","."
"Hall","2020-02-07","0","0","0","0","0","."
"Hall","2020-02-08","0","0","0","0","0","."
"Hall","2020-02-09","0","0","0","0","0","."
"Hall","2020-02-10","0","0","0","0","0","."
"Hall","2020-02-11","0","0","0","0","0","."
"Hall","2020-02-12","0","0","0","0","0","."
"Hall","2020-02-13","0","0","0","0","0","."
"Hall","2020-02-14","0","0","0","0","0","0"
"Hall","2020-02-15","0","0","0","0","0","0"
"Hall","2020-02-16","0","0","0","0","0","0"
"Hall","2020-02-17","0","0","0","0","0","0"
"Hall","2020-02-18","0","0","0","0","0","0"
"Hall","2020-02-19","0","0","0","0","0","0"
"Hall","2020-02-20","0","0","0","0","0","0"
"Hall","2020-02-21","0","0","0","0","0","0"
"Hall","2020-02-22","0","0","0","0","0","0"
"Hall","2020-02-23","0","0","0","0","0","0"
"Hall","2020-02-24","0","0","0","0","0","0"
"Hall","2020-02-25","0","0","0","0","0","0"
"Hall","2020-02-26","0","0","0","0","0","0"
"Hall","2020-02-27","0","0","0","0","0","0"
"Hall","2020-02-28","0","0","0","0","0","0"
"Hall","2020-02-29","0","0","0","0","0","0"
"Hall","2020-03-01","0","0","0","0","0","0"
"Hall","2020-03-02","0","0","0","0","0","0"
"Hall","2020-03-03","0","0","0","0","0","0"
"Hall","2020-03-04","0","0","0","0","0","0"
"Hall","2020-03-05","6","6","0","0","0","0"
"Hall","2020-03-06","0","6","0","0","0","0"
"Hall","2020-03-07","0","6","0","0","0","0"
"Hall","2020-03-08","0","6","0","0","0","0"
"Hall","2020-03-09","0","6","0","0","0","0"
"Hall","2020-03-10","3","9","0","0","0","0"
"Hall","2020-03-11","2","11","0","0","0","0"
"Hall","2020-03-12","9","20","0","0","0","0"
"Hall","2020-03-13","8","28","1","1","1.8","0.9"
"Hall","2020-03-14","4","32","0","1","1.8","0.9"
"Hall","2020-03-15","24","56","1","2","2.4","1.2"
"Hall","2020-03-16","41","97","2","4","3.1","1.5"
"Hall","2020-03-17","45","142","2","6","3.7","1.9"
"Hall","2020-03-18","69","211","2","8","4.1","2.1"
"Hall","2020-03-19","88","299","6","14","5.1","2.6"
"Hall","2020-03-20","74","373","6","20","4.5","3.1"
"Hall","2020-03-21","42","415","5","25","6.2","4"
"Hall","2020-03-22","37","452","4","29","7.1","4.8"
"Hall","2020-03-23","53","505","10","39","9.1","6.1"
"Hall","2020-03-24","47","552","3","42","9.4","6.6"
"Hall","2020-03-25","56","608","8","50","11","7.6"
"Hall","2020-03-26","48","656","7","57","12.1","8.6"
"Hall","2020-03-27","23","679","6","63","14.7","9.6"
"Hall","2020-03-28","3","682","1","64","17.8","12"
"Hall","2020-03-29","2","684","0","64","16.2","11.7"
"Hall","2020-03-30","31","715","8","72","17.2","13.2"
"Hall","2020-03-31","21","736","7","79","21.1","15.2"
"Hall","2020-04-01","50","786","13","92","22.7","16.9"
"Hall","2020-04-02","36","822","8","100","23.8","18"
"Hall","2020-04-03","17","839","5","105","24.3","19.5"
"Hall","2020-04-04","2","841","1","106","26.7","22.2"
"Hall","2020-04-05","5","846","0","106","26.7","21.5"
"Hall","2020-04-06","51","897","11","117","26.1","21.6"
"Hall","2020-04-07","24","921","1","118","21.9","21.5"
"Hall","2020-04-08","38","959","9","127","21.6","22.2"
"Hall","2020-04-09","47","1006","9","136","21.1","22.5"
"Hall","2020-04-10","43","1049","13","149","21.3","22.8"
"Hall","2020-04-11","21","1070","5","154","17.5","22.1"
"Hall","2020-04-12","7","1077","1","155","19.6","23.1"
"Hall","2020-04-13","61","1138","15","170","20","23"
"Hall","2020-04-14","68","1206","15","185","22.5","22.2"
"Hall","2020-04-15","76","1282","24","209","23.7","22.6"
"Hall","2020-04-16","73","1355","16","225","24.1","22.6"
"Hall","2020-04-17","106","1461","23","248","22.8","22.1"
"Hall","2020-04-18","65","1526","11","259","21.9","19.7"
"Hall","2020-04-19","16","1542","0","259","19.8","19.7"
"Hall","2020-04-20","109","1651","25","284","19.6","19.8"
"Hall","2020-04-21","132","1783","25","309","19.1","20.8"
"Hall","2020-04-22","167","1950","26","335","16.9","20.3"
"Hall","2020-04-23","142","2092","22","357","15.9","20"
"Hall","2020-04-24","195","2287","26","383","14.7","18.8"
"Hall","2020-04-25","163","2450","10","393","13.2","17.5"
"Hall","2020-04-26","8","2458","1","394","15","17.4"
"Hall","2020-04-27","111","2569","16","410","13.8","16.7"
"Hall","2020-04-28","221","2790","24","434","12.6","15.9"
"Hall","2020-04-29","178","2968","12","446","11.4","14.1"
"Hall","2020-04-30","225","3193","24","470","10.7","13.3"
"Hall","2020-05-01","438","3631","39","509","10","12.4"
"Hall","2020-05-02","206","3837","17","526","10.3","11.8"
"Hall","2020-05-03","57","3894","3","529","9.3","12.1"
"Hall","2020-05-04","176","4070","23","552","9.1","11.4"
"Hall","2020-05-05","239","4309","14","566","8.4","10.5"
"Hall","2020-05-06","202","4511","23","589","9.1","10.2"
"Hall","2020-05-07","192","4703","15","604","8.6","9.7"
"Hall","2020-05-08","251","4954","10","614","7.9","9"
"Hall","2020-05-09","664","5618","28","642","7.4","8.9"
"Hall","2020-05-10","42","5660","2","644","7.3","8.3"
"Hall","2020-05-11","192","5852","12","656","6.3","7.7"
"Hall","2020-05-12","316","6168","13","669","6.1","7.2"
"Hall","2020-05-13","304","6472","12","681","5","7"
"Hall","2020-05-14","253","6725","19","700","5","6.8"
"Hall","2020-05-15","977","7702","60","760","5.3","6.6"
"Hall","2020-05-16","265","7967","16","776","5.5","6.5"
"Hall","2020-05-17","67","8034","9","785","6.8","7"
"Hall","2020-05-18","247","8281","28","813","7.5","6.9"
"Hall","2020-05-19","370","8651","51","864","8.9","7.5"
"Hall","2020-05-20","529","9180","50","914","9.7","7.3"
"Hall","2020-05-21","219","9399","34","948","10.8","7.9"
"Hall","2020-05-22","513","9912","50","998","11.3","8.3"
"Hall","2020-05-23","247","10159","4","1002","10.7","8.1"
"Hall","2020-05-24","89","10248","32","1034","13.9","10.3"
"Hall","2020-05-25","35","10283","5","1039","14.3","10.9"
"Hall","2020-05-26","239","10522","102","1141","18.5","13.7"
"Hall","2020-05-27","540","11062","38","1179","18.1","13.9"
"Hall","2020-05-28","281","11343","44","1223","18.1","14.5"
"Hall","2020-05-29","243","11586","36","1259","18.9","15.1"
"Hall","2020-05-30","350","11936","50","1309","20.7","15.7"
"Hall","2020-05-31","39","11975","7","1316","18.1","16"
"Hall","2020-06-01","223","12198","69","1385","20.5","17.4"
"Hall","2020-06-02","293","12491","30","1415","15.8","17.2"
"Hall","2020-06-03","301","12792","52","1467","17.3","17.7"
"Hall","2020-06-04","383","13175","66","1533","17.5","17.8"
"Hall","2020-06-05","325","13500","49","1582","17.6","18.2"
"Hall","2020-06-06","445","13945","33","1615","16.6","18.6"
"Hall","2020-06-07","93","14038","26","1641","18","18.1"
"Hall","2020-06-08","188","14226","44","1685","16.9","18.7"
"Hall","2020-06-09","250","14476","28","1713","17.1","16.5"
"Hall","2020-06-10","586","15062","71","1784","16.3","16.8"
"Hall","2020-06-11","407","15469","46","1830","15.5","16.5"
"Hall","2020-06-12","250","15719","71","1901","17.4","17.5"
"Hall","2020-06-13","590","16309","59","1960","17.8","17.2"
"Hall","2020-06-14","57","16366","6","1966","15.3","16.6"
"Hall","2020-06-15","319","16685","30","1996","13.3","15.1"
"Hall","2020-06-16","286","16971","25","2021","12.9","15"
"Hall","2020-06-17","636","17607","82","2103","13","14.7"
"Hall","2020-06-18","405","18012","61","2164","13.6","14.5"
"Hall","2020-06-19","266","18278","81","2245","13.9","15.6"
"Hall","2020-06-20","362","18640","29","2274","13.6","15.7"
"Hall","2020-06-21","76","18716","6","2280","13.2","14.2"
"Hall","2020-06-22","518","19234","158","2438","16.2","14.8"
"Hall","2020-06-23","232","19466","14","2452","15.8","14.4"
"Hall","2020-06-24","827","20293","45","2497","14.8","13.9"
"Hall","2020-06-25","807","21100","87","2584","14.2","13.9"
"Hall","2020-06-26","383","21483","47","2631","11.6","12.7"
"Hall","2020-06-27","645","22128","60","2691","11.7","12.7"
"Hall","2020-06-28","130","22258","22","2713","13","13.1"
"Hall","2020-06-29","549","22807","91","2804","11","13.6"
"Hall","2020-06-30","535","23342","80","2884","12.3","14.1"
"Hall","2020-07-01","366","23708","57","2941","13.8","14.3"
"Hall","2020-07-02","658","24366","94","3035","14.3","14.2"
"Hall","2020-07-03","425","24791","89","3124","15.5","13.5"
"Hall","2020-07-04","428","25219","37","3161","15.4","13.6"
"Hall","2020-07-05","264","25483","62","3223","16.4","14.7"
"Hall","2020-07-06","672","26155","103","3326","16.2","13.6"
"Hall","2020-07-07","803","26958","105","3431","15.9","14.1"
"Hall","2020-07-08","1313","28271","344","3775","17.4","15.6"
"Hall","2020-07-09","1432","29703","318","4093","18.6","16.4"
"Hall","2020-07-10","1059","30762","316","4409","19.8","17.7"
"Hall","2020-07-11","999","31761","266","4675","22.4","18.9"
"Hall","2020-07-12","462","32223","179","4854","24.6","20.5"
"Hall","2020-07-13","1768","33991","521","5375","26.6","21.4"
"Hall","2020-07-14","1181","35172","340","5715","28.8","22.4"
"Hall","2020-07-15","1749","36921","384","6099","28.2","22.8"
"Hall","2020-07-16","1630","38551","306","6405","27.7","23.1"
"Hall","2020-07-17","1206","39757","321","6726","27.3","23.6"
"Hall","2020-07-18","705","40462","133","6859","26.2","24.3"
"Hall","2020-07-19","481","40943","98","6957","23.5","24.1"
"Hall","2020-07-20","1608","42551","509","7466","23.9","25.2"
"Hall","2020-07-21","1020","43571","204","7670","22.6","25.7"
"Hall","2020-07-22","1292","44863","310","7980","22.9","25.6"
"Hall","2020-07-23","1397","46260","276","8256","23","25.4"
"Hall","2020-07-24","1047","47307","222","8478","22.3","24.8"
"Hall","2020-07-25","996","48303","210","8688","22.6","24.4"
"Hall","2020-07-26","603","48906","187","8875","24.1","23.8"
"Hall","2020-07-27","1106","50012","302","9177","23.5","23.7"
"Hall","2020-07-28","724","50736","136","9313","23.3","23"
"Hall","2020-07-29","938","51674","233","9546","23.4","23.2"
"Hall","2020-07-30","1339","53013","286","9832","23.7","23.3"
"Hall","2020-07-31","911","53924","204","10036","23.8","23"
"Hall","2020-08-01","1042","54966","182","10218","23.3","22.9"
"Hall","2020-08-02","573","55539","136","10354","22.3","23.2"
"Hall","2020-08-03","529","56068","82","10436","20.6","22"
"Hall","2020-08-04","579","56647","203","10639","22.9","23.1"
"Hall","2020-08-05","706","57353","240","10879","24.2","23.8"
"Hall","2020-08-06","924","58277","195","11074","24.2","23.9"
"Hall","2020-08-07","384","58661","83","11157","24.1","23.9"
"Hall","2020-08-08","263","58924","34","11191","23.4","23.4"
"Hall","2020-08-09","543","59467","129","11320","23.4","22.8"
"Hall","2020-08-10","834","60301","165","11485","24","22.3"
"Hall","2020-08-11","622","60923","131","11616","22","22.5"
"Hall","2020-08-12","488","61411","89","11705","19.8","22"
"Hall","2020-08-13","753","62164","103","11808","18.7","21.5"
"Hall","2020-08-14","439","62603","88","11896","18.5","21.3"
"Hall","2020-08-15","295","62898","40","11936","18.6","21"
"Hall","2020-08-16","477","63375","109","12045","18.5","20.9"
"Hall","2020-08-17","441","63816","82","12127","18.3","21.2"
"Hall","2020-08-18","411","64227","78","12205","18","20"
"Hall","2020-08-19","423","64650","75","12280","17.9","18.9"
"Hall","2020-08-20","997","65647","111","12391","17.6","18.1"
"Hall","2020-08-21","630","66277","77","12468","16.4","17.5"
"Hall","2020-08-22","737","67014","77","12545","16","17.3"
"Hall","2020-08-23","217","67231","54","12599","16.3","17.4"
"Hall","2020-08-24","660","67891","96","12695","15.7","17"
"Hall","2020-08-25","702","68593","73","12768","14.5","16.2"
"Hall","2020-08-26","706","69299","137","12905","14.7","16.3"
"Hall","2020-08-27","1099","70398","107","13012","14.5","16"
"Hall","2020-08-28","696","71094","53","13065","13.9","15.2"
"Hall","2020-08-29","629","71723","32","13097","13.1","14.5"
"Hall","2020-08-30","447","72170","106","13203","12.9","14.6"
"Hall","2020-08-31","573","72743","97","13300","13.3","14.5"
"Hall","2020-09-01","488","73231","78","13378","14.1","14.3"
"Hall","2020-09-02","786","74017","97","13475","13.1","13.9"
"Hall","2020-09-03","719","74736","53","13528","12.7","13.6"
"Hall","2020-09-04","669","75405","31","13559","12.3","13.1"
"Hall","2020-09-05","645","76050","25","13584","12.1","12.6"
"Hall","2020-09-06","285","76335","51","13635","11.3","12.1"
"Hall","2020-09-07","234","76569","36","13671","11.1","12.2"
"Hall","2020-09-08","487","77056","111","13782","12","13.1"
"Hall","2020-09-09","899","77955","64","13846","11.3","12.2"
"Hall","2020-09-10","962","78917","85","13931","11.5","12.1"
"Hall","2020-09-11","701","79618","98","14029","12.8","12.6"
"Hall","2020-09-12","647","80265","69","14098","13.8","13"
"Hall","2020-09-13","136","80401","26","14124","14","12.6"
"Hall","2020-09-14","615","81016","93","14217","13.9","12.5"
"Hall","2020-09-15","805","81821","78","14295","12.1","12.1"
"Hall","2020-09-16","716","82537","60","14355","12.3","11.8"
"Hall","2020-09-17","764","83301","77","14432","12.4","12"
"Hall","2020-09-18","829","84130","63","14495","11.5","12.2"
"Hall","2020-09-19","729","84859","76","14571","11.5","12.6"
"Hall","2020-09-20","192","85051","18","14589","10.1","12"
"Hall","2020-09-21","562","85613","89","14678","10.2","12.1"
"Hall","2020-09-22","869","86482","91","14769","10.3","11.2"
"Hall","2020-09-23","697","87179","128","14897","11.7","12"
"Hall","2020-09-24","793","87972","60","14957","11.4","11.9"
"Hall","2020-09-25","710","88682","76","15033","11.8","11.7"
"Hall","2020-09-26","437","89119","54","15087","12.1","11.8"
"Hall","2020-09-27","109","89228","19","15106","13.2","11.7"
"Hall","2020-09-28","616","89844","68","15174","12.6","11.4"
"Hall","2020-09-29","824","90668","76","15250","12.4","11.3"
"Hall","2020-09-30","757","91425","35","15285","10.4","11.1"
"Hall","2020-10-01","1041","92466","80","15365","10.4","10.9"
"Hall","2020-10-02","532","92998","93","15458","11.4","11.6"
"Hall","2020-10-03","669","93667","83","15541","11.4","11.8"
"Hall","2020-10-04","243","93910","55","15596","12.2","12.7"
"Hall","2020-10-05","613","94523","97","15693","12.8","12.7"
"Hall","2020-10-06","696","95219","55","15748","12.7","12.5"
"Hall","2020-10-07","1026","96245","88","15836","13.2","11.8"
"Hall","2020-10-08","805","97050","60","15896","13.2","11.8"
"Hall","2020-10-09","652","97702","25","15921","11.2","11.3"
"Hall","2020-10-10","758","98460","37","15958","10.2","10.8"
"Hall","2020-10-11","129","98589","23","15981","9.5","10.8"
"Hall","2020-10-12","337","98926","41","16022","8.9","10.9"
"Hall","2020-10-13","663","99589","28","16050","8.4","10.5"
"Hall","2020-10-14","703","100292","39","16089","8","10.6"
"Hall","2020-10-15","770","101062","50","16139","7.9","10.5"
"Hall","2020-10-16","637","101699","31","16170","8","9.6"
"Hall","2020-10-17","526","102225","46","16216","8.6","9.4"
"Hall","2020-10-18","196","102421","18","16234","7.3","8.4"
"Hall","2020-10-19","466","102887","42","16276","6.9","7.9"
"Hall","2020-10-20","563","103450","42","16318","7.3","7.9"
"Hall","2020-10-21","883","104333","37","16355","7.1","7.6"
"Hall","2020-10-22","789","105122","64","16419","7.4","7.6"
"Hall","2020-10-23","614","105736","31","16450","7.4","7.7"
"Hall","2020-10-24","706","106442","45","16495","7.1","7.8"
"Hall","2020-10-25","198","106640","28","16523","7.8","7.5"
"Hall","2020-10-26","414","107054","36","16559","7.7","7.3"
"Hall","2020-10-27","620","107674","45","16604","7.7","7.5"
"Hall","2020-10-28","693","108367","28","16632","7.7","7.4"
"Hall","2020-10-29","550","108917","32","16664","7.3","7.4"
"Hall","2020-10-30","735","109652","58","16722","7.7","7.6"
"Hall","2020-10-31","584","110236","35","16757","7.7","7.4"
"Hall","2020-11-01","234","110470","34","16791","7.7","7.8"
"Hall","2020-11-02","406","110876","65","16856","8.8","8.3"
"Hall","2020-11-03","544","111420","56","16912","9.2","8.5"
"Hall","2020-11-04","704","112124","29","16941","9.2","8.5"
"Hall","2020-11-05","348","112472","54","16995","10.6","9"
"Hall","2020-11-06","657","113129","38","17033","10.3","9"
"Hall","2020-11-07","574","113703","64","17097","11.1","9.4"
"Hall","2020-11-08","152","113855","18","17115","10.7","9.2"
"Hall","2020-11-09","573","114428","89","17204","10.6","9.7"
"Hall","2020-11-10","629","115057","61","17265","10.5","9.9"
"Hall","2020-11-11","1019","116076","70","17335","10.9","10.1"
"Hall","2020-11-12","765","116841","94","17429","10.5","10.5"
"Hall","2020-11-13","500","117341","52","17481","11.1","10.7"
"Hall","2020-11-14","816","118157","69","17550","10.7","10.9"
"Hall","2020-11-15","146","118303","14","17564","10.4","10.5"
"Hall","2020-11-16","607","118910","76","17640","10","10.3"
"Hall","2020-11-17","1051","119961","114","17754","10.1","10.3"
"Hall","2020-11-18","822","120783","71","17825","10.4","10.7"
"Hall","2020-11-19","1123","121906","100","17925","9.9","10.2"
"Hall","2020-11-20","756","122662","78","18003","9.9","10.5"
"Hall","2020-11-21","631","123293","72","18075","10.3","10.5"
"Hall","2020-11-22","266","123559","37","18112","10.9","10.7"
"Hall","2020-11-23","738","124297","112","18224","11.3","10.6"
"Hall","2020-11-24","1197","125494","135","18359","11.4","10.8"
"Hall","2020-11-25","735","126229","95","18454","12","11.2"
"Hall","2020-11-26","394","126623","22","18476","11.5","10.7"
"Hall","2020-11-27","391","127014","63","18539","12.3","11.1"
"Hall","2020-11-28","940","127954","179","18718","13.4","11.9"
"Hall","2020-11-29","377","128331","114","18832","15.8","13.4"
"Hall","2020-11-30","990","129321","212","19044","16.7","14"
"Hall","2020-12-01","1564","130885","232","19276","17.2","14.3"
"Hall","2020-12-02","895","131780","137","19413","17.5","14.7"
"Hall","2020-12-03","1245","133025","238","19651","19.4","15.5"
"Hall","2020-12-04","1010","134035","192","19843","19.9","16.1"
"Hall","2020-12-05","1136","135171","164","20007","19.2","16.3"
"Hall","2020-12-06","453","135624","101","20108","18.1","16.9"
"Hall","2020-12-07","1114","136738","252","20360","18.2","17.4"
"Hall","2020-12-08","1350","138088","226","20586","18.5","17.8"
"Hall","2020-12-09","1005","139093","189","20775","19","18.3"
"Hall","2020-12-10","1271","140364","240","21015","19","19.2"
"Hall","2020-12-11","1189","141553","206","21221","18.7","19.3"
"Hall","2020-12-12","1194","142747","265","21486","19.8","19.5"
"Hall","2020-12-13","546","143293","140","21626","20.3","19.2"
"Hall","2020-12-14","1261","144554","314","21940","20.6","19.4"
"Hall","2020-12-15","1648","146202","311","22251","20.9","19.7"
"Hall","2020-12-16","1169","147371","291","22542","21.8","20.4"
"Hall","2020-12-17","1349","148720","312","22854","22.4","20.7"
"Hall","2020-12-18","1534","150254","314","23168","22.9","20.8"
"Hall","2020-12-19","901","151155","192","23360","22.7","21.3"
"Hall","2020-12-20","452","151607","116","23476","22.7","21.5"
"Hall","2020-12-21","1163","152770","305","23781","22.9","21.8"
"Hall","2020-12-22","1349","154119","309","24090","23.5","22.2"
"Hall","2020-12-23","1331","155450","246","24336","22.6","22.2"
"Hall","2020-12-24","910","156360","193","24529","22.3","22.4"
"Hall","2020-12-25","89","156449","20","24549","22.6","22.7"
"Hall","2020-12-26","764","157213","168","24717","22.7","22.7"
"Hall","2020-12-27","504","157717","173","24890","23.9","23.3"
"Hall","2020-12-28","1063","158780","329","25219","24.6","23.8"
"Hall","2020-12-29","1285","160065","324","25543","24.9","24.2"
"Hall","2020-12-30","1209","161274","306","25849","25.9","24.3"
"Hall","2020-12-31","1241","162515","247","26096","25.7","24"
"Hall","2021-01-01","326","162841","109","26205","27.3","25"
"Hall","2021-01-02","709","163550","142","26347","27","24.9"
"Hall","2021-01-03","779","164329","287","26634","27.4","25.7"
"Hall","2021-01-04","906","165235","242","26876","26.8","25.7"
"Hall","2021-01-05","1557","166792","374","27250","26.6","25.8"
"Hall","2021-01-06","1910","168702","455","27705","26.4","26.2"
"Hall","2021-01-07","1260","169962","341","28046","27.4","26.6"
"Hall","2021-01-08","1202","171164","258","28304","25.7","26.5"
"Hall","2021-01-09","851","172015","194","28498","26.1","26.6"
"Hall","2021-01-10","522","172537","136","28634","24.6","26"
"Hall","2021-01-11","1016","173553","257","28891","24.4","25.6"
"Hall","2021-01-12","1083","174636","213","29104","23.7","25.2"
"Hall","2021-01-13","1191","175827","277","29381","23.7","25"
"Hall","2021-01-14","897","176724","161","29542","22.4","24.9"
"Hall","2021-01-15","1372","178096","252","29794","21.9","23.8"
"Hall","2021-01-16","659","178755","130","29924","21.5","23.8"
"Hall","2021-01-17","452","179207","125","30049","21.7","23.1"
"Hall","2021-01-18","671","179878","143","30192","21.1","22.7"
"Hall","2021-01-19","1182","181060","163","30355","20.3","22"
"Hall","2021-01-20","895","181955","113","30468","18.8","21.2"
"Hall","2021-01-21","845","182800","133","30601","18.5","20.4"
"Hall","2021-01-22","1074","183874","168","30769","18.1","20"
"Hall","2021-01-23","485","184359","76","30845","17.5","19.5"
"Hall","2021-01-24","200","184559","45","30890","16.8","19.2"
"Hall","2021-01-25","428","184987","71","30961","16.1","18.6"
"Hall","2021-01-26","5","184992","0","30961","14.1","17.2"
"Hall","2021-01-27","0","184992","0","30961","12.3","15.5"
"Hancock","2020-02-01","0","0","0","0",".","."
"Hancock","2020-02-02","0","0","0","0",".","."
"Hancock","2020-02-03","0","0","0","0",".","."
"Hancock","2020-02-04","0","0","0","0",".","."
"Hancock","2020-02-05","0","0","0","0",".","."
"Hancock","2020-02-06","0","0","0","0",".","."
"Hancock","2020-02-07","0","0","0","0","0","."
"Hancock","2020-02-08","0","0","0","0","0","."
"Hancock","2020-02-09","0","0","0","0","0","."
"Hancock","2020-02-10","0","0","0","0","0","."
"Hancock","2020-02-11","0","0","0","0","0","."
"Hancock","2020-02-12","0","0","0","0","0","."
"Hancock","2020-02-13","0","0","0","0","0","."
"Hancock","2020-02-14","0","0","0","0","0","0"
"Hancock","2020-02-15","0","0","0","0","0","0"
"Hancock","2020-02-16","0","0","0","0","0","0"
"Hancock","2020-02-17","0","0","0","0","0","0"
"Hancock","2020-02-18","0","0","0","0","0","0"
"Hancock","2020-02-19","0","0","0","0","0","0"
"Hancock","2020-02-20","0","0","0","0","0","0"
"Hancock","2020-02-21","0","0","0","0","0","0"
"Hancock","2020-02-22","0","0","0","0","0","0"
"Hancock","2020-02-23","0","0","0","0","0","0"
"Hancock","2020-02-24","0","0","0","0","0","0"
"Hancock","2020-02-25","0","0","0","0","0","0"
"Hancock","2020-02-26","0","0","0","0","0","0"
"Hancock","2020-02-27","0","0","0","0","0","0"
"Hancock","2020-02-28","0","0","0","0","0","0"
"Hancock","2020-02-29","0","0","0","0","0","0"
"Hancock","2020-03-01","0","0","0","0","0","0"
"Hancock","2020-03-02","0","0","0","0","0","0"
"Hancock","2020-03-03","0","0","0","0","0","0"
"Hancock","2020-03-04","0","0","0","0","0","0"
"Hancock","2020-03-05","0","0","0","0","0","0"
"Hancock","2020-03-06","0","0","0","0","0","0"
"Hancock","2020-03-07","0","0","0","0","0","0"
"Hancock","2020-03-08","0","0","0","0","0","0"
"Hancock","2020-03-09","0","0","0","0","0","0"
"Hancock","2020-03-10","0","0","0","0","0","0"
"Hancock","2020-03-11","0","0","0","0","0","0"
"Hancock","2020-03-12","0","0","0","0","0","0"
"Hancock","2020-03-13","0","0","0","0","0","0"
"Hancock","2020-03-14","0","0","0","0","0","0"
"Hancock","2020-03-15","1","1","0","0","0","0"
"Hancock","2020-03-16","0","1","0","0","0","0"
"Hancock","2020-03-17","0","1","0","0","0","0"
"Hancock","2020-03-18","0","1","0","0","0","0"
"Hancock","2020-03-19","1","2","0","0","0","0"
"Hancock","2020-03-20","0","2","0","0","0","0"
"Hancock","2020-03-21","0","2","0","0","0","0"
"Hancock","2020-03-22","0","2","0","0","0","0"
"Hancock","2020-03-23","0","2","0","0","0","0"
"Hancock","2020-03-24","1","3","0","0","0","0"
"Hancock","2020-03-25","4","7","0","0","0","0"
"Hancock","2020-03-26","1","8","0","0","0","0"
"Hancock","2020-03-27","1","9","0","0","0","0"
"Hancock","2020-03-28","0","9","0","0","0","0"
"Hancock","2020-03-29","1","10","0","0","0","0"
"Hancock","2020-03-30","0","10","0","0","0","0"
"Hancock","2020-03-31","0","10","0","0","0","0"
"Hancock","2020-04-01","4","14","0","0","0","0"
"Hancock","2020-04-02","0","14","0","0","0","0"
"Hancock","2020-04-03","2","16","1","1","7.1","3.6"
"Hancock","2020-04-04","2","18","0","1","7.1","3.6"
"Hancock","2020-04-05","0","18","0","1","7.1","3.6"
"Hancock","2020-04-06","1","19","0","1","7.1","3.6"
"Hancock","2020-04-07","1","20","0","1","7.1","3.6"
"Hancock","2020-04-08","1","21","0","1","7.1","3.6"
"Hancock","2020-04-09","3","24","0","1","7.1","3.6"
"Hancock","2020-04-10","5","29","3","4","8.6","7.9"
"Hancock","2020-04-11","0","29","0","4","8.6","7.9"
"Hancock","2020-04-12","0","29","0","4","8.6","7.9"
"Hancock","2020-04-13","1","30","0","4","8.6","7.9"
"Hancock","2020-04-14","0","30","0","4","8.6","7.9"
"Hancock","2020-04-15","0","30","0","4","8.6","7.9"
"Hancock","2020-04-16","2","32","1","5","15.7","11.4"
"Hancock","2020-04-17","3","35","1","6","11.9","10.2"
"Hancock","2020-04-18","4","39","2","8","19","13.8"
"Hancock","2020-04-19","1","40","0","8","19","13.8"
"Hancock","2020-04-20","12","52","3","11","22.6","15.6"
"Hancock","2020-04-21","39","91","6","17","24.8","16.7"
"Hancock","2020-04-22","1","92","0","17","24.8","16.7"
"Hancock","2020-04-23","3","95","1","18","22.4","19.1"
"Hancock","2020-04-24","5","100","0","18","17.7","14.8"
"Hancock","2020-04-25","4","104","3","21","21.2","20.1"
"Hancock","2020-04-26","2","106","2","23","35.5","27.3"
"Hancock","2020-04-27","4","110","0","23","32","27.3"
"Hancock","2020-04-28","38","148","9","32","33.1","29"
"Hancock","2020-04-29","24","172","9","41","38.5","31.7"
"Hancock","2020-04-30","16","188","8","49","40.9","31.7"
"Hancock","2020-05-01","21","209","12","61","49","33.4"
"Hancock","2020-05-02","3","212","1","62","43.1","32.2"
"Hancock","2020-05-03","5","217","3","65","37.4","36.5"
"Hancock","2020-05-04","66","283","26","91","43","37.5"
"Hancock","2020-05-05","27","310","3","94","41.2","37.2"
"Hancock","2020-05-06","3","313","2","96","45.4","41.9"
"Hancock","2020-05-07","3","316","3","99","52.5","46.7"
"Hancock","2020-05-08","14","330","6","105","50.5","49.8"
"Hancock","2020-05-09","3","333","3","108","60","51.5"
"Hancock","2020-05-10","0","333","0","108","51.4","44.4"
"Hancock","2020-05-11","9","342","2","110","49","46"
"Hancock","2020-05-12","9","351","3","113","52.2","46.7"
"Hancock","2020-05-13","5","356","3","116","51.2","48.3"
"Hancock","2020-05-14","3","359","2","118","46.4","49.5"
"Hancock","2020-05-15","38","397","12","130","44.8","47.7"
"Hancock","2020-05-16","4","401","1","131","34.1","47.1"
"Hancock","2020-05-17","0","401","0","131","34.1","42.8"
"Hancock","2020-05-18","18","419","3","134","33.3","41.2"
"Hancock","2020-05-19","9","428","0","134","28.6","40.4"
"Hancock","2020-05-20","33","461","1","135","20.4","35.8"
"Hancock","2020-05-21","3","464","0","135","10.9","28.7"
"Hancock","2020-05-22","26","490","2","137","7.5","26.2"
"Hancock","2020-05-23","4","494","4","141","18.2","26.2"
"Hancock","2020-05-24","2","496","1","142","25.3","29.7"
"Hancock","2020-05-25","5","501","3","145","31.5","32.4"
"Hancock","2020-05-26","16","517","1","146","32.4","30.5"
"Hancock","2020-05-27","13","530","1","147","33.1","26.8"
"Hancock","2020-05-28","7","537","0","147","33.1","22"
"Hancock","2020-05-29","2","539","0","147","32","19.7"
"Hancock","2020-05-30","8","547","2","149","21.3","19.7"
"Hancock","2020-05-31","3","550","0","149","14.1","19.7"
"Hancock","2020-06-01","7","557","1","150","7.6","19.6"
"Hancock","2020-06-02","30","587","2","152","7.7","20"
"Hancock","2020-06-03","32","619","2","154","7.5","20.3"
"Hancock","2020-06-04","4","623","0","154","7.5","20.3"
"Hancock","2020-06-05","4","627","0","154","7.5","19.7"
"Hancock","2020-06-06","1","628","1","155","18.2","19.7"
"Hancock","2020-06-07","4","632","0","155","18.2","16.2"
"Hancock","2020-06-08","10","642","1","156","17.6","12.6"
"Hancock","2020-06-09","23","665","0","156","16.6","12.1"
"Hancock","2020-06-10","11","676","1","157","17","12.2"
"Hancock","2020-06-11","4","680","0","157","17","12.2"
"Hancock","2020-06-12","8","688","1","158","18.8","13.1"
"Hancock","2020-06-13","2","690","0","158","4.5","11.3"
"Hancock","2020-06-14","5","695","0","158","4.5","11.3"
"Hancock","2020-06-15","9","704","1","159","4.7","11.1"
"Hancock","2020-06-16","16","720","2","161","6.5","11.5"
"Hancock","2020-06-17","9","729","0","161","5.2","11.1"
"Hancock","2020-06-18","5","734","0","161","5.2","11.1"
"Hancock","2020-06-19","9","743","2","163","6.5","12.7"
"Hancock","2020-06-20","3","746","0","163","6.5","5.5"
"Hancock","2020-06-21","0","746","0","163","6.5","5.5"
"Hancock","2020-06-22","8","754","0","163","5","4.8"
"Hancock","2020-06-23","29","783","1","164","3.7","5.1"
"Hancock","2020-06-24","19","802","2","166","5.2","5.2"
"Hancock","2020-06-25","4","806","0","166","5.2","5.2"
"Hancock","2020-06-26","13","819","1","167","3.1","4.8"
"Hancock","2020-06-27","6","825","1","168","5.5","6"
"Hancock","2020-06-28","2","827","0","168","5.5","6"
"Hancock","2020-06-29","7","834","0","168","5.5","5.2"
"Hancock","2020-06-30","25","859","3","171","6.7","5.2"
"Hancock","2020-07-01","38","897","3","174","6.3","5.7"
"Hancock","2020-07-02","12","909","0","174","6.3","5.7"
"Hancock","2020-07-03","2","911","1","175","12.4","7.7"
"Hancock","2020-07-04","2","913","1","176","17.1","11.3"
"Hancock","2020-07-05","3","916","0","176","17.1","11.3"
"Hancock","2020-07-06","22","938","4","180","19.7","12.6"
"Hancock","2020-07-07","13","951","2","182","20.2","13.5"
"Hancock","2020-07-08","16","967","3","185","21.8","14"
"Hancock","2020-07-09","6","973","2","187","26.5","16.4"
"Hancock","2020-07-10","11","984","4","191","24.6","18.5"
"Hancock","2020-07-11","5","989","2","193","23.1","20.1"
"Hancock","2020-07-12","3","992","0","193","23.1","20.1"
"Hancock","2020-07-13","10","1002","5","198","27.7","23.7"
"Hancock","2020-07-14","29","1031","4","202","27.5","23.8"
"Hancock","2020-07-15","38","1069","8","210","27.8","24.8"
"Hancock","2020-07-16","8","1077","1","211","24.8","25.7"
"Hancock","2020-07-17","7","1084","0","211","19.6","22.1"
"Hancock","2020-07-18","5","1089","0","211","13.9","18.5"
"Hancock","2020-07-19","6","1095","2","213","18.7","20.9"
"Hancock","2020-07-20","13","1108","2","215","13.7","20.7"
"Hancock","2020-07-21","34","1142","5","220","13.9","20.7"
"Hancock","2020-07-22","30","1172","7","227","14.2","21"
"Hancock","2020-07-23","11","1183","2","229","15","19.9"
"Hancock","2020-07-24","8","1191","2","231","18.6","19.1"
"Hancock","2020-07-25","11","1202","1","232","19.9","16.9"
"Hancock","2020-07-26","7","1209","2","234","19.2","18.9"
"Hancock","2020-07-27","8","1217","1","235","18.8","16.2"
"Hancock","2020-07-28","32","1249","7","242","19.8","16.8"
"Hancock","2020-07-29","11","1260","0","242","16.5","15.3"
"Hancock","2020-07-30","10","1270","1","243","15.3","15.1"
"Hancock","2020-07-31","16","1286","2","245","13.5","16"
"Hancock","2020-08-01","5","1291","0","245","12.2","16"
"Hancock","2020-08-02","5","1296","1","246","11","15.1"
"Hancock","2020-08-03","8","1304","0","246","9.2","14"
"Hancock","2020-08-04","24","1328","1","247","6.7","13.2"
"Hancock","2020-08-05","22","1350","5","252","9.9","13.2"
"Hancock","2020-08-06","6","1356","3","255","15.6","15.5"
"Hancock","2020-08-07","12","1368","3","258","17.4","15.5"
"Hancock","2020-08-08","5","1373","0","258","17.4","14.8"
"Hancock","2020-08-09","5","1378","3","261","23.1","17.1"
"Hancock","2020-08-10","5","1383","0","261","23.1","16.2"
"Hancock","2020-08-11","34","1417","6","267","25.1","15.9"
"Hancock","2020-08-12","21","1438","2","269","23.2","16.5"
"Hancock","2020-08-13","5","1443","2","271","21.7","18.7"
"Hancock","2020-08-14","15","1458","2","273","20.1","18.7"
"Hancock","2020-08-15","4","1462","0","273","20.1","18.7"
"Hancock","2020-08-16","2","1464","0","273","11.5","17.3"
"Hancock","2020-08-17","11","1475","0","273","11.5","17.3"
"Hancock","2020-08-18","17","1492","0","273","9","17"
"Hancock","2020-08-19","10","1502","1","274","9","16.1"
"Hancock","2020-08-20","4","1506","0","274","3.3","12.5"
"Hancock","2020-08-21","21","1527","1","275","2.1","11.1"
"Hancock","2020-08-22","3","1530","0","275","2.1","11.1"
"Hancock","2020-08-23","2","1532","0","275","2.1","6.8"
"Hancock","2020-08-24","6","1538","2","277","6.9","9.2"
"Hancock","2020-08-25","20","1558","3","280","9","9"
"Hancock","2020-08-26","6","1564","0","280","7.6","8.3"
"Hancock","2020-08-27","5","1569","0","280","7.6","5.5"
"Hancock","2020-08-28","11","1580","1","281","8.2","5.2"
"Hancock","2020-08-29","11","1591","0","281","8.2","5.2"
"Hancock","2020-08-30","0","1591","0","281","8.2","5.2"
"Hancock","2020-08-31","20","1611","1","282","4.2","5.5"
"Hancock","2020-09-01","10","1621","4","286","7.7","8.4"
"Hancock","2020-09-02","11","1632","1","287","9","8.3"
"Hancock","2020-09-03","7","1639","2","289","13.1","10.3"
"Hancock","2020-09-04","7","1646","1","290","13.8","11"
"Hancock","2020-09-05","10","1656","0","290","13.8","11"
"Hancock","2020-09-06","5","1661","0","290","13.8","11"
"Hancock","2020-09-07","1","1662","1","291","27.4","15.8"
"Hancock","2020-09-08","16","1678","1","292","22.6","15.2"
"Hancock","2020-09-09","13","1691","0","292","21.3","15.2"
"Hancock","2020-09-10","7","1698","1","293","19.3","16.2"
"Hancock","2020-09-11","4","1702","1","294","20.8","17.3"
"Hancock","2020-09-12","1","1703","0","294","20.8","17.3"
"Hancock","2020-09-13","3","1706","0","294","20.8","17.3"
"Hancock","2020-09-14","4","1710","0","294","6.5","17"
"Hancock","2020-09-15","11","1721","0","294","5.6","14.1"
"Hancock","2020-09-16","19","1740","1","295","6.4","13.8"
"Hancock","2020-09-17","4","1744","0","295","4.3","11.8"
"Hancock","2020-09-18","12","1756","1","296","1.9","11.4"
"Hancock","2020-09-19","6","1762","1","297","4.3","12.6"
"Hancock","2020-09-20","5","1767","0","297","4.3","12.6"
"Hancock","2020-09-21","7","1774","1","298","6.4","6.4"
"Hancock","2020-09-22","10","1784","1","299","7.8","6.7"
"Hancock","2020-09-23","9","1793","0","299","7","6.7"
"Hancock","2020-09-24","5","1798","0","299","7","5.7"
"Hancock","2020-09-25","4","1802","0","299","5.9","3.9"
"Hancock","2020-09-26","7","1809","0","299","3.5","3.9"
"Hancock","2020-09-27","3","1812","1","300","8.2","6.3"
"Hancock","2020-09-28","8","1820","0","300","6.2","6.3"
"Hancock","2020-09-29","7","1827","2","302","8.8","8.3"
"Hancock","2020-09-30","9","1836","1","303","10.4","8.7"
"Hancock","2020-10-01","7","1843","0","303","10.4","8.7"
"Hancock","2020-10-02","21","1864","1","304","11.1","8.5"
"Hancock","2020-10-03","29","1893","1","305","11.6","7.5"
"Hancock","2020-10-04","4","1897","0","305","6.8","7.5"
"Hancock","2020-10-05","9","1906","1","306","8.4","7.3"
"Hancock","2020-10-06","17","1923","3","309","6.9","7.9"
"Hancock","2020-10-07","34","1957","1","310","5.7","8.1"
"Hancock","2020-10-08","9","1966","0","310","5.7","8.1"
"Hancock","2020-10-09","57","2023","0","310","5","8.1"
"Hancock","2020-10-10","7","2030","1","311","6.6","9.1"
"Hancock","2020-10-11","0","2030","0","311","6.6","6.7"
"Hancock","2020-10-12","11","2041","0","311","5","6.7"
"Hancock","2020-10-13","14","2055","5","316","7.6","7.2"
"Hancock","2020-10-14","5","2060","0","316","7.1","6.4"
"Hancock","2020-10-15","43","2103","1","317","7.5","6.6"
"Hancock","2020-10-16","19","2122","0","317","7.5","6.2"
"Hancock","2020-10-17","1","2123","0","317","5.4","6"
"Hancock","2020-10-18","4","2127","0","317","5.4","6"
"Hancock","2020-10-19","19","2146","0","317","5.4","5.2"
"Hancock","2020-10-20","17","2163","1","318","1.2","4.4"
"Hancock","2020-10-21","8","2171","0","318","1.2","4.2"
"Hancock","2020-10-22","8","2179","0","318","0.8","4.2"
"Hancock","2020-10-23","14","2193","1","319","1.9","4.7"
"Hancock","2020-10-24","4","2197","0","319","1.9","3.6"
"Hancock","2020-10-25","7","2204","2","321","5.9","5.7"
"Hancock","2020-10-26","9","2213","2","323","9.1","7.3"
"Hancock","2020-10-27","27","2240","3","326","9.9","5.5"
"Hancock","2020-10-28","6","2246","0","326","9.9","5.5"
"Hancock","2020-10-29","6","2252","1","327","12.2","6.5"
"Hancock","2020-10-30","13","2265","0","327","11.2","6.5"
"Hancock","2020-10-31","9","2274","0","327","11.2","6.5"
"Hancock","2020-11-01","0","2274","0","327","7.1","6.5"
"Hancock","2020-11-02","11","2285","0","327","4","6.5"
"Hancock","2020-11-03","15","2300","2","329","4.3","7.1"
"Hancock","2020-11-04","10","2310","0","329","4.3","7.1"
"Hancock","2020-11-05","15","2325","2","331","3.8","8"
"Hancock","2020-11-06","18","2343","2","333","5.4","8.3"
"Hancock","2020-11-07","8","2351","1","334","7.2","9.2"
"Hancock","2020-11-08","4","2355","0","334","7.2","7.2"
"Hancock","2020-11-09","12","2367","0","334","7.2","5.6"
"Hancock","2020-11-10","19","2386","1","335","6","5.2"
"Hancock","2020-11-11","5","2391","0","335","6","5.2"
"Hancock","2020-11-12","69","2460","9","344","6","4.9"
"Hancock","2020-11-13","94","2554","7","351","5.5","5.4"
"Hancock","2020-11-14","4","2558","1","352","7.3","7.2"
"Hancock","2020-11-15","4","2562","1","353","10.8","9"
"Hancock","2020-11-16","94","2656","26","379","14.8","11"
"Hancock","2020-11-17","17","2673","1","380","14.9","10.4"
"Hancock","2020-11-18","10","2683","2","382","17.7","11.9"
"Hancock","2020-11-19","6","2689","0","382","15.9","10.9"
"Hancock","2020-11-20","5","2694","0","382","14.8","10.1"
"Hancock","2020-11-21","4","2698","1","383","14.8","11"
"Hancock","2020-11-22","6","2704","1","384","13.6","12.2"
"Hancock","2020-11-23","13","2717","2","386","11.8","13.3"
"Hancock","2020-11-24","90","2807","31","417","15.9","15.4"
"Hancock","2020-11-25","89","2896","6","423","14","15.9"
"Hancock","2020-11-26","2","2898","0","423","14","14.9"
"Hancock","2020-11-27","9","2907","0","423","14","14.4"
"Hancock","2020-11-28","3","2910","2","425","20","17.4"
"Hancock","2020-11-29","5","2915","0","425","17.6","15.6"
"Hancock","2020-11-30","14","2929","0","425","15.4","13.6"
"Hancock","2020-12-01","10","2939","3","428","14.8","15.4"
"Hancock","2020-12-02","3","2942","0","428","13.8","13.9"
"Hancock","2020-12-03","6","2948","0","428","13.8","13.9"
"Hancock","2020-12-04","14","2962","1","429","14.8","14.4"
"Hancock","2020-12-05","6","2968","0","429","5.3","12.6"
"Hancock","2020-12-06","2","2970","0","429","5.3","11.5"
"Hancock","2020-12-07","15","2985","0","429","5.3","10.4"
"Hancock","2020-12-08","28","3013","4","433","3.1","8.9"
"Hancock","2020-12-09","6","3019","1","434","5.4","9.6"
"Hancock","2020-12-10","11","3030","2","436","8","10.9"
"Hancock","2020-12-11","6","3036","0","436","7","10.9"
"Hancock","2020-12-12","4","3040","1","437","10.6","7.9"
"Hancock","2020-12-13","6","3046","2","439","15.4","10.3"
"Hancock","2020-12-14","16","3062","3","442","18","11.7"
"Hancock","2020-12-15","10","3072","2","444","18.8","11"
"Hancock","2020-12-16","18","3090","4","448","19.6","12.5"
"Hancock","2020-12-17","68","3158","17","465","20.6","14.3"
"Hancock","2020-12-18","12","3170","5","470","26.6","16.8"
"Hancock","2020-12-19","10","3180","2","472","25.9","18.2"
"Hancock","2020-12-20","6","3186","3","475","28.2","21.8"
"Hancock","2020-12-21","54","3240","21","496","31.1","24.6"
"Hancock","2020-12-22","103","3343","12","508","29.9","24.4"
"Hancock","2020-12-23","24","3367","9","517","32.1","25.9"
"Hancock","2020-12-24","26","3393","8","525","32.9","26.8"
"Hancock","2020-12-25","4","3397","0","525","27","26.8"
"Hancock","2020-12-26","8","3405","3","528","29.5","27.7"
"Hancock","2020-12-27","8","3413","3","531","27.7","28"
"Hancock","2020-12-28","23","3436","6","537","25.9","28.5"
"Hancock","2020-12-29","52","3488","10","547","26.9","28.4"
"Hancock","2020-12-30","13","3501","4","551","26","29"
"Hancock","2020-12-31","11","3512","1","552","22.9","27.9"
"Hancock","2021-01-01","2","3514","2","554","37.2","32.1"
"Hancock","2021-01-02","9","3523","2","556","35","32.2"
"Hancock","2021-01-03","3","3526","2","558","39.2","33.4"
"Hancock","2021-01-04","18","3544","7","565","41","33.4"
"Hancock","2021-01-05","143","3687","25","590","40.7","33.8"
"Hancock","2021-01-06","17","3704","5","595","40.5","33.3"
"Hancock","2021-01-07","21","3725","8","603","44.7","33.8"
"Hancock","2021-01-08","25","3750","5","608","33.3","35.2"
"Hancock","2021-01-09","6","3756","2","610","34.8","34.9"
"Hancock","2021-01-10","6","3762","2","612","30.1","34.6"
"Hancock","2021-01-11","16","3778","7","619","30.8","35.9"
"Hancock","2021-01-12","27","3805","5","624","30.9","35.8"
"Hancock","2021-01-13","35","3840","9","633","30.4","35.5"
"Hancock","2021-01-14","12","3852","5","638","30.9","37.8"
"Hancock","2021-01-15","19","3871","4","642","31.1","32.2"
"Hancock","2021-01-16","8","3879","2","644","29.9","32.4"
"Hancock","2021-01-17","7","3886","1","645","27.1","28.6"
"Hancock","2021-01-18","11","3897","2","647","23.5","27.1"
"Hancock","2021-01-19","13","3910","4","651","25.2","28.1"
"Hancock","2021-01-20","30","3940","5","656","23.9","27.2"
"Hancock","2021-01-21","114","4054","0","656","18","24.4"
"Hancock","2021-01-22","13","4067","1","657","16.1","23.6"
"Hancock","2021-01-23","11","4078","2","659","15.1","22.5"
"Hancock","2021-01-24","7","4085","2","661","17.2","22.1"
"Hancock","2021-01-25","5","4090","1","662","17.4","20.5"
"Hancock","2021-01-26","0","4090","0","662","13","19.1"
"Hancock","2021-01-27","0","4090","0","662","10.6","17.3"
"Haralson","2020-02-01","0","0","0","0",".","."
"Haralson","2020-02-02","0","0","0","0",".","."
"Haralson","2020-02-03","0","0","0","0",".","."
"Haralson","2020-02-04","0","0","0","0",".","."
"Haralson","2020-02-05","0","0","0","0",".","."
"Haralson","2020-02-06","0","0","0","0",".","."
"Haralson","2020-02-07","0","0","0","0","0","."
"Haralson","2020-02-08","0","0","0","0","0","."
"Haralson","2020-02-09","0","0","0","0","0","."
"Haralson","2020-02-10","0","0","0","0","0","."
"Haralson","2020-02-11","0","0","0","0","0","."
"Haralson","2020-02-12","0","0","0","0","0","."
"Haralson","2020-02-13","0","0","0","0","0","."
"Haralson","2020-02-14","0","0","0","0","0","0"
"Haralson","2020-02-15","0","0","0","0","0","0"
"Haralson","2020-02-16","0","0","0","0","0","0"
"Haralson","2020-02-17","0","0","0","0","0","0"
"Haralson","2020-02-18","0","0","0","0","0","0"
"Haralson","2020-02-19","0","0","0","0","0","0"
"Haralson","2020-02-20","0","0","0","0","0","0"
"Haralson","2020-02-21","0","0","0","0","0","0"
"Haralson","2020-02-22","0","0","0","0","0","0"
"Haralson","2020-02-23","0","0","0","0","0","0"
"Haralson","2020-02-24","0","0","0","0","0","0"
"Haralson","2020-02-25","0","0","0","0","0","0"
"Haralson","2020-02-26","0","0","0","0","0","0"
"Haralson","2020-02-27","0","0","0","0","0","0"
"Haralson","2020-02-28","0","0","0","0","0","0"
"Haralson","2020-02-29","0","0","0","0","0","0"
"Haralson","2020-03-01","0","0","0","0","0","0"
"Haralson","2020-03-02","0","0","0","0","0","0"
"Haralson","2020-03-03","0","0","0","0","0","0"
"Haralson","2020-03-04","0","0","0","0","0","0"
"Haralson","2020-03-05","0","0","0","0","0","0"
"Haralson","2020-03-06","0","0","0","0","0","0"
"Haralson","2020-03-07","2","2","0","0","0","0"
"Haralson","2020-03-08","1","3","0","0","0","0"
"Haralson","2020-03-09","1","4","0","0","0","0"
"Haralson","2020-03-10","1","5","0","0","0","0"
"Haralson","2020-03-11","0","5","0","0","0","0"
"Haralson","2020-03-12","4","9","0","0","0","0"
"Haralson","2020-03-13","4","13","0","0","0","0"
"Haralson","2020-03-14","0","13","0","0","0","0"
"Haralson","2020-03-15","2","15","0","0","0","0"
"Haralson","2020-03-16","10","25","0","0","0","0"
"Haralson","2020-03-17","14","39","0","0","0","0"
"Haralson","2020-03-18","6","45","0","0","0","0"
"Haralson","2020-03-19","6","51","0","0","0","0"
"Haralson","2020-03-20","3","54","0","0","0","0"
"Haralson","2020-03-21","3","57","0","0","0","0"
"Haralson","2020-03-22","0","57","0","0","0","0"
"Haralson","2020-03-23","1","58","0","0","0","0"
"Haralson","2020-03-24","1","59","0","0","0","0"
"Haralson","2020-03-25","4","63","0","0","0","0"
"Haralson","2020-03-26","4","67","0","0","0","0"
"Haralson","2020-03-27","3","70","0","0","0","0"
"Haralson","2020-03-28","4","74","0","0","0","0"
"Haralson","2020-03-29","4","78","0","0","0","0"
"Haralson","2020-03-30","2","80","0","0","0","0"
"Haralson","2020-03-31","1","81","0","0","0","0"
"Haralson","2020-04-01","0","81","0","0","0","0"
"Haralson","2020-04-02","6","87","2","2","4.8","2.4"
"Haralson","2020-04-03","4","91","0","2","4.8","2.4"
"Haralson","2020-04-04","6","97","2","4","9.5","4.8"
"Haralson","2020-04-05","0","97","0","4","9.5","4.8"
"Haralson","2020-04-06","5","102","1","5","12.4","6.2"
"Haralson","2020-04-07","7","109","1","6","14.4","7.2"
"Haralson","2020-04-08","5","114","1","7","17.3","8.6"
"Haralson","2020-04-09","8","122","1","8","14.3","9.5"
"Haralson","2020-04-10","5","127","0","8","14.3","9.5"
"Haralson","2020-04-11","6","133","1","9","11.9","10.7"
"Haralson","2020-04-12","1","134","1","10","26.2","17.9"
"Haralson","2020-04-13","1","135","1","11","37.6","25"
"Haralson","2020-04-14","4","139","0","11","35.6","25"
"Haralson","2020-04-15","2","141","0","11","32.7","25"
"Haralson","2020-04-16","3","144","0","11","31","22.6"
"Haralson","2020-04-17","3","147","2","13","40.5","27.4"
"Haralson","2020-04-18","3","150","2","15","47.6","29.8"
"Haralson","2020-04-19","3","153","0","15","33.3","29.8"
"Haralson","2020-04-20","8","161","1","16","20.8","29.2"
"Haralson","2020-04-21","11","172","0","16","20.8","28.2"
"Haralson","2020-04-22","9","181","0","16","20.8","26.8"
"Haralson","2020-04-23","20","201","1","17","21.5","26.3"
"Haralson","2020-04-24","14","215","1","18","13","26.8"
"Haralson","2020-04-25","12","227","1","19","4.7","26.2"
"Haralson","2020-04-26","3","230","0","19","4.7","19"
"Haralson","2020-04-27","19","249","0","19","2.9","11.9"
"Haralson","2020-04-28","11","260","1","20","4.2","12.5"
"Haralson","2020-04-29","33","293","4","24","6","13.4"
"Haralson","2020-04-30","19","312","4","28","8.2","14.9"
"Haralson","2020-05-01","22","334","2","30","8.5","10.8"
"Haralson","2020-05-02","10","344","0","30","7.3","6"
"Haralson","2020-05-03","2","346","0","30","7.3","6"
"Haralson","2020-05-04","28","374","2","32","8.4","5.6"
"Haralson","2020-05-05","7","381","0","32","7.1","5.6"
"Haralson","2020-05-06","7","388","0","32","5.3","5.6"
"Haralson","2020-05-07","13","401","0","32","2.3","5.3"
"Haralson","2020-05-08","9","410","1","33","2.6","5.6"
"Haralson","2020-05-09","4","414","0","33","2.6","5"
"Haralson","2020-05-10","0","414","0","33","2.6","5"
"Haralson","2020-05-11","26","440","1","34","2.1","5.2"
"Haralson","2020-05-12","21","461","0","34","2.1","4.6"
"Haralson","2020-05-13","9","470","0","34","2.1","3.7"
"Haralson","2020-05-14","6","476","0","34","2.1","2.2"
"Haralson","2020-05-15","104","580","1","35","0.7","1.6"
"Haralson","2020-05-16","8","588","1","36","2.5","2.5"
"Haralson","2020-05-17","8","596","0","36","2.5","2.5"
"Haralson","2020-05-18","17","613","1","37","2.8","2.5"
"Haralson","2020-05-19","19","632","1","38","3.5","2.8"
"Haralson","2020-05-20","12","644","1","39","4.7","3.4"
"Haralson","2020-05-21","24","668","0","39","4.7","3.4"
"Haralson","2020-05-22","21","689","0","39","4.6","2.6"
"Haralson","2020-05-23","4","693","0","39","2.8","2.6"
"Haralson","2020-05-24","2","695","0","39","2.8","2.6"
"Haralson","2020-05-25","11","706","1","40","3.2","3"
"Haralson","2020-05-26","28","734","0","40","2.5","3"
"Haralson","2020-05-27","23","757","1","41","1.9","3.3"
"Haralson","2020-05-28","18","775","1","42","2.7","3.7"
"Haralson","2020-05-29","24","799","0","42","2.7","3.6"
"Haralson","2020-05-30","7","806","0","42","2.7","2.7"
"Haralson","2020-05-31","7","813","1","43","4.8","3.8"
"Haralson","2020-06-01","14","827","1","44","4.5","3.9"
"Haralson","2020-06-02","12","839","0","44","4.5","3.5"
"Haralson","2020-06-03","23","862","1","45","4.5","3.2"
"Haralson","2020-06-04","9","871","2","47","6.9","4.8"
"Haralson","2020-06-05","24","895","1","48","7.5","5.1"
"Haralson","2020-06-06","16","911","4","52","11","6.9"
"Haralson","2020-06-07","4","915","0","52","9","6.9"
"Haralson","2020-06-08","18","933","2","54","9.5","7"
"Haralson","2020-06-09","16","949","1","55","10.4","7.5"
"Haralson","2020-06-10","10","959","0","55","9.8","7.1"
"Haralson","2020-06-11","16","975","3","58","9.3","8.1"
"Haralson","2020-06-12","27","1002","0","58","8.7","8.1"
"Haralson","2020-06-13","3","1005","0","58","5.2","8.1"
"Haralson","2020-06-14","1","1006","1","59","19.4","14.2"
"Haralson","2020-06-15","19","1025","2","61","19.4","14.5"
"Haralson","2020-06-16","25","1050","1","62","19","14.7"
"Haralson","2020-06-17","22","1072","1","63","19.7","14.8"
"Haralson","2020-06-18","20","1092","3","66","19.2","14.2"
"Haralson","2020-06-19","24","1116","0","66","19.2","13.9"
"Haralson","2020-06-20","12","1128","1","67","20.3","12.8"
"Haralson","2020-06-21","7","1135","2","69","10.1","14.8"
"Haralson","2020-06-22","35","1170","2","71","9.5","14.4"
"Haralson","2020-06-23","21","1191","2","73","10.2","14.6"
"Haralson","2020-06-24","35","1226","3","76","10.8","15.3"
"Haralson","2020-06-25","32","1258","1","77","9.1","14.1"
"Haralson","2020-06-26","36","1294","4","81","10.7","14.9"
"Haralson","2020-06-27","13","1307","2","83","11.7","16"
"Haralson","2020-06-28","10","1317","2","85","10.5","10.3"
"Haralson","2020-06-29","28","1345","2","87","10.7","10.1"
"Haralson","2020-06-30","26","1371","1","88","9.9","10.1"
"Haralson","2020-07-01","46","1417","4","92","9.9","10.4"
"Haralson","2020-07-02","39","1456","4","96","10.9","10"
"Haralson","2020-07-03","15","1471","3","99","12.2","11.4"
"Haralson","2020-07-04","10","1481","2","101","12.8","12.3"
"Haralson","2020-07-05","3","1484","2","103","19.5","15"
"Haralson","2020-07-06","48","1532","11","114","21.8","16.2"
"Haralson","2020-07-07","43","1575","6","120","23.2","16.5"
"Haralson","2020-07-08","50","1625","6","126","23.7","16.8"
"Haralson","2020-07-09","48","1673","5","131","23.7","17.3"
"Haralson","2020-07-10","50","1723","9","140","23.4","17.8"
"Haralson","2020-07-11","20","1743","2","142","22","17.4"
"Haralson","2020-07-12","10","1753","0","142","12.5","16"
"Haralson","2020-07-13","48","1801","9","151","11.9","16.8"
"Haralson","2020-07-14","46","1847","9","160","12.7","17.9"
"Haralson","2020-07-15","30","1877","4","164","12.9","18.3"
"Haralson","2020-07-16","40","1917","9","173","14.6","19.2"
"Haralson","2020-07-17","62","1979","9","182","14.1","18.8"
"Haralson","2020-07-18","21","2000","5","187","16.1","19"
"Haralson","2020-07-19","11","2011","1","188","17.4","14.9"
"Haralson","2020-07-20","45","2056","12","200","18.5","15.2"
"Haralson","2020-07-21","51","2107","18","218","20.7","16.7"
"Haralson","2020-07-22","35","2142","11","229","23.3","18.1"
"Haralson","2020-07-23","36","2178","11","240","24.5","19.5"
"Haralson","2020-07-24","36","2214","7","247","25.2","19.6"
"Haralson","2020-07-25","8","2222","1","248","23.6","19.8"
"Haralson","2020-07-26","2","2224","0","248","22.3","19.8"
"Haralson","2020-07-27","35","2259","3","251","19.7","19.1"
"Haralson","2020-07-28","24","2283","4","255","17","18.9"
"Haralson","2020-07-29","24","2307","7","262","16.7","20"
"Haralson","2020-07-30","21","2328","3","265","14.4","19.4"
"Haralson","2020-07-31","26","2354","2","267","12.7","18.9"
"Haralson","2020-08-01","10","2364","4","271","16.6","20.1"
"Haralson","2020-08-02","9","2373","2","273","19.8","21"
"Haralson","2020-08-03","30","2403","6","279","21.4","20.6"
"Haralson","2020-08-04","27","2430","7","286","22.8","19.9"
"Haralson","2020-08-05","28","2458","4","290","20.6","18.7"
"Haralson","2020-08-06","26","2484","4","294","20.8","17.6"
"Haralson","2020-08-07","39","2523","16","310","25.5","19.1"
"Haralson","2020-08-08","21","2544","11","321","27.3","22"
"Haralson","2020-08-09","4","2548","2","323","31.3","25.5"
"Haralson","2020-08-10","41","2589","7","330","30.9","26.2"
"Haralson","2020-08-11","34","2623","10","340","31.4","27.1"
"Haralson","2020-08-12","29","2652","5","345","31.8","26.2"
"Haralson","2020-08-13","25","2677","3","348","31.3","26"
"Haralson","2020-08-14","27","2704","2","350","26.5","26"
"Haralson","2020-08-15","8","2712","0","350","19","23.2"
"Haralson","2020-08-16","5","2717","0","350","11.9","21.6"
"Haralson","2020-08-17","35","2752","8","358","12.7","21.8"
"Haralson","2020-08-18","46","2798","13","371","12.5","22"
"Haralson","2020-08-19","35","2833","10","381","14.2","23"
"Haralson","2020-08-20","28","2861","6","387","15.5","23.4"
"Haralson","2020-08-21","36","2897","8","395","17.6","22.1"
"Haralson","2020-08-22","14","2911","4","399","21.7","20.4"
"Haralson","2020-08-23","3","2914","0","399","21.7","16.8"
"Haralson","2020-08-24","33","2947","4","403","20.2","16.4"
"Haralson","2020-08-25","40","2987","5","408","17.9","15.2"
"Haralson","2020-08-26","37","3024","7","415","16.5","15.3"
"Haralson","2020-08-27","30","3054","4","419","15.4","15.4"
"Haralson","2020-08-28","32","3086","4","423","14","15.8"
"Haralson","2020-08-29","7","3093","1","424","12","16.8"
"Haralson","2020-08-30","3","3096","0","424","12","16.8"
"Haralson","2020-08-31","34","3130","7","431","13.2","16.7"
"Haralson","2020-09-01","34","3164","10","441","15.6","16.7"
"Haralson","2020-09-02","75","3239","6","447","14","15.3"
"Haralson","2020-09-03","37","3276","3","450","13.3","14.3"
"Haralson","2020-09-04","42","3318","3","453","12.5","13.2"
"Haralson","2020-09-05","4","3322","0","453","10.5","11.2"
"Haralson","2020-09-06","3","3325","0","453","10.5","11.2"
"Haralson","2020-09-07","12","3337","2","455","9.9","11.5"
"Haralson","2020-09-08","41","3378","6","461","7.8","11.7"
"Haralson","2020-09-09","82","3460","18","479","9.8","11.9"
"Haralson","2020-09-10","43","3503","7","486","11","12.1"
"Haralson","2020-09-11","30","3533","4","490","11.8","12.2"
"Haralson","2020-09-12","153","3686","4","494","12.2","11.3"
"Haralson","2020-09-13","12","3698","0","494","12.2","11.3"
"Haralson","2020-09-14","27","3725","2","496","10.9","10.4"
"Haralson","2020-09-15","33","3758","4","500","10.5","9.2"
"Haralson","2020-09-16","153","3911","8","508","8.1","9"
"Haralson","2020-09-17","41","3952","2","510","6.5","8.7"
"Haralson","2020-09-18","48","4000","4","514","5.8","8.8"
"Haralson","2020-09-19","75","4075","4","518","6.2","9.2"
"Haralson","2020-09-20","7","4082","1","519","8.2","10.2"
"Haralson","2020-09-21","25","4107","6","525","10.6","10.7"
"Haralson","2020-09-22","27","4134","5","530","11.5","11"
"Haralson","2020-09-23","89","4223","15","545","13.2","10.7"
"Haralson","2020-09-24","26","4249","9","554","17.4","12"
"Haralson","2020-09-25","24","4273","7","561","20.4","13.1"
"Haralson","2020-09-26","10","4283","6","567","28.2","17.2"
"Haralson","2020-09-27","5","4288","1","568","29","18.6"
"Haralson","2020-09-28","25","4313","3","571","27.3","19"
"Haralson","2020-09-29","31","4344","6","577","27.4","19.5"
"Haralson","2020-09-30","75","4419","13","590","27.5","20.3"
"Haralson","2020-10-01","110","4529","10","600","23.8","20.6"
"Haralson","2020-10-02","42","4571","7","607","22.1","21.2"
"Haralson","2020-10-03","46","4617","4","611","14.7","21.5"
"Haralson","2020-10-04","9","4626","0","611","11.9","20.4"
"Haralson","2020-10-05","29","4655","6","617","13.1","20.2"
"Haralson","2020-10-06","34","4689","11","628","15","21.2"
"Haralson","2020-10-07","149","4838","8","636","13.3","20.4"
"Haralson","2020-10-08","44","4882","4","640","13.3","18.6"
"Haralson","2020-10-09","36","4918","3","643","12.1","17.1"
"Haralson","2020-10-10","10","4928","5","648","18","16.4"
"Haralson","2020-10-11","2","4930","1","649","25.1","18.5"
"Haralson","2020-10-12","31","4961","5","654","24.5","18.8"
"Haralson","2020-10-13","40","5001","6","660","22","18.5"
"Haralson","2020-10-14","102","5103","10","670","22.6","17.9"
"Haralson","2020-10-15","46","5149","11","681","24.7","19"
"Haralson","2020-10-16","67","5216","8","689","25.3","18.7"
"Haralson","2020-10-17","35","5251","5","694","20.2","19.1"
"Haralson","2020-10-18","21","5272","1","695","13.7","19.4"
"Haralson","2020-10-19","50","5322","10","705","14.2","19.4"
"Haralson","2020-10-20","44","5366","10","715","15.3","18.7"
"Haralson","2020-10-21","84","5450","8","723","15.3","19"
"Haralson","2020-10-22","34","5484","9","732","15.7","20.2"
"Haralson","2020-10-23","53","5537","12","744","17.2","21.2"
"Haralson","2020-10-24","21","5558","8","752","20.6","20.4"
"Haralson","2020-10-25","4","5562","1","753","23.5","18.6"
"Haralson","2020-10-26","34","5596","12","765","25.7","20"
"Haralson","2020-10-27","34","5630","14","779","28.3","21.8"
"Haralson","2020-10-28","76","5706","13","792","29.4","22.4"
"Haralson","2020-10-29","18","5724","3","795","28","21.8"
"Haralson","2020-10-30","23","5747","5","800","27.9","22.5"
"Haralson","2020-10-31","14","5761","3","803","25.5","23"
"Haralson","2020-11-01","5","5766","1","804","24.8","24.1"
"Haralson","2020-11-02","38","5804","9","813","23.1","24.4"
"Haralson","2020-11-03","27","5831","4","817","19.3","23.8"
"Haralson","2020-11-04","97","5928","9","826","18.2","23.8"
"Haralson","2020-11-05","32","5960","6","832","18.5","23.3"
"Haralson","2020-11-06","37","5997","9","841","18.9","23.4"
"Haralson","2020-11-07","14","6011","5","846","20.9","23.2"
"Haralson","2020-11-08","2","6013","2","848","32.4","28.6"
"Haralson","2020-11-09","51","6064","5","853","30.4","26.7"
"Haralson","2020-11-10","53","6117","14","867","32","25.7"
"Haralson","2020-11-11","50","6167","16","883","35.3","26.8"
"Haralson","2020-11-12","46","6213","8","891","35.1","26.8"
"Haralson","2020-11-13","48","6261","13","904","35.5","27.2"
"Haralson","2020-11-14","27","6288","6","910","33.6","27.2"
"Haralson","2020-11-15","7","6295","3","913","25.4","28.9"
"Haralson","2020-11-16","54","6349","14","927","27.7","29"
"Haralson","2020-11-17","48","6397","5","932","25.4","28.7"
"Haralson","2020-11-18","126","6523","11","943","22.1","28.7"
"Haralson","2020-11-19","68","6591","10","953","21.7","28.4"
"Haralson","2020-11-20","60","6651","15","968","21.4","28.4"
"Haralson","2020-11-21","32","6683","9","977","22.3","27.9"
"Haralson","2020-11-22","8","6691","2","979","19.7","22.5"
"Haralson","2020-11-23","31","6722","3","982","17.4","22.5"
"Haralson","2020-11-24","26","6748","3","985","17.5","21.5"
"Haralson","2020-11-25","114","6862","16","1001","18.3","20.2"
"Haralson","2020-11-26","5","6867","2","1003","21.9","21.8"
"Haralson","2020-11-27","48","6915","10","1013","21.3","21.4"
"Haralson","2020-11-28","25","6940","7","1020","21.3","21.8"
"Haralson","2020-11-29","13","6953","2","1022","19.9","19.8"
"Haralson","2020-11-30","41","6994","5","1027","20.3","18.8"
"Haralson","2020-12-01","59","7053","20","1047","23.5","20.5"
"Haralson","2020-12-02","71","7124","19","1066","25.3","21.8"
"Haralson","2020-12-03","78","7202","28","1094","24.7","23.3"
"Haralson","2020-12-04","56","7258","16","1110","25.8","23.6"
"Haralson","2020-12-05","28","7286","9","1119","26.4","23.9"
"Haralson","2020-12-06","10","7296","1","1120","25.6","22.8"
"Haralson","2020-12-07","66","7362","5","1125","25","22.6"
"Haralson","2020-12-08","53","7415","16","1141","24.4","24"
"Haralson","2020-12-09","55","7470","12","1153","23.7","24.5"
"Haralson","2020-12-10","50","7520","8","1161","20.9","22.8"
"Haralson","2020-12-11","52","7572","11","1172","19.8","22.8"
"Haralson","2020-12-12","70","7642","8","1180","16.9","21.6"
"Haralson","2020-12-13","20","7662","3","1183","17.6","21.6"
"Haralson","2020-12-14","62","7724","15","1198","20","22.5"
"Haralson","2020-12-15","65","7789","19","1217","19.8","22.1"
"Haralson","2020-12-16","86","7875","28","1245","21.4","22.6"
"Haralson","2020-12-17","54","7929","9","1254","21.5","21.2"
"Haralson","2020-12-18","48","7977","10","1264","21.4","20.6"
"Haralson","2020-12-19","41","8018","13","1277","24.3","20.6"
"Haralson","2020-12-20","14","8032","4","1281","26.3","21.9"
"Haralson","2020-12-21","38","8070","10","1291","26.6","23.3"
"Haralson","2020-12-22","78","8148","19","1310","25.9","22.8"
"Haralson","2020-12-23","50","8198","15","1325","25.5","23.4"
"Haralson","2020-12-24","56","8254","16","1341","27.2","24.3"
"Haralson","2020-12-25","3","8257","0","1341","24.2","22.8"
"Haralson","2020-12-26","18","8275","4","1345","22.9","23.6"
"Haralson","2020-12-27","21","8296","3","1348","20.8","23.5"
"Haralson","2020-12-28","109","8405","22","1370","19.9","23.3"
"Haralson","2020-12-29","103","8508","24","1394","19.8","22.8"
"Haralson","2020-12-30","64","8572","18","1412","19.5","22.5"
"Haralson","2020-12-31","86","8658","23","1435","19.3","23.2"
"Haralson","2021-01-01","8","8666","1","1436","21.1","22.6"
"Haralson","2021-01-02","10","8676","2","1438","20.7","21.8"
"Haralson","2021-01-03","18","8694","4","1442","21.9","21.3"
"Haralson","2021-01-04","79","8773","28","1470","24","22"
"Haralson","2021-01-05","93","8866","21","1491","23.9","21.9"
"Haralson","2021-01-06","71","8937","9","1500","21.7","20.6"
"Haralson","2021-01-07","70","9007","14","1514","20.8","20"
"Haralson","2021-01-08","51","9058","13","1527","22.6","21.8"
"Haralson","2021-01-09","36","9094","8","1535","22.9","21.8"
"Haralson","2021-01-10","13","9107","0","1535","19.8","20.8"
"Haralson","2021-01-11","49","9156","12","1547","18.2","21.1"
"Haralson","2021-01-12","67","9223","12","1559","17.5","20.7"
"Haralson","2021-01-13","59","9282","8","1567","17.7","19.7"
"Haralson","2021-01-14","43","9325","12","1579","18.8","19.8"
"Haralson","2021-01-15","41","9366","8","1587","17.9","20.3"
"Haralson","2021-01-16","30","9396","11","1598","20","21.5"
"Haralson","2021-01-17","24","9420","5","1603","23","21.4"
"Haralson","2021-01-18","40","9460","11","1614","23.4","20.8"
"Haralson","2021-01-19","58","9518","13","1627","24.1","20.8"
"Haralson","2021-01-20","44","9562","7","1634","24.4","21"
"Haralson","2021-01-21","42","9604","6","1640","22.4","20.6"
"Haralson","2021-01-22","43","9647","6","1646","21.7","19.8"
"Haralson","2021-01-23","40","9687","14","1660","21.4","20.7"
"Haralson","2021-01-24","10","9697","0","1660","18.4","20.7"
"Haralson","2021-01-25","8","9705","1","1661","16.3","19.9"
"Haralson","2021-01-26","0","9705","0","1661","13.1","18.6"
"Haralson","2021-01-27","0","9705","0","1661","10.8","17.6"
"Harris","2020-02-01","0","0","0","0",".","."
"Harris","2020-02-02","0","0","0","0",".","."
"Harris","2020-02-03","0","0","0","0",".","."
"Harris","2020-02-04","0","0","0","0",".","."
"Harris","2020-02-05","0","0","0","0",".","."
"Harris","2020-02-06","0","0","0","0",".","."
"Harris","2020-02-07","0","0","0","0","0","."
"Harris","2020-02-08","0","0","0","0","0","."
"Harris","2020-02-09","0","0","0","0","0","."
"Harris","2020-02-10","0","0","0","0","0","."
"Harris","2020-02-11","0","0","0","0","0","."
"Harris","2020-02-12","0","0","0","0","0","."
"Harris","2020-02-13","0","0","0","0","0","."
"Harris","2020-02-14","0","0","0","0","0","0"
"Harris","2020-02-15","0","0","0","0","0","0"
"Harris","2020-02-16","0","0","0","0","0","0"
"Harris","2020-02-17","0","0","0","0","0","0"
"Harris","2020-02-18","0","0","0","0","0","0"
"Harris","2020-02-19","0","0","0","0","0","0"
"Harris","2020-02-20","0","0","0","0","0","0"
"Harris","2020-02-21","0","0","0","0","0","0"
"Harris","2020-02-22","0","0","0","0","0","0"
"Harris","2020-02-23","0","0","0","0","0","0"
"Harris","2020-02-24","0","0","0","0","0","0"
"Harris","2020-02-25","0","0","0","0","0","0"
"Harris","2020-02-26","0","0","0","0","0","0"
"Harris","2020-02-27","0","0","0","0","0","0"
"Harris","2020-02-28","0","0","0","0","0","0"
"Harris","2020-02-29","0","0","0","0","0","0"
"Harris","2020-03-01","0","0","0","0","0","0"
"Harris","2020-03-02","0","0","0","0","0","0"
"Harris","2020-03-03","0","0","0","0","0","0"
"Harris","2020-03-04","0","0","0","0","0","0"
"Harris","2020-03-05","0","0","0","0","0","0"
"Harris","2020-03-06","0","0","0","0","0","0"
"Harris","2020-03-07","0","0","0","0","0","0"
"Harris","2020-03-08","0","0","0","0","0","0"
"Harris","2020-03-09","0","0","0","0","0","0"
"Harris","2020-03-10","0","0","0","0","0","0"
"Harris","2020-03-11","0","0","0","0","0","0"
"Harris","2020-03-12","2","2","0","0","0","0"
"Harris","2020-03-13","3","5","0","0","0","0"
"Harris","2020-03-14","0","5","0","0","0","0"
"Harris","2020-03-15","0","5","0","0","0","0"
"Harris","2020-03-16","2","7","0","0","0","0"
"Harris","2020-03-17","3","10","0","0","0","0"
"Harris","2020-03-18","2","12","0","0","0","0"
"Harris","2020-03-19","5","17","0","0","0","0"
"Harris","2020-03-20","8","25","0","0","0","0"
"Harris","2020-03-21","1","26","1","1","14.3","7.1"
"Harris","2020-03-22","2","28","0","1","14.3","7.1"
"Harris","2020-03-23","6","34","0","1","14.3","7.1"
"Harris","2020-03-24","11","45","2","3","16.9","8.4"
"Harris","2020-03-25","13","58","3","6","20.2","10.1"
"Harris","2020-03-26","14","72","1","7","21.2","10.6"
"Harris","2020-03-27","4","76","0","7","21.2","10.6"
"Harris","2020-03-28","2","78","0","7","6.9","10.6"
"Harris","2020-03-29","0","78","0","7","6.9","10.6"
"Harris","2020-03-30","11","89","1","8","8.2","11.2"
"Harris","2020-03-31","8","97","1","9","7.4","12.1"
"Harris","2020-04-01","16","113","2","11","5.9","13"
"Harris","2020-04-02","3","116","1","12","9.6","15.4"
"Harris","2020-04-03","4","120","0","12","9.6","15.4"
"Harris","2020-04-04","0","120","0","12","9.6","8.3"
"Harris","2020-04-05","1","121","0","12","9.6","8.3"
"Harris","2020-04-06","11","132","3","15","12.2","10.2"
"Harris","2020-04-07","8","140","2","17","14","10.7"
"Harris","2020-04-08","15","155","1","18","13.2","9.5"
"Harris","2020-04-09","13","168","1","19","9.5","9.6"
"Harris","2020-04-10","13","181","0","19","9.5","9.6"
"Harris","2020-04-11","5","186","0","19","9.5","9.6"
"Harris","2020-04-12","3","189","0","19","9.5","9.6"
"Harris","2020-04-13","24","213","1","20","6.2","9.2"
"Harris","2020-04-14","12","225","1","21","3.8","8.9"
"Harris","2020-04-15","17","242","1","22","3.7","8.5"
"Harris","2020-04-16","16","258","0","22","2.6","6.1"
"Harris","2020-04-17","20","278","2","24","4.1","6.8"
"Harris","2020-04-18","1","279","0","24","4.1","6.8"
"Harris","2020-04-19","2","281","0","24","4.1","6.8"
"Harris","2020-04-20","25","306","3","27","5.2","5.7"
"Harris","2020-04-21","24","330","5","32","7","5.4"
"Harris","2020-04-22","10","340","0","32","6.1","4.9"
"Harris","2020-04-23","3","343","0","32","6.1","4.4"
"Harris","2020-04-24","22","365","1","33","5.3","4.7"
"Harris","2020-04-25","5","370","0","33","5.3","4.7"
"Harris","2020-04-26","10","380","1","34","6.8","5.4"
"Harris","2020-04-27","18","398","1","35","5.8","5.5"
"Harris","2020-04-28","13","411","0","35","2.9","4.9"
"Harris","2020-04-29","12","423","0","35","2.9","4.5"
"Harris","2020-04-30","14","437","1","36","3.9","5"
"Harris","2020-05-01","10","447","0","36","3.2","4.3"
"Harris","2020-05-02","6","453","0","36","3.2","4.3"
"Harris","2020-05-03","3","456","0","36","1.8","4.3"
"Harris","2020-05-04","15","471","1","37","2","3.9"
"Harris","2020-05-05","22","493","0","37","2","2.4"
"Harris","2020-05-06","18","511","0","37","2","2.4"
"Harris","2020-05-07","22","533","3","40","2.9","3.4"
"Harris","2020-05-08","7","540","1","41","4.9","4.1"
"Harris","2020-05-09","2","542","1","42","12.1","7.7"
"Harris","2020-05-10","9","551","0","42","12.1","6.9"
"Harris","2020-05-11","27","578","3","45","12.7","7.3"
"Harris","2020-05-12","23","601","0","45","12.7","7.3"
"Harris","2020-05-13","19","620","0","45","12.7","7.3"
"Harris","2020-05-14","62","682","2","47","11.2","7.1"
"Harris","2020-05-15","55","737","3","50","10","7.5"
"Harris","2020-05-16","2","739","0","50","2.8","7.5"
"Harris","2020-05-17","13","752","0","50","2.8","7.5"
"Harris","2020-05-18","21","773","4","54","4","8.3"
"Harris","2020-05-19","36","809","2","56","4.8","8.7"
"Harris","2020-05-20","34","843","1","57","5.2","8.9"
"Harris","2020-05-21","48","891","2","59","5.3","8.3"
"Harris","2020-05-22","8","899","0","59","4.5","7.3"
"Harris","2020-05-23","1","900","0","59","4.5","3.7"
"Harris","2020-05-24","5","905","0","59","4.5","3.7"
"Harris","2020-05-25","9","914","0","59","1.8","2.9"
"Harris","2020-05-26","21","935","1","60","1.7","3.2"
"Harris","2020-05-27","26","961","0","60","1.3","3.2"
"Harris","2020-05-28","34","995","0","60","0.7","3"
"Harris","2020-05-29","41","1036","8","68","3.5","4"
"Harris","2020-05-30","12","1048","0","68","3.5","4"
"Harris","2020-05-31","13","1061","0","68","3.5","4"
"Harris","2020-06-01","37","1098","5","73","5.4","3.6"
"Harris","2020-06-02","64","1162","8","81","6.5","4.1"
"Harris","2020-06-03","47","1209","4","85","7.7","4.5"
"Harris","2020-06-04","46","1255","3","88","8.7","4.7"
"Harris","2020-06-05","54","1309","6","94","7.5","5.5"
"Harris","2020-06-06","7","1316","2","96","11.5","7.5"
"Harris","2020-06-07","14","1330","0","96","11.5","7.5"
"Harris","2020-06-08","47","1377","5","101","11.1","8.3"
"Harris","2020-06-09","67","1444","10","111","11.5","9"
"Harris","2020-06-10","53","1497","3","114","11.1","9.4"
"Harris","2020-06-11","81","1578","9","123","11.7","10.2"
"Harris","2020-06-12","64","1642","4","127","11","9.2"
"Harris","2020-06-13","6","1648","1","128","9.3","10.4"
"Harris","2020-06-14","9","1657","1","129","10.9","11.2"
"Harris","2020-06-15","86","1743","13","142","11.5","11.3"
"Harris","2020-06-16","75","1818","5","147","10.4","10.9"
"Harris","2020-06-17","73","1891","7","154","10.9","11"
"Harris","2020-06-18","59","1950","6","160","10.8","11.3"
"Harris","2020-06-19","92","2042","16","176","12.4","11.7"
"Harris","2020-06-20","18","2060","1","177","10.8","10.1"
"Harris","2020-06-21","8","2068","1","178","11","11"
"Harris","2020-06-22","102","2170","21","199","11.8","11.7"
"Harris","2020-06-23","76","2246","9","208","12.5","11.4"
"Harris","2020-06-24","54","2300","5","213","12.5","11.7"
"Harris","2020-06-25","79","2379","13","226","13.4","12.1"
"Harris","2020-06-26","105","2484","24","250","14.2","13.3"
"Harris","2020-06-27","16","2500","6","256","18.7","14.8"
"Harris","2020-06-28","21","2521","7","263","21.7","16.3"
"Harris","2020-06-29","110","2631","15","278","20.7","16.2"
"Harris","2020-06-30","95","2726","12","290","20.8","16.7"
"Harris","2020-07-01","107","2833","14","304","21.4","16.9"
"Harris","2020-07-02","64","2897","10","314","21.2","17.3"
"Harris","2020-07-03","33","2930","6","320","20.6","17.4"
"Harris","2020-07-04","20","2950","2","322","16.6","17.7"
"Harris","2020-07-05","31","2981","5","327","14.2","17.9"
"Harris","2020-07-06","60","3041","10","337","14.6","17.7"
"Harris","2020-07-07","51","3092","12","349","16.2","18.5"
"Harris","2020-07-08","204","3296","30","379","16.4","18.9"
"Harris","2020-07-09","121","3417","9","388","15.2","18.2"
"Harris","2020-07-10","55","3472","6","394","14.2","17.4"
"Harris","2020-07-11","216","3688","11","405","13.5","15.1"
"Harris","2020-07-12","7","3695","1","406","13.2","13.7"
"Harris","2020-07-13","92","3787","22","428","14.3","14.4"
"Harris","2020-07-14","69","3856","11","439","13.2","14.7"
"Harris","2020-07-15","75","3931","8","447","12.6","14.5"
"Harris","2020-07-16","71","4002","5","452","12.6","13.9"
"Harris","2020-07-17","50","4052","8","460","13.3","13.7"
"Harris","2020-07-18","9","4061","4","464","18.9","16.2"
"Harris","2020-07-19","8","4069","1","465","18.6","15.9"
"Harris","2020-07-20","43","4112","10","475","18.6","16.4"
"Harris","2020-07-21","45","4157","4","479","17.5","15.4"
"Harris","2020-07-22","66","4223","6","485","17.3","15"
"Harris","2020-07-23","86","4309","7","492","17.5","15"
"Harris","2020-07-24","26","4335","2","494","16.3","14.8"
"Harris","2020-07-25","35","4370","9","503","13.6","16.3"
"Harris","2020-07-26","16","4386","1","504","12.7","15.7"
"Harris","2020-07-27","58","4444","10","514","11.9","15.2"
"Harris","2020-07-28","69","4513","3","517","11.2","14.4"
"Harris","2020-07-29","65","4578","8","525","11.7","14.5"
"Harris","2020-07-30","60","4638","6","531","11.9","14.7"
"Harris","2020-07-31","63","4701","4","535","11.7","14"
"Harris","2020-08-01","20","4721","3","538","10.2","11.9"
"Harris","2020-08-02","11","4732","0","538","9.3","11"
"Harris","2020-08-03","31","4763","3","541","8.2","10"
"Harris","2020-08-04","46","4809","5","546","9.2","10.2"
"Harris","2020-08-05","34","4843","5","551","9.5","10.6"
"Harris","2020-08-06","56","4899","3","554","8.9","10.4"
"Harris","2020-08-07","26","4925","0","554","7.9","9.8"
"Harris","2020-08-08","18","4943","2","556","7.4","8.8"
"Harris","2020-08-09","6","4949","2","558","12.2","10.7"
"Harris","2020-08-10","49","4998","5","563","12.2","10.2"
"Harris","2020-08-11","56","5054","6","569","12.2","10.7"
"Harris","2020-08-12","61","5115","1","570","10.3","9.9"
"Harris","2020-08-13","52","5167","6","576","11.2","10"
"Harris","2020-08-14","26","5193","2","578","12.3","10.1"
"Harris","2020-08-15","15","5208","2","580","12.6","10"
"Harris","2020-08-16","14","5222","1","581","8.9","10.5"
"Harris","2020-08-17","22","5244","1","582","8.1","10.2"
"Harris","2020-08-18","36","5280","4","586","8.1","10.2"
"Harris","2020-08-19","46","5326","2","588","8.5","9.4"
"Harris","2020-08-20","45","5371","2","590","7.5","9.4"
"Harris","2020-08-21","37","5408","2","592","7.2","9.8"
"Harris","2020-08-22","20","5428","3","595","7.4","10"
"Harris","2020-08-23","15","5443","2","597","8.3","8.6"
"Harris","2020-08-24","35","5478","2","599","8.5","8.3"
"Harris","2020-08-25","40","5518","2","601","7.6","7.9"
"Harris","2020-08-26","56","5574","4","605","8","8.3"
"Harris","2020-08-27","40","5614","2","607","8.1","7.8"
"Harris","2020-08-28","26","5640","1","608","7.9","7.5"
"Harris","2020-08-29","12","5652","3","611","9.3","8.4"
"Harris","2020-08-30","13","5665","0","611","7.4","7.8"
"Harris","2020-08-31","41","5706","1","612","6.9","7.7"
"Harris","2020-09-01","49","5755","2","614","6.8","7.2"
"Harris","2020-09-02","47","5802","6","620","7.6","7.8"
"Harris","2020-09-03","42","5844","1","621","7.2","7.7"
"Harris","2020-09-04","57","5901","5","626","7.9","7.9"
"Harris","2020-09-05","12","5913","1","627","5.5","7.4"
"Harris","2020-09-06","6","5919","1","628","7.9","7.7"
"Harris","2020-09-07","12","5931","2","630","10","8.4"
"Harris","2020-09-08","45","5976","0","630","9.4","8.1"
"Harris","2020-09-09","64","6040","2","632","8","7.8"
"Harris","2020-09-10","31","6071","3","635","9","8.1"
"Harris","2020-09-11","30","6101","1","636","8.3","8.1"
"Harris","2020-09-12","13","6114","0","636","7.1","6.3"
"Harris","2020-09-13","7","6121","1","637","6.7","7.3"
"Harris","2020-09-14","22","6143","0","637","4.3","7.1"
"Harris","2020-09-15","53","6196","3","640","5.2","7.3"
"Harris","2020-09-16","25","6221","0","640","4.7","6.4"
"Harris","2020-09-17","32","6253","0","640","3.3","6.2"
"Harris","2020-09-18","24","6277","0","640","2.8","5.6"
"Harris","2020-09-19","8","6285","2","642","6.4","6.7"
"Harris","2020-09-20","12","6297","0","642","4.4","5.6"
"Harris","2020-09-21","32","6329","3","645","5.7","5"
"Harris","2020-09-22","33","6362","0","645","4.9","5"
"Harris","2020-09-23","27","6389","2","647","6","5.3"
"Harris","2020-09-24","30","6419","1","648","6.4","4.9"
"Harris","2020-09-25","25","6444","0","648","6.4","4.6"
"Harris","2020-09-26","18","6462","0","648","2.9","4.6"
"Harris","2020-09-27","5","6467","1","649","5.7","5.1"
"Harris","2020-09-28","23","6490","3","652","6.3","6"
"Harris","2020-09-29","39","6529","0","652","6.3","5.6"
"Harris","2020-09-30","39","6568","3","655","6.3","6.1"
"Harris","2020-10-01","30","6598","3","658","7.2","6.8"
"Harris","2020-10-02","31","6629","1","659","7.7","7.1"
"Harris","2020-10-03","12","6641","0","659","7.7","5.3"
"Harris","2020-10-04","21","6662","0","659","4.9","5.3"
"Harris","2020-10-05","32","6694","1","660","3.4","4.8"
"Harris","2020-10-06","56","6750","1","661","3.7","5"
"Harris","2020-10-07","50","6800","1","662","2.9","4.6"
"Harris","2020-10-08","37","6837","4","666","3","5.1"
"Harris","2020-10-09","46","6883","2","668","3.2","5.4"
"Harris","2020-10-10","18","6901","1","669","3.9","5.8"
"Harris","2020-10-11","14","6915","0","669","3.9","4.4"
"Harris","2020-10-12","27","6942","1","670","4","3.7"
"Harris","2020-10-13","39","6981","4","674","5.2","4.5"
"Harris","2020-10-14","42","7023","1","675","5.3","4.1"
"Harris","2020-10-15","38","7061","1","676","4.1","3.6"
"Harris","2020-10-16","29","7090","2","678","4.5","3.8"
"Harris","2020-10-17","6","7096","0","678","3.7","3.8"
"Harris","2020-10-18","15","7111","0","678","3.7","3.8"
"Harris","2020-10-19","28","7139","1","679","3.7","3.9"
"Harris","2020-10-20","47","7186","1","680","2.5","3.9"
"Harris","2020-10-21","38","7224","1","681","2.6","3.9"
"Harris","2020-10-22","36","7260","2","683","3","3.5"
"Harris","2020-10-23","28","7288","1","684","2.5","3.5"
"Harris","2020-10-24","7","7295","0","684","2.5","3.1"
"Harris","2020-10-25","9","7304","0","684","2.5","3.1"
"Harris","2020-10-26","26","7330","0","684","2","2.8"
"Harris","2020-10-27","46","7376","1","685","2","2.3"
"Harris","2020-10-28","39","7415","1","686","2","2.3"
"Harris","2020-10-29","38","7453","2","688","1.9","2.5"
"Harris","2020-10-30","31","7484","2","690","2.4","2.4"
"Harris","2020-10-31","7","7491","0","690","2.4","2.4"
"Harris","2020-11-01","8","7499","0","690","2.4","2.4"
"Harris","2020-11-02","18","7517","3","693","4.7","3.4"
"Harris","2020-11-03","33","7550","2","695","5.3","3.6"
"Harris","2020-11-04","28","7578","2","697","5.9","4"
"Harris","2020-11-05","57","7635","2","699","5.7","3.8"
"Harris","2020-11-06","28","7663","3","702","6.3","4.3"
"Harris","2020-11-07","20","7683","0","702","6.3","4.3"
"Harris","2020-11-08","13","7696","1","703","7.4","4.9"
"Harris","2020-11-09","26","7722","3","706","6.7","5.7"
"Harris","2020-11-10","47","7769","1","707","6.1","5.7"
"Harris","2020-11-11","42","7811","3","710","6.1","6"
"Harris","2020-11-12","46","7857","1","711","5.9","5.8"
"Harris","2020-11-13","50","7907","5","716","5.8","6.1"
"Harris","2020-11-14","13","7920","1","717","6.9","6.6"
"Harris","2020-11-15","10","7930","2","719","8.7","8"
"Harris","2020-11-16","55","7985","2","721","7.5","7.1"
"Harris","2020-11-17","43","8028","4","725","8.6","7.3"
"Harris","2020-11-18","50","8078","3","728","8.4","7.3"
"Harris","2020-11-19","48","8126","3","731","9","7.4"
"Harris","2020-11-20","31","8157","5","736","9.9","7.8"
"Harris","2020-11-21","64","8221","2","738","9.2","8.1"
"Harris","2020-11-22","20","8241","0","738","6.3","7.5"
"Harris","2020-11-23","40","8281","4","742","7.3","7.4"
"Harris","2020-11-24","24","8305","1","743","6.5","7.5"
"Harris","2020-11-25","62","8367","3","746","6.4","7.4"
"Harris","2020-11-26","4","8371","1","747","9","9"
"Harris","2020-11-27","38","8409","2","749","7.5","8.7"
"Harris","2020-11-28","18","8427","4","753","10.2","9.7"
"Harris","2020-11-29","13","8440","3","756","13.5","9.9"
"Harris","2020-11-30","47","8487","4","760","13.3","10.3"
"Harris","2020-12-01","48","8535","9","769","15.4","11"
"Harris","2020-12-02","55","8590","5","774","16","11.2"
"Harris","2020-12-03","44","8634","4","778","13.7","11.4"
"Harris","2020-12-04","27","8661","2","780","14","10.8"
"Harris","2020-12-05","28","8689","0","780","10.8","10.5"
"Harris","2020-12-06","20","8709","3","783","9.7","11.6"
"Harris","2020-12-07","47","8756","2","785","9.1","11.2"
"Harris","2020-12-08","62","8818","10","795","8.7","12"
"Harris","2020-12-09","56","8874","5","800","8.7","12.3"
"Harris","2020-12-10","66","8940","5","805","8.5","11.1"
"Harris","2020-12-11","52","8992","6","811","9.1","11.5"
"Harris","2020-12-12","37","9029","7","818","11.8","11.3"
"Harris","2020-12-13","26","9055","6","824","12.9","11.3"
"Harris","2020-12-14","66","9121","13","837","15.1","12.1"
"Harris","2020-12-15","86","9207","18","855","15.8","12.3"
"Harris","2020-12-16","55","9262","2","857","15.1","11.9"
"Harris","2020-12-17","100","9362","15","872","16.1","12.3"
"Harris","2020-12-18","71","9433","7","879","15.9","12.5"
"Harris","2020-12-19","37","9470","7","886","15.9","13.8"
"Harris","2020-12-20","26","9496","4","890","14.8","13.8"
"Harris","2020-12-21","60","9556","15","905","15.5","15.3"
"Harris","2020-12-22","85","9641","16","921","15.2","15.5"
"Harris","2020-12-23","75","9716","14","935","17.4","16.2"
"Harris","2020-12-24","118","9834","12","947","16.7","16.4"
"Harris","2020-12-25","4","9838","0","947","15.3","15.6"
"Harris","2020-12-26","38","9876","11","958","16.7","16.3"
"Harris","2020-12-27","50","9926","15","973","18.8","16.8"
"Harris","2020-12-28","81","10007","21","994","18.9","17.2"
"Harris","2020-12-29","118","10125","32","1026","20.1","17.7"
"Harris","2020-12-30","81","10206","23","1049","21.5","19.4"
"Harris","2020-12-31","96","10302","17","1066","22.6","19.6"
"Harris","2021-01-01","22","10324","3","1069","24.5","19.9"
"Harris","2021-01-02","24","10348","7","1076","24.6","20.6"
"Harris","2021-01-03","37","10385","11","1087","24.5","21.7"
"Harris","2021-01-04","71","10456","21","1108","25","22"
"Harris","2021-01-05","141","10597","38","1146","25","22.6"
"Harris","2021-01-06","101","10698","22","1168","24.1","22.8"
"Harris","2021-01-07","84","10782","21","1189","25.1","23.9"
"Harris","2021-01-08","105","10887","24","1213","26.4","25.5"
"Harris","2021-01-09","79","10966","4","1217","23","23.8"
"Harris","2021-01-10","18","10984","3","1220","21.1","22.8"
"Harris","2021-01-11","84","11068","21","1241","20.5","22.8"
"Harris","2021-01-12","89","11157","18","1259","19.5","22.3"
"Harris","2021-01-13","52","11209","13","1272","20","22"
"Harris","2021-01-14","61","11270","12","1284","19.2","22.2"
"Harris","2021-01-15","74","11344","16","1300","19","22.7"
"Harris","2021-01-16","39","11383","11","1311","22.3","22.7"
"Harris","2021-01-17","31","11414","11","1322","25","23.1"
"Harris","2021-01-18","48","11462","8","1330","23.8","22.2"
"Harris","2021-01-19","81","11543","21","1351","24.7","22.1"
"Harris","2021-01-20","72","11615","12","1363","23.5","21.7"
"Harris","2021-01-21","71","11686","6","1369","21.9","20.5"
"Harris","2021-01-22","75","11761","8","1377","20.3","19.7"
"Harris","2021-01-23","27","11788","10","1387","21.6","21.9"
"Harris","2021-01-24","9","11797","3","1390","21.2","23.1"
"Harris","2021-01-25","27","11824","4","1394","21","22.4"
"Harris","2021-01-26","1","11825","0","1394","17.3","21"
"Harris","2021-01-27","0","11825","0","1394","14.9","19.2"
"Hart","2020-02-01","0","0","0","0",".","."
"Hart","2020-02-02","0","0","0","0",".","."
"Hart","2020-02-03","0","0","0","0",".","."
"Hart","2020-02-04","0","0","0","0",".","."
"Hart","2020-02-05","0","0","0","0",".","."
"Hart","2020-02-06","0","0","0","0",".","."
"Hart","2020-02-07","0","0","0","0","0","."
"Hart","2020-02-08","0","0","0","0","0","."
"Hart","2020-02-09","0","0","0","0","0","."
"Hart","2020-02-10","0","0","0","0","0","."
"Hart","2020-02-11","0","0","0","0","0","."
"Hart","2020-02-12","0","0","0","0","0","."
"Hart","2020-02-13","0","0","0","0","0","."
"Hart","2020-02-14","0","0","0","0","0","0"
"Hart","2020-02-15","0","0","0","0","0","0"
"Hart","2020-02-16","0","0","0","0","0","0"
"Hart","2020-02-17","0","0","0","0","0","0"
"Hart","2020-02-18","0","0","0","0","0","0"
"Hart","2020-02-19","0","0","0","0","0","0"
"Hart","2020-02-20","0","0","0","0","0","0"
"Hart","2020-02-21","0","0","0","0","0","0"
"Hart","2020-02-22","0","0","0","0","0","0"
"Hart","2020-02-23","0","0","0","0","0","0"
"Hart","2020-02-24","0","0","0","0","0","0"
"Hart","2020-02-25","0","0","0","0","0","0"
"Hart","2020-02-26","0","0","0","0","0","0"
"Hart","2020-02-27","0","0","0","0","0","0"
"Hart","2020-02-28","0","0","0","0","0","0"
"Hart","2020-02-29","0","0","0","0","0","0"
"Hart","2020-03-01","0","0","0","0","0","0"
"Hart","2020-03-02","0","0","0","0","0","0"
"Hart","2020-03-03","0","0","0","0","0","0"
"Hart","2020-03-04","0","0","0","0","0","0"
"Hart","2020-03-05","0","0","0","0","0","0"
"Hart","2020-03-06","0","0","0","0","0","0"
"Hart","2020-03-07","0","0","0","0","0","0"
"Hart","2020-03-08","0","0","0","0","0","0"
"Hart","2020-03-09","0","0","0","0","0","0"
"Hart","2020-03-10","0","0","0","0","0","0"
"Hart","2020-03-11","0","0","0","0","0","0"
"Hart","2020-03-12","0","0","0","0","0","0"
"Hart","2020-03-13","0","0","0","0","0","0"
"Hart","2020-03-14","0","0","0","0","0","0"
"Hart","2020-03-15","0","0","0","0","0","0"
"Hart","2020-03-16","3","3","0","0","0","0"
"Hart","2020-03-17","2","5","0","0","0","0"
"Hart","2020-03-18","2","7","0","0","0","0"
"Hart","2020-03-19","3","10","0","0","0","0"
"Hart","2020-03-20","3","13","1","1","4.8","2.4"
"Hart","2020-03-21","0","13","0","1","4.8","2.4"
"Hart","2020-03-22","0","13","0","1","4.8","2.4"
"Hart","2020-03-23","3","16","0","1","4.8","2.4"
"Hart","2020-03-24","5","21","1","2","7.6","3.8"
"Hart","2020-03-25","5","26","0","2","7.6","3.8"
"Hart","2020-03-26","11","37","0","2","7.6","3.8"
"Hart","2020-03-27","4","41","0","2","2.9","3.8"
"Hart","2020-03-28","12","53","0","2","2.9","3.8"
"Hart","2020-03-29","11","64","0","2","2.9","3.8"
"Hart","2020-03-30","5","69","0","2","2.9","3.8"
"Hart","2020-03-31","5","74","0","2","0","3.8"
"Hart","2020-04-01","9","83","0","2","0","3.8"
"Hart","2020-04-02","3","86","0","2","0","3.8"
"Hart","2020-04-03","4","90","0","2","0","1.4"
"Hart","2020-04-04","1","91","0","2","0","1.4"
"Hart","2020-04-05","0","91","0","2","0","1.4"
"Hart","2020-04-06","4","95","0","2","0","1.4"
"Hart","2020-04-07","2","97","2","4","14.3","7.1"
"Hart","2020-04-08","6","103","0","4","14.3","7.1"
"Hart","2020-04-09","2","105","0","4","14.3","7.1"
"Hart","2020-04-10","5","110","1","5","17.1","8.6"
"Hart","2020-04-11","0","110","0","5","17.1","8.6"
"Hart","2020-04-12","0","110","0","5","17.1","8.6"
"Hart","2020-04-13","4","114","0","5","17.1","8.6"
"Hart","2020-04-14","4","118","0","5","2.9","8.6"
"Hart","2020-04-15","6","124","1","6","5.2","9.8"
"Hart","2020-04-16","6","130","0","6","5.2","9.8"
"Hart","2020-04-17","5","135","0","6","2.4","9.8"
"Hart","2020-04-18","2","137","0","6","2.4","9.8"
"Hart","2020-04-19","3","140","0","6","2.4","9.8"
"Hart","2020-04-20","3","143","0","6","2.4","9.8"
"Hart","2020-04-21","7","150","1","7","4.4","3.6"
"Hart","2020-04-22","2","152","0","7","2","3.6"
"Hart","2020-04-23","4","156","1","8","5.6","5.4"
"Hart","2020-04-24","14","170","0","8","5.6","4"
"Hart","2020-04-25","0","170","0","8","5.6","4"
"Hart","2020-04-26","1","171","0","8","5.6","4"
"Hart","2020-04-27","16","187","0","8","5.6","4"
"Hart","2020-04-28","10","197","0","8","3.6","4"
"Hart","2020-04-29","10","207","2","10","6.4","4.2"
"Hart","2020-04-30","11","218","1","11","4.2","4.9"
"Hart","2020-05-01","11","229","0","11","4.2","4.9"
"Hart","2020-05-02","3","232","0","11","4.2","4.9"
"Hart","2020-05-03","2","234","0","11","4.2","4.9"
"Hart","2020-05-04","7","241","0","11","4.2","4.9"
"Hart","2020-05-05","7","248","1","12","6.2","4.9"
"Hart","2020-05-06","6","254","1","13","5.7","6.1"
"Hart","2020-05-07","5","259","1","14","7.3","5.7"
"Hart","2020-05-08","6","265","0","14","7.3","5.7"
"Hart","2020-05-09","4","269","0","14","7.3","5.7"
"Hart","2020-05-10","3","272","0","14","7.3","5.7"
"Hart","2020-05-11","8","280","0","14","7.3","5.7"
"Hart","2020-05-12","9","289","0","14","5.2","5.7"
"Hart","2020-05-13","10","299","0","14","2.9","4.3"
"Hart","2020-05-14","14","313","1","15","1","4.1"
"Hart","2020-05-15","14","327","0","15","1","4.1"
"Hart","2020-05-16","3","330","0","15","1","4.1"
"Hart","2020-05-17","27","357","4","19","3.1","5.2"
"Hart","2020-05-18","10","367","0","19","3.1","5.2"
"Hart","2020-05-19","14","381","4","23","7.2","6.2"
"Hart","2020-05-20","14","395","0","23","7.2","5"
"Hart","2020-05-21","5","400","0","23","6.2","3.6"
"Hart","2020-05-22","17","417","0","23","6.2","3.6"
"Hart","2020-05-23","1","418","0","23","6.2","3.6"
"Hart","2020-05-24","4","422","0","23","4.1","3.6"
"Hart","2020-05-25","2","424","0","23","4.1","3.6"
"Hart","2020-05-26","13","437","1","24","1.1","4.2"
"Hart","2020-05-27","13","450","1","25","2.2","4.7"
"Hart","2020-05-28","3","453","0","25","2.2","4.2"
"Hart","2020-05-29","8","461","0","25","2.2","4.2"
"Hart","2020-05-30","6","467","0","25","2.2","4.2"
"Hart","2020-05-31","5","472","0","25","2.2","3.1"
"Hart","2020-06-01","8","480","0","25","2.2","3.1"
"Hart","2020-06-02","17","497","0","25","1.1","1.1"
"Hart","2020-06-03","14","511","0","25","0","1.1"
"Hart","2020-06-04","7","518","0","25","0","1.1"
"Hart","2020-06-05","10","528","0","25","0","1.1"
"Hart","2020-06-06","3","531","0","25","0","1.1"
"Hart","2020-06-07","3","534","0","25","0","1.1"
"Hart","2020-06-08","9","543","0","25","0","1.1"
"Hart","2020-06-09","8","551","3","28","5.4","3.2"
"Hart","2020-06-10","5","556","0","28","5.4","2.7"
"Hart","2020-06-11","8","564","1","29","7.1","3.6"
"Hart","2020-06-12","8","572","3","32","12.5","6.3"
"Hart","2020-06-13","3","575","1","33","17.3","8.6"
"Hart","2020-06-14","2","577","0","33","17.3","8.6"
"Hart","2020-06-15","7","584","0","33","17.3","8.6"
"Hart","2020-06-16","11","595","2","35","14.5","9.9"
"Hart","2020-06-17","9","604","1","36","16.1","10.7"
"Hart","2020-06-18","12","616","1","37","15.5","11.3"
"Hart","2020-06-19","12","628","2","39","12.5","12.5"
"Hart","2020-06-20","7","635","3","42","13.9","15.6"
"Hart","2020-06-21","2","637","0","42","13.9","15.6"
"Hart","2020-06-22","8","645","1","43","15.7","16.5"
"Hart","2020-06-23","12","657","2","45","15.4","15"
"Hart","2020-06-24","19","676","8","53","19.9","18"
"Hart","2020-06-25","21","697","2","55","20","17.8"
"Hart","2020-06-26","22","719","4","59","20.3","16.4"
"Hart","2020-06-27","7","726","0","59","14.1","14"
"Hart","2020-06-28","12","738","1","60","15.3","14.6"
"Hart","2020-06-29","20","758","2","62","15","15.3"
"Hart","2020-06-30","14","772","4","66","16.7","16.1"
"Hart","2020-07-01","19","791","6","72","15.2","17.5"
"Hart","2020-07-02","12","803","1","73","15","17.5"
"Hart","2020-07-03","6","809","0","73","12.4","16.3"
"Hart","2020-07-04","7","816","1","74","14.4","14.3"
"Hart","2020-07-05","6","822","1","75","15.6","15.5"
"Hart","2020-07-06","17","839","6","81","19.2","17.1"
"Hart","2020-07-07","24","863","3","84","17","16.8"
"Hart","2020-07-08","16","879","2","86","14.2","14.7"
"Hart","2020-07-09","31","910","8","94","16.7","15.9"
"Hart","2020-07-10","24","934","2","96","17.9","15.2"
"Hart","2020-07-11","9","943","2","98","19","16.7"
"Hart","2020-07-12","15","958","4","102","20.5","18.1"
"Hart","2020-07-13","17","975","3","105","18","18.6"
"Hart","2020-07-14","18","993","2","107","17.8","17.4"
"Hart","2020-07-15","29","1022","6","113","18.9","16.6"
"Hart","2020-07-16","22","1044","2","115","16.5","16.6"
"Hart","2020-07-17","19","1063","4","119","18.4","18.1"
"Hart","2020-07-18","2","1065","0","119","15.2","17.1"
"Hart","2020-07-19","5","1070","3","122","19.9","20.2"
"Hart","2020-07-20","12","1082","2","124","19.8","18.9"
"Hart","2020-07-21","15","1097","4","128","22","19.9"
"Hart","2020-07-22","33","1130","4","132","20.8","19.9"
"Hart","2020-07-23","12","1142","5","137","25.5","21"
"Hart","2020-07-24","15","1157","3","140","25.3","21.8"
"Hart","2020-07-25","22","1179","10","150","31.8","23.5"
"Hart","2020-07-26","4","1183","0","150","23.2","21.6"
"Hart","2020-07-27","17","1200","2","152","22.5","21.2"
"Hart","2020-07-28","25","1225","6","158","22.1","22.1"
"Hart","2020-07-29","28","1253","12","170","26.5","23.7"
"Hart","2020-07-30","10","1263","1","171","22","23.7"
"Hart","2020-07-31","42","1305","3","174","20.2","22.7"
"Hart","2020-08-01","19","1324","6","180","18.2","25"
"Hart","2020-08-02","10","1334","1","181","19.6","21.4"
"Hart","2020-08-03","31","1365","6","187","20.7","21.6"
"Hart","2020-08-04","18","1383","5","192","21.2","21.7"
"Hart","2020-08-05","18","1401","0","192","15.1","20.8"
"Hart","2020-08-06","8","1409","1","193","15.5","18.7"
"Hart","2020-08-07","13","1422","1","194","15.6","17.9"
"Hart","2020-08-08","6","1428","0","194","11","14.6"
"Hart","2020-08-09","3","1431","0","194","9.6","14.6"
"Hart","2020-08-10","20","1451","6","200","11.1","15.9"
"Hart","2020-08-11","14","1465","2","202","9.2","15.2"
"Hart","2020-08-12","8","1473","0","202","9.2","12.2"
"Hart","2020-08-13","18","1491","2","204","9","12.2"
"Hart","2020-08-14","9","1500","1","205","9.5","12.5"
"Hart","2020-08-15","1","1501","0","205","9.5","10.3"
"Hart","2020-08-16","3","1504","0","205","9.5","9.6"
"Hart","2020-08-17","20","1524","2","207","6.6","8.9"
"Hart","2020-08-18","16","1540","2","209","6.4","7.8"
"Hart","2020-08-19","19","1559","2","211","7.9","8.6"
"Hart","2020-08-20","5","1564","2","213","12","10.5"
"Hart","2020-08-21","16","1580","3","216","13.1","11.3"
"Hart","2020-08-22","5","1585","1","217","16","12.7"
"Hart","2020-08-23","1","1586","0","217","16","12.7"
"Hart","2020-08-24","16","1602","1","218","15.4","11"
"Hart","2020-08-25","13","1615","0","218","13.6","10"
"Hart","2020-08-26","11","1626","3","221","16","12"
"Hart","2020-08-27","11","1637","4","225","15.5","13.8"
"Hart","2020-08-28","20","1657","4","229","15.7","14.4"
"Hart","2020-08-29","2","1659","1","230","20","18"
"Hart","2020-08-30","4","1663","1","231","23.6","19.8"
"Hart","2020-08-31","19","1682","0","231","22.7","19"
"Hart","2020-09-01","12","1694","4","235","27.4","20.5"
"Hart","2020-09-02","22","1716","4","239","26.1","21.1"
"Hart","2020-09-03","8","1724","0","239","20.9","18.2"
"Hart","2020-09-04","10","1734","0","239","18.1","16.9"
"Hart","2020-09-05","15","1749","2","241","12.8","16.4"
"Hart","2020-09-06","8","1757","1","242","11","17.3"
"Hart","2020-09-07","9","1766","1","243","12.6","17.6"
"Hart","2020-09-08","25","1791","0","243","7.9","17.6"
"Hart","2020-09-09","29","1820","2","245","6.3","16.2"
"Hart","2020-09-10","13","1833","1","246","7.4","14.1"
"Hart","2020-09-11","19","1852","3","249","9.6","13.8"
"Hart","2020-09-12","1","1853","1","250","22","17.4"
"Hart","2020-09-13","6","1859","1","251","22.6","16.8"
"Hart","2020-09-14","13","1872","2","253","23.2","17.9"
"Hart","2020-09-15","15","1887","1","254","24.2","16"
"Hart","2020-09-16","16","1903","2","256","25","15.6"
"Hart","2020-09-17","14","1917","2","258","25.9","16.6"
"Hart","2020-09-18","16","1933","1","259","24.5","17.1"
"Hart","2020-09-19","4","1937","0","259","10.3","16.1"
"Hart","2020-09-20","5","1942","2","261","13.6","18.1"
"Hart","2020-09-21","20","1962","1","262","12.1","17.7"
"Hart","2020-09-22","11","1973","1","263","12.4","18.3"
"Hart","2020-09-23","14","1987","2","265","12.7","18.8"
"Hart","2020-09-24","12","1999","2","267","13","19.5"
"Hart","2020-09-25","10","2009","1","268","13.6","19.1"
"Hart","2020-09-26","2","2011","0","268","13.6","11.9"
"Hart","2020-09-27","4","2015","1","269","11.4","12.5"
"Hart","2020-09-28","17","2032","1","270","11.6","11.8"
"Hart","2020-09-29","13","2045","0","270","10.3","11.4"
"Hart","2020-09-30","18","2063","0","270","8.2","10.5"
"Hart","2020-10-01","9","2072","1","271","7.4","10.2"
"Hart","2020-10-02","11","2083","0","271","6","9.8"
"Hart","2020-10-03","17","2100","1","272","6.8","10.2"
"Hart","2020-10-04","3","2103","0","272","3.3","7.4"
"Hart","2020-10-05","11","2114","0","272","2.4","7"
"Hart","2020-10-06","16","2130","1","273","3.3","6.8"
"Hart","2020-10-07","13","2143","2","275","5.5","6.9"
"Hart","2020-10-08","16","2159","0","275","3.9","5.7"
"Hart","2020-10-09","24","2183","1","276","4.5","5.3"
"Hart","2020-10-10","15","2198","3","279","6.5","6.7"
"Hart","2020-10-11","2","2200","0","279","6.5","4.9"
"Hart","2020-10-12","15","2215","1","280","7.5","5"
"Hart","2020-10-13","19","2234","2","282","8.1","5.7"
"Hart","2020-10-14","14","2248","0","282","5.9","5.7"
"Hart","2020-10-15","20","2268","0","282","5.9","4.9"
"Hart","2020-10-16","24","2292","4","286","7.7","6.1"
"Hart","2020-10-17","1","2293","0","286","4.8","5.7"
"Hart","2020-10-18","3","2296","1","287","9.6","8.1"
"Hart","2020-10-19","13","2309","0","287","8.6","8.1"
"Hart","2020-10-20","15","2324","0","287","7.1","7.6"
"Hart","2020-10-21","30","2354","4","291","9","7.5"
"Hart","2020-10-22","17","2371","1","292","9.9","7.9"
"Hart","2020-10-23","21","2392","2","294","8.9","8.3"
"Hart","2020-10-24","11","2403","3","297","12.8","8.8"
"Hart","2020-10-25","6","2409","2","299","12.8","11.2"
"Hart","2020-10-26","22","2431","3","302","14.7","11.7"
"Hart","2020-10-27","26","2457","6","308","18","12.6"
"Hart","2020-10-28","23","2480","5","313","19.2","14.1"
"Hart","2020-10-29","16","2496","1","314","19.3","14.6"
"Hart","2020-10-30","8","2504","1","315","19.7","14.3"
"Hart","2020-10-31","10","2514","0","315","15.8","14.3"
"Hart","2020-11-01","8","2522","0","315","11","11.9"
"Hart","2020-11-02","18","2540","2","317","10.7","12.7"
"Hart","2020-11-03","15","2555","2","319","9.3","13.6"
"Hart","2020-11-04","24","2579","4","323","8.6","13.9"
"Hart","2020-11-05","23","2602","3","326","9.5","14.4"
"Hart","2020-11-06","28","2630","4","330","9.8","14.7"
"Hart","2020-11-07","17","2647","9","339","17.3","16.6"
"Hart","2020-11-08","12","2659","3","342","20.9","16"
"Hart","2020-11-09","17","2676","1","343","20.2","15.4"
"Hart","2020-11-10","27","2703","2","345","19.3","14.3"
"Hart","2020-11-11","22","2725","0","345","16.9","12.7"
"Hart","2020-11-12","25","2750","6","351","18.5","14"
"Hart","2020-11-13","30","2780","4","355","18.4","14.1"
"Hart","2020-11-14","17","2797","5","360","15","16.2"
"Hart","2020-11-15","19","2816","0","360","11.4","16.2"
"Hart","2020-11-16","45","2861","6","366","12.5","16.3"
"Hart","2020-11-17","17","2878","2","368","13.1","16.2"
"Hart","2020-11-18","28","2906","2","370","14.1","15.5"
"Hart","2020-11-19","37","2943","4","374","12.3","15.4"
"Hart","2020-11-20","22","2965","4","378","12.9","15.7"
"Hart","2020-11-21","16","2981","3","381","11.4","13.2"
"Hart","2020-11-22","9","2990","2","383","14.6","13"
"Hart","2020-11-23","32","3022","2","385","13.6","13"
"Hart","2020-11-24","33","3055","4","389","13.6","13.4"
"Hart","2020-11-25","26","3081","5","394","15.4","14.8"
"Hart","2020-11-26","6","3087","1","395","16.2","14.2"
"Hart","2020-11-27","24","3111","2","397","14.8","13.9"
"Hart","2020-11-28","9","3120","3","400","16.9","14.2"
"Hart","2020-11-29","15","3135","5","405","18.5","16.5"
"Hart","2020-11-30","38","3173","10","415","21.3","17.5"
"Hart","2020-12-01","33","3206","6","421","22.2","17.9"
"Hart","2020-12-02","33","3239","4","425","21.2","18.3"
"Hart","2020-12-03","48","3287","8","433","21.2","18.7"
"Hart","2020-12-04","51","3338","7","440","22","18.4"
"Hart","2020-12-05","28","3366","11","451","22.8","19.8"
"Hart","2020-12-06","16","3382","3","454","20.7","19.6"
"Hart","2020-12-07","51","3433","11","465","20","20.7"
"Hart","2020-12-08","60","3493","7","472","19.1","20.7"
"Hart","2020-12-09","56","3549","9","481","19.7","20.4"
"Hart","2020-12-10","46","3595","12","493","21","21.1"
"Hart","2020-12-11","49","3644","10","503","22","22"
"Hart","2020-12-12","32","3676","6","509","19","20.9"
"Hart","2020-12-13","13","3689","7","516","24.1","22.4"
"Hart","2020-12-14","54","3743","12","528","24.2","22.1"
"Hart","2020-12-15","52","3795","14","542","26.3","22.7"
"Hart","2020-12-16","53","3848","11","553","27","23.3"
"Hart","2020-12-17","54","3902","10","563","25.9","23.5"
"Hart","2020-12-18","76","3978","16","579","26","24"
"Hart","2020-12-19","35","4013","14","593","29","24"
"Hart","2020-12-20","26","4039","15","608","29.6","26.8"
"Hart","2020-12-21","62","4101","17","625","30.3","27.2"
"Hart","2020-12-22","74","4175","13","638","29","27.7"
"Hart","2020-12-23","76","4251","24","662","30.5","28.8"
"Hart","2020-12-24","36","4287","12","674","32.7","29.3"
"Hart","2020-12-25","3","4290","0","674","29.7","27.8"
"Hart","2020-12-26","19","4309","6","680","28.5","28.7"
"Hart","2020-12-27","28","4337","10","690","25.3","27.5"
"Hart","2020-12-28","180","4517","30","720","23.8","27.1"
"Hart","2020-12-29","120","4637","29","749","24.7","26.9"
"Hart","2020-12-30","82","4719","34","783","26.1","28.3"
"Hart","2020-12-31","134","4853","28","811","24.4","28.5"
"Hart","2021-01-01","9","4862","1","812","25.9","27.8"
"Hart","2021-01-02","20","4882","8","820","27.1","27.8"
"Hart","2021-01-03","31","4913","14","834","28.5","26.9"
"Hart","2021-01-04","76","4989","22","856","30.2","27"
"Hart","2021-01-05","91","5080","18","874","29.6","27.2"
"Hart","2021-01-06","71","5151","10","884","25.7","25.9"
"Hart","2021-01-07","71","5222","17","901","26.1","25.3"
"Hart","2021-01-08","65","5287","17","918","28.3","27.1"
"Hart","2021-01-09","70","5357","10","928","24.6","25.9"
"Hart","2021-01-10","34","5391","13","941","23.6","26.1"
"Hart","2021-01-11","69","5460","15","956","22.6","26.4"
"Hart","2021-01-12","65","5525","16","972","23.3","26.5"
"Hart","2021-01-13","84","5609","15","987","23.8","24.8"
"Hart","2021-01-14","48","5657","5","992","21.9","24"
"Hart","2021-01-15","41","5698","10","1002","21.6","25"
"Hart","2021-01-16","38","5736","17","1019","26","25.3"
"Hart","2021-01-17","20","5756","2","1021","22","22.8"
"Hart","2021-01-18","47","5803","10","1031","21.9","22.3"
"Hart","2021-01-19","91","5894","9","1040","19.8","21.5"
"Hart","2021-01-20","41","5935","7","1047","19.7","21.8"
"Hart","2021-01-21","49","5984","13","1060","22","21.9"
"Hart","2021-01-22","51","6035","13","1073","22.1","21.9"
"Hart","2021-01-23","22","6057","4","1077","18.3","22.2"
"Hart","2021-01-24","5","6062","2","1079","22.6","22.3"
"Hart","2021-01-25","9","6071","0","1079","19.6","20.7"
"Hart","2021-01-26","3","6074","1","1080","22.9","21.4"
"Hart","2021-01-27","0","6074","0","1080","20.5","20.1"
"Heard","2020-02-01","0","0","0","0",".","."
"Heard","2020-02-02","0","0","0","0",".","."
"Heard","2020-02-03","0","0","0","0",".","."
"Heard","2020-02-04","0","0","0","0",".","."
"Heard","2020-02-05","0","0","0","0",".","."
"Heard","2020-02-06","0","0","0","0",".","."
"Heard","2020-02-07","0","0","0","0","0","."
"Heard","2020-02-08","0","0","0","0","0","."
"Heard","2020-02-09","0","0","0","0","0","."
"Heard","2020-02-10","0","0","0","0","0","."
"Heard","2020-02-11","0","0","0","0","0","."
"Heard","2020-02-12","0","0","0","0","0","."
"Heard","2020-02-13","0","0","0","0","0","."
"Heard","2020-02-14","0","0","0","0","0","0"
"Heard","2020-02-15","0","0","0","0","0","0"
"Heard","2020-02-16","0","0","0","0","0","0"
"Heard","2020-02-17","0","0","0","0","0","0"
"Heard","2020-02-18","0","0","0","0","0","0"
"Heard","2020-02-19","0","0","0","0","0","0"
"Heard","2020-02-20","0","0","0","0","0","0"
"Heard","2020-02-21","0","0","0","0","0","0"
"Heard","2020-02-22","0","0","0","0","0","0"
"Heard","2020-02-23","0","0","0","0","0","0"
"Heard","2020-02-24","0","0","0","0","0","0"
"Heard","2020-02-25","0","0","0","0","0","0"
"Heard","2020-02-26","0","0","0","0","0","0"
"Heard","2020-02-27","0","0","0","0","0","0"
"Heard","2020-02-28","0","0","0","0","0","0"
"Heard","2020-02-29","0","0","0","0","0","0"
"Heard","2020-03-01","0","0","0","0","0","0"
"Heard","2020-03-02","0","0","0","0","0","0"
"Heard","2020-03-03","0","0","0","0","0","0"
"Heard","2020-03-04","0","0","0","0","0","0"
"Heard","2020-03-05","0","0","0","0","0","0"
"Heard","2020-03-06","0","0","0","0","0","0"
"Heard","2020-03-07","0","0","0","0","0","0"
"Heard","2020-03-08","0","0","0","0","0","0"
"Heard","2020-03-09","0","0","0","0","0","0"
"Heard","2020-03-10","0","0","0","0","0","0"
"Heard","2020-03-11","0","0","0","0","0","0"
"Heard","2020-03-12","2","2","0","0","0","0"
"Heard","2020-03-13","1","3","0","0","0","0"
"Heard","2020-03-14","1","4","0","0","0","0"
"Heard","2020-03-15","5","9","3","3","8.6","4.3"
"Heard","2020-03-16","1","10","0","3","8.6","4.3"
"Heard","2020-03-17","0","10","0","3","8.6","4.3"
"Heard","2020-03-18","2","12","0","3","8.6","4.3"
"Heard","2020-03-19","2","14","0","3","8.6","4.3"
"Heard","2020-03-20","0","14","0","3","8.6","4.3"
"Heard","2020-03-21","0","14","0","3","8.6","4.3"
"Heard","2020-03-22","0","14","0","3","0","4.3"
"Heard","2020-03-23","1","15","0","3","0","4.3"
"Heard","2020-03-24","4","19","0","3","0","4.3"
"Heard","2020-03-25","4","23","0","3","0","4.3"
"Heard","2020-03-26","1","24","0","3","0","4.3"
"Heard","2020-03-27","6","30","0","3","0","4.3"
"Heard","2020-03-28","1","31","0","3","0","4.3"
"Heard","2020-03-29","2","33","0","3","0","0"
"Heard","2020-03-30","0","33","0","3","0","0"
"Heard","2020-03-31","5","38","0","3","0","0"
"Heard","2020-04-01","2","40","0","3","0","0"
"Heard","2020-04-02","3","43","0","3","0","0"
"Heard","2020-04-03","1","44","0","3","0","0"
"Heard","2020-04-04","2","46","0","3","0","0"
"Heard","2020-04-05","1","47","0","3","0","0"
"Heard","2020-04-06","1","48","0","3","0","0"
"Heard","2020-04-07","5","53","0","3","0","0"
"Heard","2020-04-08","1","54","0","3","0","0"
"Heard","2020-04-09","2","56","1","4","7.1","3.6"
"Heard","2020-04-10","0","56","0","4","7.1","3.6"
"Heard","2020-04-11","1","57","1","5","21.4","10.7"
"Heard","2020-04-12","0","57","0","5","21.4","10.7"
"Heard","2020-04-13","0","57","0","5","21.4","10.7"
"Heard","2020-04-14","1","58","1","6","35.7","17.9"
"Heard","2020-04-15","1","59","0","6","35.7","17.9"
"Heard","2020-04-16","3","62","1","7","33.3","20.2"
"Heard","2020-04-17","2","64","0","7","33.3","20.2"
"Heard","2020-04-18","6","70","0","7","19","20.2"
"Heard","2020-04-19","0","70","0","7","19","20.2"
"Heard","2020-04-20","4","74","1","8","22.6","22"
"Heard","2020-04-21","3","77","0","8","8.3","22"
"Heard","2020-04-22","3","80","1","9","13.1","24.4"
"Heard","2020-04-23","15","95","0","9","8.3","20.8"
"Heard","2020-04-24","0","95","0","9","8.3","20.8"
"Heard","2020-04-25","6","101","0","9","8.3","13.7"
"Heard","2020-04-26","1","102","0","9","8.3","13.7"
"Heard","2020-04-27","3","105","0","9","4.8","13.7"
"Heard","2020-04-28","7","112","0","9","4.8","6.5"
"Heard","2020-04-29","9","121","1","10","1.6","7.3"
"Heard","2020-04-30","8","129","3","13","6.9","7.6"
"Heard","2020-05-01","16","145","0","13","6.9","7.6"
"Heard","2020-05-02","7","152","1","14","9","8.7"
"Heard","2020-05-03","2","154","0","14","9","8.7"
"Heard","2020-05-04","7","161","0","14","9","6.9"
"Heard","2020-05-05","6","167","0","14","9","6.9"
"Heard","2020-05-06","8","175","0","14","7.4","4.5"
"Heard","2020-05-07","11","186","1","15","3.3","5.1"
"Heard","2020-05-08","8","194","1","16","5.1","6"
"Heard","2020-05-09","3","197","1","17","7.8","8.4"
"Heard","2020-05-10","1","198","0","17","7.8","8.4"
"Heard","2020-05-11","28","226","0","17","7.8","8.4"
"Heard","2020-05-12","8","234","1","18","9.6","9.3"
"Heard","2020-05-13","20","254","1","19","10.3","8.9"
"Heard","2020-05-14","16","270","4","23","12.6","8"
"Heard","2020-05-15","9","279","1","24","12.4","8.8"
"Heard","2020-05-16","14","293","1","25","8.7","8.3"
"Heard","2020-05-17","3","296","0","25","8.7","8.3"
"Heard","2020-05-18","15","311","0","25","8.7","8.3"
"Heard","2020-05-19","24","335","1","26","7.5","8.6"
"Heard","2020-05-20","11","346","1","27","8.1","9.2"
"Heard","2020-05-21","13","359","1","28","5.6","9.1"
"Heard","2020-05-22","9","368","1","29","5.6","9"
"Heard","2020-05-23","2","370","0","29","4.6","6.6"
"Heard","2020-05-24","5","375","0","29","4.6","6.6"
"Heard","2020-05-25","6","381","1","30","7","7.8"
"Heard","2020-05-26","10","391","2","32","9.2","8.4"
"Heard","2020-05-27","10","401","1","33","9.4","8.7"
"Heard","2020-05-28","12","413","1","34","9.4","7.5"
"Heard","2020-05-29","12","425","0","34","7.9","6.7"
"Heard","2020-05-30","7","432","1","35","9.9","7.2"
"Heard","2020-05-31","0","432","0","35","9.9","7.2"
"Heard","2020-06-01","5","437","1","36","10.4","8.7"
"Heard","2020-06-02","12","449","0","36","7.5","8.4"
"Heard","2020-06-03","14","463","0","36","6.1","7.7"
"Heard","2020-06-04","8","471","0","36","4.9","7.2"
"Heard","2020-06-05","13","484","2","38","7.1","7.5"
"Heard","2020-06-06","14","498","2","40","7.1","8.5"
"Heard","2020-06-07","2","500","0","40","7.1","8.5"
"Heard","2020-06-08","17","517","1","41","5.1","7.7"
"Heard","2020-06-09","14","531","1","42","6.1","6.8"
"Heard","2020-06-10","11","542","1","43","7.4","6.7"
"Heard","2020-06-11","9","551","1","44","9","6.9"
"Heard","2020-06-12","15","566","1","45","7.7","7.4"
"Heard","2020-06-13","1","567","0","45","5.7","6.4"
"Heard","2020-06-14","1","568","0","45","5.7","6.4"
"Heard","2020-06-15","11","579","0","45","4.9","5"
"Heard","2020-06-16","20","599","0","45","3.8","5"
"Heard","2020-06-17","9","608","0","45","2.5","5"
"Heard","2020-06-18","8","616","0","45","1","5"
"Heard","2020-06-19","10","626","2","47","2.9","5.3"
"Heard","2020-06-20","6","632","1","48","5.2","5.5"
"Heard","2020-06-21","1","633","0","48","5.2","5.5"
"Heard","2020-06-22","10","643","1","49","6.7","5.8"
"Heard","2020-06-23","13","656","0","49","6.7","5.3"
"Heard","2020-06-24","18","674","0","49","6.7","4.6"
"Heard","2020-06-25","25","699","2","51","7.8","4.4"
"Heard","2020-06-26","13","712","0","51","5","3.9"
"Heard","2020-06-27","9","721","1","52","4.2","4.7"
"Heard","2020-06-28","4","725","1","53","7.7","6.5"
"Heard","2020-06-29","16","741","1","54","7.2","6.9"
"Heard","2020-06-30","23","764","4","58","9.7","8.2"
"Heard","2020-07-01","45","809","3","61","10.6","8.6"
"Heard","2020-07-02","20","829","4","65","12.3","10.1"
"Heard","2020-07-03","13","842","2","67","14.5","9.7"
"Heard","2020-07-04","17","859","5","72","17.2","10.7"
"Heard","2020-07-05","4","863","0","72","13.6","10.7"
"Heard","2020-07-06","27","890","6","78","15.9","11.5"
"Heard","2020-07-07","19","909","0","78","13.4","11.5"
"Heard","2020-07-08","71","980","3","81","13","11.8"
"Heard","2020-07-09","14","994","1","82","11.2","11.8"
"Heard","2020-07-10","30","1024","3","85","10.4","12.5"
"Heard","2020-07-11","20","1044","2","87","7.7","12.4"
"Heard","2020-07-12","9","1053","3","90","12.4","13"
"Heard","2020-07-13","20","1073","4","94","12.1","14"
"Heard","2020-07-14","15","1088","0","94","12.1","12.7"
"Heard","2020-07-15","104","1192","15","109","13.6","13.3"
"Heard","2020-07-16","4","1196","1","110","16.1","13.7"
"Heard","2020-07-17","26","1222","4","114","16.9","13.7"
"Heard","2020-07-18","8","1230","1","115","17.2","12.4"
"Heard","2020-07-19","4","1234","0","115","12.5","12.4"
"Heard","2020-07-20","26","1260","3","118","11.3","11.7"
"Heard","2020-07-21","32","1292","5","123","13.5","12.8"
"Heard","2020-07-22","65","1357","3","126","12.1","12.8"
"Heard","2020-07-23","10","1367","1","127","10","13"
"Heard","2020-07-24","12","1379","1","128","8.9","12.9"
"Heard","2020-07-25","2","1381","0","128","7.2","12.2"
"Heard","2020-07-26","6","1387","1","129","9.5","11"
"Heard","2020-07-27","16","1403","7","136","14.1","12.7"
"Heard","2020-07-28","21","1424","7","143","16.7","15.1"
"Heard","2020-07-29","33","1457","2","145","16.9","14.5"
"Heard","2020-07-30","7","1464","1","146","17.5","13.7"
"Heard","2020-07-31","8","1472","1","147","18.1","13.5"
"Heard","2020-08-01","5","1477","1","148","20.9","14.1"
"Heard","2020-08-02","2","1479","1","149","25.7","17.6"
"Heard","2020-08-03","20","1499","4","153","22.3","18.2"
"Heard","2020-08-04","9","1508","3","156","22.3","19.5"
"Heard","2020-08-05","53","1561","0","156","21.4","19.2"
"Heard","2020-08-06","10","1571","1","157","20.8","19.2"
"Heard","2020-08-07","15","1586","0","157","19","18.6"
"Heard","2020-08-08","7","1593","1","158","18.2","19.6"
"Heard","2020-08-09","8","1601","0","158","11.1","18.4"
"Heard","2020-08-10","11","1612","0","158","8.2","15.3"
"Heard","2020-08-11","19","1631","1","159","4.2","13.3"
"Heard","2020-08-12","50","1681","3","162","5.1","13.3"
"Heard","2020-08-13","24","1705","1","163","4.2","12.5"
"Heard","2020-08-14","16","1721","1","164","5.1","12.1"
"Heard","2020-08-15","9","1730","1","165","4.7","11.5"
"Heard","2020-08-16","15","1745","0","165","4.7","7.9"
"Heard","2020-08-17","23","1768","2","167","5.9","7.1"
"Heard","2020-08-18","22","1790","2","169","6.5","5.3"
"Heard","2020-08-19","54","1844","4","173","6.7","5.9"
"Heard","2020-08-20","14","1858","1","174","7.1","5.7"
"Heard","2020-08-21","19","1877","2","176","7.7","6.4"
"Heard","2020-08-22","18","1895","1","177","6.9","5.8"
"Heard","2020-08-23","7","1902","1","178","9","6.8"
"Heard","2020-08-24","9","1911","3","181","12.5","9.2"
"Heard","2020-08-25","15","1926","1","182","12.1","9.3"
"Heard","2020-08-26","35","1961","1","183","11.5","9.1"
"Heard","2020-08-27","8","1969","0","183","10.5","8.8"
"Heard","2020-08-28","32","2001","0","183","9","8.3"
"Heard","2020-08-29","13","2014","2","185","10.4","8.6"
"Heard","2020-08-30","1","2015","0","185","8.3","8.6"
"Heard","2020-08-31","6","2021","1","186","5.9","9.2"
"Heard","2020-09-01","15","2036","2","188","6.9","9.5"
"Heard","2020-09-02","25","2061","2","190","7.6","9.6"
"Heard","2020-09-03","9","2070","3","193","12.4","11.4"
"Heard","2020-09-04","38","2108","1","194","12.8","10.9"
"Heard","2020-09-05","55","2163","0","194","10.6","10.5"
"Heard","2020-09-06","10","2173","0","194","10.6","9.4"
"Heard","2020-09-07","4","2177","0","194","8.2","7.1"
"Heard","2020-09-08","8","2185","0","194","6.3","6.6"
"Heard","2020-09-09","24","2209","1","195","5.7","6.7"
"Heard","2020-09-10","9","2218","0","195","1","6.7"
"Heard","2020-09-11","16","2234","3","198","3.3","8"
"Heard","2020-09-12","1","2235","0","198","3.3","6.9"
"Heard","2020-09-13","3","2238","1","199","8","9.3"
"Heard","2020-09-14","9","2247","0","199","8","8.1"
"Heard","2020-09-15","7","2254","0","199","8","7.2"
"Heard","2020-09-16","28","2282","0","199","7.4","6.6"
"Heard","2020-09-17","5","2287","0","199","7.4","4.2"
"Heard","2020-09-18","9","2296","0","199","4.8","4"
"Heard","2020-09-19","5","2301","0","199","4.8","4"
"Heard","2020-09-20","3","2304","0","199","0","4"
"Heard","2020-09-21","7","2311","0","199","0","4"
"Heard","2020-09-22","9","2320","5","204","7.9","8"
"Heard","2020-09-23","22","2342","3","207","9.9","8.7"
"Heard","2020-09-24","11","2353","2","209","12.5","10"
"Heard","2020-09-25","6","2359","0","209","12.5","8.6"
"Heard","2020-09-26","4","2363","0","209","12.5","8.6"
"Heard","2020-09-27","2","2365","0","209","12.5","6.2"
"Heard","2020-09-28","8","2373","1","210","14.3","7.1"
"Heard","2020-09-29","16","2389","6","216","11.7","9.8"
"Heard","2020-09-30","20","2409","1","217","10.5","10.2"
"Heard","2020-10-01","3","2412","1","218","12.6","12.6"
"Heard","2020-10-02","12","2424","1","219","13.8","13.1"
"Heard","2020-10-03","4","2428","0","219","13.8","13.1"
"Heard","2020-10-04","0","2428","0","219","13.8","13.1"
"Heard","2020-10-05","14","2442","0","219","12","13.1"
"Heard","2020-10-06","22","2464","1","220","7.3","9.5"
"Heard","2020-10-07","14","2478","2","222","8.6","9.5"
"Heard","2020-10-08","11","2489","1","223","5.2","8.9"
"Heard","2020-10-09","7","2496","0","223","4","8.9"
"Heard","2020-10-10","4","2500","0","223","4","8.9"
"Heard","2020-10-11","4","2504","0","223","4","8.9"
"Heard","2020-10-12","8","2512","0","223","4","8"
"Heard","2020-10-13","15","2527","1","224","4.3","5.8"
"Heard","2020-10-14","18","2545","1","225","3","5.8"
"Heard","2020-10-15","17","2562","3","228","4.3","4.7"
"Heard","2020-10-16","12","2574","1","229","5.5","4.7"
"Heard","2020-10-17","11","2585","1","230","6.8","5.4"
"Heard","2020-10-18","6","2591","0","230","6.8","5.4"
"Heard","2020-10-19","26","2617","3","233","8.4","6.2"
"Heard","2020-10-20","25","2642","7","240","11.5","7.9"
"Heard","2020-10-21","15","2657","5","245","15.4","9.2"
"Heard","2020-10-22","10","2667","4","249","18.6","11.4"
"Heard","2020-10-23","11","2678","3","252","21.3","13.4"
"Heard","2020-10-24","8","2686","0","252","20","13.4"
"Heard","2020-10-25","7","2693","1","253","22.1","14.4"
"Heard","2020-10-26","31","2724","6","259","23.2","15.8"
"Heard","2020-10-27","23","2747","3","262","21","16.2"
"Heard","2020-10-28","19","2766","4","266","19.3","17.4"
"Heard","2020-10-29","13","2779","2","268","15.8","17.2"
"Heard","2020-10-30","19","2798","2","270","13.4","17.3"
"Heard","2020-10-31","3","2801","1","271","18.1","19.1"
"Heard","2020-11-01","8","2809","0","271","16.1","19.1"
"Heard","2020-11-02","22","2831","6","277","17.2","20.2"
"Heard","2020-11-03","12","2843","0","277","15.4","18.2"
"Heard","2020-11-04","27","2870","3","280","13.9","16.6"
"Heard","2020-11-05","7","2877","2","282","15.8","15.8"
"Heard","2020-11-06","17","2894","2","284","16","14.7"
"Heard","2020-11-07","6","2900","0","284","11.2","14.7"
"Heard","2020-11-08","5","2905","0","284","11.2","13.7"
"Heard","2020-11-09","19","2924","2","286","8.9","13"
"Heard","2020-11-10","17","2941","4","290","12.2","13.8"
"Heard","2020-11-11","6","2947","3","293","17.8","15.9"
"Heard","2020-11-12","11","2958","3","296","17.6","16.7"
"Heard","2020-11-13","11","2969","3","299","19.8","17.9"
"Heard","2020-11-14","8","2977","4","303","26.9","19.1"
"Heard","2020-11-15","6","2983","0","303","26.9","19.1"
"Heard","2020-11-16","29","3012","3","306","26.9","17.9"
"Heard","2020-11-17","13","3025","2","308","25.8","19"
"Heard","2020-11-18","22","3047","3","311","20.6","19.2"
"Heard","2020-11-19","21","3068","1","312","17.3","17.5"
"Heard","2020-11-20","31","3099","3","315","14.8","17.3"
"Heard","2020-11-21","9","3108","0","315","7.7","17.3"
"Heard","2020-11-22","4","3112","0","315","7.7","17.3"
"Heard","2020-11-23","13","3125","1","316","7.3","17.1"
"Heard","2020-11-24","21","3146","5","321","8.5","17.1"
"Heard","2020-11-25","12","3158","4","325","11.3","15.9"
"Heard","2020-11-26","5","3163","0","325","10.6","14"
"Heard","2020-11-27","8","3171","1","326","11","12.9"
"Heard","2020-11-28","3","3174","1","327","15.8","11.7"
"Heard","2020-11-29","8","3182","3","330","21.2","14.4"
"Heard","2020-11-30","40","3222","13","343","24.7","16"
"Heard","2020-12-01","10","3232","1","344","22.7","15.6"
"Heard","2020-12-02","19","3251","4","348","21","16.2"
"Heard","2020-12-03","17","3268","6","354","26","18.3"
"Heard","2020-12-04","18","3286","5","359","28.2","19.6"
"Heard","2020-12-05","4","3290","0","359","23.4","19.6"
"Heard","2020-12-06","6","3296","0","359","18.1","19.6"
"Heard","2020-12-07","14","3310","1","360","14.5","19.6"
"Heard","2020-12-08","31","3341","10","370","17.6","20.2"
"Heard","2020-12-09","29","3370","11","381","20.1","20.5"
"Heard","2020-12-10","25","3395","5","386","17.9","21.9"
"Heard","2020-12-11","21","3416","1","387","14.6","21.4"
"Heard","2020-12-12","5","3421","2","389","20.3","21.9"
"Heard","2020-12-13","5","3426","1","390","23.2","20.6"
"Heard","2020-12-14","61","3487","5","395","23.3","18.9"
"Heard","2020-12-15","22","3509","6","401","22.6","20.1"
"Heard","2020-12-16","18","3527","1","402","18","19"
"Heard","2020-12-17","22","3549","2","404","16.4","17.1"
"Heard","2020-12-18","29","3578","8","412","19.7","17.1"
"Heard","2020-12-19","10","3588","1","413","15.4","17.8"
"Heard","2020-12-20","2","3590","0","413","12.5","17.8"
"Heard","2020-12-21","22","3612","8","421","16.6","19.9"
"Heard","2020-12-22","39","3651","12","433","17.1","19.8"
"Heard","2020-12-23","19","3670","5","438","20","19"
"Heard","2020-12-24","22","3692","9","447","24.6","20.5"
"Heard","2020-12-25","3","3695","3","450","34.9","27.3"
"Heard","2020-12-26","9","3704","0","450","33.5","24.4"
"Heard","2020-12-27","6","3710","2","452","38.2","25.4"
"Heard","2020-12-28","68","3778","9","461","34.9","25.7"
"Heard","2020-12-29","18","3796","8","469","36.9","27"
"Heard","2020-12-30","31","3827","6","475","35.9","28"
"Heard","2020-12-31","16","3843","4","479","33.6","29.1"
"Heard","2021-01-01","2","3845","0","479","19.3","27.1"
"Heard","2021-01-02","8","3853","0","479","19.3","26.4"
"Heard","2021-01-03","1","3854","0","479","14.6","26.4"
"Heard","2021-01-04","18","3872","5","484","16.7","25.8"
"Heard","2021-01-05","31","3903","11","495","15.4","26.1"
"Heard","2021-01-06","21","3924","8","503","18.1","27"
"Heard","2021-01-07","25","3949","3","506","16.2","24.9"
"Heard","2021-01-08","19","3968","5","511","20","19.6"
"Heard","2021-01-09","16","3984","4","515","23.5","21.4"
"Heard","2021-01-10","8","3992","2","517","27.1","20.8"
"Heard","2021-01-11","12","4004","2","519","25.5","21.1"
"Heard","2021-01-12","85","4089","8","527","21.8","18.6"
"Heard","2021-01-13","22","4111","6","533","20.2","19.1"
"Heard","2021-01-14","20","4131","4","537","21.4","18.8"
"Heard","2021-01-15","25","4156","8","545","22.2","21.1"
"Heard","2021-01-16","18","4174","7","552","24.2","23.9"
"Heard","2021-01-17","9","4183","1","553","22.2","24.6"
"Heard","2021-01-18","24","4207","5","558","22.8","24.1"
"Heard","2021-01-19","31","4238","3","561","22.8","22.3"
"Heard","2021-01-20","29","4267","7","568","22.4","21.3"
"Heard","2021-01-21","19","4286","2","570","21","21.2"
"Heard","2021-01-22","34","4320","2","572","17.3","19.7"
"Heard","2021-01-23","16","4336","6","578","17.1","20.6"
"Heard","2021-01-24","2","4338","1","579","22.7","22.4"
"Heard","2021-01-25","3","4341","0","579","19.7","21.2"
"Heard","2021-01-26","1","4342","0","579","18.3","20.6"
"Heard","2021-01-27","0","4342","0","579","14.8","18.6"
"Henry","2020-02-01","0","0","0","0",".","."
"Henry","2020-02-02","0","0","0","0",".","."
"Henry","2020-02-03","0","0","0","0",".","."
"Henry","2020-02-04","0","0","0","0",".","."
"Henry","2020-02-05","0","0","0","0",".","."
"Henry","2020-02-06","0","0","0","0",".","."
"Henry","2020-02-07","0","0","0","0","0","."
"Henry","2020-02-08","0","0","0","0","0","."
"Henry","2020-02-09","0","0","0","0","0","."
"Henry","2020-02-10","0","0","0","0","0","."
"Henry","2020-02-11","0","0","0","0","0","."
"Henry","2020-02-12","0","0","0","0","0","."
"Henry","2020-02-13","0","0","0","0","0","."
"Henry","2020-02-14","0","0","0","0","0","0"
"Henry","2020-02-15","0","0","0","0","0","0"
"Henry","2020-02-16","0","0","0","0","0","0"
"Henry","2020-02-17","0","0","0","0","0","0"
"Henry","2020-02-18","0","0","0","0","0","0"
"Henry","2020-02-19","0","0","0","0","0","0"
"Henry","2020-02-20","0","0","0","0","0","0"
"Henry","2020-02-21","0","0","0","0","0","0"
"Henry","2020-02-22","0","0","0","0","0","0"
"Henry","2020-02-23","0","0","0","0","0","0"
"Henry","2020-02-24","0","0","0","0","0","0"
"Henry","2020-02-25","0","0","0","0","0","0"
"Henry","2020-02-26","0","0","0","0","0","0"
"Henry","2020-02-27","0","0","0","0","0","0"
"Henry","2020-02-28","0","0","0","0","0","0"
"Henry","2020-02-29","0","0","0","0","0","0"
"Henry","2020-03-01","0","0","0","0","0","0"
"Henry","2020-03-02","0","0","0","0","0","0"
"Henry","2020-03-03","0","0","0","0","0","0"
"Henry","2020-03-04","0","0","0","0","0","0"
"Henry","2020-03-05","0","0","0","0","0","0"
"Henry","2020-03-06","0","0","0","0","0","0"
"Henry","2020-03-07","0","0","0","0","0","0"
"Henry","2020-03-08","0","0","0","0","0","0"
"Henry","2020-03-09","0","0","0","0","0","0"
"Henry","2020-03-10","0","0","0","0","0","0"
"Henry","2020-03-11","10","10","0","0","0","0"
"Henry","2020-03-12","12","22","5","5","6","3"
"Henry","2020-03-13","28","50","9","14","10.5","5.3"
"Henry","2020-03-14","2","52","0","14","10.5","5.3"
"Henry","2020-03-15","10","62","1","15","12","6"
"Henry","2020-03-16","24","86","4","19","14.4","7.2"
"Henry","2020-03-17","23","109","4","23","16.8","8.4"
"Henry","2020-03-18","33","142","10","33","21.2","10.6"
"Henry","2020-03-19","43","185","5","38","16.9","11.4"
"Henry","2020-03-20","37","222","9","47","15.8","13.2"
"Henry","2020-03-21","12","234","3","50","19.3","14.9"
"Henry","2020-03-22","17","251","10","60","26.3","19.1"
"Henry","2020-03-23","53","304","25","85","30.7","22.5"
"Henry","2020-03-24","50","354","19","104","33.6","25.2"
"Henry","2020-03-25","86","440","32","136","34.6","27.9"
"Henry","2020-03-26","75","515","17","153","36.2","26.5"
"Henry","2020-03-27","68","583","14","167","35.6","25.7"
"Henry","2020-03-28","21","604","11","178","39.5","29.4"
"Henry","2020-03-29","20","624","4","182","34","30.2"
"Henry","2020-03-30","97","721","24","206","30.8","30.7"
"Henry","2020-03-31","63","784","14","220","28.5","31.1"
"Henry","2020-04-01","66","850","12","232","25.8","30.2"
"Henry","2020-04-02","67","917","15","247","25.8","31"
"Henry","2020-04-03","56","973","6","253","24.4","30"
"Henry","2020-04-04","29","1002","6","259","19.8","29.7"
"Henry","2020-04-05","12","1014","3","262","20.6","27.3"
"Henry","2020-04-06","110","1124","24","286","20.1","25.5"
"Henry","2020-04-07","80","1204","15","301","19.6","24.1"
"Henry","2020-04-08","120","1324","17","318","19.1","22.5"
"Henry","2020-04-09","114","1438","18","336","18.1","22"
"Henry","2020-04-10","118","1556","13","349","18.2","21.3"
"Henry","2020-04-11","47","1603","3","352","16.1","18"
"Henry","2020-04-12","20","1623","3","355","14.7","17.6"
"Henry","2020-04-13","126","1749","19","374","13.7","16.9"
"Henry","2020-04-14","123","1872","15","389","12.8","16.2"
"Henry","2020-04-15","113","1985","14","403","12.6","15.8"
"Henry","2020-04-16","129","2114","20","423","12.5","15.3"
"Henry","2020-04-17","126","2240","5","428","11.5","14.8"
"Henry","2020-04-18","49","2289","8","436","12.9","14.5"
"Henry","2020-04-19","51","2340","7","443","12.7","13.7"
"Henry","2020-04-20","156","2496","20","463","12.4","13.1"
"Henry","2020-04-21","269","2765","32","495","12.4","12.6"
"Henry","2020-04-22","182","2947","8","503","11.2","11.9"
"Henry","2020-04-23","191","3138","12","515","9.9","11.2"
"Henry","2020-04-24","197","3335","25","540","11.2","11.3"
"Henry","2020-04-25","101","3436","10","550","10.2","11.6"
"Henry","2020-04-26","41","3477","2","552","9","10.9"
"Henry","2020-04-27","192","3669","17","569","8.4","10.4"
"Henry","2020-04-28","203","3872","17","586","7.9","10.1"
"Henry","2020-04-29","189","4061","9","595","8","9.6"
"Henry","2020-04-30","226","4287","16","611","8.1","9"
"Henry","2020-05-01","214","4501","18","629","7.5","9.3"
"Henry","2020-05-02","105","4606","10","639","7.4","8.8"
"Henry","2020-05-03","98","4704","4","643","7.3","8.1"
"Henry","2020-05-04","190","4894","16","659","7.2","7.8"
"Henry","2020-05-05","221","5115","16","675","7.1","7.5"
"Henry","2020-05-06","197","5312","17","692","7.6","7.8"
"Henry","2020-05-07","175","5487","11","703","7.5","7.8"
"Henry","2020-05-08","221","5708","10","713","7","7.2"
"Henry","2020-05-09","97","5805","5","718","6.3","6.9"
"Henry","2020-05-10","66","5871","4","722","6.6","7"
"Henry","2020-05-11","273","6144","9","731","5.9","6.6"
"Henry","2020-05-12","283","6427","16","747","5.7","6.4"
"Henry","2020-05-13","256","6683","6","753","4.8","6.2"
"Henry","2020-05-14","248","6931","6","759","4.2","5.9"
"Henry","2020-05-15","249","7180","11","770","4.2","5.6"
"Henry","2020-05-16","141","7321","4","774","3.9","5.1"
"Henry","2020-05-17","72","7393","3","777","3.6","5.1"
"Henry","2020-05-18","190","7583","4","781","3.4","4.7"
"Henry","2020-05-19","269","7852","15","796","3.4","4.5"
"Henry","2020-05-20","276","8128","10","806","3.6","4.2"
"Henry","2020-05-21","227","8355","11","817","3.9","4.1"
"Henry","2020-05-22","279","8634","7","824","3.7","3.9"
"Henry","2020-05-23","351","8985","5","829","3.5","3.7"
"Henry","2020-05-24","69","9054","2","831","3.3","3.4"
"Henry","2020-05-25","34","9088","3","834","4.2","3.8"
"Henry","2020-05-26","292","9380","18","852","4.3","3.9"
"Henry","2020-05-27","253","9633","18","870","4.8","4.2"
"Henry","2020-05-28","208","9841","10","880","4.8","4.4"
"Henry","2020-05-29","201","10042","13","893","5.4","4.5"
"Henry","2020-05-30","54","10096","3","896","6","4.7"
"Henry","2020-05-31","64","10160","3","899","6.2","4.8"
"Henry","2020-06-01","242","10402","21","920","6.2","5.2"
"Henry","2020-06-02","219","10621","13","933","6.2","5.3"
"Henry","2020-06-03","234","10855","6","939","5.5","5.2"
"Henry","2020-06-04","206","11061","11","950","5.6","5.2"
"Henry","2020-06-05","233","11294","13","963","5.5","5.4"
"Henry","2020-06-06","114","11408","6","969","5.4","5.7"
"Henry","2020-06-07","60","11468","4","973","5.7","6"
"Henry","2020-06-08","366","11834","17","990","5.1","5.7"
"Henry","2020-06-09","259","12093","8","998","4.7","5.5"
"Henry","2020-06-10","245","12338","16","1014","5.3","5.4"
"Henry","2020-06-11","273","12611","14","1028","5.3","5.4"
"Henry","2020-06-12","179","12790","9","1037","5.2","5.3"
"Henry","2020-06-13","60","12850","6","1043","5.9","5.7"
"Henry","2020-06-14","82","12932","6","1049","6","5.8"
"Henry","2020-06-15","297","13229","44","1093","7.4","6.3"
"Henry","2020-06-16","292","13521","30","1123","8.4","6.6"
"Henry","2020-06-17","286","13807","34","1157","9.2","7.3"
"Henry","2020-06-18","313","14120","34","1191","10","7.6"
"Henry","2020-06-19","293","14413","30","1221","10.8","8"
"Henry","2020-06-20","100","14513","14","1235","11.3","8.6"
"Henry","2020-06-21","76","14589","11","1246","12.4","9.2"
"Henry","2020-06-22","434","15023","52","1298","12","9.7"
"Henry","2020-06-23","442","15465","47","1345","12","10.2"
"Henry","2020-06-24","402","15867","44","1389","11.9","10.5"
"Henry","2020-06-25","256","16123","20","1409","11.4","10.7"
"Henry","2020-06-26","406","16529","39","1448","11.4","11.1"
"Henry","2020-06-27","130","16659","15","1463","11","11.2"
"Henry","2020-06-28","125","16784","16","1479","10.8","11.6"
"Henry","2020-06-29","522","17306","51","1530","10.4","11.2"
"Henry","2020-06-30","386","17692","45","1575","10.6","11.3"
"Henry","2020-07-01","341","18033","38","1613","10.6","11.2"
"Henry","2020-07-02","314","18347","53","1666","11.9","11.7"
"Henry","2020-07-03","199","18546","35","1701","13.1","12.2"
"Henry","2020-07-04","51","18597","13","1714","15","13"
"Henry","2020-07-05","110","18707","21","1735","15.9","13.4"
"Henry","2020-07-06","392","19099","76","1811","17.3","13.9"
"Henry","2020-07-07","388","19487","68","1879","18.2","14.4"
"Henry","2020-07-08","451","19938","55","1934","18.3","14.5"
"Henry","2020-07-09","433","20371","52","1986","17.6","14.8"
"Henry","2020-07-10","383","20754","50","2036","17","15"
"Henry","2020-07-11","171","20925","22","2058","15.2","15.1"
"Henry","2020-07-12","109","21034","13","2071","14.1","15"
"Henry","2020-07-13","377","21411","62","2133","13.7","15.5"
"Henry","2020-07-14","367","21778","67","2200","13.8","16"
"Henry","2020-07-15","319","22097","50","2250","14.3","16.3"
"Henry","2020-07-16","344","22441","51","2301","14.7","16.2"
"Henry","2020-07-17","311","22752","29","2330","14.2","15.6"
"Henry","2020-07-18","159","22911","24","2354","14.5","14.8"
"Henry","2020-07-19","119","23030","16","2370","14.7","14.4"
"Henry","2020-07-20","292","23322","39","2409","14.3","14"
"Henry","2020-07-21","287","23609","24","2433","12.9","13.3"
"Henry","2020-07-22","353","23962","43","2476","12.4","13.3"
"Henry","2020-07-23","360","24322","39","2515","11.8","13.3"
"Henry","2020-07-24","320","24642","52","2567","12.8","13.5"
"Henry","2020-07-25","176","24818","12","2579","11.6","13.1"
"Henry","2020-07-26","79","24897","6","2585","10.8","12.7"
"Henry","2020-07-27","372","25269","38","2623","10.3","12.3"
"Henry","2020-07-28","376","25645","45","2668","10.8","11.9"
"Henry","2020-07-29","317","25962","34","2702","10.6","11.5"
"Henry","2020-07-30","300","26262","31","2733","10.6","11.2"
"Henry","2020-07-31","319","26581","29","2762","9.5","11.2"
"Henry","2020-08-01","131","26712","22","2784","11","11.3"
"Henry","2020-08-02","94","26806","17","2801","12.5","11.6"
"Henry","2020-08-03","349","27155","36","2837","12.5","11.4"
"Henry","2020-08-04","315","27470","30","2867","12.1","11.5"
"Henry","2020-08-05","264","27734","25","2892","11.9","11.3"
"Henry","2020-08-06","315","28049","36","2928","12.1","11.3"
"Henry","2020-08-07","294","28343","34","2962","12.5","11"
"Henry","2020-08-08","214","28557","15","2977","11.1","11"
"Henry","2020-08-09","109","28666","11","2988","9.9","11.2"
"Henry","2020-08-10","352","29018","34","3022","9.8","11.1"
"Henry","2020-08-11","636","29654","72","3094","10.1","11.1"
"Henry","2020-08-12","532","30186","70","3164","10.6","11.3"
"Henry","2020-08-13","528","30714","54","3218","10.4","11.3"
"Henry","2020-08-14","669","31383","58","3276","10","11.2"
"Henry","2020-08-15","268","31651","22","3298","10.2","10.6"
"Henry","2020-08-16","186","31837","16","3314","10","9.9"
"Henry","2020-08-17","522","32359","72","3386","10.6","10.2"
"Henry","2020-08-18","540","32899","79","3465","11","10.6"
"Henry","2020-08-19","543","33442","60","3525","10.7","10.7"
"Henry","2020-08-20","440","33882","65","3590","11.4","10.9"
"Henry","2020-08-21","450","34332","51","3641","11.8","10.9"
"Henry","2020-08-22","186","34518","14","3655","11.7","10.9"
"Henry","2020-08-23","108","34626","6","3661","11.2","10.6"
"Henry","2020-08-24","459","35085","57","3718","11","10.8"
"Henry","2020-08-25","410","35495","48","3766","10.6","10.8"
"Henry","2020-08-26","394","35889","31","3797","10.2","10.5"
"Henry","2020-08-27","329","36218","29","3826","9.3","10.4"
"Henry","2020-08-28","399","36617","40","3866","9.1","10.5"
"Henry","2020-08-29","233","36850","21","3887","9.3","10.5"
"Henry","2020-08-30","81","36931","6","3893","9.6","10.4"
"Henry","2020-08-31","375","37306","41","3934","9.4","10.2"
"Henry","2020-09-01","386","37692","40","3974","9.2","9.9"
"Henry","2020-09-02","296","37988","26","4000","9.3","9.8"
"Henry","2020-09-03","318","38306","40","4040","9.9","9.6"
"Henry","2020-09-04","303","38609","38","4078","10.2","9.7"
"Henry","2020-09-05","206","38815","22","4100","10.5","9.9"
"Henry","2020-09-06","85","38900","5","4105","10.3","9.9"
"Henry","2020-09-07","84","38984","15","4120","11.2","10.3"
"Henry","2020-09-08","417","39401","49","4169","11.4","10.3"
"Henry","2020-09-09","333","39734","28","4197","11.4","10.4"
"Henry","2020-09-10","351","40085","42","4239","11.3","10.6"
"Henry","2020-09-11","329","40414","24","4263","10.5","10.4"
"Henry","2020-09-12","156","40570","14","4277","10.3","10.4"
"Henry","2020-09-13","91","40661","5","4282","10.2","10.3"
"Henry","2020-09-14","345","41006","31","4313","9","10.1"
"Henry","2020-09-15","442","41448","43","4356","8.7","10.1"
"Henry","2020-09-16","285","41733","21","4377","8.5","10"
"Henry","2020-09-17","331","42064","19","4396","7.7","9.5"
"Henry","2020-09-18","395","42459","45","4441","8.2","9.4"
"Henry","2020-09-19","113","42572","6","4447","7.7","9"
"Henry","2020-09-20","93","42665","9","4456","8.3","9.3"
"Henry","2020-09-21","390","43055","39","4495","8.5","8.7"
"Henry","2020-09-22","297","43352","16","4511","7.8","8.3"
"Henry","2020-09-23","368","43720","30","4541","8","8.2"
"Henry","2020-09-24","268","43988","14","4555","7.9","7.8"
"Henry","2020-09-25","323","44311","20","4575","7.1","7.7"
"Henry","2020-09-26","97","44408","11","4586","8","7.9"
"Henry","2020-09-27","90","44498","8","4594","7.9","8.1"
"Henry","2020-09-28","347","44845","21","4615","7.3","7.9"
"Henry","2020-09-29","427","45272","35","4650","7.7","7.8"
"Henry","2020-09-30","336","45608","23","4673","7.5","7.7"
"Henry","2020-10-01","306","45914","20","4693","7.7","7.8"
"Henry","2020-10-02","385","46299","30","4723","8","7.5"
"Henry","2020-10-03","229","46528","12","4735","7.1","7.5"
"Henry","2020-10-04","96","46624","3","4738","6.3","7.1"
"Henry","2020-10-05","428","47052","34","4772","6.5","6.9"
"Henry","2020-10-06","544","47596","33","4805","6.2","7"
"Henry","2020-10-07","431","48027","27","4832","6.1","6.8"
"Henry","2020-10-08","373","48400","32","4864","6.4","7.1"
"Henry","2020-10-09","410","48810","31","4895","6.4","7.2"
"Henry","2020-10-10","164","48974","18","4913","7.2","7.1"
"Henry","2020-10-11","93","49067","6","4919","7.7","7"
"Henry","2020-10-12","325","49392","26","4945","7.7","7.1"
"Henry","2020-10-13","513","49905","35","4980","7.8","7"
"Henry","2020-10-14","366","50271","29","5009","8","7.1"
"Henry","2020-10-15","369","50640","33","5042","8.1","7.3"
"Henry","2020-10-16","379","51019","36","5078","8.4","7.4"
"Henry","2020-10-17","158","51177","14","5092","8.1","7.6"
"Henry","2020-10-18","97","51274","10","5102","8.6","8.2"
"Henry","2020-10-19","450","51724","38","5140","8.7","8.2"
"Henry","2020-10-20","442","52166","31","5171","8.7","8.3"
"Henry","2020-10-21","436","52602","33","5204","8.7","8.4"
"Henry","2020-10-22","410","53012","45","5249","9","8.5"
"Henry","2020-10-23","495","53507","52","5301","9.1","8.7"
"Henry","2020-10-24","240","53747","39","5340","10.2","9.1"
"Henry","2020-10-25","162","53909","15","5355","10","9.3"
"Henry","2020-10-26","523","54432","52","5407","10.2","9.5"
"Henry","2020-10-27","499","54931","45","5452","10.5","9.6"
"Henry","2020-10-28","451","55382","50","5502","11","9.8"
"Henry","2020-10-29","298","55680","31","5533","10.9","9.9"
"Henry","2020-10-30","525","56205","56","5589","10.9","10"
"Henry","2020-10-31","177","56382","12","5601","9.6","9.9"
"Henry","2020-11-01","169","56551","17","5618","9.7","9.9"
"Henry","2020-11-02","585","57136","63","5681","9.8","10"
"Henry","2020-11-03","591","57727","57","5738","9.9","10.2"
"Henry","2020-11-04","496","58223","51","5789","9.8","10.4"
"Henry","2020-11-05","460","58683","28","5817","9.2","10.1"
"Henry","2020-11-06","492","59175","49","5866","9.1","10"
"Henry","2020-11-07","253","59428","23","5889","9.4","9.5"
"Henry","2020-11-08","143","59571","18","5907","9.8","9.7"
"Henry","2020-11-09","650","60221","70","5977","9.8","9.8"
"Henry","2020-11-10","548","60769","61","6038","10","10"
"Henry","2020-11-11","376","61145","41","6079","10.1","9.9"
"Henry","2020-11-12","595","61740","65","6144","10.8","10"
"Henry","2020-11-13","589","62329","55","6199","10.7","9.9"
"Henry","2020-11-14","293","62622","35","6234","11.1","10.2"
"Henry","2020-11-15","229","62851","25","6259","10.8","10.3"
"Henry","2020-11-16","683","63534","71","6330","10.8","10.3"
"Henry","2020-11-17","684","64218","73","6403","10.7","10.4"
"Henry","2020-11-18","683","64901","60","6463","10.4","10.3"
"Henry","2020-11-19","673","65574","61","6524","10.2","10.5"
"Henry","2020-11-20","737","66311","91","6615","10.6","10.6"
"Henry","2020-11-21","253","66564","26","6641","10.4","10.7"
"Henry","2020-11-22","189","66753","32","6673","11.2","11"
"Henry","2020-11-23","809","67562","80","6753","11.1","11"
"Henry","2020-11-24","739","68301","105","6858","11.6","11.2"
"Henry","2020-11-25","706","69007","85","6943","12.1","11.3"
"Henry","2020-11-26","105","69112","8","6951","11.9","11"
"Henry","2020-11-27","370","69482","64","7015","12.6","11.6"
"Henry","2020-11-28","260","69742","50","7065","13.9","12.1"
"Henry","2020-11-29","209","69951","45","7110","14.5","12.9"
"Henry","2020-11-30","845","70796","155","7265","15.8","13.4"
"Henry","2020-12-01","623","71419","84","7349","15.6","13.6"
"Henry","2020-12-02","823","72242","133","7482","16.2","14.2"
"Henry","2020-12-03","760","73002","107","7589","17.2","14.5"
"Henry","2020-12-04","853","73855","151","7740","17.2","14.9"
"Henry","2020-12-05","335","74190","55","7795","16.8","15.4"
"Henry","2020-12-06","221","74411","37","7832","16.1","15.3"
"Henry","2020-12-07","840","75251","140","7972","15.9","15.8"
"Henry","2020-12-08","832","76083","126","8098","16.1","15.9"
"Henry","2020-12-09","823","76906","145","8243","16.3","16.3"
"Henry","2020-12-10","814","77720","150","8393","17","17.1"
"Henry","2020-12-11","903","78623","160","8553","17","17.1"
"Henry","2020-12-12","373","78996","67","8620","17.2","17"
"Henry","2020-12-13","262","79258","53","8673","17.7","16.9"
"Henry","2020-12-14","1111","80369","172","8845","17.5","16.7"
"Henry","2020-12-15","959","81328","167","9012","17.8","17"
"Henry","2020-12-16","962","82290","173","9185","17.9","17.1"
"Henry","2020-12-17","1004","83294","187","9372","17.9","17.4"
"Henry","2020-12-18","1094","84388","210","9582","18.1","17.5"
"Henry","2020-12-19","355","84743","66","9648","18.2","17.7"
"Henry","2020-12-20","252","84995","47","9695","18","17.8"
"Henry","2020-12-21","1427","86422","277","9972","18.6","18"
"Henry","2020-12-22","1065","87487","210","10182","18.9","18.4"
"Henry","2020-12-23","1125","88612","201","10383","18.9","18.4"
"Henry","2020-12-24","451","89063","121","10504","20","19"
"Henry","2020-12-25","65","89128","15","10519","20.6","19.4"
"Henry","2020-12-26","513","89641","148","10667","22.1","20.1"
"Henry","2020-12-27","243","89884","67","10734","23.3","20.7"
"Henry","2020-12-28","1330","91214","256","10990","23.3","20.9"
"Henry","2020-12-29","1141","92355","291","11281","24.1","21.5"
"Henry","2020-12-30","1124","93479","245","11526","24.7","21.8"
"Henry","2020-12-31","575","94054","126","11652","24","22"
"Henry","2021-01-01","107","94161","28","11680","24.4","22.5"
"Henry","2021-01-02","530","94691","131","11811","23.8","23"
"Henry","2021-01-03","256","94947","87","11898","24.8","24"
"Henry","2021-01-04","1285","96232","338","12236","25.8","24.5"
"Henry","2021-01-05","1292","97524","281","12517","25.2","24.7"
"Henry","2021-01-06","1275","98799","276","12793","25.2","25"
"Henry","2021-01-07","1261","100060","293","13086","25.4","24.7"
"Henry","2021-01-08","902","100962","192","13278","24.7","24.6"
"Henry","2021-01-09","638","101600","134","13412","24.2","24"
"Henry","2021-01-10","295","101895","50","13462","21.7","23.3"
"Henry","2021-01-11","1225","103120","226","13688","20.6","23.2"
"Henry","2021-01-12","994","104114","194","13882","20.3","22.8"
"Henry","2021-01-13","1033","105147","204","14086","20","22.6"
"Henry","2021-01-14","1024","106171","190","14276","19.4","22.4"
"Henry","2021-01-15","747","106918","167","14443","19.5","22.1"
"Henry","2021-01-16","514","107432","113","14556","19.7","21.9"
"Henry","2021-01-17","347","107779","53","14609","19.4","20.6"
"Henry","2021-01-18","760","108539","133","14742","19.3","19.9"
"Henry","2021-01-19","917","109456","168","14910","19.1","19.7"
"Henry","2021-01-20","949","110405","187","15097","19.1","19.6"
"Henry","2021-01-21","824","111229","135","15232","18.8","19.1"
"Henry","2021-01-22","789","112018","116","15348","17.7","18.6"
"Henry","2021-01-23","424","112442","81","15429","17.3","18.5"
"Henry","2021-01-24","153","112595","23","15452","17.2","18.3"
"Henry","2021-01-25","512","113107","103","15555","17.6","18.4"
"Henry","2021-01-26","23","113130","6","15561","18.7","18.9"
"Henry","2021-01-27","0","113130","0","15561","15.9","17.5"
"Houston","2020-02-01","0","0","0","0",".","."
"Houston","2020-02-02","0","0","0","0",".","."
"Houston","2020-02-03","0","0","0","0",".","."
"Houston","2020-02-04","0","0","0","0",".","."
"Houston","2020-02-05","0","0","0","0",".","."
"Houston","2020-02-06","0","0","0","0",".","."
"Houston","2020-02-07","0","0","0","0","0","."
"Houston","2020-02-08","0","0","0","0","0","."
"Houston","2020-02-09","0","0","0","0","0","."
"Houston","2020-02-10","0","0","0","0","0","."
"Houston","2020-02-11","0","0","0","0","0","."
"Houston","2020-02-12","0","0","0","0","0","."
"Houston","2020-02-13","0","0","0","0","0","."
"Houston","2020-02-14","0","0","0","0","0","0"
"Houston","2020-02-15","0","0","0","0","0","0"
"Houston","2020-02-16","0","0","0","0","0","0"
"Houston","2020-02-17","0","0","0","0","0","0"
"Houston","2020-02-18","0","0","0","0","0","0"
"Houston","2020-02-19","0","0","0","0","0","0"
"Houston","2020-02-20","0","0","0","0","0","0"
"Houston","2020-02-21","0","0","0","0","0","0"
"Houston","2020-02-22","0","0","0","0","0","0"
"Houston","2020-02-23","0","0","0","0","0","0"
"Houston","2020-02-24","0","0","0","0","0","0"
"Houston","2020-02-25","0","0","0","0","0","0"
"Houston","2020-02-26","0","0","0","0","0","0"
"Houston","2020-02-27","0","0","0","0","0","0"
"Houston","2020-02-28","0","0","0","0","0","0"
"Houston","2020-02-29","0","0","0","0","0","0"
"Houston","2020-03-01","0","0","0","0","0","0"
"Houston","2020-03-02","0","0","0","0","0","0"
"Houston","2020-03-03","0","0","0","0","0","0"
"Houston","2020-03-04","0","0","0","0","0","0"
"Houston","2020-03-05","0","0","0","0","0","0"
"Houston","2020-03-06","5","5","0","0","0","0"
"Houston","2020-03-07","1","6","0","0","0","0"
"Houston","2020-03-08","2","8","0","0","0","0"
"Houston","2020-03-09","2","10","0","0","0","0"
"Houston","2020-03-10","0","10","0","0","0","0"
"Houston","2020-03-11","0","10","0","0","0","0"
"Houston","2020-03-12","1","11","0","0","0","0"
"Houston","2020-03-13","0","11","0","0","0","0"
"Houston","2020-03-14","1","12","0","0","0","0"
"Houston","2020-03-15","2","14","0","0","0","0"
"Houston","2020-03-16","5","19","2","2","5.7","2.9"
"Houston","2020-03-17","6","25","2","4","10.5","5.2"
"Houston","2020-03-18","11","36","2","6","13.1","6.5"
"Houston","2020-03-19","16","52","0","6","13.1","6.5"
"Houston","2020-03-20","18","70","1","7","13.9","6.9"
"Houston","2020-03-21","4","74","1","8","17.4","8.7"
"Houston","2020-03-22","5","79","0","8","17.4","8.7"
"Houston","2020-03-23","28","107","2","10","12.7","9.2"
"Houston","2020-03-24","35","142","2","12","8.8","9.6"
"Houston","2020-03-25","31","173","8","20","9.9","11.5"
"Houston","2020-03-26","20","193","5","25","13.5","13.3"
"Houston","2020-03-27","19","212","4","29","15.7","14.8"
"Houston","2020-03-28","6","218","0","29","12.1","14.8"
"Houston","2020-03-29","4","222","1","30","15.7","16.6"
"Houston","2020-03-30","46","268","5","35","16.2","14.5"
"Houston","2020-03-31","17","285","2","37","17.1","12.9"
"Houston","2020-04-01","40","325","5","42","15.2","12.5"
"Houston","2020-04-02","42","367","5","47","13.3","13.4"
"Houston","2020-04-03","52","419","6","53","11.9","13.8"
"Houston","2020-04-04","17","436","0","53","11.9","12"
"Houston","2020-04-05","4","440","2","55","15.5","15.6"
"Houston","2020-04-06","48","488","9","64","16.6","16.4"
"Houston","2020-04-07","62","550","9","73","17","17.1"
"Houston","2020-04-08","40","590","4","77","16.7","15.9"
"Houston","2020-04-09","51","641","8","85","17.2","15.3"
"Houston","2020-04-10","27","668","3","88","17.2","14.5"
"Houston","2020-04-11","23","691","1","89","17.8","14.9"
"Houston","2020-04-12","8","699","0","89","10.6","13.1"
"Houston","2020-04-13","51","750","14","103","11.9","14.3"
"Houston","2020-04-14","52","802","7","110","11.7","14.4"
"Houston","2020-04-15","49","851","8","118","12.6","14.6"
"Houston","2020-04-16","77","928","5","123","11.3","14.3"
"Houston","2020-04-17","64","992","5","128","10.8","14"
"Houston","2020-04-18","31","1023","0","128","10.2","14"
"Houston","2020-04-19","5","1028","0","128","10.2","10.4"
"Houston","2020-04-20","69","1097","6","134","7.5","9.7"
"Houston","2020-04-21","63","1160","3","137","6.3","9"
"Houston","2020-04-22","71","1231","10","147","6","9.3"
"Houston","2020-04-23","27","1258","2","149","6.1","8.7"
"Houston","2020-04-24","91","1349","12","161","6.9","8.9"
"Houston","2020-04-25","33","1382","1","162","7.3","8.8"
"Houston","2020-04-26","7","1389","0","162","7.3","8.8"
"Houston","2020-04-27","89","1478","6","168","7","7.3"
"Houston","2020-04-28","159","1637","12","180","7.4","6.9"
"Houston","2020-04-29","129","1766","15","195","7.1","6.5"
"Houston","2020-04-30","49","1815","1","196","6.3","6.2"
"Houston","2020-05-01","104","1919","5","201","5.1","6"
"Houston","2020-05-02","32","1951","2","203","5.6","6.4"
"Houston","2020-05-03","24","1975","0","203","5.6","6.4"
"Houston","2020-05-04","82","2057","5","208","5.5","6.3"
"Houston","2020-05-05","66","2123","3","211","5.1","6.2"
"Houston","2020-05-06","81","2204","6","217","4.4","5.8"
"Houston","2020-05-07","83","2287","5","222","5","5.7"
"Houston","2020-05-08","248","2535","18","240","5.4","5.2"
"Houston","2020-05-09","97","2632","3","243","4.9","5.2"
"Houston","2020-05-10","83","2715","16","259","7.7","6.6"
"Houston","2020-05-11","92","2807","3","262","7.3","6.4"
"Houston","2020-05-12","104","2911","3","265","7","6"
"Houston","2020-05-13","92","3003","3","268","6.4","5.4"
"Houston","2020-05-14","90","3093","6","274","6.5","5.8"
"Houston","2020-05-15","110","3203","9","283","6.7","6"
"Houston","2020-05-16","62","3265","2","285","6.7","5.8"
"Houston","2020-05-17","10","3275","0","285","3.9","5.8"
"Houston","2020-05-18","73","3348","5","290","4.4","5.9"
"Houston","2020-05-19","121","3469","2","292","4.3","5.6"
"Houston","2020-05-20","111","3580","3","295","4.2","5.3"
"Houston","2020-05-21","45","3625","3","298","4.2","5.4"
"Houston","2020-05-22","63","3688","2","300","3.5","5.1"
"Houston","2020-05-23","48","3736","2","302","3.6","5.1"
"Houston","2020-05-24","11","3747","0","302","3.6","3.8"
"Houston","2020-05-25","15","3762","1","303","3.6","4"
"Houston","2020-05-26","119","3881","4","307","3.8","4"
"Houston","2020-05-27","71","3952","3","310","4","4.1"
"Houston","2020-05-28","55","4007","2","312","3.6","3.9"
"Houston","2020-05-29","78","4085","3","315","3.7","3.6"
"Houston","2020-05-30","47","4132","0","315","3.1","3.4"
"Houston","2020-05-31","10","4142","0","315","3.1","3.4"
"Houston","2020-06-01","94","4236","3","318","2.6","3.1"
"Houston","2020-06-02","77","4313","5","323","3.1","3.4"
"Houston","2020-06-03","99","4412","5","328","3.2","3.6"
"Houston","2020-06-04","91","4503","2","330","3","3.3"
"Houston","2020-06-05","103","4606","2","332","2.7","3.2"
"Houston","2020-06-06","35","4641","3","335","3.9","3.5"
"Houston","2020-06-07","24","4665","0","335","3.9","3.5"
"Houston","2020-06-08","92","4757","1","336","3.6","3.1"
"Houston","2020-06-09","109","4866","3","339","3.1","3.1"
"Houston","2020-06-10","85","4951","6","345","3.4","3.3"
"Houston","2020-06-11","161","5112","22","367","5","4"
"Houston","2020-06-12","109","5221","11","378","6.2","4.4"
"Houston","2020-06-13","40","5261","1","379","5.3","4.6"
"Houston","2020-06-14","16","5277","3","382","8","6"
"Houston","2020-06-15","140","5417","6","388","8.4","6"
"Houston","2020-06-16","144","5561","7","395","8.7","5.9"
"Houston","2020-06-17","115","5676","7","402","8.6","6"
"Houston","2020-06-18","153","5829","10","412","7.6","6.3"
"Houston","2020-06-19","206","6035","11","423","6.9","6.5"
"Houston","2020-06-20","65","6100","5","428","7.7","6.5"
"Houston","2020-06-21","30","6130","0","428","5","6.5"
"Houston","2020-06-22","183","6313","21","449","6","7.2"
"Houston","2020-06-23","193","6506","19","468","6.7","7.7"
"Houston","2020-06-24","209","6715","16","484","6.9","7.8"
"Houston","2020-06-25","205","6920","38","522","8.6","8.1"
"Houston","2020-06-26","255","7175","15","537","8.7","7.8"
"Houston","2020-06-27","69","7244","9","546","9.5","8.6"
"Houston","2020-06-28","30","7274","5","551","11.9","8.4"
"Houston","2020-06-29","285","7559","29","580","11.7","8.8"
"Houston","2020-06-30","362","7921","41","621","11.9","9.3"
"Houston","2020-07-01","286","8207","26","647","12.1","9.5"
"Houston","2020-07-02","406","8613","40","687","10.9","9.8"
"Houston","2020-07-03","100","8713","18","705","12.6","10.7"
"Houston","2020-07-04","42","8755","4","709","12.1","10.8"
"Houston","2020-07-05","45","8800","4","713","11","11.4"
"Houston","2020-07-06","302","9102","38","751","11.3","11.5"
"Houston","2020-07-07","370","9472","51","802","11.7","11.8"
"Houston","2020-07-08","267","9739","32","834","12.1","12.1"
"Houston","2020-07-09","320","10059","40","874","12.5","11.7"
"Houston","2020-07-10","352","10411","39","913","11.5","12"
"Houston","2020-07-11","87","10498","13","926","12.3","12.2"
"Houston","2020-07-12","56","10554","6","932","12.5","11.7"
"Houston","2020-07-13","294","10848","26","958","12","11.7"
"Houston","2020-07-14","238","11086","26","984","11.6","11.6"
"Houston","2020-07-15","263","11349","32","1016","11.6","11.8"
"Houston","2020-07-16","273","11622","26","1042","11.2","11.8"
"Houston","2020-07-17","287","11909","37","1079","11.4","11.5"
"Houston","2020-07-18","88","11997","10","1089","10.9","11.6"
"Houston","2020-07-19","60","12057","10","1099","11.8","12.1"
"Houston","2020-07-20","301","12358","34","1133","12.1","12"
"Houston","2020-07-21","338","12696","16","1149","11.2","11.4"
"Houston","2020-07-22","254","12950","34","1183","11.4","11.5"
"Houston","2020-07-23","264","13214","21","1204","11.2","11.2"
"Houston","2020-07-24","315","13529","43","1247","11.3","11.4"
"Houston","2020-07-25","84","13613","10","1257","11.4","11.1"
"Houston","2020-07-26","56","13669","6","1263","10.5","11.1"
"Houston","2020-07-27","444","14113","31","1294","9.9","11"
"Houston","2020-07-28","352","14465","47","1341","11.1","11.2"
"Houston","2020-07-29","295","14760","29","1370","10.6","11"
"Houston","2020-07-30","302","15062","23","1393","10.6","10.9"
"Houston","2020-07-31","314","15376","23","1416","9.7","10.5"
"Houston","2020-08-01","92","15468","15","1431","10.3","10.8"
"Houston","2020-08-02","38","15506","3","1434","9.9","10.2"
"Houston","2020-08-03","396","15902","22","1456","9.7","9.8"
"Houston","2020-08-04","335","16237","27","1483","8.9","10"
"Houston","2020-08-05","246","16483","23","1506","8.9","9.7"
"Houston","2020-08-06","287","16770","27","1533","9.1","9.9"
"Houston","2020-08-07","237","17007","19","1552","9.2","9.5"
"Houston","2020-08-08","71","17078","13","1565","9.5","9.9"
"Houston","2020-08-09","51","17129","8","1573","10.6","10.3"
"Houston","2020-08-10","408","17537","36","1609","11.1","10.4"
"Houston","2020-08-11","345","17882","49","1658","12","10.5"
"Houston","2020-08-12","271","18153","30","1688","12.2","10.5"
"Houston","2020-08-13","327","18480","50","1738","13.1","11.1"
"Houston","2020-08-14","251","18731","36","1774","14","11.6"
"Houston","2020-08-15","125","18856","22","1796","13.9","11.7"
"Houston","2020-08-16","62","18918","10","1806","13.9","12.3"
"Houston","2020-08-17","301","19219","22","1828","13.7","12.4"
"Houston","2020-08-18","313","19532","32","1860","13.1","12.6"
"Houston","2020-08-19","351","19883","40","1900","13.2","12.7"
"Houston","2020-08-20","267","20150","21","1921","12.1","12.6"
"Houston","2020-08-21","343","20493","26","1947","11.2","12.6"
"Houston","2020-08-22","89","20582","5","1952","9.4","11.7"
"Houston","2020-08-23","72","20654","9","1961","8.9","11.4"
"Houston","2020-08-24","397","21051","25","1986","8.8","11.2"
"Houston","2020-08-25","254","21305","22","2008","8.6","10.8"
"Houston","2020-08-26","241","21546","18","2026","8","10.6"
"Houston","2020-08-27","234","21780","16","2042","7.9","10"
"Houston","2020-08-28","201","21981","15","2057","7.8","9.5"
"Houston","2020-08-29","93","22074","10","2067","8.6","9"
"Houston","2020-08-30","55","22129","8","2075","8.9","8.9"
"Houston","2020-08-31","338","22467","21","2096","8.8","8.8"
"Houston","2020-09-01","230","22697","13","2109","8.4","8.5"
"Houston","2020-09-02","190","22887","14","2123","8.4","8.2"
"Houston","2020-09-03","318","23205","34","2157","9","8.4"
"Houston","2020-09-04","196","23401","12","2169","8.8","8.3"
"Houston","2020-09-05","90","23491","11","2180","9","8.8"
"Houston","2020-09-06","121","23612","6","2186","7.6","8.2"
"Houston","2020-09-07","45","23657","7","2193","8.9","8.9"
"Houston","2020-09-08","267","23924","19","2212","9.1","8.8"
"Houston","2020-09-09","315","24239","19","2231","9","8.7"
"Houston","2020-09-10","221","24460","19","2250","8.7","8.8"
"Houston","2020-09-11","199","24659","20","2270","9.2","9"
"Houston","2020-09-12","60","24719","4","2274","8.4","8.7"
"Houston","2020-09-13","104","24823","7","2281","8.7","8.1"
"Houston","2020-09-14","172","24995","21","2302","8.2","8.6"
"Houston","2020-09-15","215","25210","23","2325","8.7","8.9"
"Houston","2020-09-16","184","25394","15","2340","9","9"
"Houston","2020-09-17","280","25674","17","2357","8.7","8.7"
"Houston","2020-09-18","190","25864","19","2376","8.6","8.9"
"Houston","2020-09-19","65","25929","5","2381","8.8","8.6"
"Houston","2020-09-20","92","26021","1","2382","8","8.3"
"Houston","2020-09-21","236","26257","24","2406","7.7","7.9"
"Houston","2020-09-22","158","26415","12","2418","7.3","8"
"Houston","2020-09-23","142","26557","14","2432","7.5","8.3"
"Houston","2020-09-24","218","26775","14","2446","7.5","8.1"
"Houston","2020-09-25","149","26924","7","2453","6.8","7.7"
"Houston","2020-09-26","54","26978","4","2457","6.7","7.8"
"Houston","2020-09-27","24","27002","4","2461","9","8.5"
"Houston","2020-09-28","278","27280","18","2479","8.4","8.1"
"Houston","2020-09-29","197","27477","12","2491","8.2","7.7"
"Houston","2020-09-30","147","27624","11","2502","7.9","7.7"
"Houston","2020-10-01","239","27863","5","2507","7.3","7.4"
"Houston","2020-10-02","155","28018","13","2520","7.8","7.3"
"Houston","2020-10-03","88","28106","12","2532","8.7","7.7"
"Houston","2020-10-04","97","28203","6","2538","7.2","8.1"
"Houston","2020-10-05","343","28546","9","2547","6.6","7.5"
"Houston","2020-10-06","214","28760","10","2557","6.4","7.3"
"Houston","2020-10-07","207","28967","24","2581","7","7.5"
"Houston","2020-10-08","301","29268","13","2594","7.3","7.3"
"Houston","2020-10-09","163","29431","10","2604","7","7.4"
"Houston","2020-10-10","63","29494","11","2615","7.6","8.1"
"Houston","2020-10-11","59","29553","10","2625","9.1","8.2"
"Houston","2020-10-12","282","29835","13","2638","9.4","8"
"Houston","2020-10-13","175","30010","21","2659","10.4","8.4"
"Houston","2020-10-14","195","30205","24","2683","10.5","8.8"
"Houston","2020-10-15","199","30404","20","2703","11.4","9.4"
"Houston","2020-10-16","200","30604","22","2725","12.1","9.5"
"Houston","2020-10-17","66","30670","9","2734","11.5","9.5"
"Houston","2020-10-18","43","30713","11","2745","12.7","10.9"
"Houston","2020-10-19","365","31078","23","2768","13","11.2"
"Houston","2020-10-20","112","31190","10","2778","12.5","11.5"
"Houston","2020-10-21","200","31390","19","2797","12.1","11.3"
"Houston","2020-10-22","156","31546","15","2812","12.1","11.7"
"Houston","2020-10-23","233","31779","24","2836","12","12"
"Houston","2020-10-24","86","31865","10","2846","11.7","11.6"
"Houston","2020-10-25","73","31938","13","2859","10.6","11.7"
"Houston","2020-10-26","390","32328","37","2896","11","12"
"Houston","2020-10-27","164","32492","20","2916","11.5","12"
"Houston","2020-10-28","247","32739","21","2937","11.4","11.8"
"Houston","2020-10-29","144","32883","24","2961","12.4","12.2"
"Houston","2020-10-30","253","33136","15","2976","11.7","11.9"
"Houston","2020-10-31","119","33255","14","2990","11.8","11.7"
"Houston","2020-11-01","103","33358","14","3004","11.2","10.9"
"Houston","2020-11-02","393","33751","22","3026","10.6","10.8"
"Houston","2020-11-03","181","33932","15","3041","10","10.8"
"Houston","2020-11-04","218","34150","27","3068","10.6","11"
"Houston","2020-11-05","175","34325","13","3081","9.3","10.8"
"Houston","2020-11-06","262","34587","22","3103","9.6","10.7"
"Houston","2020-11-07","95","34682","20","3123","11","11.4"
"Houston","2020-11-08","73","34755","7","3130","10.4","10.8"
"Houston","2020-11-09","247","35002","22","3152","10.9","10.7"
"Houston","2020-11-10","173","35175","15","3167","10.9","10.5"
"Houston","2020-11-11","162","35337","21","3188","11","10.8"
"Houston","2020-11-12","190","35527","22","3210","11.6","10.4"
"Houston","2020-11-13","300","35827","29","3239","11.8","10.7"
"Houston","2020-11-14","132","35959","9","3248","9.7","10.4"
"Houston","2020-11-15","77","36036","11","3259","10.4","10.4"
"Houston","2020-11-16","312","36348","37","3296","10.8","10.8"
"Houston","2020-11-17","238","36586","24","3320","11","11"
"Houston","2020-11-18","285","36871","32","3352","10.8","10.9"
"Houston","2020-11-19","201","37072","10","3362","9.8","10.7"
"Houston","2020-11-20","294","37366","28","3390","9.8","10.8"
"Houston","2020-11-21","130","37496","12","3402","10.2","10"
"Houston","2020-11-22","105","37601","8","3410","9.2","9.8"
"Houston","2020-11-23","278","37879","23","3433","8.7","9.8"
"Houston","2020-11-24","191","38070","20","3453","8.8","9.9"
"Houston","2020-11-25","278","38348","35","3488","9","9.9"
"Houston","2020-11-26","24","38372","2","3490","9.4","9.6"
"Houston","2020-11-27","181","38553","25","3515","10","9.9"
"Houston","2020-11-28","121","38674","29","3544","12.2","11.2"
"Houston","2020-11-29","96","38770","21","3565","14.2","11.7"
"Houston","2020-11-30","373","39143","41","3606","14.6","11.6"
"Houston","2020-12-01","261","39404","30","3636","14.7","11.7"
"Houston","2020-12-02","400","39804","41","3677","14.4","11.7"
"Houston","2020-12-03","200","40004","24","3701","14.9","12.2"
"Houston","2020-12-04","358","40362","55","3756","15.1","12.6"
"Houston","2020-12-05","192","40554","19","3775","13.1","12.6"
"Houston","2020-12-06","124","40678","23","3798","12.6","13.4"
"Houston","2020-12-07","354","41032","42","3840","12.8","13.7"
"Houston","2020-12-08","260","41292","40","3880","13.3","14"
"Houston","2020-12-09","373","41665","61","3941","14.2","14.3"
"Houston","2020-12-10","318","41983","48","3989","14.6","14.8"
"Houston","2020-12-11","430","42413","73","4062","14.9","15"
"Houston","2020-12-12","203","42616","25","4087","15.2","14.2"
"Houston","2020-12-13","148","42764","45","4132","16.9","14.8"
"Houston","2020-12-14","465","43229","79","4211","17.6","15.2"
"Houston","2020-12-15","340","43569","56","4267","17.8","15.6"
"Houston","2020-12-16","433","44002","86","4353","18.3","16.3"
"Houston","2020-12-17","331","44333","44","4397","18","16.3"
"Houston","2020-12-18","422","44755","68","4465","17.9","16.4"
"Houston","2020-12-19","225","44980","58","4523","19.8","17.5"
"Houston","2020-12-20","217","45197","54","4577","19.1","18"
"Houston","2020-12-21","464","45661","96","4673","19.6","18.6"
"Houston","2020-12-22","339","46000","100","4773","21.4","19.6"
"Houston","2020-12-23","513","46513","113","4886","21.8","20"
"Houston","2020-12-24","312","46825","75","4961","23.3","20.7"
"Houston","2020-12-25","28","46853","9","4970","25.6","21.8"
"Houston","2020-12-26","216","47069","65","5035","26.2","23"
"Houston","2020-12-27","155","47224","54","5089","27.6","23.3"
"Houston","2020-12-28","611","47835","155","5244","28.3","23.9"
"Houston","2020-12-29","342","48177","98","5342","28.2","24.8"
"Houston","2020-12-30","626","48803","163","5505","28.7","25.2"
"Houston","2020-12-31","360","49163","90","5595","28.9","26.1"
"Houston","2021-01-01","46","49209","21","5616","30.8","28.2"
"Houston","2021-01-02","126","49335","53","5669","32.5","29.4"
"Houston","2021-01-03","260","49595","89","5758","32.4","30"
"Houston","2021-01-04","610","50205","183","5941","33.1","30.7"
"Houston","2021-01-05","478","50683","129","6070","32.9","30.5"
"Houston","2021-01-06","567","51250","145","6215","32.8","30.8"
"Houston","2021-01-07","394","51644","75","6290","31.9","30.4"
"Houston","2021-01-08","549","52193","83","6373","27.6","29.2"
"Houston","2021-01-09","241","52434","43","6416","24.1","28.3"
"Houston","2021-01-10","226","52660","45","6461","22.1","27.2"
"Houston","2021-01-11","530","53190","108","6569","20.7","26.9"
"Houston","2021-01-12","371","53561","88","6657","20.2","26.5"
"Houston","2021-01-13","481","54042","111","6768","19.9","26.3"
"Houston","2021-01-14","398","54440","86","6854","20.2","26.1"
"Houston","2021-01-15","388","54828","88","6942","21.3","24.4"
"Houston","2021-01-16","194","55022","46","6988","22.2","23.1"
"Houston","2021-01-17","153","55175","42","7030","23.2","22.6"
"Houston","2021-01-18","337","55512","79","7109","23.7","22.2"
"Houston","2021-01-19","473","55985","107","7216","23.5","21.9"
"Houston","2021-01-20","379","56364","64","7280","22.6","21.2"
"Houston","2021-01-21","411","56775","78","7358","22.3","21.2"
"Houston","2021-01-22","303","57078","45","7403","21.1","21.2"
"Houston","2021-01-23","132","57210","34","7437","21.4","21.8"
"Houston","2021-01-24","43","57253","17","7454","23.2","23.2"
"Houston","2021-01-25","87","57340","4","7458","20.5","22.1"
"Houston","2021-01-26","3","57343","1","7459","22","22.8"
"Houston","2021-01-27","0","57343","0","7459","19.6","21.1"
"Irwin","2020-02-01","0","0","0","0",".","."
"Irwin","2020-02-02","0","0","0","0",".","."
"Irwin","2020-02-03","0","0","0","0",".","."
"Irwin","2020-02-04","0","0","0","0",".","."
"Irwin","2020-02-05","0","0","0","0",".","."
"Irwin","2020-02-06","0","0","0","0",".","."
"Irwin","2020-02-07","0","0","0","0","0","."
"Irwin","2020-02-08","0","0","0","0","0","."
"Irwin","2020-02-09","0","0","0","0","0","."
"Irwin","2020-02-10","0","0","0","0","0","."
"Irwin","2020-02-11","0","0","0","0","0","."
"Irwin","2020-02-12","0","0","0","0","0","."
"Irwin","2020-02-13","0","0","0","0","0","."
"Irwin","2020-02-14","0","0","0","0","0","0"
"Irwin","2020-02-15","0","0","0","0","0","0"
"Irwin","2020-02-16","0","0","0","0","0","0"
"Irwin","2020-02-17","0","0","0","0","0","0"
"Irwin","2020-02-18","0","0","0","0","0","0"
"Irwin","2020-02-19","0","0","0","0","0","0"
"Irwin","2020-02-20","0","0","0","0","0","0"
"Irwin","2020-02-21","0","0","0","0","0","0"
"Irwin","2020-02-22","0","0","0","0","0","0"
"Irwin","2020-02-23","0","0","0","0","0","0"
"Irwin","2020-02-24","0","0","0","0","0","0"
"Irwin","2020-02-25","0","0","0","0","0","0"
"Irwin","2020-02-26","0","0","0","0","0","0"
"Irwin","2020-02-27","0","0","0","0","0","0"
"Irwin","2020-02-28","0","0","0","0","0","0"
"Irwin","2020-02-29","0","0","0","0","0","0"
"Irwin","2020-03-01","0","0","0","0","0","0"
"Irwin","2020-03-02","0","0","0","0","0","0"
"Irwin","2020-03-03","0","0","0","0","0","0"
"Irwin","2020-03-04","0","0","0","0","0","0"
"Irwin","2020-03-05","0","0","0","0","0","0"
"Irwin","2020-03-06","0","0","0","0","0","0"
"Irwin","2020-03-07","0","0","0","0","0","0"
"Irwin","2020-03-08","0","0","0","0","0","0"
"Irwin","2020-03-09","0","0","0","0","0","0"
"Irwin","2020-03-10","0","0","0","0","0","0"
"Irwin","2020-03-11","1","1","0","0","0","0"
"Irwin","2020-03-12","1","2","0","0","0","0"
"Irwin","2020-03-13","0","2","0","0","0","0"
"Irwin","2020-03-14","0","2","0","0","0","0"
"Irwin","2020-03-15","0","2","0","0","0","0"
"Irwin","2020-03-16","1","3","0","0","0","0"
"Irwin","2020-03-17","2","5","0","0","0","0"
"Irwin","2020-03-18","0","5","0","0","0","0"
"Irwin","2020-03-19","5","10","1","1","2.9","1.4"
"Irwin","2020-03-20","0","10","0","1","2.9","1.4"
"Irwin","2020-03-21","0","10","0","1","2.9","1.4"
"Irwin","2020-03-22","2","12","0","1","2.9","1.4"
"Irwin","2020-03-23","0","12","0","1","2.9","1.4"
"Irwin","2020-03-24","4","16","1","2","6.4","3.2"
"Irwin","2020-03-25","3","19","2","4","16","8"
"Irwin","2020-03-26","3","22","0","4","13.1","8"
"Irwin","2020-03-27","1","23","1","5","27.4","15.1"
"Irwin","2020-03-28","0","23","0","5","27.4","15.1"
"Irwin","2020-03-29","0","23","0","5","27.4","15.1"
"Irwin","2020-03-30","3","26","2","7","36.9","19.9"
"Irwin","2020-03-31","3","29","0","7","33.3","19.9"
"Irwin","2020-04-01","1","30","1","8","38.1","27"
"Irwin","2020-04-02","3","33","0","8","38.1","25.6"
"Irwin","2020-04-03","1","34","0","8","23.8","25.6"
"Irwin","2020-04-04","0","34","0","8","23.8","25.6"
"Irwin","2020-04-05","2","36","0","8","23.8","25.6"
"Irwin","2020-04-06","3","39","0","8","14.3","25.6"
"Irwin","2020-04-07","8","47","1","9","16.1","24.7"
"Irwin","2020-04-08","3","50","0","9","1.8","19.9"
"Irwin","2020-04-09","4","54","0","9","1.8","19.9"
"Irwin","2020-04-10","2","56","0","9","1.8","12.8"
"Irwin","2020-04-11","2","58","0","9","1.8","12.8"
"Irwin","2020-04-12","1","59","0","9","1.8","12.8"
"Irwin","2020-04-13","2","61","0","9","1.8","8"
"Irwin","2020-04-14","1","62","0","9","0","8"
"Irwin","2020-04-15","3","65","2","11","9.5","5.7"
"Irwin","2020-04-16","6","71","2","13","14.3","8"
"Irwin","2020-04-17","5","76","2","15","20","10.9"
"Irwin","2020-04-18","2","78","0","15","20","10.9"
"Irwin","2020-04-19","2","80","0","15","20","10.9"
"Irwin","2020-04-20","2","82","0","15","20","10.9"
"Irwin","2020-04-21","0","82","0","15","20","10"
"Irwin","2020-04-22","1","83","0","15","10.5","10"
"Irwin","2020-04-23","1","84","1","16","20","17.1"
"Irwin","2020-04-24","2","86","0","16","14.3","17.1"
"Irwin","2020-04-25","1","87","0","16","14.3","17.1"
"Irwin","2020-04-26","0","87","0","16","14.3","17.1"
"Irwin","2020-04-27","4","91","1","17","17.9","18.9"
"Irwin","2020-04-28","4","95","1","18","21.4","20.7"
"Irwin","2020-04-29","2","97","1","19","28.6","19.5"
"Irwin","2020-04-30","2","99","0","19","14.3","17.1"
"Irwin","2020-05-01","3","102","2","21","23.8","19"
"Irwin","2020-05-02","1","103","0","21","23.8","19"
"Irwin","2020-05-03","0","103","0","21","23.8","19"
"Irwin","2020-05-04","4","107","0","21","20.2","19"
"Irwin","2020-05-05","11","118","1","22","18","19.7"
"Irwin","2020-05-06","16","134","0","22","10.8","19.7"
"Irwin","2020-05-07","5","139","1","23","13.7","14"
"Irwin","2020-05-08","1","140","0","23","4.2","14"
"Irwin","2020-05-09","3","143","0","23","4.2","14"
"Irwin","2020-05-10","1","144","0","23","4.2","14"
"Irwin","2020-05-11","3","147","1","24","8.9","14.6"
"Irwin","2020-05-12","8","155","0","24","7.6","12.8"
"Irwin","2020-05-13","5","160","0","24","7.6","9.2"
"Irwin","2020-05-14","4","164","0","24","4.8","9.2"
"Irwin","2020-05-15","2","166","0","24","4.8","4.5"
"Irwin","2020-05-16","2","168","0","24","4.8","4.5"
"Irwin","2020-05-17","1","169","0","24","4.8","4.5"
"Irwin","2020-05-18","5","174","1","25","2.9","5.9"
"Irwin","2020-05-19","18","192","1","26","3.7","5.6"
"Irwin","2020-05-20","7","199","1","27","5.7","6.7"
"Irwin","2020-05-21","3","202","0","27","5.7","5.2"
"Irwin","2020-05-22","3","205","1","28","10.5","7.6"
"Irwin","2020-05-23","2","207","0","28","10.5","7.6"
"Irwin","2020-05-24","0","207","0","28","10.5","7.6"
"Irwin","2020-05-25","1","208","0","28","7.6","5.2"
"Irwin","2020-05-26","13","221","0","28","6.8","5.2"
"Irwin","2020-05-27","5","226","2","30","10.5","8.1"
"Irwin","2020-05-28","1","227","1","31","24.8","15.2"
"Irwin","2020-05-29","0","227","0","31","20","15.2"
"Irwin","2020-05-30","0","227","0","31","20","15.2"
"Irwin","2020-05-31","4","231","0","31","20","15.2"
"Irwin","2020-06-01","4","235","1","32","23.6","15.6"
"Irwin","2020-06-02","15","250","1","33","24.5","15.7"
"Irwin","2020-06-03","17","267","1","34","19.6","15.1"
"Irwin","2020-06-04","7","274","1","35","7.4","16.1"
"Irwin","2020-06-05","14","288","1","36","8.4","14.2"
"Irwin","2020-06-06","1","289","0","36","8.4","14.2"
"Irwin","2020-06-07","2","291","0","36","8.4","14.2"
"Irwin","2020-06-08","7","298","0","36","4.9","14.2"
"Irwin","2020-06-09","18","316","0","36","3.9","14.2"
"Irwin","2020-06-10","13","329","3","39","6.4","13"
"Irwin","2020-06-11","5","334","3","42","12.9","10.1"
"Irwin","2020-06-12","11","345","2","44","14.5","11.4"
"Irwin","2020-06-13","0","345","0","44","14.5","11.4"
"Irwin","2020-06-14","0","345","0","44","14.5","11.4"
"Irwin","2020-06-15","9","354","0","44","14.5","9.7"
"Irwin","2020-06-16","39","393","1","45","14.8","9.4"
"Irwin","2020-06-17","25","418","1","46","12.1","9.2"
"Irwin","2020-06-18","3","421","0","46","3.5","8.2"
"Irwin","2020-06-19","7","428","0","46","0.9","7.7"
"Irwin","2020-06-20","2","430","0","46","0.9","7.7"
"Irwin","2020-06-21","1","431","0","46","0.9","7.7"
"Irwin","2020-06-22","12","443","0","46","0.9","7.7"
"Irwin","2020-06-23","30","473","4","50","2.5","8.7"
"Irwin","2020-06-24","30","503","3","53","3.3","7.7"
"Irwin","2020-06-25","2","505","0","53","3.3","3.4"
"Irwin","2020-06-26","21","526","6","59","7.4","4.2"
"Irwin","2020-06-27","6","532","0","59","7.4","4.2"
"Irwin","2020-06-28","1","533","0","59","7.4","4.2"
"Irwin","2020-06-29","94","627","9","68","8.8","4.9"
"Irwin","2020-06-30","62","689","6","74","8.3","5.4"
"Irwin","2020-07-01","26","715","3","77","8.5","5.9"
"Irwin","2020-07-02","9","724","2","79","11.7","7.5"
"Irwin","2020-07-03","4","728","1","80","11.1","9.3"
"Irwin","2020-07-04","5","733","3","83","19.7","13.6"
"Irwin","2020-07-05","3","736","1","84","24.5","15.9"
"Irwin","2020-07-06","25","761","3","87","24.8","16.8"
"Irwin","2020-07-07","91","852","19","106","26.4","17.3"
"Irwin","2020-07-08","18","870","2","108","26.4","17.4"
"Irwin","2020-07-09","13","883","4","112","27.6","19.6"
"Irwin","2020-07-10","9","892","1","113","25.6","18.4"
"Irwin","2020-07-11","3","895","0","113","17","18.4"
"Irwin","2020-07-12","2","897","1","114","19.4","21.9"
"Irwin","2020-07-13","59","956","2","116","18.2","21.5"
"Irwin","2020-07-14","32","988","1","117","15.6","21"
"Irwin","2020-07-15","27","1015","2","119","15.1","20.7"
"Irwin","2020-07-16","10","1025","0","119","10.7","19.2"
"Irwin","2020-07-17","15","1040","3","122","12","18.8"
"Irwin","2020-07-18","2","1042","1","123","19.1","18.1"
"Irwin","2020-07-19","2","1044","0","123","12","15.7"
"Irwin","2020-07-20","12","1056","3","126","15.1","16.6"
"Irwin","2020-07-21","54","1110","8","134","16.7","16.2"
"Irwin","2020-07-22","12","1122","2","136","18.1","16.6"
"Irwin","2020-07-23","17","1139","3","139","20.6","15.7"
"Irwin","2020-07-24","20","1159","6","145","22","17"
"Irwin","2020-07-25","2","1161","1","146","22","20.6"
"Irwin","2020-07-26","3","1164","0","146","22","17"
"Irwin","2020-07-27","28","1192","6","152","21.5","18.3"
"Irwin","2020-07-28","20","1212","5","157","23","19.9"
"Irwin","2020-07-29","10","1222","3","160","24.9","21.5"
"Irwin","2020-07-30","21","1243","3","163","24.4","22.5"
"Irwin","2020-07-31","17","1260","2","165","21.8","21.9"
"Irwin","2020-08-01","3","1263","0","165","14.6","18.3"
"Irwin","2020-08-02","3","1266","0","165","14.6","18.3"
"Irwin","2020-08-03","90","1356","2","167","11.9","16.7"
"Irwin","2020-08-04","22","1378","2","169","9.6","16.3"
"Irwin","2020-08-05","23","1401","2","171","6.6","15.7"
"Irwin","2020-08-06","23","1424","0","171","4.5","14.5"
"Irwin","2020-08-07","24","1448","1","172","3.5","12.6"
"Irwin","2020-08-08","6","1454","0","172","3.5","9"
"Irwin","2020-08-09","3","1457","0","172","3.5","9"
"Irwin","2020-08-10","42","1499","7","179","5.5","8.7"
"Irwin","2020-08-11","18","1517","7","186","9.8","9.7"
"Irwin","2020-08-12","78","1595","4","190","9.3","7.9"
"Irwin","2020-08-13","10","1605","1","191","10.7","7.6"
"Irwin","2020-08-14","31","1636","0","191","10.1","6.8"
"Irwin","2020-08-15","16","1652","1","192","11","7.2"
"Irwin","2020-08-16","3","1655","0","192","11","7.2"
"Irwin","2020-08-17","10","1665","1","193","10","7.8"
"Irwin","2020-08-18","14","1679","0","193","4.5","7.1"
"Irwin","2020-08-19","60","1739","0","193","3.8","6.5"
"Irwin","2020-08-20","391","2130","7","200","2.6","6.6"
"Irwin","2020-08-21","85","2215","3","203","3.1","6.6"
"Irwin","2020-08-22","3","2218","0","203","2.2","6.6"
"Irwin","2020-08-23","2","2220","0","203","2.2","6.6"
"Irwin","2020-08-24","36","2256","4","207","2.3","6.2"
"Irwin","2020-08-25","30","2286","1","208","2.8","3.7"
"Irwin","2020-08-26","26","2312","0","208","2.8","3.3"
"Irwin","2020-08-27","27","2339","2","210","3.6","3.1"
"Irwin","2020-08-28","23","2362","1","211","3.7","3.4"
"Irwin","2020-08-29","24","2386","0","211","3.7","3"
"Irwin","2020-08-30","4","2390","0","211","3.7","3"
"Irwin","2020-08-31","60","2450","2","213","2.6","2.5"
"Irwin","2020-09-01","10","2460","0","213","2.2","2.5"
"Irwin","2020-09-02","27","2487","3","216","3.7","3.3"
"Irwin","2020-09-03","21","2508","1","217","3.4","3.5"
"Irwin","2020-09-04","83","2591","4","221","3.4","3.6"
"Irwin","2020-09-05","10","2601","1","222","4.9","4.3"
"Irwin","2020-09-06","1","2602","0","222","4.9","4.3"
"Irwin","2020-09-07","2","2604","0","222","4.4","3.5"
"Irwin","2020-09-08","27","2631","2","224","5.4","3.8"
"Irwin","2020-09-09","23","2654","0","224","3.9","3.8"
"Irwin","2020-09-10","10","2664","1","225","4.6","4"
"Irwin","2020-09-11","104","2768","14","239","5.8","4.6"
"Irwin","2020-09-12","7","2775","0","239","4.4","4.6"
"Irwin","2020-09-13","4","2779","2","241","11.6","8.2"
"Irwin","2020-09-14","16","2795","2","243","13.3","8.9"
"Irwin","2020-09-15","34","2829","1","244","12.7","9.1"
"Irwin","2020-09-16","26","2855","2","246","13.8","8.8"
"Irwin","2020-09-17","38","2893","6","252","14.6","9.6"
"Irwin","2020-09-18","12","2905","3","255","16.3","11.1"
"Irwin","2020-09-19","6","2911","2","257","21","12.7"
"Irwin","2020-09-20","2","2913","0","257","13.9","12.7"
"Irwin","2020-09-21","28","2941","0","257","12.1","12.7"
"Irwin","2020-09-22","29","2970","1","258","12.2","12.4"
"Irwin","2020-09-23","37","3007","4","262","12.6","13.2"
"Irwin","2020-09-24","28","3035","1","263","10.9","12.8"
"Irwin","2020-09-25","32","3067","2","265","8.2","12.2"
"Irwin","2020-09-26","2","3069","0","265","3.4","12.2"
"Irwin","2020-09-27","0","3069","0","265","3.4","8.7"
"Irwin","2020-09-28","11","3080","3","268","7.3","9.7"
"Irwin","2020-09-29","28","3108","6","274","9.9","11"
"Irwin","2020-09-30","27","3135","2","276","9.4","11"
"Irwin","2020-10-01","30","3165","5","281","11.3","11.1"
"Irwin","2020-10-02","18","3183","0","281","10.4","9.3"
"Irwin","2020-10-03","5","3188","1","282","13.3","8.3"
"Irwin","2020-10-04","5","3193","1","283","16.1","9.8"
"Irwin","2020-10-05","15","3208","2","285","14.1","10.7"
"Irwin","2020-10-06","4","3212","0","285","11.1","10.5"
"Irwin","2020-10-07","22","3234","0","285","10","9.7"
"Irwin","2020-10-08","28","3262","3","288","9.1","10.2"
"Irwin","2020-10-09","11","3273","2","290","11.7","11.1"
"Irwin","2020-10-10","1","3274","0","290","8.9","11.1"
"Irwin","2020-10-11","4","3278","1","291","9.6","12.9"
"Irwin","2020-10-12","5","3283","0","291","7.7","10.9"
"Irwin","2020-10-13","33","3316","1","292","8.1","9.6"
"Irwin","2020-10-14","19","3335","2","294","9.6","9.8"
"Irwin","2020-10-15","25","3360","1","295","8.7","8.9"
"Irwin","2020-10-16","8","3368","0","295","6.1","8.9"
"Irwin","2020-10-17","1","3369","0","295","6.1","7.5"
"Irwin","2020-10-18","4","3373","0","295","2.5","6.1"
"Irwin","2020-10-19","11","3384","1","296","3.8","5.8"
"Irwin","2020-10-20","15","3399","0","296","3.4","5.8"
"Irwin","2020-10-21","42","3441","2","298","2.6","6.1"
"Irwin","2020-10-22","12","3453","0","298","2","5.3"
"Irwin","2020-10-23","13","3466","2","300","4.2","5.1"
"Irwin","2020-10-24","21","3487","1","301","4.9","5.5"
"Irwin","2020-10-25","1","3488","0","301","4.9","3.7"
"Irwin","2020-10-26","24","3512","2","303","4.7","4.3"
"Irwin","2020-10-27","21","3533","1","304","5.4","4.4"
"Irwin","2020-10-28","25","3558","2","306","5.9","4.2"
"Irwin","2020-10-29","6","3564","1","307","8.3","5.1"
"Irwin","2020-10-30","18","3582","1","308","6.9","5.5"
"Irwin","2020-10-31","3","3585","0","308","6.2","5.5"
"Irwin","2020-11-01","4","3589","1","309","9.8","7.3"
"Irwin","2020-11-02","36","3625","4","313","10.2","7.5"
"Irwin","2020-11-03","32","3657","2","315","10.4","7.9"
"Irwin","2020-11-04","40","3697","1","316","9.6","7.7"
"Irwin","2020-11-05","33","3730","1","317","7.6","8"
"Irwin","2020-11-06","15","3745","0","317","6.8","6.9"
"Irwin","2020-11-07","2","3747","0","317","6.8","6.5"
"Irwin","2020-11-08","2","3749","0","317","3.3","6.5"
"Irwin","2020-11-09","21","3770","4","321","4.4","7.3"
"Irwin","2020-11-10","35","3805","4","325","5.1","7.8"
"Irwin","2020-11-11","14","3819","1","326","5.8","7.7"
"Irwin","2020-11-12","30","3849","1","327","5.9","6.7"
"Irwin","2020-11-13","12","3861","2","329","8.2","7.5"
"Irwin","2020-11-14","6","3867","1","330","10.6","8.7"
"Irwin","2020-11-15","1","3868","0","330","10.6","6.9"
"Irwin","2020-11-16","32","3900","5","335","10.1","7.3"
"Irwin","2020-11-17","33","3933","3","338","9.8","7.5"
"Irwin","2020-11-18","4","3937","0","338","8.8","7.3"
"Irwin","2020-11-19","28","3965","1","339","8.8","7.3"
"Irwin","2020-11-20","42","4007","1","340","6.8","7.5"
"Irwin","2020-11-21","5","4012","2","342","10.1","10.4"
"Irwin","2020-11-22","8","4020","1","343","11.9","11.2"
"Irwin","2020-11-23","32","4052","4","347","11.4","10.8"
"Irwin","2020-11-24","14","4066","1","348","11.2","10.5"
"Irwin","2020-11-25","11","4077","1","349","12.5","10.6"
"Irwin","2020-11-26","4","4081","0","349","11.9","10.4"
"Irwin","2020-11-27","6","4087","0","349","11.6","9.2"
"Irwin","2020-11-28","3","4090","0","349","5.9","8"
"Irwin","2020-11-29","6","4096","1","350","6.5","9.2"
"Irwin","2020-11-30","28","4124","5","355","7.3","9.3"
"Irwin","2020-12-01","14","4138","1","356","7.3","9.2"
"Irwin","2020-12-02","10","4148","0","356","6","9.2"
"Irwin","2020-12-03","13","4161","5","361","11.4","11.7"
"Irwin","2020-12-04","14","4175","1","362","12.5","12"
"Irwin","2020-12-05","6","4181","3","365","19.6","12.8"
"Irwin","2020-12-06","4","4185","1","366","20.8","13.6"
"Irwin","2020-12-07","43","4228","7","373","20.6","13.9"
"Irwin","2020-12-08","23","4251","6","379","23.3","15.3"
"Irwin","2020-12-09","19","4270","3","382","25.5","15.7"
"Irwin","2020-12-10","12","4282","0","382","20","15.7"
"Irwin","2020-12-11","12","4294","4","386","23.8","18.1"
"Irwin","2020-12-12","7","4301","1","387","18.7","19.1"
"Irwin","2020-12-13","8","4309","3","390","20.5","20.6"
"Irwin","2020-12-14","49","4358","12","402","21.6","21.1"
"Irwin","2020-12-15","13","4371","2","404","20.1","21.7"
"Irwin","2020-12-16","10","4381","4","408","23.6","24.6"
"Irwin","2020-12-17","27","4408","9","417","28.3","24.2"
"Irwin","2020-12-18","8","4416","3","420","28.9","26.4"
"Irwin","2020-12-19","5","4421","3","423","35.5","27.1"
"Irwin","2020-12-20","9","4430","1","424","31.7","26.1"
"Irwin","2020-12-21","58","4488","13","437","31.4","26.5"
"Irwin","2020-12-22","16","4504","4","441","32.8","26.4"
"Irwin","2020-12-23","12","4516","2","443","29.4","26.5"
"Irwin","2020-12-24","10","4526","4","447","30.4","29.4"
"Irwin","2020-12-25","1","4527","1","448","39.3","34.1"
"Irwin","2020-12-26","5","4532","2","450","36.5","36"
"Irwin","2020-12-27","2","4534","1","451","42","36.8"
"Irwin","2020-12-28","79","4613","17","468","41.9","36.6"
"Irwin","2020-12-29","11","4624","2","470","40.9","36.8"
"Irwin","2020-12-30","45","4669","13","483","42.7","36"
"Irwin","2020-12-31","10","4679","3","486","41.2","35.8"
"Irwin","2021-01-01","4","4683","0","486","26.9","33.1"
"Irwin","2021-01-02","4","4687","0","486","21.2","28.8"
"Irwin","2021-01-03","5","4692","1","487","16.9","29.5"
"Irwin","2021-01-04","43","4735","10","497","17.2","29.5"
"Irwin","2021-01-05","15","4750","1","498","15.5","28.2"
"Irwin","2021-01-06","14","4764","0","498","11.4","27"
"Irwin","2021-01-07","25","4789","2","500","8.3","24.8"
"Irwin","2021-01-08","11","4800","2","502","10.9","18.9"
"Irwin","2021-01-09","5","4805","2","504","16.6","18.9"
"Irwin","2021-01-10","3","4808","3","507","28","22.5"
"Irwin","2021-01-11","32","4840","6","513","27.4","22.3"
"Irwin","2021-01-12","10","4850","3","516","30.7","23.1"
"Irwin","2021-01-13","28","4878","4","520","32.7","22.1"
"Irwin","2021-01-14","8","4886","0","520","31.6","19.9"
"Irwin","2021-01-15","10","4896","1","521","30.4","20.7"
"Irwin","2021-01-16","5","4901","2","523","30.4","23.5"
"Irwin","2021-01-17","2","4903","1","524","23.3","25.7"
"Irwin","2021-01-18","6","4909","0","524","20.6","24"
"Irwin","2021-01-19","5","4914","1","525","19.2","24.9"
"Irwin","2021-01-20","10","4924","1","526","18.6","25.7"
"Irwin","2021-01-21","10","4934","1","527","20","25.8"
"Irwin","2021-01-22","6","4940","2","529","23.3","26.9"
"Irwin","2021-01-23","2","4942","1","530","24.8","27.6"
"Irwin","2021-01-24","3","4945","2","532","27.1","25.2"
"Irwin","2021-01-25","1","4946","0","532","27.1","23.9"
"Irwin","2021-01-26","0","4946","0","532","24.3","21.7"
"Irwin","2021-01-27","0","4946","0","532","22.9","20.7"
"Jackson","2020-02-01","0","0","0","0",".","."
"Jackson","2020-02-02","0","0","0","0",".","."
"Jackson","2020-02-03","0","0","0","0",".","."
"Jackson","2020-02-04","0","0","0","0",".","."
"Jackson","2020-02-05","0","0","0","0",".","."
"Jackson","2020-02-06","0","0","0","0",".","."
"Jackson","2020-02-07","0","0","0","0","0","."
"Jackson","2020-02-08","0","0","0","0","0","."
"Jackson","2020-02-09","0","0","0","0","0","."
"Jackson","2020-02-10","0","0","0","0","0","."
"Jackson","2020-02-11","0","0","0","0","0","."
"Jackson","2020-02-12","0","0","0","0","0","."
"Jackson","2020-02-13","0","0","0","0","0","."
"Jackson","2020-02-14","0","0","0","0","0","0"
"Jackson","2020-02-15","0","0","0","0","0","0"
"Jackson","2020-02-16","0","0","0","0","0","0"
"Jackson","2020-02-17","0","0","0","0","0","0"
"Jackson","2020-02-18","0","0","0","0","0","0"
"Jackson","2020-02-19","0","0","0","0","0","0"
"Jackson","2020-02-20","0","0","0","0","0","0"
"Jackson","2020-02-21","0","0","0","0","0","0"
"Jackson","2020-02-22","0","0","0","0","0","0"
"Jackson","2020-02-23","0","0","0","0","0","0"
"Jackson","2020-02-24","0","0","0","0","0","0"
"Jackson","2020-02-25","0","0","0","0","0","0"
"Jackson","2020-02-26","0","0","0","0","0","0"
"Jackson","2020-02-27","0","0","0","0","0","0"
"Jackson","2020-02-28","0","0","0","0","0","0"
"Jackson","2020-02-29","0","0","0","0","0","0"
"Jackson","2020-03-01","0","0","0","0","0","0"
"Jackson","2020-03-02","0","0","0","0","0","0"
"Jackson","2020-03-03","0","0","0","0","0","0"
"Jackson","2020-03-04","0","0","0","0","0","0"
"Jackson","2020-03-05","0","0","0","0","0","0"
"Jackson","2020-03-06","0","0","0","0","0","0"
"Jackson","2020-03-07","0","0","0","0","0","0"
"Jackson","2020-03-08","0","0","0","0","0","0"
"Jackson","2020-03-09","0","0","0","0","0","0"
"Jackson","2020-03-10","0","0","0","0","0","0"
"Jackson","2020-03-11","1","1","0","0","0","0"
"Jackson","2020-03-12","2","3","0","0","0","0"
"Jackson","2020-03-13","3","6","0","0","0","0"
"Jackson","2020-03-14","3","9","0","0","0","0"
"Jackson","2020-03-15","1","10","0","0","0","0"
"Jackson","2020-03-16","7","17","0","0","0","0"
"Jackson","2020-03-17","15","32","0","0","0","0"
"Jackson","2020-03-18","21","53","0","0","0","0"
"Jackson","2020-03-19","21","74","1","1","0.7","0.3"
"Jackson","2020-03-20","10","84","2","3","3.5","1.8"
"Jackson","2020-03-21","13","97","0","3","3.5","1.8"
"Jackson","2020-03-22","6","103","0","3","3.5","1.8"
"Jackson","2020-03-23","23","126","1","4","4.2","2.1"
"Jackson","2020-03-24","23","149","1","5","4.8","2.4"
"Jackson","2020-03-25","18","167","1","6","5.6","2.8"
"Jackson","2020-03-26","19","186","3","9","7.1","3.9"
"Jackson","2020-03-27","5","191","2","11","10","6.8"
"Jackson","2020-03-28","4","195","2","13","17.1","10.3"
"Jackson","2020-03-29","3","198","1","14","21.9","12.7"
"Jackson","2020-03-30","12","210","0","14","21.3","12.7"
"Jackson","2020-03-31","6","216","0","14","20.7","12.7"
"Jackson","2020-04-01","14","230","0","14","19.9","12.7"
"Jackson","2020-04-02","11","241","0","14","17.6","12.4"
"Jackson","2020-04-03","11","252","2","16","14.5","12.3"
"Jackson","2020-04-04","1","253","0","16","7.4","12.3"
"Jackson","2020-04-05","2","255","0","16","2.6","12.3"
"Jackson","2020-04-06","11","266","1","17","3.9","12.6"
"Jackson","2020-04-07","5","271","1","18","6.8","13.7"
"Jackson","2020-04-08","12","283","0","18","6.8","13.3"
"Jackson","2020-04-09","11","294","0","18","6.8","12.2"
"Jackson","2020-04-10","10","304","1","19","5.6","10"
"Jackson","2020-04-11","7","311","0","19","5.6","6.5"
"Jackson","2020-04-12","1","312","0","19","5.6","4.1"
"Jackson","2020-04-13","21","333","1","20","5","4.4"
"Jackson","2020-04-14","18","351","0","20","2.1","4.4"
"Jackson","2020-04-15","15","366","1","21","3.1","4.9"
"Jackson","2020-04-16","26","392","5","26","5.8","6.3"
"Jackson","2020-04-17","23","415","0","26","4.4","5"
"Jackson","2020-04-18","16","431","2","28","6.2","5.9"
"Jackson","2020-04-19","2","433","0","28","6.2","5.9"
"Jackson","2020-04-20","33","466","3","31","6.8","5.9"
"Jackson","2020-04-21","27","493","8","39","11","6.6"
"Jackson","2020-04-22","23","516","2","41","11.3","7.2"
"Jackson","2020-04-23","19","535","2","43","10.1","7.9"
"Jackson","2020-04-24","29","564","0","43","10.1","7.2"
"Jackson","2020-04-25","20","584","0","43","8.3","7.2"
"Jackson","2020-04-26","7","591","0","43","8.3","7.2"
"Jackson","2020-04-27","13","604","1","44","8.1","7.4"
"Jackson","2020-04-28","32","636","5","49","6.1","8.5"
"Jackson","2020-04-29","36","672","2","51","5.6","8.5"
"Jackson","2020-04-30","30","702","2","53","5.1","7.6"
"Jackson","2020-05-01","33","735","3","56","6.4","8.2"
"Jackson","2020-05-02","13","748","3","59","9.7","9"
"Jackson","2020-05-03","16","764","0","59","9.7","9"
"Jackson","2020-05-04","32","796","0","59","8.6","8.3"
"Jackson","2020-05-05","30","826","1","60","6.8","6.4"
"Jackson","2020-05-06","23","849","1","61","6.6","6.1"
"Jackson","2020-05-07","24","873","2","63","6.9","6"
"Jackson","2020-05-08","27","900","0","63","5.6","6"
"Jackson","2020-05-09","4","904","0","63","2.3","6"
"Jackson","2020-05-10","11","915","0","63","2.3","6"
"Jackson","2020-05-11","36","951","0","63","2.3","5.4"
"Jackson","2020-05-12","37","988","1","64","2.2","4.5"
"Jackson","2020-05-13","30","1018","2","66","2.5","4.6"
"Jackson","2020-05-14","36","1054","0","66","1.3","4.1"
"Jackson","2020-05-15","33","1087","2","68","2.2","3.9"
"Jackson","2020-05-16","22","1109","1","69","2.9","2.6"
"Jackson","2020-05-17","14","1123","1","70","3.9","3.1"
"Jackson","2020-05-18","47","1170","2","72","4.5","3.4"
"Jackson","2020-05-19","52","1222","3","75","4.9","3.6"
"Jackson","2020-05-20","59","1281","1","76","4.2","3.4"
"Jackson","2020-05-21","101","1382","2","78","4.5","2.9"
"Jackson","2020-05-22","158","1540","7","85","4.3","3.2"
"Jackson","2020-05-23","27","1567","1","86","4.1","3.5"
"Jackson","2020-05-24","20","1587","0","86","3.1","3.5"
"Jackson","2020-05-25","19","1606","0","86","2.5","3.5"
"Jackson","2020-05-26","49","1655","8","94","4","4.5"
"Jackson","2020-05-27","41","1696","1","95","4.1","4.2"
"Jackson","2020-05-28","47","1743","0","95","3.8","4.2"
"Jackson","2020-05-29","67","1810","4","99","4.1","4.2"
"Jackson","2020-05-30","32","1842","2","101","4.4","4.3"
"Jackson","2020-05-31","28","1870","2","103","5.4","4.3"
"Jackson","2020-06-01","82","1952","6","109","6.5","4.5"
"Jackson","2020-06-02","65","2017","4","113","5","4.5"
"Jackson","2020-06-03","60","2077","2","115","5.2","4.6"
"Jackson","2020-06-04","61","2138","3","118","5.9","4.9"
"Jackson","2020-06-05","76","2214","6","124","6.1","5.1"
"Jackson","2020-06-06","31","2245","0","124","5.3","4.8"
"Jackson","2020-06-07","23","2268","1","125","4.9","5.1"
"Jackson","2020-06-08","62","2330","5","130","5","5.7"
"Jackson","2020-06-09","60","2390","6","136","5.5","5.3"
"Jackson","2020-06-10","63","2453","6","142","6.4","5.8"
"Jackson","2020-06-11","63","2516","1","143","5.9","5.9"
"Jackson","2020-06-12","101","2617","4","147","5.4","5.7"
"Jackson","2020-06-13","32","2649","5","152","7.6","6.4"
"Jackson","2020-06-14","34","2683","2","154","7.8","6.3"
"Jackson","2020-06-15","64","2747","0","154","6.7","5.8"
"Jackson","2020-06-16","56","2803","6","160","6.8","6.1"
"Jackson","2020-06-17","46","2849","3","163","6.3","6.4"
"Jackson","2020-06-18","72","2921","7","170","7.5","6.7"
"Jackson","2020-06-19","66","2987","9","179","8.9","7.1"
"Jackson","2020-06-20","26","3013","3","182","8.3","7.9"
"Jackson","2020-06-21","31","3044","1","183","7.9","7.9"
"Jackson","2020-06-22","124","3168","13","196","9.4","8"
"Jackson","2020-06-23","84","3252","7","203","9.1","7.9"
"Jackson","2020-06-24","77","3329","5","208","9.1","7.7"
"Jackson","2020-06-25","110","3439","13","221","9.4","8.4"
"Jackson","2020-06-26","128","3567","18","239","9.4","9.1"
"Jackson","2020-06-27","71","3638","10","249","9.8","9"
"Jackson","2020-06-28","23","3661","1","250","9.9","8.9"
"Jackson","2020-06-29","194","3855","20","270","9.9","9.7"
"Jackson","2020-06-30","143","3998","21","291","10.8","9.9"
"Jackson","2020-07-01","98","4096","6","297","10.8","9.9"
"Jackson","2020-07-02","97","4193","14","311","11.1","10.3"
"Jackson","2020-07-03","72","4265","7","318","10.5","10"
"Jackson","2020-07-04","58","4323","2","320","9","9.4"
"Jackson","2020-07-05","75","4398","6","326","9.5","9.7"
"Jackson","2020-07-06","117","4515","15","341","9.9","9.9"
"Jackson","2020-07-07","199","4714","19","360","9.2","10"
"Jackson","2020-07-08","167","4881","14","374","9.5","10.1"
"Jackson","2020-07-09","137","5018","18","392","9.3","10.2"
"Jackson","2020-07-10","122","5140","12","404","9.3","9.9"
"Jackson","2020-07-11","33","5173","1","405","9.3","9.1"
"Jackson","2020-07-12","27","5200","2","407","9.2","9.3"
"Jackson","2020-07-13","104","5304","15","422","9.4","9.6"
"Jackson","2020-07-14","119","5423","19","441","10.3","9.7"
"Jackson","2020-07-15","121","5544","14","455","10.8","10.1"
"Jackson","2020-07-16","108","5652","23","478","11.9","10.6"
"Jackson","2020-07-17","98","5750","10","488","12","10.6"
"Jackson","2020-07-18","57","5807","11","499","14.3","11.8"
"Jackson","2020-07-19","63","5870","9","508","15.3","12.2"
"Jackson","2020-07-20","89","5959","9","517","14.7","12"
"Jackson","2020-07-21","92","6051","13","530","14.4","12.4"
"Jackson","2020-07-22","114","6165","7","537","13.6","12.2"
"Jackson","2020-07-23","82","6247","8","545","12","12"
"Jackson","2020-07-24","97","6344","12","557","12.3","12.1"
"Jackson","2020-07-25","60","6404","10","567","11.9","13.1"
"Jackson","2020-07-26","37","6441","8","575","13","14.1"
"Jackson","2020-07-27","132","6573","11","586","12.7","13.7"
"Jackson","2020-07-28","77","6650","9","595","12.4","13.4"
"Jackson","2020-07-29","71","6721","11","606","13.7","13.7"
"Jackson","2020-07-30","96","6817","18","624","15","13.5"
"Jackson","2020-07-31","93","6910","10","634","14.8","13.5"
"Jackson","2020-08-01","61","6971","11","645","15","13.4"
"Jackson","2020-08-02","63","7034","8","653","13.7","13.3"
"Jackson","2020-08-03","81","7115","7","660","13.7","13.2"
"Jackson","2020-08-04","102","7217","14","674","14","13.2"
"Jackson","2020-08-05","80","7297","8","682","13.2","13.5"
"Jackson","2020-08-06","86","7383","6","688","11.5","13.3"
"Jackson","2020-08-07","87","7470","2","690","10.3","12.5"
"Jackson","2020-08-08","38","7508","5","695","9.6","12.3"
"Jackson","2020-08-09","38","7546","6","701","10.1","11.9"
"Jackson","2020-08-10","115","7661","8","709","9.8","11.8"
"Jackson","2020-08-11","107","7768","12","721","9.5","11.7"
"Jackson","2020-08-12","77","7845","8","729","9.5","11.4"
"Jackson","2020-08-13","104","7949","11","740","10.1","10.8"
"Jackson","2020-08-14","92","8041","8","748","11","10.7"
"Jackson","2020-08-15","47","8088","5","753","10.6","10.1"
"Jackson","2020-08-16","62","8150","3","756","9","9.6"
"Jackson","2020-08-17","133","8283","8","764","8.9","9.4"
"Jackson","2020-08-18","157","8440","4","768","7.7","8.6"
"Jackson","2020-08-19","121","8561","12","780","7.6","8.6"
"Jackson","2020-08-20","100","8661","5","785","6.8","8.4"
"Jackson","2020-08-21","99","8760","2","787","5.9","8.4"
"Jackson","2020-08-22","64","8824","8","795","6.1","8.4"
"Jackson","2020-08-23","55","8879","7","802","7.2","8.1"
"Jackson","2020-08-24","156","9035","6","808","6.9","7.9"
"Jackson","2020-08-25","131","9166","13","821","8","7.8"
"Jackson","2020-08-26","127","9293","14","835","8.1","7.9"
"Jackson","2020-08-27","97","9390","10","845","8.9","7.9"
"Jackson","2020-08-28","126","9516","12","857","10","7.9"
"Jackson","2020-08-29","53","9569","5","862","9.5","7.8"
"Jackson","2020-08-30","41","9610","6","868","9.8","8.5"
"Jackson","2020-08-31","111","9721","6","874","10","8.5"
"Jackson","2020-09-01","128","9849","5","879","9.2","8.6"
"Jackson","2020-09-02","108","9957","5","884","8.3","8.2"
"Jackson","2020-09-03","105","10062","7","891","7.7","8.3"
"Jackson","2020-09-04","106","10168","9","900","7.6","8.8"
"Jackson","2020-09-05","48","10216","1","901","6.5","8"
"Jackson","2020-09-06","30","10246","1","902","4.9","7.4"
"Jackson","2020-09-07","46","10292","6","908","6","8"
"Jackson","2020-09-08","127","10419","20","928","7.7","8.4"
"Jackson","2020-09-09","83","10502","8","936","8.4","8.3"
"Jackson","2020-09-10","109","10611","9","945","8.7","8.2"
"Jackson","2020-09-11","97","10708","12","957","9.2","8.4"
"Jackson","2020-09-12","45","10753","9","966","11.8","9.2"
"Jackson","2020-09-13","45","10798","11","977","14.8","9.9"
"Jackson","2020-09-14","103","10901","6","983","13.8","9.9"
"Jackson","2020-09-15","100","11001","12","995","13.2","10.5"
"Jackson","2020-09-16","111","11112","6","1001","12.6","10.5"
"Jackson","2020-09-17","101","11213","8","1009","12.6","10.6"
"Jackson","2020-09-18","133","11346","8","1017","11.7","10.4"
"Jackson","2020-09-19","44","11390","2","1019","9.5","10.6"
"Jackson","2020-09-20","29","11419","3","1022","7.4","11.1"
"Jackson","2020-09-21","101","11520","8","1030","7.7","10.7"
"Jackson","2020-09-22","95","11615","8","1038","7.2","10.2"
"Jackson","2020-09-23","93","11708","5","1043","7.2","9.9"
"Jackson","2020-09-24","77","11785","5","1048","7","9.8"
"Jackson","2020-09-25","91","11876","12","1060","8","9.8"
"Jackson","2020-09-26","29","11905","4","1064","9.4","9.4"
"Jackson","2020-09-27","30","11935","2","1066","8.8","8.1"
"Jackson","2020-09-28","106","12041","6","1072","8.5","8.1"
"Jackson","2020-09-29","84","12125","3","1075","7.8","7.5"
"Jackson","2020-09-30","95","12220","6","1081","8","7.6"
"Jackson","2020-10-01","91","12311","7","1088","8.1","7.6"
"Jackson","2020-10-02","110","12421","3","1091","6.6","7.3"
"Jackson","2020-10-03","60","12481","5","1096","5.9","7.6"
"Jackson","2020-10-04","37","12518","2","1098","5.7","7.3"
"Jackson","2020-10-05","96","12614","8","1106","6.1","7.3"
"Jackson","2020-10-06","100","12714","9","1115","6.8","7.3"
"Jackson","2020-10-07","108","12822","7","1122","6.9","7.4"
"Jackson","2020-10-08","88","12910","1","1123","5.9","7"
"Jackson","2020-10-09","109","13019","6","1129","6.3","6.5"
"Jackson","2020-10-10","53","13072","7","1136","7","6.4"
"Jackson","2020-10-11","43","13115","5","1141","7.9","6.8"
"Jackson","2020-10-12","114","13229","19","1160","9.1","7.6"
"Jackson","2020-10-13","103","13332","14","1174","9.7","8.3"
"Jackson","2020-10-14","87","13419","9","1183","10.3","8.6"
"Jackson","2020-10-15","130","13549","10","1193","11.2","8.6"
"Jackson","2020-10-16","86","13635","8","1201","11.8","9"
"Jackson","2020-10-17","82","13717","9","1210","11.5","9.2"
"Jackson","2020-10-18","26","13743","4","1214","12","9.9"
"Jackson","2020-10-19","131","13874","12","1226","10.9","10"
"Jackson","2020-10-20","95","13969","6","1232","9.9","9.8"
"Jackson","2020-10-21","114","14083","18","1250","10.7","10.5"
"Jackson","2020-10-22","117","14200","6","1256","10.3","10.8"
"Jackson","2020-10-23","103","14303","8","1264","10.1","10.9"
"Jackson","2020-10-24","60","14363","5","1269","9.7","10.6"
"Jackson","2020-10-25","50","14413","7","1276","9.5","10.7"
"Jackson","2020-10-26","152","14565","22","1298","10.3","10.6"
"Jackson","2020-10-27","98","14663","6","1304","10.2","10.1"
"Jackson","2020-10-28","140","14803","34","1338","11.4","11.1"
"Jackson","2020-10-29","134","14937","15","1353","12.3","11.3"
"Jackson","2020-10-30","103","15040","13","1366","13","11.5"
"Jackson","2020-10-31","78","15118","6","1372","12.9","11.3"
"Jackson","2020-11-01","62","15180","11","1383","13.4","11.5"
"Jackson","2020-11-02","118","15298","16","1399","13.3","11.8"
"Jackson","2020-11-03","127","15425","25","1424","15.3","12.7"
"Jackson","2020-11-04","119","15544","20","1444","14.2","12.8"
"Jackson","2020-11-05","150","15694","29","1473","15.3","13.8"
"Jackson","2020-11-06","111","15805","14","1487","15.3","14.2"
"Jackson","2020-11-07","76","15881","8","1495","15.8","14.3"
"Jackson","2020-11-08","64","15945","13","1508","16.1","14.8"
"Jackson","2020-11-09","163","16108","32","1540","17","15.2"
"Jackson","2020-11-10","171","16279","25","1565","16.3","15.8"
"Jackson","2020-11-11","153","16432","16","1581","15.4","14.8"
"Jackson","2020-11-12","180","16612","12","1593","13.5","14.4"
"Jackson","2020-11-13","177","16789","18","1611","13.2","14.3"
"Jackson","2020-11-14","61","16850","12","1623","14.5","15.1"
"Jackson","2020-11-15","49","16899","9","1632","14.2","15.2"
"Jackson","2020-11-16","191","17090","37","1669","14.2","15.6"
"Jackson","2020-11-17","224","17314","14","1683","13","14.6"
"Jackson","2020-11-18","180","17494","16","1699","12.8","14.1"
"Jackson","2020-11-19","213","17707","23","1722","13.4","13.5"
"Jackson","2020-11-20","169","17876","8","1730","12.6","12.9"
"Jackson","2020-11-21","106","17982","9","1739","11","12.7"
"Jackson","2020-11-22","85","18067","11","1750","10.2","12.2"
"Jackson","2020-11-23","215","18282","27","1777","9.2","11.7"
"Jackson","2020-11-24","172","18454","23","1800","10.3","11.6"
"Jackson","2020-11-25","121","18575","19","1819","11.2","12"
"Jackson","2020-11-26","19","18594","1","1820","10.4","11.9"
"Jackson","2020-11-27","161","18755","39","1859","13.2","12.9"
"Jackson","2020-11-28","117","18872","25","1884","15.1","13"
"Jackson","2020-11-29","88","18960","26","1910","17.4","13.8"
"Jackson","2020-11-30","320","19280","59","1969","18.3","13.8"
"Jackson","2020-12-01","340","19620","54","2023","18.6","14.4"
"Jackson","2020-12-02","344","19964","49","2072","18.4","14.8"
"Jackson","2020-12-03","319","20283","40","2112","19.5","15"
"Jackson","2020-12-04","304","20587","46","2158","18.2","15.7"
"Jackson","2020-12-05","125","20712","26","2184","18.1","16.6"
"Jackson","2020-12-06","114","20826","22","2206","16.6","17"
"Jackson","2020-12-07","310","21136","69","2275","17.2","17.7"
"Jackson","2020-12-08","256","21392","53","2328","17.9","18.2"
"Jackson","2020-12-09","263","21655","49","2377","18.5","18.5"
"Jackson","2020-12-10","271","21926","59","2436","19.8","19.6"
"Jackson","2020-12-11","222","22148","47","2483","20.7","19.4"
"Jackson","2020-12-12","153","22301","48","2531","22.2","20.1"
"Jackson","2020-12-13","131","22432","38","2569","23.6","20.1"
"Jackson","2020-12-14","328","22760","89","2658","24.3","20.7"
"Jackson","2020-12-15","281","23041","63","2721","24.5","21.2"
"Jackson","2020-12-16","266","23307","65","2786","25.3","21.9"
"Jackson","2020-12-17","313","23620","76","2862","25.7","22.7"
"Jackson","2020-12-18","260","23880","61","2923","26","23.3"
"Jackson","2020-12-19","148","24028","46","2969","26","24.1"
"Jackson","2020-12-20","173","24201","59","3028","26.7","25.1"
"Jackson","2020-12-21","314","24515","74","3102","26.2","25.2"
"Jackson","2020-12-22","354","24869","80","3182","26.2","25.4"
"Jackson","2020-12-23","278","25147","72","3254","26.4","25.9"
"Jackson","2020-12-24","167","25314","45","3299","26.8","26.2"
"Jackson","2020-12-25","34","25348","12","3311","28.5","27.3"
"Jackson","2020-12-26","199","25547","78","3389","29.7","27.8"
"Jackson","2020-12-27","134","25681","38","3427","28.8","27.8"
"Jackson","2020-12-28","287","25968","89","3516","29.9","28"
"Jackson","2020-12-29","325","26293","93","3609","30.8","28.5"
"Jackson","2020-12-30","315","26608","97","3706","31.5","28.9"
"Jackson","2020-12-31","225","26833","80","3786","32.7","29.7"
"Jackson","2021-01-01","97","26930","35","3821","32.8","30.7"
"Jackson","2021-01-02","98","27028","34","3855","32.2","30.9"
"Jackson","2021-01-03","116","27144","39","3894","32.9","30.9"
"Jackson","2021-01-04","339","27483","103","3997","32.8","31.4"
"Jackson","2021-01-05","377","27860","114","4111","33.1","31.9"
"Jackson","2021-01-06","420","28280","112","4223","32.5","32"
"Jackson","2021-01-07","359","28639","90","4313","31","31.8"
"Jackson","2021-01-08","320","28959","81","4394","29.4","31.1"
"Jackson","2021-01-09","142","29101","37","4431","28.2","30.2"
"Jackson","2021-01-10","118","29219","30","4461","27","30"
"Jackson","2021-01-11","304","29523","88","4549","26.8","29.8"
"Jackson","2021-01-12","276","29799","59","4608","25.6","29.3"
"Jackson","2021-01-13","318","30117","66","4674","24.7","28.6"
"Jackson","2021-01-14","283","30400","61","4735","24.2","27.6"
"Jackson","2021-01-15","238","30638","52","4787","23.7","26.6"
"Jackson","2021-01-16","140","30778","24","4811","22.4","25.3"
"Jackson","2021-01-17","143","30921","41","4852","22.9","25"
"Jackson","2021-01-18","208","31129","53","4905","22.4","24.6"
"Jackson","2021-01-19","252","31381","47","4952","22","23.8"
"Jackson","2021-01-20","279","31660","53","5005","21.8","23.2"
"Jackson","2021-01-21","259","31919","41","5046","20.9","22.6"
"Jackson","2021-01-22","190","32109","25","5071","19.7","21.7"
"Jackson","2021-01-23","111","32220","28","5099","20.9","21.6"
"Jackson","2021-01-24","54","32274","6","5105","18.4","20.6"
"Jackson","2021-01-25","70","32344","10","5115","16.8","19.6"
"Jackson","2021-01-26","8","32352","2","5117","17.7","19.8"
"Jackson","2021-01-27","0","32352","0","5117","14.9","18.4"
"Jasper","2020-02-01","0","0","0","0",".","."
"Jasper","2020-02-02","0","0","0","0",".","."
"Jasper","2020-02-03","0","0","0","0",".","."
"Jasper","2020-02-04","0","0","0","0",".","."
"Jasper","2020-02-05","0","0","0","0",".","."
"Jasper","2020-02-06","0","0","0","0",".","."
"Jasper","2020-02-07","0","0","0","0","0","."
"Jasper","2020-02-08","0","0","0","0","0","."
"Jasper","2020-02-09","0","0","0","0","0","."
"Jasper","2020-02-10","0","0","0","0","0","."
"Jasper","2020-02-11","0","0","0","0","0","."
"Jasper","2020-02-12","0","0","0","0","0","."
"Jasper","2020-02-13","0","0","0","0","0","."
"Jasper","2020-02-14","0","0","0","0","0","0"
"Jasper","2020-02-15","0","0","0","0","0","0"
"Jasper","2020-02-16","0","0","0","0","0","0"
"Jasper","2020-02-17","0","0","0","0","0","0"
"Jasper","2020-02-18","0","0","0","0","0","0"
"Jasper","2020-02-19","0","0","0","0","0","0"
"Jasper","2020-02-20","0","0","0","0","0","0"
"Jasper","2020-02-21","0","0","0","0","0","0"
"Jasper","2020-02-22","0","0","0","0","0","0"
"Jasper","2020-02-23","0","0","0","0","0","0"
"Jasper","2020-02-24","0","0","0","0","0","0"
"Jasper","2020-02-25","0","0","0","0","0","0"
"Jasper","2020-02-26","0","0","0","0","0","0"
"Jasper","2020-02-27","0","0","0","0","0","0"
"Jasper","2020-02-28","0","0","0","0","0","0"
"Jasper","2020-02-29","0","0","0","0","0","0"
"Jasper","2020-03-01","0","0","0","0","0","0"
"Jasper","2020-03-02","0","0","0","0","0","0"
"Jasper","2020-03-03","0","0","0","0","0","0"
"Jasper","2020-03-04","0","0","0","0","0","0"
"Jasper","2020-03-05","0","0","0","0","0","0"
"Jasper","2020-03-06","0","0","0","0","0","0"
"Jasper","2020-03-07","0","0","0","0","0","0"
"Jasper","2020-03-08","0","0","0","0","0","0"
"Jasper","2020-03-09","2","2","1","1","7.1","3.6"
"Jasper","2020-03-10","1","3","0","1","7.1","3.6"
"Jasper","2020-03-11","0","3","0","1","7.1","3.6"
"Jasper","2020-03-12","0","3","0","1","7.1","3.6"
"Jasper","2020-03-13","0","3","0","1","7.1","3.6"
"Jasper","2020-03-14","0","3","0","1","7.1","3.6"
"Jasper","2020-03-15","0","3","0","1","7.1","3.6"
"Jasper","2020-03-16","3","6","1","2","4.8","6"
"Jasper","2020-03-17","1","7","0","2","4.8","6"
"Jasper","2020-03-18","4","11","0","2","4.8","6"
"Jasper","2020-03-19","2","13","0","2","4.8","6"
"Jasper","2020-03-20","3","16","0","2","4.8","6"
"Jasper","2020-03-21","0","16","0","2","4.8","6"
"Jasper","2020-03-22","2","18","1","3","11.9","9.5"
"Jasper","2020-03-23","1","19","0","3","7.1","6"
"Jasper","2020-03-24","8","27","2","5","10.7","7.7"
"Jasper","2020-03-25","4","31","2","7","17.9","11.3"
"Jasper","2020-03-26","3","34","0","7","17.9","11.3"
"Jasper","2020-03-27","3","37","0","7","17.9","11.3"
"Jasper","2020-03-28","2","39","0","7","17.9","11.3"
"Jasper","2020-03-29","0","39","0","7","10.7","11.3"
"Jasper","2020-03-30","1","40","0","7","10.7","8.9"
"Jasper","2020-03-31","0","40","0","7","7.1","8.9"
"Jasper","2020-04-01","2","42","0","7","0","8.9"
"Jasper","2020-04-02","0","42","0","7","0","8.9"
"Jasper","2020-04-03","6","48","0","7","0","8.9"
"Jasper","2020-04-04","2","50","0","7","0","8.9"
"Jasper","2020-04-05","1","51","0","7","0","5.4"
"Jasper","2020-04-06","5","56","0","7","0","5.4"
"Jasper","2020-04-07","4","60","0","7","0","3.6"
"Jasper","2020-04-08","7","67","2","9","4.1","2"
"Jasper","2020-04-09","4","71","1","10","7.7","3.8"
"Jasper","2020-04-10","8","79","0","10","7.7","3.8"
"Jasper","2020-04-11","1","80","0","10","7.7","3.8"
"Jasper","2020-04-12","0","80","0","10","7.7","3.8"
"Jasper","2020-04-13","11","91","3","13","11.5","5.8"
"Jasper","2020-04-14","7","98","1","14","13.6","6.8"
"Jasper","2020-04-15","8","106","1","15","11.3","7.7"
"Jasper","2020-04-16","9","115","3","18","12.5","10.1"
"Jasper","2020-04-17","7","122","1","19","14.5","11.1"
"Jasper","2020-04-18","8","130","0","19","14.5","11.1"
"Jasper","2020-04-19","1","131","0","19","14.5","11.1"
"Jasper","2020-04-20","11","142","1","20","11.9","11.7"
"Jasper","2020-04-21","10","152","0","20","9.9","11.7"
"Jasper","2020-04-22","10","162","0","20","8.1","9.7"
"Jasper","2020-04-23","15","177","1","21","4.3","8.4"
"Jasper","2020-04-24","12","189","0","21","2.3","8.4"
"Jasper","2020-04-25","6","195","0","21","2.3","8.4"
"Jasper","2020-04-26","3","198","1","22","7","10.8"
"Jasper","2020-04-27","28","226","4","26","7.8","9.8"
"Jasper","2020-04-28","15","241","0","26","7.8","8.8"
"Jasper","2020-04-29","10","251","0","26","7.8","7.9"
"Jasper","2020-04-30","15","266","0","26","6.8","5.5"
"Jasper","2020-05-01","14","280","2","28","8.8","5.5"
"Jasper","2020-05-02","8","288","0","28","8.8","5.5"
"Jasper","2020-05-03","4","292","0","28","4.1","5.5"
"Jasper","2020-05-04","8","300","1","29","3.8","5.8"
"Jasper","2020-05-05","10","310","0","29","3.8","5.8"
"Jasper","2020-05-06","18","328","0","29","3.8","5.8"
"Jasper","2020-05-07","24","352","1","30","4.4","5.6"
"Jasper","2020-05-08","23","375","1","31","3","5.9"
"Jasper","2020-05-09","2","377","0","31","3","5.9"
"Jasper","2020-05-10","2","379","0","31","3","3.5"
"Jasper","2020-05-11","52","431","1","32","1.5","2.7"
"Jasper","2020-05-12","32","463","0","32","1.5","2.7"
"Jasper","2020-05-13","45","508","5","37","3.1","3.5"
"Jasper","2020-05-14","39","547","0","37","2.5","3.5"
"Jasper","2020-05-15","52","599","6","43","3.5","3.3"
"Jasper","2020-05-16","9","608","0","43","3.5","3.3"
"Jasper","2020-05-17","5","613","0","43","3.5","3.3"
"Jasper","2020-05-18","58","671","1","44","3.5","2.5"
"Jasper","2020-05-19","29","700","1","45","4","2.7"
"Jasper","2020-05-20","16","716","0","45","2.4","2.7"
"Jasper","2020-05-21","13","729","0","45","2.4","2.4"
"Jasper","2020-05-22","19","748","0","45","0.7","2.1"
"Jasper","2020-05-23","2","750","0","45","0.7","2.1"
"Jasper","2020-05-24","5","755","0","45","0.7","2.1"
"Jasper","2020-05-25","6","761","0","45","0.5","2"
"Jasper","2020-05-26","31","792","3","48","1.4","2.7"
"Jasper","2020-05-27","48","840","3","51","2.3","2.3"
"Jasper","2020-05-28","40","880","3","54","3.3","2.9"
"Jasper","2020-05-29","33","913","6","60","5.9","3.3"
"Jasper","2020-05-30","3","916","0","60","5.9","3.3"
"Jasper","2020-05-31","4","920","0","60","5.9","3.3"
"Jasper","2020-06-01","50","970","2","62","6.5","3.5"
"Jasper","2020-06-02","63","1033","3","65","5.8","3.6"
"Jasper","2020-06-03","18","1051","0","65","4.9","3.6"
"Jasper","2020-06-04","22","1073","3","68","5.8","4.6"
"Jasper","2020-06-05","38","1111","1","69","3.6","4.8"
"Jasper","2020-06-06","14","1125","0","69","3.6","4.8"
"Jasper","2020-06-07","6","1131","0","69","3.6","4.8"
"Jasper","2020-06-08","11","1142","0","69","3","4.8"
"Jasper","2020-06-09","44","1186","5","74","3.9","4.9"
"Jasper","2020-06-10","18","1204","2","76","5.5","5.2"
"Jasper","2020-06-11","16","1220","1","77","4.5","5.1"
"Jasper","2020-06-12","33","1253","0","77","4.1","3.8"
"Jasper","2020-06-13","3","1256","0","77","4.1","3.8"
"Jasper","2020-06-14","3","1259","0","77","4.1","3.8"
"Jasper","2020-06-15","24","1283","1","78","4.7","3.9"
"Jasper","2020-06-16","38","1321","1","79","3.5","3.7"
"Jasper","2020-06-17","10","1331","2","81","4.7","5.1"
"Jasper","2020-06-18","14","1345","0","81","3.8","4.2"
"Jasper","2020-06-19","39","1384","6","87","6","5.1"
"Jasper","2020-06-20","2","1386","0","87","6","5.1"
"Jasper","2020-06-21","5","1391","0","87","6","5.1"
"Jasper","2020-06-22","23","1414","1","88","6.1","5.4"
"Jasper","2020-06-23","22","1436","3","91","7.6","5.5"
"Jasper","2020-06-24","13","1449","2","93","7","5.8"
"Jasper","2020-06-25","12","1461","0","93","7","5.4"
"Jasper","2020-06-26","51","1512","3","96","5.6","5.8"
"Jasper","2020-06-27","6","1518","0","96","5.6","5.8"
"Jasper","2020-06-28","4","1522","0","96","5.6","5.8"
"Jasper","2020-06-29","53","1575","3","99","5.8","5.9"
"Jasper","2020-06-30","56","1631","4","103","4.9","6.2"
"Jasper","2020-07-01","24","1655","6","109","6.2","6.6"
"Jasper","2020-07-02","20","1675","4","113","9.1","8"
"Jasper","2020-07-03","7","1682","0","113","8.3","6.9"
"Jasper","2020-07-04","2","1684","1","114","15.4","10.5"
"Jasper","2020-07-05","4","1688","0","114","15.4","10.5"
"Jasper","2020-07-06","35","1723","4","118","16.2","11"
"Jasper","2020-07-07","54","1777","6","124","16.8","10.8"
"Jasper","2020-07-08","14","1791","2","126","15.3","10.8"
"Jasper","2020-07-09","11","1802","0","126","12.4","10.8"
"Jasper","2020-07-10","62","1864","3","129","13.1","10.7"
"Jasper","2020-07-11","8","1872","1","130","7.7","11.6"
"Jasper","2020-07-12","3","1875","0","130","7.7","11.6"
"Jasper","2020-07-13","8","1883","3","133","11.5","13.8"
"Jasper","2020-07-14","39","1922","7","140","12.4","14.6"
"Jasper","2020-07-15","14","1936","0","140","10.4","12.8"
"Jasper","2020-07-16","7","1943","0","140","10.4","11.4"
"Jasper","2020-07-17","43","1986","3","143","10.7","11.9"
"Jasper","2020-07-18","9","1995","0","143","8.9","8.3"
"Jasper","2020-07-19","2","1997","1","144","16.1","11.9"
"Jasper","2020-07-20","15","2012","2","146","12.6","12"
"Jasper","2020-07-21","40","2052","3","149","11.1","11.8"
"Jasper","2020-07-22","9","2061","2","151","14.3","12.3"
"Jasper","2020-07-23","16","2077","3","154","17","13.7"
"Jasper","2020-07-24","47","2124","6","160","17.8","14.2"
"Jasper","2020-07-25","10","2134","4","164","23.5","16.2"
"Jasper","2020-07-26","3","2137","0","164","16.4","16.2"
"Jasper","2020-07-27","15","2152","0","164","14.5","13.5"
"Jasper","2020-07-28","31","2183","5","169","15.7","13.4"
"Jasper","2020-07-29","17","2200","0","169","12.5","13.4"
"Jasper","2020-07-30","12","2212","2","171","12.2","14.6"
"Jasper","2020-07-31","35","2247","2","173","11.2","14.5"
"Jasper","2020-08-01","8","2255","0","173","5.5","14.5"
"Jasper","2020-08-02","4","2259","1","174","9.1","12.7"
"Jasper","2020-08-03","13","2272","1","175","10.2","12.3"
"Jasper","2020-08-04","51","2323","4","179","9","12.3"
"Jasper","2020-08-05","13","2336","1","180","10.1","11.3"
"Jasper","2020-08-06","9","2345","1","181","9.3","10.8"
"Jasper","2020-08-07","37","2382","6","187","10.8","11"
"Jasper","2020-08-08","3","2385","0","187","10.8","8.1"
"Jasper","2020-08-09","5","2390","1","188","10.1","9.6"
"Jasper","2020-08-10","16","2406","3","191","11.7","10.9"
"Jasper","2020-08-11","50","2456","5","196","12","10.5"
"Jasper","2020-08-12","11","2467","0","196","10.9","10.5"
"Jasper","2020-08-13","11","2478","1","197","10.6","9.9"
"Jasper","2020-08-14","32","2510","5","202","10.5","10.6"
"Jasper","2020-08-15","9","2519","2","204","13.7","12.2"
"Jasper","2020-08-16","7","2526","0","204","10.8","10.4"
"Jasper","2020-08-17","18","2544","1","205","8.9","10.3"
"Jasper","2020-08-18","35","2579","1","206","7.9","9.9"
"Jasper","2020-08-19","15","2594","2","208","9.8","10.3"
"Jasper","2020-08-20","13","2607","0","208","8.5","9.5"
"Jasper","2020-08-21","20","2627","2","210","7.7","9.1"
"Jasper","2020-08-22","11","2638","4","214","9.7","11.7"
"Jasper","2020-08-23","5","2643","0","214","9.7","10.3"
"Jasper","2020-08-24","6","2649","1","215","11.3","10.1"
"Jasper","2020-08-25","24","2673","2","217","12.1","10"
"Jasper","2020-08-26","11","2684","2","219","12.8","11.3"
"Jasper","2020-08-27","11","2695","1","220","14.1","11.3"
"Jasper","2020-08-28","21","2716","1","221","13.3","10.5"
"Jasper","2020-08-29","5","2721","0","221","8.1","8.9"
"Jasper","2020-08-30","2","2723","0","221","8.1","8.9"
"Jasper","2020-08-31","12","2735","1","222","7","9.1"
"Jasper","2020-09-01","17","2752","1","223","6.6","9.4"
"Jasper","2020-09-02","14","2766","0","223","4","8.4"
"Jasper","2020-09-03","11","2777","0","223","2.7","8.4"
"Jasper","2020-09-04","11","2788","1","224","3.3","8.3"
"Jasper","2020-09-05","2","2790","0","224","3.3","5.7"
"Jasper","2020-09-06","8","2798","0","224","3.3","5.7"
"Jasper","2020-09-07","4","2802","0","224","2.1","4.5"
"Jasper","2020-09-08","24","2826","2","226","2.5","4.5"
"Jasper","2020-09-09","10","2836","0","226","2.5","3.2"
"Jasper","2020-09-10","15","2851","0","226","2.5","2.6"
"Jasper","2020-09-11","30","2881","1","227","1.7","2.5"
"Jasper","2020-09-12","5","2886","1","228","4.5","3.9"
"Jasper","2020-09-13","4","2890","1","229","8.1","5.7"
"Jasper","2020-09-14","8","2898","1","230","9.9","6"
"Jasper","2020-09-15","27","2925","1","231","9.2","5.9"
"Jasper","2020-09-16","16","2941","0","231","9.2","5.9"
"Jasper","2020-09-17","13","2954","1","232","10.3","6.4"
"Jasper","2020-09-18","18","2972","0","232","9.8","5.8"
"Jasper","2020-09-19","6","2978","0","232","7","5.8"
"Jasper","2020-09-20","4","2982","1","233","7","7.5"
"Jasper","2020-09-21","15","2997","0","233","5.2","7.5"
"Jasper","2020-09-22","19","3016","0","233","4.7","6.9"
"Jasper","2020-09-23","13","3029","4","237","9.1","9.1"
"Jasper","2020-09-24","10","3039","1","238","9.4","9.9"
"Jasper","2020-09-25","16","3055","0","238","9.4","9.6"
"Jasper","2020-09-26","4","3059","0","238","9.4","8.2"
"Jasper","2020-09-27","3","3062","0","238","5.8","6.4"
"Jasper","2020-09-28","15","3077","0","238","5.8","5.5"
"Jasper","2020-09-29","18","3095","0","238","5.8","5.2"
"Jasper","2020-09-30","12","3107","0","238","1.4","5.2"
"Jasper","2020-10-01","15","3122","2","240","1.9","5.7"
"Jasper","2020-10-02","14","3136","2","242","3.9","6.7"
"Jasper","2020-10-03","8","3144","2","244","7.5","8.5"
"Jasper","2020-10-04","3","3147","0","244","7.5","6.7"
"Jasper","2020-10-05","11","3158","1","245","8.8","7.3"
"Jasper","2020-10-06","20","3178","1","246","9.5","7.7"
"Jasper","2020-10-07","13","3191","1","247","10.6","6"
"Jasper","2020-10-08","12","3203","2","249","11.1","6.5"
"Jasper","2020-10-09","18","3221","3","252","11.4","7.7"
"Jasper","2020-10-10","2","3223","0","252","7.9","7.7"
"Jasper","2020-10-11","8","3231","1","253","9.7","8.6"
"Jasper","2020-10-12","9","3240","2","255","11.5","10.2"
"Jasper","2020-10-13","25","3265","1","256","11.4","10.5"
"Jasper","2020-10-14","4","3269","0","256","10.3","10.5"
"Jasper","2020-10-15","13","3282","0","256","7.9","9.5"
"Jasper","2020-10-16","6","3288","0","256","5.5","8.5"
"Jasper","2020-10-17","5","3293","0","256","5.5","6.7"
"Jasper","2020-10-18","6","3299","1","257","6.1","7.9"
"Jasper","2020-10-19","18","3317","0","257","3","7.2"
"Jasper","2020-10-20","22","3339","0","257","2.4","6.9"
"Jasper","2020-10-21","15","3354","1","258","3.3","6.8"
"Jasper","2020-10-22","11","3365","0","258","3.3","5.6"
"Jasper","2020-10-23","11","3376","2","260","5.9","5.7"
"Jasper","2020-10-24","1","3377","0","260","5.9","5.7"
"Jasper","2020-10-25","5","3382","0","260","3.5","4.8"
"Jasper","2020-10-26","11","3393","0","260","3.5","3.3"
"Jasper","2020-10-27","41","3434","2","262","4.2","3.3"
"Jasper","2020-10-28","39","3473","0","262","3.3","3.3"
"Jasper","2020-10-29","33","3506","0","262","3.3","3.3"
"Jasper","2020-10-30","19","3525","0","262","0.7","3.3"
"Jasper","2020-10-31","6","3531","0","262","0.7","3.3"
"Jasper","2020-11-01","6","3537","1","263","3.1","3.3"
"Jasper","2020-11-02","36","3573","0","263","3.1","3.3"
"Jasper","2020-11-03","16","3589","1","264","3.3","3.8"
"Jasper","2020-11-04","16","3605","0","264","3.3","3.3"
"Jasper","2020-11-05","12","3617","3","267","6.8","5.1"
"Jasper","2020-11-06","17","3634","2","269","8.5","4.6"
"Jasper","2020-11-07","7","3641","1","270","10.6","5.6"
"Jasper","2020-11-08","2","3643","0","270","8.2","5.6"
"Jasper","2020-11-09","10","3653","1","271","9.6","6.3"
"Jasper","2020-11-10","36","3689","8","279","11.9","7.6"
"Jasper","2020-11-11","12","3701","1","280","13.1","8.2"
"Jasper","2020-11-12","9","3710","0","280","9.5","8.2"
"Jasper","2020-11-13","17","3727","3","283","10.4","9.4"
"Jasper","2020-11-14","7","3734","1","284","10.4","10.5"
"Jasper","2020-11-15","1","3735","0","284","10.4","9.3"
"Jasper","2020-11-16","29","3764","2","286","9.9","9.8"
"Jasper","2020-11-17","29","3793","1","287","7.2","9.6"
"Jasper","2020-11-18","9","3802","0","287","6","9.6"
"Jasper","2020-11-19","13","3815","0","287","6","7.8"
"Jasper","2020-11-20","13","3828","1","288","4.6","7.5"
"Jasper","2020-11-21","9","3837","0","288","2.6","6.5"
"Jasper","2020-11-22","4","3841","1","289","6.1","8.3"
"Jasper","2020-11-23","22","3863","5","294","8.4","9.2"
"Jasper","2020-11-24","29","3892","0","294","7.9","7.6"
"Jasper","2020-11-25","16","3908","5","299","12.4","9.2"
"Jasper","2020-11-26","5","3913","0","299","12.4","9.2"
"Jasper","2020-11-27","15","3928","1","300","12.2","8.4"
"Jasper","2020-11-28","7","3935","2","302","16.3","9.4"
"Jasper","2020-11-29","4","3939","0","302","12.7","9.4"
"Jasper","2020-11-30","26","3965","5","307","12.2","10.3"
"Jasper","2020-12-01","32","3997","6","313","14.9","11.4"
"Jasper","2020-12-02","22","4019","4","317","13.1","12.7"
"Jasper","2020-12-03","15","4034","0","317","13.1","12.7"
"Jasper","2020-12-04","17","4051","1","318","12.9","12.6"
"Jasper","2020-12-05","10","4061","1","319","10.3","13.3"
"Jasper","2020-12-06","10","4071","2","321","13.1","12.9"
"Jasper","2020-12-07","15","4086","0","321","10.4","11.3"
"Jasper","2020-12-08","31","4117","6","327","10.5","12.7"
"Jasper","2020-12-09","26","4143","6","333","11.2","12.1"
"Jasper","2020-12-10","25","4168","5","338","14","13.6"
"Jasper","2020-12-11","33","4201","5","343","15.4","14.2"
"Jasper","2020-12-12","13","4214","3","346","17.2","13.8"
"Jasper","2020-12-13","8","4222","2","348","18","15.6"
"Jasper","2020-12-14","20","4242","5","353","21.5","16"
"Jasper","2020-12-15","30","4272","8","361","22.6","16.5"
"Jasper","2020-12-16","22","4294","2","363","20.6","15.9"
"Jasper","2020-12-17","28","4322","6","369","20.8","17.4"
"Jasper","2020-12-18","57","4379","8","377","20.6","18"
"Jasper","2020-12-19","13","4392","1","378","18.4","17.8"
"Jasper","2020-12-20","6","4398","3","381","22","20"
"Jasper","2020-12-21","20","4418","6","387","22.7","22.1"
"Jasper","2020-12-22","21","4439","4","391","21.6","22.1"
"Jasper","2020-12-23","12","4451","2","393","22.7","21.6"
"Jasper","2020-12-24","17","4468","3","396","22.2","21.5"
"Jasper","2020-12-25","1","4469","0","396","20.2","20.4"
"Jasper","2020-12-26","11","4480","1","397","20.4","19.4"
"Jasper","2020-12-27","10","4490","1","398","14.6","18.3"
"Jasper","2020-12-28","24","4514","9","407","15.7","19.2"
"Jasper","2020-12-29","27","4541","9","416","17.7","19.7"
"Jasper","2020-12-30","49","4590","15","431","19.7","21.2"
"Jasper","2020-12-31","36","4626","4","435","18.8","20.5"
"Jasper","2021-01-01","6","4632","3","438","25.9","23.1"
"Jasper","2021-01-02","17","4649","4","442","28","24.2"
"Jasper","2021-01-03","6","4655","1","443","29","21.8"
"Jasper","2021-01-04","23","4678","6","449","27.3","21.5"
"Jasper","2021-01-05","65","4743","25","474","28.1","22.9"
"Jasper","2021-01-06","31","4774","8","482","27.4","23.6"
"Jasper","2021-01-07","37","4811","11","493","30","24.4"
"Jasper","2021-01-08","69","4880","16","509","26.2","26.1"
"Jasper","2021-01-09","14","4894","4","513","26.9","27.5"
"Jasper","2021-01-10","6","4900","2","515","29.3","29.1"
"Jasper","2021-01-11","25","4925","5","520","28.4","27.9"
"Jasper","2021-01-12","30","4955","9","529","27.2","27.6"
"Jasper","2021-01-13","41","4996","8","537","26.3","26.9"
"Jasper","2021-01-14","44","5040","4","541","23.4","26.7"
"Jasper","2021-01-15","38","5078","9","550","23.5","24.8"
"Jasper","2021-01-16","12","5090","3","553","22.9","24.9"
"Jasper","2021-01-17","18","5108","3","556","20.6","24.9"
"Jasper","2021-01-18","17","5125","2","558","19.4","23.9"
"Jasper","2021-01-19","31","5156","4","562","16.9","22.1"
"Jasper","2021-01-20","29","5185","4","566","16.1","21.2"
"Jasper","2021-01-21","34","5219","4","570","16.5","19.9"
"Jasper","2021-01-22","53","5272","9","579","15.6","19.5"
"Jasper","2021-01-23","8","5280","3","582","17.3","20.1"
"Jasper","2021-01-24","6","5286","2","584","19.7","20.1"
"Jasper","2021-01-25","4","5290","1","585","21.6","20.5"
"Jasper","2021-01-26","0","5290","0","585","19.8","18.4"
"Jasper","2021-01-27","0","5290","0","585","17.8","17"
"Jeff Davis","2020-02-01","0","0","0","0",".","."
"Jeff Davis","2020-02-02","0","0","0","0",".","."
"Jeff Davis","2020-02-03","0","0","0","0",".","."
"Jeff Davis","2020-02-04","0","0","0","0",".","."
"Jeff Davis","2020-02-05","0","0","0","0",".","."
"Jeff Davis","2020-02-06","0","0","0","0",".","."
"Jeff Davis","2020-02-07","0","0","0","0","0","."
"Jeff Davis","2020-02-08","0","0","0","0","0","."
"Jeff Davis","2020-02-09","0","0","0","0","0","."
"Jeff Davis","2020-02-10","0","0","0","0","0","."
"Jeff Davis","2020-02-11","0","0","0","0","0","."
"Jeff Davis","2020-02-12","0","0","0","0","0","."
"Jeff Davis","2020-02-13","0","0","0","0","0","."
"Jeff Davis","2020-02-14","0","0","0","0","0","0"
"Jeff Davis","2020-02-15","0","0","0","0","0","0"
"Jeff Davis","2020-02-16","0","0","0","0","0","0"
"Jeff Davis","2020-02-17","0","0","0","0","0","0"
"Jeff Davis","2020-02-18","0","0","0","0","0","0"
"Jeff Davis","2020-02-19","0","0","0","0","0","0"
"Jeff Davis","2020-02-20","0","0","0","0","0","0"
"Jeff Davis","2020-02-21","0","0","0","0","0","0"
"Jeff Davis","2020-02-22","0","0","0","0","0","0"
"Jeff Davis","2020-02-23","0","0","0","0","0","0"
"Jeff Davis","2020-02-24","0","0","0","0","0","0"
"Jeff Davis","2020-02-25","0","0","0","0","0","0"
"Jeff Davis","2020-02-26","0","0","0","0","0","0"
"Jeff Davis","2020-02-27","0","0","0","0","0","0"
"Jeff Davis","2020-02-28","0","0","0","0","0","0"
"Jeff Davis","2020-02-29","0","0","0","0","0","0"
"Jeff Davis","2020-03-01","0","0","0","0","0","0"
"Jeff Davis","2020-03-02","0","0","0","0","0","0"
"Jeff Davis","2020-03-03","0","0","0","0","0","0"
"Jeff Davis","2020-03-04","0","0","0","0","0","0"
"Jeff Davis","2020-03-05","0","0","0","0","0","0"
"Jeff Davis","2020-03-06","0","0","0","0","0","0"
"Jeff Davis","2020-03-07","0","0","0","0","0","0"
"Jeff Davis","2020-03-08","0","0","0","0","0","0"
"Jeff Davis","2020-03-09","0","0","0","0","0","0"
"Jeff Davis","2020-03-10","0","0","0","0","0","0"
"Jeff Davis","2020-03-11","0","0","0","0","0","0"
"Jeff Davis","2020-03-12","0","0","0","0","0","0"
"Jeff Davis","2020-03-13","4","4","0","0","0","0"
"Jeff Davis","2020-03-14","0","4","0","0","0","0"
"Jeff Davis","2020-03-15","0","4","0","0","0","0"
"Jeff Davis","2020-03-16","3","7","0","0","0","0"
"Jeff Davis","2020-03-17","1","8","0","0","0","0"
"Jeff Davis","2020-03-18","1","9","0","0","0","0"
"Jeff Davis","2020-03-19","3","12","0","0","0","0"
"Jeff Davis","2020-03-20","2","14","0","0","0","0"
"Jeff Davis","2020-03-21","2","16","0","0","0","0"
"Jeff Davis","2020-03-22","2","18","0","0","0","0"
"Jeff Davis","2020-03-23","5","23","0","0","0","0"
"Jeff Davis","2020-03-24","8","31","0","0","0","0"
"Jeff Davis","2020-03-25","7","38","0","0","0","0"
"Jeff Davis","2020-03-26","3","41","0","0","0","0"
"Jeff Davis","2020-03-27","3","44","0","0","0","0"
"Jeff Davis","2020-03-28","3","47","0","0","0","0"
"Jeff Davis","2020-03-29","2","49","0","0","0","0"
"Jeff Davis","2020-03-30","2","51","0","0","0","0"
"Jeff Davis","2020-03-31","6","57","0","0","0","0"
"Jeff Davis","2020-04-01","5","62","1","1","2.9","1.4"
"Jeff Davis","2020-04-02","3","65","0","1","2.9","1.4"
"Jeff Davis","2020-04-03","5","70","0","1","2.9","1.4"
"Jeff Davis","2020-04-04","1","71","0","1","2.9","1.4"
"Jeff Davis","2020-04-05","5","76","0","1","2.9","1.4"
"Jeff Davis","2020-04-06","4","80","0","1","2.9","1.4"
"Jeff Davis","2020-04-07","8","88","0","1","2.9","1.4"
"Jeff Davis","2020-04-08","2","90","0","1","0","1.4"
"Jeff Davis","2020-04-09","3","93","0","1","0","1.4"
"Jeff Davis","2020-04-10","2","95","1","2","7.1","5"
"Jeff Davis","2020-04-11","0","95","0","2","7.1","5"
"Jeff Davis","2020-04-12","0","95","0","2","7.1","5"
"Jeff Davis","2020-04-13","5","100","2","4","12.9","7.9"
"Jeff Davis","2020-04-14","0","100","0","4","12.9","7.9"
"Jeff Davis","2020-04-15","1","101","0","4","12.9","6.4"
"Jeff Davis","2020-04-16","1","102","1","5","27.1","13.6"
"Jeff Davis","2020-04-17","0","102","0","5","20","13.6"
"Jeff Davis","2020-04-18","1","103","1","6","34.3","20.7"
"Jeff Davis","2020-04-19","0","103","0","6","34.3","20.7"
"Jeff Davis","2020-04-20","4","107","0","6","28.6","20.7"
"Jeff Davis","2020-04-21","4","111","0","6","28.6","20.7"
"Jeff Davis","2020-04-22","4","115","1","7","32.1","22.5"
"Jeff Davis","2020-04-23","0","115","0","7","17.9","22.5"
"Jeff Davis","2020-04-24","2","117","0","7","17.9","18.9"
"Jeff Davis","2020-04-25","0","117","0","7","3.6","18.9"
"Jeff Davis","2020-04-26","3","120","0","7","3.6","18.9"
"Jeff Davis","2020-04-27","9","129","2","9","6.7","17.7"
"Jeff Davis","2020-04-28","2","131","0","9","6.7","17.7"
"Jeff Davis","2020-04-29","2","133","0","9","3.2","17.7"
"Jeff Davis","2020-04-30","11","144","1","10","4.5","11.2"
"Jeff Davis","2020-05-01","3","147","0","10","4.5","11.2"
"Jeff Davis","2020-05-02","2","149","1","11","11.6","7.6"
"Jeff Davis","2020-05-03","0","149","0","11","11.6","7.6"
"Jeff Davis","2020-05-04","8","157","0","11","8.4","7.6"
"Jeff Davis","2020-05-05","4","161","0","11","8.4","7.6"
"Jeff Davis","2020-05-06","3","164","0","11","8.4","5.8"
"Jeff Davis","2020-05-07","6","170","1","12","9.5","7"
"Jeff Davis","2020-05-08","3","173","0","12","9.5","7"
"Jeff Davis","2020-05-09","2","175","0","12","2.4","7"
"Jeff Davis","2020-05-10","0","175","0","12","2.4","7"
"Jeff Davis","2020-05-11","2","177","0","12","2.4","5.4"
"Jeff Davis","2020-05-12","1","178","0","12","2.4","5.4"
"Jeff Davis","2020-05-13","1","179","0","12","2.4","5.4"
"Jeff Davis","2020-05-14","5","184","1","13","2.9","6.2"
"Jeff Davis","2020-05-15","2","186","0","13","2.9","6.2"
"Jeff Davis","2020-05-16","0","186","0","13","2.9","2.6"
"Jeff Davis","2020-05-17","0","186","0","13","2.9","2.6"
"Jeff Davis","2020-05-18","4","190","0","13","2.9","2.6"
"Jeff Davis","2020-05-19","2","192","0","13","2.9","2.6"
"Jeff Davis","2020-05-20","2","194","1","14","10","6.2"
"Jeff Davis","2020-05-21","5","199","1","15","10","6.4"
"Jeff Davis","2020-05-22","7","206","0","15","10","6.4"
"Jeff Davis","2020-05-23","2","208","0","15","10","6.4"
"Jeff Davis","2020-05-24","2","210","0","15","10","6.4"
"Jeff Davis","2020-05-25","3","213","0","15","10","6.4"
"Jeff Davis","2020-05-26","4","217","0","15","10","6.4"
"Jeff Davis","2020-05-27","7","224","0","15","2.9","6.4"
"Jeff Davis","2020-05-28","4","228","0","15","0","5"
"Jeff Davis","2020-05-29","3","231","0","15","0","5"
"Jeff Davis","2020-05-30","0","231","0","15","0","5"
"Jeff Davis","2020-05-31","0","231","0","15","0","5"
"Jeff Davis","2020-06-01","13","244","1","16","1.1","5.5"
"Jeff Davis","2020-06-02","9","253","0","16","1.1","5.5"
"Jeff Davis","2020-06-03","5","258","0","16","1.1","2"
"Jeff Davis","2020-06-04","2","260","0","16","1.1","0.5"
"Jeff Davis","2020-06-05","1","261","0","16","1.1","0.5"
"Jeff Davis","2020-06-06","0","261","0","16","1.1","0.5"
"Jeff Davis","2020-06-07","0","261","0","16","1.1","0.5"
"Jeff Davis","2020-06-08","7","268","0","16","0","0.5"
"Jeff Davis","2020-06-09","2","270","0","16","0","0.5"
"Jeff Davis","2020-06-10","5","275","1","17","2.9","2"
"Jeff Davis","2020-06-11","3","278","0","17","2.9","2"
"Jeff Davis","2020-06-12","3","281","0","17","2.9","2"
"Jeff Davis","2020-06-13","3","284","0","17","2.9","2"
"Jeff Davis","2020-06-14","3","287","1","18","7.6","4.4"
"Jeff Davis","2020-06-15","4","291","0","18","7.6","3.8"
"Jeff Davis","2020-06-16","2","293","0","18","7.6","3.8"
"Jeff Davis","2020-06-17","3","296","0","18","4.8","3.8"
"Jeff Davis","2020-06-18","4","300","0","18","4.8","3.8"
"Jeff Davis","2020-06-19","3","303","1","19","9.5","6.2"
"Jeff Davis","2020-06-20","5","308","1","20","12.4","7.6"
"Jeff Davis","2020-06-21","0","308","0","20","7.6","7.6"
"Jeff Davis","2020-06-22","8","316","3","23","13","10.3"
"Jeff Davis","2020-06-23","9","325","4","27","19.3","13.5"
"Jeff Davis","2020-06-24","1","326","0","27","19.3","12"
"Jeff Davis","2020-06-25","6","332","1","28","21.7","13.2"
"Jeff Davis","2020-06-26","40","372","1","29","17.3","13.4"
"Jeff Davis","2020-06-27","8","380","3","32","19.8","16.1"
"Jeff Davis","2020-06-28","2","382","1","33","26.9","17.3"
"Jeff Davis","2020-06-29","27","409","0","33","21.6","17.3"
"Jeff Davis","2020-06-30","15","424","2","35","17.1","18.2"
"Jeff Davis","2020-07-01","11","435","4","39","22.3","20.8"
"Jeff Davis","2020-07-02","9","444","1","40","21.5","21.6"
"Jeff Davis","2020-07-03","8","452","3","43","26.5","21.9"
"Jeff Davis","2020-07-04","2","454","1","44","28.3","24.1"
"Jeff Davis","2020-07-05","5","459","3","47","29.8","28.4"
"Jeff Davis","2020-07-06","16","475","7","54","36","28.8"
"Jeff Davis","2020-07-07","8","483","1","55","35.9","26.5"
"Jeff Davis","2020-07-08","6","489","0","55","30.7","26.5"
"Jeff Davis","2020-07-09","14","503","3","58","32.2","26.9"
"Jeff Davis","2020-07-10","6","509","0","58","26.8","26.7"
"Jeff Davis","2020-07-11","8","517","2","60","23.2","25.8"
"Jeff Davis","2020-07-12","2","519","0","60","14.7","22.2"
"Jeff Davis","2020-07-13","17","536","4","64","11.8","23.9"
"Jeff Davis","2020-07-14","7","543","0","64","10","22.9"
"Jeff Davis","2020-07-15","8","551","1","65","11.8","21.2"
"Jeff Davis","2020-07-16","20","571","4","69","11.6","21.9"
"Jeff Davis","2020-07-17","4","575","0","69","11.6","19.2"
"Jeff Davis","2020-07-18","0","575","0","69","8","15.6"
"Jeff Davis","2020-07-19","0","575","0","69","8","11.3"
"Jeff Davis","2020-07-20","5","580","1","70","7.5","9.6"
"Jeff Davis","2020-07-21","6","586","2","72","12.3","11.1"
"Jeff Davis","2020-07-22","4","590","1","73","14","12.9"
"Jeff Davis","2020-07-23","3","593","1","74","16","13.8"
"Jeff Davis","2020-07-24","8","601","2","76","19.5","15.5"
"Jeff Davis","2020-07-25","2","603","0","76","19.5","13.8"
"Jeff Davis","2020-07-26","5","608","2","78","25.2","16.6"
"Jeff Davis","2020-07-27","7","615","3","81","28.5","18"
"Jeff Davis","2020-07-28","6","621","0","81","23.7","18"
"Jeff Davis","2020-07-29","14","635","4","85","24.3","19.1"
"Jeff Davis","2020-07-30","3","638","0","85","19.5","17.7"
"Jeff Davis","2020-07-31","2","640","1","86","23.1","21.3"
"Jeff Davis","2020-08-01","5","645","2","88","28.8","24.1"
"Jeff Davis","2020-08-02","4","649","0","88","23.1","24.1"
"Jeff Davis","2020-08-03","6","655","1","89","19.3","23.9"
"Jeff Davis","2020-08-04","3","658","1","90","24.1","23.9"
"Jeff Davis","2020-08-05","9","667","2","92","23.2","23.7"
"Jeff Davis","2020-08-06","9","676","3","95","27.9","23.7"
"Jeff Davis","2020-08-07","6","682","0","95","20.8","21.9"
"Jeff Davis","2020-08-08","1","683","0","95","15.1","21.9"
"Jeff Davis","2020-08-09","1","684","0","95","15.1","19.1"
"Jeff Davis","2020-08-10","8","692","1","96","14.5","16.9"
"Jeff Davis","2020-08-11","6","698","0","96","9.7","16.9"
"Jeff Davis","2020-08-12","6","704","0","96","6.5","14.9"
"Jeff Davis","2020-08-13","5","709","0","96","1.8","14.9"
"Jeff Davis","2020-08-14","10","719","3","99","6.1","13.4"
"Jeff Davis","2020-08-15","1","720","0","99","6.1","10.6"
"Jeff Davis","2020-08-16","1","721","0","99","6.1","10.6"
"Jeff Davis","2020-08-17","29","750","4","103","6.3","10.4"
"Jeff Davis","2020-08-18","13","763","2","105","8.5","9.1"
"Jeff Davis","2020-08-19","4","767","1","106","12","9.3"
"Jeff Davis","2020-08-20","19","786","2","108","13.5","7.7"
"Jeff Davis","2020-08-21","2","788","1","109","16.4","11.2"
"Jeff Davis","2020-08-22","4","792","3","112","27.1","16.6"
"Jeff Davis","2020-08-23","1","793","0","112","27.1","16.6"
"Jeff Davis","2020-08-24","13","806","3","115","28.4","17.3"
"Jeff Davis","2020-08-25","16","822","4","119","29.8","19.1"
"Jeff Davis","2020-08-26","10","832","3","122","30.5","21.3"
"Jeff Davis","2020-08-27","8","840","1","123","30.8","22.2"
"Jeff Davis","2020-08-28","7","847","0","123","23.7","20"
"Jeff Davis","2020-08-29","6","853","2","125","17.7","22.4"
"Jeff Davis","2020-08-30","2","855","0","125","17.7","22.4"
"Jeff Davis","2020-08-31","2","857","0","125","14.4","21.4"
"Jeff Davis","2020-09-01","17","874","0","125","10.8","20.3"
"Jeff Davis","2020-09-02","11","885","3","128","10.4","20.5"
"Jeff Davis","2020-09-03","20","905","4","132","11.5","21.2"
"Jeff Davis","2020-09-04","13","918","2","134","13.7","18.7"
"Jeff Davis","2020-09-05","3","921","2","136","18.5","18.1"
"Jeff Davis","2020-09-06","7","928","2","138","22.6","20.1"
"Jeff Davis","2020-09-07","29","957","0","138","22.6","18.5"
"Jeff Davis","2020-09-08","10","967","1","139","24","17.4"
"Jeff Davis","2020-09-09","9","976","2","141","23.3","16.9"
"Jeff Davis","2020-09-10","12","988","1","142","21.6","16.6"
"Jeff Davis","2020-09-11","7","995","0","142","19.4","16.6"
"Jeff Davis","2020-09-12","5","1000","0","142","9.9","14.2"
"Jeff Davis","2020-09-13","1","1001","0","142","5.8","14.2"
"Jeff Davis","2020-09-14","29","1030","0","142","5.8","14.2"
"Jeff Davis","2020-09-15","44","1074","5","147","6","15"
"Jeff Davis","2020-09-16","2","1076","1","148","10","16.6"
"Jeff Davis","2020-09-17","22","1098","3","151","10.7","16.2"
"Jeff Davis","2020-09-18","2","1100","0","151","10.7","15.1"
"Jeff Davis","2020-09-19","0","1100","0","151","10.7","10.3"
"Jeff Davis","2020-09-20","5","1105","1","152","13.6","9.7"
"Jeff Davis","2020-09-21","6","1111","1","153","16","10.9"
"Jeff Davis","2020-09-22","24","1135","0","153","14.3","10.2"
"Jeff Davis","2020-09-23","8","1143","0","153","7.2","8.6"
"Jeff Davis","2020-09-24","49","1192","0","153","5.2","8"
"Jeff Davis","2020-09-25","3","1195","0","153","5.2","8"
"Jeff Davis","2020-09-26","2","1197","0","153","5.2","8"
"Jeff Davis","2020-09-27","0","1197","0","153","2.4","8"
"Jeff Davis","2020-09-28","9","1206","0","153","0","8"
"Jeff Davis","2020-09-29","50","1256","3","156","0.9","7.6"
"Jeff Davis","2020-09-30","8","1264","1","157","2.6","4.9"
"Jeff Davis","2020-10-01","7","1271","0","157","2.6","3.9"
"Jeff Davis","2020-10-02","9","1280","2","159","5.8","5.5"
"Jeff Davis","2020-10-03","3","1283","0","159","5.8","5.5"
"Jeff Davis","2020-10-04","3","1286","0","159","5.8","4.1"
"Jeff Davis","2020-10-05","3","1289","0","159","5.8","2.9"
"Jeff Davis","2020-10-06","25","1314","3","162","6.7","3.8"
"Jeff Davis","2020-10-07","15","1329","1","163","5.8","4.2"
"Jeff Davis","2020-10-08","13","1342","1","164","6.9","4.8"
"Jeff Davis","2020-10-09","5","1347","1","165","6.6","6.2"
"Jeff Davis","2020-10-10","1","1348","0","165","6.6","6.2"
"Jeff Davis","2020-10-11","0","1348","0","165","6.6","6.2"
"Jeff Davis","2020-10-12","6","1354","0","165","6.6","6.2"
"Jeff Davis","2020-10-13","15","1369","1","166","5.9","6.3"
"Jeff Davis","2020-10-14","4","1373","0","166","4.9","5.4"
"Jeff Davis","2020-10-15","23","1396","1","167","4.4","5.7"
"Jeff Davis","2020-10-16","12","1408","0","167","1.6","4.1"
"Jeff Davis","2020-10-17","1","1409","0","167","1.6","4.1"
"Jeff Davis","2020-10-18","1","1410","0","167","1.6","4.1"
"Jeff Davis","2020-10-19","18","1428","1","168","2.4","4.5"
"Jeff Davis","2020-10-20","18","1446","0","168","1.4","3.6"
"Jeff Davis","2020-10-21","11","1457","3","171","5.3","5.1"
"Jeff Davis","2020-10-22","10","1467","0","171","4.7","4.6"
"Jeff Davis","2020-10-23","42","1509","1","172","5","3.3"
"Jeff Davis","2020-10-24","4","1513","0","172","5","3.3"
"Jeff Davis","2020-10-25","1","1514","0","172","5","3.3"
"Jeff Davis","2020-10-26","10","1524","1","173","5.7","4"
"Jeff Davis","2020-10-27","15","1539","4","177","9.5","5.4"
"Jeff Davis","2020-10-28","9","1548","1","178","7.2","6.2"
"Jeff Davis","2020-10-29","6","1554","0","178","7.2","5.9"
"Jeff Davis","2020-10-30","6","1560","1","179","9.2","7.1"
"Jeff Davis","2020-10-31","2","1562","0","179","9.2","7.1"
"Jeff Davis","2020-11-01","0","1562","0","179","9.2","7.1"
"Jeff Davis","2020-11-02","4","1566","0","179","7.8","6.7"
"Jeff Davis","2020-11-03","7","1573","2","181","8","8.8"
"Jeff Davis","2020-11-04","5","1578","0","181","6.5","6.8"
"Jeff Davis","2020-11-05","8","1586","1","182","8.2","7.7"
"Jeff Davis","2020-11-06","9","1595","3","185","10.6","9.9"
"Jeff Davis","2020-11-07","1","1596","0","185","10.6","9.9"
"Jeff Davis","2020-11-08","3","1599","0","185","10.6","9.9"
"Jeff Davis","2020-11-09","5","1604","0","185","10.6","9.2"
"Jeff Davis","2020-11-10","5","1609","0","185","6.5","7.3"
"Jeff Davis","2020-11-11","6","1615","1","186","8.9","7.7"
"Jeff Davis","2020-11-12","13","1628","0","186","7.1","7.7"
"Jeff Davis","2020-11-13","7","1635","0","186","2.4","6.5"
"Jeff Davis","2020-11-14","3","1638","0","186","2.4","6.5"
"Jeff Davis","2020-11-15","2","1640","1","187","9.5","10.1"
"Jeff Davis","2020-11-16","13","1653","1","188","10.6","10.6"
"Jeff Davis","2020-11-17","14","1667","1","189","11.6","9.1"
"Jeff Davis","2020-11-18","5","1672","0","189","9.3","9.1"
"Jeff Davis","2020-11-19","5","1677","2","191","15","11.1"
"Jeff Davis","2020-11-20","4","1681","1","192","18.5","10.5"
"Jeff Davis","2020-11-21","4","1685","1","193","22.1","12.3"
"Jeff Davis","2020-11-22","2","1687","0","193","15","12.3"
"Jeff Davis","2020-11-23","18","1705","2","195","15.5","13"
"Jeff Davis","2020-11-24","17","1722","2","197","16.1","13.9"
"Jeff Davis","2020-11-25","15","1737","0","197","16.1","12.7"
"Jeff Davis","2020-11-26","3","1740","0","197","10.4","12.7"
"Jeff Davis","2020-11-27","11","1751","2","199","9.4","14"
"Jeff Davis","2020-11-28","10","1761","1","200","7.3","14.7"
"Jeff Davis","2020-11-29","5","1766","0","200","7.3","11.1"
"Jeff Davis","2020-11-30","32","1798","7","207","8.8","12.1"
"Jeff Davis","2020-12-01","15","1813","0","207","7.2","11.6"
"Jeff Davis","2020-12-02","6","1819","0","207","7.2","11.6"
"Jeff Davis","2020-12-03","13","1832","0","207","7.2","8.8"
"Jeff Davis","2020-12-04","13","1845","0","207","4.6","7"
"Jeff Davis","2020-12-05","4","1849","0","207","3.1","5.2"
"Jeff Davis","2020-12-06","4","1853","1","208","6.7","7"
"Jeff Davis","2020-12-07","10","1863","4","212","9.3","9.1"
"Jeff Davis","2020-12-08","27","1890","3","215","10.9","9"
"Jeff Davis","2020-12-09","9","1899","4","219","17.2","12.2"
"Jeff Davis","2020-12-10","24","1923","5","224","20.2","13.7"
"Jeff Davis","2020-12-11","15","1938","2","226","22.1","13.3"
"Jeff Davis","2020-12-12","13","1951","5","231","27.6","15.4"
"Jeff Davis","2020-12-13","1","1952","1","232","38.3","22.5"
"Jeff Davis","2020-12-14","16","1968","1","233","33.5","21.4"
"Jeff Davis","2020-12-15","44","2012","8","241","34.5","22.7"
"Jeff Davis","2020-12-16","18","2030","2","243","29.7","23.5"
"Jeff Davis","2020-12-17","40","2070","6","249","28.9","24.6"
"Jeff Davis","2020-12-18","16","2086","5","254","31.5","26.8"
"Jeff Davis","2020-12-19","9","2095","2","256","29.1","28.4"
"Jeff Davis","2020-12-20","8","2103","2","258","18.4","28.4"
"Jeff Davis","2020-12-21","16","2119","5","263","22","27.7"
"Jeff Davis","2020-12-22","33","2152","8","271","22.9","28.7"
"Jeff Davis","2020-12-23","13","2165","1","272","22.4","26.1"
"Jeff Davis","2020-12-24","13","2178","4","276","24.6","26.8"
"Jeff Davis","2020-12-25","0","2178","0","276","20.2","25.8"
"Jeff Davis","2020-12-26","12","2190","7","283","25.3","27.2"
"Jeff Davis","2020-12-27","6","2196","3","286","28.9","23.7"
"Jeff Davis","2020-12-28","23","2219","6","292","28.2","25.1"
"Jeff Davis","2020-12-29","43","2262","10","302","28","25.4"
"Jeff Davis","2020-12-30","31","2293","8","310","30.6","26.5"
"Jeff Davis","2020-12-31","38","2331","10","320","30","27.3"
"Jeff Davis","2021-01-01","1","2332","0","320","30","25.1"
"Jeff Davis","2021-01-02","21","2353","5","325","25","25.2"
"Jeff Davis","2021-01-03","8","2361","5","330","26.8","27.9"
"Jeff Davis","2021-01-04","38","2399","13","343","28","28.1"
"Jeff Davis","2021-01-05","79","2478","19","362","28.1","28.1"
"Jeff Davis","2021-01-06","19","2497","6","368","28.9","29.8"
"Jeff Davis","2021-01-07","38","2535","8","376","28.2","29.1"
"Jeff Davis","2021-01-08","15","2550","4","380","32","31"
"Jeff Davis","2021-01-09","12","2562","3","383","32.2","28.6"
"Jeff Davis","2021-01-10","10","2572","2","385","26.1","26.5"
"Jeff Davis","2021-01-11","18","2590","3","388","23.6","25.8"
"Jeff Davis","2021-01-12","51","2641","10","398","22.9","25.5"
"Jeff Davis","2021-01-13","17","2658","2","400","20.1","24.5"
"Jeff Davis","2021-01-14","32","2690","6","406","19.8","24"
"Jeff Davis","2021-01-15","27","2717","4","410","18.1","25"
"Jeff Davis","2021-01-16","11","2728","3","413","18.4","25.3"
"Jeff Davis","2021-01-17","13","2741","6","419","22.1","24.1"
"Jeff Davis","2021-01-18","17","2758","2","421","21.4","22.5"
"Jeff Davis","2021-01-19","19","2777","5","426","22.4","22.7"
"Jeff Davis","2021-01-20","15","2792","4","430","24.5","22.3"
"Jeff Davis","2021-01-21","23","2815","3","433","23.7","21.7"
"Jeff Davis","2021-01-22","18","2833","6","439","26.4","22.2"
"Jeff Davis","2021-01-23","11","2844","4","443","27.7","23"
"Jeff Davis","2021-01-24","8","2852","2","445","24.6","23.4"
"Jeff Davis","2021-01-25","2","2854","1","446","30.1","25.8"
"Jeff Davis","2021-01-26","0","2854","0","446","26.3","24.4"
"Jeff Davis","2021-01-27","0","2854","0","446","22.5","23.5"
"Jefferson","2020-02-01","0","0","0","0",".","."
"Jefferson","2020-02-02","0","0","0","0",".","."
"Jefferson","2020-02-03","0","0","0","0",".","."
"Jefferson","2020-02-04","0","0","0","0",".","."
"Jefferson","2020-02-05","0","0","0","0",".","."
"Jefferson","2020-02-06","0","0","0","0",".","."
"Jefferson","2020-02-07","0","0","0","0","0","."
"Jefferson","2020-02-08","0","0","0","0","0","."
"Jefferson","2020-02-09","0","0","0","0","0","."
"Jefferson","2020-02-10","0","0","0","0","0","."
"Jefferson","2020-02-11","0","0","0","0","0","."
"Jefferson","2020-02-12","0","0","0","0","0","."
"Jefferson","2020-02-13","0","0","0","0","0","."
"Jefferson","2020-02-14","0","0","0","0","0","0"
"Jefferson","2020-02-15","0","0","0","0","0","0"
"Jefferson","2020-02-16","0","0","0","0","0","0"
"Jefferson","2020-02-17","0","0","0","0","0","0"
"Jefferson","2020-02-18","0","0","0","0","0","0"
"Jefferson","2020-02-19","0","0","0","0","0","0"
"Jefferson","2020-02-20","0","0","0","0","0","0"
"Jefferson","2020-02-21","0","0","0","0","0","0"
"Jefferson","2020-02-22","0","0","0","0","0","0"
"Jefferson","2020-02-23","0","0","0","0","0","0"
"Jefferson","2020-02-24","0","0","0","0","0","0"
"Jefferson","2020-02-25","0","0","0","0","0","0"
"Jefferson","2020-02-26","0","0","0","0","0","0"
"Jefferson","2020-02-27","0","0","0","0","0","0"
"Jefferson","2020-02-28","0","0","0","0","0","0"
"Jefferson","2020-02-29","0","0","0","0","0","0"
"Jefferson","2020-03-01","0","0","0","0","0","0"
"Jefferson","2020-03-02","0","0","0","0","0","0"
"Jefferson","2020-03-03","0","0","0","0","0","0"
"Jefferson","2020-03-04","0","0","0","0","0","0"
"Jefferson","2020-03-05","0","0","0","0","0","0"
"Jefferson","2020-03-06","0","0","0","0","0","0"
"Jefferson","2020-03-07","0","0","0","0","0","0"
"Jefferson","2020-03-08","0","0","0","0","0","0"
"Jefferson","2020-03-09","0","0","0","0","0","0"
"Jefferson","2020-03-10","0","0","0","0","0","0"
"Jefferson","2020-03-11","0","0","0","0","0","0"
"Jefferson","2020-03-12","0","0","0","0","0","0"
"Jefferson","2020-03-13","0","0","0","0","0","0"
"Jefferson","2020-03-14","0","0","0","0","0","0"
"Jefferson","2020-03-15","0","0","0","0","0","0"
"Jefferson","2020-03-16","1","1","0","0","0","0"
"Jefferson","2020-03-17","3","4","0","0","0","0"
"Jefferson","2020-03-18","1","5","0","0","0","0"
"Jefferson","2020-03-19","2","7","1","1","7.1","3.6"
"Jefferson","2020-03-20","1","8","0","1","7.1","3.6"
"Jefferson","2020-03-21","1","9","0","1","7.1","3.6"
"Jefferson","2020-03-22","2","11","0","1","7.1","3.6"
"Jefferson","2020-03-23","1","12","0","1","7.1","3.6"
"Jefferson","2020-03-24","2","14","0","1","7.1","3.6"
"Jefferson","2020-03-25","0","14","0","1","7.1","3.6"
"Jefferson","2020-03-26","1","15","0","1","0","3.6"
"Jefferson","2020-03-27","2","17","0","1","0","3.6"
"Jefferson","2020-03-28","0","17","0","1","0","3.6"
"Jefferson","2020-03-29","0","17","0","1","0","3.6"
"Jefferson","2020-03-30","2","19","0","1","0","3.6"
"Jefferson","2020-03-31","1","20","0","1","0","3.6"
"Jefferson","2020-04-01","3","23","0","1","0","3.6"
"Jefferson","2020-04-02","2","25","0","1","0","0"
"Jefferson","2020-04-03","1","26","0","1","0","0"
"Jefferson","2020-04-04","2","28","1","2","7.1","3.6"
"Jefferson","2020-04-05","0","28","0","2","7.1","3.6"
"Jefferson","2020-04-06","4","32","1","3","10.7","5.4"
"Jefferson","2020-04-07","3","35","0","3","10.7","5.4"
"Jefferson","2020-04-08","6","41","1","4","13.1","6.5"
"Jefferson","2020-04-09","4","45","0","4","13.1","6.5"
"Jefferson","2020-04-10","1","46","0","4","13.1","6.5"
"Jefferson","2020-04-11","5","51","0","4","6","6.5"
"Jefferson","2020-04-12","2","53","0","4","6","6.5"
"Jefferson","2020-04-13","4","57","1","5","6","8.3"
"Jefferson","2020-04-14","5","62","0","5","6","8.3"
"Jefferson","2020-04-15","6","68","1","6","6","9.5"
"Jefferson","2020-04-16","2","70","0","6","6","9.5"
"Jefferson","2020-04-17","2","72","0","6","6","9.5"
"Jefferson","2020-04-18","1","73","0","6","6","6"
"Jefferson","2020-04-19","1","74","0","6","6","6"
"Jefferson","2020-04-20","7","81","1","7","4.4","5.2"
"Jefferson","2020-04-21","15","96","1","8","5.4","5.7"
"Jefferson","2020-04-22","5","101","0","8","3","4.5"
"Jefferson","2020-04-23","9","110","0","8","3","4.5"
"Jefferson","2020-04-24","4","114","0","8","3","4.5"
"Jefferson","2020-04-25","11","125","0","8","3","4.5"
"Jefferson","2020-04-26","1","126","0","8","3","4.5"
"Jefferson","2020-04-27","4","130","0","8","1","2.7"
"Jefferson","2020-04-28","7","137","0","8","0","2.7"
"Jefferson","2020-04-29","4","141","0","8","0","1.5"
"Jefferson","2020-04-30","13","154","0","8","0","1.5"
"Jefferson","2020-05-01","6","160","0","8","0","1.5"
"Jefferson","2020-05-02","1","161","0","8","0","1.5"
"Jefferson","2020-05-03","2","163","0","8","0","1.5"
"Jefferson","2020-05-04","14","177","0","8","0","0.5"
"Jefferson","2020-05-05","6","183","0","8","0","0"
"Jefferson","2020-05-06","17","200","2","10","1.7","0.8"
"Jefferson","2020-05-07","3","203","0","10","1.7","0.8"
"Jefferson","2020-05-08","4","207","0","10","1.7","0.8"
"Jefferson","2020-05-09","4","211","0","10","1.7","0.8"
"Jefferson","2020-05-10","2","213","0","10","1.7","0.8"
"Jefferson","2020-05-11","8","221","0","10","1.7","0.8"
"Jefferson","2020-05-12","8","229","0","10","1.7","0.8"
"Jefferson","2020-05-13","9","238","1","11","1.6","1.6"
"Jefferson","2020-05-14","18","256","4","15","4.8","3.2"
"Jefferson","2020-05-15","7","263","0","15","4.8","3.2"
"Jefferson","2020-05-16","13","276","2","17","7","4.3"
"Jefferson","2020-05-17","0","276","0","17","7","4.3"
"Jefferson","2020-05-18","12","288","0","17","7","4.3"
"Jefferson","2020-05-19","15","303","2","19","8.9","5.3"
"Jefferson","2020-05-20","9","312","0","19","7.3","4.4"
"Jefferson","2020-05-21","4","316","0","19","4.1","4.4"
"Jefferson","2020-05-22","39","355","0","19","4.1","4.4"
"Jefferson","2020-05-23","5","360","2","21","7.6","7.3"
"Jefferson","2020-05-24","2","362","0","21","7.6","7.3"
"Jefferson","2020-05-25","1","363","0","21","7.6","7.3"
"Jefferson","2020-05-26","82","445","0","21","5.7","7.3"
"Jefferson","2020-05-27","11","456","2","23","8.3","7.8"
"Jefferson","2020-05-28","9","465","1","24","9.9","7"
"Jefferson","2020-05-29","8","473","1","25","11.7","7.9"
"Jefferson","2020-05-30","1","474","0","25","6","6.8"
"Jefferson","2020-05-31","2","476","0","25","6","6.8"
"Jefferson","2020-06-01","13","489","1","26","7.1","7.3"
"Jefferson","2020-06-02","13","502","0","26","7.1","6.4"
"Jefferson","2020-06-03","6","508","0","26","4.5","6.4"
"Jefferson","2020-06-04","15","523","1","27","3.8","6.9"
"Jefferson","2020-06-05","3","526","0","27","2.1","6.9"
"Jefferson","2020-06-06","3","529","0","27","2.1","4"
"Jefferson","2020-06-07","2","531","0","27","2.1","4"
"Jefferson","2020-06-08","6","537","1","28","3.3","5.2"
"Jefferson","2020-06-09","5","542","1","29","6.2","6.6"
"Jefferson","2020-06-10","11","553","1","30","7.5","6"
"Jefferson","2020-06-11","6","559","0","30","6.5","5.2"
"Jefferson","2020-06-12","10","569","1","31","8","5"
"Jefferson","2020-06-13","8","577","2","33","11.5","6.8"
"Jefferson","2020-06-14","7","584","1","34","13.6","7.8"
"Jefferson","2020-06-15","16","600","2","36","13","8.2"
"Jefferson","2020-06-16","16","616","6","42","15.5","10.8"
"Jefferson","2020-06-17","20","636","3","45","16.3","11.9"
"Jefferson","2020-06-18","5","641","0","45","16.3","11.4"
"Jefferson","2020-06-19","7","648","1","46","16.9","12.5"
"Jefferson","2020-06-20","6","654","0","46","13.4","12.5"
"Jefferson","2020-06-21","3","657","0","46","11.3","12.5"
"Jefferson","2020-06-22","23","680","5","51","12.6","12.8"
"Jefferson","2020-06-23","21","701","3","54","9.3","12.4"
"Jefferson","2020-06-24","21","722","6","60","11.3","13.8"
"Jefferson","2020-06-25","19","741","3","63","13.5","14.9"
"Jefferson","2020-06-26","19","760","2","65","13","15"
"Jefferson","2020-06-27","13","773","4","69","17.4","15.4"
"Jefferson","2020-06-28","7","780","1","70","19.4","15.4"
"Jefferson","2020-06-29","39","819","7","77","18.9","15.8"
"Jefferson","2020-06-30","30","849","7","84","20.2","14.8"
"Jefferson","2020-07-01","146","995","22","106","18.2","14.8"
"Jefferson","2020-07-02","19","1014","7","113","21.3","17.4"
"Jefferson","2020-07-03","15","1029","5","118","24.5","18.7"
"Jefferson","2020-07-04","13","1042","1","119","21.2","19.3"
"Jefferson","2020-07-05","13","1055","2","121","21.4","20.4"
"Jefferson","2020-07-06","33","1088","6","127","21.4","20.1"
"Jefferson","2020-07-07","47","1135","11","138","21.4","20.8"
"Jefferson","2020-07-08","41","1176","3","141","20.3","19.3"
"Jefferson","2020-07-09","42","1218","11","152","18.8","20"
"Jefferson","2020-07-10","41","1259","10","162","17.5","21"
"Jefferson","2020-07-11","22","1281","6","168","20.3","20.8"
"Jefferson","2020-07-12","25","1306","13","181","25.5","23.5"
"Jefferson","2020-07-13","49","1355","14","195","27","24.2"
"Jefferson","2020-07-14","42","1397","11","206","27.4","24.4"
"Jefferson","2020-07-15","42","1439","10","216","29.8","25"
"Jefferson","2020-07-16","35","1474","8","224","29.3","24"
"Jefferson","2020-07-17","46","1520","3","227","26.7","22.1"
"Jefferson","2020-07-18","17","1537","3","230","25.4","22.8"
"Jefferson","2020-07-19","13","1550","4","234","22.3","23.9"
"Jefferson","2020-07-20","24","1574","6","240","21.8","24.4"
"Jefferson","2020-07-21","38","1612","5","245","20","23.7"
"Jefferson","2020-07-22","21","1633","7","252","21.3","25.6"
"Jefferson","2020-07-23","33","1666","12","264","23.3","26.3"
"Jefferson","2020-07-24","24","1690","2","266","23.5","25.1"
"Jefferson","2020-07-25","17","1707","4","270","24.4","24.9"
"Jefferson","2020-07-26","7","1714","0","270","20","21.1"
"Jefferson","2020-07-27","31","1745","10","280","21","21.4"
"Jefferson","2020-07-28","27","1772","9","289","23.9","21.9"
"Jefferson","2020-07-29","25","1797","7","296","23.1","22.2"
"Jefferson","2020-07-30","27","1824","8","304","22.2","22.7"
"Jefferson","2020-07-31","28","1852","12","316","27.1","25.3"
"Jefferson","2020-08-01","10","1862","5","321","30.9","27.6"
"Jefferson","2020-08-02","12","1874","2","323","33.2","26.6"
"Jefferson","2020-08-03","18","1892","6","329","33.4","27.2"
"Jefferson","2020-08-04","20","1912","6","335","32.9","28.4"
"Jefferson","2020-08-05","102","2014","7","342","29.9","26.5"
"Jefferson","2020-08-06","27","2041","4","346","27.8","25"
"Jefferson","2020-08-07","51","2092","12","358","25","26.1"
"Jefferson","2020-08-08","10","2102","0","358","17.9","24.4"
"Jefferson","2020-08-09","40","2142","3","361","16.6","24.9"
"Jefferson","2020-08-10","24","2166","9","370","17.2","25.3"
"Jefferson","2020-08-11","28","2194","5","375","15.4","24.2"
"Jefferson","2020-08-12","27","2221","3","378","16","23"
"Jefferson","2020-08-13","114","2335","14","392","15.7","21.7"
"Jefferson","2020-08-14","38","2373","11","403","16.5","20.7"
"Jefferson","2020-08-15","8","2381","2","405","20","19"
"Jefferson","2020-08-16","14","2395","5","410","24.1","20.3"
"Jefferson","2020-08-17","27","2422","4","414","20.8","19"
"Jefferson","2020-08-18","16","2438","2","416","20.1","17.7"
"Jefferson","2020-08-19","29","2467","5","421","20.9","18.5"
"Jefferson","2020-08-20","73","2540","10","431","21.1","18.4"
"Jefferson","2020-08-21","67","2607","2","433","17.4","16.9"
"Jefferson","2020-08-22","12","2619","0","433","13.9","16.9"
"Jefferson","2020-08-23","4","2623","0","433","8.7","16.4"
"Jefferson","2020-08-24","16","2639","5","438","11.1","16"
"Jefferson","2020-08-25","15","2654","4","442","13.1","16.6"
"Jefferson","2020-08-26","18","2672","9","451","17.8","19.4"
"Jefferson","2020-08-27","60","2732","9","460","18","19.6"
"Jefferson","2020-08-28","39","2771","4","464","19","18.2"
"Jefferson","2020-08-29","21","2792","4","468","21.7","17.8"
"Jefferson","2020-08-30","22","2814","4","472","24.3","16.5"
"Jefferson","2020-08-31","25","2839","7","479","23.9","17.5"
"Jefferson","2020-09-01","30","2869","12","491","25.8","19.5"
"Jefferson","2020-09-02","96","2965","8","499","19.8","18.8"
"Jefferson","2020-09-03","41","3006","4","503","19.1","18.5"
"Jefferson","2020-09-04","30","3036","3","506","19","19"
"Jefferson","2020-09-05","16","3052","2","508","18.1","19.9"
"Jefferson","2020-09-06","8","3060","3","511","20.9","22.6"
"Jefferson","2020-09-07","12","3072","4","515","21.6","22.8"
"Jefferson","2020-09-08","27","3099","6","521","19.1","22.4"
"Jefferson","2020-09-09","18","3117","4","525","21.1","20.5"
"Jefferson","2020-09-10","24","3141","5","530","22.7","20.9"
"Jefferson","2020-09-11","16","3157","0","530","21.2","20.1"
"Jefferson","2020-09-12","14","3171","3","533","22.5","20.3"
"Jefferson","2020-09-13","7","3178","0","533","17.1","19"
"Jefferson","2020-09-14","28","3206","6","539","15.4","18.5"
"Jefferson","2020-09-15","28","3234","3","542","13.8","16.4"
"Jefferson","2020-09-16","18","3252","1","543","11.4","16.2"
"Jefferson","2020-09-17","16","3268","4","547","12","17.3"
"Jefferson","2020-09-18","18","3286","8","555","18.4","19.8"
"Jefferson","2020-09-19","53","3339","2","557","15.8","19.2"
"Jefferson","2020-09-20","11","3350","0","557","15.8","16.5"
"Jefferson","2020-09-21","21","3371","3","560","14.8","15.1"
"Jefferson","2020-09-22","18","3389","4","564","16.5","15.1"
"Jefferson","2020-09-23","14","3403","3","567","18.7","15.1"
"Jefferson","2020-09-24","48","3451","5","572","16.7","14.3"
"Jefferson","2020-09-25","20","3471","3","575","12.4","15.4"
"Jefferson","2020-09-26","13","3484","2","577","14.1","15"
"Jefferson","2020-09-27","2","3486","0","577","14.1","15"
"Jefferson","2020-09-28","22","3508","5","582","15.3","15.1"
"Jefferson","2020-09-29","29","3537","6","588","15.1","15.8"
"Jefferson","2020-09-30","22","3559","1","589","12.7","15.7"
"Jefferson","2020-10-01","107","3666","2","591","11.5","14.1"
"Jefferson","2020-10-02","55","3721","2","593","9.8","11.1"
"Jefferson","2020-10-03","17","3738","1","594","8.5","11.3"
"Jefferson","2020-10-04","4","3742","0","594","8.5","11.3"
"Jefferson","2020-10-05","21","3763","2","596","6.6","11"
"Jefferson","2020-10-06","42","3805","1","597","4","9.5"
"Jefferson","2020-10-07","63","3868","1","598","3.6","8.1"
"Jefferson","2020-10-08","40","3908","1","599","3.6","7.6"
"Jefferson","2020-10-09","62","3970","1","600","3.4","6.6"
"Jefferson","2020-10-10","22","3992","0","600","2.5","5.5"
"Jefferson","2020-10-11","6","3998","0","600","2.5","5.5"
"Jefferson","2020-10-12","30","4028","3","603","2.6","4.6"
"Jefferson","2020-10-13","44","4072","1","604","2.6","3.3"
"Jefferson","2020-10-14","19","4091","1","605","3.1","3.3"
"Jefferson","2020-10-15","53","4144","1","606","3","3.3"
"Jefferson","2020-10-16","41","4185","4","610","4.2","3.8"
"Jefferson","2020-10-17","5","4190","1","611","7","4.8"
"Jefferson","2020-10-18","5","4195","0","611","7","4.8"
"Jefferson","2020-10-19","28","4223","2","613","6.6","4.6"
"Jefferson","2020-10-20","24","4247","1","614","6.9","4.7"
"Jefferson","2020-10-21","18","4265","3","617","8.5","5.8"
"Jefferson","2020-10-22","33","4298","2","619","9.1","6.1"
"Jefferson","2020-10-23","20","4318","2","621","9.1","6.7"
"Jefferson","2020-10-24","13","4331","0","621","6.3","6.7"
"Jefferson","2020-10-25","7","4338","1","622","8.3","7.7"
"Jefferson","2020-10-26","36","4374","1","623","7.7","7.2"
"Jefferson","2020-10-27","25","4399","1","624","7.7","7.3"
"Jefferson","2020-10-28","16","4415","1","625","6.2","7.4"
"Jefferson","2020-10-29","18","4433","0","625","5.3","7.2"
"Jefferson","2020-10-30","18","4451","1","626","4.7","6.9"
"Jefferson","2020-10-31","9","4460","0","626","4.7","5.5"
"Jefferson","2020-11-01","3","4463","1","627","7.4","7.9"
"Jefferson","2020-11-02","22","4485","2","629","8.3","8"
"Jefferson","2020-11-03","20","4505","2","631","9.2","8.4"
"Jefferson","2020-11-04","12","4517","3","634","11.9","9"
"Jefferson","2020-11-05","66","4583","10","644","14","9.7"
"Jefferson","2020-11-06","27","4610","4","648","15.3","10"
"Jefferson","2020-11-07","19","4629","3","651","17.6","11.1"
"Jefferson","2020-11-08","98","4727","2","653","13.1","10.3"
"Jefferson","2020-11-09","56","4783","4","657","12.8","10.6"
"Jefferson","2020-11-10","34","4817","7","664","14.4","11.8"
"Jefferson","2020-11-11","47","4864","4","668","12","11.9"
"Jefferson","2020-11-12","45","4909","4","672","11.1","12.6"
"Jefferson","2020-11-13","22","4931","5","677","12.2","13.8"
"Jefferson","2020-11-14","14","4945","3","680","13","15.3"
"Jefferson","2020-11-15","8","4953","1","681","14.5","13.8"
"Jefferson","2020-11-16","32","4985","7","688","16.6","14.7"
"Jefferson","2020-11-17","39","5024","6","694","15.9","15.1"
"Jefferson","2020-11-18","34","5058","4","698","16.4","14.2"
"Jefferson","2020-11-19","49","5107","4","702","16.3","13.7"
"Jefferson","2020-11-20","30","5137","4","706","14.9","13.6"
"Jefferson","2020-11-21","10","5147","2","708","14.7","13.9"
"Jefferson","2020-11-22","8","5155","0","708","12.9","13.7"
"Jefferson","2020-11-23","25","5180","1","709","10.4","13.5"
"Jefferson","2020-11-24","43","5223","7","716","10.5","13.2"
"Jefferson","2020-11-25","11","5234","0","716","8.8","12.6"
"Jefferson","2020-11-26","6","5240","2","718","12.4","14.3"
"Jefferson","2020-11-27","44","5284","3","721","11.5","13.2"
"Jefferson","2020-11-28","7","5291","0","721","8.6","11.7"
"Jefferson","2020-11-29","7","5298","0","721","8.6","10.8"
"Jefferson","2020-11-30","45","5343","12","733","11.9","11.1"
"Jefferson","2020-12-01","56","5399","5","738","10.8","10.7"
"Jefferson","2020-12-02","30","5429","9","747","15.1","12"
"Jefferson","2020-12-03","66","5495","5","752","11.4","11.9"
"Jefferson","2020-12-04","54","5549","1","753","10.7","11.1"
"Jefferson","2020-12-05","15","5564","3","756","13.6","11.1"
"Jefferson","2020-12-06","8","5572","1","757","15.4","12"
"Jefferson","2020-12-07","35","5607","5","762","13.6","12.7"
"Jefferson","2020-12-08","60","5667","5","767","13.5","12.2"
"Jefferson","2020-12-09","36","5703","4","771","10.8","13"
"Jefferson","2020-12-10","39","5742","5","776","11.6","11.5"
"Jefferson","2020-12-11","60","5802","6","782","12.7","11.7"
"Jefferson","2020-12-12","17","5819","2","784","11.5","12.6"
"Jefferson","2020-12-13","9","5828","3","787","14.5","14.9"
"Jefferson","2020-12-14","44","5872","16","803","17.7","15.6"
"Jefferson","2020-12-15","69","5941","8","811","18.1","15.8"
"Jefferson","2020-12-16","36","5977","5","816","18.5","14.7"
"Jefferson","2020-12-17","42","6019","6","822","18.7","15.2"
"Jefferson","2020-12-18","45","6064","4","826","18.6","15.7"
"Jefferson","2020-12-19","15","6079","4","830","20.7","16.1"
"Jefferson","2020-12-20","10","6089","3","833","20.2","17.4"
"Jefferson","2020-12-21","48","6137","8","841","17.4","17.6"
"Jefferson","2020-12-22","63","6200","12","853","18.5","18.3"
"Jefferson","2020-12-23","31","6231","7","860","19.7","19.1"
"Jefferson","2020-12-24","28","6259","6","866","20.8","19.8"
"Jefferson","2020-12-25","8","6267","1","867","21.3","19.9"
"Jefferson","2020-12-26","12","6279","4","871","22.2","21.5"
"Jefferson","2020-12-27","12","6291","1","872","19.1","19.7"
"Jefferson","2020-12-28","51","6342","12","884","20.1","18.8"
"Jefferson","2020-12-29","51","6393","12","896","20.7","19.6"
"Jefferson","2020-12-30","29","6422","8","904","21.5","20.6"
"Jefferson","2020-12-31","46","6468","11","915","21.8","21.3"
"Jefferson","2021-01-01","4","6472","0","915","20","20.7"
"Jefferson","2021-01-02","20","6492","8","923","21","21.6"
"Jefferson","2021-01-03","11","6503","5","928","26.3","22.7"
"Jefferson","2021-01-04","24","6527","6","934","26.5","23.3"
"Jefferson","2021-01-05","58","6585","11","945","25.8","23.3"
"Jefferson","2021-01-06","55","6640","16","961","26.1","23.8"
"Jefferson","2021-01-07","41","6681","18","979","28.9","25.4"
"Jefferson","2021-01-08","81","6762","16","995","31.7","25.9"
"Jefferson","2021-01-09","22","6784","8","1003","31.2","26.1"
"Jefferson","2021-01-10","10","6794","4","1007","30.4","28.4"
"Jefferson","2021-01-11","54","6848","21","1028","32.4","29.5"
"Jefferson","2021-01-12","183","7031","12","1040","30.7","28.2"
"Jefferson","2021-01-13","42","7073","11","1051","30.2","28.1"
"Jefferson","2021-01-14","45","7118","18","1069","29.7","29.3"
"Jefferson","2021-01-15","176","7294","19","1088","28.4","30.1"
"Jefferson","2021-01-16","29","7323","13","1101","29.6","30.4"
"Jefferson","2021-01-17","13","7336","1","1102","25","27.7"
"Jefferson","2021-01-18","33","7369","13","1115","25.1","28.7"
"Jefferson","2021-01-19","88","7457","13","1128","26.2","28.4"
"Jefferson","2021-01-20","43","7500","6","1134","24.5","27.4"
"Jefferson","2021-01-21","38","7538","3","1137","19.9","24.8"
"Jefferson","2021-01-22","69","7607","9","1146","20.2","24.3"
"Jefferson","2021-01-23","16","7623","3","1149","16.5","23.1"
"Jefferson","2021-01-24","8","7631","0","1149","15.4","20.2"
"Jefferson","2021-01-25","15","7646","4","1153","13.6","19.3"
"Jefferson","2021-01-26","35","7681","0","1153","11.5","18.9"
"Jefferson","2021-01-27","0","7681","0","1153","9.5","17"
"Jenkins","2020-02-01","0","0","0","0",".","."
"Jenkins","2020-02-02","0","0","0","0",".","."
"Jenkins","2020-02-03","0","0","0","0",".","."
"Jenkins","2020-02-04","0","0","0","0",".","."
"Jenkins","2020-02-05","0","0","0","0",".","."
"Jenkins","2020-02-06","0","0","0","0",".","."
"Jenkins","2020-02-07","0","0","0","0","0","."
"Jenkins","2020-02-08","0","0","0","0","0","."
"Jenkins","2020-02-09","0","0","0","0","0","."
"Jenkins","2020-02-10","0","0","0","0","0","."
"Jenkins","2020-02-11","0","0","0","0","0","."
"Jenkins","2020-02-12","0","0","0","0","0","."
"Jenkins","2020-02-13","0","0","0","0","0","."
"Jenkins","2020-02-14","0","0","0","0","0","0"
"Jenkins","2020-02-15","0","0","0","0","0","0"
"Jenkins","2020-02-16","0","0","0","0","0","0"
"Jenkins","2020-02-17","0","0","0","0","0","0"
"Jenkins","2020-02-18","0","0","0","0","0","0"
"Jenkins","2020-02-19","0","0","0","0","0","0"
"Jenkins","2020-02-20","0","0","0","0","0","0"
"Jenkins","2020-02-21","0","0","0","0","0","0"
"Jenkins","2020-02-22","0","0","0","0","0","0"
"Jenkins","2020-02-23","0","0","0","0","0","0"
"Jenkins","2020-02-24","0","0","0","0","0","0"
"Jenkins","2020-02-25","0","0","0","0","0","0"
"Jenkins","2020-02-26","0","0","0","0","0","0"
"Jenkins","2020-02-27","0","0","0","0","0","0"
"Jenkins","2020-02-28","0","0","0","0","0","0"
"Jenkins","2020-02-29","0","0","0","0","0","0"
"Jenkins","2020-03-01","0","0","0","0","0","0"
"Jenkins","2020-03-02","0","0","0","0","0","0"
"Jenkins","2020-03-03","0","0","0","0","0","0"
"Jenkins","2020-03-04","0","0","0","0","0","0"
"Jenkins","2020-03-05","0","0","0","0","0","0"
"Jenkins","2020-03-06","0","0","0","0","0","0"
"Jenkins","2020-03-07","0","0","0","0","0","0"
"Jenkins","2020-03-08","0","0","0","0","0","0"
"Jenkins","2020-03-09","0","0","0","0","0","0"
"Jenkins","2020-03-10","0","0","0","0","0","0"
"Jenkins","2020-03-11","2","2","0","0","0","0"
"Jenkins","2020-03-12","0","2","0","0","0","0"
"Jenkins","2020-03-13","3","5","0","0","0","0"
"Jenkins","2020-03-14","0","5","0","0","0","0"
"Jenkins","2020-03-15","0","5","0","0","0","0"
"Jenkins","2020-03-16","0","5","0","0","0","0"
"Jenkins","2020-03-17","2","7","1","1","7.1","3.6"
"Jenkins","2020-03-18","4","11","0","1","7.1","3.6"
"Jenkins","2020-03-19","2","13","0","1","7.1","3.6"
"Jenkins","2020-03-20","1","14","0","1","7.1","3.6"
"Jenkins","2020-03-21","1","15","0","1","7.1","3.6"
"Jenkins","2020-03-22","0","15","0","1","7.1","3.6"
"Jenkins","2020-03-23","0","15","0","1","7.1","3.6"
"Jenkins","2020-03-24","0","15","0","1","0","3.6"
"Jenkins","2020-03-25","0","15","0","1","0","3.6"
"Jenkins","2020-03-26","2","17","0","1","0","3.6"
"Jenkins","2020-03-27","3","20","0","1","0","3.6"
"Jenkins","2020-03-28","0","20","0","1","0","3.6"
"Jenkins","2020-03-29","0","20","0","1","0","3.6"
"Jenkins","2020-03-30","1","21","0","1","0","3.6"
"Jenkins","2020-03-31","3","24","1","2","4.8","2.4"
"Jenkins","2020-04-01","0","24","0","2","4.8","2.4"
"Jenkins","2020-04-02","5","29","1","3","7.6","3.8"
"Jenkins","2020-04-03","3","32","0","3","7.6","3.8"
"Jenkins","2020-04-04","1","33","1","4","21.9","11"
"Jenkins","2020-04-05","1","34","0","4","21.9","11"
"Jenkins","2020-04-06","11","45","2","6","24.5","12.3"
"Jenkins","2020-04-07","6","51","0","6","19.7","12.3"
"Jenkins","2020-04-08","6","57","1","7","22.1","13.4"
"Jenkins","2020-04-09","6","63","1","8","21.6","14.6"
"Jenkins","2020-04-10","2","65","0","8","21.6","14.6"
"Jenkins","2020-04-11","1","66","0","8","7.4","14.6"
"Jenkins","2020-04-12","1","67","0","8","7.4","14.6"
"Jenkins","2020-04-13","13","80","2","10","7","15.7"
"Jenkins","2020-04-14","2","82","0","10","7","13.3"
"Jenkins","2020-04-15","3","85","1","11","9.3","15.7"
"Jenkins","2020-04-16","3","88","0","11","7","14.3"
"Jenkins","2020-04-17","2","90","0","11","7","14.3"
"Jenkins","2020-04-18","0","90","0","11","7","7.2"
"Jenkins","2020-04-19","0","90","0","11","7","7.2"
"Jenkins","2020-04-20","6","96","1","12","7.1","7.1"
"Jenkins","2020-04-21","15","111","3","15","10","8.5"
"Jenkins","2020-04-22","6","117","0","15","5.2","7.3"
"Jenkins","2020-04-23","3","120","0","15","5.2","6.1"
"Jenkins","2020-04-24","7","127","0","15","5.2","6.1"
"Jenkins","2020-04-25","0","127","0","15","5.2","6.1"
"Jenkins","2020-04-26","1","128","0","15","5.2","6.1"
"Jenkins","2020-04-27","2","130","0","15","2.9","5"
"Jenkins","2020-04-28","7","137","0","15","0","5"
"Jenkins","2020-04-29","6","143","2","17","4.8","5"
"Jenkins","2020-04-30","2","145","0","17","4.8","5"
"Jenkins","2020-05-01","3","148","0","17","4.8","5"
"Jenkins","2020-05-02","0","148","0","17","4.8","5"
"Jenkins","2020-05-03","1","149","0","17","4.8","5"
"Jenkins","2020-05-04","5","154","0","17","4.8","3.8"
"Jenkins","2020-05-05","5","159","0","17","4.8","2.4"
"Jenkins","2020-05-06","4","163","0","17","0","2.4"
"Jenkins","2020-05-07","2","165","0","17","0","2.4"
"Jenkins","2020-05-08","6","171","1","18","2.4","3.6"
"Jenkins","2020-05-09","0","171","0","18","2.4","3.6"
"Jenkins","2020-05-10","1","172","1","19","16.7","10.7"
"Jenkins","2020-05-11","3","175","0","19","16.7","10.7"
"Jenkins","2020-05-12","5","180","0","19","16.7","10.7"
"Jenkins","2020-05-13","3","183","0","19","16.7","8.3"
"Jenkins","2020-05-14","2","185","0","19","16.7","8.3"
"Jenkins","2020-05-15","0","185","0","19","14.3","8.3"
"Jenkins","2020-05-16","3","188","0","19","14.3","8.3"
"Jenkins","2020-05-17","1","189","0","19","0","8.3"
"Jenkins","2020-05-18","2","191","1","20","7.1","11.9"
"Jenkins","2020-05-19","5","196","0","20","7.1","11.9"
"Jenkins","2020-05-20","3","199","0","20","7.1","11.9"
"Jenkins","2020-05-21","2","201","1","21","14.3","15.5"
"Jenkins","2020-05-22","4","205","0","21","14.3","14.3"
"Jenkins","2020-05-23","0","205","0","21","14.3","14.3"
"Jenkins","2020-05-24","0","205","0","21","14.3","7.1"
"Jenkins","2020-05-25","2","207","0","21","7.1","7.1"
"Jenkins","2020-05-26","2","209","0","21","7.1","7.1"
"Jenkins","2020-05-27","4","213","0","21","7.1","7.1"
"Jenkins","2020-05-28","1","214","0","21","0","7.1"
"Jenkins","2020-05-29","6","220","1","22","2.4","8.3"
"Jenkins","2020-05-30","0","220","0","22","2.4","8.3"
"Jenkins","2020-05-31","2","222","0","22","2.4","8.3"
"Jenkins","2020-06-01","5","227","2","24","8.1","7.6"
"Jenkins","2020-06-02","6","233","2","26","12.9","10"
"Jenkins","2020-06-03","2","235","2","28","27.1","17.1"
"Jenkins","2020-06-04","6","241","2","30","31.9","16"
"Jenkins","2020-06-05","6","247","1","31","31.9","17.1"
"Jenkins","2020-06-06","0","247","0","31","31.9","17.1"
"Jenkins","2020-06-07","0","247","0","31","31.9","17.1"
"Jenkins","2020-06-08","5","252","0","31","26.2","17.1"
"Jenkins","2020-06-09","11","263","3","34","25.3","19.1"
"Jenkins","2020-06-10","5","268","0","34","11","19.1"
"Jenkins","2020-06-11","4","272","0","34","6.3","19.1"
"Jenkins","2020-06-12","3","275","1","35","8.7","20.3"
"Jenkins","2020-06-13","4","279","1","36","12.2","22.1"
"Jenkins","2020-06-14","2","281","0","36","12.2","22.1"
"Jenkins","2020-06-15","8","289","1","37","14","20.1"
"Jenkins","2020-06-16","12","301","0","37","10.1","17.7"
"Jenkins","2020-06-17","3","304","3","40","24.4","17.7"
"Jenkins","2020-06-18","2","306","1","41","31.5","18.9"
"Jenkins","2020-06-19","7","313","2","43","30.9","19.8"
"Jenkins","2020-06-20","2","315","0","43","27.3","19.8"
"Jenkins","2020-06-21","1","316","1","44","41.6","26.9"
"Jenkins","2020-06-22","14","330","3","47","42.9","28.4"
"Jenkins","2020-06-23","16","346","5","52","47.3","28.7"
"Jenkins","2020-06-24","12","358","3","55","36.6","30.5"
"Jenkins","2020-06-25","10","368","1","56","30.9","31.2"
"Jenkins","2020-06-26","11","379","0","56","26.8","28.8"
"Jenkins","2020-06-27","2","381","1","57","34","30.6"
"Jenkins","2020-06-28","3","384","0","57","19.7","30.6"
"Jenkins","2020-06-29","18","402","2","59","18.2","30.5"
"Jenkins","2020-06-30","18","420","2","61","15.3","31.3"
"Jenkins","2020-07-01","17","437","0","61","11.7","24.2"
"Jenkins","2020-07-02","9","446","1","62","11.9","21.4"
"Jenkins","2020-07-03","0","446","0","62","11.9","19.4"
"Jenkins","2020-07-04","1","447","0","62","4.8","19.4"
"Jenkins","2020-07-05","3","450","0","62","4.8","12.2"
"Jenkins","2020-07-06","12","462","3","65","6.7","12.5"
"Jenkins","2020-07-07","15","477","2","67","7.1","11.2"
"Jenkins","2020-07-08","7","484","3","70","13.2","12.5"
"Jenkins","2020-07-09","99","583","7","77","12.6","12.3"
"Jenkins","2020-07-10","14","597","1","78","13.6","12.8"
"Jenkins","2020-07-11","4","601","1","79","17.2","11"
"Jenkins","2020-07-12","1","602","0","79","17.2","11"
"Jenkins","2020-07-13","54","656","3","82","14.4","10.6"
"Jenkins","2020-07-14","7","663","2","84","16.6","11.8"
"Jenkins","2020-07-15","11","674","3","87","14.4","13.8"
"Jenkins","2020-07-16","8","682","2","89","16.9","14.8"
"Jenkins","2020-07-17","7","689","0","89","15.9","14.8"
"Jenkins","2020-07-18","2","691","0","89","12.3","14.8"
"Jenkins","2020-07-19","0","691","0","89","12.3","14.8"
"Jenkins","2020-07-20","93","784","3","92","12","13.2"
"Jenkins","2020-07-21","9","793","3","95","12.7","14.6"
"Jenkins","2020-07-22","5","798","0","95","8.8","11.6"
"Jenkins","2020-07-23","5","803","1","96","8.1","12.5"
"Jenkins","2020-07-24","5","808","0","96","8.1","12"
"Jenkins","2020-07-25","1","809","0","96","8.1","10.2"
"Jenkins","2020-07-26","1","810","1","97","22.4","17.4"
"Jenkins","2020-07-27","69","879","6","103","23.1","17.6"
"Jenkins","2020-07-28","10","889","0","103","18.4","15.5"
"Jenkins","2020-07-29","5","894","2","105","24.1","16.4"
"Jenkins","2020-07-30","7","901","0","105","21.2","14.7"
"Jenkins","2020-07-31","7","908","1","106","23.3","15.7"
"Jenkins","2020-08-01","5","913","1","107","26.1","17.1"
"Jenkins","2020-08-02","2","915","0","107","11.9","17.1"
"Jenkins","2020-08-03","55","970","8","115","12.7","17.9"
"Jenkins","2020-08-04","6","976","0","115","12.7","15.5"
"Jenkins","2020-08-05","9","985","1","116","8.6","16.3"
"Jenkins","2020-08-06","6","991","2","118","13.3","17.3"
"Jenkins","2020-08-07","9","1000","0","118","11.3","17.3"
"Jenkins","2020-08-08","57","1057","6","124","9.9","18"
"Jenkins","2020-08-09","7","1064","4","128","18.1","15"
"Jenkins","2020-08-10","46","1110","7","135","18.2","15.4"
"Jenkins","2020-08-11","7","1117","0","135","18.2","15.4"
"Jenkins","2020-08-12","23","1140","3","138","18.5","13.5"
"Jenkins","2020-08-13","25","1165","1","139","14.3","13.8"
"Jenkins","2020-08-14","8","1173","0","139","14.3","12.8"
"Jenkins","2020-08-15","7","1180","2","141","16.9","13.4"
"Jenkins","2020-08-16","9","1189","0","141","8.7","13.4"
"Jenkins","2020-08-17","10","1199","4","145","12.2","15.2"
"Jenkins","2020-08-18","3","1202","1","146","17","17.6"
"Jenkins","2020-08-19","29","1231","0","146","15.1","16.8"
"Jenkins","2020-08-20","4","1235","0","146","14.6","14.4"
"Jenkins","2020-08-21","39","1274","0","146","14.6","14.4"
"Jenkins","2020-08-22","4","1278","2","148","17.6","17.2"
"Jenkins","2020-08-23","1","1279","0","148","17.6","13.2"
"Jenkins","2020-08-24","33","1312","4","152","13.6","12.9"
"Jenkins","2020-08-25","11","1323","5","157","15.4","16.2"
"Jenkins","2020-08-26","11","1334","3","160","19.3","17.2"
"Jenkins","2020-08-27","10","1344","5","165","26.4","20.5"
"Jenkins","2020-08-28","7","1351","0","165","26.4","20.5"
"Jenkins","2020-08-29","3","1354","1","166","24","20.8"
"Jenkins","2020-08-30","4","1358","3","169","34.7","26.2"
"Jenkins","2020-08-31","69","1427","17","186","36.5","25.1"
"Jenkins","2020-09-01","9","1436","2","188","33.2","24.3"
"Jenkins","2020-09-02","19","1455","3","191","31.6","25.4"
"Jenkins","2020-09-03","22","1477","3","194","26.4","26.4"
"Jenkins","2020-09-04","11","1488","3","197","30.3","28.3"
"Jenkins","2020-09-05","8","1496","1","198","27.3","25.7"
"Jenkins","2020-09-06","1","1497","0","198","16.6","25.7"
"Jenkins","2020-09-07","3","1500","2","200","22.6","29.6"
"Jenkins","2020-09-08","23","1523","10","210","25.6","29.4"
"Jenkins","2020-09-09","7","1530","3","213","29.5","30.5"
"Jenkins","2020-09-10","5","1535","1","214","30.4","28.4"
"Jenkins","2020-09-11","15","1550","1","215","27.5","28.9"
"Jenkins","2020-09-12","6","1556","0","215","25.7","26.5"
"Jenkins","2020-09-13","3","1559","1","216","30.4","23.5"
"Jenkins","2020-09-14","53","1612","9","225","23.3","23"
"Jenkins","2020-09-15","8","1620","3","228","22.5","24"
"Jenkins","2020-09-16","6","1626","2","230","21.1","25.3"
"Jenkins","2020-09-17","8","1634","0","230","18.3","24.3"
"Jenkins","2020-09-18","8","1642","0","230","17.3","22.4"
"Jenkins","2020-09-19","5","1647","3","233","25.9","25.8"
"Jenkins","2020-09-20","7","1654","2","235","25.2","27.8"
"Jenkins","2020-09-21","35","1689","2","237","23.6","23.5"
"Jenkins","2020-09-22","18","1707","4","241","21.4","21.9"
"Jenkins","2020-09-23","7","1714","2","243","20.7","20.9"
"Jenkins","2020-09-24","9","1723","1","244","22.3","20.3"
"Jenkins","2020-09-25","7","1730","3","247","28.4","22.9"
"Jenkins","2020-09-26","4","1734","0","247","19.9","22.9"
"Jenkins","2020-09-27","3","1737","2","249","25.3","25.3"
"Jenkins","2020-09-28","26","1763","6","255","27.8","25.7"
"Jenkins","2020-09-29","11","1774","2","257","27.2","24.3"
"Jenkins","2020-09-30","7","1781","0","257","23.1","21.9"
"Jenkins","2020-10-01","6","1787","0","257","21.5","21.9"
"Jenkins","2020-10-02","5","1792","0","257","15.4","21.9"
"Jenkins","2020-10-03","3","1795","0","257","15.4","17.6"
"Jenkins","2020-10-04","6","1801","0","257","5.9","15.6"
"Jenkins","2020-10-05","24","1825","4","261","5","16.4"
"Jenkins","2020-10-06","6","1831","1","262","4.8","16"
"Jenkins","2020-10-07","4","1835","1","263","8.3","15.7"
"Jenkins","2020-10-08","9","1844","2","265","11.5","16.5"
"Jenkins","2020-10-09","3","1847","0","265","11.5","13.5"
"Jenkins","2020-10-10","3","1850","0","265","11.5","13.5"
"Jenkins","2020-10-11","0","1850","0","265","11.5","8.7"
"Jenkins","2020-10-12","6","1856","0","265","9.1","7.1"
"Jenkins","2020-10-13","5","1861","1","266","9.6","7.2"
"Jenkins","2020-10-14","2","1863","0","266","6","7.2"
"Jenkins","2020-10-15","5","1868","0","266","2.9","7.2"
"Jenkins","2020-10-16","3","1871","0","266","2.9","7.2"
"Jenkins","2020-10-17","3","1874","0","266","2.9","7.2"
"Jenkins","2020-10-18","2","1876","0","266","2.9","7.2"
"Jenkins","2020-10-19","17","1893","1","267","3.7","6.4"
"Jenkins","2020-10-20","5","1898","0","267","0.8","5.2"
"Jenkins","2020-10-21","3","1901","0","267","0.8","3.4"
"Jenkins","2020-10-22","2","1903","0","267","0.8","1.8"
"Jenkins","2020-10-23","7","1910","4","271","9","5.9"
"Jenkins","2020-10-24","3","1913","0","271","9","5.9"
"Jenkins","2020-10-25","1","1914","0","271","9","5.9"
"Jenkins","2020-10-26","32","1946","4","275","9.9","6.8"
"Jenkins","2020-10-27","5","1951","0","275","9.9","5.4"
"Jenkins","2020-10-28","7","1958","2","277","14","7.4"
"Jenkins","2020-10-29","4","1962","2","279","21.2","11"
"Jenkins","2020-10-30","5","1967","1","280","15.9","12.4"
"Jenkins","2020-10-31","1","1968","0","280","15.9","12.4"
"Jenkins","2020-11-01","3","1971","0","280","15.9","12.4"
"Jenkins","2020-11-02","14","1985","0","280","14.1","12"
"Jenkins","2020-11-03","5","1990","1","281","16.9","13.4"
"Jenkins","2020-11-04","7","1997","1","282","14.9","14.5"
"Jenkins","2020-11-05","7","2004","1","283","9.8","15.5"
"Jenkins","2020-11-06","5","2009","2","285","12.7","14.3"
"Jenkins","2020-11-07","9","2018","1","286","14.2","15.1"
"Jenkins","2020-11-08","4","2022","1","287","17.8","16.8"
"Jenkins","2020-11-09","13","2035","0","287","17.8","15.9"
"Jenkins","2020-11-10","7","2042","1","288","17","17"
"Jenkins","2020-11-11","3","2045","1","289","19.7","17.3"
"Jenkins","2020-11-12","11","2056","2","291","20.3","15"
"Jenkins","2020-11-13","8","2064","0","291","14.6","13.6"
"Jenkins","2020-11-14","3","2067","0","291","13","13.6"
"Jenkins","2020-11-15","3","2070","0","291","9.4","13.6"
"Jenkins","2020-11-16","52","2122","1","292","9.7","13.7"
"Jenkins","2020-11-17","8","2130","0","292","7.6","12.3"
"Jenkins","2020-11-18","6","2136","2","294","7.6","13.7"
"Jenkins","2020-11-19","13","2149","1","295","6.1","13.2"
"Jenkins","2020-11-20","6","2155","0","295","6.1","10.3"
"Jenkins","2020-11-21","1","2156","0","295","6.1","9.6"
"Jenkins","2020-11-22","2","2158","0","295","6.1","7.8"
"Jenkins","2020-11-23","6","2164","1","296","8.2","9"
"Jenkins","2020-11-24","7","2171","1","297","10.3","9"
"Jenkins","2020-11-25","8","2179","0","297","5.5","6.6"
"Jenkins","2020-11-26","1","2180","0","297","4.4","5.3"
"Jenkins","2020-11-27","0","2180","0","297","4.4","5.3"
"Jenkins","2020-11-28","2","2182","0","297","4.4","5.3"
"Jenkins","2020-11-29","4","2186","1","298","8","7.1"
"Jenkins","2020-11-30","31","2217","1","299","6.1","7.2"
"Jenkins","2020-12-01","6","2223","0","299","4","7.2"
"Jenkins","2020-12-02","6","2229","1","300","6.4","6"
"Jenkins","2020-12-03","8","2237","0","300","6.4","5.4"
"Jenkins","2020-12-04","6","2243","1","301","8.8","6.6"
"Jenkins","2020-12-05","0","2243","0","301","8.8","6.6"
"Jenkins","2020-12-06","2","2245","0","301","5.2","6.6"
"Jenkins","2020-12-07","15","2260","1","302","5.7","5.9"
"Jenkins","2020-12-08","8","2268","1","303","7.5","5.8"
"Jenkins","2020-12-09","7","2275","2","305","9.2","7.8"
"Jenkins","2020-12-10","12","2287","1","306","10.4","8.4"
"Jenkins","2020-12-11","3","2290","0","306","8","8.4"
"Jenkins","2020-12-12","2","2292","0","306","8","8.4"
"Jenkins","2020-12-13","0","2292","0","306","8","6.6"
"Jenkins","2020-12-14","10","2302","1","307","8.5","7.1"
"Jenkins","2020-12-15","9","2311","4","311","13","10.3"
"Jenkins","2020-12-16","11","2322","1","312","10.3","9.7"
"Jenkins","2020-12-17","4","2326","0","312","9.1","9.7"
"Jenkins","2020-12-18","7","2333","0","312","9.1","8.5"
"Jenkins","2020-12-19","4","2337","0","312","9.1","8.5"
"Jenkins","2020-12-20","1","2338","0","312","9.1","8.5"
"Jenkins","2020-12-21","12","2350","0","312","7.6","8.1"
"Jenkins","2020-12-22","9","2359","4","316","7.6","10.3"
"Jenkins","2020-12-23","6","2365","3","319","13.5","11.9"
"Jenkins","2020-12-24","8","2373","2","321","17.1","13.1"
"Jenkins","2020-12-25","3","2376","0","321","17.1","13.1"
"Jenkins","2020-12-26","6","2382","3","324","24.2","16.6"
"Jenkins","2020-12-27","2","2384","0","324","24.2","16.6"
"Jenkins","2020-12-28","15","2399","4","328","28","17.8"
"Jenkins","2020-12-29","15","2414","5","333","26.4","17"
"Jenkins","2020-12-30","24","2438","10","343","25.2","19.4"
"Jenkins","2020-12-31","8","2446","1","344","23.5","20.3"
"Jenkins","2021-01-01","1","2447","1","345","37.7","27.4"
"Jenkins","2021-01-02","3","2450","3","348","44.9","34.5"
"Jenkins","2021-01-03","0","2450","0","348","44.9","34.5"
"Jenkins","2021-01-04","16","2466","4","352","44.6","36.3"
"Jenkins","2021-01-05","30","2496","10","362","44.6","35.5"
"Jenkins","2021-01-06","20","2516","8","370","44.4","34.8"
"Jenkins","2021-01-07","21","2537","7","377","47.4","35.4"
"Jenkins","2021-01-08","17","2554","5","382","37.3","37.5"
"Jenkins","2021-01-09","7","2561","2","384","27.1","36"
"Jenkins","2021-01-10","5","2566","0","384","27.1","36"
"Jenkins","2021-01-11","19","2585","7","391","28.8","36.7"
"Jenkins","2021-01-12","27","2612","7","398","27.7","36.2"
"Jenkins","2021-01-13","24","2636","9","407","27.4","35.9"
"Jenkins","2021-01-14","21","2657","5","412","26","36.7"
"Jenkins","2021-01-15","24","2681","9","421","27.2","32.2"
"Jenkins","2021-01-16","2","2683","0","421","23.1","25.1"
"Jenkins","2021-01-17","8","2691","1","422","24.9","26"
"Jenkins","2021-01-18","18","2709","0","422","19.6","24.2"
"Jenkins","2021-01-19","18","2727","1","423","16.7","22.2"
"Jenkins","2021-01-20","21","2748","9","432","17.5","22.4"
"Jenkins","2021-01-21","16","2764","0","432","14.1","20"
"Jenkins","2021-01-22","13","2777","4","436","13.1","20.1"
"Jenkins","2021-01-23","5","2782","0","436","13.1","18.1"
"Jenkins","2021-01-24","2","2784","1","437","18.5","21.7"
"Jenkins","2021-01-25","4","2788","2","439","25.6","22.6"
"Jenkins","2021-01-26","1","2789","1","440","39.1","27.9"
"Jenkins","2021-01-27","0","2789","0","440","33","25.2"
"Johnson","2020-02-01","0","0","0","0",".","."
"Johnson","2020-02-02","0","0","0","0",".","."
"Johnson","2020-02-03","0","0","0","0",".","."
"Johnson","2020-02-04","0","0","0","0",".","."
"Johnson","2020-02-05","0","0","0","0",".","."
"Johnson","2020-02-06","0","0","0","0",".","."
"Johnson","2020-02-07","0","0","0","0","0","."
"Johnson","2020-02-08","0","0","0","0","0","."
"Johnson","2020-02-09","0","0","0","0","0","."
"Johnson","2020-02-10","0","0","0","0","0","."
"Johnson","2020-02-11","0","0","0","0","0","."
"Johnson","2020-02-12","0","0","0","0","0","."
"Johnson","2020-02-13","0","0","0","0","0","."
"Johnson","2020-02-14","0","0","0","0","0","0"
"Johnson","2020-02-15","0","0","0","0","0","0"
"Johnson","2020-02-16","0","0","0","0","0","0"
"Johnson","2020-02-17","0","0","0","0","0","0"
"Johnson","2020-02-18","0","0","0","0","0","0"
"Johnson","2020-02-19","0","0","0","0","0","0"
"Johnson","2020-02-20","0","0","0","0","0","0"
"Johnson","2020-02-21","0","0","0","0","0","0"
"Johnson","2020-02-22","0","0","0","0","0","0"
"Johnson","2020-02-23","0","0","0","0","0","0"
"Johnson","2020-02-24","0","0","0","0","0","0"
"Johnson","2020-02-25","0","0","0","0","0","0"
"Johnson","2020-02-26","0","0","0","0","0","0"
"Johnson","2020-02-27","0","0","0","0","0","0"
"Johnson","2020-02-28","0","0","0","0","0","0"
"Johnson","2020-02-29","0","0","0","0","0","0"
"Johnson","2020-03-01","0","0","0","0","0","0"
"Johnson","2020-03-02","0","0","0","0","0","0"
"Johnson","2020-03-03","0","0","0","0","0","0"
"Johnson","2020-03-04","0","0","0","0","0","0"
"Johnson","2020-03-05","0","0","0","0","0","0"
"Johnson","2020-03-06","0","0","0","0","0","0"
"Johnson","2020-03-07","0","0","0","0","0","0"
"Johnson","2020-03-08","0","0","0","0","0","0"
"Johnson","2020-03-09","0","0","0","0","0","0"
"Johnson","2020-03-10","0","0","0","0","0","0"
"Johnson","2020-03-11","0","0","0","0","0","0"
"Johnson","2020-03-12","0","0","0","0","0","0"
"Johnson","2020-03-13","0","0","0","0","0","0"
"Johnson","2020-03-14","0","0","0","0","0","0"
"Johnson","2020-03-15","0","0","0","0","0","0"
"Johnson","2020-03-16","0","0","0","0","0","0"
"Johnson","2020-03-17","1","1","0","0","0","0"
"Johnson","2020-03-18","1","2","0","0","0","0"
"Johnson","2020-03-19","1","3","0","0","0","0"
"Johnson","2020-03-20","1","4","0","0","0","0"
"Johnson","2020-03-21","0","4","0","0","0","0"
"Johnson","2020-03-22","0","4","0","0","0","0"
"Johnson","2020-03-23","1","5","0","0","0","0"
"Johnson","2020-03-24","3","8","1","1","4.8","2.4"
"Johnson","2020-03-25","3","11","0","1","4.8","2.4"
"Johnson","2020-03-26","1","12","0","1","4.8","2.4"
"Johnson","2020-03-27","1","13","0","1","4.8","2.4"
"Johnson","2020-03-28","0","13","0","1","4.8","2.4"
"Johnson","2020-03-29","0","13","0","1","4.8","2.4"
"Johnson","2020-03-30","4","17","3","4","15.5","7.7"
"Johnson","2020-03-31","0","17","0","4","10.7","7.7"
"Johnson","2020-04-01","1","18","0","4","10.7","7.7"
"Johnson","2020-04-02","0","18","0","4","10.7","7.7"
"Johnson","2020-04-03","3","21","0","4","10.7","7.7"
"Johnson","2020-04-04","0","21","0","4","10.7","7.7"
"Johnson","2020-04-05","0","21","0","4","10.7","7.7"
"Johnson","2020-04-06","2","23","1","5","7.1","11.3"
"Johnson","2020-04-07","1","24","0","5","7.1","8.9"
"Johnson","2020-04-08","8","32","7","12","19.6","15.2"
"Johnson","2020-04-09","2","34","0","12","19.6","15.2"
"Johnson","2020-04-10","1","35","0","12","19.6","15.2"
"Johnson","2020-04-11","0","35","0","12","19.6","15.2"
"Johnson","2020-04-12","4","39","3","15","30.4","20.5"
"Johnson","2020-04-13","11","50","6","21","31","19.1"
"Johnson","2020-04-14","1","51","0","21","31","19.1"
"Johnson","2020-04-15","3","54","3","24","32.8","26.2"
"Johnson","2020-04-16","7","61","7","31","47.1","33.4"
"Johnson","2020-04-17","1","62","0","31","47.1","33.4"
"Johnson","2020-04-18","1","63","1","32","61.4","40.5"
"Johnson","2020-04-19","1","64","0","32","50.6","40.5"
"Johnson","2020-04-20","2","66","1","33","50","40.5"
"Johnson","2020-04-21","5","71","2","35","55.7","43.4"
"Johnson","2020-04-22","4","75","0","35","41.4","37.1"
"Johnson","2020-04-23","2","77","0","35","27.1","37.1"
"Johnson","2020-04-24","9","86","0","35","27.1","37.1"
"Johnson","2020-04-25","2","88","0","35","12.9","37.1"
"Johnson","2020-04-26","1","89","0","35","12.9","31.8"
"Johnson","2020-04-27","15","104","9","44","14.3","32.1"
"Johnson","2020-04-28","12","116","5","49","14.5","35.1"
"Johnson","2020-04-29","11","127","4","53","19.7","30.6"
"Johnson","2020-04-30","12","139","2","55","22.1","24.6"
"Johnson","2020-05-01","2","141","1","56","29.2","28.2"
"Johnson","2020-05-02","2","143","1","57","36.4","24.6"
"Johnson","2020-05-03","31","174","0","57","36.4","24.6"
"Johnson","2020-05-04","14","188","0","57","27.8","21"
"Johnson","2020-05-05","7","195","1","58","23.9","19.2"
"Johnson","2020-05-06","8","203","1","59","20.5","20.1"
"Johnson","2020-05-07","3","206","2","61","27.6","24.9"
"Johnson","2020-05-08","4","210","0","61","20.5","24.9"
"Johnson","2020-05-09","2","212","0","61","13.4","24.9"
"Johnson","2020-05-10","1","213","0","61","13.4","24.9"
"Johnson","2020-05-11","9","222","3","64","18.1","23"
"Johnson","2020-05-12","3","225","0","64","16.1","20"
"Johnson","2020-05-13","6","231","2","66","19","19.8"
"Johnson","2020-05-14","8","239","2","68","13.1","20.4"
"Johnson","2020-05-15","1","240","0","68","13.1","16.8"
"Johnson","2020-05-16","24","264","8","76","17.9","15.6"
"Johnson","2020-05-17","8","272","8","84","32.1","22.7"
"Johnson","2020-05-18","4","276","0","84","27.4","22.7"
"Johnson","2020-05-19","9","285","0","84","27.4","21.7"
"Johnson","2020-05-20","6","291","0","84","22.6","20.8"
"Johnson","2020-05-21","3","294","0","84","19","16.1"
"Johnson","2020-05-22","3","297","0","84","19","16.1"
"Johnson","2020-05-23","2","299","0","84","14.3","16.1"
"Johnson","2020-05-24","3","302","0","84","0","16.1"
"Johnson","2020-05-25","4","306","1","85","3.6","15.5"
"Johnson","2020-05-26","3","309","0","85","3.6","15.5"
"Johnson","2020-05-27","7","316","0","85","3.6","13.1"
"Johnson","2020-05-28","11","327","0","85","3.6","11.3"
"Johnson","2020-05-29","1","328","0","85","3.6","11.3"
"Johnson","2020-05-30","3","331","1","86","8.3","11.3"
"Johnson","2020-05-31","0","331","0","86","8.3","4.2"
"Johnson","2020-06-01","8","339","0","86","4.8","4.2"
"Johnson","2020-06-02","5","344","0","86","4.8","4.2"
"Johnson","2020-06-03","15","359","0","86","4.8","4.2"
"Johnson","2020-06-04","28","387","0","86","4.8","4.2"
"Johnson","2020-06-05","5","392","1","87","7.6","5.6"
"Johnson","2020-06-06","0","392","0","87","2.9","5.6"
"Johnson","2020-06-07","2","394","0","87","2.9","5.6"
"Johnson","2020-06-08","2","396","0","87","2.9","3.8"
"Johnson","2020-06-09","0","396","0","87","2.9","3.8"
"Johnson","2020-06-10","10","406","0","87","2.9","3.8"
"Johnson","2020-06-11","27","433","0","87","2.9","3.8"
"Johnson","2020-06-12","12","445","1","88","1.2","4.4"
"Johnson","2020-06-13","1","446","0","88","1.2","2"
"Johnson","2020-06-14","2","448","1","89","8.3","5.6"
"Johnson","2020-06-15","2","450","0","89","8.3","5.6"
"Johnson","2020-06-16","4","454","0","89","8.3","5.6"
"Johnson","2020-06-17","4","458","0","89","8.3","5.6"
"Johnson","2020-06-18","1","459","0","89","8.3","5.6"
"Johnson","2020-06-19","2","461","0","89","7.1","4.2"
"Johnson","2020-06-20","1","462","0","89","7.1","4.2"
"Johnson","2020-06-21","0","462","0","89","0","4.2"
"Johnson","2020-06-22","3","465","0","89","0","4.2"
"Johnson","2020-06-23","0","465","0","89","0","4.2"
"Johnson","2020-06-24","9","474","0","89","0","4.2"
"Johnson","2020-06-25","4","478","1","90","3.6","6"
"Johnson","2020-06-26","5","483","0","90","3.6","5.4"
"Johnson","2020-06-27","3","486","1","91","8.3","7.7"
"Johnson","2020-06-28","0","486","0","91","8.3","4.2"
"Johnson","2020-06-29","2","488","0","91","8.3","4.2"
"Johnson","2020-06-30","5","493","1","92","11.2","5.6"
"Johnson","2020-07-01","3","496","1","93","16","8"
"Johnson","2020-07-02","6","502","1","94","14.8","9.2"
"Johnson","2020-07-03","2","504","1","95","21.9","12.7"
"Johnson","2020-07-04","0","504","0","95","17.1","12.7"
"Johnson","2020-07-05","6","510","2","97","21.9","15.1"
"Johnson","2020-07-06","9","519","1","98","23.5","15.9"
"Johnson","2020-07-07","12","531","4","102","25.4","18.3"
"Johnson","2020-07-08","5","536","0","102","20.6","18.3"
"Johnson","2020-07-09","6","542","1","103","20.6","17.7"
"Johnson","2020-07-10","5","547","2","105","19.2","20.6"
"Johnson","2020-07-11","3","550","2","107","28.7","22.9"
"Johnson","2020-07-12","1","551","0","107","24","22.9"
"Johnson","2020-07-13","6","557","0","107","22.4","22.9"
"Johnson","2020-07-14","9","566","1","108","19.2","22.3"
"Johnson","2020-07-15","7","573","0","108","19.2","19.9"
"Johnson","2020-07-16","4","577","1","109","20.4","20.5"
"Johnson","2020-07-17","2","579","0","109","14.7","16.9"
"Johnson","2020-07-18","1","580","1","110","19.4","24.1"
"Johnson","2020-07-19","2","582","0","110","19.4","21.7"
"Johnson","2020-07-20","1","583","0","110","19.4","20.9"
"Johnson","2020-07-21","7","590","2","112","21.9","20.6"
"Johnson","2020-07-22","4","594","0","112","21.9","20.6"
"Johnson","2020-07-23","3","597","0","112","18.4","19.4"
"Johnson","2020-07-24","6","603","3","115","25.5","20.1"
"Johnson","2020-07-25","6","609","2","117","16","17.7"
"Johnson","2020-07-26","1","610","1","118","30.3","24.9"
"Johnson","2020-07-27","4","614","1","119","33.8","26.6"
"Johnson","2020-07-28","2","616","1","120","36.9","29.4"
"Johnson","2020-07-29","3","619","0","120","36.9","29.4"
"Johnson","2020-07-30","3","622","1","121","41.7","30"
"Johnson","2020-07-31","6","628","2","123","39.3","32.4"
"Johnson","2020-08-01","4","632","4","127","48.8","32.4"
"Johnson","2020-08-02","3","635","1","128","39.3","34.8"
"Johnson","2020-08-03","3","638","0","128","35.7","34.8"
"Johnson","2020-08-04","5","643","0","128","28.6","32.7"
"Johnson","2020-08-05","9","652","3","131","33.3","35.1"
"Johnson","2020-08-06","4","656","1","132","32.1","36.9"
"Johnson","2020-08-07","6","662","1","133","29.8","34.5"
"Johnson","2020-08-08","6","668","2","135","20.2","34.5"
"Johnson","2020-08-09","1","669","0","135","15.5","27.4"
"Johnson","2020-08-10","5","674","0","135","15.5","25.6"
"Johnson","2020-08-11","9","683","2","137","18.7","23.6"
"Johnson","2020-08-12","4","687","0","137","13.9","23.6"
"Johnson","2020-08-13","3","690","0","137","10.3","21.2"
"Johnson","2020-08-14","12","702","1","138","9.1","19.4"
"Johnson","2020-08-15","8","710","2","140","7.9","14.1"
"Johnson","2020-08-16","2","712","1","141","15.1","15.3"
"Johnson","2020-08-17","4","716","0","141","15.1","15.3"
"Johnson","2020-08-18","3","719","3","144","26.2","22.4"
"Johnson","2020-08-19","6","725","1","145","28.6","21.2"
"Johnson","2020-08-20","5","730","1","146","31.4","20.9"
"Johnson","2020-08-21","10","740","2","148","33.1","21.1"
"Johnson","2020-08-22","7","747","2","150","33.6","20.8"
"Johnson","2020-08-23","3","750","2","152","36","25.5"
"Johnson","2020-08-24","10","760","0","152","36","25.5"
"Johnson","2020-08-25","9","769","2","154","24.9","25.5"
"Johnson","2020-08-26","9","778","0","154","22.5","25.5"
"Johnson","2020-08-27","6","784","2","156","24.4","27.9"
"Johnson","2020-08-28","35","819","19","175","29.3","31.2"
"Johnson","2020-08-29","5","824","2","177","30.9","32.3"
"Johnson","2020-08-30","2","826","1","178","28.5","32.3"
"Johnson","2020-08-31","6","832","1","179","30.9","33.5"
"Johnson","2020-09-01","5","837","4","183","39.2","32"
"Johnson","2020-09-02","6","843","1","184","41.6","32"
"Johnson","2020-09-03","4","847","1","185","40.4","32.4"
"Johnson","2020-09-04","23","870","11","196","39.5","34.4"
"Johnson","2020-09-05","7","877","2","198","37.8","34.4"
"Johnson","2020-09-06","2","879","0","198","30.7","29.6"
"Johnson","2020-09-07","3","882","2","200","37.8","34.4"
"Johnson","2020-09-08","18","900","3","203","28.8","34"
"Johnson","2020-09-09","3","903","0","203","26.4","34"
"Johnson","2020-09-10","6","909","0","203","22.8","31.6"
"Johnson","2020-09-11","11","920","6","209","23.8","31.6"
"Johnson","2020-09-12","3","923","1","210","24.5","31.1"
"Johnson","2020-09-13","0","923","0","210","24.5","27.6"
"Johnson","2020-09-14","6","929","0","210","14.9","26.4"
"Johnson","2020-09-15","9","938","0","210","12.6","20.7"
"Johnson","2020-09-16","3","941","1","211","17.3","21.9"
"Johnson","2020-09-17","14","955","2","213","19.4","21.1"
"Johnson","2020-09-18","3","958","1","214","16.3","20.1"
"Johnson","2020-09-19","3","961","0","214","11.6","18"
"Johnson","2020-09-20","0","961","0","214","11.6","18"
"Johnson","2020-09-21","10","971","1","215","13","14"
"Johnson","2020-09-22","15","986","2","217","14.9","13.7"
"Johnson","2020-09-23","1","987","0","217","10.1","13.7"
"Johnson","2020-09-24","10","997","5","222","15.2","17.3"
"Johnson","2020-09-25","4","1001","1","223","14","15.2"
"Johnson","2020-09-26","2","1003","0","223","14","12.8"
"Johnson","2020-09-27","1","1004","0","223","14","12.8"
"Johnson","2020-09-28","13","1017","2","225","14.8","13.9"
"Johnson","2020-09-29","6","1023","1","226","15.3","15.1"
"Johnson","2020-09-30","4","1027","0","226","15.3","12.7"
"Johnson","2020-10-01","4","1031","0","226","8.2","11.7"
"Johnson","2020-10-02","11","1042","0","226","4.6","9.3"
"Johnson","2020-10-03","8","1050","0","226","4.6","9.3"
"Johnson","2020-10-04","4","1054","1","227","8.2","11.1"
"Johnson","2020-10-05","6","1060","0","227","6","10.4"
"Johnson","2020-10-06","24","1084","1","228","4.2","9.7"
"Johnson","2020-10-07","4","1088","0","228","4.2","9.7"
"Johnson","2020-10-08","10","1098","2","230","7","7.6"
"Johnson","2020-10-09","8","1106","0","230","7","5.8"
"Johnson","2020-10-10","2","1108","0","230","7","5.8"
"Johnson","2020-10-11","0","1108","0","230","3.5","5.8"
"Johnson","2020-10-12","6","1114","0","230","3.5","4.7"
"Johnson","2020-10-13","5","1119","2","232","8.6","6.4"
"Johnson","2020-10-14","2","1121","0","232","8.6","6.4"
"Johnson","2020-10-15","5","1126","1","233","8.6","7.8"
"Johnson","2020-10-16","1","1127","0","233","8.6","7.8"
"Johnson","2020-10-17","4","1131","1","234","12.1","9.6"
"Johnson","2020-10-18","2","1133","1","235","19.3","11.4"
"Johnson","2020-10-19","7","1140","0","235","19.3","11.4"
"Johnson","2020-10-20","19","1159","0","235","13.6","11.1"
"Johnson","2020-10-21","3","1162","0","235","13.6","11.1"
"Johnson","2020-10-22","13","1175","1","236","11.8","10.2"
"Johnson","2020-10-23","1","1176","1","237","26.1","17.3"
"Johnson","2020-10-24","0","1176","0","237","22.5","17.3"
"Johnson","2020-10-25","3","1179","1","238","20.1","19.7"
"Johnson","2020-10-26","12","1191","0","238","20.1","19.7"
"Johnson","2020-10-27","7","1198","0","238","20.1","16.9"
"Johnson","2020-10-28","9","1207","0","238","20.1","16.9"
"Johnson","2020-10-29","4","1211","0","238","19","15.4"
"Johnson","2020-10-30","3","1214","0","238","4.8","15.4"
"Johnson","2020-10-31","2","1216","0","238","4.8","13.6"
"Johnson","2020-11-01","0","1216","0","238","0","10.1"
"Johnson","2020-11-02","9","1225","1","239","1.6","10.9"
"Johnson","2020-11-03","6","1231","1","240","4","12.1"
"Johnson","2020-11-04","7","1238","2","242","8","14.1"
"Johnson","2020-11-05","200","1438","0","242","8","13.5"
"Johnson","2020-11-06","17","1455","2","244","9.7","7.2"
"Johnson","2020-11-07","4","1459","1","245","13.3","9"
"Johnson","2020-11-08","2","1461","0","245","13.3","6.7"
"Johnson","2020-11-09","4","1465","0","245","11.7","6.7"
"Johnson","2020-11-10","75","1540","0","245","9.3","6.7"
"Johnson","2020-11-11","3","1543","0","245","5.3","6.7"
"Johnson","2020-11-12","6","1549","0","245","5.3","6.7"
"Johnson","2020-11-13","3","1552","1","246","8.3","9"
"Johnson","2020-11-14","2","1554","0","246","4.8","9"
"Johnson","2020-11-15","2","1556","1","247","11.9","12.6"
"Johnson","2020-11-16","30","1586","0","247","11.9","11.8"
"Johnson","2020-11-17","6","1592","1","248","14.3","11.8"
"Johnson","2020-11-18","7","1599","1","249","16.3","10.8"
"Johnson","2020-11-19","4","1603","0","249","16.3","10.8"
"Johnson","2020-11-20","7","1610","2","251","15.6","12"
"Johnson","2020-11-21","2","1612","0","251","15.6","10.2"
"Johnson","2020-11-22","2","1614","0","251","8.5","10.2"
"Johnson","2020-11-23","6","1620","0","251","8.5","10.2"
"Johnson","2020-11-24","15","1635","1","252","7.1","10.7"
"Johnson","2020-11-25","3","1638","0","252","5","10.7"
"Johnson","2020-11-26","2","1640","1","253","12.2","14.3"
"Johnson","2020-11-27","5","1645","0","253","8.1","11.9"
"Johnson","2020-11-28","3","1648","0","253","8.1","11.9"
"Johnson","2020-11-29","1","1649","0","253","8.1","8.3"
"Johnson","2020-11-30","4","1653","0","253","8.1","8.3"
"Johnson","2020-12-01","11","1664","1","254","8.4","7.8"
"Johnson","2020-12-02","9","1673","1","255","10","7.5"
"Johnson","2020-12-03","8","1681","1","256","4.7","8.4"
"Johnson","2020-12-04","10","1691","2","258","7.5","7.8"
"Johnson","2020-12-05","6","1697","0","258","7.5","7.8"
"Johnson","2020-12-06","3","1700","0","258","7.5","7.8"
"Johnson","2020-12-07","11","1711","2","260","10.1","9.1"
"Johnson","2020-12-08","5","1716","0","260","8.8","8.6"
"Johnson","2020-12-09","5","1721","1","261","10.1","10.1"
"Johnson","2020-12-10","2","1723","0","261","8.3","6.5"
"Johnson","2020-12-11","9","1732","2","263","8.6","8.1"
"Johnson","2020-12-12","2","1734","2","265","22.9","15.2"
"Johnson","2020-12-13","3","1737","0","265","22.9","15.2"
"Johnson","2020-12-14","71","1808","2","267","20.7","15.4"
"Johnson","2020-12-15","32","1840","10","277","25.2","17"
"Johnson","2020-12-16","7","1847","0","277","22.3","16.2"
"Johnson","2020-12-17","11","1858","2","279","24.9","16.6"
"Johnson","2020-12-18","5","1863","2","281","27.5","18"
"Johnson","2020-12-19","4","1867","0","281","13.2","18"
"Johnson","2020-12-20","2","1869","2","283","27.5","25.2"
"Johnson","2020-12-21","65","1934","4","287","27.9","24.3"
"Johnson","2020-12-22","45","1979","8","295","26","25.6"
"Johnson","2020-12-23","6","1985","2","297","30.8","26.6"
"Johnson","2020-12-24","8","1993","1","298","30","27.4"
"Johnson","2020-12-25","2","1995","1","299","31.4","29.4"
"Johnson","2020-12-26","9","2004","3","302","36.2","24.7"
"Johnson","2020-12-27","0","2004","0","302","21.9","24.7"
"Johnson","2020-12-28","8","2012","2","304","24.6","26.3"
"Johnson","2020-12-29","29","2041","9","313","26.5","26.2"
"Johnson","2020-12-30","12","2053","4","317","26.5","28.6"
"Johnson","2020-12-31","13","2066","2","319","26.9","28.4"
"Johnson","2021-01-01","1","2067","0","319","19.7","25.6"
"Johnson","2021-01-02","3","2070","1","320","19.7","27.9"
"Johnson","2021-01-03","5","2075","3","323","28.3","25.1"
"Johnson","2021-01-04","192","2267","51","374","28.5","26.5"
"Johnson","2021-01-05","32","2299","7","381","27.2","26.8"
"Johnson","2021-01-06","74","2373","2","383","22.8","24.6"
"Johnson","2021-01-07","77","2450","0","383","20.6","23.8"
"Johnson","2021-01-08","10","2460","0","383","20.6","20.2"
"Johnson","2021-01-09","9","2469","3","386","20.6","20.2"
"Johnson","2021-01-10","2","2471","0","386","12.1","20.2"
"Johnson","2021-01-11","98","2569","13","399","10.2","19.3"
"Johnson","2021-01-12","39","2608","7","406","9.6","18.4"
"Johnson","2021-01-13","15","2623","3","409","12.1","17.5"
"Johnson","2021-01-14","178","2801","2","411","12.2","16.4"
"Johnson","2021-01-15","7","2808","0","411","12.2","16.4"
"Johnson","2021-01-16","5","2813","0","411","7.5","14.1"
"Johnson","2021-01-17","0","2813","0","411","7.5","9.8"
"Johnson","2021-01-18","5","2818","0","411","5.6","7.9"
"Johnson","2021-01-19","23","2841","10","421","9.2","9.4"
"Johnson","2021-01-20","8","2849","3","424","11.7","11.9"
"Johnson","2021-01-21","14","2863","2","426","13.6","12.9"
"Johnson","2021-01-22","5","2868","0","426","13.6","12.9"
"Johnson","2021-01-23","4","2872","1","427","17.2","12.3"
"Johnson","2021-01-24","3","2875","0","427","17.2","12.3"
"Johnson","2021-01-25","4","2879","1","428","20.8","13.2"
"Johnson","2021-01-26","1","2880","0","428","14.5","11.9"
"Johnson","2021-01-27","0","2880","0","428","9.2","10.5"
"Jones","2020-02-01","0","0","0","0",".","."
"Jones","2020-02-02","0","0","0","0",".","."
"Jones","2020-02-03","0","0","0","0",".","."
"Jones","2020-02-04","0","0","0","0",".","."
"Jones","2020-02-05","0","0","0","0",".","."
"Jones","2020-02-06","0","0","0","0",".","."
"Jones","2020-02-07","0","0","0","0","0","."
"Jones","2020-02-08","0","0","0","0","0","."
"Jones","2020-02-09","0","0","0","0","0","."
"Jones","2020-02-10","0","0","0","0","0","."
"Jones","2020-02-11","0","0","0","0","0","."
"Jones","2020-02-12","0","0","0","0","0","."
"Jones","2020-02-13","0","0","0","0","0","."
"Jones","2020-02-14","0","0","0","0","0","0"
"Jones","2020-02-15","0","0","0","0","0","0"
"Jones","2020-02-16","0","0","0","0","0","0"
"Jones","2020-02-17","0","0","0","0","0","0"
"Jones","2020-02-18","0","0","0","0","0","0"
"Jones","2020-02-19","0","0","0","0","0","0"
"Jones","2020-02-20","0","0","0","0","0","0"
"Jones","2020-02-21","0","0","0","0","0","0"
"Jones","2020-02-22","0","0","0","0","0","0"
"Jones","2020-02-23","0","0","0","0","0","0"
"Jones","2020-02-24","0","0","0","0","0","0"
"Jones","2020-02-25","0","0","0","0","0","0"
"Jones","2020-02-26","0","0","0","0","0","0"
"Jones","2020-02-27","0","0","0","0","0","0"
"Jones","2020-02-28","0","0","0","0","0","0"
"Jones","2020-02-29","0","0","0","0","0","0"
"Jones","2020-03-01","0","0","0","0","0","0"
"Jones","2020-03-02","0","0","0","0","0","0"
"Jones","2020-03-03","0","0","0","0","0","0"
"Jones","2020-03-04","0","0","0","0","0","0"
"Jones","2020-03-05","0","0","0","0","0","0"
"Jones","2020-03-06","0","0","0","0","0","0"
"Jones","2020-03-07","0","0","0","0","0","0"
"Jones","2020-03-08","0","0","0","0","0","0"
"Jones","2020-03-09","0","0","0","0","0","0"
"Jones","2020-03-10","0","0","0","0","0","0"
"Jones","2020-03-11","0","0","0","0","0","0"
"Jones","2020-03-12","0","0","0","0","0","0"
"Jones","2020-03-13","1","1","0","0","0","0"
"Jones","2020-03-14","0","1","0","0","0","0"
"Jones","2020-03-15","0","1","0","0","0","0"
"Jones","2020-03-16","3","4","0","0","0","0"
"Jones","2020-03-17","5","9","0","0","0","0"
"Jones","2020-03-18","5","14","0","0","0","0"
"Jones","2020-03-19","1","15","0","0","0","0"
"Jones","2020-03-20","1","16","0","0","0","0"
"Jones","2020-03-21","2","18","0","0","0","0"
"Jones","2020-03-22","5","23","0","0","0","0"
"Jones","2020-03-23","7","30","2","2","4.1","2"
"Jones","2020-03-24","6","36","0","2","4.1","2"
"Jones","2020-03-25","19","55","3","5","6.3","3.2"
"Jones","2020-03-26","9","64","0","5","6.3","3.2"
"Jones","2020-03-27","10","74","1","6","7.8","3.9"
"Jones","2020-03-28","1","75","0","6","7.8","3.9"
"Jones","2020-03-29","3","78","0","6","7.8","3.9"
"Jones","2020-03-30","4","82","0","6","3.7","3.9"
"Jones","2020-03-31","10","92","3","9","8","6"
"Jones","2020-04-01","10","102","0","9","5.7","6"
"Jones","2020-04-02","11","113","1","10","7","6.7"
"Jones","2020-04-03","9","122","3","13","10.3","9.1"
"Jones","2020-04-04","5","127","2","15","16.1","11.9"
"Jones","2020-04-05","5","132","0","15","16.1","11.9"
"Jones","2020-04-06","6","138","2","17","20.8","12.3"
"Jones","2020-04-07","5","143","2","19","22.3","15.1"
"Jones","2020-04-08","6","149","0","19","22.3","14"
"Jones","2020-04-09","9","158","4","23","27.3","17.2"
"Jones","2020-04-10","6","164","1","24","24.9","17.6"
"Jones","2020-04-11","1","165","1","25","33.5","24.8"
"Jones","2020-04-12","3","168","0","25","33.5","24.8"
"Jones","2020-04-13","23","191","0","25","28.7","24.8"
"Jones","2020-04-14","13","204","0","25","23","22.6"
"Jones","2020-04-15","27","231","6","31","26.2","24.2"
"Jones","2020-04-16","27","258","1","32","20.4","23.8"
"Jones","2020-04-17","13","271","1","33","19.1","22"
"Jones","2020-04-18","3","274","0","33","4.8","19.1"
"Jones","2020-04-19","5","279","0","33","4.8","19.1"
"Jones","2020-04-20","20","299","4","37","7.7","18.2"
"Jones","2020-04-21","28","327","4","41","9.7","16.4"
"Jones","2020-04-22","18","345","1","42","7.3","16.8"
"Jones","2020-04-23","5","350","2","44","12.5","16.4"
"Jones","2020-04-24","35","385","5","49","13.4","16.3"
"Jones","2020-04-25","3","388","0","49","13.4","9.1"
"Jones","2020-04-26","6","394","0","49","13.4","9.1"
"Jones","2020-04-27","17","411","8","57","17.3","12.5"
"Jones","2020-04-28","14","425","0","57","15.3","12.5"
"Jones","2020-04-29","11","436","0","57","14.5","10.9"
"Jones","2020-04-30","12","448","0","57","8.8","10.6"
"Jones","2020-05-01","19","467","1","58","7.5","10.5"
"Jones","2020-05-02","11","478","1","59","8.8","11.1"
"Jones","2020-05-03","5","483","0","59","8.8","11.1"
"Jones","2020-05-04","8","491","1","60","3.8","10.6"
"Jones","2020-05-05","15","506","1","61","4.8","10"
"Jones","2020-05-06","18","524","2","63","6.4","10.4"
"Jones","2020-05-07","14","538","0","63","6.4","7.6"
"Jones","2020-05-08","18","556","0","63","5.6","6.5"
"Jones","2020-05-09","3","559","0","63","4.3","6.5"
"Jones","2020-05-10","7","566","1","64","6.4","7.6"
"Jones","2020-05-11","20","586","1","65","5.3","4.6"
"Jones","2020-05-12","11","597","0","65","4.3","4.6"
"Jones","2020-05-13","45","642","0","65","2.8","4.6"
"Jones","2020-05-14","40","682","4","69","4.2","5.3"
"Jones","2020-05-15","34","716","1","70","4.6","5.1"
"Jones","2020-05-16","0","716","0","70","4.6","4.5"
"Jones","2020-05-17","4","720","0","70","2.6","4.5"
"Jones","2020-05-18","34","754","3","73","3.1","4.2"
"Jones","2020-05-19","25","779","2","75","4.3","4.3"
"Jones","2020-05-20","14","793","0","75","4.3","3.5"
"Jones","2020-05-21","16","809","2","77","4.6","4.4"
"Jones","2020-05-22","24","833","0","77","4.2","4.4"
"Jones","2020-05-23","7","840","0","77","4.2","4.4"
"Jones","2020-05-24","6","846","0","77","4.2","3.4"
"Jones","2020-05-25","6","852","1","78","5.3","4.2"
"Jones","2020-05-26","19","871","0","78","4.2","4.2"
"Jones","2020-05-27","72","943","2","80","4.6","4.4"
"Jones","2020-05-28","47","990","2","82","3.4","4"
"Jones","2020-05-29","81","1071","6","88","4.4","4.3"
"Jones","2020-05-30","3","1074","0","88","4.4","4.3"
"Jones","2020-05-31","9","1083","1","89","6","5.1"
"Jones","2020-06-01","51","1134","7","96","5.6","5.5"
"Jones","2020-06-02","18","1152","4","100","8.8","6.5"
"Jones","2020-06-03","92","1244","5","105","9.2","6.9"
"Jones","2020-06-04","31","1275","1","106","9","6.2"
"Jones","2020-06-05","31","1306","0","106","8","6.2"
"Jones","2020-06-06","9","1315","3","109","12.7","8.6"
"Jones","2020-06-07","3","1318","0","109","11.1","8.6"
"Jones","2020-06-08","26","1344","1","110","9.7","7.7"
"Jones","2020-06-09","20","1364","2","112","8","8.4"
"Jones","2020-06-10","17","1381","0","112","7.2","8.2"
"Jones","2020-06-11","19","1400","2","114","8.2","8.6"
"Jones","2020-06-12","32","1432","0","114","8.2","8.1"
"Jones","2020-06-13","9","1441","2","116","6.7","9.7"
"Jones","2020-06-14","2","1443","1","117","13.8","12.5"
"Jones","2020-06-15","26","1469","0","117","13.2","11.5"
"Jones","2020-06-16","16","1485","1","118","12.7","10.3"
"Jones","2020-06-17","38","1523","3","121","13.8","10.5"
"Jones","2020-06-18","20","1543","1","122","13.1","10.6"
"Jones","2020-06-19","25","1568","0","122","13.1","10.6"
"Jones","2020-06-20","3","1571","1","123","14.6","10.6"
"Jones","2020-06-21","5","1576","1","124","10.4","12.1"
"Jones","2020-06-22","45","1621","9","133","13.2","13.2"
"Jones","2020-06-23","30","1651","2","135","13.3","13"
"Jones","2020-06-24","69","1720","17","152","15.7","14.8"
"Jones","2020-06-25","46","1766","3","155","15.9","14.5"
"Jones","2020-06-26","55","1821","14","169","19.5","16.3"
"Jones","2020-06-27","13","1834","6","175","21.3","18"
"Jones","2020-06-28","9","1843","3","178","23.3","16.8"
"Jones","2020-06-29","81","1924","21","199","24.1","18.7"
"Jones","2020-06-30","42","1966","4","203","24.5","18.9"
"Jones","2020-07-01","134","2100","15","218","22.6","19.1"
"Jones","2020-07-02","79","2179","9","227","23.3","19.6"
"Jones","2020-07-03","22","2201","3","230","21.6","20.6"
"Jones","2020-07-04","9","2210","2","232","18.2","19.8"
"Jones","2020-07-05","24","2234","9","241","18.8","21"
"Jones","2020-07-06","106","2340","12","253","16.7","20.4"
"Jones","2020-07-07","66","2406","18","271","19.2","21.9"
"Jones","2020-07-08","95","2501","13","284","19.6","21.1"
"Jones","2020-07-09","90","2591","25","309","21.9","22.6"
"Jones","2020-07-10","104","2695","11","320","21.5","21.5"
"Jones","2020-07-11","21","2716","5","325","21.7","19.9"
"Jones","2020-07-12","24","2740","9","334","21.7","20.2"
"Jones","2020-07-13","136","2876","36","370","23.9","20.3"
"Jones","2020-07-14","50","2926","7","377","22","20.6"
"Jones","2020-07-15","102","3028","10","387","21.4","20.5"
"Jones","2020-07-16","82","3110","28","415","22.3","22.1"
"Jones","2020-07-17","95","3205","21","436","24","22.7"
"Jones","2020-07-18","25","3230","7","443","24.6","23.1"
"Jones","2020-07-19","29","3259","5","448","21.7","21.7"
"Jones","2020-07-20","92","3351","10","458","19.5","21.7"
"Jones","2020-07-21","41","3392","11","469","21.3","21.6"
"Jones","2020-07-22","84","3476","11","480","21.8","21.6"
"Jones","2020-07-23","43","3519","6","486","18.9","20.6"
"Jones","2020-07-24","81","3600","11","497","17.7","20.8"
"Jones","2020-07-25","39","3639","7","504","16.2","20.4"
"Jones","2020-07-26","19","3658","11","515","22","21.9"
"Jones","2020-07-27","69","3727","14","529","23.4","21.4"
"Jones","2020-07-28","64","3791","12","541","22.2","21.8"
"Jones","2020-07-29","105","3896","17","558","22.7","22.2"
"Jones","2020-07-30","77","3973","17","575","23.8","21.3"
"Jones","2020-07-31","94","4067","20","595","24.9","21.3"
"Jones","2020-08-01","29","4096","5","600","24.8","20.5"
"Jones","2020-08-02","21","4117","5","605","19.9","21"
"Jones","2020-08-03","88","4205","7","612","18.2","20.8"
"Jones","2020-08-04","48","4253","12","624","19.1","20.6"
"Jones","2020-08-05","44","4297","6","630","18.7","20.7"
"Jones","2020-08-06","55","4352","11","641","18.4","21.1"
"Jones","2020-08-07","129","4481","16","657","17.1","21"
"Jones","2020-08-08","12","4493","5","662","20.6","22.7"
"Jones","2020-08-09","26","4519","2","664","18.3","19.1"
"Jones","2020-08-10","78","4597","14","678","19.8","19"
"Jones","2020-08-11","38","4635","5","683","18.1","18.6"
"Jones","2020-08-12","67","4702","8","691","17.8","18.3"
"Jones","2020-08-13","50","4752","6","697","16.7","17.6"
"Jones","2020-08-14","60","4812","8","705","16.8","17"
"Jones","2020-08-15","19","4831","5","710","14.6","17.6"
"Jones","2020-08-16","21","4852","3","713","15.6","17"
"Jones","2020-08-17","36","4888","2","715","13.8","16.8"
"Jones","2020-08-18","41","4929","4","719","13.3","15.7"
"Jones","2020-08-19","50","4979","3","722","12.5","15.1"
"Jones","2020-08-20","42","5021","8","730","13.5","15.1"
"Jones","2020-08-21","78","5099","14","744","14.1","15.5"
"Jones","2020-08-22","15","5114","4","748","14.2","14.4"
"Jones","2020-08-23","23","5137","3","751","14","14.8"
"Jones","2020-08-24","66","5203","5","756","14.3","14"
"Jones","2020-08-25","33","5236","7","763","15.9","14.6"
"Jones","2020-08-26","71","5307","11","774","17.3","14.9"
"Jones","2020-08-27","52","5359","6","780","16.2","14.8"
"Jones","2020-08-28","67","5426","5","785","14.7","14.4"
"Jones","2020-08-29","18","5444","2","787","12.5","13.3"
"Jones","2020-08-30","17","5461","2","789","12.3","13.2"
"Jones","2020-08-31","59","5520","7","796","12.9","13.6"
"Jones","2020-09-01","40","5560","6","802","12","14"
"Jones","2020-09-02","55","5615","5","807","11.1","14.2"
"Jones","2020-09-03","34","5649","5","812","11.6","13.9"
"Jones","2020-09-04","47","5696","6","818","12.3","13.5"
"Jones","2020-09-05","17","5713","6","824","15.8","14.1"
"Jones","2020-09-06","14","5727","2","826","16.1","14.2"
"Jones","2020-09-07","14","5741","3","829","17.5","15.2"
"Jones","2020-09-08","44","5785","2","831","16","14"
"Jones","2020-09-09","67","5852","6","837","16","13.6"
"Jones","2020-09-10","29","5881","6","843","16.9","14.2"
"Jones","2020-09-11","65","5946","0","843","15","13.7"
"Jones","2020-09-12","7","5953","0","843","10","12.9"
"Jones","2020-09-13","20","5973","0","843","7.9","12"
"Jones","2020-09-14","42","6015","2","845","5.6","11.5"
"Jones","2020-09-15","36","6051","2","847","5.7","10.9"
"Jones","2020-09-16","112","6163","9","856","5.6","10.8"
"Jones","2020-09-17","71","6234","2","858","3","9.9"
"Jones","2020-09-18","67","6301","2","860","3.5","9.2"
"Jones","2020-09-19","24","6325","3","863","5.2","7.6"
"Jones","2020-09-20","13","6338","0","863","5.2","6.6"
"Jones","2020-09-21","48","6386","6","869","6.3","6"
"Jones","2020-09-22","36","6422","5","874","7.5","6.6"
"Jones","2020-09-23","37","6459","3","877","7.5","6.6"
"Jones","2020-09-24","37","6496","4","881","8.7","5.9"
"Jones","2020-09-25","49","6545","4","885","9.4","6.4"
"Jones","2020-09-26","18","6563","1","886","8.4","6.8"
"Jones","2020-09-27","14","6577","6","892","14.6","9.9"
"Jones","2020-09-28","50","6627","7","899","14.8","10.6"
"Jones","2020-09-29","26","6653","0","899","12.8","10.2"
"Jones","2020-09-30","31","6684","5","904","13.9","10.7"
"Jones","2020-10-01","104","6788","3","907","12.8","10.7"
"Jones","2020-10-02","79","6867","6","913","12.7","11.1"
"Jones","2020-10-03","16","6883","3","916","14.6","11.5"
"Jones","2020-10-04","10","6893","0","916","8.5","11.5"
"Jones","2020-10-05","36","6929","2","918","7.3","11"
"Jones","2020-10-06","54","6983","1","919","7.5","10.2"
"Jones","2020-10-07","78","7061","4","923","6","9.9"
"Jones","2020-10-08","72","7133","1","924","5.8","9.3"
"Jones","2020-10-09","135","7268","7","931","5.4","9.1"
"Jones","2020-10-10","13","7281","3","934","6","10.3"
"Jones","2020-10-11","13","7294","3","937","9.3","8.9"
"Jones","2020-10-12","51","7345","6","943","10.2","8.7"
"Jones","2020-10-13","31","7376","2","945","10.9","9.2"
"Jones","2020-10-14","33","7409","3","948","11.4","8.7"
"Jones","2020-10-15","142","7551","4","952","11.6","8.7"
"Jones","2020-10-16","41","7592","1","953","11.2","8.3"
"Jones","2020-10-17","11","7603","0","953","7.9","7"
"Jones","2020-10-18","6","7609","2","955","9.4","9.4"
"Jones","2020-10-19","66","7675","4","959","8.6","9.4"
"Jones","2020-10-20","36","7711","2","961","8.5","9.7"
"Jones","2020-10-21","46","7757","5","966","8.7","10.1"
"Jones","2020-10-22","57","7814","1","967","8.6","10.1"
"Jones","2020-10-23","79","7893","1","968","8.4","9.8"
"Jones","2020-10-24","22","7915","1","969","9.1","8.5"
"Jones","2020-10-25","15","7930","0","969","4.3","6.9"
"Jones","2020-10-26","49","7979","4","973","4.6","6.6"
"Jones","2020-10-27","27","8006","4","977","5.9","7.2"
"Jones","2020-10-28","46","8052","7","984","6.5","7.6"
"Jones","2020-10-29","36","8088","2","986","7.1","7.8"
"Jones","2020-10-30","96","8184","3","989","7.3","7.9"
"Jones","2020-10-31","18","8202","1","990","7.5","8.3"
"Jones","2020-11-01","13","8215","1","991","8.6","6.4"
"Jones","2020-11-02","63","8278","5","996","8.6","6.6"
"Jones","2020-11-03","43","8321","4","1000","7.8","6.8"
"Jones","2020-11-04","71","8392","6","1006","6.8","6.7"
"Jones","2020-11-05","74","8466","4","1010","6.8","6.9"
"Jones","2020-11-06","72","8538","2","1012","6.7","7"
"Jones","2020-11-07","22","8560","5","1017","9.2","8.3"
"Jones","2020-11-08","8","8568","0","1017","8.1","8.3"
"Jones","2020-11-09","54","8622","6","1023","8.5","8.5"
"Jones","2020-11-10","50","8672","4","1027","8.4","8.1"
"Jones","2020-11-11","49","8721","6","1033","8.9","7.8"
"Jones","2020-11-12","44","8765","3","1036","9.1","7.9"
"Jones","2020-11-13","65","8830","3","1039","9.4","8"
"Jones","2020-11-14","19","8849","3","1042","8.4","8.8"
"Jones","2020-11-15","15","8864","1","1043","9.3","8.7"
"Jones","2020-11-16","67","8931","5","1048","8.8","8.7"
"Jones","2020-11-17","39","8970","8","1056","10.6","9.5"
"Jones","2020-11-18","43","9013","7","1063","11.2","10"
"Jones","2020-11-19","65","9078","7","1070","11.7","10.4"
"Jones","2020-11-20","67","9145","4","1074","11.9","10.6"
"Jones","2020-11-21","14","9159","1","1075","10.7","9.5"
"Jones","2020-11-22","10","9169","0","1075","9.7","9.5"
"Jones","2020-11-23","71","9240","5","1080","9.7","9.2"
"Jones","2020-11-24","50","9290","1","1081","7","8.8"
"Jones","2020-11-25","46","9336","9","1090","7.5","9.3"
"Jones","2020-11-26","24","9360","0","1090","6","8.8"
"Jones","2020-11-27","31","9391","1","1091","5.6","8.7"
"Jones","2020-11-28","11","9402","0","1091","4.5","7.6"
"Jones","2020-11-29","17","9419","3","1094","7.1","8.4"
"Jones","2020-11-30","68","9487","12","1106","8.6","9.1"
"Jones","2020-12-01","58","9545","8","1114","10.3","8.6"
"Jones","2020-12-02","40","9585","7","1121","10","8.7"
"Jones","2020-12-03","51","9636","6","1127","11.7","8.8"
"Jones","2020-12-04","54","9690","6","1133","12.8","9.2"
"Jones","2020-12-05","11","9701","1","1134","14.1","9.3"
"Jones","2020-12-06","22","9723","3","1137","13.5","10.3"
"Jones","2020-12-07","65","9788","7","1144","12.5","10.6"
"Jones","2020-12-08","69","9857","11","1155","12.8","11.5"
"Jones","2020-12-09","56","9913","8","1163","12.4","11.2"
"Jones","2020-12-10","81","9994","9","1172","12.3","12"
"Jones","2020-12-11","55","10049","7","1179","12.5","12.6"
"Jones","2020-12-12","31","10080","6","1185","14","14"
"Jones","2020-12-13","25","10105","8","1193","16.6","15.1"
"Jones","2020-12-14","67","10172","11","1204","17.4","15"
"Jones","2020-12-15","93","10265","17","1221","17.7","15.3"
"Jones","2020-12-16","72","10337","9","1230","17.5","14.9"
"Jones","2020-12-17","82","10419","9","1239","17.5","14.9"
"Jones","2020-12-18","41","10460","9","1248","18.8","15.6"
"Jones","2020-12-19","53","10513","13","1261","19.5","16.7"
"Jones","2020-12-20","50","10563","12","1273","18.4","17.5"
"Jones","2020-12-21","65","10628","10","1283","18.2","17.8"
"Jones","2020-12-22","95","10723","22","1305","18.9","18.3"
"Jones","2020-12-23","91","10814","17","1322","19.8","18.6"
"Jones","2020-12-24","53","10867","20","1342","23.6","20.5"
"Jones","2020-12-25","7","10874","2","1344","24.6","21.7"
"Jones","2020-12-26","87","10961","15","1359","23.5","21.5"
"Jones","2020-12-27","50","11011","16","1375","24.7","21.5"
"Jones","2020-12-28","117","11128","34","1409","26.6","22.4"
"Jones","2020-12-29","165","11293","59","1468","28.4","23.7"
"Jones","2020-12-30","96","11389","30","1498","30.2","25"
"Jones","2020-12-31","73","11462","14","1512","27.6","25.6"
"Jones","2021-01-01","23","11485","7","1519","27.8","26.2"
"Jones","2021-01-02","40","11525","8","1527","28.2","25.9"
"Jones","2021-01-03","37","11562","8","1535","26.8","25.7"
"Jones","2021-01-04","106","11668","21","1556","25.4","26"
"Jones","2021-01-05","246","11914","66","1622","24.2","26.3"
"Jones","2021-01-06","94","12008","7","1629","20.8","25.5"
"Jones","2021-01-07","57","12065","11","1640","20.8","24.2"
"Jones","2021-01-08","71","12136","16","1656","19.6","23.7"
"Jones","2021-01-09","48","12184","17","1673","21.9","25"
"Jones","2021-01-10","33","12217","8","1681","22.2","24.5"
"Jones","2021-01-11","83","12300","22","1703","23.2","24.3"
"Jones","2021-01-12","77","12377","17","1720","22.5","23.3"
"Jones","2021-01-13","76","12453","13","1733","23.9","22.3"
"Jones","2021-01-14","58","12511","10","1743","23.6","22.2"
"Jones","2021-01-15","82","12593","9","1752","21.9","20.8"
"Jones","2021-01-16","29","12622","6","1758","19.8","20.8"
"Jones","2021-01-17","36","12658","6","1764","18.8","20.5"
"Jones","2021-01-18","64","12722","9","1773","17","20.1"
"Jones","2021-01-19","59","12781","13","1786","17","19.7"
"Jones","2021-01-20","75","12856","11","1797","16.6","20.3"
"Jones","2021-01-21","57","12913","13","1810","17.4","20.5"
"Jones","2021-01-22","67","12980","14","1824","18.8","20.4"
"Jones","2021-01-23","36","13016","10","1834","19.8","19.8"
"Jones","2021-01-24","21","13037","1","1835","18.1","18.4"
"Jones","2021-01-25","22","13059","3","1838","18.1","17.5"
"Jones","2021-01-26","1","13060","1","1839","29.2","23.1"
"Jones","2021-01-27","0","13060","0","1839","27.1","21.9"
"Lamar","2020-02-01","0","0","0","0",".","."
"Lamar","2020-02-02","0","0","0","0",".","."
"Lamar","2020-02-03","0","0","0","0",".","."
"Lamar","2020-02-04","0","0","0","0",".","."
"Lamar","2020-02-05","0","0","0","0",".","."
"Lamar","2020-02-06","0","0","0","0",".","."
"Lamar","2020-02-07","0","0","0","0","0","."
"Lamar","2020-02-08","0","0","0","0","0","."
"Lamar","2020-02-09","0","0","0","0","0","."
"Lamar","2020-02-10","0","0","0","0","0","."
"Lamar","2020-02-11","0","0","0","0","0","."
"Lamar","2020-02-12","0","0","0","0","0","."
"Lamar","2020-02-13","0","0","0","0","0","."
"Lamar","2020-02-14","0","0","0","0","0","0"
"Lamar","2020-02-15","0","0","0","0","0","0"
"Lamar","2020-02-16","0","0","0","0","0","0"
"Lamar","2020-02-17","0","0","0","0","0","0"
"Lamar","2020-02-18","0","0","0","0","0","0"
"Lamar","2020-02-19","0","0","0","0","0","0"
"Lamar","2020-02-20","0","0","0","0","0","0"
"Lamar","2020-02-21","0","0","0","0","0","0"
"Lamar","2020-02-22","0","0","0","0","0","0"
"Lamar","2020-02-23","0","0","0","0","0","0"
"Lamar","2020-02-24","0","0","0","0","0","0"
"Lamar","2020-02-25","0","0","0","0","0","0"
"Lamar","2020-02-26","0","0","0","0","0","0"
"Lamar","2020-02-27","0","0","0","0","0","0"
"Lamar","2020-02-28","0","0","0","0","0","0"
"Lamar","2020-02-29","0","0","0","0","0","0"
"Lamar","2020-03-01","0","0","0","0","0","0"
"Lamar","2020-03-02","0","0","0","0","0","0"
"Lamar","2020-03-03","0","0","0","0","0","0"
"Lamar","2020-03-04","0","0","0","0","0","0"
"Lamar","2020-03-05","0","0","0","0","0","0"
"Lamar","2020-03-06","0","0","0","0","0","0"
"Lamar","2020-03-07","0","0","0","0","0","0"
"Lamar","2020-03-08","0","0","0","0","0","0"
"Lamar","2020-03-09","0","0","0","0","0","0"
"Lamar","2020-03-10","2","2","0","0","0","0"
"Lamar","2020-03-11","2","4","0","0","0","0"
"Lamar","2020-03-12","0","4","0","0","0","0"
"Lamar","2020-03-13","2","6","0","0","0","0"
"Lamar","2020-03-14","0","6","0","0","0","0"
"Lamar","2020-03-15","0","6","0","0","0","0"
"Lamar","2020-03-16","1","7","0","0","0","0"
"Lamar","2020-03-17","3","10","0","0","0","0"
"Lamar","2020-03-18","1","11","0","0","0","0"
"Lamar","2020-03-19","1","12","0","0","0","0"
"Lamar","2020-03-20","4","16","2","2","7.1","3.6"
"Lamar","2020-03-21","3","19","0","2","7.1","3.6"
"Lamar","2020-03-22","5","24","1","3","10","5"
"Lamar","2020-03-23","10","34","1","4","11.4","5.7"
"Lamar","2020-03-24","12","46","2","6","13.8","6.9"
"Lamar","2020-03-25","5","51","0","6","13.8","6.9"
"Lamar","2020-03-26","9","60","1","7","15.4","7.7"
"Lamar","2020-03-27","9","69","5","12","16.2","11.7"
"Lamar","2020-03-28","4","73","0","12","16.2","11.7"
"Lamar","2020-03-29","4","77","0","12","13.3","11.7"
"Lamar","2020-03-30","4","81","0","12","11.9","11.7"
"Lamar","2020-03-31","6","87","2","14","14.3","14"
"Lamar","2020-04-01","13","100","2","16","16.5","15.1"
"Lamar","2020-04-02","6","106","0","16","14.9","15.1"
"Lamar","2020-04-03","6","112","1","17","9.3","12.8"
"Lamar","2020-04-04","0","112","0","17","9.3","12.8"
"Lamar","2020-04-05","1","113","1","18","23.6","18.5"
"Lamar","2020-04-06","7","120","1","19","25.7","18.8"
"Lamar","2020-04-07","9","129","0","19","20.9","17.6"
"Lamar","2020-04-08","13","142","0","19","18.7","17.6"
"Lamar","2020-04-09","14","156","2","21","20.7","17.8"
"Lamar","2020-04-10","8","164","1","22","20.2","14.7"
"Lamar","2020-04-11","4","168","0","22","20.2","14.7"
"Lamar","2020-04-12","1","169","0","22","5.9","14.7"
"Lamar","2020-04-13","10","179","1","23","5.3","15.5"
"Lamar","2020-04-14","8","187","0","23","5.3","13.1"
"Lamar","2020-04-15","21","208","2","25","6.6","12.7"
"Lamar","2020-04-16","7","215","0","25","4.6","12.7"
"Lamar","2020-04-17","7","222","2","27","6.9","13.5"
"Lamar","2020-04-18","3","225","0","27","6.9","13.5"
"Lamar","2020-04-19","2","227","0","27","6.9","6.4"
"Lamar","2020-04-20","17","244","2","29","7.1","6.2"
"Lamar","2020-04-21","21","265","1","30","7.8","6.5"
"Lamar","2020-04-22","38","303","3","33","7.6","7.1"
"Lamar","2020-04-23","17","320","1","34","8.4","6.5"
"Lamar","2020-04-24","14","334","3","37","7.4","7.1"
"Lamar","2020-04-25","4","338","0","37","7.4","7.1"
"Lamar","2020-04-26","3","341","0","37","7.4","7.1"
"Lamar","2020-04-27","18","359","4","41","8.9","8"
"Lamar","2020-04-28","16","375","1","42","9.1","8.4"
"Lamar","2020-04-29","12","387","0","42","8","7.8"
"Lamar","2020-04-30","12","399","0","42","7.1","7.8"
"Lamar","2020-05-01","4","403","0","42","4.1","5.7"
"Lamar","2020-05-02","7","410","0","42","4.1","5.7"
"Lamar","2020-05-03","5","415","0","42","4.1","5.7"
"Lamar","2020-05-04","13","428","1","43","2","5.4"
"Lamar","2020-05-05","7","435","0","43","1.1","5.1"
"Lamar","2020-05-06","5","440","1","44","4","6"
"Lamar","2020-05-07","9","449","2","46","7.1","7.1"
"Lamar","2020-05-08","10","459","0","46","7.1","5.6"
"Lamar","2020-05-09","4","463","0","46","7.1","5.6"
"Lamar","2020-05-10","0","463","0","46","7.1","5.6"
"Lamar","2020-05-11","10","473","0","46","6","4"
"Lamar","2020-05-12","8","481","1","47","7.8","4.5"
"Lamar","2020-05-13","13","494","1","48","6.1","5"
"Lamar","2020-05-14","9","503","2","50","6.1","6.6"
"Lamar","2020-05-15","23","526","6","56","9.8","8.5"
"Lamar","2020-05-16","7","533","0","56","9.8","8.5"
"Lamar","2020-05-17","4","537","1","57","13.4","10.2"
"Lamar","2020-05-18","20","557","1","58","14.1","10.1"
"Lamar","2020-05-19","21","578","2","60","13.6","10.7"
"Lamar","2020-05-20","43","621","10","70","15.9","11"
"Lamar","2020-05-21","13","634","2","72","14.9","10.5"
"Lamar","2020-05-22","9","643","0","72","11.2","10.5"
"Lamar","2020-05-23","10","653","2","74","14","11.9"
"Lamar","2020-05-24","6","659","0","74","10.5","11.9"
"Lamar","2020-05-25","3","662","0","74","9.7","11.9"
"Lamar","2020-05-26","18","680","1","75","9.2","11.4"
"Lamar","2020-05-27","110","790","2","77","6.1","11"
"Lamar","2020-05-28","8","798","0","77","3.9","9.4"
"Lamar","2020-05-29","10","808","1","78","5.3","8.3"
"Lamar","2020-05-30","7","815","1","79","4.5","9.3"
"Lamar","2020-05-31","0","815","0","79","4.5","7.5"
"Lamar","2020-06-01","17","832","0","79","4.5","7.1"
"Lamar","2020-06-02","13","845","1","80","4.8","7"
"Lamar","2020-06-03","16","861","0","80","4.6","5.3"
"Lamar","2020-06-04","17","878","2","82","6.2","5.1"
"Lamar","2020-06-05","16","894","0","82","4.8","5.1"
"Lamar","2020-06-06","5","899","0","82","2.8","3.7"
"Lamar","2020-06-07","5","904","1","83","5.6","5.1"
"Lamar","2020-06-08","12","916","1","84","6.8","5.7"
"Lamar","2020-06-09","17","933","0","84","5.7","5.3"
"Lamar","2020-06-10","20","953","6","90","10","7.3"
"Lamar","2020-06-11","20","973","2","92","9.8","8"
"Lamar","2020-06-12","13","986","0","92","9.8","7.3"
"Lamar","2020-06-13","7","993","0","92","9.8","6.3"
"Lamar","2020-06-14","3","996","0","92","6.9","6.3"
"Lamar","2020-06-15","22","1018","3","95","7.7","7.2"
"Lamar","2020-06-16","25","1043","2","97","8.8","7.3"
"Lamar","2020-06-17","23","1066","1","98","5.1","7.6"
"Lamar","2020-06-18","15","1081","3","101","6.6","8.2"
"Lamar","2020-06-19","21","1102","3","104","8.6","9.2"
"Lamar","2020-06-20","19","1121","3","107","10.9","10.3"
"Lamar","2020-06-21","2","1123","0","107","10.9","8.9"
"Lamar","2020-06-22","38","1161","1","108","9.3","8.5"
"Lamar","2020-06-23","31","1192","0","108","8.2","8.5"
"Lamar","2020-06-24","28","1220","3","111","9.1","7.1"
"Lamar","2020-06-25","27","1247","3","114","7.8","7.2"
"Lamar","2020-06-26","21","1268","8","122","11.2","9.9"
"Lamar","2020-06-27","19","1287","2","124","10.4","10.7"
"Lamar","2020-06-28","8","1295","2","126","14","12.4"
"Lamar","2020-06-29","19","1314","1","127","14.4","11.8"
"Lamar","2020-06-30","34","1348","2","129","15.2","11.7"
"Lamar","2020-07-01","35","1383","2","131","14.5","11.8"
"Lamar","2020-07-02","127","1510","9","140","13.9","10.9"
"Lamar","2020-07-03","15","1525","1","141","9.4","10.3"
"Lamar","2020-07-04","10","1535","1","142","9.4","9.9"
"Lamar","2020-07-05","6","1541","0","142","5.8","9.9"
"Lamar","2020-07-06","90","1631","1","143","5.2","9.8"
"Lamar","2020-07-07","34","1665","2","145","5.2","10.2"
"Lamar","2020-07-08","22","1687","2","147","5.7","10.1"
"Lamar","2020-07-09","157","1844","4","151","5","9.5"
"Lamar","2020-07-10","44","1888","1","152","4.4","6.9"
"Lamar","2020-07-11","18","1906","3","155","5.4","7.4"
"Lamar","2020-07-12","8","1914","1","156","7.2","6.5"
"Lamar","2020-07-13","35","1949","5","161","9","7.1"
"Lamar","2020-07-14","30","1979","6","167","11.1","8.1"
"Lamar","2020-07-15","23","2002","2","169","11","8.3"
"Lamar","2020-07-16","131","2133","6","175","11.3","8.2"
"Lamar","2020-07-17","44","2177","0","175","11","7.7"
"Lamar","2020-07-18","26","2203","1","176","9.1","7.2"
"Lamar","2020-07-19","6","2209","1","177","9.7","8.4"
"Lamar","2020-07-20","44","2253","6","183","9.6","9.3"
"Lamar","2020-07-21","24","2277","2","185","8","9.5"
"Lamar","2020-07-22","29","2306","3","188","8.2","9.6"
"Lamar","2020-07-23","184","2490","17","205","8.9","10.1"
"Lamar","2020-07-24","32","2522","3","208","10.2","10.6"
"Lamar","2020-07-25","33","2555","5","213","11.8","10.5"
"Lamar","2020-07-26","9","2564","2","215","12.6","11.2"
"Lamar","2020-07-27","39","2603","2","217","11.4","10.5"
"Lamar","2020-07-28","39","2642","2","219","10.9","9.5"
"Lamar","2020-07-29","16","2658","0","219","9.5","8.8"
"Lamar","2020-07-30","150","2808","19","238","10","9.4"
"Lamar","2020-07-31","31","2839","9","247","12.8","11.5"
"Lamar","2020-08-01","20","2859","1","248","11.3","11.6"
"Lamar","2020-08-02","9","2868","2","250","11.3","12"
"Lamar","2020-08-03","34","2902","5","255","12.7","12"
"Lamar","2020-08-04","26","2928","5","260","14.7","12.8"
"Lamar","2020-08-05","40","2968","4","264","16.1","12.8"
"Lamar","2020-08-06","101","3069","5","269","15","12.5"
"Lamar","2020-08-07","19","3088","2","271","12.4","12.6"
"Lamar","2020-08-08","18","3106","2","273","13.2","12.3"
"Lamar","2020-08-09","9","3115","3","276","14.8","13.1"
"Lamar","2020-08-10","21","3136","1","277","13.4","13"
"Lamar","2020-08-11","21","3157","3","280","12.7","13.7"
"Lamar","2020-08-12","29","3186","5","285","13.7","14.9"
"Lamar","2020-08-13","76","3262","1","286","13.2","14.1"
"Lamar","2020-08-14","41","3303","3","289","12.8","12.6"
"Lamar","2020-08-15","34","3337","4","293","12.9","13.1"
"Lamar","2020-08-16","9","3346","1","294","9.7","12.3"
"Lamar","2020-08-17","44","3390","3","297","10","11.7"
"Lamar","2020-08-18","48","3438","1","298","8.2","10.5"
"Lamar","2020-08-19","35","3473","6","304","8.2","11"
"Lamar","2020-08-20","99","3572","4","308","8.6","10.9"
"Lamar","2020-08-21","43","3615","2","310","8.2","10.5"
"Lamar","2020-08-22","57","3672","1","311","6.8","9.8"
"Lamar","2020-08-23","9","3681","1","312","6.8","8.2"
"Lamar","2020-08-24","36","3717","4","316","7.4","8.7"
"Lamar","2020-08-25","45","3762","1","317","7.4","7.8"
"Lamar","2020-08-26","40","3802","1","318","5.3","6.8"
"Lamar","2020-08-27","87","3889","0","318","4.8","6.7"
"Lamar","2020-08-28","34","3923","3","321","5.4","6.8"
"Lamar","2020-08-29","13","3936","0","321","5.1","6"
"Lamar","2020-08-30","6","3942","0","321","3.5","5.2"
"Lamar","2020-08-31","29","3971","2","323","2.9","5.2"
"Lamar","2020-09-01","24","3995","2","325","3.8","5.6"
"Lamar","2020-09-02","33","4028","2","327","4.3","4.8"
"Lamar","2020-09-03","44","4072","0","327","4.3","4.5"
"Lamar","2020-09-04","29","4101","1","328","3.5","4.4"
"Lamar","2020-09-05","37","4138","2","330","4.3","4.7"
"Lamar","2020-09-06","6","4144","1","331","6.7","5.1"
"Lamar","2020-09-07","7","4151","1","332","7.7","5.3"
"Lamar","2020-09-08","25","4176","2","334","7.7","5.7"
"Lamar","2020-09-09","35","4211","0","334","6.8","5.6"
"Lamar","2020-09-10","43","4254","0","334","6.8","5.6"
"Lamar","2020-09-11","25","4279","3","337","8.1","5.8"
"Lamar","2020-09-12","5","4284","1","338","10.1","7.2"
"Lamar","2020-09-13","3","4287","1","339","12.5","9.6"
"Lamar","2020-09-14","52","4339","4","343","11.6","9.7"
"Lamar","2020-09-15","24","4363","0","343","10.4","9.1"
"Lamar","2020-09-16","14","4377","0","343","10.4","8.6"
"Lamar","2020-09-17","22","4399","1","344","11.1","9"
"Lamar","2020-09-18","18","4417","3","347","11.7","9.9"
"Lamar","2020-09-19","17","4434","0","347","8.9","9.5"
"Lamar","2020-09-20","5","4439","0","347","4.1","8.3"
"Lamar","2020-09-21","36","4475","1","348","3.4","7.5"
"Lamar","2020-09-22","34","4509","4","352","5.1","7.8"
"Lamar","2020-09-23","25","4534","2","354","6.3","8.3"
"Lamar","2020-09-24","65","4599","1","355","5.8","8.5"
"Lamar","2020-09-25","28","4627","3","358","5","8.4"
"Lamar","2020-09-26","18","4645","1","359","5.8","7.3"
"Lamar","2020-09-27","7","4652","2","361","9.8","7"
"Lamar","2020-09-28","27","4679","2","363","10.5","7"
"Lamar","2020-09-29","34","4713","1","364","9.2","7.2"
"Lamar","2020-09-30","28","4741","1","365","8.6","7.4"
"Lamar","2020-10-01","72","4813","4","369","9.2","7.5"
"Lamar","2020-10-02","39","4852","0","369","7.7","6.3"
"Lamar","2020-10-03","14","4866","0","369","6.9","6.3"
"Lamar","2020-10-04","9","4875","1","370","4.4","7.1"
"Lamar","2020-10-05","45","4920","2","372","3.9","7.2"
"Lamar","2020-10-06","53","4973","3","375","4.3","6.8"
"Lamar","2020-10-07","37","5010","1","376","4.2","6.4"
"Lamar","2020-10-08","54","5064","0","376","3.4","6.3"
"Lamar","2020-10-09","26","5090","0","376","3.4","5.5"
"Lamar","2020-10-10","13","5103","0","376","3.4","5.1"
"Lamar","2020-10-11","7","5110","0","376","1.8","3.1"
"Lamar","2020-10-12","32","5142","1","377","1.6","2.8"
"Lamar","2020-10-13","35","5177","3","380","2.1","3.2"
"Lamar","2020-10-14","31","5208","1","381","2.1","3.2"
"Lamar","2020-10-15","45","5253","2","383","2.8","3.1"
"Lamar","2020-10-16","33","5286","2","385","3.6","3.5"
"Lamar","2020-10-17","17","5303","0","385","3.6","3.5"
"Lamar","2020-10-18","7","5310","0","385","3.6","2.7"
"Lamar","2020-10-19","40","5350","1","386","3.5","2.6"
"Lamar","2020-10-20","43","5393","2","388","3","2.5"
"Lamar","2020-10-21","18","5411","1","389","3.3","2.7"
"Lamar","2020-10-22","32","5443","3","392","4","3.4"
"Lamar","2020-10-23","72","5515","8","400","4.7","4.2"
"Lamar","2020-10-24","20","5535","1","401","5.5","4.5"
"Lamar","2020-10-25","11","5546","1","402","6.8","5.2"
"Lamar","2020-10-26","26","5572","3","405","8","5.8"
"Lamar","2020-10-27","25","5597","1","406","8","5.5"
"Lamar","2020-10-28","23","5620","1","407","7.8","5.5"
"Lamar","2020-10-29","27","5647","2","409","7.5","5.8"
"Lamar","2020-10-30","28","5675","3","412","7.4","6.1"
"Lamar","2020-10-31","27","5702","8","420","11","8.2"
"Lamar","2020-11-01","11","5713","1","421","11","8.9"
"Lamar","2020-11-02","32","5745","4","425","11.1","9.6"
"Lamar","2020-11-03","19","5764","1","426","11.3","9.6"
"Lamar","2020-11-04","37","5801","1","427","11","9.4"
"Lamar","2020-11-05","87","5888","7","434","11.1","9.3"
"Lamar","2020-11-06","36","5924","1","435","10","8.7"
"Lamar","2020-11-07","41","5965","7","442","8.2","9.6"
"Lamar","2020-11-08","6","5971","0","442","6.9","8.9"
"Lamar","2020-11-09","41","6012","7","449","7.6","9.3"
"Lamar","2020-11-10","33","6045","2","451","7.7","9.5"
"Lamar","2020-11-11","48","6093","5","456","8.8","9.9"
"Lamar","2020-11-12","52","6145","3","459","8.5","9.8"
"Lamar","2020-11-13","46","6191","4","463","9.3","9.6"
"Lamar","2020-11-14","23","6214","3","466","8.7","8.5"
"Lamar","2020-11-15","17","6231","4","470","12.1","9.5"
"Lamar","2020-11-16","37","6268","4","474","11.2","9.4"
"Lamar","2020-11-17","31","6299","3","477","11.7","9.7"
"Lamar","2020-11-18","47","6346","7","484","12.3","10.6"
"Lamar","2020-11-19","76","6422","5","489","12.5","10.5"
"Lamar","2020-11-20","55","6477","10","499","13.8","11.6"
"Lamar","2020-11-21","41","6518","9","508","15.1","11.9"
"Lamar","2020-11-22","7","6525","2","510","15.8","13.9"
"Lamar","2020-11-23","29","6554","6","516","17.2","14.2"
"Lamar","2020-11-24","35","6589","7","523","18.7","15.2"
"Lamar","2020-11-25","39","6628","4","527","18","15.2"
"Lamar","2020-11-26","7","6635","0","527","17.1","14.8"
"Lamar","2020-11-27","36","6671","4","531","16.1","14.9"
"Lamar","2020-11-28","58","6729","7","538","14.7","14.9"
"Lamar","2020-11-29","9","6738","1","539","12.2","14"
"Lamar","2020-11-30","41","6779","4","543","10.6","13.9"
"Lamar","2020-12-01","52","6831","14","557","11.6","15.1"
"Lamar","2020-12-02","32","6863","5","562","12.4","15.2"
"Lamar","2020-12-03","105","6968","9","571","13.6","15.3"
"Lamar","2020-12-04","46","7014","6","577","13.9","15"
"Lamar","2020-12-05","14","7028","1","578","13.2","13.9"
"Lamar","2020-12-06","9","7037","4","582","17.9","15.1"
"Lamar","2020-12-07","39","7076","8","590","19.5","15"
"Lamar","2020-12-08","44","7120","12","602","19.5","15.6"
"Lamar","2020-12-09","66","7186","5","607","18.4","15.4"
"Lamar","2020-12-10","151","7337","17","624","18.8","16.2"
"Lamar","2020-12-11","43","7380","4","628","18.2","16"
"Lamar","2020-12-12","75","7455","5","633","18.1","15.7"
"Lamar","2020-12-13","27","7482","6","639","15","16.5"
"Lamar","2020-12-14","76","7558","12","651","14.3","16.9"
"Lamar","2020-12-15","92","7650","12","663","12.3","15.9"
"Lamar","2020-12-16","48","7698","15","678","15.6","17"
"Lamar","2020-12-17","142","7840","26","704","16.7","17.7"
"Lamar","2020-12-18","33","7873","4","708","17.1","17.6"
"Lamar","2020-12-19","24","7897","6","714","19.7","18.9"
"Lamar","2020-12-20","13","7910","2","716","18.7","16.8"
"Lamar","2020-12-21","33","7943","9","725","20.3","17.3"
"Lamar","2020-12-22","63","8006","12","737","21.2","16.7"
"Lamar","2020-12-23","50","8056","9","746","19.3","17.5"
"Lamar","2020-12-24","31","8087","14","760","23.1","19.9"
"Lamar","2020-12-25","2","8089","2","762","35.7","26.4"
"Lamar","2020-12-26","25","8114","7","769","36.1","27.9"
"Lamar","2020-12-27","17","8131","6","775","39","28.8"
"Lamar","2020-12-28","94","8225","19","794","38","29.1"
"Lamar","2020-12-29","80","8305","19","813","38.6","29.9"
"Lamar","2020-12-30","59","8364","22","835","41.4","30.3"
"Lamar","2020-12-31","213","8577","49","884","38.2","30.7"
"Lamar","2021-01-01","5","8582","2","886","29.6","32.7"
"Lamar","2021-01-02","14","8596","6","892","31.8","33.9"
"Lamar","2021-01-03","28","8624","7","899","30.3","34.6"
"Lamar","2021-01-04","62","8686","18","917","31.6","34.8"
"Lamar","2021-01-05","70","8756","23","940","32.9","35.7"
"Lamar","2021-01-06","67","8823","12","952","30.1","35.7"
"Lamar","2021-01-07","170","8993","23","975","28.7","33.5"
"Lamar","2021-01-08","51","9044","9","984","25.5","27.6"
"Lamar","2021-01-09","34","9078","12","996","24.5","28.1"
"Lamar","2021-01-10","13","9091","0","996","20.9","25.6"
"Lamar","2021-01-11","71","9162","16","1012","20","25.8"
"Lamar","2021-01-12","52","9214","15","1027","19.4","26.1"
"Lamar","2021-01-13","57","9271","14","1041","20.3","25.2"
"Lamar","2021-01-14","171","9442","25","1066","20.5","24.6"
"Lamar","2021-01-15","54","9496","11","1077","20.9","23.2"
"Lamar","2021-01-16","25","9521","4","1081","18.1","21.3"
"Lamar","2021-01-17","23","9544","5","1086","21.2","21.1"
"Lamar","2021-01-18","53","9597","9","1095","20.4","20.2"
"Lamar","2021-01-19","45","9642","11","1106","19.8","19.6"
"Lamar","2021-01-20","52","9694","15","1121","20.4","20.4"
"Lamar","2021-01-21","147","9841","23","1144","20.6","20.5"
"Lamar","2021-01-22","48","9889","15","1159","22.1","21.5"
"Lamar","2021-01-23","35","9924","4","1163","21.5","19.8"
"Lamar","2021-01-24","8","9932","1","1164","20.2","20.7"
"Lamar","2021-01-25","15","9947","1","1165","18.7","19.6"
"Lamar","2021-01-26","0","9947","0","1165","15.2","17.5"
"Lamar","2021-01-27","0","9947","0","1165","11.1","15.7"
"Lanier","2020-02-01","0","0","0","0",".","."
"Lanier","2020-02-02","0","0","0","0",".","."
"Lanier","2020-02-03","0","0","0","0",".","."
"Lanier","2020-02-04","0","0","0","0",".","."
"Lanier","2020-02-05","0","0","0","0",".","."
"Lanier","2020-02-06","0","0","0","0",".","."
"Lanier","2020-02-07","0","0","0","0","0","."
"Lanier","2020-02-08","0","0","0","0","0","."
"Lanier","2020-02-09","0","0","0","0","0","."
"Lanier","2020-02-10","0","0","0","0","0","."
"Lanier","2020-02-11","0","0","0","0","0","."
"Lanier","2020-02-12","0","0","0","0","0","."
"Lanier","2020-02-13","0","0","0","0","0","."
"Lanier","2020-02-14","0","0","0","0","0","0"
"Lanier","2020-02-15","0","0","0","0","0","0"
"Lanier","2020-02-16","0","0","0","0","0","0"
"Lanier","2020-02-17","0","0","0","0","0","0"
"Lanier","2020-02-18","0","0","0","0","0","0"
"Lanier","2020-02-19","0","0","0","0","0","0"
"Lanier","2020-02-20","0","0","0","0","0","0"
"Lanier","2020-02-21","0","0","0","0","0","0"
"Lanier","2020-02-22","0","0","0","0","0","0"
"Lanier","2020-02-23","0","0","0","0","0","0"
"Lanier","2020-02-24","0","0","0","0","0","0"
"Lanier","2020-02-25","0","0","0","0","0","0"
"Lanier","2020-02-26","0","0","0","0","0","0"
"Lanier","2020-02-27","0","0","0","0","0","0"
"Lanier","2020-02-28","0","0","0","0","0","0"
"Lanier","2020-02-29","0","0","0","0","0","0"
"Lanier","2020-03-01","0","0","0","0","0","0"
"Lanier","2020-03-02","0","0","0","0","0","0"
"Lanier","2020-03-03","0","0","0","0","0","0"
"Lanier","2020-03-04","0","0","0","0","0","0"
"Lanier","2020-03-05","0","0","0","0","0","0"
"Lanier","2020-03-06","0","0","0","0","0","0"
"Lanier","2020-03-07","0","0","0","0","0","0"
"Lanier","2020-03-08","0","0","0","0","0","0"
"Lanier","2020-03-09","0","0","0","0","0","0"
"Lanier","2020-03-10","0","0","0","0","0","0"
"Lanier","2020-03-11","0","0","0","0","0","0"
"Lanier","2020-03-12","0","0","0","0","0","0"
"Lanier","2020-03-13","0","0","0","0","0","0"
"Lanier","2020-03-14","0","0","0","0","0","0"
"Lanier","2020-03-15","0","0","0","0","0","0"
"Lanier","2020-03-16","0","0","0","0","0","0"
"Lanier","2020-03-17","0","0","0","0","0","0"
"Lanier","2020-03-18","1","1","0","0","0","0"
"Lanier","2020-03-19","2","3","0","0","0","0"
"Lanier","2020-03-20","0","3","0","0","0","0"
"Lanier","2020-03-21","0","3","0","0","0","0"
"Lanier","2020-03-22","0","3","0","0","0","0"
"Lanier","2020-03-23","1","4","0","0","0","0"
"Lanier","2020-03-24","1","5","0","0","0","0"
"Lanier","2020-03-25","0","5","0","0","0","0"
"Lanier","2020-03-26","0","5","0","0","0","0"
"Lanier","2020-03-27","3","8","0","0","0","0"
"Lanier","2020-03-28","0","8","0","0","0","0"
"Lanier","2020-03-29","1","9","0","0","0","0"
"Lanier","2020-03-30","1","10","0","0","0","0"
"Lanier","2020-03-31","1","11","1","1","14.3","7.1"
"Lanier","2020-04-01","3","14","0","1","14.3","7.1"
"Lanier","2020-04-02","1","15","0","1","14.3","7.1"
"Lanier","2020-04-03","3","18","1","2","19","9.5"
"Lanier","2020-04-04","4","22","3","5","29.8","14.9"
"Lanier","2020-04-05","0","22","0","5","29.8","14.9"
"Lanier","2020-04-06","3","25","0","5","29.8","14.9"
"Lanier","2020-04-07","4","29","0","5","15.5","14.9"
"Lanier","2020-04-08","2","31","0","5","15.5","14.9"
"Lanier","2020-04-09","1","32","0","5","15.5","14.9"
"Lanier","2020-04-10","0","32","0","5","10.7","14.9"
"Lanier","2020-04-11","0","32","0","5","0","14.9"
"Lanier","2020-04-12","0","32","0","5","0","14.9"
"Lanier","2020-04-13","2","34","0","5","0","14.9"
"Lanier","2020-04-14","4","38","0","5","0","7.7"
"Lanier","2020-04-15","4","42","0","5","0","7.7"
"Lanier","2020-04-16","5","47","0","5","0","7.7"
"Lanier","2020-04-17","2","49","0","5","0","5.4"
"Lanier","2020-04-18","15","64","4","9","3.8","1.9"
"Lanier","2020-04-19","1","65","0","9","3.8","1.9"
"Lanier","2020-04-20","3","68","0","9","3.8","1.9"
"Lanier","2020-04-21","3","71","0","9","3.8","1.9"
"Lanier","2020-04-22","3","74","1","10","8.6","4.3"
"Lanier","2020-04-23","3","77","0","10","8.6","4.3"
"Lanier","2020-04-24","2","79","0","10","8.6","4.3"
"Lanier","2020-04-25","0","79","0","10","4.8","4.3"
"Lanier","2020-04-26","2","81","0","10","4.8","4.3"
"Lanier","2020-04-27","7","88","1","11","6.8","5.3"
"Lanier","2020-04-28","3","91","0","11","6.8","5.3"
"Lanier","2020-04-29","3","94","0","11","2","5.3"
"Lanier","2020-04-30","4","98","0","11","2","5.3"
"Lanier","2020-05-01","10","108","1","12","3.5","6"
"Lanier","2020-05-02","0","108","0","12","3.5","4.1"
"Lanier","2020-05-03","0","108","0","12","3.5","4.1"
"Lanier","2020-05-04","7","115","0","12","1.4","4.1"
"Lanier","2020-05-05","8","123","0","12","1.4","4.1"
"Lanier","2020-05-06","1","124","0","12","1.4","1.7"
"Lanier","2020-05-07","2","126","0","12","1.4","1.7"
"Lanier","2020-05-08","3","129","1","13","4.8","4.1"
"Lanier","2020-05-09","1","130","0","13","4.8","4.1"
"Lanier","2020-05-10","0","130","0","13","4.8","4.1"
"Lanier","2020-05-11","22","152","0","13","4.8","3.1"
"Lanier","2020-05-12","17","169","0","13","4.8","3.1"
"Lanier","2020-05-13","3","172","0","13","4.8","3.1"
"Lanier","2020-05-14","7","179","0","13","4.8","3.1"
"Lanier","2020-05-15","5","184","0","13","0","2.4"
"Lanier","2020-05-16","0","184","0","13","0","2.4"
"Lanier","2020-05-17","0","184","0","13","0","2.4"
"Lanier","2020-05-18","14","198","1","14","1","2.9"
"Lanier","2020-05-19","20","218","1","15","1.7","3.2"
"Lanier","2020-05-20","7","225","0","15","1.7","3.2"
"Lanier","2020-05-21","1","226","0","15","1.7","3.2"
"Lanier","2020-05-22","2","228","0","15","1.7","0.9"
"Lanier","2020-05-23","0","228","0","15","1.7","0.9"
"Lanier","2020-05-24","1","229","1","16","16","8"
"Lanier","2020-05-25","1","230","0","16","15","8"
"Lanier","2020-05-26","29","259","5","21","16.7","9.2"
"Lanier","2020-05-27","3","262","1","22","21.5","11.6"
"Lanier","2020-05-28","8","270","0","22","21.5","11.6"
"Lanier","2020-05-29","6","276","1","23","23.9","12.8"
"Lanier","2020-05-30","0","276","0","23","23.9","12.8"
"Lanier","2020-05-31","2","278","2","25","23.9","20"
"Lanier","2020-06-01","10","288","0","25","23.9","19.4"
"Lanier","2020-06-02","10","298","2","27","24.3","20.5"
"Lanier","2020-06-03","5","303","2","29","25.2","23.4"
"Lanier","2020-06-04","6","309","0","29","25.2","23.4"
"Lanier","2020-06-05","10","319","0","29","22.9","23.4"
"Lanier","2020-06-06","2","321","0","29","22.9","23.4"
"Lanier","2020-06-07","6","327","5","34","20.5","22.2"
"Lanier","2020-06-08","51","378","1","35","20.8","22.3"
"Lanier","2020-06-09","33","411","0","35","17.9","21.1"
"Lanier","2020-06-10","9","420","3","38","16.9","21.1"
"Lanier","2020-06-11","14","434","6","44","23.1","24.2"
"Lanier","2020-06-12","9","443","1","45","24.7","23.8"
"Lanier","2020-06-13","0","443","0","45","24.7","23.8"
"Lanier","2020-06-14","0","443","0","45","12.8","16.6"
"Lanier","2020-06-15","38","481","5","50","14.4","17.6"
"Lanier","2020-06-16","38","519","2","52","15.1","16.5"
"Lanier","2020-06-17","15","534","1","53","11.3","14.1"
"Lanier","2020-06-18","13","547","2","55","7.4","15.2"
"Lanier","2020-06-19","19","566","1","56","6.5","15.6"
"Lanier","2020-06-20","1","567","1","57","20.8","22.7"
"Lanier","2020-06-21","2","569","1","58","28","20.4"
"Lanier","2020-06-22","58","627","5","63","27.3","20.8"
"Lanier","2020-06-23","49","676","5","68","28","21.6"
"Lanier","2020-06-24","13","689","2","70","29.3","20.3"
"Lanier","2020-06-25","34","723","9","79","30.8","19.1"
"Lanier","2020-06-26","41","764","5","84","31.8","19.2"
"Lanier","2020-06-27","1","765","0","84","17.6","19.2"
"Lanier","2020-06-28","1","766","1","85","24.7","26.3"
"Lanier","2020-06-29","74","840","10","95","25.4","26.4"
"Lanier","2020-06-30","91","931","10","105","25.5","26.8"
"Lanier","2020-07-01","13","944","0","105","23.3","26.3"
"Lanier","2020-07-02","21","965","4","109","22.2","26.5"
"Lanier","2020-07-03","4","969","1","110","24.1","28"
"Lanier","2020-07-04","1","970","0","110","24.1","20.8"
"Lanier","2020-07-05","3","973","2","112","19.3","22"
"Lanier","2020-07-06","55","1028","3","115","18.2","21.8"
"Lanier","2020-07-07","45","1073","8","123","19.1","22.3"
"Lanier","2020-07-08","8","1081","0","123","19.1","21.2"
"Lanier","2020-07-09","9","1090","2","125","19.6","20.9"
"Lanier","2020-07-10","3","1093","0","125","16","20"
"Lanier","2020-07-11","0","1093","0","125","16","20"
"Lanier","2020-07-12","3","1096","0","125","6.5","12.9"
"Lanier","2020-07-13","49","1145","5","130","7.2","12.7"
"Lanier","2020-07-14","50","1195","4","134","5.8","12.5"
"Lanier","2020-07-15","14","1209","1","135","6.8","13"
"Lanier","2020-07-16","16","1225","8","143","10.8","15.2"
"Lanier","2020-07-17","29","1254","4","147","12.7","14.4"
"Lanier","2020-07-18","5","1259","0","147","12.7","14.4"
"Lanier","2020-07-19","4","1263","0","147","12.7","9.6"
"Lanier","2020-07-20","79","1342","5","152","12.2","9.7"
"Lanier","2020-07-21","55","1397","6","158","12.6","9.2"
"Lanier","2020-07-22","25","1422","2","160","12.7","9.8"
"Lanier","2020-07-23","14","1436","0","160","5.6","8.2"
"Lanier","2020-07-24","17","1453","8","168","10.3","11.5"
"Lanier","2020-07-25","4","1457","1","169","13.9","13.3"
"Lanier","2020-07-26","0","1457","0","169","13.9","13.3"
"Lanier","2020-07-27","74","1531","8","177","14.5","13.4"
"Lanier","2020-07-28","36","1567","0","177","13","12.8"
"Lanier","2020-07-29","7","1574","2","179","15.9","14.3"
"Lanier","2020-07-30","13","1587","4","183","20.3","12.9"
"Lanier","2020-07-31","23","1610","2","185","14.8","12.6"
"Lanier","2020-08-01","4","1614","0","185","11.3","12.6"
"Lanier","2020-08-02","2","1616","0","185","11.3","12.6"
"Lanier","2020-08-03","58","1674","3","188","10.5","12.5"
"Lanier","2020-08-04","26","1700","5","193","13.2","13.1"
"Lanier","2020-08-05","11","1711","2","195","11.7","13.8"
"Lanier","2020-08-06","6","1717","0","195","7.3","13.8"
"Lanier","2020-08-07","9","1726","1","196","7.7","11.3"
"Lanier","2020-08-08","2","1728","0","196","7.7","9.5"
"Lanier","2020-08-09","5","1733","2","198","13.4","12.3"
"Lanier","2020-08-10","35","1768","7","205","15.5","13"
"Lanier","2020-08-11","38","1806","4","209","14.3","13.7"
"Lanier","2020-08-12","4","1810","1","210","15.2","13.5"
"Lanier","2020-08-13","13","1823","2","212","17.4","12.4"
"Lanier","2020-08-14","13","1836","3","215","19.1","13.4"
"Lanier","2020-08-15","2","1838","0","215","19.1","13.4"
"Lanier","2020-08-16","1","1839","0","215","13.4","13.4"
"Lanier","2020-08-17","28","1867","7","222","14.1","14.8"
"Lanier","2020-08-18","31","1898","2","224","13.6","13.9"
"Lanier","2020-08-19","10","1908","4","228","15.7","15.5"
"Lanier","2020-08-20","17","1925","0","228","13.5","15.5"
"Lanier","2020-08-21","20","1945","2","230","11.6","15.4"
"Lanier","2020-08-22","1","1946","0","230","11.6","15.4"
"Lanier","2020-08-23","2","1948","0","230","11.6","12.5"
"Lanier","2020-08-24","28","1976","0","230","8.1","11.1"
"Lanier","2020-08-25","17","1993","1","231","8","10.8"
"Lanier","2020-08-26","12","2005","0","231","2.3","9"
"Lanier","2020-08-27","12","2017","0","231","2.3","7.9"
"Lanier","2020-08-28","27","2044","16","247","9.3","10.5"
"Lanier","2020-08-29","3","2047","0","247","9.3","10.5"
"Lanier","2020-08-30","8","2055","4","251","16.4","14"
"Lanier","2020-08-31","30","2085","2","253","17.4","12.7"
"Lanier","2020-09-01","25","2110","4","257","18.8","13.4"
"Lanier","2020-09-02","18","2128","1","258","19.6","11"
"Lanier","2020-09-03","6","2134","2","260","24.4","13.3"
"Lanier","2020-09-04","20","2154","0","260","15.9","12.6"
"Lanier","2020-09-05","6","2160","2","262","20.7","15"
"Lanier","2020-09-06","2","2162","0","262","13.6","15"
"Lanier","2020-09-07","3","2165","0","262","12.6","15"
"Lanier","2020-09-08","65","2230","5","267","11.4","15.1"
"Lanier","2020-09-09","27","2257","4","271","12.7","16.2"
"Lanier","2020-09-10","6","2263","4","275","17.5","21"
"Lanier","2020-09-11","6","2269","0","275","17.5","16.7"
"Lanier","2020-09-12","1","2270","0","275","12.7","16.7"
"Lanier","2020-09-13","1","2271","0","275","12.7","13.1"
"Lanier","2020-09-14","35","2306","5","280","14.8","13.7"
"Lanier","2020-09-15","14","2320","0","280","13.7","12.5"
"Lanier","2020-09-16","9","2329","1","281","13.2","12.9"
"Lanier","2020-09-17","14","2343","0","281","3.6","10.6"
"Lanier","2020-09-18","9","2352","0","281","3.6","10.6"
"Lanier","2020-09-19","2","2354","0","281","3.6","8.2"
"Lanier","2020-09-20","4","2358","0","281","3.6","8.2"
"Lanier","2020-09-21","22","2380","1","282","2.2","8.5"
"Lanier","2020-09-22","17","2397","0","282","2.2","8"
"Lanier","2020-09-23","8","2405","3","285","6","9.6"
"Lanier","2020-09-24","4","2409","0","285","6","4.8"
"Lanier","2020-09-25","2","2411","0","285","6","4.8"
"Lanier","2020-09-26","1","2412","0","285","6","4.8"
"Lanier","2020-09-27","2","2414","0","285","6","4.8"
"Lanier","2020-09-28","10","2424","1","286","6.8","4.5"
"Lanier","2020-09-29","7","2431","0","286","6.8","4.5"
"Lanier","2020-09-30","4","2435","0","286","1.4","3.7"
"Lanier","2020-10-01","5","2440","0","286","1.4","3.7"
"Lanier","2020-10-02","11","2451","1","287","2.7","4.4"
"Lanier","2020-10-03","1","2452","0","287","2.7","4.4"
"Lanier","2020-10-04","0","2452","0","287","2.7","4.4"
"Lanier","2020-10-05","19","2471","0","287","1.3","4"
"Lanier","2020-10-06","6","2477","0","287","1.3","4"
"Lanier","2020-10-07","21","2498","0","287","1.3","1.4"
"Lanier","2020-10-08","15","2513","6","293","7","4.2"
"Lanier","2020-10-09","10","2523","2","295","8.6","5.6"
"Lanier","2020-10-10","2","2525","0","295","8.6","5.6"
"Lanier","2020-10-11","0","2525","0","295","8.6","5.6"
"Lanier","2020-10-12","11","2536","0","295","8.6","4.9"
"Lanier","2020-10-13","14","2550","0","295","8.6","4.9"
"Lanier","2020-10-14","9","2559","0","295","8.6","4.9"
"Lanier","2020-10-15","6","2565","0","295","2.9","4.9"
"Lanier","2020-10-16","12","2577","0","295","0","4.3"
"Lanier","2020-10-17","4","2581","0","295","0","4.3"
"Lanier","2020-10-18","2","2583","0","295","0","4.3"
"Lanier","2020-10-19","22","2605","0","295","0","4.3"
"Lanier","2020-10-20","20","2625","2","297","1.4","5"
"Lanier","2020-10-21","6","2631","0","297","1.4","5"
"Lanier","2020-10-22","6","2637","0","297","1.4","2.1"
"Lanier","2020-10-23","5","2642","0","297","1.4","0.7"
"Lanier","2020-10-24","2","2644","1","298","8.6","4.3"
"Lanier","2020-10-25","6","2650","2","300","13.3","6.7"
"Lanier","2020-10-26","18","2668","1","301","14.1","7.1"
"Lanier","2020-10-27","15","2683","0","301","12.7","7.1"
"Lanier","2020-10-28","6","2689","0","301","12.7","7.1"
"Lanier","2020-10-29","7","2696","0","301","12.7","7.1"
"Lanier","2020-10-30","9","2705","0","301","12.7","7.1"
"Lanier","2020-10-31","7","2712","0","301","5.6","7.1"
"Lanier","2020-11-01","2","2714","0","301","0.8","7.1"
"Lanier","2020-11-02","8","2722","1","302","1.8","8"
"Lanier","2020-11-03","16","2738","0","302","1.8","7.2"
"Lanier","2020-11-04","6","2744","0","302","1.8","7.2"
"Lanier","2020-11-05","7","2751","2","304","5.9","9.3"
"Lanier","2020-11-06","11","2762","2","306","8.5","10.6"
"Lanier","2020-11-07","0","2762","0","306","8.5","7"
"Lanier","2020-11-08","1","2763","0","306","8.5","4.6"
"Lanier","2020-11-09","11","2774","2","308","9.3","5.5"
"Lanier","2020-11-10","15","2789","0","308","9.3","5.5"
"Lanier","2020-11-11","11","2800","0","308","9.3","5.5"
"Lanier","2020-11-12","7","2807","0","308","5.2","5.5"
"Lanier","2020-11-13","5","2812","0","308","2.6","5.5"
"Lanier","2020-11-14","3","2815","1","309","7.4","7.9"
"Lanier","2020-11-15","1","2816","1","310","21.6","15.1"
"Lanier","2020-11-16","16","2832","0","310","19","14.2"
"Lanier","2020-11-17","9","2841","0","310","19","14.2"
"Lanier","2020-11-18","9","2850","1","311","20.6","15"
"Lanier","2020-11-19","9","2859","1","312","22.2","13.7"
"Lanier","2020-11-20","3","2862","0","312","22.2","12.4"
"Lanier","2020-11-21","1","2863","0","312","17.5","12.4"
"Lanier","2020-11-22","5","2868","1","313","6","13.8"
"Lanier","2020-11-23","8","2876","2","315","9.6","14.3"
"Lanier","2020-11-24","26","2902","1","316","10.2","14.6"
"Lanier","2020-11-25","11","2913","1","317","9.9","15.2"
"Lanier","2020-11-26","0","2913","0","317","8.3","15.2"
"Lanier","2020-11-27","4","2917","0","317","8.3","15.2"
"Lanier","2020-11-28","2","2919","0","317","8.3","12.9"
"Lanier","2020-11-29","1","2920","0","317","5.4","5.7"
"Lanier","2020-11-30","19","2939","5","322","5.6","7.6"
"Lanier","2020-12-01","10","2949","1","323","6.5","8.3"
"Lanier","2020-12-02","5","2954","0","323","5.2","7.5"
"Lanier","2020-12-03","3","2957","1","324","9.9","9.1"
"Lanier","2020-12-04","8","2965","0","324","9.9","9.1"
"Lanier","2020-12-05","4","2969","0","324","9.9","9.1"
"Lanier","2020-12-06","0","2969","0","324","9.9","7.7"
"Lanier","2020-12-07","34","3003","5","329","8.3","6.9"
"Lanier","2020-12-08","10","3013","2","331","9.7","8.1"
"Lanier","2020-12-09","10","3023","0","331","9.7","7.5"
"Lanier","2020-12-10","8","3031","1","332","6.7","8.3"
"Lanier","2020-12-11","16","3047","4","336","10.3","10.1"
"Lanier","2020-12-12","3","3050","1","337","15.1","12.5"
"Lanier","2020-12-13","4","3054","0","337","15.1","12.5"
"Lanier","2020-12-14","24","3078","3","340","14.8","11.5"
"Lanier","2020-12-15","9","3087","1","341","13.5","11.6"
"Lanier","2020-12-16","14","3101","2","343","15.5","12.6"
"Lanier","2020-12-17","11","3112","1","344","15","10.9"
"Lanier","2020-12-18","8","3120","0","344","11.5","10.9"
"Lanier","2020-12-19","9","3129","2","346","9.9","12.5"
"Lanier","2020-12-20","4","3133","1","347","13.5","14.3"
"Lanier","2020-12-21","39","3172","3","350","12.8","13.8"
"Lanier","2020-12-22","10","3182","2","352","14","13.8"
"Lanier","2020-12-23","11","3193","3","355","15.9","15.7"
"Lanier","2020-12-24","4","3197","0","355","14.6","14.8"
"Lanier","2020-12-25","1","3198","0","355","14.6","13"
"Lanier","2020-12-26","10","3208","4","359","17.1","13.5"
"Lanier","2020-12-27","5","3213","2","361","19.3","16.4"
"Lanier","2020-12-28","34","3247","10","371","22.4","17.6"
"Lanier","2020-12-29","14","3261","3","374","22.6","18.3"
"Lanier","2020-12-30","11","3272","4","378","23.9","19.9"
"Lanier","2020-12-31","4","3276","0","378","23.9","19.2"
"Lanier","2021-01-01","0","3276","0","378","23.9","19.2"
"Lanier","2021-01-02","2","3278","0","378","18.2","17.7"
"Lanier","2021-01-03","3","3281","2","380","22","20.6"
"Lanier","2021-01-04","18","3299","6","386","22.5","22.5"
"Lanier","2021-01-05","9","3308","1","387","21.1","21.8"
"Lanier","2021-01-06","14","3322","3","390","18.9","21.4"
"Lanier","2021-01-07","7","3329","0","390","18.9","21.4"
"Lanier","2021-01-08","12","3341","2","392","21.3","22.6"
"Lanier","2021-01-09","3","3344","2","394","30.8","24.5"
"Lanier","2021-01-10","1","3345","0","394","21.3","21.6"
"Lanier","2021-01-11","27","3372","5","399","19.2","20.9"
"Lanier","2021-01-12","12","3384","1","400","18.8","19.9"
"Lanier","2021-01-13","10","3394","1","401","17.2","18.1"
"Lanier","2021-01-14","11","3405","1","402","18.5","18.7"
"Lanier","2021-01-15","9","3414","1","403","17.7","19.5"
"Lanier","2021-01-16","3","3417","0","403","8.2","19.5"
"Lanier","2021-01-17","3","3420","2","405","17.7","19.5"
"Lanier","2021-01-18","12","3432","4","409","19.8","19.5"
"Lanier","2021-01-19","10","3442","3","412","22.9","20.8"
"Lanier","2021-01-20","13","3455","1","413","22.6","19.9"
"Lanier","2021-01-21","25","3480","3","416","23","20.7"
"Lanier","2021-01-22","11","3491","0","416","21.4","19.5"
"Lanier","2021-01-23","4","3495","1","417","25","16.6"
"Lanier","2021-01-24","4","3499","1","418","19","18.3"
"Lanier","2021-01-25","7","3506","0","418","14.2","17"
"Lanier","2021-01-26","3","3509","1","419","14.7","18.8"
"Lanier","2021-01-27","0","3509","0","419","13.6","18.1"
"Laurens","2020-02-01","0","0","0","0",".","."
"Laurens","2020-02-02","0","0","0","0",".","."
"Laurens","2020-02-03","0","0","0","0",".","."
"Laurens","2020-02-04","0","0","0","0",".","."
"Laurens","2020-02-05","0","0","0","0",".","."
"Laurens","2020-02-06","0","0","0","0",".","."
"Laurens","2020-02-07","0","0","0","0","0","."
"Laurens","2020-02-08","0","0","0","0","0","."
"Laurens","2020-02-09","0","0","0","0","0","."
"Laurens","2020-02-10","0","0","0","0","0","."
"Laurens","2020-02-11","0","0","0","0","0","."
"Laurens","2020-02-12","0","0","0","0","0","."
"Laurens","2020-02-13","0","0","0","0","0","."
"Laurens","2020-02-14","0","0","0","0","0","0"
"Laurens","2020-02-15","0","0","0","0","0","0"
"Laurens","2020-02-16","0","0","0","0","0","0"
"Laurens","2020-02-17","0","0","0","0","0","0"
"Laurens","2020-02-18","0","0","0","0","0","0"
"Laurens","2020-02-19","0","0","0","0","0","0"
"Laurens","2020-02-20","0","0","0","0","0","0"
"Laurens","2020-02-21","0","0","0","0","0","0"
"Laurens","2020-02-22","0","0","0","0","0","0"
"Laurens","2020-02-23","0","0","0","0","0","0"
"Laurens","2020-02-24","0","0","0","0","0","0"
"Laurens","2020-02-25","0","0","0","0","0","0"
"Laurens","2020-02-26","0","0","0","0","0","0"
"Laurens","2020-02-27","0","0","0","0","0","0"
"Laurens","2020-02-28","0","0","0","0","0","0"
"Laurens","2020-02-29","0","0","0","0","0","0"
"Laurens","2020-03-01","0","0","0","0","0","0"
"Laurens","2020-03-02","0","0","0","0","0","0"
"Laurens","2020-03-03","0","0","0","0","0","0"
"Laurens","2020-03-04","0","0","0","0","0","0"
"Laurens","2020-03-05","0","0","0","0","0","0"
"Laurens","2020-03-06","1","1","0","0","0","0"
"Laurens","2020-03-07","0","1","0","0","0","0"
"Laurens","2020-03-08","0","1","0","0","0","0"
"Laurens","2020-03-09","1","2","0","0","0","0"
"Laurens","2020-03-10","0","2","0","0","0","0"
"Laurens","2020-03-11","0","2","0","0","0","0"
"Laurens","2020-03-12","2","4","0","0","0","0"
"Laurens","2020-03-13","1","5","0","0","0","0"
"Laurens","2020-03-14","0","5","0","0","0","0"
"Laurens","2020-03-15","2","7","1","1","7.1","3.6"
"Laurens","2020-03-16","2","9","0","1","7.1","3.6"
"Laurens","2020-03-17","7","16","1","2","9.2","4.6"
"Laurens","2020-03-18","2","18","1","3","16.3","8.2"
"Laurens","2020-03-19","13","31","1","4","17.4","8.7"
"Laurens","2020-03-20","38","69","6","10","19.7","9.8"
"Laurens","2020-03-21","0","69","0","10","19.7","9.8"
"Laurens","2020-03-22","2","71","0","10","12.5","9.8"
"Laurens","2020-03-23","39","110","1","11","12.9","10"
"Laurens","2020-03-24","79","189","6","17","11.9","10.6"
"Laurens","2020-03-25","47","236","3","20","5.7","11"
"Laurens","2020-03-26","24","260","3","23","6.4","11.9"
"Laurens","2020-03-27","18","278","1","24","4.9","12.3"
"Laurens","2020-03-28","13","291","2","26","7.1","13.4"
"Laurens","2020-03-29","0","291","0","26","7.1","9.8"
"Laurens","2020-03-30","43","334","8","34","9.4","11.2"
"Laurens","2020-03-31","24","358","2","36","9.5","10.7"
"Laurens","2020-04-01","24","382","2","38","9.8","7.8"
"Laurens","2020-04-02","22","404","3","41","10","8.2"
"Laurens","2020-04-03","21","425","3","44","11.2","8.1"
"Laurens","2020-04-04","8","433","2","46","12.6","9.9"
"Laurens","2020-04-05","5","438","0","46","12.6","9.9"
"Laurens","2020-04-06","20","458","2","48","11.4","10.4"
"Laurens","2020-04-07","31","489","7","55","13.4","11.5"
"Laurens","2020-04-08","23","512","3","58","14.1","11.9"
"Laurens","2020-04-09","24","536","2","60","13.3","11.6"
"Laurens","2020-04-10","25","561","3","63","13","12.1"
"Laurens","2020-04-11","9","570","2","65","12.6","12.6"
"Laurens","2020-04-12","6","576","1","66","15","13.8"
"Laurens","2020-04-13","38","614","8","74","16.6","14"
"Laurens","2020-04-14","24","638","0","74","13.3","13.4"
"Laurens","2020-04-15","44","682","6","80","13.4","13.7"
"Laurens","2020-04-16","59","741","4","84","13.2","13.3"
"Laurens","2020-04-17","32","773","1","85","11.9","12.5"
"Laurens","2020-04-18","22","795","4","89","11.3","12"
"Laurens","2020-04-19","1","796","0","89","9","12"
"Laurens","2020-04-20","31","827","3","92","7.3","11.9"
"Laurens","2020-04-21","28","855","0","92","7.3","10.3"
"Laurens","2020-04-22","30","885","0","92","5.4","9.4"
"Laurens","2020-04-23","23","908","2","94","5.7","9.4"
"Laurens","2020-04-24","71","979","3","97","5.8","8.9"
"Laurens","2020-04-25","47","1026","2","99","3.8","7.6"
"Laurens","2020-04-26","2","1028","0","99","3.8","6.4"
"Laurens","2020-04-27","31","1059","1","100","2.9","5.1"
"Laurens","2020-04-28","34","1093","1","101","3.3","5.3"
"Laurens","2020-04-29","39","1132","5","106","5.2","5.3"
"Laurens","2020-04-30","40","1172","3","109","5","5.3"
"Laurens","2020-05-01","57","1229","3","112","5.1","5.5"
"Laurens","2020-05-02","28","1257","0","112","4.5","4.2"
"Laurens","2020-05-03","154","1411","4","116","4.9","4.4"
"Laurens","2020-05-04","105","1516","2","118","4.7","3.8"
"Laurens","2020-05-05","60","1576","1","119","4.5","3.9"
"Laurens","2020-05-06","173","1749","3","122","3","4.1"
"Laurens","2020-05-07","52","1801","5","127","3.3","4.1"
"Laurens","2020-05-08","79","1880","12","139","4.7","4.9"
"Laurens","2020-05-09","87","1967","1","140","4.8","4.7"
"Laurens","2020-05-10","1","1968","0","140","4.5","4.7"
"Laurens","2020-05-11","97","2065","7","147","5.2","5"
"Laurens","2020-05-12","46","2111","0","147","5","4.8"
"Laurens","2020-05-13","88","2199","3","150","5.2","4.1"
"Laurens","2020-05-14","83","2282","3","153","4.4","3.8"
"Laurens","2020-05-15","82","2364","0","153","2.2","3.4"
"Laurens","2020-05-16","39","2403","1","154","2.4","3.6"
"Laurens","2020-05-17","24","2427","2","156","3.6","4"
"Laurens","2020-05-18","99","2526","4","160","3.1","4.2"
"Laurens","2020-05-19","86","2612","2","162","3.5","4.2"
"Laurens","2020-05-20","71","2683","1","163","3.2","4.2"
"Laurens","2020-05-21","41","2724","1","164","3","3.7"
"Laurens","2020-05-22","21","2745","0","164","3","2.6"
"Laurens","2020-05-23","13","2758","0","164","2.6","2.5"
"Laurens","2020-05-24","11","2769","0","164","1.5","2.5"
"Laurens","2020-05-25","13","2782","1","165","2","2.6"
"Laurens","2020-05-26","76","2858","0","165","1.6","2.6"
"Laurens","2020-05-27","29","2887","1","166","1.9","2.6"
"Laurens","2020-05-28","37","2924","1","167","2","2.5"
"Laurens","2020-05-29","86","3010","2","169","2.3","2.7"
"Laurens","2020-05-30","16","3026","0","169","2.3","2.5"
"Laurens","2020-05-31","4","3030","0","169","2.3","1.9"
"Laurens","2020-06-01","43","3073","1","170","1.5","1.8"
"Laurens","2020-06-02","50","3123","3","173","2.4","2"
"Laurens","2020-06-03","24","3147","2","175","3.1","2.5"
"Laurens","2020-06-04","36","3183","4","179","4.3","3.1"
"Laurens","2020-06-05","26","3209","2","181","5.1","3.7"
"Laurens","2020-06-06","9","3218","1","182","6.7","4.5"
"Laurens","2020-06-07","3","3221","0","182","6.7","4.5"
"Laurens","2020-06-08","24","3245","2","184","7.5","4.5"
"Laurens","2020-06-09","37","3282","2","186","7.4","4.9"
"Laurens","2020-06-10","16","3298","2","188","8","5.6"
"Laurens","2020-06-11","42","3340","6","194","8.5","6.4"
"Laurens","2020-06-12","29","3369","4","198","9.3","7.2"
"Laurens","2020-06-13","35","3404","2","200","8.6","7.6"
"Laurens","2020-06-14","5","3409","1","201","11.4","9"
"Laurens","2020-06-15","96","3505","8","209","11.4","9.5"
"Laurens","2020-06-16","85","3590","2","211","11","9.2"
"Laurens","2020-06-17","52","3642","4","215","10.3","9.2"
"Laurens","2020-06-18","138","3780","5","220","8.8","8.6"
"Laurens","2020-06-19","47","3827","2","222","7.4","8.4"
"Laurens","2020-06-20","64","3891","3","225","7.3","7.9"
"Laurens","2020-06-21","1","3892","0","225","4.4","7.9"
"Laurens","2020-06-22","110","4002","14","239","5","8.2"
"Laurens","2020-06-23","109","4111","6","245","5.5","8.2"
"Laurens","2020-06-24","254","4365","11","256","5","7.7"
"Laurens","2020-06-25","201","4566","16","272","5.6","7.2"
"Laurens","2020-06-26","188","4754","16","288","6.2","6.8"
"Laurens","2020-06-27","211","4965","18","306","6.8","7"
"Laurens","2020-06-28","15","4980","6","312","12.5","8.5"
"Laurens","2020-06-29","333","5313","20","332","11.5","8.3"
"Laurens","2020-06-30","277","5590","24","356","12","8.7"
"Laurens","2020-07-01","245","5835","25","381","12.8","8.9"
"Laurens","2020-07-02","278","6113","33","414","13.4","9.5"
"Laurens","2020-07-03","226","6339","16","430","13.2","9.7"
"Laurens","2020-07-04","95","6434","12","442","13.8","10.3"
"Laurens","2020-07-05","17","6451","8","450","14.8","13.6"
"Laurens","2020-07-06","295","6746","62","512","16.9","14.2"
"Laurens","2020-07-07","387","7133","24","536","16.6","14.3"
"Laurens","2020-07-08","322","7455","45","581","17.1","15"
"Laurens","2020-07-09","205","7660","28","609","17.4","15.4"
"Laurens","2020-07-10","320","7980","37","646","18","15.6"
"Laurens","2020-07-11","168","8148","16","662","17.6","15.7"
"Laurens","2020-07-12","3","8151","2","664","20.4","17.6"
"Laurens","2020-07-13","277","8428","22","686","18.5","17.7"
"Laurens","2020-07-14","264","8692","34","720","19.5","18"
"Laurens","2020-07-15","286","8978","26","746","18.8","17.9"
"Laurens","2020-07-16","314","9292","21","767","17.8","17.6"
"Laurens","2020-07-17","311","9603","33","800","17.6","17.8"
"Laurens","2020-07-18","105","9708","14","814","18.2","17.9"
"Laurens","2020-07-19","12","9720","1","815","9.8","15.1"
"Laurens","2020-07-20","232","9952","31","846","10.6","14.6"
"Laurens","2020-07-21","227","10179","23","869","10.2","14.8"
"Laurens","2020-07-22","186","10365","23","892","10.7","14.7"
"Laurens","2020-07-23","232","10597","22","914","11.1","14.4"
"Laurens","2020-07-24","201","10798","20","934","11","14.3"
"Laurens","2020-07-25","122","10920","7","941","9.9","14"
"Laurens","2020-07-26","6","10926","1","942","11.1","10.5"
"Laurens","2020-07-27","379","11305","48","990","11","10.8"
"Laurens","2020-07-28","213","11518","43","1033","12.4","11.3"
"Laurens","2020-07-29","218","11736","25","1058","12.3","11.5"
"Laurens","2020-07-30","167","11903","28","1086","13.3","12.2"
"Laurens","2020-07-31","359","12262","49","1135","13.9","12.4"
"Laurens","2020-08-01","22","12284","3","1138","15","12.5"
"Laurens","2020-08-02","11","12295","2","1140","15.2","13.2"
"Laurens","2020-08-03","244","12539","29","1169","15.1","13.1"
"Laurens","2020-08-04","214","12753","57","1226","16","14.2"
"Laurens","2020-08-05","312","13065","54","1280","16.9","14.6"
"Laurens","2020-08-06","205","13270","34","1314","16.8","15.1"
"Laurens","2020-08-07","463","13733","119","1433","18.6","16.2"
"Laurens","2020-08-08","104","13837","14","1447","18.5","16.8"
"Laurens","2020-08-09","4","13841","2","1449","23.1","19.2"
"Laurens","2020-08-10","256","14097","33","1482","23.2","19.2"
"Laurens","2020-08-11","213","14310","17","1499","20.6","18.3"
"Laurens","2020-08-12","285","14595","26","1525","19.4","18.1"
"Laurens","2020-08-13","161","14756","21","1546","18.9","17.9"
"Laurens","2020-08-14","273","15029","27","1573","16.6","17.6"
"Laurens","2020-08-15","100","15129","11","1584","16.3","17.4"
"Laurens","2020-08-16","10","15139","2","1586","12","17.5"
"Laurens","2020-08-17","27","15166","6","1592","13.3","18.3"
"Laurens","2020-08-18","175","15341","20","1612","13.8","17.2"
"Laurens","2020-08-19","169","15510","20","1632","14.2","16.8"
"Laurens","2020-08-20","141","15651","29","1661","15.3","17.1"
"Laurens","2020-08-21","229","15880","13","1674","14.7","15.7"
"Laurens","2020-08-22","111","15991","18","1692","15.4","15.8"
"Laurens","2020-08-23","20","16011","7","1699","17.6","14.8"
"Laurens","2020-08-24","241","16252","33","1732","16.3","14.8"
"Laurens","2020-08-25","172","16424","25","1757","16.8","15.3"
"Laurens","2020-08-26","183","16607","25","1782","17","15.6"
"Laurens","2020-08-27","176","16783","22","1804","15.9","15.6"
"Laurens","2020-08-28","297","17080","25","1829","16.3","15.5"
"Laurens","2020-08-29","129","17209","18","1847","16","15.7"
"Laurens","2020-08-30","29","17238","2","1849","12","14.8"
"Laurens","2020-08-31","189","17427","21","1870","11.6","14"
"Laurens","2020-09-01","185","17612","18","1888","10.9","13.8"
"Laurens","2020-09-02","156","17768","21","1909","10.9","14"
"Laurens","2020-09-03","221","17989","27","1936","10.8","13.4"
"Laurens","2020-09-04","268","18257","85","2021","14.2","15.2"
"Laurens","2020-09-05","79","18336","16","2037","15.1","15.5"
"Laurens","2020-09-06","13","18349","3","2040","17.4","14.7"
"Laurens","2020-09-07","65","18414","18","2058","19.7","15.7"
"Laurens","2020-09-08","340","18754","17","2075","19.1","15"
"Laurens","2020-09-09","150","18904","10","2085","18.1","14.5"
"Laurens","2020-09-10","371","19275","21","2106","17.2","14"
"Laurens","2020-09-11","246","19521","33","2139","14.5","14.3"
"Laurens","2020-09-12","74","19595","4","2143","12.4","13.7"
"Laurens","2020-09-13","8","19603","1","2144","10.9","14.1"
"Laurens","2020-09-14","283","19886","20","2164","8","13.8"
"Laurens","2020-09-15","245","20131","14","2178","8.1","13.6"
"Laurens","2020-09-16","282","20413","22","2200","8.2","13.2"
"Laurens","2020-09-17","292","20705","17","2217","8.2","12.7"
"Laurens","2020-09-18","248","20953","16","2233","7.3","10.9"
"Laurens","2020-09-19","98","21051","7","2240","7.5","10"
"Laurens","2020-09-20","16","21067","3","2243","8.4","9.6"
"Laurens","2020-09-21","275","21342","20","2263","8.4","8.2"
"Laurens","2020-09-22","352","21694","14","2277","8.2","8.1"
"Laurens","2020-09-23","215","21909","20","2297","8.4","8.3"
"Laurens","2020-09-24","485","22394","15","2312","8","8.1"
"Laurens","2020-09-25","112","22506","7","2319","8","7.6"
"Laurens","2020-09-26","99","22605","3","2322","7.4","7.4"
"Laurens","2020-09-27","10","22615","1","2323","6.1","7.3"
"Laurens","2020-09-28","183","22798","18","2341","6.5","7.5"
"Laurens","2020-09-29","426","23224","20","2361","6.6","7.4"
"Laurens","2020-09-30","187","23411","22","2383","7","7.7"
"Laurens","2020-10-01","436","23847","31","2414","7.5","7.8"
"Laurens","2020-10-02","183","24030","22","2436","8.4","8.2"
"Laurens","2020-10-03","102","24132","11","2447","9.5","8.4"
"Laurens","2020-10-04","22","24154","4","2451","10.6","8.4"
"Laurens","2020-10-05","278","24432","28","2479","10.7","8.6"
"Laurens","2020-10-06","321","24753","32","2511","11.4","9"
"Laurens","2020-10-07","398","25151","30","2541","10.8","8.9"
"Laurens","2020-10-08","197","25348","18","2559","11.1","9.3"
"Laurens","2020-10-09","248","25596","27","2586","10.9","9.6"
"Laurens","2020-10-10","101","25697","13","2599","11.2","10.3"
"Laurens","2020-10-11","16","25713","4","2603","12.2","11.4"
"Laurens","2020-10-12","168","25881","24","2627","12.8","11.7"
"Laurens","2020-10-13","335","26216","22","2649","12.3","11.9"
"Laurens","2020-10-14","265","26481","19","2668","12.3","11.5"
"Laurens","2020-10-15","224","26705","12","2680","11.7","11.4"
"Laurens","2020-10-16","171","26876","17","2697","11.6","11.3"
"Laurens","2020-10-17","66","26942","9","2706","11.7","11.5"
"Laurens","2020-10-18","10","26952","3","2709","12.4","12.3"
"Laurens","2020-10-19","291","27243","35","2744","12.1","12.5"
"Laurens","2020-10-20","261","27504","16","2760","12","12.2"
"Laurens","2020-10-21","284","27788","18","2778","11.9","12.1"
"Laurens","2020-10-22","110","27898","11","2789","12.6","12.2"
"Laurens","2020-10-23","152","28050","20","2809","13","12.3"
"Laurens","2020-10-24","73","28123","11","2820","13.2","12.5"
"Laurens","2020-10-25","15","28138","3","2823","11.8","12.1"
"Laurens","2020-10-26","221","28359","28","2851","11.9","12"
"Laurens","2020-10-27","201","28560","10","2861","11.7","11.9"
"Laurens","2020-10-28","223","28783","21","2882","12.2","12.1"
"Laurens","2020-10-29","282","29065","32","2914","12.4","12.5"
"Laurens","2020-10-30","124","29189","11","2925","11.8","12.4"
"Laurens","2020-10-31","73","29262","12","2937","12","12.6"
"Laurens","2020-11-01","15","29277","5","2942","13.9","12.8"
"Laurens","2020-11-02","192","29469","26","2968","14","12.9"
"Laurens","2020-11-03","342","29811","23","2991","14.2","13"
"Laurens","2020-11-04","131","29942","6","2997","13.5","12.9"
"Laurens","2020-11-05","235","30177","19","3016","13.1","12.7"
"Laurens","2020-11-06","85","30262","0","3016","11.8","11.8"
"Laurens","2020-11-07","57","30319","8","3024","11.5","11.7"
"Laurens","2020-11-08","10","30329","2","3026","9.6","11.7"
"Laurens","2020-11-09","200","30529","8","3034","8.2","11.1"
"Laurens","2020-11-10","343","30872","21","3055","8.1","11.2"
"Laurens","2020-11-11","114","30986","7","3062","8.3","10.9"
"Laurens","2020-11-12","286","31272","19","3081","8.1","10.6"
"Laurens","2020-11-13","110","31382","6","3087","8.9","10.4"
"Laurens","2020-11-14","40","31422","3","3090","8","9.7"
"Laurens","2020-11-15","15","31437","2","3092","7","8.3"
"Laurens","2020-11-16","205","31642","9","3101","7.1","7.6"
"Laurens","2020-11-17","221","31863","3","3104","6.4","7.3"
"Laurens","2020-11-18","159","32022","17","3121","7.1","7.7"
"Laurens","2020-11-19","100","32122","6","3127","7","7.5"
"Laurens","2020-11-20","141","32263","10","3137","7.2","8.1"
"Laurens","2020-11-21","21","32284","4","3141","8.8","8.4"
"Laurens","2020-11-22","16","32300","6","3147","12.3","9.7"
"Laurens","2020-11-23","469","32769","16","3163","12.2","9.6"
"Laurens","2020-11-24","42","32811","3","3166","13","9.7"
"Laurens","2020-11-25","92","32903","8","3174","12.7","9.9"
"Laurens","2020-11-26","7","32910","3","3177","18","12.5"
"Laurens","2020-11-27","76","32986","12","3189","19.2","13.2"
"Laurens","2020-11-28","22","33008","6","3195","20.4","14.6"
"Laurens","2020-11-29","14","33022","2","3197","17.1","14.7"
"Laurens","2020-11-30","198","33220","18","3215","17.9","15"
"Laurens","2020-12-01","244","33464","11","3226","17.5","15.2"
"Laurens","2020-12-02","307","33771","47","3273","18.4","15.6"
"Laurens","2020-12-03","192","33963","7","3280","12.8","15.4"
"Laurens","2020-12-04","163","34126","17","3297","12.1","15.6"
"Laurens","2020-12-05","29","34155","10","3307","13.1","16.7"
"Laurens","2020-12-06","19","34174","2","3309","12.6","14.8"
"Laurens","2020-12-07","325","34499","13","3322","11.8","14.9"
"Laurens","2020-12-08","262","34761","16","3338","12.1","14.8"
"Laurens","2020-12-09","164","34925","12","3350","10.9","14.7"
"Laurens","2020-12-10","326","35251","28","3378","11.6","12.2"
"Laurens","2020-12-11","235","35486","32","3410","12.1","12.1"
"Laurens","2020-12-12","27","35513","4","3414","9.3","11.2"
"Laurens","2020-12-13","34","35547","10","3424","12","12.3"
"Laurens","2020-12-14","474","36021","54","3478","13","12.4"
"Laurens","2020-12-15","461","36482","45","3523","13.6","12.8"
"Laurens","2020-12-16","293","36775","39","3562","14.4","12.7"
"Laurens","2020-12-17","334","37109","31","3593","14.5","13.1"
"Laurens","2020-12-18","316","37425","43","3636","14.5","13.3"
"Laurens","2020-12-19","34","37459","8","3644","15.8","12.5"
"Laurens","2020-12-20","115","37574","8","3652","12.5","12.3"
"Laurens","2020-12-21","683","38257","51","3703","12","12.5"
"Laurens","2020-12-22","350","38607","42","3745","12.3","12.9"
"Laurens","2020-12-23","250","38857","27","3772","11.9","13.2"
"Laurens","2020-12-24","31","38888","7","3779","13.8","14.2"
"Laurens","2020-12-25","10","38898","4","3783","17.6","16.1"
"Laurens","2020-12-26","38","38936","10","3793","18","16.9"
"Laurens","2020-12-27","23","38959","11","3804","23.9","18.2"
"Laurens","2020-12-28","625","39584","73","3877","24.5","18.2"
"Laurens","2020-12-29","536","40120","52","3929","24.1","18.2"
"Laurens","2020-12-30","394","40514","62","3991","24.8","18.4"
"Laurens","2020-12-31","281","40795","67","4058","25","19.4"
"Laurens","2021-01-01","7","40802","1","4059","21.3","19.5"
"Laurens","2021-01-02","45","40847","10","4069","20.8","19.4"
"Laurens","2021-01-03","19","40866","10","4079","21.4","22.6"
"Laurens","2021-01-04","168","41034","18","4097","21.3","22.9"
"Laurens","2021-01-05","693","41727","117","4214","22.3","23.2"
"Laurens","2021-01-06","253","41980","19","4233","21.2","23"
"Laurens","2021-01-07","383","42363","59","4292","20","22.5"
"Laurens","2021-01-08","69","42432","15","4307","21","21.2"
"Laurens","2021-01-09","54","42486","12","4319","21","20.9"
"Laurens","2021-01-10","26","42512","9","4328","18.4","19.9"
"Laurens","2021-01-11","167","42679","38","4366","20.2","20.7"
"Laurens","2021-01-12","440","43119","57","4423","19.6","21"
"Laurens","2021-01-13","67","43186","14","4437","21.5","21.3"
"Laurens","2021-01-14","111","43297","16","4453","21.4","20.7"
"Laurens","2021-01-15","68","43365","9","4462","20.2","20.6"
"Laurens","2021-01-16","45","43410","12","4474","20.8","20.9"
"Laurens","2021-01-17","27","43437","5","4479","18.5","18.5"
"Laurens","2021-01-18","143","43580","26","4505","17.8","19"
"Laurens","2021-01-19","366","43946","51","4556","18","18.8"
"Laurens","2021-01-20","46","43992","10","4566","18.1","19.8"
"Laurens","2021-01-21","100","44092","10","4576","17.5","19.4"
"Laurens","2021-01-22","52","44144","9","4585","18","19.1"
"Laurens","2021-01-23","33","44177","8","4593","17.7","19.2"
"Laurens","2021-01-24","38","44215","10","4603","18.8","18.7"
"Laurens","2021-01-25","39","44254","12","4615","20.6","19.2"
"Laurens","2021-01-26","7","44261","1","4616","20.7","19.3"
"Laurens","2021-01-27","0","44261","0","4616","17.6","17.8"
"Lee","2020-02-01","0","0","0","0",".","."
"Lee","2020-02-02","0","0","0","0",".","."
"Lee","2020-02-03","0","0","0","0",".","."
"Lee","2020-02-04","0","0","0","0",".","."
"Lee","2020-02-05","0","0","0","0",".","."
"Lee","2020-02-06","0","0","0","0",".","."
"Lee","2020-02-07","0","0","0","0","0","."
"Lee","2020-02-08","0","0","0","0","0","."
"Lee","2020-02-09","0","0","0","0","0","."
"Lee","2020-02-10","0","0","0","0","0","."
"Lee","2020-02-11","0","0","0","0","0","."
"Lee","2020-02-12","0","0","0","0","0","."
"Lee","2020-02-13","0","0","0","0","0","."
"Lee","2020-02-14","0","0","0","0","0","0"
"Lee","2020-02-15","0","0","0","0","0","0"
"Lee","2020-02-16","0","0","0","0","0","0"
"Lee","2020-02-17","0","0","0","0","0","0"
"Lee","2020-02-18","0","0","0","0","0","0"
"Lee","2020-02-19","0","0","0","0","0","0"
"Lee","2020-02-20","0","0","0","0","0","0"
"Lee","2020-02-21","0","0","0","0","0","0"
"Lee","2020-02-22","0","0","0","0","0","0"
"Lee","2020-02-23","0","0","0","0","0","0"
"Lee","2020-02-24","0","0","0","0","0","0"
"Lee","2020-02-25","0","0","0","0","0","0"
"Lee","2020-02-26","0","0","0","0","0","0"
"Lee","2020-02-27","0","0","0","0","0","0"
"Lee","2020-02-28","0","0","0","0","0","0"
"Lee","2020-02-29","0","0","0","0","0","0"
"Lee","2020-03-01","0","0","0","0","0","0"
"Lee","2020-03-02","0","0","0","0","0","0"
"Lee","2020-03-03","0","0","0","0","0","0"
"Lee","2020-03-04","0","0","0","0","0","0"
"Lee","2020-03-05","0","0","0","0","0","0"
"Lee","2020-03-06","0","0","0","0","0","0"
"Lee","2020-03-07","0","0","0","0","0","0"
"Lee","2020-03-08","1","1","1","1","14.3","7.1"
"Lee","2020-03-09","0","1","0","1","14.3","7.1"
"Lee","2020-03-10","0","1","0","1","14.3","7.1"
"Lee","2020-03-11","7","8","2","3","18.4","9.2"
"Lee","2020-03-12","4","12","1","4","21.9","11"
"Lee","2020-03-13","3","15","2","6","31.5","15.7"
"Lee","2020-03-14","2","17","1","7","38.6","19.3"
"Lee","2020-03-15","12","29","6","13","31.5","22.9"
"Lee","2020-03-16","21","50","9","22","37.6","25.9"
"Lee","2020-03-17","40","90","15","37","42.9","28.6"
"Lee","2020-03-18","18","108","3","40","41.2","29.8"
"Lee","2020-03-19","24","132","4","44","40.1","31"
"Lee","2020-03-20","42","174","12","56","34.6","33"
"Lee","2020-03-21","24","198","8","64","32.2","35.4"
"Lee","2020-03-22","17","215","7","71","31","31.2"
"Lee","2020-03-23","98","313","16","87","27.2","32.4"
"Lee","2020-03-24","103","416","25","112","25.3","34.1"
"Lee","2020-03-25","52","468","15","127","27","34.1"
"Lee","2020-03-26","59","527","15","142","28.3","34.2"
"Lee","2020-03-27","71","598","14","156","27","30.8"
"Lee","2020-03-28","37","635","11","167","26.5","29.4"
"Lee","2020-03-29","22","657","8","175","25.8","28.4"
"Lee","2020-03-30","62","719","16","191","27.2","27.2"
"Lee","2020-03-31","28","747","8","199","27.8","26.5"
"Lee","2020-04-01","65","812","24","223","28.9","28"
"Lee","2020-04-02","52","864","13","236","28.9","28.6"
"Lee","2020-04-03","33","897","10","246","30.4","28.7"
"Lee","2020-04-04","13","910","5","251","31.6","29.1"
"Lee","2020-04-05","18","928","8","259","32.8","29.3"
"Lee","2020-04-06","43","971","5","264","30.8","29"
"Lee","2020-04-07","32","1003","4","268","28.5","28.1"
"Lee","2020-04-08","27","1030","5","273","25.8","27.4"
"Lee","2020-04-09","21","1051","3","276","24.3","26.6"
"Lee","2020-04-10","31","1082","7","283","23.2","26.8"
"Lee","2020-04-11","10","1092","3","286","22","26.8"
"Lee","2020-04-12","2","1094","0","286","15.6","24.2"
"Lee","2020-04-13","37","1131","5","291","15.9","23.3"
"Lee","2020-04-14","41","1172","5","296","15.9","22.2"
"Lee","2020-04-15","40","1212","4","300","14.7","20.2"
"Lee","2020-04-16","42","1254","9","309","15.7","20"
"Lee","2020-04-17","36","1290","4","313","14","18.6"
"Lee","2020-04-18","12","1302","1","314","10.9","16.5"
"Lee","2020-04-19","11","1313","1","315","12.2","13.9"
"Lee","2020-04-20","22","1335","4","319","12.9","14.4"
"Lee","2020-04-21","25","1360","3","322","12.9","14.4"
"Lee","2020-04-22","26","1386","1","323","12","13.3"
"Lee","2020-04-23","42","1428","12","335","13","14.3"
"Lee","2020-04-24","66","1494","7","342","12.9","13.5"
"Lee","2020-04-25","17","1511","2","344","13.4","12.2"
"Lee","2020-04-26","12","1523","1","345","13.3","12.8"
"Lee","2020-04-27","27","1550","5","350","13.4","13.1"
"Lee","2020-04-28","36","1586","1","351","12.1","12.5"
"Lee","2020-04-29","46","1632","1","352","11.8","11.9"
"Lee","2020-04-30","63","1695","6","358","9.1","11.1"
"Lee","2020-05-01","60","1755","4","362","8.5","10.7"
"Lee","2020-05-02","39","1794","0","362","6.9","10.1"
"Lee","2020-05-03","26","1820","1","363","6.2","9.8"
"Lee","2020-05-04","62","1882","5","368","4.7","9"
"Lee","2020-05-05","56","1938","2","370","4.8","8.4"
"Lee","2020-05-06","63","2001","1","371","4.8","8.3"
"Lee","2020-05-07","47","2048","4","375","4.6","6.9"
"Lee","2020-05-08","36","2084","4","379","5.2","6.9"
"Lee","2020-05-09","14","2098","0","379","5.2","6"
"Lee","2020-05-10","5","2103","3","382","13.3","9.7"
"Lee","2020-05-11","32","2135","1","383","12.6","8.6"
"Lee","2020-05-12","32","2167","1","384","12.5","8.7"
"Lee","2020-05-13","40","2207","1","385","12.6","8.7"
"Lee","2020-05-14","56","2263","0","385","11.4","8"
"Lee","2020-05-15","46","2309","1","386","10.1","7.7"
"Lee","2020-05-16","8","2317","2","388","13.7","9.5"
"Lee","2020-05-17","16","2333","0","388","5.1","9.2"
"Lee","2020-05-18","79","2412","6","394","5.8","9.2"
"Lee","2020-05-19","69","2481","4","398","6.2","9.3"
"Lee","2020-05-20","49","2530","2","400","6.4","9.5"
"Lee","2020-05-21","101","2631","4","404","6.9","9.2"
"Lee","2020-05-22","61","2692","0","404","6.6","8.4"
"Lee","2020-05-23","21","2713","1","405","3.7","8.7"
"Lee","2020-05-24","12","2725","0","405","3.7","4.4"
"Lee","2020-05-25","49","2774","3","408","3.5","4.7"
"Lee","2020-05-26","70","2844","1","409","2.9","4.5"
"Lee","2020-05-27","48","2892","0","409","2.3","4.4"
"Lee","2020-05-28","75","2967","0","409","1.8","4.4"
"Lee","2020-05-29","44","3011","2","411","2.4","4.5"
"Lee","2020-05-30","16","3027","2","413","3.5","3.6"
"Lee","2020-05-31","17","3044","1","414","4.4","4"
"Lee","2020-06-01","38","3082","0","414","3.5","3.5"
"Lee","2020-06-02","44","3126","1","415","3.6","3.3"
"Lee","2020-06-03","86","3212","3","418","4.1","3.2"
"Lee","2020-06-04","53","3265","0","418","4.1","2.9"
"Lee","2020-06-05","55","3320","3","421","4.2","3.3"
"Lee","2020-06-06","11","3331","1","422","3.7","3.6"
"Lee","2020-06-07","15","3346","1","423","3.9","4.1"
"Lee","2020-06-08","40","3386","2","425","4.6","4"
"Lee","2020-06-09","32","3418","1","426","4.7","4.1"
"Lee","2020-06-10","64","3482","1","427","4.4","4.3"
"Lee","2020-06-11","30","3512","1","428","4.9","4.5"
"Lee","2020-06-12","37","3549","2","430","4.9","4.6"
"Lee","2020-06-13","9","3558","1","431","5.2","4.5"
"Lee","2020-06-14","6","3564","0","431","4.2","4"
"Lee","2020-06-15","42","3606","2","433","4.2","4.4"
"Lee","2020-06-16","42","3648","4","437","5.1","4.9"
"Lee","2020-06-17","58","3706","0","437","4.9","4.6"
"Lee","2020-06-18","28","3734","1","438","4.9","4.9"
"Lee","2020-06-19","22","3756","0","438","4.1","4.5"
"Lee","2020-06-20","7","3763","2","440","6.6","5.9"
"Lee","2020-06-21","9","3772","0","440","6.6","5.4"
"Lee","2020-06-22","54","3826","3","443","6.7","5.5"
"Lee","2020-06-23","53","3879","1","444","5.7","5.4"
"Lee","2020-06-24","38","3917","1","445","6","5.5"
"Lee","2020-06-25","29","3946","0","445","5.5","5.2"
"Lee","2020-06-26","58","4004","2","447","6","5.1"
"Lee","2020-06-27","13","4017","0","447","1.9","4.3"
"Lee","2020-06-28","11","4028","1","448","3.2","4.9"
"Lee","2020-06-29","44","4072","4","452","3.7","5.2"
"Lee","2020-06-30","39","4111","0","452","3.5","4.6"
"Lee","2020-07-01","124","4235","10","462","4.2","5.1"
"Lee","2020-07-02","51","4286","7","469","6.2","5.9"
"Lee","2020-07-03","23","4309","0","469","5.7","5.9"
"Lee","2020-07-04","15","4324","0","469","5.7","3.8"
"Lee","2020-07-05","19","4343","1","470","5.2","4.2"
"Lee","2020-07-06","58","4401","2","472","4.4","4"
"Lee","2020-07-07","45","4446","5","477","5.9","4.7"
"Lee","2020-07-08","125","4571","8","485","5.7","5"
"Lee","2020-07-09","49","4620","1","486","4","5.1"
"Lee","2020-07-10","60","4680","3","489","4.8","5.2"
"Lee","2020-07-11","14","4694","2","491","6.8","6.3"
"Lee","2020-07-12","12","4706","1","492","7.2","6.2"
"Lee","2020-07-13","54","4760","3","495","7.5","5.9"
"Lee","2020-07-14","48","4808","2","497","6.5","6.2"
"Lee","2020-07-15","188","4996","5","502","6","5.9"
"Lee","2020-07-16","35","5031","4","506","7.3","5.7"
"Lee","2020-07-17","52","5083","7","513","8.6","6.7"
"Lee","2020-07-18","17","5100","3","516","9","7.9"
"Lee","2020-07-19","17","5117","4","520","11.2","9.2"
"Lee","2020-07-20","53","5170","6","526","12","9.8"
"Lee","2020-07-21","49","5219","6","532","13.2","9.9"
"Lee","2020-07-22","67","5286","5","537","13.9","9.9"
"Lee","2020-07-23","71","5357","5","542","13.2","10.3"
"Lee","2020-07-24","40","5397","5","547","13.1","10.8"
"Lee","2020-07-25","12","5409","1","548","11.8","10.4"
"Lee","2020-07-26","9","5418","1","549","10","10.6"
"Lee","2020-07-27","77","5495","6","555","9.5","10.8"
"Lee","2020-07-28","54","5549","6","561","9.3","11.3"
"Lee","2020-07-29","169","5718","6","567","8.8","11.3"
"Lee","2020-07-30","45","5763","4","571","9","11.1"
"Lee","2020-07-31","47","5810","3","574","8.2","10.6"
"Lee","2020-08-01","13","5823","0","574","7","9.4"
"Lee","2020-08-02","56","5879","5","579","6.7","8.3"
"Lee","2020-08-03","66","5945","6","585","6.9","8.2"
"Lee","2020-08-04","51","5996","4","589","6.4","7.9"
"Lee","2020-08-05","113","6109","8","597","6.9","7.8"
"Lee","2020-08-06","57","6166","2","599","6.1","7.6"
"Lee","2020-08-07","57","6223","7","606","7","7.6"
"Lee","2020-08-08","25","6248","2","608","8.1","7.5"
"Lee","2020-08-09","17","6265","0","608","6.8","6.7"
"Lee","2020-08-10","68","6333","5","613","6.6","6.7"
"Lee","2020-08-11","54","6387","5","618","6.8","6.6"
"Lee","2020-08-12","82","6469","5","623","6.6","6.8"
"Lee","2020-08-13","39","6508","5","628","8","7"
"Lee","2020-08-14","38","6546","2","630","7","7"
"Lee","2020-08-15","40","6586","6","636","8","8"
"Lee","2020-08-16","17","6603","4","640","11.3","9.1"
"Lee","2020-08-17","47","6650","2","642","10.9","8.7"
"Lee","2020-08-18","52","6702","3","645","10.4","8.6"
"Lee","2020-08-19","87","6789","4","649","10.2","8.4"
"Lee","2020-08-20","34","6823","5","654","10.4","9.2"
"Lee","2020-08-21","45","6868","3","657","10.6","8.8"
"Lee","2020-08-22","13","6881","2","659","10.7","9.3"
"Lee","2020-08-23","48","6929","3","662","8.2","9.8"
"Lee","2020-08-24","59","6988","4","666","8.6","9.7"
"Lee","2020-08-25","60","7048","1","667","8","9.2"
"Lee","2020-08-26","80","7128","6","673","8.4","9.3"
"Lee","2020-08-27","53","7181","3","676","7.1","8.8"
"Lee","2020-08-28","31","7212","1","677","6.6","8.6"
"Lee","2020-08-29","68","7280","6","683","5.7","8.2"
"Lee","2020-08-30","20","7300","2","685","6.2","7.2"
"Lee","2020-08-31","50","7350","2","687","5.8","7.2"
"Lee","2020-09-01","121","7471","10","697","6.8","7.4"
"Lee","2020-09-02","59","7530","2","699","6.2","7.3"
"Lee","2020-09-03","46","7576","3","702","6.3","6.7"
"Lee","2020-09-04","46","7622","2","704","6.5","6.6"
"Lee","2020-09-05","12","7634","1","705","6.4","6.1"
"Lee","2020-09-06","8","7642","0","705","5","5.6"
"Lee","2020-09-07","8","7650","1","706","6.2","6"
"Lee","2020-09-08","90","7740","6","712","6","6.4"
"Lee","2020-09-09","96","7836","10","722","7","6.6"
"Lee","2020-09-10","70","7906","5","727","7.1","6.7"
"Lee","2020-09-11","54","7960","3","730","7.2","6.9"
"Lee","2020-09-12","16","7976","3","733","8.7","7.6"
"Lee","2020-09-13","9","7985","0","733","8.7","6.8"
"Lee","2020-09-14","54","8039","2","735","7.5","6.8"
"Lee","2020-09-15","59","8098","3","738","7.2","6.6"
"Lee","2020-09-16","86","8184","4","742","6.4","6.7"
"Lee","2020-09-17","46","8230","4","746","6.6","6.8"
"Lee","2020-09-18","50","8280","2","748","6.4","6.8"
"Lee","2020-09-19","10","8290","1","749","5.2","6.9"
"Lee","2020-09-20","18","8308","2","751","6.7","7.7"
"Lee","2020-09-21","60","8368","5","756","7.4","7.4"
"Lee","2020-09-22","85","8453","3","759","7.2","7.2"
"Lee","2020-09-23","51","8504","3","762","7.4","6.9"
"Lee","2020-09-24","46","8550","0","762","6.1","6.4"
"Lee","2020-09-25","53","8603","1","763","5.8","6.1"
"Lee","2020-09-26","29","8632","0","763","4.4","4.8"
"Lee","2020-09-27","16","8648","0","763","2.8","4.8"
"Lee","2020-09-28","60","8708","5","768","2.8","5.1"
"Lee","2020-09-29","60","8768","1","769","2.5","4.9"
"Lee","2020-09-30","39","8807","2","771","2.4","4.9"
"Lee","2020-10-01","44","8851","3","774","3.4","4.8"
"Lee","2020-10-02","49","8900","1","775","3.4","4.6"
"Lee","2020-10-03","7","8907","1","776","5.5","4.9"
"Lee","2020-10-04","10","8917","1","777","6.9","4.9"
"Lee","2020-10-05","69","8986","5","782","6.7","4.8"
"Lee","2020-10-06","69","9055","4","786","7.3","4.9"
"Lee","2020-10-07","70","9125","2","788","7","4.7"
"Lee","2020-10-08","48","9173","1","789","6.3","4.9"
"Lee","2020-10-09","41","9214","1","790","6.4","4.9"
"Lee","2020-10-10","11","9225","2","792","6.9","6.2"
"Lee","2020-10-11","13","9238","2","794","7.7","7.3"
"Lee","2020-10-12","60","9298","0","794","6.7","6.7"
"Lee","2020-10-13","44","9342","4","798","7.1","7.2"
"Lee","2020-10-14","53","9395","0","798","6.7","6.9"
"Lee","2020-10-15","39","9434","1","799","6.8","6.6"
"Lee","2020-10-16","31","9465","2","801","7.4","6.9"
"Lee","2020-10-17","7","9472","0","801","4.8","5.9"
"Lee","2020-10-18","13","9485","3","804","5.9","6.8"
"Lee","2020-10-19","49","9534","0","804","5.9","6.3"
"Lee","2020-10-20","56","9590","1","805","4.8","6"
"Lee","2020-10-21","47","9637","0","805","4.8","5.8"
"Lee","2020-10-22","53","9690","3","808","5.3","6"
"Lee","2020-10-23","36","9726","1","809","4.8","6.1"
"Lee","2020-10-24","12","9738","0","809","4.8","4.8"
"Lee","2020-10-25","9","9747","1","810","3","4.5"
"Lee","2020-10-26","58","9805","2","812","3.5","4.7"
"Lee","2020-10-27","42","9847","2","814","4","4.4"
"Lee","2020-10-28","37","9884","1","815","4.4","4.6"
"Lee","2020-10-29","46","9930","2","817","4.2","4.7"
"Lee","2020-10-30","40","9970","1","818","4.1","4.4"
"Lee","2020-10-31","20","9990","0","818","4.1","4.4"
"Lee","2020-11-01","8","9998","1","819","4.3","3.7"
"Lee","2020-11-02","34","10032","1","820","4.3","3.9"
"Lee","2020-11-03","68","10100","1","821","3.8","3.9"
"Lee","2020-11-04","45","10145","2","823","4","4.2"
"Lee","2020-11-05","41","10186","2","825","4.1","4.1"
"Lee","2020-11-06","42","10228","0","825","3.7","3.9"
"Lee","2020-11-07","9","10237","0","825","3.7","3.9"
"Lee","2020-11-08","12","10249","1","826","3.2","3.7"
"Lee","2020-11-09","52","10301","2","828","3.3","3.8"
"Lee","2020-11-10","53","10354","0","828","3.1","3.4"
"Lee","2020-11-11","62","10416","2","830","2.9","3.5"
"Lee","2020-11-12","42","10458","2","832","2.9","3.5"
"Lee","2020-11-13","46","10504","2","834","3.5","3.6"
"Lee","2020-11-14","21","10525","2","836","4.9","4.3"
"Lee","2020-11-15","17","10542","2","838","5.4","4.3"
"Lee","2020-11-16","65","10607","6","844","6.1","4.7"
"Lee","2020-11-17","47","10654","5","849","7.6","5.4"
"Lee","2020-11-18","69","10723","4","853","8","5.5"
"Lee","2020-11-19","43","10766","4","857","8.7","5.8"
"Lee","2020-11-20","74","10840","7","864","9.4","6.4"
"Lee","2020-11-21","16","10856","3","867","10.7","7.8"
"Lee","2020-11-22","20","10876","3","870","11.2","8.3"
"Lee","2020-11-23","87","10963","4","874","10.5","8.3"
"Lee","2020-11-24","60","11023","2","876","9.5","8.6"
"Lee","2020-11-25","73","11096","6","882","9.8","8.9"
"Lee","2020-11-26","17","11113","0","882","8.5","8.6"
"Lee","2020-11-27","23","11136","3","885","9","9.2"
"Lee","2020-11-28","20","11156","6","891","10.6","10.7"
"Lee","2020-11-29","14","11170","1","892","9.5","10.3"
"Lee","2020-11-30","88","11258","7","899","10","10.2"
"Lee","2020-12-01","69","11327","4","903","10.3","9.9"
"Lee","2020-12-02","54","11381","2","905","9.7","9.7"
"Lee","2020-12-03","72","11453","3","908","10.3","9.4"
"Lee","2020-12-04","65","11518","10","918","10.6","9.8"
"Lee","2020-12-05","24","11542","7","925","10.5","10.5"
"Lee","2020-12-06","23","11565","5","930","12.6","11"
"Lee","2020-12-07","88","11653","7","937","12.6","11.3"
"Lee","2020-12-08","69","11722","11","948","14","12.2"
"Lee","2020-12-09","69","11791","6","954","14.7","12.2"
"Lee","2020-12-10","73","11864","6","960","15.3","12.8"
"Lee","2020-12-11","90","11954","7","967","14.2","12.4"
"Lee","2020-12-12","26","11980","6","973","13.3","11.9"
"Lee","2020-12-13","27","12007","9","982","15","13.8"
"Lee","2020-12-14","65","12072","17","999","17.6","15.1"
"Lee","2020-12-15","60","12132","9","1008","17.5","15.7"
"Lee","2020-12-16","61","12193","6","1014","17.6","16.2"
"Lee","2020-12-17","67","12260","7","1021","17.9","16.6"
"Lee","2020-12-18","64","12324","4","1025","17.7","16"
"Lee","2020-12-19","58","12382","8","1033","16.4","14.9"
"Lee","2020-12-20","26","12408","7","1040","15.5","15.2"
"Lee","2020-12-21","65","12473","10","1050","13.9","15.8"
"Lee","2020-12-22","82","12555","18","1068","14.9","16.2"
"Lee","2020-12-23","53","12608","7","1075","15.4","16.5"
"Lee","2020-12-24","44","12652","7","1082","16.2","17.1"
"Lee","2020-12-25","13","12665","4","1086","19.7","18.7"
"Lee","2020-12-26","36","12701","15","1101","23.7","20"
"Lee","2020-12-27","23","12724","4","1105","22.3","18.9"
"Lee","2020-12-28","122","12846","32","1137","23.9","18.9"
"Lee","2020-12-29","85","12931","15","1152","23.3","19.1"
"Lee","2020-12-30","86","13017","16","1168","24","19.7"
"Lee","2020-12-31","100","13117","16","1184","24","20.1"
"Lee","2021-01-01","7","13124","0","1184","19.6","19.7"
"Lee","2021-01-02","22","13146","9","1193","19.5","21.6"
"Lee","2021-01-03","32","13178","8","1201","20.6","21.5"
"Lee","2021-01-04","80","13258","17","1218","19.9","21.9"
"Lee","2021-01-05","104","13362","15","1233","19.5","21.4"
"Lee","2021-01-06","90","13452","12","1245","18.7","21.4"
"Lee","2021-01-07","98","13550","16","1261","18.7","21.4"
"Lee","2021-01-08","87","13637","10","1271","20.4","20"
"Lee","2021-01-09","34","13671","8","1279","17.9","18.7"
"Lee","2021-01-10","33","13704","8","1287","17.8","19.2"
"Lee","2021-01-11","83","13787","23","1310","18.7","19.3"
"Lee","2021-01-12","88","13875","11","1321","18.4","19"
"Lee","2021-01-13","71","13946","10","1331","18.6","18.6"
"Lee","2021-01-14","66","14012","9","1340","18.2","18.5"
"Lee","2021-01-15","65","14077","12","1352","19.2","19.8"
"Lee","2021-01-16","27","14104","7","1359","19.5","18.7"
"Lee","2021-01-17","25","14129","5","1364","18.9","18.4"
"Lee","2021-01-18","49","14178","12","1376","18.4","18.6"
"Lee","2021-01-19","60","14238","10","1386","19","18.7"
"Lee","2021-01-20","58","14296","10","1396","19.5","19"
"Lee","2021-01-21","46","14342","7","1403","19.7","18.9"
"Lee","2021-01-22","82","14424","14","1417","19.5","19.3"
"Lee","2021-01-23","29","14453","7","1424","19.3","19.4"
"Lee","2021-01-24","11","14464","1","1425","17.7","18.3"
"Lee","2021-01-25","31","14495","8","1433","17.9","18.2"
"Lee","2021-01-26","22","14517","1","1434","16.2","17.6"
"Lee","2021-01-27","0","14517","0","1434","13.7","16.6"
"Liberty","2020-02-01","0","0","0","0",".","."
"Liberty","2020-02-02","0","0","0","0",".","."
"Liberty","2020-02-03","0","0","0","0",".","."
"Liberty","2020-02-04","0","0","0","0",".","."
"Liberty","2020-02-05","0","0","0","0",".","."
"Liberty","2020-02-06","0","0","0","0",".","."
"Liberty","2020-02-07","0","0","0","0","0","."
"Liberty","2020-02-08","0","0","0","0","0","."
"Liberty","2020-02-09","0","0","0","0","0","."
"Liberty","2020-02-10","0","0","0","0","0","."
"Liberty","2020-02-11","0","0","0","0","0","."
"Liberty","2020-02-12","0","0","0","0","0","."
"Liberty","2020-02-13","0","0","0","0","0","."
"Liberty","2020-02-14","0","0","0","0","0","0"
"Liberty","2020-02-15","0","0","0","0","0","0"
"Liberty","2020-02-16","0","0","0","0","0","0"
"Liberty","2020-02-17","0","0","0","0","0","0"
"Liberty","2020-02-18","0","0","0","0","0","0"
"Liberty","2020-02-19","0","0","0","0","0","0"
"Liberty","2020-02-20","0","0","0","0","0","0"
"Liberty","2020-02-21","0","0","0","0","0","0"
"Liberty","2020-02-22","0","0","0","0","0","0"
"Liberty","2020-02-23","0","0","0","0","0","0"
"Liberty","2020-02-24","0","0","0","0","0","0"
"Liberty","2020-02-25","0","0","0","0","0","0"
"Liberty","2020-02-26","0","0","0","0","0","0"
"Liberty","2020-02-27","0","0","0","0","0","0"
"Liberty","2020-02-28","0","0","0","0","0","0"
"Liberty","2020-02-29","0","0","0","0","0","0"
"Liberty","2020-03-01","0","0","0","0","0","0"
"Liberty","2020-03-02","0","0","0","0","0","0"
"Liberty","2020-03-03","0","0","0","0","0","0"
"Liberty","2020-03-04","0","0","0","0","0","0"
"Liberty","2020-03-05","0","0","0","0","0","0"
"Liberty","2020-03-06","0","0","0","0","0","0"
"Liberty","2020-03-07","0","0","0","0","0","0"
"Liberty","2020-03-08","0","0","0","0","0","0"
"Liberty","2020-03-09","0","0","0","0","0","0"
"Liberty","2020-03-10","0","0","0","0","0","0"
"Liberty","2020-03-11","0","0","0","0","0","0"
"Liberty","2020-03-12","0","0","0","0","0","0"
"Liberty","2020-03-13","1","1","0","0","0","0"
"Liberty","2020-03-14","1","2","0","0","0","0"
"Liberty","2020-03-15","10","12","0","0","0","0"
"Liberty","2020-03-16","8","20","0","0","0","0"
"Liberty","2020-03-17","17","37","0","0","0","0"
"Liberty","2020-03-18","5","42","0","0","0","0"
"Liberty","2020-03-19","8","50","0","0","0","0"
"Liberty","2020-03-20","9","59","1","1","1.6","0.8"
"Liberty","2020-03-21","10","69","0","1","1.6","0.8"
"Liberty","2020-03-22","9","78","0","1","1.6","0.8"
"Liberty","2020-03-23","8","86","4","5","8.7","4.4"
"Liberty","2020-03-24","16","102","2","7","10.5","5.3"
"Liberty","2020-03-25","20","122","3","10","12.7","6.3"
"Liberty","2020-03-26","19","141","1","11","13.4","6.7"
"Liberty","2020-03-27","16","157","0","11","11.8","6.7"
"Liberty","2020-03-28","4","161","0","11","11.8","6.7"
"Liberty","2020-03-29","5","166","1","12","14.7","8.1"
"Liberty","2020-03-30","11","177","1","13","8.8","8.8"
"Liberty","2020-03-31","18","195","0","13","7.1","8.8"
"Liberty","2020-04-01","15","210","0","13","4.9","8.8"
"Liberty","2020-04-02","14","224","1","14","5.2","9.3"
"Liberty","2020-04-03","21","245","2","16","6.5","9.2"
"Liberty","2020-04-04","18","263","0","16","6.5","9.2"
"Liberty","2020-04-05","2","265","0","16","3.7","9.2"
"Liberty","2020-04-06","27","292","1","17","2.9","5.9"
"Liberty","2020-04-07","51","343","4","21","4","5.5"
"Liberty","2020-04-08","46","389","2","23","4.7","4.8"
"Liberty","2020-04-09","40","429","2","25","4.3","4.8"
"Liberty","2020-04-10","33","462","3","28","4.3","5.4"
"Liberty","2020-04-11","6","468","0","28","4.3","5.4"
"Liberty","2020-04-12","3","471","0","28","4.3","4"
"Liberty","2020-04-13","18","489","3","31","6.1","4.5"
"Liberty","2020-04-14","28","517","2","33","6","5"
"Liberty","2020-04-15","33","550","3","36","6.7","5.7"
"Liberty","2020-04-16","31","581","1","37","6.5","5.4"
"Liberty","2020-04-17","26","607","1","38","5.7","5"
"Liberty","2020-04-18","13","620","0","38","5.7","5"
"Liberty","2020-04-19","5","625","0","38","5.7","5"
"Liberty","2020-04-20","20","645","0","38","3.3","4.7"
"Liberty","2020-04-21","37","682","0","38","2.3","4.2"
"Liberty","2020-04-22","26","708","0","38","1","3.9"
"Liberty","2020-04-23","17","725","0","38","0.5","3.5"
"Liberty","2020-04-24","31","756","0","38","0","2.9"
"Liberty","2020-04-25","12","768","0","38","0","2.9"
"Liberty","2020-04-26","6","774","1","39","2.4","4"
"Liberty","2020-04-27","16","790","1","40","3.3","3.3"
"Liberty","2020-04-28","26","816","1","41","3.8","3.1"
"Liberty","2020-04-29","29","845","0","41","3.8","2.4"
"Liberty","2020-04-30","36","881","1","42","4.2","2.4"
"Liberty","2020-05-01","118","999","1","43","4.3","2.2"
"Liberty","2020-05-02","5","1004","0","43","4.3","2.2"
"Liberty","2020-05-03","4","1008","0","43","2","2.2"
"Liberty","2020-05-04","130","1138","1","44","1.2","2.2"
"Liberty","2020-05-05","85","1223","0","44","0.6","2.2"
"Liberty","2020-05-06","163","1386","1","45","0.7","2.3"
"Liberty","2020-05-07","214","1600","2","47","0.5","2.3"
"Liberty","2020-05-08","70","1670","0","47","0.3","2.3"
"Liberty","2020-05-09","5","1675","0","47","0.3","2.3"
"Liberty","2020-05-10","0","1675","0","47","0.3","1.1"
"Liberty","2020-05-11","29","1704","0","47","0.2","0.7"
"Liberty","2020-05-12","120","1824","1","48","0.3","0.5"
"Liberty","2020-05-13","228","2052","11","59","0.9","0.8"
"Liberty","2020-05-14","140","2192","1","60","0.9","0.7"
"Liberty","2020-05-15","100","2292","0","60","0.9","0.6"
"Liberty","2020-05-16","17","2309","0","60","0.9","0.6"
"Liberty","2020-05-17","4","2313","0","60","0.9","0.6"
"Liberty","2020-05-18","20","2333","0","60","0.9","0.6"
"Liberty","2020-05-19","35","2368","0","60","0.8","0.6"
"Liberty","2020-05-20","33","2401","1","61","0.5","0.7"
"Liberty","2020-05-21","242","2643","1","62","0.5","0.7"
"Liberty","2020-05-22","61","2704","3","65","1.2","1.1"
"Liberty","2020-05-23","10","2714","0","65","1.2","1.1"
"Liberty","2020-05-24","1","2715","0","65","1.2","1.1"
"Liberty","2020-05-25","6","2721","0","65","1.2","1.1"
"Liberty","2020-05-26","41","2762","2","67","1.9","1.3"
"Liberty","2020-05-27","212","2974","0","67","1.5","1"
"Liberty","2020-05-28","79","3053","0","67","1.4","0.9"
"Liberty","2020-05-29","60","3113","1","68","0.9","1.1"
"Liberty","2020-05-30","11","3124","0","68","0.9","1.1"
"Liberty","2020-05-31","7","3131","0","68","0.9","1.1"
"Liberty","2020-06-01","53","3184","1","69","1.2","1.2"
"Liberty","2020-06-02","31","3215","0","69","0.5","1.2"
"Liberty","2020-06-03","34","3249","0","69","0.5","1"
"Liberty","2020-06-04","22","3271","0","69","0.5","1"
"Liberty","2020-06-05","12","3283","0","69","0.3","0.6"
"Liberty","2020-06-06","5","3288","0","69","0.3","0.6"
"Liberty","2020-06-07","4","3292","0","69","0.3","0.6"
"Liberty","2020-06-08","92","3384","1","70","0.2","0.7"
"Liberty","2020-06-09","42","3426","1","71","0.5","0.5"
"Liberty","2020-06-10","36","3462","0","71","0.5","0.5"
"Liberty","2020-06-11","65","3527","2","73","0.9","0.7"
"Liberty","2020-06-12","39","3566","0","73","0.9","0.6"
"Liberty","2020-06-13","5","3571","0","73","0.9","0.6"
"Liberty","2020-06-14","4","3575","0","73","0.9","0.6"
"Liberty","2020-06-15","46","3621","1","74","1.1","0.6"
"Liberty","2020-06-16","47","3668","2","76","1.4","0.9"
"Liberty","2020-06-17","47","3715","2","78","2","1.2"
"Liberty","2020-06-18","70","3785","1","79","1.7","1.3"
"Liberty","2020-06-19","43","3828","0","79","1.7","1.3"
"Liberty","2020-06-20","22","3850","0","79","1.7","1.3"
"Liberty","2020-06-21","19","3869","1","80","2.5","1.7"
"Liberty","2020-06-22","77","3946","2","82","2.5","1.8"
"Liberty","2020-06-23","67","4013","2","84","2.4","1.9"
"Liberty","2020-06-24","41","4054","1","85","2.1","2"
"Liberty","2020-06-25","65","4119","2","87","2.3","2"
"Liberty","2020-06-26","142","4261","5","92","2.8","2.3"
"Liberty","2020-06-27","36","4297","0","92","2.8","2.3"
"Liberty","2020-06-28","18","4315","1","93","2.9","2.7"
"Liberty","2020-06-29","157","4472","12","105","3.6","3.1"
"Liberty","2020-06-30","123","4595","11","116","4.5","3.4"
"Liberty","2020-07-01","389","4984","44","160","5.7","3.9"
"Liberty","2020-07-02","53","5037","10","170","8","5.2"
"Liberty","2020-07-03","26","5063","3","173","9.1","6"
"Liberty","2020-07-04","7","5070","3","176","15.2","9"
"Liberty","2020-07-05","15","5085","1","177","15.4","9.1"
"Liberty","2020-07-06","165","5250","50","227","18.6","11.1"
"Liberty","2020-07-07","217","5467","33","260","19.5","12"
"Liberty","2020-07-08","112","5579","11","271","19.3","12.5"
"Liberty","2020-07-09","221","5800","25","296","18.2","13.1"
"Liberty","2020-07-10","231","6031","37","333","18.9","14"
"Liberty","2020-07-11","77","6108","6","339","13.9","14.6"
"Liberty","2020-07-12","10","6118","3","342","17.2","16.3"
"Liberty","2020-07-13","220","6338","36","378","15.2","16.9"
"Liberty","2020-07-14","178","6516","32","410","15.6","17.6"
"Liberty","2020-07-15","245","6761","27","437","15.8","17.6"
"Liberty","2020-07-16","173","6934","20","457","15.8","17"
"Liberty","2020-07-17","192","7126","29","486","15.7","17.3"
"Liberty","2020-07-18","25","7151","4","490","16.9","15.4"
"Liberty","2020-07-19","38","7189","3","493","13.7","15.5"
"Liberty","2020-07-20","61","7250","8","501","13.2","14.2"
"Liberty","2020-07-21","145","7395","10","511","11.7","13.6"
"Liberty","2020-07-22","245","7640","29","540","11.8","13.8"
"Liberty","2020-07-23","161","7801","29","569","12.7","14.3"
"Liberty","2020-07-24","126","7927","13","582","12","13.8"
"Liberty","2020-07-25","44","7971","13","595","13.9","15.4"
"Liberty","2020-07-26","24","7995","11","606","19.4","16.5"
"Liberty","2020-07-27","83","8078","19","625","20.8","17"
"Liberty","2020-07-28","73","8151","9","634","21.5","16.6"
"Liberty","2020-07-29","117","8268","15","649","21.7","16.7"
"Liberty","2020-07-30","85","8353","21","670","22.6","17.7"
"Liberty","2020-07-31","120","8473","12","682","22.6","17.3"
"Liberty","2020-08-01","34","8507","5","687","20.5","17.2"
"Liberty","2020-08-02","13","8520","1","688","15","17.2"
"Liberty","2020-08-03","83","8603","15","703","14.3","17.5"
"Liberty","2020-08-04","70","8673","20","723","16.7","19.1"
"Liberty","2020-08-05","107","8780","13","736","16.6","19.1"
"Liberty","2020-08-06","82","8862","34","770","19","20.8"
"Liberty","2020-08-07","108","8970","15","785","19.5","21"
"Liberty","2020-08-08","33","9003","8","793","20.9","20.7"
"Liberty","2020-08-09","23","9026","3","796","21.6","18.3"
"Liberty","2020-08-10","59","9085","10","806","21.5","17.9"
"Liberty","2020-08-11","61","9146","12","818","20.2","18.4"
"Liberty","2020-08-12","146","9292","11","829","19.5","18"
"Liberty","2020-08-13","58","9350","6","835","15.1","17"
"Liberty","2020-08-14","127","9477","10","845","14.2","16.9"
"Liberty","2020-08-15","29","9506","3","848","12.3","16.6"
"Liberty","2020-08-16","21","9527","2","850","11.7","16.7"
"Liberty","2020-08-17","42","9569","5","855","11","16.3"
"Liberty","2020-08-18","55","9624","7","862","10","15.1"
"Liberty","2020-08-19","156","9780","11","873","10","14.8"
"Liberty","2020-08-20","121","9901","9","882","9.6","12.3"
"Liberty","2020-08-21","146","10047","18","900","10.2","12.2"
"Liberty","2020-08-22","28","10075","4","904","10.8","11.5"
"Liberty","2020-08-23","15","10090","2","906","11.3","11.5"
"Liberty","2020-08-24","51","10141","7","913","11.6","11.3"
"Liberty","2020-08-25","31","10172","2","915","10.7","10.3"
"Liberty","2020-08-26","130","10302","10","925","10.8","10.4"
"Liberty","2020-08-27","77","10379","2","927","10.1","9.8"
"Liberty","2020-08-28","115","10494","11","938","9.7","9.9"
"Liberty","2020-08-29","14","10508","3","941","10.7","10.7"
"Liberty","2020-08-30","20","10528","1","942","9.5","10.4"
"Liberty","2020-08-31","34","10562","2","944","8.4","10"
"Liberty","2020-09-01","62","10624","11","955","10","10.3"
"Liberty","2020-09-02","131","10755","9","964","9.9","10.3"
"Liberty","2020-09-03","49","10804","1","965","9.8","9.9"
"Liberty","2020-09-04","75","10879","4","969","9.2","9.4"
"Liberty","2020-09-05","57","10936","2","971","6.6","8.7"
"Liberty","2020-09-06","15","10951","0","971","5.9","7.7"
"Liberty","2020-09-07","13","10964","4","975","9.5","8.9"
"Liberty","2020-09-08","74","11038","5","980","7.9","8.9"
"Liberty","2020-09-09","102","11140","6","986","7.8","8.8"
"Liberty","2020-09-10","41","11181","5","991","9.2","9.5"
"Liberty","2020-09-11","107","11288","11","1002","9.9","9.5"
"Liberty","2020-09-12","31","11319","6","1008","12.2","9.4"
"Liberty","2020-09-13","18","11337","2","1010","13.8","9.8"
"Liberty","2020-09-14","57","11394","6","1016","10.9","10.2"
"Liberty","2020-09-15","81","11475","4","1020","10.6","9.3"
"Liberty","2020-09-16","97","11572","8","1028","11","9.4"
"Liberty","2020-09-17","72","11644","5","1033","10.2","9.7"
"Liberty","2020-09-18","91","11735","5","1038","9.5","9.7"
"Liberty","2020-09-19","38","11773","3","1041","7.9","10"
"Liberty","2020-09-20","22","11795","1","1042","6.9","10.4"
"Liberty","2020-09-21","45","11840","2","1044","6.1","8.5"
"Liberty","2020-09-22","41","11881","5","1049","7.1","8.9"
"Liberty","2020-09-23","105","11986","5","1054","6.6","8.8"
"Liberty","2020-09-24","52","12038","7","1061","7.5","8.9"
"Liberty","2020-09-25","93","12131","4","1065","7.4","8.4"
"Liberty","2020-09-26","25","12156","0","1065","6.2","7.1"
"Liberty","2020-09-27","10","12166","0","1065","5.6","6.3"
"Liberty","2020-09-28","50","12216","2","1067","5.5","5.8"
"Liberty","2020-09-29","27","12243","0","1067","3.8","5.4"
"Liberty","2020-09-30","90","12333","6","1073","4.1","5.3"
"Liberty","2020-10-01","34","12367","0","1073","2.1","4.8"
"Liberty","2020-10-02","98","12465","4","1077","2.1","4.7"
"Liberty","2020-10-03","25","12490","1","1078","2.7","4.5"
"Liberty","2020-10-04","19","12509","3","1081","4.9","5.3"
"Liberty","2020-10-05","54","12563","1","1082","4.6","5.1"
"Liberty","2020-10-06","37","12600","1","1083","5","4.4"
"Liberty","2020-10-07","171","12771","5","1088","4.5","4.3"
"Liberty","2020-10-08","41","12812","6","1094","6.6","4.4"
"Liberty","2020-10-09","107","12919","2","1096","6.3","4.2"
"Liberty","2020-10-10","16","12935","1","1097","6.6","4.6"
"Liberty","2020-10-11","17","12952","0","1097","4.3","4.6"
"Liberty","2020-10-12","36","12988","3","1100","5.2","4.9"
"Liberty","2020-10-13","37","13025","0","1100","4.9","4.9"
"Liberty","2020-10-14","108","13133","5","1105","5.1","4.8"
"Liberty","2020-10-15","40","13173","4","1109","4.4","5.5"
"Liberty","2020-10-16","38","13211","4","1113","5.7","6"
"Liberty","2020-10-17","22","13233","0","1113","4.8","5.7"
"Liberty","2020-10-18","20","13253","1","1114","5.5","4.9"
"Liberty","2020-10-19","55","13308","5","1119","5.6","5.4"
"Liberty","2020-10-20","34","13342","0","1119","5.6","5.2"
"Liberty","2020-10-21","144","13486","13","1132","6.2","5.7"
"Liberty","2020-10-22","42","13528","2","1134","5.5","5"
"Liberty","2020-10-23","52","13580","4","1138","5.1","5.4"
"Liberty","2020-10-24","19","13599","0","1138","5.1","4.9"
"Liberty","2020-10-25","31","13630","4","1142","6.2","5.9"
"Liberty","2020-10-26","64","13694","2","1144","5.4","5.5"
"Liberty","2020-10-27","34","13728","0","1144","5.4","5.5"
"Liberty","2020-10-28","136","13864","5","1149","4.6","5.4"
"Liberty","2020-10-29","40","13904","3","1152","5","5.2"
"Liberty","2020-10-30","48","13952","11","1163","7.2","6.1"
"Liberty","2020-10-31","7","13959","0","1163","7.2","6.1"
"Liberty","2020-11-01","13","13972","1","1164","6.4","6.3"
"Liberty","2020-11-02","64","14036","2","1166","6.4","5.9"
"Liberty","2020-11-03","46","14082","2","1168","7","6.2"
"Liberty","2020-11-04","145","14227","5","1173","7","5.8"
"Liberty","2020-11-05","24","14251","0","1173","5.9","5.5"
"Liberty","2020-11-06","51","14302","6","1179","4.3","5.7"
"Liberty","2020-11-07","32","14334","2","1181","5.2","6.2"
"Liberty","2020-11-08","22","14356","0","1181","4.1","5.3"
"Liberty","2020-11-09","47","14403","7","1188","5.8","6.1"
"Liberty","2020-11-10","53","14456","6","1194","6.8","6.9"
"Liberty","2020-11-11","112","14568","12","1206","7.8","7.4"
"Liberty","2020-11-12","40","14608","6","1212","10","8"
"Liberty","2020-11-13","47","14655","2","1214","8.9","6.6"
"Liberty","2020-11-14","19","14674","4","1218","11","8.1"
"Liberty","2020-11-15","23","14697","1","1219","11.7","7.9"
"Liberty","2020-11-16","61","14758","7","1226","11.2","8.5"
"Liberty","2020-11-17","80","14838","8","1234","11","8.9"
"Liberty","2020-11-18","158","14996","5","1239","9.9","8.9"
"Liberty","2020-11-19","63","15059","5","1244","8.9","9.4"
"Liberty","2020-11-20","54","15113","4","1248","9.3","9.1"
"Liberty","2020-11-21","58","15171","5","1253","7.6","9.3"
"Liberty","2020-11-22","24","15195","2","1255","8.1","9.9"
"Liberty","2020-11-23","73","15268","8","1263","8.1","9.6"
"Liberty","2020-11-24","62","15330","5","1268","7.8","9.4"
"Liberty","2020-11-25","139","15469","10","1278","8.4","9.1"
"Liberty","2020-11-26","5","15474","0","1278","7.2","8.1"
"Liberty","2020-11-27","35","15509","5","1283","8.2","8.8"
"Liberty","2020-11-28","29","15538","2","1285","8","7.8"
"Liberty","2020-11-29","29","15567","0","1285","6.8","7.5"
"Liberty","2020-11-30","64","15631","13","1298","8.1","8.1"
"Liberty","2020-12-01","43","15674","7","1305","9.3","8.5"
"Liberty","2020-12-02","185","15859","13","1318","9.3","8.8"
"Liberty","2020-12-03","56","15915","3","1321","10","8.6"
"Liberty","2020-12-04","51","15966","9","1330","10.5","9.4"
"Liberty","2020-12-05","26","15992","2","1332","10.6","9.3"
"Liberty","2020-12-06","13","16005","4","1336","15","10.9"
"Liberty","2020-12-07","58","16063","6","1342","13.6","10.8"
"Liberty","2020-12-08","68","16131","4","1346","12.1","10.7"
"Liberty","2020-12-09","243","16374","14","1360","11.9","10.6"
"Liberty","2020-12-10","62","16436","10","1370","13.5","11.7"
"Liberty","2020-12-11","88","16524","6","1376","11.9","11.2"
"Liberty","2020-12-12","41","16565","7","1383","13.3","11.9"
"Liberty","2020-12-13","36","16601","5","1388","10.8","12.9"
"Liberty","2020-12-14","81","16682","6","1394","10.4","12"
"Liberty","2020-12-15","69","16751","7","1401","11","11.6"
"Liberty","2020-12-16","207","16958","19","1420","11.5","11.7"
"Liberty","2020-12-17","85","17043","12","1432","11.2","12.3"
"Liberty","2020-12-18","80","17123","10","1442","12","12"
"Liberty","2020-12-19","45","17168","6","1448","11.5","12.4"
"Liberty","2020-12-20","40","17208","6","1454","11.7","11.3"
"Liberty","2020-12-21","62","17270","8","1462","12.5","11.4"
"Liberty","2020-12-22","71","17341","11","1473","13.2","12.1"
"Liberty","2020-12-23","160","17501","13","1486","13.1","12.3"
"Liberty","2020-12-24","47","17548","8","1494","13.5","12.4"
"Liberty","2020-12-25","7","17555","0","1494","11.7","11.9"
"Liberty","2020-12-26","35","17590","9","1503","13.5","12.5"
"Liberty","2020-12-27","24","17614","2","1505","12.5","12.1"
"Liberty","2020-12-28","86","17700","10","1515","12.3","12.4"
"Liberty","2020-12-29","72","17772","15","1530","13.1","13.2"
"Liberty","2020-12-30","185","17957","25","1555","13.9","13.5"
"Liberty","2020-12-31","56","18013","7","1562","13.2","13.3"
"Liberty","2021-01-01","5","18018","0","1562","13.2","12.5"
"Liberty","2021-01-02","26","18044","4","1566","11.7","12.6"
"Liberty","2021-01-03","32","18076","1","1567","11","11.8"
"Liberty","2021-01-04","74","18150","19","1586","13","12.7"
"Liberty","2021-01-05","112","18262","34","1620","14.4","13.7"
"Liberty","2021-01-06","209","18471","22","1642","13.9","13.9"
"Liberty","2021-01-07","83","18554","22","1664","15.9","14.6"
"Liberty","2021-01-08","72","18626","11","1675","18.1","15.7"
"Liberty","2021-01-09","44","18670","3","1678","16.9","14.3"
"Liberty","2021-01-10","33","18703","7","1685","19.5","15.2"
"Liberty","2021-01-11","89","18792","19","1704","18.9","15.9"
"Liberty","2021-01-12","131","18923","17","1721","16.4","15.4"
"Liberty","2021-01-13","177","19100","23","1744","16.7","15.3"
"Liberty","2021-01-14","76","19176","19","1763","16.5","16.2"
"Liberty","2021-01-15","94","19270","18","1781","17.1","17.6"
"Liberty","2021-01-16","38","19308","8","1789","19.1","18"
"Liberty","2021-01-17","43","19351","17","1806","21.7","20.6"
"Liberty","2021-01-18","98","19449","18","1824","21.3","20.1"
"Liberty","2021-01-19","91","19540","15","1839","21.8","19.1"
"Liberty","2021-01-20","184","19724","26","1865","22","19.3"
"Liberty","2021-01-21","76","19800","13","1878","20.8","18.7"
"Liberty","2021-01-22","89","19889","17","1895","20.8","18.9"
"Liberty","2021-01-23","44","19933","14","1909","22.4","20.7"
"Liberty","2021-01-24","25","19958","3","1912","18.4","20.1"
"Liberty","2021-01-25","36","19994","4","1916","17.4","19.3"
"Liberty","2021-01-26","1","19995","0","1916","15","18.4"
"Liberty","2021-01-27","0","19995","0","1916","13","17.5"
"Lincoln","2020-02-01","0","0","0","0",".","."
"Lincoln","2020-02-02","0","0","0","0",".","."
"Lincoln","2020-02-03","0","0","0","0",".","."
"Lincoln","2020-02-04","0","0","0","0",".","."
"Lincoln","2020-02-05","0","0","0","0",".","."
"Lincoln","2020-02-06","0","0","0","0",".","."
"Lincoln","2020-02-07","0","0","0","0","0","."
"Lincoln","2020-02-08","0","0","0","0","0","."
"Lincoln","2020-02-09","0","0","0","0","0","."
"Lincoln","2020-02-10","0","0","0","0","0","."
"Lincoln","2020-02-11","0","0","0","0","0","."
"Lincoln","2020-02-12","0","0","0","0","0","."
"Lincoln","2020-02-13","0","0","0","0","0","."
"Lincoln","2020-02-14","0","0","0","0","0","0"
"Lincoln","2020-02-15","0","0","0","0","0","0"
"Lincoln","2020-02-16","0","0","0","0","0","0"
"Lincoln","2020-02-17","0","0","0","0","0","0"
"Lincoln","2020-02-18","0","0","0","0","0","0"
"Lincoln","2020-02-19","0","0","0","0","0","0"
"Lincoln","2020-02-20","0","0","0","0","0","0"
"Lincoln","2020-02-21","0","0","0","0","0","0"
"Lincoln","2020-02-22","0","0","0","0","0","0"
"Lincoln","2020-02-23","0","0","0","0","0","0"
"Lincoln","2020-02-24","0","0","0","0","0","0"
"Lincoln","2020-02-25","0","0","0","0","0","0"
"Lincoln","2020-02-26","0","0","0","0","0","0"
"Lincoln","2020-02-27","0","0","0","0","0","0"
"Lincoln","2020-02-28","0","0","0","0","0","0"
"Lincoln","2020-02-29","0","0","0","0","0","0"
"Lincoln","2020-03-01","0","0","0","0","0","0"
"Lincoln","2020-03-02","0","0","0","0","0","0"
"Lincoln","2020-03-03","0","0","0","0","0","0"
"Lincoln","2020-03-04","0","0","0","0","0","0"
"Lincoln","2020-03-05","0","0","0","0","0","0"
"Lincoln","2020-03-06","0","0","0","0","0","0"
"Lincoln","2020-03-07","0","0","0","0","0","0"
"Lincoln","2020-03-08","0","0","0","0","0","0"
"Lincoln","2020-03-09","0","0","0","0","0","0"
"Lincoln","2020-03-10","0","0","0","0","0","0"
"Lincoln","2020-03-11","0","0","0","0","0","0"
"Lincoln","2020-03-12","0","0","0","0","0","0"
"Lincoln","2020-03-13","0","0","0","0","0","0"
"Lincoln","2020-03-14","0","0","0","0","0","0"
"Lincoln","2020-03-15","0","0","0","0","0","0"
"Lincoln","2020-03-16","0","0","0","0","0","0"
"Lincoln","2020-03-17","0","0","0","0","0","0"
"Lincoln","2020-03-18","0","0","0","0","0","0"
"Lincoln","2020-03-19","0","0","0","0","0","0"
"Lincoln","2020-03-20","0","0","0","0","0","0"
"Lincoln","2020-03-21","2","2","2","2","14.3","7.1"
"Lincoln","2020-03-22","0","2","0","2","14.3","7.1"
"Lincoln","2020-03-23","1","3","0","2","14.3","7.1"
"Lincoln","2020-03-24","0","3","0","2","14.3","7.1"
"Lincoln","2020-03-25","0","3","0","2","14.3","7.1"
"Lincoln","2020-03-26","1","4","0","2","14.3","7.1"
"Lincoln","2020-03-27","1","5","0","2","14.3","7.1"
"Lincoln","2020-03-28","1","6","0","2","0","7.1"
"Lincoln","2020-03-29","0","6","0","2","0","7.1"
"Lincoln","2020-03-30","2","8","1","3","7.1","10.7"
"Lincoln","2020-03-31","0","8","0","3","7.1","10.7"
"Lincoln","2020-04-01","2","10","0","3","7.1","10.7"
"Lincoln","2020-04-02","3","13","0","3","7.1","10.7"
"Lincoln","2020-04-03","5","18","0","3","7.1","10.7"
"Lincoln","2020-04-04","2","20","1","4","14.3","7.1"
"Lincoln","2020-04-05","1","21","0","4","14.3","7.1"
"Lincoln","2020-04-06","0","21","0","4","7.1","7.1"
"Lincoln","2020-04-07","2","23","1","5","14.3","10.7"
"Lincoln","2020-04-08","8","31","2","7","17.9","12.5"
"Lincoln","2020-04-09","3","34","0","7","17.9","12.5"
"Lincoln","2020-04-10","4","38","0","7","17.9","12.5"
"Lincoln","2020-04-11","1","39","0","7","10.7","12.5"
"Lincoln","2020-04-12","0","39","0","7","10.7","12.5"
"Lincoln","2020-04-13","2","41","0","7","10.7","8.9"
"Lincoln","2020-04-14","1","42","0","7","3.6","8.9"
"Lincoln","2020-04-15","5","47","0","7","0","8.9"
"Lincoln","2020-04-16","4","51","0","7","0","8.9"
"Lincoln","2020-04-17","0","51","0","7","0","8.9"
"Lincoln","2020-04-18","1","52","0","7","0","5.4"
"Lincoln","2020-04-19","1","53","1","8","14.3","12.5"
"Lincoln","2020-04-20","6","59","1","9","16.7","13.7"
"Lincoln","2020-04-21","1","60","0","9","16.7","10.1"
"Lincoln","2020-04-22","10","70","2","11","19.5","9.8"
"Lincoln","2020-04-23","5","75","0","11","19.5","9.8"
"Lincoln","2020-04-24","4","79","0","11","19.5","9.8"
"Lincoln","2020-04-25","8","87","0","11","19.5","9.8"
"Lincoln","2020-04-26","3","90","2","13","14.8","14.5"
"Lincoln","2020-04-27","0","90","0","13","12.4","14.5"
"Lincoln","2020-04-28","3","93","0","13","12.4","14.5"
"Lincoln","2020-04-29","2","95","0","13","9.5","14.5"
"Lincoln","2020-04-30","4","99","0","13","9.5","14.5"
"Lincoln","2020-05-01","4","103","0","13","9.5","14.5"
"Lincoln","2020-05-02","4","107","0","13","9.5","14.5"
"Lincoln","2020-05-03","3","110","0","13","0","7.4"
"Lincoln","2020-05-04","3","113","0","13","0","6.2"
"Lincoln","2020-05-05","7","120","0","13","0","6.2"
"Lincoln","2020-05-06","4","124","0","13","0","4.8"
"Lincoln","2020-05-07","1","125","0","13","0","4.8"
"Lincoln","2020-05-08","3","128","0","13","0","4.8"
"Lincoln","2020-05-09","0","128","0","13","0","4.8"
"Lincoln","2020-05-10","0","128","0","13","0","0"
"Lincoln","2020-05-11","1","129","0","13","0","0"
"Lincoln","2020-05-12","1","130","0","13","0","0"
"Lincoln","2020-05-13","3","133","0","13","0","0"
"Lincoln","2020-05-14","2","135","0","13","0","0"
"Lincoln","2020-05-15","2","137","0","13","0","0"
"Lincoln","2020-05-16","2","139","0","13","0","0"
"Lincoln","2020-05-17","2","141","0","13","0","0"
"Lincoln","2020-05-18","12","153","4","17","4.8","2.4"
"Lincoln","2020-05-19","5","158","2","19","10.5","5.2"
"Lincoln","2020-05-20","4","162","0","19","10.5","5.2"
"Lincoln","2020-05-21","24","186","0","19","10.5","5.2"
"Lincoln","2020-05-22","21","207","0","19","10.5","5.2"
"Lincoln","2020-05-23","1","208","0","19","10.5","5.2"
"Lincoln","2020-05-24","2","210","0","19","10.5","5.2"
"Lincoln","2020-05-25","0","210","0","19","5.7","5.2"
"Lincoln","2020-05-26","2","212","0","19","0","5.2"
"Lincoln","2020-05-27","4","216","0","19","0","5.2"
"Lincoln","2020-05-28","3","219","0","19","0","5.2"
"Lincoln","2020-05-29","2","221","0","19","0","5.2"
"Lincoln","2020-05-30","0","221","0","19","0","5.2"
"Lincoln","2020-05-31","2","223","0","19","0","5.2"
"Lincoln","2020-06-01","13","236","0","19","0","2.9"
"Lincoln","2020-06-02","6","242","0","19","0","0"
"Lincoln","2020-06-03","4","246","1","20","3.6","1.8"
"Lincoln","2020-06-04","1","247","0","20","3.6","1.8"
"Lincoln","2020-06-05","4","251","0","20","3.6","1.8"
"Lincoln","2020-06-06","0","251","0","20","3.6","1.8"
"Lincoln","2020-06-07","0","251","0","20","3.6","1.8"
"Lincoln","2020-06-08","2","253","0","20","3.6","1.8"
"Lincoln","2020-06-09","5","258","1","21","6.4","3.2"
"Lincoln","2020-06-10","2","260","0","21","2.9","3.2"
"Lincoln","2020-06-11","4","264","0","21","2.9","3.2"
"Lincoln","2020-06-12","4","268","0","21","2.9","3.2"
"Lincoln","2020-06-13","6","274","0","21","2.9","3.2"
"Lincoln","2020-06-14","1","275","1","22","17.1","10.4"
"Lincoln","2020-06-15","5","280","1","23","20","11.8"
"Lincoln","2020-06-16","6","286","2","25","21.9","14.2"
"Lincoln","2020-06-17","6","292","1","26","24.3","13.6"
"Lincoln","2020-06-18","6","298","4","30","33.8","18.3"
"Lincoln","2020-06-19","3","301","0","30","33.8","18.3"
"Lincoln","2020-06-20","7","308","2","32","37.9","20.4"
"Lincoln","2020-06-21","1","309","0","32","23.6","20.4"
"Lincoln","2020-06-22","14","323","3","35","23.8","21.9"
"Lincoln","2020-06-23","10","333","1","36","20.5","21.2"
"Lincoln","2020-06-24","15","348","1","37","19","21.7"
"Lincoln","2020-06-25","17","365","1","38","10.4","22.1"
"Lincoln","2020-06-26","11","376","3","41","14.3","24"
"Lincoln","2020-06-27","5","381","0","41","10.2","24"
"Lincoln","2020-06-28","1","382","0","41","10.2","16.9"
"Lincoln","2020-06-29","6","388","1","42","9.5","16.7"
"Lincoln","2020-06-30","14","402","3","45","11.1","15.8"
"Lincoln","2020-07-01","22","424","7","52","14.7","16.9"
"Lincoln","2020-07-02","13","437","2","54","16.1","13.2"
"Lincoln","2020-07-03","5","442","1","55","15","14.7"
"Lincoln","2020-07-04","4","446","1","56","18.6","14.4"
"Lincoln","2020-07-05","9","455","1","57","20.2","15.2"
"Lincoln","2020-07-06","11","466","1","58","19.1","14.3"
"Lincoln","2020-07-07","14","480","2","60","18.1","14.6"
"Lincoln","2020-07-08","20","500","1","61","14.3","14.5"
"Lincoln","2020-07-09","3","503","2","63","21.6","18.8"
"Lincoln","2020-07-10","9","512","0","63","18.7","16.9"
"Lincoln","2020-07-11","13","525","1","64","16.3","17.4"
"Lincoln","2020-07-12","5","530","1","65","17.5","18.9"
"Lincoln","2020-07-13","18","548","6","71","21","20.1"
"Lincoln","2020-07-14","14","562","0","71","19","18.5"
"Lincoln","2020-07-15","15","577","6","77","24","19.1"
"Lincoln","2020-07-16","9","586","0","77","14.4","18"
"Lincoln","2020-07-17","11","597","0","77","14.4","16.6"
"Lincoln","2020-07-18","14","611","4","81","17.4","16.8"
"Lincoln","2020-07-19","1","612","0","81","14.6","16"
"Lincoln","2020-07-20","7","619","1","82","11.8","16.4"
"Lincoln","2020-07-21","6","625","0","82","11.8","15.4"
"Lincoln","2020-07-22","4","629","2","84","13.3","18.6"
"Lincoln","2020-07-23","9","638","1","85","14.9","14.6"
"Lincoln","2020-07-24","18","656","0","85","14.9","14.6"
"Lincoln","2020-07-25","8","664","1","86","12.6","15"
"Lincoln","2020-07-26","13","677","2","88","14.8","14.7"
"Lincoln","2020-07-27","22","699","1","89","13.4","12.6"
"Lincoln","2020-07-28","11","710","2","91","16","13.9"
"Lincoln","2020-07-29","9","719","2","93","12","12.6"
"Lincoln","2020-07-30","6","725","2","95","15.2","15"
"Lincoln","2020-07-31","10","735","1","96","16.6","15.7"
"Lincoln","2020-08-01","7","742","3","99","20.9","16.7"
"Lincoln","2020-08-02","5","747","1","100","21.6","18.2"
"Lincoln","2020-08-03","11","758","0","100","20.9","17.2"
"Lincoln","2020-08-04","9","767","0","100","18.3","17.2"
"Lincoln","2020-08-05","13","780","2","102","17.4","14.7"
"Lincoln","2020-08-06","13","793","5","107","18.1","16.6"
"Lincoln","2020-08-07","17","810","3","110","19.2","17.9"
"Lincoln","2020-08-08","3","813","1","111","17.8","19.4"
"Lincoln","2020-08-09","11","824","1","112","16.3","18.9"
"Lincoln","2020-08-10","27","851","2","114","17.3","19.1"
"Lincoln","2020-08-11","10","861","2","116","20.2","19.3"
"Lincoln","2020-08-12","4","865","2","118","25.1","21.3"
"Lincoln","2020-08-13","5","870","1","119","22.5","20.3"
"Lincoln","2020-08-14","13","883","1","120","21.1","20.1"
"Lincoln","2020-08-15","30","913","0","120","16.3","17.1"
"Lincoln","2020-08-16","4","917","1","121","18.6","17.4"
"Lincoln","2020-08-17","4","921","0","121","17.5","17.4"
"Lincoln","2020-08-18","7","928","2","123","18.8","19.5"
"Lincoln","2020-08-19","7","935","1","124","13.6","19.4"
"Lincoln","2020-08-20","6","941","1","125","13.2","17.8"
"Lincoln","2020-08-21","6","947","0","125","12.1","16.6"
"Lincoln","2020-08-22","7","954","2","127","16.2","16.2"
"Lincoln","2020-08-23","6","960","0","127","12.6","15.6"
"Lincoln","2020-08-24","33","993","3","130","13.9","15.7"
"Lincoln","2020-08-25","10","1003","0","130","9.8","14.3"
"Lincoln","2020-08-26","5","1008","0","130","7.8","10.7"
"Lincoln","2020-08-27","4","1012","1","131","9","11.1"
"Lincoln","2020-08-28","11","1023","3","134","12.8","12.5"
"Lincoln","2020-08-29","2","1025","0","134","8.8","12.5"
"Lincoln","2020-08-30","2","1027","0","134","8.8","10.7"
"Lincoln","2020-08-31","22","1049","2","136","8.8","11.3"
"Lincoln","2020-09-01","10","1059","0","136","8.8","9.3"
"Lincoln","2020-09-02","10","1069","0","136","8.8","8.3"
"Lincoln","2020-09-03","9","1078","0","136","5.2","7.1"
"Lincoln","2020-09-04","9","1087","0","136","1.3","7.1"
"Lincoln","2020-09-05","12","1099","0","136","1.3","5"
"Lincoln","2020-09-06","4","1103","0","136","1.3","5"
"Lincoln","2020-09-07","1","1104","0","136","0","4.4"
"Lincoln","2020-09-08","8","1112","1","137","1.8","5.3"
"Lincoln","2020-09-09","6","1118","2","139","6.5","7.7"
"Lincoln","2020-09-10","9","1127","0","139","6.5","5.9"
"Lincoln","2020-09-11","8","1135","1","140","8.3","4.8"
"Lincoln","2020-09-12","10","1145","1","141","9.8","5.5"
"Lincoln","2020-09-13","3","1148","0","141","9.8","5.5"
"Lincoln","2020-09-14","32","1180","0","141","9.8","4.9"
"Lincoln","2020-09-15","13","1193","0","141","8","4.9"
"Lincoln","2020-09-16","8","1201","1","142","5","5.8"
"Lincoln","2020-09-17","13","1214","1","143","6.1","6.3"
"Lincoln","2020-09-18","11","1225","2","145","6.9","7.6"
"Lincoln","2020-09-19","7","1232","1","146","7.5","8.6"
"Lincoln","2020-09-20","0","1232","0","146","7.5","8.6"
"Lincoln","2020-09-21","21","1253","0","146","7.5","8.6"
"Lincoln","2020-09-22","5","1258","0","146","7.5","7.7"
"Lincoln","2020-09-23","3","1261","1","147","10.5","7.7"
"Lincoln","2020-09-24","3","1264","0","147","9.4","7.7"
"Lincoln","2020-09-25","4","1268","0","147","6.8","6.9"
"Lincoln","2020-09-26","4","1272","0","147","4.8","6.1"
"Lincoln","2020-09-27","2","1274","0","147","4.8","6.1"
"Lincoln","2020-09-28","9","1283","0","147","4.8","6.1"
"Lincoln","2020-09-29","9","1292","1","148","6.3","6.9"
"Lincoln","2020-09-30","6","1298","0","148","1.6","6"
"Lincoln","2020-10-01","3","1301","0","148","1.6","5.5"
"Lincoln","2020-10-02","10","1311","1","149","3","4.9"
"Lincoln","2020-10-03","7","1318","0","149","3","3.9"
"Lincoln","2020-10-04","2","1320","0","149","3","3.9"
"Lincoln","2020-10-05","12","1332","1","150","4.2","4.5"
"Lincoln","2020-10-06","11","1343","0","150","2.6","4.5"
"Lincoln","2020-10-07","14","1357","1","151","3.6","2.6"
"Lincoln","2020-10-08","11","1368","2","153","6.2","3.9"
"Lincoln","2020-10-09","6","1374","0","153","4.8","3.9"
"Lincoln","2020-10-10","8","1382","0","153","4.8","3.9"
"Lincoln","2020-10-11","5","1387","0","153","4.8","3.9"
"Lincoln","2020-10-12","6","1393","1","154","6","5.1"
"Lincoln","2020-10-13","7","1400","0","154","6","4.3"
"Lincoln","2020-10-14","9","1409","0","154","5","4.3"
"Lincoln","2020-10-15","5","1414","1","155","5.2","5.7"
"Lincoln","2020-10-16","17","1431","2","157","6.9","5.9"
"Lincoln","2020-10-17","15","1446","0","157","6.9","5.9"
"Lincoln","2020-10-18","6","1452","2","159","11.7","8.2"
"Lincoln","2020-10-19","23","1475","3","162","11.2","8.6"
"Lincoln","2020-10-20","10","1485","1","163","12.6","9.3"
"Lincoln","2020-10-21","4","1489","0","163","12.6","8.8"
"Lincoln","2020-10-22","6","1495","1","164","12.1","8.7"
"Lincoln","2020-10-23","8","1503","0","164","10.4","8.7"
"Lincoln","2020-10-24","15","1518","0","164","10.4","8.7"
"Lincoln","2020-10-25","5","1523","0","164","5.7","8.7"
"Lincoln","2020-10-26","28","1551","1","165","4.3","7.7"
"Lincoln","2020-10-27","9","1560","0","165","2.9","7.7"
"Lincoln","2020-10-28","8","1568","5","170","11.8","12.2"
"Lincoln","2020-10-29","12","1580","1","171","10.6","11.4"
"Lincoln","2020-10-30","13","1593","1","172","11.7","11.1"
"Lincoln","2020-10-31","4","1597","0","172","11.7","11.1"
"Lincoln","2020-11-01","6","1603","0","172","11.7","8.7"
"Lincoln","2020-11-02","29","1632","4","176","13.2","8.8"
"Lincoln","2020-11-03","13","1645","2","178","15.4","9.1"
"Lincoln","2020-11-04","9","1654","1","179","8","9.9"
"Lincoln","2020-11-05","12","1666","2","181","9.2","9.9"
"Lincoln","2020-11-06","7","1673","2","183","12.2","12"
"Lincoln","2020-11-07","21","1694","1","184","12.9","12.3"
"Lincoln","2020-11-08","3","1697","0","184","12.9","12.3"
"Lincoln","2020-11-09","14","1711","2","186","13","13.1"
"Lincoln","2020-11-10","17","1728","3","189","13.3","14.3"
"Lincoln","2020-11-11","16","1744","1","190","12.6","10.3"
"Lincoln","2020-11-12","15","1759","0","190","10.2","9.7"
"Lincoln","2020-11-13","18","1777","1","191","6.9","9.6"
"Lincoln","2020-11-14","44","1821","4","195","7.5","10.2"
"Lincoln","2020-11-15","21","1842","1","196","8.2","10.6"
"Lincoln","2020-11-16","27","1869","1","197","6.7","9.8"
"Lincoln","2020-11-17","11","1880","0","197","4.2","8.7"
"Lincoln","2020-11-18","23","1903","3","200","5.2","8.9"
"Lincoln","2020-11-19","16","1919","3","203","7.8","9"
"Lincoln","2020-11-20","19","1938","4","207","10.1","8.5"
"Lincoln","2020-11-21","11","1949","1","208","10.1","8.8"
"Lincoln","2020-11-22","7","1956","0","208","9.4","8.8"
"Lincoln","2020-11-23","31","1987","3","211","10.2","8.5"
"Lincoln","2020-11-24","11","1998","0","211","10.2","7.2"
"Lincoln","2020-11-25","6","2004","1","212","10.7","8"
"Lincoln","2020-11-26","16","2020","0","212","8.1","8"
"Lincoln","2020-11-27","5","2025","0","212","5.1","7.6"
"Lincoln","2020-11-28","3","2028","0","212","3.8","6.9"
"Lincoln","2020-11-29","4","2032","0","212","3.8","6.6"
"Lincoln","2020-11-30","21","2053","2","214","3.7","7"
"Lincoln","2020-12-01","14","2067","1","215","4.8","7.5"
"Lincoln","2020-12-02","18","2085","3","218","4.8","7.8"
"Lincoln","2020-12-03","13","2098","0","218","4.8","6.4"
"Lincoln","2020-12-04","12","2110","1","219","6","5.5"
"Lincoln","2020-12-05","17","2127","2","221","7.6","5.7"
"Lincoln","2020-12-06","4","2131","1","222","11.2","7.5"
"Lincoln","2020-12-07","20","2151","0","222","9.8","6.8"
"Lincoln","2020-12-08","11","2162","2","224","11.4","8.1"
"Lincoln","2020-12-09","35","2197","2","226","9.9","7.3"
"Lincoln","2020-12-10","14","2211","1","227","10.9","7.8"
"Lincoln","2020-12-11","9","2220","0","227","9.7","7.8"
"Lincoln","2020-12-12","8","2228","2","229","11.6","9.6"
"Lincoln","2020-12-13","4","2232","0","229","8","9.6"
"Lincoln","2020-12-14","13","2245","1","230","9.1","9.5"
"Lincoln","2020-12-15","14","2259","2","232","8.5","10"
"Lincoln","2020-12-16","11","2270","4","236","12.9","11.4"
"Lincoln","2020-12-17","7","2277","2","238","16","13.4"
"Lincoln","2020-12-18","7","2284","1","239","18","13.9"
"Lincoln","2020-12-19","9","2293","1","240","16","13.8"
"Lincoln","2020-12-20","8","2301","0","240","16","12"
"Lincoln","2020-12-21","7","2308","1","241","17","13"
"Lincoln","2020-12-22","8","2316","2","243","18.5","13.5"
"Lincoln","2020-12-23","15","2331","2","245","15.2","14.1"
"Lincoln","2020-12-24","5","2336","1","246","14","15"
"Lincoln","2020-12-25","1","2337","0","246","12","15"
"Lincoln","2020-12-26","4","2341","1","247","13.9","15"
"Lincoln","2020-12-27","8","2349","4","251","21.1","18.6"
"Lincoln","2020-12-28","16","2365","0","251","19","18"
"Lincoln","2020-12-29","9","2374","1","252","17.1","17.8"
"Lincoln","2020-12-30","18","2392","5","257","19.1","17.2"
"Lincoln","2020-12-31","17","2409","2","259","18","16"
"Lincoln","2021-01-01","1","2410","0","259","18","15"
"Lincoln","2021-01-02","7","2417","2","261","18.5","16.2"
"Lincoln","2021-01-03","1","2418","1","262","25.6","23.3"
"Lincoln","2021-01-04","7","2425","1","263","27.6","23.3"
"Lincoln","2021-01-05","25","2450","7","270","30.1","23.6"
"Lincoln","2021-01-06","17","2467","5","275","30.3","24.7"
"Lincoln","2021-01-07","19","2486","2","277","30.1","24"
"Lincoln","2021-01-08","14","2500","3","280","33.2","25.6"
"Lincoln","2021-01-09","8","2508","4","284","36.2","27.3"
"Lincoln","2021-01-10","9","2517","3","287","26.7","26.2"
"Lincoln","2021-01-11","32","2549","7","294","27.8","27.7"
"Lincoln","2021-01-12","14","2563","4","298","27.9","29"
"Lincoln","2021-01-13","13","2576","3","301","27","28.6"
"Lincoln","2021-01-14","25","2601","5","306","28.3","29.2"
"Lincoln","2021-01-15","22","2623","7","313","29.8","31.5"
"Lincoln","2021-01-16","8","2631","1","314","24.5","30.3"
"Lincoln","2021-01-17","10","2641","7","321","29.7","28.2"
"Lincoln","2021-01-18","27","2668","6","327","29.7","28.8"
"Lincoln","2021-01-19","20","2688","7","334","30.7","29.3"
"Lincoln","2021-01-20","15","2703","4","338","31.2","29.1"
"Lincoln","2021-01-21","17","2720","4","342","31.7","30"
"Lincoln","2021-01-22","7","2727","0","342","27.1","28.5"
"Lincoln","2021-01-23","2","2729","0","342","25.3","24.9"
"Lincoln","2021-01-24","4","2733","0","342","15.3","22.5"
"Lincoln","2021-01-25","5","2738","2","344","17.9","23.8"
"Lincoln","2021-01-26","1","2739","0","344","12.9","21.8"
"Lincoln","2021-01-27","0","2739","0","344","9.1","20.1"
"Long","2020-02-01","0","0","0","0",".","."
"Long","2020-02-02","0","0","0","0",".","."
"Long","2020-02-03","0","0","0","0",".","."
"Long","2020-02-04","0","0","0","0",".","."
"Long","2020-02-05","0","0","0","0",".","."
"Long","2020-02-06","0","0","0","0",".","."
"Long","2020-02-07","0","0","0","0","0","."
"Long","2020-02-08","0","0","0","0","0","."
"Long","2020-02-09","0","0","0","0","0","."
"Long","2020-02-10","0","0","0","0","0","."
"Long","2020-02-11","0","0","0","0","0","."
"Long","2020-02-12","0","0","0","0","0","."
"Long","2020-02-13","0","0","0","0","0","."
"Long","2020-02-14","0","0","0","0","0","0"
"Long","2020-02-15","0","0","0","0","0","0"
"Long","2020-02-16","0","0","0","0","0","0"
"Long","2020-02-17","0","0","0","0","0","0"
"Long","2020-02-18","0","0","0","0","0","0"
"Long","2020-02-19","0","0","0","0","0","0"
"Long","2020-02-20","0","0","0","0","0","0"
"Long","2020-02-21","0","0","0","0","0","0"
"Long","2020-02-22","0","0","0","0","0","0"
"Long","2020-02-23","0","0","0","0","0","0"
"Long","2020-02-24","0","0","0","0","0","0"
"Long","2020-02-25","0","0","0","0","0","0"
"Long","2020-02-26","0","0","0","0","0","0"
"Long","2020-02-27","0","0","0","0","0","0"
"Long","2020-02-28","0","0","0","0","0","0"
"Long","2020-02-29","0","0","0","0","0","0"
"Long","2020-03-01","0","0","0","0","0","0"
"Long","2020-03-02","0","0","0","0","0","0"
"Long","2020-03-03","0","0","0","0","0","0"
"Long","2020-03-04","0","0","0","0","0","0"
"Long","2020-03-05","0","0","0","0","0","0"
"Long","2020-03-06","0","0","0","0","0","0"
"Long","2020-03-07","0","0","0","0","0","0"
"Long","2020-03-08","0","0","0","0","0","0"
"Long","2020-03-09","0","0","0","0","0","0"
"Long","2020-03-10","0","0","0","0","0","0"
"Long","2020-03-11","0","0","0","0","0","0"
"Long","2020-03-12","4","4","0","0","0","0"
"Long","2020-03-13","1","5","0","0","0","0"
"Long","2020-03-14","0","5","0","0","0","0"
"Long","2020-03-15","0","5","0","0","0","0"
"Long","2020-03-16","1","6","0","0","0","0"
"Long","2020-03-17","1","7","1","1","14.3","7.1"
"Long","2020-03-18","4","11","0","1","14.3","7.1"
"Long","2020-03-19","1","12","0","1","14.3","7.1"
"Long","2020-03-20","0","12","0","1","14.3","7.1"
"Long","2020-03-21","3","15","0","1","14.3","7.1"
"Long","2020-03-22","0","15","0","1","14.3","7.1"
"Long","2020-03-23","1","16","0","1","14.3","7.1"
"Long","2020-03-24","3","19","0","1","0","7.1"
"Long","2020-03-25","12","31","0","1","0","7.1"
"Long","2020-03-26","1","32","0","1","0","7.1"
"Long","2020-03-27","6","38","0","1","0","7.1"
"Long","2020-03-28","0","38","0","1","0","7.1"
"Long","2020-03-29","2","40","0","1","0","7.1"
"Long","2020-03-30","3","43","0","1","0","7.1"
"Long","2020-03-31","0","43","0","1","0","0"
"Long","2020-04-01","2","45","0","1","0","0"
"Long","2020-04-02","2","47","0","1","0","0"
"Long","2020-04-03","6","53","0","1","0","0"
"Long","2020-04-04","7","60","0","1","0","0"
"Long","2020-04-05","0","60","0","1","0","0"
"Long","2020-04-06","9","69","0","1","0","0"
"Long","2020-04-07","6","75","0","1","0","0"
"Long","2020-04-08","9","84","0","1","0","0"
"Long","2020-04-09","2","86","0","1","0","0"
"Long","2020-04-10","2","88","0","1","0","0"
"Long","2020-04-11","0","88","0","1","0","0"
"Long","2020-04-12","2","90","0","1","0","0"
"Long","2020-04-13","4","94","0","1","0","0"
"Long","2020-04-14","5","99","0","1","0","0"
"Long","2020-04-15","0","99","0","1","0","0"
"Long","2020-04-16","5","104","0","1","0","0"
"Long","2020-04-17","4","108","0","1","0","0"
"Long","2020-04-18","1","109","0","1","0","0"
"Long","2020-04-19","2","111","0","1","0","0"
"Long","2020-04-20","3","114","0","1","0","0"
"Long","2020-04-21","10","124","0","1","0","0"
"Long","2020-04-22","5","129","0","1","0","0"
"Long","2020-04-23","6","135","1","2","2.4","1.2"
"Long","2020-04-24","9","144","1","3","4","2"
"Long","2020-04-25","1","145","0","3","4","2"
"Long","2020-04-26","1","146","0","3","4","2"
"Long","2020-04-27","3","149","0","3","4","2"
"Long","2020-04-28","4","153","0","3","4","2"
"Long","2020-04-29","4","157","0","3","4","2"
"Long","2020-04-30","3","160","0","3","1.6","2"
"Long","2020-05-01","21","181","0","3","0","2"
"Long","2020-05-02","2","183","0","3","0","2"
"Long","2020-05-03","2","185","0","3","0","2"
"Long","2020-05-04","19","204","0","3","0","2"
"Long","2020-05-05","12","216","0","3","0","2"
"Long","2020-05-06","7","223","0","3","0","2"
"Long","2020-05-07","118","341","1","4","0.1","0.9"
"Long","2020-05-08","1","342","0","4","0.1","0.1"
"Long","2020-05-09","0","342","0","4","0.1","0.1"
"Long","2020-05-10","1","343","0","4","0.1","0.1"
"Long","2020-05-11","15","358","0","4","0.1","0.1"
"Long","2020-05-12","5","363","0","4","0.1","0.1"
"Long","2020-05-13","5","368","1","5","3","1.5"
"Long","2020-05-14","70","438","6","11","4.1","2.1"
"Long","2020-05-15","3","441","0","11","4.1","2.1"
"Long","2020-05-16","0","441","0","11","4.1","2.1"
"Long","2020-05-17","0","441","0","11","4.1","2.1"
"Long","2020-05-18","6","447","2","13","8.8","4.5"
"Long","2020-05-19","10","457","0","13","8.8","4.5"
"Long","2020-05-20","3","460","0","13","6","4.5"
"Long","2020-05-21","43","503","0","13","4.8","4.4"
"Long","2020-05-22","7","510","0","13","4.8","4.4"
"Long","2020-05-23","1","511","0","13","4.8","4.4"
"Long","2020-05-24","0","511","0","13","4.8","4.4"
"Long","2020-05-25","1","512","0","13","0","4.4"
"Long","2020-05-26","3","515","0","13","0","4.4"
"Long","2020-05-27","3","518","0","13","0","3"
"Long","2020-05-28","110","628","4","17","0.5","2.6"
"Long","2020-05-29","3","631","0","17","0.5","2.6"
"Long","2020-05-30","0","631","0","17","0.5","2.6"
"Long","2020-05-31","0","631","0","17","0.5","2.6"
"Long","2020-06-01","3","634","0","17","0.5","0.3"
"Long","2020-06-02","5","639","0","17","0.5","0.3"
"Long","2020-06-03","7","646","0","17","0.5","0.3"
"Long","2020-06-04","11","657","1","18","1.3","0.9"
"Long","2020-06-05","6","663","0","18","1.3","0.9"
"Long","2020-06-06","1","664","0","18","1.3","0.9"
"Long","2020-06-07","1","665","0","18","1.3","0.9"
"Long","2020-06-08","17","682","2","20","3","1.7"
"Long","2020-06-09","12","694","0","20","3","1.7"
"Long","2020-06-10","8","702","0","20","3","1.7"
"Long","2020-06-11","11","713","0","20","1.7","1.5"
"Long","2020-06-12","9","722","0","20","1.7","1.5"
"Long","2020-06-13","0","722","0","20","1.7","1.5"
"Long","2020-06-14","2","724","0","20","1.7","1.5"
"Long","2020-06-15","12","736","0","20","0","1.5"
"Long","2020-06-16","16","752","2","22","1.8","2.4"
"Long","2020-06-17","6","758","0","22","1.8","2.4"
"Long","2020-06-18","12","770","1","23","3","2.3"
"Long","2020-06-19","13","783","2","25","5.2","3.4"
"Long","2020-06-20","1","784","0","25","5.2","3.4"
"Long","2020-06-21","2","786","2","27","19.5","10.6"
"Long","2020-06-22","17","803","0","27","19.5","9.7"
"Long","2020-06-23","13","816","2","29","19.9","10.8"
"Long","2020-06-24","16","832","2","31","21.7","11.7"
"Long","2020-06-25","21","853","0","31","20.5","11.7"
"Long","2020-06-26","24","877","3","34","20.1","12.6"
"Long","2020-06-27","3","880","0","34","20.1","12.6"
"Long","2020-06-28","2","882","0","34","5.8","12.6"
"Long","2020-06-29","24","906","3","37","7.6","13.5"
"Long","2020-06-30","16","922","0","37","5.4","12.6"
"Long","2020-07-01","32","954","3","40","4.9","13.3"
"Long","2020-07-02","168","1122","15","55","6.2","13.3"
"Long","2020-07-03","8","1130","0","55","4.4","12.2"
"Long","2020-07-04","3","1133","0","55","4.4","12.2"
"Long","2020-07-05","3","1136","0","55","4.4","5.1"
"Long","2020-07-06","115","1251","6","61","3.4","5.5"
"Long","2020-07-07","59","1310","9","70","5.5","5.4"
"Long","2020-07-08","18","1328","2","72","5.8","5.3"
"Long","2020-07-09","35","1363","2","74","5.3","5.8"
"Long","2020-07-10","17","1380","2","76","7","5.7"
"Long","2020-07-11","5","1385","2","78","12.7","8.6"
"Long","2020-07-12","8","1393","1","79","14.5","9.5"
"Long","2020-07-13","29","1422","5","84","16.2","9.8"
"Long","2020-07-14","57","1479","3","87","14.8","10.2"
"Long","2020-07-15","34","1513","3","90","14.5","10.1"
"Long","2020-07-16","45","1558","2","92","14.3","9.8"
"Long","2020-07-17","19","1577","1","93","13.4","10.2"
"Long","2020-07-18","4","1581","0","93","7.6","10.2"
"Long","2020-07-19","8","1589","2","95","9.4","12"
"Long","2020-07-20","93","1682","1","96","7.1","11.7"
"Long","2020-07-21","116","1798","8","104","7.4","11.1"
"Long","2020-07-22","21","1819","3","107","8.1","11.3"
"Long","2020-07-23","54","1873","3","110","8.3","11.3"
"Long","2020-07-24","11","1884","3","113","11.4","12.4"
"Long","2020-07-25","3","1887","0","113","11.4","9.5"
"Long","2020-07-26","8","1895","1","114","9.7","9.5"
"Long","2020-07-27","16","1911","4","118","13.1","10.1"
"Long","2020-07-28","57","1968","3","121","12.8","10.1"
"Long","2020-07-29","10","1978","2","123","13.7","10.9"
"Long","2020-07-30","43","2021","0","123","12.9","10.6"
"Long","2020-07-31","13","2034","1","124","10.1","10.8"
"Long","2020-08-01","7","2041","0","124","10.1","10.8"
"Long","2020-08-02","8","2049","3","127","13.6","11.6"
"Long","2020-08-03","17","2066","1","128","10.9","12"
"Long","2020-08-04","30","2096","2","130","11.1","12"
"Long","2020-08-05","10","2106","1","131","9.7","11.7"
"Long","2020-08-06","80","2186","3","134","10.2","11.5"
"Long","2020-08-07","7","2193","1","135","11.2","10.6"
"Long","2020-08-08","10","2203","5","140","18.3","14.2"
"Long","2020-08-09","3","2206","2","142","22.5","18.1"
"Long","2020-08-10","16","2222","4","146","25.2","18.1"
"Long","2020-08-11","55","2277","4","150","25.3","18.2"
"Long","2020-08-12","17","2294","6","156","28.9","19.3"
"Long","2020-08-13","69","2363","6","162","29.6","19.9"
"Long","2020-08-14","22","2385","2","164","28.9","20"
"Long","2020-08-15","8","2393","4","168","28.9","23.6"
"Long","2020-08-16","1","2394","0","168","19.3","20.9"
"Long","2020-08-17","89","2483","2","170","16.1","20.6"
"Long","2020-08-18","53","2536","6","176","16.7","21"
"Long","2020-08-19","7","2543","4","180","19.8","24.3"
"Long","2020-08-20","47","2590","8","188","21","25.3"
"Long","2020-08-21","9","2599","0","188","19.7","24.3"
"Long","2020-08-22","6","2605","0","188","12.5","20.7"
"Long","2020-08-23","5","2610","0","188","12.5","15.9"
"Long","2020-08-24","12","2622","2","190","14.6","15.3"
"Long","2020-08-25","38","2660","5","195","14.9","15.8"
"Long","2020-08-26","9","2669","2","197","9.9","14.8"
"Long","2020-08-27","126","2795","2","199","7.7","14.3"
"Long","2020-08-28","17","2812","2","201","9.3","14.5"
"Long","2020-08-29","1","2813","0","201","9.3","10.9"
"Long","2020-08-30","6","2819","2","203","14.1","13.3"
"Long","2020-08-31","9","2828","1","204","13.3","14"
"Long","2020-09-01","45","2873","6","210","13.3","14.1"
"Long","2020-09-02","9","2882","0","210","10.2","10"
"Long","2020-09-03","115","2997","6","216","10.7","9.2"
"Long","2020-09-04","13","3010","1","217","10.1","9.7"
"Long","2020-09-05","7","3017","2","219","14.2","11.8"
"Long","2020-09-06","0","3017","0","219","9.4","11.8"
"Long","2020-09-07","5","3022","3","222","16.4","14.9"
"Long","2020-09-08","31","3053","6","228","17.3","15.3"
"Long","2020-09-09","12","3065","2","230","19.6","14.9"
"Long","2020-09-10","131","3196","4","234","19.3","15"
"Long","2020-09-11","11","3207","0","234","18.2","14.2"
"Long","2020-09-12","8","3215","1","235","15.9","15.1"
"Long","2020-09-13","7","3222","3","238","22.1","15.7"
"Long","2020-09-14","17","3239","4","242","16.9","16.6"
"Long","2020-09-15","39","3278","2","244","14.8","16"
"Long","2020-09-16","11","3289","2","246","15","17.3"
"Long","2020-09-17","34","3323","1","247","15","17.2"
"Long","2020-09-18","13","3336","0","247","15","16.6"
"Long","2020-09-19","6","3342","1","248","15.6","15.8"
"Long","2020-09-20","1","3343","0","248","9.5","15.8"
"Long","2020-09-21","14","3357","1","249","7.2","12"
"Long","2020-09-22","51","3408","11","260","9.5","12.2"
"Long","2020-09-23","12","3420","0","260","6.9","11"
"Long","2020-09-24","45","3465","3","263","7.4","11.2"
"Long","2020-09-25","10","3475","0","263","7.4","11.2"
"Long","2020-09-26","2","3477","1","264","12.2","13.9"
"Long","2020-09-27","1","3478","0","264","12.2","10.8"
"Long","2020-09-28","22","3500","0","264","11.2","9.2"
"Long","2020-09-29","48","3548","1","265","8.4","8.9"
"Long","2020-09-30","7","3555","0","265","8.4","7.6"
"Long","2020-10-01","41","3596","2","267","8.1","7.8"
"Long","2020-10-02","9","3605","0","267","8.1","7.8"
"Long","2020-10-03","4","3609","0","267","1","6.6"
"Long","2020-10-04","6","3615","0","267","1","6.6"
"Long","2020-10-05","15","3630","1","268","1.9","6.6"
"Long","2020-10-06","58","3688","3","271","2.4","5.4"
"Long","2020-10-07","9","3697","0","271","2.4","5.4"
"Long","2020-10-08","24","3721","0","271","1.7","4.9"
"Long","2020-10-09","8","3729","0","271","1.7","4.9"
"Long","2020-10-10","5","3734","1","272","4.5","2.8"
"Long","2020-10-11","5","3739","0","272","4.5","2.8"
"Long","2020-10-12","12","3751","0","272","3.6","2.8"
"Long","2020-10-13","25","3776","1","273","3.4","2.9"
"Long","2020-10-14","5","3781","0","273","3.4","2.9"
"Long","2020-10-15","9","3790","0","273","3.4","2.6"
"Long","2020-10-16","13","3803","3","276","6.7","4.2"
"Long","2020-10-17","4","3807","3","279","14.6","9.6"
"Long","2020-10-18","3","3810","0","279","14.6","9.6"
"Long","2020-10-19","15","3825","2","281","16.5","10"
"Long","2020-10-20","32","3857","0","281","15.9","9.7"
"Long","2020-10-21","6","3863","0","281","15.9","9.7"
"Long","2020-10-22","17","3880","1","282","16.8","10.1"
"Long","2020-10-23","13","3893","1","283","14.6","10.6"
"Long","2020-10-24","3","3896","0","283","3.8","9.2"
"Long","2020-10-25","5","3901","0","283","3.8","9.2"
"Long","2020-10-26","3","3904","0","283","1.9","9.2"
"Long","2020-10-27","41","3945","4","287","3.3","9.6"
"Long","2020-10-28","11","3956","2","289","5.9","10.9"
"Long","2020-10-29","5","3961","0","289","5.1","10.9"
"Long","2020-10-30","9","3970","0","289","4","9.3"
"Long","2020-10-31","7","3977","1","290","6","4.9"
"Long","2020-11-01","2","3979","1","291","13.2","8.5"
"Long","2020-11-02","8","3987","0","291","13.2","7.6"
"Long","2020-11-03","18","4005","0","291","11.8","7.6"
"Long","2020-11-04","10","4015","0","291","9.2","7.6"
"Long","2020-11-05","5","4020","1","292","12","8.6"
"Long","2020-11-06","20","4040","0","292","12","8"
"Long","2020-11-07","3","4043","0","292","10","8"
"Long","2020-11-08","2","4045","0","292","2.9","8"
"Long","2020-11-09","15","4060","0","292","2.9","8"
"Long","2020-11-10","31","4091","2","294","3.8","7.8"
"Long","2020-11-11","8","4099","0","294","3.8","6.5"
"Long","2020-11-12","13","4112","4","298","5.3","8.7"
"Long","2020-11-13","11","4123","0","298","5.3","8.7"
"Long","2020-11-14","9","4132","1","299","6.9","8.5"
"Long","2020-11-15","6","4138","3","302","14","8.5"
"Long","2020-11-16","13","4151","1","303","15.1","9"
"Long","2020-11-17","39","4190","2","305","15","9.4"
"Long","2020-11-18","10","4200","0","305","15","9.4"
"Long","2020-11-19","15","4215","0","305","10.6","7.9"
"Long","2020-11-20","12","4227","0","305","10.6","7.9"
"Long","2020-11-21","11","4238","4","309","14.2","10.5"
"Long","2020-11-22","6","4244","0","309","7","10.5"
"Long","2020-11-23","9","4253","0","309","5.9","10.5"
"Long","2020-11-24","42","4295","1","310","5.5","10.2"
"Long","2020-11-25","13","4308","0","310","5.5","10.2"
"Long","2020-11-26","1","4309","0","310","5.5","8"
"Long","2020-11-27","6","4315","0","310","5.5","8"
"Long","2020-11-28","6","4321","2","312","5.1","9.6"
"Long","2020-11-29","17","4338","1","313","5.9","6.5"
"Long","2020-11-30","19","4357","2","315","7.4","6.7"
"Long","2020-12-01","39","4396","5","320","8.9","7.2"
"Long","2020-12-02","11","4407","1","321","10.2","7.9"
"Long","2020-12-03","12","4419","2","323","12.6","9.1"
"Long","2020-12-04","10","4429","0","323","12.6","9.1"
"Long","2020-12-05","8","4437","4","327","15","10.1"
"Long","2020-12-06","1","4438","1","328","28.4","17.2"
"Long","2020-12-07","12","4450","1","329","28.1","17.8"
"Long","2020-12-08","68","4518","5","334","27.3","18.1"
"Long","2020-12-09","20","4538","0","334","26.1","18.1"
"Long","2020-12-10","20","4558","1","335","24.4","18.5"
"Long","2020-12-11","7","4565","2","337","28.5","20.5"
"Long","2020-12-12","7","4572","1","338","23.4","19.2"
"Long","2020-12-13","15","4587","7","345","15.7","22.1"
"Long","2020-12-14","25","4612","6","351","18","23.1"
"Long","2020-12-15","80","4692","11","362","18.9","23.1"
"Long","2020-12-16","27","4719","6","368","22.1","24.1"
"Long","2020-12-17","19","4738","2","370","22.9","23.6"
"Long","2020-12-18","21","4759","8","378","24.2","26.3"
"Long","2020-12-19","12","4771","3","381","25.8","24.6"
"Long","2020-12-20","6","4777","2","383","23.8","19.8"
"Long","2020-12-21","16","4793","3","386","23.1","20.5"
"Long","2020-12-22","97","4890","12","398","22.9","20.9"
"Long","2020-12-23","20","4910","2","400","21.2","21.6"
"Long","2020-12-24","12","4922","2","402","22","22.4"
"Long","2020-12-25","2","4924","1","403","23.7","24"
"Long","2020-12-26","7","4931","0","403","20.2","23"
"Long","2020-12-27","4","4935","1","404","19","21.4"
"Long","2020-12-28","21","4956","2","406","17.7","20.4"
"Long","2020-12-29","102","5058","18","424","18.4","20.7"
"Long","2020-12-30","14","5072","2","426","19","20.1"
"Long","2020-12-31","15","5087","3","429","19.5","20.8"
"Long","2021-01-01","0","5087","0","429","12.4","18"
"Long","2021-01-02","15","5102","2","431","14.3","17.2"
"Long","2021-01-03","7","5109","1","432","12.7","15.8"
"Long","2021-01-04","18","5127","2","434","13","15.3"
"Long","2021-01-05","117","5244","13","447","12","15.2"
"Long","2021-01-06","19","5263","5","452","13.7","16.4"
"Long","2021-01-07","17","5280","6","458","15.9","17.7"
"Long","2021-01-08","20","5300","1","459","16.6","14.5"
"Long","2021-01-09","6","5306","1","460","17.1","15.7"
"Long","2021-01-10","6","5312","1","461","17.5","15.1"
"Long","2021-01-11","14","5326","3","464","18.9","15.9"
"Long","2021-01-12","104","5430","10","474","18.7","15.4"
"Long","2021-01-13","22","5452","7","481","19.5","16.6"
"Long","2021-01-14","26","5478","3","484","16.1","16"
"Long","2021-01-15","27","5505","3","487","17","16.8"
"Long","2021-01-16","9","5514","4","491","20.9","19"
"Long","2021-01-17","6","5520","0","491","18.6","18"
"Long","2021-01-18","22","5542","2","493","16.8","17.9"
"Long","2021-01-19","69","5611","9","502","17.3","18"
"Long","2021-01-20","17","5628","3","505","15.3","17.4"
"Long","2021-01-21","33","5661","9","514","17.5","16.8"
"Long","2021-01-22","23","5684","3","517","17.8","17.4"
"Long","2021-01-23","19","5703","5","522","15.2","18.1"
"Long","2021-01-24","5","5708","1","523","18.1","18.3"
"Long","2021-01-25","5","5713","0","523","16.8","16.8"
"Long","2021-01-26","0","5713","0","523","14.9","16.1"
"Long","2021-01-27","0","5713","0","523","12.4","13.8"
"Lowndes","2020-02-01","0","0","0","0",".","."
"Lowndes","2020-02-02","0","0","0","0",".","."
"Lowndes","2020-02-03","0","0","0","0",".","."
"Lowndes","2020-02-04","0","0","0","0",".","."
"Lowndes","2020-02-05","0","0","0","0",".","."
"Lowndes","2020-02-06","0","0","0","0",".","."
"Lowndes","2020-02-07","0","0","0","0","0","."
"Lowndes","2020-02-08","0","0","0","0","0","."
"Lowndes","2020-02-09","0","0","0","0","0","."
"Lowndes","2020-02-10","0","0","0","0","0","."
"Lowndes","2020-02-11","0","0","0","0","0","."
"Lowndes","2020-02-12","0","0","0","0","0","."
"Lowndes","2020-02-13","0","0","0","0","0","."
"Lowndes","2020-02-14","0","0","0","0","0","0"
"Lowndes","2020-02-15","0","0","0","0","0","0"
"Lowndes","2020-02-16","0","0","0","0","0","0"
"Lowndes","2020-02-17","0","0","0","0","0","0"
"Lowndes","2020-02-18","0","0","0","0","0","0"
"Lowndes","2020-02-19","0","0","0","0","0","0"
"Lowndes","2020-02-20","0","0","0","0","0","0"
"Lowndes","2020-02-21","0","0","0","0","0","0"
"Lowndes","2020-02-22","0","0","0","0","0","0"
"Lowndes","2020-02-23","0","0","0","0","0","0"
"Lowndes","2020-02-24","0","0","0","0","0","0"
"Lowndes","2020-02-25","0","0","0","0","0","0"
"Lowndes","2020-02-26","0","0","0","0","0","0"
"Lowndes","2020-02-27","0","0","0","0","0","0"
"Lowndes","2020-02-28","0","0","0","0","0","0"
"Lowndes","2020-02-29","0","0","0","0","0","0"
"Lowndes","2020-03-01","0","0","0","0","0","0"
"Lowndes","2020-03-02","0","0","0","0","0","0"
"Lowndes","2020-03-03","0","0","0","0","0","0"
"Lowndes","2020-03-04","0","0","0","0","0","0"
"Lowndes","2020-03-05","0","0","0","0","0","0"
"Lowndes","2020-03-06","0","0","0","0","0","0"
"Lowndes","2020-03-07","0","0","0","0","0","0"
"Lowndes","2020-03-08","0","0","0","0","0","0"
"Lowndes","2020-03-09","1","1","1","1","14.3","7.1"
"Lowndes","2020-03-10","0","1","0","1","14.3","7.1"
"Lowndes","2020-03-11","0","1","0","1","14.3","7.1"
"Lowndes","2020-03-12","3","4","0","1","14.3","7.1"
"Lowndes","2020-03-13","3","7","1","2","19","9.5"
"Lowndes","2020-03-14","1","8","0","2","19","9.5"
"Lowndes","2020-03-15","0","8","0","2","19","9.5"
"Lowndes","2020-03-16","2","10","0","2","4.8","9.5"
"Lowndes","2020-03-17","14","24","4","6","8.8","11.6"
"Lowndes","2020-03-18","23","47","2","8","10.1","12.2"
"Lowndes","2020-03-19","15","62","1","9","11","12.7"
"Lowndes","2020-03-20","24","86","3","12","8.1","13.6"
"Lowndes","2020-03-21","7","93","2","14","12.1","15.6"
"Lowndes","2020-03-22","1","94","0","14","12.1","15.6"
"Lowndes","2020-03-23","11","105","0","14","12.1","8.5"
"Lowndes","2020-03-24","23","128","3","17","9.9","9.4"
"Lowndes","2020-03-25","23","151","1","18","9.3","9.7"
"Lowndes","2020-03-26","32","183","1","19","8.8","9.9"
"Lowndes","2020-03-27","21","204","4","23","9.7","8.9"
"Lowndes","2020-03-28","4","208","0","23","5.7","8.9"
"Lowndes","2020-03-29","3","211","0","23","5.7","8.9"
"Lowndes","2020-03-30","52","263","19","42","10.9","11.5"
"Lowndes","2020-03-31","40","303","1","43","9.4","9.6"
"Lowndes","2020-04-01","44","347","8","51","11.3","10.3"
"Lowndes","2020-04-02","36","383","5","56","12.9","10.8"
"Lowndes","2020-04-03","37","420","5","61","12.1","10.9"
"Lowndes","2020-04-04","7","427","1","62","14.1","9.9"
"Lowndes","2020-04-05","7","434","0","62","14.1","9.9"
"Lowndes","2020-04-06","30","464","3","65","10.3","10.6"
"Lowndes","2020-04-07","37","501","5","70","11.9","10.6"
"Lowndes","2020-04-08","38","539","6","76","11.6","11.5"
"Lowndes","2020-04-09","49","588","12","88","13.1","13"
"Lowndes","2020-04-10","33","621","5","93","13.3","12.7"
"Lowndes","2020-04-11","10","631","0","93","11.3","12.7"
"Lowndes","2020-04-12","15","646","6","99","17","15.6"
"Lowndes","2020-04-13","27","673","1","100","16.1","13.2"
"Lowndes","2020-04-14","38","711","7","107","16.8","14.4"
"Lowndes","2020-04-15","50","761","6","113","16.3","13.9"
"Lowndes","2020-04-16","43","804","3","116","13.8","13.4"
"Lowndes","2020-04-17","67","871","11","127","13.9","13.6"
"Lowndes","2020-04-18","36","907","1","128","14.3","12.8"
"Lowndes","2020-04-19","58","965","4","132","9.6","13.3"
"Lowndes","2020-04-20","207","1172","17","149","10.2","13.2"
"Lowndes","2020-04-21","274","1446","18","167","8.6","12.7"
"Lowndes","2020-04-22","136","1582","7","174","7.6","11.9"
"Lowndes","2020-04-23","53","1635","5","179","7.9","10.8"
"Lowndes","2020-04-24","180","1815","4","183","5.9","9.9"
"Lowndes","2020-04-25","19","1834","1","184","6.2","10.3"
"Lowndes","2020-04-26","5","1839","1","185","8.1","8.9"
"Lowndes","2020-04-27","165","2004","4","189","7.3","8.8"
"Lowndes","2020-04-28","106","2110","6","195","7.2","7.9"
"Lowndes","2020-04-29","107","2217","5","200","7.1","7.3"
"Lowndes","2020-04-30","84","2301","5","205","6.6","7.3"
"Lowndes","2020-05-01","96","2397","8","213","7.5","6.7"
"Lowndes","2020-05-02","12","2409","0","213","6.7","6.5"
"Lowndes","2020-05-03","13","2422","2","215","6.1","7.1"
"Lowndes","2020-05-04","107","2529","5","220","6.4","6.8"
"Lowndes","2020-05-05","113","2642","8","228","6.6","6.9"
"Lowndes","2020-05-06","89","2731","8","236","7.2","7.1"
"Lowndes","2020-05-07","88","2819","7","243","7.5","7"
"Lowndes","2020-05-08","77","2896","5","248","7.2","7.3"
"Lowndes","2020-05-09","21","2917","2","250","8.6","7.7"
"Lowndes","2020-05-10","6","2923","0","250","6.4","6.2"
"Lowndes","2020-05-11","270","3193","12","262","6.4","6.4"
"Lowndes","2020-05-12","426","3619","12","274","5.7","6.2"
"Lowndes","2020-05-13","105","3724","2","276","4.7","6"
"Lowndes","2020-05-14","126","3850","15","291","5.3","6.4"
"Lowndes","2020-05-15","104","3954","8","299","5.5","6.3"
"Lowndes","2020-05-16","21","3975","1","300","4.8","6.7"
"Lowndes","2020-05-17","16","3991","2","302","6.6","6.5"
"Lowndes","2020-05-18","176","4167","34","336","8.7","7.5"
"Lowndes","2020-05-19","103","4270","0","336","8.3","7"
"Lowndes","2020-05-20","107","4377","4","340","8.6","6.6"
"Lowndes","2020-05-21","160","4537","5","345","7.3","6.3"
"Lowndes","2020-05-22","136","4673","15","360","7.8","6.6"
"Lowndes","2020-05-23","34","4707","6","366","9.6","7.2"
"Lowndes","2020-05-24","6","4713","1","367","10.2","8.4"
"Lowndes","2020-05-25","23","4736","3","370","9.3","9"
"Lowndes","2020-05-26","131","4867","19","389","11.4","9.8"
"Lowndes","2020-05-27","146","5013","17","406","12.5","10.5"
"Lowndes","2020-05-28","166","5179","9","415","12.9","10.1"
"Lowndes","2020-05-29","162","5341","20","435","13","10.4"
"Lowndes","2020-05-30","63","5404","9","444","12.6","11.1"
"Lowndes","2020-05-31","11","5415","1","445","11.5","10.8"
"Lowndes","2020-06-01","228","5643","29","474","11.4","10.4"
"Lowndes","2020-06-02","205","5848","26","500","11.2","11.3"
"Lowndes","2020-06-03","366","6214","38","538","11","11.8"
"Lowndes","2020-06-04","313","6527","48","586","12.4","12.6"
"Lowndes","2020-06-05","295","6822","28","614","12","12.5"
"Lowndes","2020-06-06","71","6893","8","622","11.6","12.1"
"Lowndes","2020-06-07","27","6920","8","630","14.5","13"
"Lowndes","2020-06-08","317","7237","47","677","14.8","13.1"
"Lowndes","2020-06-09","254","7491","31","708","14.7","13"
"Lowndes","2020-06-10","242","7733","46","754","16","13.5"
"Lowndes","2020-06-11","423","8156","50","804","15.5","13.9"
"Lowndes","2020-06-12","411","8567","51","855","15.9","13.9"
"Lowndes","2020-06-13","71","8638","20","875","18.3","14.9"
"Lowndes","2020-06-14","41","8679","12","887","18.2","16.4"
"Lowndes","2020-06-15","520","9199","76","963","18.2","16.5"
"Lowndes","2020-06-16","500","9699","31","994","17.4","16"
"Lowndes","2020-06-17","392","10091","46","1040","16.3","16.1"
"Lowndes","2020-06-18","426","10517","34","1074","15.8","15.6"
"Lowndes","2020-06-19","394","10911","59","1133","16.1","16"
"Lowndes","2020-06-20","90","11001","17","1150","14.8","16.6"
"Lowndes","2020-06-21","53","11054","14","1164","14.4","16.3"
"Lowndes","2020-06-22","520","11574","63","1227","14","16.1"
"Lowndes","2020-06-23","406","11980","77","1304","15.9","16.6"
"Lowndes","2020-06-24","377","12357","48","1352","16","16.2"
"Lowndes","2020-06-25","402","12759","46","1398","16.5","16.1"
"Lowndes","2020-06-26","510","13269","56","1454","15.9","16"
"Lowndes","2020-06-27","70","13339","12","1466","15.7","15.2"
"Lowndes","2020-06-28","52","13391","13","1479","15.5","14.9"
"Lowndes","2020-06-29","746","14137","163","1642","16.9","15.5"
"Lowndes","2020-06-30","833","14970","201","1843","17.6","16.7"
"Lowndes","2020-07-01","503","15473","75","1918","17.9","17"
"Lowndes","2020-07-02","509","15982","95","2013","19","17.7"
"Lowndes","2020-07-03","181","16163","27","2040","19.5","17.7"
"Lowndes","2020-07-04","105","16268","12","2052","18.7","17.2"
"Lowndes","2020-07-05","25","16293","5","2057","18","16.7"
"Lowndes","2020-07-06","485","16778","144","2201","19.1","18"
"Lowndes","2020-07-07","436","17214","98","2299","18.9","18.2"
"Lowndes","2020-07-08","368","17582","71","2370","19.5","18.7"
"Lowndes","2020-07-09","383","17965","71","2441","19.5","19.2"
"Lowndes","2020-07-10","416","18381","91","2532","20.5","20"
"Lowndes","2020-07-11","94","18475","17","2549","21.4","20.1"
"Lowndes","2020-07-12","33","18508","7","2556","21.6","19.8"
"Lowndes","2020-07-13","333","18841","116","2672","22.3","20.7"
"Lowndes","2020-07-14","475","19316","81","2753","21.6","20.2"
"Lowndes","2020-07-15","458","19774","81","2834","21.3","20.4"
"Lowndes","2020-07-16","388","20162","66","2900","21.1","20.3"
"Lowndes","2020-07-17","413","20575","66","2966","20.3","20.4"
"Lowndes","2020-07-18","108","20683","9","2975","18.9","20.1"
"Lowndes","2020-07-19","38","20721","0","2975","15.8","18.7"
"Lowndes","2020-07-20","551","21272","102","3077","13.5","17.9"
"Lowndes","2020-07-21","554","21826","101","3178","13.7","17.6"
"Lowndes","2020-07-22","614","22440","90","3268","13.2","17.3"
"Lowndes","2020-07-23","740","23180","127","3395","13.3","17.2"
"Lowndes","2020-07-24","529","23709","65","3460","12.7","16.5"
"Lowndes","2020-07-25","144","23853","14","3474","12.9","15.9"
"Lowndes","2020-07-26","51","23904","12","3486","16.3","16.1"
"Lowndes","2020-07-27","718","24622","169","3655","17","15.3"
"Lowndes","2020-07-28","394","25016","55","3710","16.4","15"
"Lowndes","2020-07-29","393","25409","77","3787","17.1","15.2"
"Lowndes","2020-07-30","576","25985","75","3862","16.5","14.9"
"Lowndes","2020-07-31","389","26374","58","3920","16.9","14.8"
"Lowndes","2020-08-01","325","26699","87","4007","19.3","16.1"
"Lowndes","2020-08-02","119","26818","21","4028","18.5","17.4"
"Lowndes","2020-08-03","514","27332","73","4101","17.2","17.1"
"Lowndes","2020-08-04","384","27716","56","4157","17.2","16.8"
"Lowndes","2020-08-05","316","28032","40","4197","16.3","16.7"
"Lowndes","2020-08-06","460","28492","78","4275","16.8","16.7"
"Lowndes","2020-08-07","376","28868","63","4338","17.1","17"
"Lowndes","2020-08-08","98","28966","11","4349","14.9","17.1"
"Lowndes","2020-08-09","128","29094","16","4365","14.1","16.3"
"Lowndes","2020-08-10","526","29620","84","4449","14.4","15.8"
"Lowndes","2020-08-11","443","30063","30","4479","13.3","15.3"
"Lowndes","2020-08-12","354","30417","51","4530","13.5","14.9"
"Lowndes","2020-08-13","319","30736","53","4583","13.5","15.1"
"Lowndes","2020-08-14","286","31022","38","4621","13","15"
"Lowndes","2020-08-15","97","31119","6","4627","12.2","13.6"
"Lowndes","2020-08-16","85","31204","4","4631","11.1","12.6"
"Lowndes","2020-08-17","217","31421","23","4654","10.4","12.4"
"Lowndes","2020-08-18","222","31643","14","4668","10.3","11.8"
"Lowndes","2020-08-19","234","31877","36","4704","10.4","12"
"Lowndes","2020-08-20","346","32223","19","4723","8.9","11.2"
"Lowndes","2020-08-21","309","32532","42","4765","8.9","10.9"
"Lowndes","2020-08-22","87","32619","11","4776","9.8","11"
"Lowndes","2020-08-23","84","32703","2","4778","9.5","10.3"
"Lowndes","2020-08-24","238","32941","24","4802","9.4","9.9"
"Lowndes","2020-08-25","190","33131","19","4821","9.9","10.1"
"Lowndes","2020-08-26","460","33591","15","4836","8.2","9.3"
"Lowndes","2020-08-27","295","33886","28","4864","8.8","8.8"
"Lowndes","2020-08-28","223","34109","19","4883","8.1","8.5"
"Lowndes","2020-08-29","78","34187","8","4891","7.7","8.8"
"Lowndes","2020-08-30","66","34253","5","4896","8.5","9"
"Lowndes","2020-08-31","250","34503","26","4922","8.5","9"
"Lowndes","2020-09-01","237","34740","19","4941","8.2","9.1"
"Lowndes","2020-09-02","502","35242","26","4967","8.5","8.3"
"Lowndes","2020-09-03","238","35480","21","4988","8.4","8.6"
"Lowndes","2020-09-04","284","35764","14","5002","7.9","8"
"Lowndes","2020-09-05","131","35895","9","5011","7.4","7.6"
"Lowndes","2020-09-06","43","35938","6","5017","8.3","8.4"
"Lowndes","2020-09-07","42","35980","9","5026","9.9","9.2"
"Lowndes","2020-09-08","286","36266","32","5058","10.3","9.3"
"Lowndes","2020-09-09","359","36625","34","5092","11","9.7"
"Lowndes","2020-09-10","234","36859","20","5112","10.9","9.7"
"Lowndes","2020-09-11","319","37178","24","5136","11.3","9.6"
"Lowndes","2020-09-12","66","37244","10","5146","12.5","9.9"
"Lowndes","2020-09-13","24","37268","6","5152","14","11.2"
"Lowndes","2020-09-14","276","37544","27","5179","12.4","11.1"
"Lowndes","2020-09-15","247","37791","24","5203","12.2","11.3"
"Lowndes","2020-09-16","260","38051","9","5212","11.3","11.1"
"Lowndes","2020-09-17","202","38253","13","5225","11","11"
"Lowndes","2020-09-18","257","38510","21","5246","11.1","11.2"
"Lowndes","2020-09-19","224","38734","8","5254","9.4","11"
"Lowndes","2020-09-20","84","38818","0","5254","5.9","10"
"Lowndes","2020-09-21","255","39073","24","5278","5.8","9.1"
"Lowndes","2020-09-22","297","39370","4","5282","4.6","8.4"
"Lowndes","2020-09-23","220","39590","17","5299","5.2","8.3"
"Lowndes","2020-09-24","213","39803","16","5315","5.4","8.2"
"Lowndes","2020-09-25","178","39981","17","5332","5.6","8.3"
"Lowndes","2020-09-26","70","40051","7","5339","6.5","8"
"Lowndes","2020-09-27","40","40091","0","5339","6.5","6.2"
"Lowndes","2020-09-28","221","40312","20","5359","6.5","6.1"
"Lowndes","2020-09-29","193","40505","15","5374","7.4","6"
"Lowndes","2020-09-30","209","40714","23","5397","7.8","6.5"
"Lowndes","2020-10-01","269","40983","24","5421","8","6.7"
"Lowndes","2020-10-02","409","41392","21","5442","7.4","6.5"
"Lowndes","2020-10-03","90","41482","9","5451","7.4","7"
"Lowndes","2020-10-04","42","41524","7","5458","9.8","8.1"
"Lowndes","2020-10-05","310","41834","42","5500","10.4","8.4"
"Lowndes","2020-10-06","296","42130","29","5529","10.7","9"
"Lowndes","2020-10-07","456","42586","33","5562","10.2","9"
"Lowndes","2020-10-08","396","42982","38","5600","10.3","9.2"
"Lowndes","2020-10-09","409","43391","19","5619","10.2","8.8"
"Lowndes","2020-10-10","75","43466","12","5631","11.1","9.2"
"Lowndes","2020-10-11","46","43512","9","5640","11.5","10.6"
"Lowndes","2020-10-12","228","43740","29","5669","11.4","10.9"
"Lowndes","2020-10-13","312","44052","56","5725","12.5","11.6"
"Lowndes","2020-10-14","401","44453","42","5767","13","11.6"
"Lowndes","2020-10-15","381","44834","34","5801","12.9","11.6"
"Lowndes","2020-10-16","408","45242","44","5845","13.8","12"
"Lowndes","2020-10-17","137","45379","7","5852","12.2","11.6"
"Lowndes","2020-10-18","52","45431","8","5860","11.6","11.6"
"Lowndes","2020-10-19","398","45829","57","5917","11.8","11.6"
"Lowndes","2020-10-20","273","46102","28","5945","10.8","11.6"
"Lowndes","2020-10-21","220","46322","24","5969","10.8","11.9"
"Lowndes","2020-10-22","186","46508","28","5997","11.7","12.3"
"Lowndes","2020-10-23","346","46854","42","6039","11.9","12.8"
"Lowndes","2020-10-24","81","46935","7","6046","12.4","12.3"
"Lowndes","2020-10-25","41","46976","3","6049","11.2","11.4"
"Lowndes","2020-10-26","239","47215","22","6071","10.5","11.2"
"Lowndes","2020-10-27","257","47472","27","6098","10.5","10.6"
"Lowndes","2020-10-28","222","47694","23","6121","10.5","10.6"
"Lowndes","2020-10-29","190","47884","19","6140","9.7","10.7"
"Lowndes","2020-10-30","231","48115","15","6155","8.9","10.4"
"Lowndes","2020-10-31","183","48298","8","6163","8.3","10.4"
"Lowndes","2020-11-01","87","48385","4","6167","7.9","9.6"
"Lowndes","2020-11-02","166","48551","21","6188","8.4","9.5"
"Lowndes","2020-11-03","206","48757","9","6197","7.5","9"
"Lowndes","2020-11-04","245","49002","18","6215","7.1","8.8"
"Lowndes","2020-11-05","285","49287","13","6228","6.3","8"
"Lowndes","2020-11-06","372","49659","21","6249","6.2","7.6"
"Lowndes","2020-11-07","113","49772","12","6261","7.1","7.7"
"Lowndes","2020-11-08","51","49823","3","6264","7.3","7.6"
"Lowndes","2020-11-09","170","49993","26","6290","7.7","8"
"Lowndes","2020-11-10","150","50143","16","6306","8.6","8.1"
"Lowndes","2020-11-11","257","50400","15","6321","8.4","7.7"
"Lowndes","2020-11-12","370","50770","22","6343","8.6","7.4"
"Lowndes","2020-11-13","244","51014","39","6382","10","8.1"
"Lowndes","2020-11-14","74","51088","11","6393","10.6","8.9"
"Lowndes","2020-11-15","55","51143","9","6402","12.1","9.7"
"Lowndes","2020-11-16","250","51393","34","6436","11.9","9.8"
"Lowndes","2020-11-17","291","51684","22","6458","11.5","10"
"Lowndes","2020-11-18","408","52092","27","6485","11.6","10"
"Lowndes","2020-11-19","299","52391","31","6516","12.2","10.4"
"Lowndes","2020-11-20","257","52648","33","6549","11.7","10.9"
"Lowndes","2020-11-21","64","52712","9","6558","11.6","11.1"
"Lowndes","2020-11-22","91","52803","9","6567","10.7","11.4"
"Lowndes","2020-11-23","394","53197","40","6607","10.2","11.1"
"Lowndes","2020-11-24","310","53507","23","6630","10.2","10.8"
"Lowndes","2020-11-25","395","53902","39","6669","10.7","11.1"
"Lowndes","2020-11-26","86","53988","3","6672","9.7","10.9"
"Lowndes","2020-11-27","116","54104","31","6703","11.7","11.7"
"Lowndes","2020-11-28","57","54161","10","6713","12.2","11.9"
"Lowndes","2020-11-29","45","54206","8","6721","13.3","12"
"Lowndes","2020-11-30","278","54484","57","6778","14.8","12.5"
"Lowndes","2020-12-01","257","54741","46","6824","16.3","13.2"
"Lowndes","2020-12-02","294","55035","35","6859","16.5","13.6"
"Lowndes","2020-12-03","278","55313","27","6886","17.4","13.6"
"Lowndes","2020-12-04","392","55705","48","6934","15.4","13.5"
"Lowndes","2020-12-05","193","55898","5","6939","13.2","12.7"
"Lowndes","2020-12-06","59","55957","11","6950","13.4","13.3"
"Lowndes","2020-12-07","202","56159","21","6971","11.9","13.3"
"Lowndes","2020-12-08","338","56497","30","7001","10.6","13.4"
"Lowndes","2020-12-09","291","56788","20","7021","9.9","13.2"
"Lowndes","2020-12-10","244","57032","27","7048","10.1","13.8"
"Lowndes","2020-12-11","509","57541","31","7079","9.2","12.3"
"Lowndes","2020-12-12","73","57614","17","7096","12.2","12.7"
"Lowndes","2020-12-13","59","57673","14","7110","12.9","13.1"
"Lowndes","2020-12-14","238","57911","41","7151","13.9","12.9"
"Lowndes","2020-12-15","230","58141","35","7186","14.8","12.7"
"Lowndes","2020-12-16","297","58438","37","7223","15.6","12.7"
"Lowndes","2020-12-17","309","58747","26","7249","15.2","12.7"
"Lowndes","2020-12-18","282","59029","46","7295","16.7","12.9"
"Lowndes","2020-12-19","103","59132","12","7307","15","13.6"
"Lowndes","2020-12-20","67","59199","14","7321","14.6","13.7"
"Lowndes","2020-12-21","223","59422","33","7354","14.2","14.1"
"Lowndes","2020-12-22","284","59706","41","7395","14.1","14.5"
"Lowndes","2020-12-23","370","60076","39","7434","13.9","14.7"
"Lowndes","2020-12-24","92","60168","26","7460","16.7","16"
"Lowndes","2020-12-25","30","60198","6","7466","17.2","16.9"
"Lowndes","2020-12-26","117","60315","28","7494","19","17"
"Lowndes","2020-12-27","90","60405","32","7526","21.1","17.8"
"Lowndes","2020-12-28","132","60537","28","7554","22","18.1"
"Lowndes","2020-12-29","209","60746","40","7594","22.7","18.4"
"Lowndes","2020-12-30","564","61310","54","7648","22.5","18.2"
"Lowndes","2020-12-31","224","61534","12","7660","19.3","18"
"Lowndes","2021-01-01","30","61564","5","7665","18.8","18"
"Lowndes","2021-01-02","52","61616","14","7679","19.2","19.1"
"Lowndes","2021-01-03","71","61687","13","7692","16.7","18.9"
"Lowndes","2021-01-04","119","61806","30","7722","17.3","19.7"
"Lowndes","2021-01-05","285","62091","47","7769","16.9","19.8"
"Lowndes","2021-01-06","330","62421","40","7809","17.3","19.9"
"Lowndes","2021-01-07","436","62857","50","7859","18.2","18.7"
"Lowndes","2021-01-08","148","63005","33","7892","19","18.9"
"Lowndes","2021-01-09","84","63089","21","7913","18.7","19"
"Lowndes","2021-01-10","73","63162","18","7931","19.6","18.2"
"Lowndes","2021-01-11","189","63351","22","7953","17.7","17.5"
"Lowndes","2021-01-12","384","63735","41","7994","16.8","16.9"
"Lowndes","2021-01-13","230","63965","27","8021","16.8","17"
"Lowndes","2021-01-14","409","64374","18","8039","15.8","17"
"Lowndes","2021-01-15","168","64542","23","8062","14.5","16.8"
"Lowndes","2021-01-16","85","64627","18","8080","14","16.3"
"Lowndes","2021-01-17","76","64703","19","8099","14","16.8"
"Lowndes","2021-01-18","131","64834","23","8122","14.9","16.3"
"Lowndes","2021-01-19","259","65093","31","8153","15.1","16"
"Lowndes","2021-01-20","187","65280","23","8176","15.2","16"
"Lowndes","2021-01-21","419","65699","19","8195","15.2","15.5"
"Lowndes","2021-01-22","186","65885","10","8205","14","14.3"
"Lowndes","2021-01-23","168","66053","5","8210","11.4","12.7"
"Lowndes","2021-01-24","71","66124","12","8222","10.2","12.1"
"Lowndes","2021-01-25","61","66185","14","8236","11","12.9"
"Lowndes","2021-01-26","42","66227","6","8242","11.3","13.2"
"Lowndes","2021-01-27","0","66227","0","8242","9.6","12.4"
"Lumpkin","2020-02-01","0","0","0","0",".","."
"Lumpkin","2020-02-02","0","0","0","0",".","."
"Lumpkin","2020-02-03","0","0","0","0",".","."
"Lumpkin","2020-02-04","0","0","0","0",".","."
"Lumpkin","2020-02-05","0","0","0","0",".","."
"Lumpkin","2020-02-06","0","0","0","0",".","."
"Lumpkin","2020-02-07","0","0","0","0","0","."
"Lumpkin","2020-02-08","0","0","0","0","0","."
"Lumpkin","2020-02-09","0","0","0","0","0","."
"Lumpkin","2020-02-10","0","0","0","0","0","."
"Lumpkin","2020-02-11","0","0","0","0","0","."
"Lumpkin","2020-02-12","0","0","0","0","0","."
"Lumpkin","2020-02-13","0","0","0","0","0","."
"Lumpkin","2020-02-14","0","0","0","0","0","0"
"Lumpkin","2020-02-15","0","0","0","0","0","0"
"Lumpkin","2020-02-16","0","0","0","0","0","0"
"Lumpkin","2020-02-17","0","0","0","0","0","0"
"Lumpkin","2020-02-18","0","0","0","0","0","0"
"Lumpkin","2020-02-19","0","0","0","0","0","0"
"Lumpkin","2020-02-20","0","0","0","0","0","0"
"Lumpkin","2020-02-21","0","0","0","0","0","0"
"Lumpkin","2020-02-22","0","0","0","0","0","0"
"Lumpkin","2020-02-23","0","0","0","0","0","0"
"Lumpkin","2020-02-24","0","0","0","0","0","0"
"Lumpkin","2020-02-25","0","0","0","0","0","0"
"Lumpkin","2020-02-26","0","0","0","0","0","0"
"Lumpkin","2020-02-27","0","0","0","0","0","0"
"Lumpkin","2020-02-28","0","0","0","0","0","0"
"Lumpkin","2020-02-29","0","0","0","0","0","0"
"Lumpkin","2020-03-01","0","0","0","0","0","0"
"Lumpkin","2020-03-02","0","0","0","0","0","0"
"Lumpkin","2020-03-03","0","0","0","0","0","0"
"Lumpkin","2020-03-04","0","0","0","0","0","0"
"Lumpkin","2020-03-05","0","0","0","0","0","0"
"Lumpkin","2020-03-06","0","0","0","0","0","0"
"Lumpkin","2020-03-07","0","0","0","0","0","0"
"Lumpkin","2020-03-08","0","0","0","0","0","0"
"Lumpkin","2020-03-09","0","0","0","0","0","0"
"Lumpkin","2020-03-10","0","0","0","0","0","0"
"Lumpkin","2020-03-11","0","0","0","0","0","0"
"Lumpkin","2020-03-12","2","2","0","0","0","0"
"Lumpkin","2020-03-13","1","3","0","0","0","0"
"Lumpkin","2020-03-14","2","5","0","0","0","0"
"Lumpkin","2020-03-15","0","5","0","0","0","0"
"Lumpkin","2020-03-16","2","7","0","0","0","0"
"Lumpkin","2020-03-17","5","12","0","0","0","0"
"Lumpkin","2020-03-18","10","22","1","1","1.4","0.7"
"Lumpkin","2020-03-19","8","30","1","2","3.2","1.6"
"Lumpkin","2020-03-20","15","45","0","2","3.2","1.6"
"Lumpkin","2020-03-21","5","50","0","2","3.2","1.6"
"Lumpkin","2020-03-22","8","58","0","2","3.2","1.6"
"Lumpkin","2020-03-23","15","73","0","2","3.2","1.6"
"Lumpkin","2020-03-24","5","78","0","2","3.2","1.6"
"Lumpkin","2020-03-25","8","86","0","2","1.8","1.6"
"Lumpkin","2020-03-26","2","88","0","2","0","1.6"
"Lumpkin","2020-03-27","2","90","0","2","0","1.6"
"Lumpkin","2020-03-28","0","90","0","2","0","1.6"
"Lumpkin","2020-03-29","1","91","0","2","0","1.6"
"Lumpkin","2020-03-30","2","93","0","2","0","1.6"
"Lumpkin","2020-03-31","3","96","0","2","0","1.6"
"Lumpkin","2020-04-01","4","100","0","2","0","0.9"
"Lumpkin","2020-04-02","4","104","0","2","0","0"
"Lumpkin","2020-04-03","2","106","0","2","0","0"
"Lumpkin","2020-04-04","0","106","0","2","0","0"
"Lumpkin","2020-04-05","0","106","0","2","0","0"
"Lumpkin","2020-04-06","5","111","0","2","0","0"
"Lumpkin","2020-04-07","2","113","0","2","0","0"
"Lumpkin","2020-04-08","2","115","0","2","0","0"
"Lumpkin","2020-04-09","0","115","0","2","0","0"
"Lumpkin","2020-04-10","3","118","0","2","0","0"
"Lumpkin","2020-04-11","5","123","0","2","0","0"
"Lumpkin","2020-04-12","0","123","0","2","0","0"
"Lumpkin","2020-04-13","3","126","0","2","0","0"
"Lumpkin","2020-04-14","6","132","0","2","0","0"
"Lumpkin","2020-04-15","3","135","0","2","0","0"
"Lumpkin","2020-04-16","4","139","0","2","0","0"
"Lumpkin","2020-04-17","4","143","1","3","3.6","1.8"
"Lumpkin","2020-04-18","2","145","0","3","3.6","1.8"
"Lumpkin","2020-04-19","1","146","0","3","3.6","1.8"
"Lumpkin","2020-04-20","8","154","0","3","3.6","1.8"
"Lumpkin","2020-04-21","4","158","1","4","7.1","3.6"
"Lumpkin","2020-04-22","8","166","0","4","7.1","3.6"
"Lumpkin","2020-04-23","7","173","0","4","7.1","3.6"
"Lumpkin","2020-04-24","10","183","0","4","3.6","3.6"
"Lumpkin","2020-04-25","12","195","2","6","6","4.8"
"Lumpkin","2020-04-26","4","199","0","6","6","4.8"
"Lumpkin","2020-04-27","4","203","0","6","6","4.8"
"Lumpkin","2020-04-28","12","215","0","6","2.4","4.8"
"Lumpkin","2020-04-29","16","231","0","6","2.4","4.8"
"Lumpkin","2020-04-30","9","240","1","7","4","5.6"
"Lumpkin","2020-05-01","14","254","1","8","5","4.3"
"Lumpkin","2020-05-02","9","263","1","9","4.2","5.1"
"Lumpkin","2020-05-03","6","269","0","9","4.2","5.1"
"Lumpkin","2020-05-04","23","292","1","10","4.8","5.4"
"Lumpkin","2020-05-05","21","313","0","10","4.8","3.6"
"Lumpkin","2020-05-06","16","329","0","10","4.8","3.6"
"Lumpkin","2020-05-07","12","341","0","10","3.2","3.6"
"Lumpkin","2020-05-08","53","394","2","12","2.7","3.9"
"Lumpkin","2020-05-09","11","405","1","13","2.5","3.3"
"Lumpkin","2020-05-10","0","405","0","13","2.5","3.3"
"Lumpkin","2020-05-11","19","424","2","15","3.3","4.1"
"Lumpkin","2020-05-12","20","444","0","15","3.3","4.1"
"Lumpkin","2020-05-13","16","460","0","15","3.3","4.1"
"Lumpkin","2020-05-14","14","474","0","15","3.3","3.3"
"Lumpkin","2020-05-15","46","520","0","15","2.8","2.8"
"Lumpkin","2020-05-16","3","523","0","15","1.5","2"
"Lumpkin","2020-05-17","6","529","1","16","3.9","3.2"
"Lumpkin","2020-05-18","19","548","2","18","3.9","3.6"
"Lumpkin","2020-05-19","18","566","1","19","4.7","4"
"Lumpkin","2020-05-20","18","584","0","19","4.7","4"
"Lumpkin","2020-05-21","40","624","1","20","5","4.2"
"Lumpkin","2020-05-22","14","638","0","20","5","3.9"
"Lumpkin","2020-05-23","4","642","0","20","5","3.3"
"Lumpkin","2020-05-24","1","643","0","20","2.7","3.3"
"Lumpkin","2020-05-25","1","644","0","20","1.2","2.5"
"Lumpkin","2020-05-26","17","661","1","21","1.2","2.9"
"Lumpkin","2020-05-27","27","688","0","21","1.2","2.9"
"Lumpkin","2020-05-28","27","715","0","21","0.8","2.9"
"Lumpkin","2020-05-29","17","732","0","21","0.8","2.9"
"Lumpkin","2020-05-30","9","741","0","21","0.8","2.9"
"Lumpkin","2020-05-31","9","750","0","21","0.8","1.7"
"Lumpkin","2020-06-01","22","772","0","21","0.8","1"
"Lumpkin","2020-06-02","11","783","0","21","0","0.6"
"Lumpkin","2020-06-03","23","806","0","21","0","0.6"
"Lumpkin","2020-06-04","15","821","0","21","0","0.4"
"Lumpkin","2020-06-05","10","831","0","21","0","0.4"
"Lumpkin","2020-06-06","11","842","0","21","0","0.4"
"Lumpkin","2020-06-07","2","844","0","21","0","0.4"
"Lumpkin","2020-06-08","9","853","0","21","0","0.4"
"Lumpkin","2020-06-09","15","868","1","22","1","0.5"
"Lumpkin","2020-06-10","14","882","0","22","1","0.5"
"Lumpkin","2020-06-11","17","899","0","22","1","0.5"
"Lumpkin","2020-06-12","19","918","0","22","1","0.5"
"Lumpkin","2020-06-13","7","925","0","22","1","0.5"
"Lumpkin","2020-06-14","4","929","0","22","1","0.5"
"Lumpkin","2020-06-15","11","940","0","22","1","0.5"
"Lumpkin","2020-06-16","19","959","0","22","0","0.5"
"Lumpkin","2020-06-17","19","978","0","22","0","0.5"
"Lumpkin","2020-06-18","18","996","0","22","0","0.5"
"Lumpkin","2020-06-19","12","1008","1","23","1.2","1.1"
"Lumpkin","2020-06-20","10","1018","0","23","1.2","1.1"
"Lumpkin","2020-06-21","4","1022","0","23","1.2","1.1"
"Lumpkin","2020-06-22","11","1033","0","23","1.2","1.1"
"Lumpkin","2020-06-23","14","1047","0","23","1.2","0.6"
"Lumpkin","2020-06-24","31","1078","1","24","1.7","0.8"
"Lumpkin","2020-06-25","54","1132","2","26","2.2","1.1"
"Lumpkin","2020-06-26","38","1170","1","27","1.4","1.3"
"Lumpkin","2020-06-27","38","1208","1","28","1.7","1.5"
"Lumpkin","2020-06-28","2","1210","0","28","1.7","1.5"
"Lumpkin","2020-06-29","38","1248","2","30","2.5","1.8"
"Lumpkin","2020-06-30","55","1303","4","34","3.5","2.4"
"Lumpkin","2020-07-01","42","1345","5","39","4.8","3.2"
"Lumpkin","2020-07-02","51","1396","1","40","4.5","3.4"
"Lumpkin","2020-07-03","13","1409","1","41","5.2","3.3"
"Lumpkin","2020-07-04","56","1465","1","42","5.1","3.4"
"Lumpkin","2020-07-05","29","1494","1","43","5.6","3.7"
"Lumpkin","2020-07-06","45","1539","7","50","7.1","4.8"
"Lumpkin","2020-07-07","58","1597","10","60","8.5","6"
"Lumpkin","2020-07-08","44","1641","2","62","7.5","6.1"
"Lumpkin","2020-07-09","56","1697","4","66","8.2","6.4"
"Lumpkin","2020-07-10","47","1744","8","74","9.5","7.4"
"Lumpkin","2020-07-11","5","1749","0","74","9.3","7.2"
"Lumpkin","2020-07-12","11","1760","0","74","8.8","7.2"
"Lumpkin","2020-07-13","31","1791","6","80","9.3","8.2"
"Lumpkin","2020-07-14","32","1823","2","82","7.8","8.1"
"Lumpkin","2020-07-15","34","1857","1","83","7.5","7.5"
"Lumpkin","2020-07-16","24","1881","0","83","6.5","7.4"
"Lumpkin","2020-07-17","28","1909","1","84","4.6","7.1"
"Lumpkin","2020-07-18","10","1919","1","85","6","7.6"
"Lumpkin","2020-07-19","13","1932","1","86","7.1","8"
"Lumpkin","2020-07-20","45","1977","5","91","5.9","7.6"
"Lumpkin","2020-07-21","30","2007","0","91","5","6.4"
"Lumpkin","2020-07-22","24","2031","4","95","7","7.3"
"Lumpkin","2020-07-23","33","2064","0","95","7","6.8"
"Lumpkin","2020-07-24","25","2089","0","95","6.5","5.5"
"Lumpkin","2020-07-25","13","2102","5","100","10.6","8.3"
"Lumpkin","2020-07-26","8","2110","0","100","9.5","8.3"
"Lumpkin","2020-07-27","23","2133","2","102","9.1","7.5"
"Lumpkin","2020-07-28","14","2147","1","103","10.1","7.6"
"Lumpkin","2020-07-29","33","2180","1","104","8.2","7.6"
"Lumpkin","2020-07-30","20","2200","2","106","9.6","8.3"
"Lumpkin","2020-07-31","29","2229","0","106","9.6","8.1"
"Lumpkin","2020-08-01","8","2237","0","106","4.1","7.3"
"Lumpkin","2020-08-02","6","2243","0","106","4.1","6.8"
"Lumpkin","2020-08-03","25","2268","1","107","3.5","6.3"
"Lumpkin","2020-08-04","23","2291","2","109","3.7","6.9"
"Lumpkin","2020-08-05","31","2322","7","116","6.5","7.3"
"Lumpkin","2020-08-06","31","2353","1","117","5.5","7.6"
"Lumpkin","2020-08-07","21","2374","3","120","7.5","8.6"
"Lumpkin","2020-08-08","10","2384","5","125","14.7","9.4"
"Lumpkin","2020-08-09","12","2396","0","125","14.7","9.4"
"Lumpkin","2020-08-10","22","2418","1","126","14.8","9.1"
"Lumpkin","2020-08-11","17","2435","2","128","15.2","9.4"
"Lumpkin","2020-08-12","28","2463","2","130","13","9.7"
"Lumpkin","2020-08-13","19","2482","3","133","14.8","10.1"
"Lumpkin","2020-08-14","27","2509","3","136","14.3","10.9"
"Lumpkin","2020-08-15","14","2523","2","138","9.2","12"
"Lumpkin","2020-08-16","10","2533","1","139","10.7","12.7"
"Lumpkin","2020-08-17","20","2553","1","140","10.7","12.7"
"Lumpkin","2020-08-18","20","2573","2","142","10.5","12.8"
"Lumpkin","2020-08-19","24","2597","1","143","10.1","11.5"
"Lumpkin","2020-08-20","18","2615","0","143","7.8","11.3"
"Lumpkin","2020-08-21","26","2641","2","145","7.3","10.8"
"Lumpkin","2020-08-22","11","2652","1","146","6.6","7.9"
"Lumpkin","2020-08-23","5","2657","0","146","5.1","7.9"
"Lumpkin","2020-08-24","23","2680","3","149","6.3","8.5"
"Lumpkin","2020-08-25","22","2702","1","150","5.5","8"
"Lumpkin","2020-08-26","20","2722","2","152","6.3","8.2"
"Lumpkin","2020-08-27","22","2744","3","155","8.3","8"
"Lumpkin","2020-08-28","30","2774","3","158","8.6","8"
"Lumpkin","2020-08-29","12","2786","1","159","8.5","7.5"
"Lumpkin","2020-08-30","5","2791","0","159","8.5","6.8"
"Lumpkin","2020-08-31","28","2819","1","160","7.2","6.7"
"Lumpkin","2020-09-01","33","2852","1","161","6.9","6.2"
"Lumpkin","2020-09-02","25","2877","1","162","6.1","6.2"
"Lumpkin","2020-09-03","23","2900","2","164","5.4","6.8"
"Lumpkin","2020-09-04","25","2925","2","166","5.1","6.9"
"Lumpkin","2020-09-05","8","2933","1","167","5.7","7.1"
"Lumpkin","2020-09-06","3","2936","0","167","5.7","7.1"
"Lumpkin","2020-09-07","5","2941","0","167","5.2","6.2"
"Lumpkin","2020-09-08","31","2972","3","170","6.1","6.5"
"Lumpkin","2020-09-09","32","3004","2","172","6.4","6.3"
"Lumpkin","2020-09-10","25","3029","0","172","5.2","5.3"
"Lumpkin","2020-09-11","39","3068","1","173","4.4","4.8"
"Lumpkin","2020-09-12","8","3076","3","176","8","6.8"
"Lumpkin","2020-09-13","3","3079","0","176","8","6.8"
"Lumpkin","2020-09-14","30","3109","5","181","10.4","7.8"
"Lumpkin","2020-09-15","33","3142","2","183","9.9","8"
"Lumpkin","2020-09-16","41","3183","3","186","10","8.2"
"Lumpkin","2020-09-17","23","3206","1","187","10.6","7.9"
"Lumpkin","2020-09-18","26","3232","2","189","11.4","7.9"
"Lumpkin","2020-09-19","8","3240","2","191","9.6","8.8"
"Lumpkin","2020-09-20","4","3244","0","191","9.6","8.8"
"Lumpkin","2020-09-21","26","3270","1","192","7.8","9.1"
"Lumpkin","2020-09-22","18","3288","1","193","7.7","8.8"
"Lumpkin","2020-09-23","20","3308","0","193","6.6","8.3"
"Lumpkin","2020-09-24","21","3329","0","193","6","8.3"
"Lumpkin","2020-09-25","23","3352","1","194","5.5","8.5"
"Lumpkin","2020-09-26","4","3356","0","194","2","5.8"
"Lumpkin","2020-09-27","2","3358","0","194","2","5.8"
"Lumpkin","2020-09-28","31","3389","0","194","1.4","4.6"
"Lumpkin","2020-09-29","36","3425","0","194","0.6","4.2"
"Lumpkin","2020-09-30","24","3449","2","196","1.8","4.2"
"Lumpkin","2020-10-01","34","3483","3","199","3.1","4.5"
"Lumpkin","2020-10-02","23","3506","1","200","3.1","4.3"
"Lumpkin","2020-10-03","6","3512","0","200","3.1","2.5"
"Lumpkin","2020-10-04","7","3519","0","200","3.1","2.5"
"Lumpkin","2020-10-05","35","3554","1","201","3.5","2.4"
"Lumpkin","2020-10-06","36","3590","1","202","3.9","2.2"
"Lumpkin","2020-10-07","36","3626","2","204","3.5","2.6"
"Lumpkin","2020-10-08","27","3653","3","207","3.8","3.4"
"Lumpkin","2020-10-09","72","3725","1","208","3.4","3.2"
"Lumpkin","2020-10-10","9","3734","0","208","3.4","3.2"
"Lumpkin","2020-10-11","8","3742","0","208","3.4","3.2"
"Lumpkin","2020-10-12","38","3780","5","213","4.9","4.2"
"Lumpkin","2020-10-13","34","3814","1","214","4.9","4.4"
"Lumpkin","2020-10-14","45","3859","3","217","5","4.3"
"Lumpkin","2020-10-15","38","3897","5","222","5.3","4.6"
"Lumpkin","2020-10-16","35","3932","2","224","5.9","4.7"
"Lumpkin","2020-10-17","5","3937","0","224","5.9","4.7"
"Lumpkin","2020-10-18","1","3938","0","224","5.9","4.7"
"Lumpkin","2020-10-19","37","3975","3","227","5.2","5"
"Lumpkin","2020-10-20","37","4012","1","228","5.2","5"
"Lumpkin","2020-10-21","45","4057","1","229","4.6","4.8"
"Lumpkin","2020-10-22","28","4085","4","233","4.7","5"
"Lumpkin","2020-10-23","36","4121","1","234","4.3","5.1"
"Lumpkin","2020-10-24","5","4126","0","234","4.3","5.1"
"Lumpkin","2020-10-25","8","4134","2","236","7.9","6.9"
"Lumpkin","2020-10-26","22","4156","0","236","6.7","6"
"Lumpkin","2020-10-27","28","4184","1","237","6.8","6"
"Lumpkin","2020-10-28","41","4225","1","238","6.9","5.7"
"Lumpkin","2020-10-29","26","4251","1","239","5.4","5"
"Lumpkin","2020-10-30","32","4283","3","242","6.3","5.3"
"Lumpkin","2020-10-31","9","4292","3","245","11.1","7.7"
"Lumpkin","2020-11-01","8","4300","2","247","11.1","9.5"
"Lumpkin","2020-11-02","31","4331","3","250","12.5","9.6"
"Lumpkin","2020-11-03","25","4356","0","250","12","9.4"
"Lumpkin","2020-11-04","43","4399","2","252","12.3","9.6"
"Lumpkin","2020-11-05","32","4431","5","257","14","9.7"
"Lumpkin","2020-11-06","39","4470","3","260","13.7","10"
"Lumpkin","2020-11-07","15","4485","1","261","9.9","10.5"
"Lumpkin","2020-11-08","6","4491","1","262","8.7","9.9"
"Lumpkin","2020-11-09","29","4520","6","268","10.3","11.4"
"Lumpkin","2020-11-10","49","4569","3","271","11.2","11.6"
"Lumpkin","2020-11-11","45","4614","5","276","12.1","12.2"
"Lumpkin","2020-11-12","30","4644","1","277","10.3","12.1"
"Lumpkin","2020-11-13","35","4679","2","279","10","11.9"
"Lumpkin","2020-11-14","13","4692","2","281","11.3","10.6"
"Lumpkin","2020-11-15","11","4703","1","282","10.2","9.5"
"Lumpkin","2020-11-16","34","4737","5","287","9.4","9.8"
"Lumpkin","2020-11-17","48","4785","2","289","9.1","10.1"
"Lumpkin","2020-11-18","51","4836","6","295","9.2","10.6"
"Lumpkin","2020-11-19","56","4892","7","302","10.5","10.4"
"Lumpkin","2020-11-20","51","4943","5","307","11.1","10.6"
"Lumpkin","2020-11-21","11","4954","2","309","11.5","11.4"
"Lumpkin","2020-11-22","5","4959","0","309","10.2","10.2"
"Lumpkin","2020-11-23","36","4995","11","320","12.4","10.9"
"Lumpkin","2020-11-24","27","5022","6","326","15","12"
"Lumpkin","2020-11-25","49","5071","5","331","14.8","12"
"Lumpkin","2020-11-26","3","5074","0","331","13","11.7"
"Lumpkin","2020-11-27","34","5108","2","333","12.4","11.7"
"Lumpkin","2020-11-28","8","5116","2","335","13.4","12.4"
"Lumpkin","2020-11-29","14","5130","2","337","15.4","12.8"
"Lumpkin","2020-11-30","52","5182","14","351","14.9","13.7"
"Lumpkin","2020-12-01","47","5229","4","355","13","14"
"Lumpkin","2020-12-02","34","5263","12","367","16.6","15.7"
"Lumpkin","2020-12-03","54","5317","8","375","18.7","15.8"
"Lumpkin","2020-12-04","42","5359","8","383","20.6","16.5"
"Lumpkin","2020-12-05","11","5370","2","385","19.6","16.5"
"Lumpkin","2020-12-06","12","5382","3","388","21.1","18.3"
"Lumpkin","2020-12-07","38","5420","8","396","20.3","17.6"
"Lumpkin","2020-12-08","62","5482","10","406","21.4","17.2"
"Lumpkin","2020-12-09","46","5528","10","416","19.4","18"
"Lumpkin","2020-12-10","43","5571","4","420","18.6","18.7"
"Lumpkin","2020-12-11","59","5630","8","428","17.9","19.2"
"Lumpkin","2020-12-12","22","5652","4","432","17.9","18.7"
"Lumpkin","2020-12-13","9","5661","0","432","14.3","17.7"
"Lumpkin","2020-12-14","68","5729","16","448","14.6","17.5"
"Lumpkin","2020-12-15","101","5830","6","454","13.2","17.3"
"Lumpkin","2020-12-16","60","5890","6","460","11.5","15.5"
"Lumpkin","2020-12-17","50","5940","10","470","13","15.8"
"Lumpkin","2020-12-18","44","5984","8","478","13.7","15.8"
"Lumpkin","2020-12-19","18","6002","3","481","13.5","15.7"
"Lumpkin","2020-12-20","18","6020","8","489","19.8","17.1"
"Lumpkin","2020-12-21","41","6061","12","501","20.6","17.6"
"Lumpkin","2020-12-22","44","6105","9","510","22.7","17.9"
"Lumpkin","2020-12-23","65","6170","12","522","23.9","17.7"
"Lumpkin","2020-12-24","33","6203","9","531","25","19"
"Lumpkin","2020-12-25","8","6211","3","534","27.7","20.7"
"Lumpkin","2020-12-26","19","6230","5","539","29.1","21.3"
"Lumpkin","2020-12-27","16","6246","2","541","24.5","22.2"
"Lumpkin","2020-12-28","70","6316","19","560","24.2","22.4"
"Lumpkin","2020-12-29","62","6378","20","580","25.9","24.3"
"Lumpkin","2020-12-30","46","6424","13","593","27.3","25.6"
"Lumpkin","2020-12-31","35","6459","5","598","25.5","25.2"
"Lumpkin","2021-01-01","10","6469","5","603","27.3","27.5"
"Lumpkin","2021-01-02","14","6483","6","609","29.6","29.4"
"Lumpkin","2021-01-03","18","6501","4","613","31","27.8"
"Lumpkin","2021-01-04","74","6575","15","628","30","27.1"
"Lumpkin","2021-01-05","59","6634","13","641","28.6","27.2"
"Lumpkin","2021-01-06","64","6698","17","658","28.3","27.8"
"Lumpkin","2021-01-07","79","6777","18","676","29.5","27.5"
"Lumpkin","2021-01-08","46","6823","5","681","23.9","25.6"
"Lumpkin","2021-01-09","24","6847","6","687","21.4","25.5"
"Lumpkin","2021-01-10","17","6864","4","691","21.6","26.3"
"Lumpkin","2021-01-11","48","6912","4","695","19.9","24.9"
"Lumpkin","2021-01-12","66","6978","9","704","18.7","23.6"
"Lumpkin","2021-01-13","63","7041","8","712","16.7","22.5"
"Lumpkin","2021-01-14","90","7131","8","720","14.7","22.1"
"Lumpkin","2021-01-15","51","7182","7","727","15.1","19.5"
"Lumpkin","2021-01-16","23","7205","2","729","12.8","17.1"
"Lumpkin","2021-01-17","12","7217","1","730","10.6","16.1"
"Lumpkin","2021-01-18","43","7260","6","736","11.4","15.6"
"Lumpkin","2021-01-19","76","7336","16","752","12.5","15.6"
"Lumpkin","2021-01-20","60","7396","13","765","13.8","15.2"
"Lumpkin","2021-01-21","67","7463","7","772","14","14.3"
"Lumpkin","2021-01-22","67","7530","10","782","14.2","14.6"
"Lumpkin","2021-01-23","15","7545","2","784","14.8","13.8"
"Lumpkin","2021-01-24","4","7549","1","785","17.2","13.9"
"Lumpkin","2021-01-25","15","7564","3","788","18.1","14.7"
"Lumpkin","2021-01-26","6","7570","2","790","19.8","16.1"
"Lumpkin","2021-01-27","0","7570","0","790","16.7","15.2"
"Macon","2020-02-01","0","0","0","0",".","."
"Macon","2020-02-02","0","0","0","0",".","."
"Macon","2020-02-03","0","0","0","0",".","."
"Macon","2020-02-04","0","0","0","0",".","."
"Macon","2020-02-05","0","0","0","0",".","."
"Macon","2020-02-06","0","0","0","0",".","."
"Macon","2020-02-07","0","0","0","0","0","."
"Macon","2020-02-08","0","0","0","0","0","."
"Macon","2020-02-09","0","0","0","0","0","."
"Macon","2020-02-10","0","0","0","0","0","."
"Macon","2020-02-11","0","0","0","0","0","."
"Macon","2020-02-12","0","0","0","0","0","."
"Macon","2020-02-13","0","0","0","0","0","."
"Macon","2020-02-14","0","0","0","0","0","0"
"Macon","2020-02-15","0","0","0","0","0","0"
"Macon","2020-02-16","0","0","0","0","0","0"
"Macon","2020-02-17","0","0","0","0","0","0"
"Macon","2020-02-18","0","0","0","0","0","0"
"Macon","2020-02-19","0","0","0","0","0","0"
"Macon","2020-02-20","0","0","0","0","0","0"
"Macon","2020-02-21","0","0","0","0","0","0"
"Macon","2020-02-22","0","0","0","0","0","0"
"Macon","2020-02-23","0","0","0","0","0","0"
"Macon","2020-02-24","0","0","0","0","0","0"
"Macon","2020-02-25","0","0","0","0","0","0"
"Macon","2020-02-26","0","0","0","0","0","0"
"Macon","2020-02-27","0","0","0","0","0","0"
"Macon","2020-02-28","0","0","0","0","0","0"
"Macon","2020-02-29","0","0","0","0","0","0"
"Macon","2020-03-01","0","0","0","0","0","0"
"Macon","2020-03-02","0","0","0","0","0","0"
"Macon","2020-03-03","0","0","0","0","0","0"
"Macon","2020-03-04","0","0","0","0","0","0"
"Macon","2020-03-05","0","0","0","0","0","0"
"Macon","2020-03-06","0","0","0","0","0","0"
"Macon","2020-03-07","0","0","0","0","0","0"
"Macon","2020-03-08","0","0","0","0","0","0"
"Macon","2020-03-09","0","0","0","0","0","0"
"Macon","2020-03-10","0","0","0","0","0","0"
"Macon","2020-03-11","0","0","0","0","0","0"
"Macon","2020-03-12","0","0","0","0","0","0"
"Macon","2020-03-13","0","0","0","0","0","0"
"Macon","2020-03-14","0","0","0","0","0","0"
"Macon","2020-03-15","1","1","0","0","0","0"
"Macon","2020-03-16","1","2","0","0","0","0"
"Macon","2020-03-17","0","2","0","0","0","0"
"Macon","2020-03-18","0","2","0","0","0","0"
"Macon","2020-03-19","5","7","0","0","0","0"
"Macon","2020-03-20","1","8","1","1","14.3","7.1"
"Macon","2020-03-21","0","8","0","1","14.3","7.1"
"Macon","2020-03-22","0","8","0","1","14.3","7.1"
"Macon","2020-03-23","3","11","0","1","14.3","7.1"
"Macon","2020-03-24","5","16","0","1","14.3","7.1"
"Macon","2020-03-25","3","19","1","2","19","9.5"
"Macon","2020-03-26","1","20","1","3","33.3","16.7"
"Macon","2020-03-27","5","25","0","3","19","16.7"
"Macon","2020-03-28","1","26","0","3","19","16.7"
"Macon","2020-03-29","0","26","0","3","19","16.7"
"Macon","2020-03-30","0","26","0","3","19","16.7"
"Macon","2020-03-31","5","31","4","7","30.5","22.4"
"Macon","2020-04-01","1","32","0","7","25.7","22.4"
"Macon","2020-04-02","4","36","1","8","15","24.2"
"Macon","2020-04-03","9","45","4","12","21.3","20.2"
"Macon","2020-04-04","0","45","0","12","21.3","20.2"
"Macon","2020-04-05","0","45","0","12","21.3","20.2"
"Macon","2020-04-06","9","54","6","18","30.9","25"
"Macon","2020-04-07","5","59","3","21","28","29.2"
"Macon","2020-04-08","7","66","3","24","34.1","29.9"
"Macon","2020-04-09","6","72","3","27","37.7","26.4"
"Macon","2020-04-10","8","80","2","29","34.9","28.1"
"Macon","2020-04-11","1","81","1","30","49.2","35.3"
"Macon","2020-04-12","0","81","0","30","49.2","35.3"
"Macon","2020-04-13","10","91","3","33","44","37.4"
"Macon","2020-04-14","20","111","7","40","40.4","34.2"
"Macon","2020-04-15","14","125","3","43","37.3","35.7"
"Macon","2020-04-16","12","137","2","45","32.6","35.1"
"Macon","2020-04-17","9","146","4","49","35.4","35.1"
"Macon","2020-04-18","3","149","1","50","25.8","37.5"
"Macon","2020-04-19","2","151","1","51","33","41.1"
"Macon","2020-04-20","29","180","5","56","31.2","37.6"
"Macon","2020-04-21","13","193","2","58","28.4","34.4"
"Macon","2020-04-22","25","218","2","60","26.4","31.9"
"Macon","2020-04-23","12","230","3","63","27.6","30.1"
"Macon","2020-04-24","12","242","0","63","21.3","28.3"
"Macon","2020-04-25","1","243","0","63","16.5","21.2"
"Macon","2020-04-26","2","245","0","63","9.4","21.2"
"Macon","2020-04-27","25","270","6","69","10.3","20.7"
"Macon","2020-04-28","16","286","0","69","8.1","18.2"
"Macon","2020-04-29","15","301","3","72","9.9","18.1"
"Macon","2020-04-30","2","303","0","72","6.3","17"
"Macon","2020-05-01","6","309","1","73","8.7","15"
"Macon","2020-05-02","0","309","0","73","8.7","12.6"
"Macon","2020-05-03","7","316","1","74","10.7","10"
"Macon","2020-05-04","16","332","2","76","9.1","9.7"
"Macon","2020-05-05","18","350","3","79","11.4","9.8"
"Macon","2020-05-06","11","361","0","79","8.6","9.2"
"Macon","2020-05-07","16","377","1","80","9.5","7.9"
"Macon","2020-05-08","2","379","1","81","14.2","11.5"
"Macon","2020-05-09","0","379","0","81","14.2","11.5"
"Macon","2020-05-10","4","383","0","81","12.2","11.5"
"Macon","2020-05-11","6","389","0","81","10.4","9.7"
"Macon","2020-05-12","12","401","0","81","8","9.7"
"Macon","2020-05-13","17","418","2","83","9.7","9.2"
"Macon","2020-05-14","3","421","0","83","8.8","9.2"
"Macon","2020-05-15","4","425","1","84","5.3","9.7"
"Macon","2020-05-16","2","427","0","84","5.3","9.7"
"Macon","2020-05-17","2","429","0","84","5.3","8.7"
"Macon","2020-05-18","11","440","2","86","7.8","9.1"
"Macon","2020-05-19","9","449","2","88","11","9.5"
"Macon","2020-05-20","15","464","1","89","10.3","10"
"Macon","2020-05-21","2","466","1","90","17.4","13.1"
"Macon","2020-05-22","8","474","1","91","15.7","10.5"
"Macon","2020-05-23","2","476","0","91","15.7","10.5"
"Macon","2020-05-24","3","479","0","91","15.7","10.5"
"Macon","2020-05-25","3","482","1","92","17.8","12.8"
"Macon","2020-05-26","20","502","1","93","15.4","13.2"
"Macon","2020-05-27","29","531","0","93","14.4","12.4"
"Macon","2020-05-28","10","541","0","93","7.3","12.4"
"Macon","2020-05-29","7","548","0","93","5.5","10.6"
"Macon","2020-05-30","6","554","2","95","10.2","12.9"
"Macon","2020-05-31","6","560","0","95","10.2","12.9"
"Macon","2020-06-01","11","571","0","95","5.5","11.6"
"Macon","2020-06-02","32","603","1","96","5.2","10.3"
"Macon","2020-06-03","25","628","2","98","6.4","10.4"
"Macon","2020-06-04","12","640","0","98","6.4","6.8"
"Macon","2020-06-05","7","647","0","98","6.4","5.9"
"Macon","2020-06-06","11","658","1","99","2.9","6.6"
"Macon","2020-06-07","3","661","0","99","2.9","6.6"
"Macon","2020-06-08","28","689","2","101","3.9","4.7"
"Macon","2020-06-09","24","713","1","102","4.1","4.6"
"Macon","2020-06-10","19","732","0","102","2.9","4.6"
"Macon","2020-06-11","6","738","0","102","2.9","4.6"
"Macon","2020-06-12","9","747","0","102","2.9","4.6"
"Macon","2020-06-13","0","747","0","102","1.6","2.3"
"Macon","2020-06-14","4","751","0","102","1.6","2.3"
"Macon","2020-06-15","4","755","0","102","0.6","2.3"
"Macon","2020-06-16","22","777","0","102","0","2"
"Macon","2020-06-17","5","782","0","102","0","1.5"
"Macon","2020-06-18","17","799","0","102","0","1.5"
"Macon","2020-06-19","15","814","0","102","0","1.5"
"Macon","2020-06-20","3","817","0","102","0","0.8"
"Macon","2020-06-21","7","824","0","102","0","0.8"
"Macon","2020-06-22","7","831","0","102","0","0.3"
"Macon","2020-06-23","32","863","2","104","0.9","0.4"
"Macon","2020-06-24","9","872","1","105","2.5","1.2"
"Macon","2020-06-25","14","886","2","107","4.5","2.3"
"Macon","2020-06-26","10","896","0","107","4.5","2.3"
"Macon","2020-06-27","10","906","0","107","4.5","2.3"
"Macon","2020-06-28","2","908","0","107","4.5","2.3"
"Macon","2020-06-29","15","923","1","108","5.5","2.7"
"Macon","2020-06-30","15","938","2","110","6.5","3.7"
"Macon","2020-07-01","20","958","3","113","7","4.8"
"Macon","2020-07-02","34","992","7","120","7.9","6.2"
"Macon","2020-07-03","15","1007","4","124","11.8","8.1"
"Macon","2020-07-04","4","1011","0","124","11.8","8.1"
"Macon","2020-07-05","1","1012","0","124","11.8","8.1"
"Macon","2020-07-06","16","1028","5","129","15.3","10.4"
"Macon","2020-07-07","45","1073","3","132","14.3","10.4"
"Macon","2020-07-08","11","1084","0","132","12.2","9.6"
"Macon","2020-07-09","32","1116","0","132","9.2","8.6"
"Macon","2020-07-10","33","1149","2","134","6.3","9"
"Macon","2020-07-11","5","1154","1","135","9.1","10.4"
"Macon","2020-07-12","9","1163","0","135","9.1","10.4"
"Macon","2020-07-13","12","1175","0","135","4.7","10"
"Macon","2020-07-14","28","1203","0","135","3.7","9"
"Macon","2020-07-15","14","1217","1","136","4.7","8.5"
"Macon","2020-07-16","35","1252","2","138","5.6","7.4"
"Macon","2020-07-17","26","1278","5","143","7.4","6.9"
"Macon","2020-07-18","8","1286","0","143","4.6","6.9"
"Macon","2020-07-19","4","1290","1","144","8.2","8.6"
"Macon","2020-07-20","8","1298","0","144","8.2","6.4"
"Macon","2020-07-21","30","1328","2","146","9.1","6.4"
"Macon","2020-07-22","6","1334","1","147","10.5","7.6"
"Macon","2020-07-23","38","1372","4","151","11.2","8.4"
"Macon","2020-07-24","19","1391","0","151","8.4","7.9"
"Macon","2020-07-25","11","1402","2","153","11","7.8"
"Macon","2020-07-26","3","1405","0","153","7.4","7.8"
"Macon","2020-07-27","9","1414","0","153","7.4","7.8"
"Macon","2020-07-28","32","1446","1","154","6.9","8"
"Macon","2020-07-29","5","1451","1","155","7.4","8.9"
"Macon","2020-07-30","34","1485","2","157","6.7","8.9"
"Macon","2020-07-31","5","1490","1","158","9.6","9"
"Macon","2020-08-01","4","1494","0","158","7","9"
"Macon","2020-08-02","1","1495","1","159","21.3","14.4"
"Macon","2020-08-03","6","1501","1","160","23.7","15.6"
"Macon","2020-08-04","29","1530","0","160","23.2","15.1"
"Macon","2020-08-05","10","1540","2","162","23.2","15.3"
"Macon","2020-08-06","32","1572","0","162","22.4","14.6"
"Macon","2020-08-07","12","1584","1","163","20.7","15.2"
"Macon","2020-08-08","1","1585","1","164","35","21"
"Macon","2020-08-09","6","1591","0","164","20.7","21"
"Macon","2020-08-10","12","1603","1","165","19.5","21.6"
"Macon","2020-08-11","35","1638","4","169","21.2","22.2"
"Macon","2020-08-12","4","1642","0","169","18.3","20.8"
"Macon","2020-08-13","27","1669","4","173","20.4","21.4"
"Macon","2020-08-14","12","1681","2","175","21.6","21.2"
"Macon","2020-08-15","7","1688","1","176","9.4","22.2"
"Macon","2020-08-16","3","1691","0","176","9.4","15"
"Macon","2020-08-17","7","1698","0","176","8.2","13.8"
"Macon","2020-08-18","36","1734","3","179","7.7","14.4"
"Macon","2020-08-19","12","1746","3","182","11.3","14.8"
"Macon","2020-08-20","26","1772","3","185","10.8","15.6"
"Macon","2020-08-21","12","1784","1","186","9.6","15.6"
"Macon","2020-08-22","4","1788","0","186","7.6","8.5"
"Macon","2020-08-23","6","1794","0","186","7.6","8.5"
"Macon","2020-08-24","5","1799","0","186","7.6","7.9"
"Macon","2020-08-25","25","1824","1","187","7","7.4"
"Macon","2020-08-26","6","1830","0","187","3.4","7.4"
"Macon","2020-08-27","36","1866","1","188","2.2","6.5"
"Macon","2020-08-28","17","1883","2","190","2.6","6.1"
"Macon","2020-08-29","4","1887","0","190","2.6","5.1"
"Macon","2020-08-30","3","1890","1","191","7.4","7.5"
"Macon","2020-08-31","21","1911","2","193","8.8","8.2"
"Macon","2020-09-01","20","1931","1","194","8.9","7.9"
"Macon","2020-09-02","7","1938","1","195","11","7.2"
"Macon","2020-09-03","34","1972","1","196","11","6.6"
"Macon","2020-09-04","4","1976","0","196","9.3","6"
"Macon","2020-09-05","6","1982","0","196","9.3","6"
"Macon","2020-09-06","7","1989","1","197","6.6","7"
"Macon","2020-09-07","4","1993","2","199","12.4","10.6"
"Macon","2020-09-08","20","2013","4","203","14.5","11.7"
"Macon","2020-09-09","12","2025","2","205","14.8","12.9"
"Macon","2020-09-10","31","2056","1","206","14.9","12.9"
"Macon","2020-09-11","11","2067","1","207","16.2","12.7"
"Macon","2020-09-12","7","2074","0","207","16.2","12.7"
"Macon","2020-09-13","1","2075","0","207","14.1","10.4"
"Macon","2020-09-14","12","2087","1","208","8.2","10.3"
"Macon","2020-09-15","23","2110","0","208","5.3","9.9"
"Macon","2020-09-16","14","2124","2","210","5","9.9"
"Macon","2020-09-17","12","2136","1","211","5.7","10.3"
"Macon","2020-09-18","6","2142","0","211","4.4","10.3"
"Macon","2020-09-19","6","2148","0","211","4.4","10.3"
"Macon","2020-09-20","4","2152","0","211","4.4","9.3"
"Macon","2020-09-21","12","2164","1","212","4.4","6.3"
"Macon","2020-09-22","26","2190","2","214","5.5","5.4"
"Macon","2020-09-23","4","2194","0","214","3.5","4.2"
"Macon","2020-09-24","32","2226","2","216","3.2","4.5"
"Macon","2020-09-25","7","2233","0","216","3.2","3.8"
"Macon","2020-09-26","9","2242","1","217","4.8","4.6"
"Macon","2020-09-27","3","2245","0","217","4.8","4.6"
"Macon","2020-09-28","6","2251","0","217","3.6","4"
"Macon","2020-09-29","16","2267","0","217","2.5","4"
"Macon","2020-09-30","6","2273","1","218","4.9","4.2"
"Macon","2020-10-01","23","2296","0","218","4","3.6"
"Macon","2020-10-02","11","2307","1","219","5.3","4.2"
"Macon","2020-10-03","3","2310","1","220","8.4","6.6"
"Macon","2020-10-04","2","2312","0","220","8.4","6.6"
"Macon","2020-10-05","6","2318","0","220","8.4","6"
"Macon","2020-10-06","7","2325","1","221","10.5","6.5"
"Macon","2020-10-07","18","2343","1","222","8.9","6.9"
"Macon","2020-10-08","18","2361","0","222","8.9","6.4"
"Macon","2020-10-09","10","2371","0","222","7.6","6.4"
"Macon","2020-10-10","5","2376","0","222","2.8","5.6"
"Macon","2020-10-11","3","2379","0","222","2.8","5.6"
"Macon","2020-10-12","10","2389","0","222","2.8","5.6"
"Macon","2020-10-13","15","2404","0","222","0.8","5.6"
"Macon","2020-10-14","6","2410","0","222","0","4.4"
"Macon","2020-10-15","26","2436","3","225","1.6","5.3"
"Macon","2020-10-16","7","2443","2","227","5.7","6.7"
"Macon","2020-10-17","2","2445","0","227","5.7","4.3"
"Macon","2020-10-18","0","2445","0","227","5.7","4.3"
"Macon","2020-10-19","8","2453","1","228","7.5","5.2"
"Macon","2020-10-20","16","2469","2","230","9.3","5"
"Macon","2020-10-21","11","2480","1","231","10.6","5.3"
"Macon","2020-10-22","18","2498","1","232","9.7","5.7"
"Macon","2020-10-23","4","2502","0","232","5.7","5.7"
"Macon","2020-10-24","3","2505","0","232","5.7","5.7"
"Macon","2020-10-25","5","2510","1","233","8.5","7.1"
"Macon","2020-10-26","12","2522","0","233","6.7","7.1"
"Macon","2020-10-27","26","2548","2","235","6","7.7"
"Macon","2020-10-28","6","2554","1","236","7.1","8.9"
"Macon","2020-10-29","30","2584","4","240","8.2","9"
"Macon","2020-10-30","8","2592","0","240","8.2","7"
"Macon","2020-10-31","4","2596","1","241","11.8","8.7"
"Macon","2020-11-01","4","2600","1","242","12.5","10.5"
"Macon","2020-11-02","6","2606","2","244","17.3","12"
"Macon","2020-11-03","21","2627","2","246","17.6","11.8"
"Macon","2020-11-04","7","2634","0","246","15.2","11.2"
"Macon","2020-11-05","14","2648","0","246","13.3","10.8"
"Macon","2020-11-06","6","2654","0","246","13.3","10.8"
"Macon","2020-11-07","2","2656","0","246","9.7","10.8"
"Macon","2020-11-08","1","2657","0","246","6.1","9.3"
"Macon","2020-11-09","11","2668","2","248","4","10.6"
"Macon","2020-11-10","22","2690","0","248","2.6","10.1"
"Macon","2020-11-11","8","2698","0","248","2.6","8.9"
"Macon","2020-11-12","54","2752","4","252","3.7","8.5"
"Macon","2020-11-13","13","2765","1","253","4.8","9"
"Macon","2020-11-14","4","2769","0","253","4.8","7.2"
"Macon","2020-11-15","5","2774","1","254","7.6","6.9"
"Macon","2020-11-16","7","2781","0","254","5","4.5"
"Macon","2020-11-17","6","2787","0","254","5","3.8"
"Macon","2020-11-18","7","2794","2","256","9.1","5.8"
"Macon","2020-11-19","33","2827","4","260","9.8","6.7"
"Macon","2020-11-20","6","2833","0","260","8.7","6.7"
"Macon","2020-11-21","2","2835","0","260","8.7","6.7"
"Macon","2020-11-22","3","2838","0","260","5.8","6.7"
"Macon","2020-11-23","10","2848","3","263","10.1","7.6"
"Macon","2020-11-24","27","2875","5","268","12.7","8.9"
"Macon","2020-11-25","4","2879","1","269","12.2","10.7"
"Macon","2020-11-26","8","2887","0","269","10.5","10.1"
"Macon","2020-11-27","7","2894","1","270","12.5","10.6"
"Macon","2020-11-28","5","2899","1","271","15.4","12"
"Macon","2020-11-29","6","2905","0","271","15.4","10.6"
"Macon","2020-11-30","11","2916","0","271","11.1","10.6"
"Macon","2020-12-01","11","2927","3","274","12.4","12.6"
"Macon","2020-12-02","7","2934","2","276","12.9","12.6"
"Macon","2020-12-03","24","2958","5","281","15.9","13.2"
"Macon","2020-12-04","5","2963","0","281","13.8","13.2"
"Macon","2020-12-05","11","2974","4","285","16.1","15.8"
"Macon","2020-12-06","6","2980","1","286","18.5","17"
"Macon","2020-12-07","8","2988","1","287","20.3","15.7"
"Macon","2020-12-08","16","3004","6","293","21.8","17.1"
"Macon","2020-12-09","15","3019","2","295","19.6","16.2"
"Macon","2020-12-10","38","3057","1","296","17","16.4"
"Macon","2020-12-11","11","3068","0","296","17","15.4"
"Macon","2020-12-12","5","3073","1","297","14.7","15.4"
"Macon","2020-12-13","4","3077","1","298","15.9","17.2"
"Macon","2020-12-14","13","3090","2","300","16.3","18.3"
"Macon","2020-12-15","10","3100","0","300","10.9","16.3"
"Macon","2020-12-16","8","3108","2","302","12.6","16.1"
"Macon","2020-12-17","45","3153","3","305","13.2","15.1"
"Macon","2020-12-18","14","3167","1","306","14.2","15.6"
"Macon","2020-12-19","8","3175","3","309","16.7","15.7"
"Macon","2020-12-20","7","3182","2","311","17.2","16.5"
"Macon","2020-12-21","12","3194","2","313","17.4","16.8"
"Macon","2020-12-22","11","3205","4","317","22.6","16.7"
"Macon","2020-12-23","8","3213","2","319","22.6","17.6"
"Macon","2020-12-24","10","3223","1","320","23","18.1"
"Macon","2020-12-25","2","3225","0","320","22","18.1"
"Macon","2020-12-26","10","3235","7","327","26.7","21.7"
"Macon","2020-12-27","7","3242","3","330","28.7","22.9"
"Macon","2020-12-28","29","3271","7","337","29.8","23.6"
"Macon","2020-12-29","19","3290","10","347","32.1","27.3"
"Macon","2020-12-30","31","3321","9","356","32.7","27.6"
"Macon","2020-12-31","20","3341","6","362","35.5","29.3"
"Macon","2021-01-01","2","3343","1","363","42.7","32.3"
"Macon","2021-01-02","6","3349","3","366","39.8","33.2"
"Macon","2021-01-03","14","3363","5","371","38.8","33.7"
"Macon","2021-01-04","32","3395","11","382","40.3","35"
"Macon","2021-01-05","33","3428","8","390","36.2","34.1"
"Macon","2021-01-06","25","3453","4","394","34.3","33.5"
"Macon","2021-01-07","53","3506","6","400","31.7","33.6"
"Macon","2021-01-08","76","3582","2","402","24.9","33.8"
"Macon","2021-01-09","20","3602","4","406","20.6","30.2"
"Macon","2021-01-10","8","3610","2","408","19.1","28.9"
"Macon","2021-01-11","22","3632","5","413","17.4","28.8"
"Macon","2021-01-12","21","3653","5","418","17.4","26.8"
"Macon","2021-01-13","25","3678","5","423","17.9","26.1"
"Macon","2021-01-14","40","3718","2","425","17","24.3"
"Macon","2021-01-15","19","3737","4","429","19.7","22.3"
"Macon","2021-01-16","12","3749","2","431","19.2","19.9"
"Macon","2021-01-17","11","3760","4","435","20.8","19.9"
"Macon","2021-01-18","19","3779","5","440","21.3","19.4"
"Macon","2021-01-19","19","3798","4","444","20.9","19.1"
"Macon","2021-01-20","26","3824","7","451","21.9","19.9"
"Macon","2021-01-21","37","3861","7","458","23.9","20.5"
"Macon","2021-01-22","9","3870","5","463","28.8","24.2"
"Macon","2021-01-23","7","3877","3","466","32.6","25.9"
"Macon","2021-01-24","3","3880","1","467","32.1","26.5"
"Macon","2021-01-25","7","3887","3","470","34.5","27.9"
"Macon","2021-01-26","1","3888","1","471","45.8","33.3"
"Macon","2021-01-27","0","3888","0","471","41.9","31.9"
"Madison","2020-02-01","0","0","0","0",".","."
"Madison","2020-02-02","0","0","0","0",".","."
"Madison","2020-02-03","0","0","0","0",".","."
"Madison","2020-02-04","0","0","0","0",".","."
"Madison","2020-02-05","0","0","0","0",".","."
"Madison","2020-02-06","0","0","0","0",".","."
"Madison","2020-02-07","0","0","0","0","0","."
"Madison","2020-02-08","0","0","0","0","0","."
"Madison","2020-02-09","0","0","0","0","0","."
"Madison","2020-02-10","0","0","0","0","0","."
"Madison","2020-02-11","0","0","0","0","0","."
"Madison","2020-02-12","0","0","0","0","0","."
"Madison","2020-02-13","0","0","0","0","0","."
"Madison","2020-02-14","0","0","0","0","0","0"
"Madison","2020-02-15","0","0","0","0","0","0"
"Madison","2020-02-16","0","0","0","0","0","0"
"Madison","2020-02-17","0","0","0","0","0","0"
"Madison","2020-02-18","0","0","0","0","0","0"
"Madison","2020-02-19","0","0","0","0","0","0"
"Madison","2020-02-20","0","0","0","0","0","0"
"Madison","2020-02-21","0","0","0","0","0","0"
"Madison","2020-02-22","0","0","0","0","0","0"
"Madison","2020-02-23","0","0","0","0","0","0"
"Madison","2020-02-24","0","0","0","0","0","0"
"Madison","2020-02-25","0","0","0","0","0","0"
"Madison","2020-02-26","0","0","0","0","0","0"
"Madison","2020-02-27","0","0","0","0","0","0"
"Madison","2020-02-28","0","0","0","0","0","0"
"Madison","2020-02-29","0","0","0","0","0","0"
"Madison","2020-03-01","0","0","0","0","0","0"
"Madison","2020-03-02","0","0","0","0","0","0"
"Madison","2020-03-03","0","0","0","0","0","0"
"Madison","2020-03-04","0","0","0","0","0","0"
"Madison","2020-03-05","0","0","0","0","0","0"
"Madison","2020-03-06","0","0","0","0","0","0"
"Madison","2020-03-07","0","0","0","0","0","0"
"Madison","2020-03-08","0","0","0","0","0","0"
"Madison","2020-03-09","0","0","0","0","0","0"
"Madison","2020-03-10","0","0","0","0","0","0"
"Madison","2020-03-11","0","0","0","0","0","0"
"Madison","2020-03-12","0","0","0","0","0","0"
"Madison","2020-03-13","0","0","0","0","0","0"
"Madison","2020-03-14","1","1","0","0","0","0"
"Madison","2020-03-15","1","2","0","0","0","0"
"Madison","2020-03-16","1","3","0","0","0","0"
"Madison","2020-03-17","3","6","0","0","0","0"
"Madison","2020-03-18","11","17","1","1","1.3","0.6"
"Madison","2020-03-19","3","20","0","1","1.3","0.6"
"Madison","2020-03-20","3","23","0","1","1.3","0.6"
"Madison","2020-03-21","2","25","0","1","1.3","0.6"
"Madison","2020-03-22","2","27","1","2","8.4","4.2"
"Madison","2020-03-23","5","32","1","3","11.3","5.6"
"Madison","2020-03-24","20","52","1","4","12","6"
"Madison","2020-03-25","8","60","2","6","14.3","7.8"
"Madison","2020-03-26","13","73","2","8","16.5","8.9"
"Madison","2020-03-27","11","84","2","10","19.1","10.2"
"Madison","2020-03-28","3","87","0","10","19.1","10.2"
"Madison","2020-03-29","2","89","0","10","11.9","10.2"
"Madison","2020-03-30","12","101","1","11","10.3","10.8"
"Madison","2020-03-31","7","108","0","11","9.6","10.8"
"Madison","2020-04-01","10","118","0","11","6","10.1"
"Madison","2020-04-02","4","122","1","12","7.4","11.9"
"Madison","2020-04-03","4","126","0","12","4.8","11.9"
"Madison","2020-04-04","3","129","0","12","4.8","11.9"
"Madison","2020-04-05","0","129","0","12","4.8","8.3"
"Madison","2020-04-06","6","135","1","13","6","8.1"
"Madison","2020-04-07","0","135","0","13","6","7.8"
"Madison","2020-04-08","8","143","2","15","9.5","7.8"
"Madison","2020-04-09","2","145","0","15","6","6.7"
"Madison","2020-04-10","7","152","0","15","6","5.4"
"Madison","2020-04-11","1","153","0","15","6","5.4"
"Madison","2020-04-12","0","153","0","15","6","5.4"
"Madison","2020-04-13","13","166","0","15","3.6","4.8"
"Madison","2020-04-14","7","173","0","15","3.6","4.8"
"Madison","2020-04-15","8","181","1","16","1.8","5.7"
"Madison","2020-04-16","7","188","0","16","1.8","3.9"
"Madison","2020-04-17","5","193","0","16","1.8","3.9"
"Madison","2020-04-18","2","195","0","16","1.8","3.9"
"Madison","2020-04-19","4","199","1","17","5.4","5.7"
"Madison","2020-04-20","13","212","2","19","7.6","5.6"
"Madison","2020-04-21","5","217","0","19","7.6","5.6"
"Madison","2020-04-22","8","225","1","20","7.6","4.7"
"Madison","2020-04-23","8","233","0","20","7.6","4.7"
"Madison","2020-04-24","15","248","1","21","8.5","5.1"
"Madison","2020-04-25","6","254","0","21","8.5","5.1"
"Madison","2020-04-26","2","256","0","21","4.9","5.1"
"Madison","2020-04-27","4","260","0","21","2.7","5.1"
"Madison","2020-04-28","11","271","0","21","2.7","5.1"
"Madison","2020-04-29","15","286","0","21","1","4.3"
"Madison","2020-04-30","15","301","0","21","1","4.3"
"Madison","2020-05-01","15","316","1","22","1","4.7"
"Madison","2020-05-02","7","323","0","22","1","4.7"
"Madison","2020-05-03","11","334","0","22","1","2.9"
"Madison","2020-05-04","12","346","1","23","2.1","2.4"
"Madison","2020-05-05","14","360","1","24","3.2","3"
"Madison","2020-05-06","14","374","0","24","3.2","2.1"
"Madison","2020-05-07","10","384","1","25","4.6","2.8"
"Madison","2020-05-08","8","392","0","25","3.6","2.3"
"Madison","2020-05-09","4","396","1","26","7.2","4.1"
"Madison","2020-05-10","2","398","0","26","7.2","4.1"
"Madison","2020-05-11","11","409","0","26","6","4.1"
"Madison","2020-05-12","11","420","1","27","6.3","4.7"
"Madison","2020-05-13","11","431","0","27","6.3","4.7"
"Madison","2020-05-14","18","449","1","28","5.7","5.1"
"Madison","2020-05-15","27","476","0","28","5.7","4.7"
"Madison","2020-05-16","9","485","0","28","2.1","4.7"
"Madison","2020-05-17","8","493","1","29","3.9","5.5"
"Madison","2020-05-18","22","515","0","29","3.9","4.9"
"Madison","2020-05-19","13","528","0","29","2.6","4.4"
"Madison","2020-05-20","16","544","1","30","3.5","4.9"
"Madison","2020-05-21","18","562","1","31","3.5","4.6"
"Madison","2020-05-22","23","585","2","33","4.7","5.2"
"Madison","2020-05-23","8","593","2","35","8.3","5.2"
"Madison","2020-05-24","7","600","0","35","6.5","5.2"
"Madison","2020-05-25","12","612","3","38","10.1","7"
"Madison","2020-05-26","30","642","1","39","10.5","6.6"
"Madison","2020-05-27","20","662","2","41","11.1","7.3"
"Madison","2020-05-28","15","677","0","41","10.3","6.9"
"Madison","2020-05-29","22","699","0","41","9","6.9"
"Madison","2020-05-30","11","710","0","41","5.5","6.9"
"Madison","2020-05-31","13","723","3","44","8.8","7.6"
"Madison","2020-06-01","37","760","2","46","6","8"
"Madison","2020-06-02","37","797","0","46","5.5","8"
"Madison","2020-06-03","26","823","0","46","4.1","7.6"
"Madison","2020-06-04","23","846","0","46","4.1","7.2"
"Madison","2020-06-05","29","875","0","46","4.1","6.6"
"Madison","2020-06-06","11","886","0","46","4.1","4.8"
"Madison","2020-06-07","16","902","0","46","0.8","4.8"
"Madison","2020-06-08","19","921","0","46","0","3"
"Madison","2020-06-09","18","939","2","48","1.6","3.5"
"Madison","2020-06-10","30","969","0","48","1.6","2.8"
"Madison","2020-06-11","16","985","1","49","2.5","3.3"
"Madison","2020-06-12","27","1012","2","51","3.5","3.8"
"Madison","2020-06-13","17","1029","0","51","3.5","3.8"
"Madison","2020-06-14","9","1038","0","51","3.5","2.2"
"Madison","2020-06-15","19","1057","1","52","4.3","2.1"
"Madison","2020-06-16","26","1083","0","52","2.7","2.1"
"Madison","2020-06-17","32","1115","0","52","2.7","2.1"
"Madison","2020-06-18","26","1141","2","54","2.9","2.7"
"Madison","2020-06-19","20","1161","1","55","2.6","3.1"
"Madison","2020-06-20","9","1170","1","56","4.2","3.8"
"Madison","2020-06-21","11","1181","0","56","4.2","3.8"
"Madison","2020-06-22","34","1215","1","57","3.8","4.1"
"Madison","2020-06-23","27","1242","1","58","4.3","3.5"
"Madison","2020-06-24","29","1271","4","62","6.3","4.5"
"Madison","2020-06-25","40","1311","1","63","5.6","4.2"
"Madison","2020-06-26","47","1358","10","73","7.9","5.2"
"Madison","2020-06-27","5","1363","1","74","9.2","6.7"
"Madison","2020-06-28","18","1381","5","79","13.1","8.6"
"Madison","2020-06-29","42","1423","1","80","13.1","8.4"
"Madison","2020-06-30","47","1470","5","85","14.1","9.2"
"Madison","2020-07-01","33","1503","8","93","15.5","10.9"
"Madison","2020-07-02","33","1536","6","99","17.8","11.7"
"Madison","2020-07-03","23","1559","2","101","16","11.9"
"Madison","2020-07-04","7","1566","2","103","17.2","13.2"
"Madison","2020-07-05","18","1584","3","106","15.6","14.4"
"Madison","2020-07-06","60","1644","8","114","17.2","15.1"
"Madison","2020-07-07","56","1700","11","125","18.5","16.3"
"Madison","2020-07-08","38","1738","5","130","16.9","16.2"
"Madison","2020-07-09","53","1791","9","139","16.7","17.3"
"Madison","2020-07-10","55","1846","5","144","16.8","16.4"
"Madison","2020-07-11","13","1859","5","149","18.2","17.7"
"Madison","2020-07-12","17","1876","4","153","19.2","17.4"
"Madison","2020-07-13","50","1926","7","160","19.3","18.2"
"Madison","2020-07-14","51","1977","10","170","19.3","18.9"
"Madison","2020-07-15","57","2034","9","179","19.6","18.3"
"Madison","2020-07-16","39","2073","7","186","19.8","18.2"
"Madison","2020-07-17","27","2100","4","190","20.6","18.7"
"Madison","2020-07-18","8","2108","4","194","22.2","20.2"
"Madison","2020-07-19","27","2135","5","199","21.5","20.3"
"Madison","2020-07-20","49","2184","10","209","22.4","20.9"
"Madison","2020-07-21","39","2223","8","217","22.6","20.9"
"Madison","2020-07-22","65","2288","10","227","22.5","21.1"
"Madison","2020-07-23","34","2322","6","233","22.5","21.1"
"Madison","2020-07-24","27","2349","6","239","23.5","22.1"
"Madison","2020-07-25","26","2375","6","245","19.7","21"
"Madison","2020-07-26","9","2384","2","247","20.2","20.9"
"Madison","2020-07-27","50","2434","13","260","21","21.7"
"Madison","2020-07-28","56","2490","12","272","21.1","21.9"
"Madison","2020-07-29","35","2525","9","281","22.6","22.6"
"Madison","2020-07-30","42","2567","5","286","21.8","22.1"
"Madison","2020-07-31","41","2608","6","292","20.7","22.1"
"Madison","2020-08-01","16","2624","3","295","20.1","19.9"
"Madison","2020-08-02","13","2637","1","296","18","19.1"
"Madison","2020-08-03","46","2683","4","300","15.5","18.3"
"Madison","2020-08-04","55","2738","8","308","14.6","17.9"
"Madison","2020-08-05","36","2774","8","316","14.1","18.3"
"Madison","2020-08-06","25","2799","2","318","13.5","17.7"
"Madison","2020-08-07","41","2840","5","323","13.2","16.9"
"Madison","2020-08-08","19","2859","2","325","12","16"
"Madison","2020-08-09","17","2876","2","327","12.6","15.3"
"Madison","2020-08-10","46","2922","7","334","13.5","14.5"
"Madison","2020-08-11","31","2953","2","336","12.3","13.5"
"Madison","2020-08-12","26","2979","3","339","10.8","12.4"
"Madison","2020-08-13","31","3010","3","342","11.1","12.3"
"Madison","2020-08-14","31","3041","7","349","12.5","12.8"
"Madison","2020-08-15","13","3054","0","349","11","11.5"
"Madison","2020-08-16","17","3071","3","352","11.9","12.2"
"Madison","2020-08-17","41","3112","6","358","11.8","12.6"
"Madison","2020-08-18","39","3151","4","362","12.3","12.3"
"Madison","2020-08-19","49","3200","6","368","12.4","11.6"
"Madison","2020-08-20","36","3236","8","376","14.2","12.6"
"Madison","2020-08-21","36","3272","1","377","11.4","12"
"Madison","2020-08-22","16","3288","2","379","13.2","12.1"
"Madison","2020-08-23","16","3304","0","379","10.7","11.3"
"Madison","2020-08-24","55","3359","4","383","9.6","10.7"
"Madison","2020-08-25","46","3405","5","388","9.7","11"
"Madison","2020-08-26","44","3449","6","394","9.9","11.2"
"Madison","2020-08-27","48","3497","4","398","7.9","11.1"
"Madison","2020-08-28","56","3553","1","399","7.8","9.6"
"Madison","2020-08-29","25","3578","2","401","7.1","10.2"
"Madison","2020-08-30","13","3591","0","401","7.1","8.9"
"Madison","2020-08-31","54","3645","5","406","7.4","8.5"
"Madison","2020-09-01","79","3724","6","412","6.9","8.3"
"Madison","2020-09-02","67","3791","7","419","6.5","8.2"
"Madison","2020-09-03","57","3848","7","426","7.1","7.5"
"Madison","2020-09-04","61","3909","9","435","8.9","8.3"
"Madison","2020-09-05","22","3931","1","436","8.4","7.8"
"Madison","2020-09-06","15","3946","3","439","11.3","9.2"
"Madison","2020-09-07","24","3970","2","441","11.1","9.3"
"Madison","2020-09-08","63","4033","10","451","12.3","9.6"
"Madison","2020-09-09","64","4097","7","458","12.4","9.4"
"Madison","2020-09-10","44","4141","4","462","11.9","9.5"
"Madison","2020-09-11","53","4194","3","465","10.6","9.8"
"Madison","2020-09-12","22","4216","4","469","12.6","10.5"
"Madison","2020-09-13","15","4231","3","472","12.6","11.9"
"Madison","2020-09-14","48","4279","4","476","12.6","11.9"
"Madison","2020-09-15","61","4340","7","483","12","12.1"
"Madison","2020-09-16","49","4389","5","488","11.8","12.1"
"Madison","2020-09-17","111","4500","11","499","12","11.9"
"Madison","2020-09-18","41","4541","3","502","12.2","11.4"
"Madison","2020-09-19","26","4567","2","504","10.7","11.6"
"Madison","2020-09-20","11","4578","0","504","7.8","10.2"
"Madison","2020-09-21","37","4615","1","505","7","9.8"
"Madison","2020-09-22","56","4671","3","508","6.2","9.1"
"Madison","2020-09-23","34","4705","2","510","5.6","8.7"
"Madison","2020-09-24","43","4748","2","512","4.8","8.4"
"Madison","2020-09-25","39","4787","4","516","5.2","8.7"
"Madison","2020-09-26","38","4825","3","519","5.2","8"
"Madison","2020-09-27","13","4838","2","521","7.4","7.6"
"Madison","2020-09-28","51","4889","2","523","7.6","7.3"
"Madison","2020-09-29","71","4960","0","523","6.9","6.5"
"Madison","2020-09-30","66","5026","2","525","6.4","6"
"Madison","2020-10-01","104","5130","1","526","5.9","5.4"
"Madison","2020-10-02","39","5169","2","528","5.2","5.2"
"Madison","2020-10-03","26","5195","2","530","5.2","5.2"
"Madison","2020-10-04","22","5217","1","531","3.6","5.5"
"Madison","2020-10-05","35","5252","1","532","3.5","5.5"
"Madison","2020-10-06","48","5300","2","534","4.1","5.5"
"Madison","2020-10-07","55","5355","4","538","4.7","5.6"
"Madison","2020-10-08","33","5388","0","538","4.5","5.2"
"Madison","2020-10-09","33","5421","0","538","3.8","4.5"
"Madison","2020-10-10","18","5439","1","539","3.5","4.3"
"Madison","2020-10-11","12","5451","1","540","4","3.8"
"Madison","2020-10-12","32","5483","4","544","5.4","4.4"
"Madison","2020-10-13","37","5520","6","550","7.1","5.6"
"Madison","2020-10-14","39","5559","2","552","6.8","5.7"
"Madison","2020-10-15","23","5582","0","552","6.8","5.7"
"Madison","2020-10-16","29","5611","2","554","7.8","5.8"
"Madison","2020-10-17","13","5624","1","555","8.1","5.8"
"Madison","2020-10-18","16","5640","3","558","9.6","6.8"
"Madison","2020-10-19","41","5681","4","562","9.2","7.3"
"Madison","2020-10-20","36","5717","3","565","8.1","7.6"
"Madison","2020-10-21","38","5755","4","569","8.9","7.8"
"Madison","2020-10-22","31","5786","8","577","12.5","9.7"
"Madison","2020-10-23","42","5828","2","579","12.2","10"
"Madison","2020-10-24","17","5845","4","583","14.5","11.3"
"Madison","2020-10-25","12","5857","1","584","13","11.3"
"Madison","2020-10-26","34","5891","7","591","14.6","11.9"
"Madison","2020-10-27","41","5932","3","594","14.4","11.2"
"Madison","2020-10-28","52","5984","9","603","15.4","12.1"
"Madison","2020-10-29","35","6019","5","608","13.7","13.1"
"Madison","2020-10-30","35","6054","7","615","15.9","14.1"
"Madison","2020-10-31","18","6072","5","620","16.5","15.5"
"Madison","2020-11-01","16","6088","4","624","18.9","16"
"Madison","2020-11-02","43","6131","7","631","18.3","16.4"
"Madison","2020-11-03","46","6177","5","636","18.8","16.6"
"Madison","2020-11-04","38","6215","5","641","18.2","16.8"
"Madison","2020-11-05","44","6259","7","648","18.4","16.1"
"Madison","2020-11-06","49","6308","4","652","16.7","16.3"
"Madison","2020-11-07","20","6328","7","659","17.8","17.1"
"Madison","2020-11-08","17","6345","3","662","16.7","17.8"
"Madison","2020-11-09","65","6410","5","667","15.5","16.9"
"Madison","2020-11-10","52","6462","8","675","16.1","17.5"
"Madison","2020-11-11","49","6511","11","686","17.5","17.8"
"Madison","2020-11-12","54","6565","6","692","16.8","17.6"
"Madison","2020-11-13","36","6601","7","699","18.4","17.6"
"Madison","2020-11-14","33","6634","6","705","16","16.9"
"Madison","2020-11-15","25","6659","4","709","15.8","16.2"
"Madison","2020-11-16","77","6736","10","719","16.5","16"
"Madison","2020-11-17","69","6805","6","725","15.6","15.8"
"Madison","2020-11-18","79","6884","11","736","14.3","15.9"
"Madison","2020-11-19","74","6958","3","739","13.3","15.1"
"Madison","2020-11-20","55","7013","9","748","12.9","15.6"
"Madison","2020-11-21","27","7040","6","754","13.5","14.7"
"Madison","2020-11-22","36","7076","7","761","14","14.9"
"Madison","2020-11-23","68","7144","12","773","14.6","15.6"
"Madison","2020-11-24","71","7215","10","783","15.4","15.5"
"Madison","2020-11-25","38","7253","4","787","14.9","14.6"
"Madison","2020-11-26","9","7262","2","789","17.5","15.4"
"Madison","2020-11-27","48","7310","10","799","18.1","15.5"
"Madison","2020-11-28","38","7348","11","810","19.1","16.3"
"Madison","2020-11-29","41","7389","10","820","19.8","16.9"
"Madison","2020-11-30","88","7477","26","846","21.5","18.1"
"Madison","2020-12-01","99","7576","17","863","21.9","18.7"
"Madison","2020-12-02","65","7641","14","877","23.5","19.2"
"Madison","2020-12-03","76","7717","21","898","24.3","20.9"
"Madison","2020-12-04","81","7798","17","915","24.3","21.2"
"Madison","2020-12-05","50","7848","17","932","25","22.1"
"Madison","2020-12-06","49","7897","6","938","23.3","21.6"
"Madison","2020-12-07","130","8027","19","957","21.2","21.3"
"Madison","2020-12-08","80","8107","10","967","20.5","21.2"
"Madison","2020-12-09","92","8199","15","982","19.8","21.6"
"Madison","2020-12-10","106","8305","30","1012","19.9","22.1"
"Madison","2020-12-11","93","8398","24","1036","20.5","22.4"
"Madison","2020-12-12","41","8439","11","1047","19.5","22.3"
"Madison","2020-12-13","33","8472","11","1058","22.5","22.9"
"Madison","2020-12-14","111","8583","26","1084","23.8","22.5"
"Madison","2020-12-15","116","8699","17","1101","24.1","22.3"
"Madison","2020-12-16","150","8849","23","1124","24","21.9"
"Madison","2020-12-17","88","8937","12","1136","21.9","20.9"
"Madison","2020-12-18","94","9031","25","1161","22","21.3"
"Madison","2020-12-19","57","9088","18","1179","22.7","21.1"
"Madison","2020-12-20","48","9136","16","1195","22.7","22.6"
"Madison","2020-12-21","106","9242","31","1226","23.5","23.6"
"Madison","2020-12-22","101","9343","16","1242","23.7","23.9"
"Madison","2020-12-23","91","9434","26","1268","25.5","24.7"
"Madison","2020-12-24","45","9479","16","1284","28.7","25.3"
"Madison","2020-12-25","12","9491","1","1285","26.1","24"
"Madison","2020-12-26","50","9541","14","1299","25.6","24.1"
"Madison","2020-12-27","58","9599","20","1319","25.7","24.2"
"Madison","2020-12-28","112","9711","31","1350","25.5","24.5"
"Madison","2020-12-29","92","9803","29","1379","27.7","25.7"
"Madison","2020-12-30","109","9912","38","1417","28.6","27.1"
"Madison","2020-12-31","90","10002","30","1447","28.3","28.5"
"Madison","2021-01-01","34","10036","18","1465","34.7","30.4"
"Madison","2021-01-02","35","10071","19","1484","38.4","32"
"Madison","2021-01-03","53","10124","12","1496","36.8","31.2"
"Madison","2021-01-04","111","10235","33","1529","37","31.3"
"Madison","2021-01-05","158","10393","38","1567","36","31.9"
"Madison","2021-01-06","139","10532","40","1607","35.1","31.9"
"Madison","2021-01-07","137","10669","42","1649","34.7","31.5"
"Madison","2021-01-08","134","10803","39","1688","31.3","33"
"Madison","2021-01-09","56","10859","12","1700","26.6","32.5"
"Madison","2021-01-10","58","10917","22","1722","28.8","32.8"
"Madison","2021-01-11","127","11044","36","1758","28.6","32.8"
"Madison","2021-01-12","109","11153","23","1781","28.2","32.1"
"Madison","2021-01-13","108","11261","36","1817","28.8","32"
"Madison","2021-01-14","111","11372","31","1848","28.5","31.6"
"Madison","2021-01-15","104","11476","26","1874","27.9","29.6"
"Madison","2021-01-16","53","11529","14","1888","28.6","27.6"
"Madison","2021-01-17","42","11571","11","1899","26.9","27.9"
"Madison","2021-01-18","78","11649","22","1921","26.9","27.7"
"Madison","2021-01-19","76","11725","21","1942","27.8","28"
"Madison","2021-01-20","100","11825","20","1962","25.9","27.4"
"Madison","2021-01-21","121","11946","30","1992","25.5","27"
"Madison","2021-01-22","83","12029","16","2008","24.6","26.3"
"Madison","2021-01-23","49","12078","14","2022","25","26.8"
"Madison","2021-01-24","27","12105","9","2031","26","26.4"
"Madison","2021-01-25","46","12151","10","2041","25","26"
"Madison","2021-01-26","8","12159","4","2045","28.2","28"
"Madison","2021-01-27","0","12159","0","2045","25.4","25.6"
"Marion","2020-02-01","0","0","0","0",".","."
"Marion","2020-02-02","0","0","0","0",".","."
"Marion","2020-02-03","0","0","0","0",".","."
"Marion","2020-02-04","0","0","0","0",".","."
"Marion","2020-02-05","0","0","0","0",".","."
"Marion","2020-02-06","0","0","0","0",".","."
"Marion","2020-02-07","0","0","0","0","0","."
"Marion","2020-02-08","0","0","0","0","0","."
"Marion","2020-02-09","0","0","0","0","0","."
"Marion","2020-02-10","0","0","0","0","0","."
"Marion","2020-02-11","0","0","0","0","0","."
"Marion","2020-02-12","0","0","0","0","0","."
"Marion","2020-02-13","0","0","0","0","0","."
"Marion","2020-02-14","0","0","0","0","0","0"
"Marion","2020-02-15","0","0","0","0","0","0"
"Marion","2020-02-16","0","0","0","0","0","0"
"Marion","2020-02-17","0","0","0","0","0","0"
"Marion","2020-02-18","0","0","0","0","0","0"
"Marion","2020-02-19","0","0","0","0","0","0"
"Marion","2020-02-20","0","0","0","0","0","0"
"Marion","2020-02-21","0","0","0","0","0","0"
"Marion","2020-02-22","0","0","0","0","0","0"
"Marion","2020-02-23","0","0","0","0","0","0"
"Marion","2020-02-24","0","0","0","0","0","0"
"Marion","2020-02-25","0","0","0","0","0","0"
"Marion","2020-02-26","0","0","0","0","0","0"
"Marion","2020-02-27","0","0","0","0","0","0"
"Marion","2020-02-28","0","0","0","0","0","0"
"Marion","2020-02-29","0","0","0","0","0","0"
"Marion","2020-03-01","0","0","0","0","0","0"
"Marion","2020-03-02","0","0","0","0","0","0"
"Marion","2020-03-03","0","0","0","0","0","0"
"Marion","2020-03-04","0","0","0","0","0","0"
"Marion","2020-03-05","0","0","0","0","0","0"
"Marion","2020-03-06","0","0","0","0","0","0"
"Marion","2020-03-07","0","0","0","0","0","0"
"Marion","2020-03-08","0","0","0","0","0","0"
"Marion","2020-03-09","0","0","0","0","0","0"
"Marion","2020-03-10","0","0","0","0","0","0"
"Marion","2020-03-11","0","0","0","0","0","0"
"Marion","2020-03-12","0","0","0","0","0","0"
"Marion","2020-03-13","0","0","0","0","0","0"
"Marion","2020-03-14","0","0","0","0","0","0"
"Marion","2020-03-15","0","0","0","0","0","0"
"Marion","2020-03-16","0","0","0","0","0","0"
"Marion","2020-03-17","0","0","0","0","0","0"
"Marion","2020-03-18","1","1","0","0","0","0"
"Marion","2020-03-19","3","4","0","0","0","0"
"Marion","2020-03-20","0","4","0","0","0","0"
"Marion","2020-03-21","0","4","0","0","0","0"
"Marion","2020-03-22","2","6","0","0","0","0"
"Marion","2020-03-23","2","8","0","0","0","0"
"Marion","2020-03-24","3","11","0","0","0","0"
"Marion","2020-03-25","9","20","0","0","0","0"
"Marion","2020-03-26","4","24","0","0","0","0"
"Marion","2020-03-27","5","29","2","2","5.7","2.9"
"Marion","2020-03-28","0","29","0","2","5.7","2.9"
"Marion","2020-03-29","1","30","0","2","5.7","2.9"
"Marion","2020-03-30","2","32","0","2","5.7","2.9"
"Marion","2020-03-31","0","32","0","2","5.7","2.9"
"Marion","2020-04-01","2","34","1","3","12.9","6.4"
"Marion","2020-04-02","1","35","0","3","12.9","6.4"
"Marion","2020-04-03","1","36","0","3","7.1","6.4"
"Marion","2020-04-04","2","38","1","4","14.3","10"
"Marion","2020-04-05","0","38","0","4","14.3","10"
"Marion","2020-04-06","7","45","2","6","18.4","12"
"Marion","2020-04-07","5","50","2","8","24.1","14.9"
"Marion","2020-04-08","1","51","0","8","16.9","14.9"
"Marion","2020-04-09","4","55","0","8","16.9","14.9"
"Marion","2020-04-10","6","61","4","12","26.5","16.8"
"Marion","2020-04-11","1","62","1","13","33.6","23.9"
"Marion","2020-04-12","0","62","0","13","33.6","23.9"
"Marion","2020-04-13","6","68","3","16","36.7","27.5"
"Marion","2020-04-14","2","70","0","16","31","27.5"
"Marion","2020-04-15","9","79","3","19","35.7","26.3"
"Marion","2020-04-16","8","87","2","21","39.3","28.1"
"Marion","2020-04-17","8","95","3","24","35.1","30.8"
"Marion","2020-04-18","0","95","0","24","20.8","27.2"
"Marion","2020-04-19","1","96","0","24","20.8","27.2"
"Marion","2020-04-20","6","102","3","27","20.8","28.8"
"Marion","2020-04-21","5","107","0","27","20.8","25.9"
"Marion","2020-04-22","5","112","2","29","21.8","28.8"
"Marion","2020-04-23","1","113","0","29","18.2","28.8"
"Marion","2020-04-24","11","124","2","31","15.5","25.3"
"Marion","2020-04-25","2","126","1","32","22.6","21.7"
"Marion","2020-04-26","4","130","0","32","22.6","21.7"
"Marion","2020-04-27","8","138","2","34","19","19.9"
"Marion","2020-04-28","3","141","0","34","19","19.9"
"Marion","2020-04-29","1","142","0","34","13.3","17.5"
"Marion","2020-04-30","1","143","0","34","13.3","15.8"
"Marion","2020-05-01","9","152","0","34","10.7","13.1"
"Marion","2020-05-02","1","153","0","34","3.6","13.1"
"Marion","2020-05-03","3","156","1","35","8.3","15.5"
"Marion","2020-05-04","5","161","1","36","7.6","13.3"
"Marion","2020-05-05","3","164","0","36","7.6","13.3"
"Marion","2020-05-06","10","174","2","38","10.5","11.9"
"Marion","2020-05-07","1","175","0","38","10.5","11.9"
"Marion","2020-05-08","10","185","0","38","10.5","10.6"
"Marion","2020-05-09","2","187","0","38","10.5","7"
"Marion","2020-05-10","0","187","0","38","5.7","7"
"Marion","2020-05-11","8","195","1","39","4.6","6.1"
"Marion","2020-05-12","2","197","0","39","4.6","6.1"
"Marion","2020-05-13","11","208","2","41","4.4","7.4"
"Marion","2020-05-14","10","218","4","45","10.1","10.3"
"Marion","2020-05-15","8","226","2","47","13.7","12.1"
"Marion","2020-05-16","1","227","0","47","13.7","12.1"
"Marion","2020-05-17","10","237","1","48","15.1","10.4"
"Marion","2020-05-18","27","264","3","51","14.9","9.8"
"Marion","2020-05-19","6","270","1","52","17.3","11"
"Marion","2020-05-20","4","274","0","52","14.7","9.5"
"Marion","2020-05-21","7","281","0","52","9","9.5"
"Marion","2020-05-22","1","282","0","52","5.4","9.5"
"Marion","2020-05-23","0","282","0","52","5.4","9.5"
"Marion","2020-05-24","1","283","0","52","4","9.5"
"Marion","2020-05-25","2","285","0","52","2.4","8.6"
"Marion","2020-05-26","16","301","3","55","2.7","10"
"Marion","2020-05-27","10","311","0","55","2.7","8.7"
"Marion","2020-05-28","3","314","0","55","2.7","5.8"
"Marion","2020-05-29","8","322","2","57","6.3","5.8"
"Marion","2020-05-30","1","323","0","57","6.3","5.8"
"Marion","2020-05-31","1","324","0","57","6.3","5.1"
"Marion","2020-06-01","5","329","0","57","6.3","4.3"
"Marion","2020-06-02","10","339","0","57","3.6","3.1"
"Marion","2020-06-03","6","345","0","57","3.6","3.1"
"Marion","2020-06-04","10","355","1","58","5","3.8"
"Marion","2020-06-05","14","369","1","59","2.4","4.3"
"Marion","2020-06-06","10","379","0","59","2.4","4.3"
"Marion","2020-06-07","0","379","0","59","2.4","4.3"
"Marion","2020-06-08","11","390","0","59","2.4","4.3"
"Marion","2020-06-09","4","394","0","59","2.4","3"
"Marion","2020-06-10","18","412","3","62","4.8","4.2"
"Marion","2020-06-11","10","422","1","63","4.8","4.9"
"Marion","2020-06-12","8","430","0","63","3.8","3.1"
"Marion","2020-06-13","0","430","0","63","3.8","3.1"
"Marion","2020-06-14","4","434","1","64","7.4","4.9"
"Marion","2020-06-15","23","457","2","66","8.6","5.5"
"Marion","2020-06-16","7","464","2","68","12.7","7.6"
"Marion","2020-06-17","49","513","3","71","11.2","8"
"Marion","2020-06-18","13","526","1","72","10.9","7.8"
"Marion","2020-06-19","15","541","2","74","12.8","8.3"
"Marion","2020-06-20","3","544","2","76","22.3","13.1"
"Marion","2020-06-21","2","546","0","76","18.7","13.1"
"Marion","2020-06-22","29","575","0","76","17.5","13.1"
"Marion","2020-06-23","10","585","0","76","13.4","13.1"
"Marion","2020-06-24","28","613","1","77","13","12.1"
"Marion","2020-06-25","14","627","0","77","11.9","11.4"
"Marion","2020-06-26","8","635","0","77","10","11.4"
"Marion","2020-06-27","4","639","0","77","0.5","11.4"
"Marion","2020-06-28","3","642","0","77","0.5","9.6"
"Marion","2020-06-29","7","649","0","77","0.5","9"
"Marion","2020-06-30","11","660","2","79","3.1","8.3"
"Marion","2020-07-01","19","679","7","86","7.9","10.4"
"Marion","2020-07-02","8","687","1","87","9.6","10.8"
"Marion","2020-07-03","4","691","0","87","9.6","9.8"
"Marion","2020-07-04","1","692","1","88","23.9","12.2"
"Marion","2020-07-05","4","696","1","89","27.5","14"
"Marion","2020-07-06","35","731","6","95","30","15.2"
"Marion","2020-07-07","7","738","2","97","31.4","17.3"
"Marion","2020-07-08","42","780","2","99","26.9","17.4"
"Marion","2020-07-09","8","788","0","99","25.1","17.4"
"Marion","2020-07-10","11","799","1","100","26.4","18"
"Marion","2020-07-11","4","803","1","101","15.7","19.8"
"Marion","2020-07-12","5","808","0","101","12.1","19.8"
"Marion","2020-07-13","43","851","3","104","10.6","20.3"
"Marion","2020-07-14","3","854","2","106","16.1","23.8"
"Marion","2020-07-15","39","893","3","109","16.5","21.7"
"Marion","2020-07-16","11","904","3","112","20.4","22.7"
"Marion","2020-07-17","7","911","0","112","19.1","22.7"
"Marion","2020-07-18","5","916","1","113","18.4","17"
"Marion","2020-07-19","3","919","0","113","18.4","15.2"
"Marion","2020-07-20","36","955","4","117","19","14.8"
"Marion","2020-07-21","5","960","0","117","9.4","12.8"
"Marion","2020-07-22","28","988","3","120","9.9","13.2"
"Marion","2020-07-23","18","1006","4","124","9.1","14.8"
"Marion","2020-07-24","6","1012","1","125","11.5","15.3"
"Marion","2020-07-25","7","1019","0","125","8.7","13.5"
"Marion","2020-07-26","2","1021","0","125","8.7","13.5"
"Marion","2020-07-27","46","1067","10","135","10.2","14.6"
"Marion","2020-07-28","12","1079","2","137","12.6","11"
"Marion","2020-07-29","55","1134","5","142","12.3","11.1"
"Marion","2020-07-30","10","1144","2","144","12","10.6"
"Marion","2020-07-31","9","1153","0","144","9.6","10.6"
"Marion","2020-08-01","1","1154","1","145","23.9","16.3"
"Marion","2020-08-02","3","1157","1","146","28.7","18.7"
"Marion","2020-08-03","39","1196","1","147","26","18.1"
"Marion","2020-08-04","38","1234","1","148","23.9","18.3"
"Marion","2020-08-05","37","1271","3","151","23.8","18.1"
"Marion","2020-08-06","7","1278","0","151","20.9","16.5"
"Marion","2020-08-07","4","1282","0","151","20.9","15.3"
"Marion","2020-08-08","7","1289","0","151","6.7","15.3"
"Marion","2020-08-09","4","1293","0","151","1.9","15.3"
"Marion","2020-08-10","33","1326","0","151","1.5","13.7"
"Marion","2020-08-11","5","1331","1","152","4","14"
"Marion","2020-08-12","26","1357","0","152","2.9","13.3"
"Marion","2020-08-13","8","1365","0","152","2.9","11.9"
"Marion","2020-08-14","14","1379","1","153","3.9","12.4"
"Marion","2020-08-15","1","1380","0","153","3.9","5.3"
"Marion","2020-08-16","6","1386","0","153","3.9","2.9"
"Marion","2020-08-17","6","1392","1","154","6.3","3.9"
"Marion","2020-08-18","10","1402","0","154","3.4","3.7"
"Marion","2020-08-19","8","1410","1","155","5.2","4"
"Marion","2020-08-20","13","1423","0","155","5.2","4"
"Marion","2020-08-21","7","1430","0","155","4.2","4"
"Marion","2020-08-22","6","1436","1","156","6.5","5.2"
"Marion","2020-08-23","2","1438","1","157","13.7","8.8"
"Marion","2020-08-24","15","1453","2","159","13.2","9.7"
"Marion","2020-08-25","7","1460","0","159","13.2","8.3"
"Marion","2020-08-26","16","1476","2","161","13.2","9.2"
"Marion","2020-08-27","7","1483","1","162","15.3","10.2"
"Marion","2020-08-28","8","1491","1","163","17","10.6"
"Marion","2020-08-29","1","1492","0","163","14.7","10.6"
"Marion","2020-08-30","2","1494","0","163","7.5","10.6"
"Marion","2020-08-31","18","1512","3","166","8","10.6"
"Marion","2020-09-01","4","1516","0","166","8","10.6"
"Marion","2020-09-02","6","1522","0","166","6.2","9.7"
"Marion","2020-09-03","38","1560","0","166","4.2","9.7"
"Marion","2020-09-04","15","1575","0","166","2.4","9.7"
"Marion","2020-09-05","17","1592","0","166","2.4","8.5"
"Marion","2020-09-06","2","1594","0","166","2.4","4.9"
"Marion","2020-09-07","3","1597","0","166","0","4"
"Marion","2020-09-08","1","1598","0","166","0","4"
"Marion","2020-09-09","15","1613","1","167","1","3.6"
"Marion","2020-09-10","11","1624","0","167","1","2.6"
"Marion","2020-09-11","10","1634","2","169","3.8","3.1"
"Marion","2020-09-12","11","1645","1","170","5.1","3.7"
"Marion","2020-09-13","2","1647","0","170","5.1","3.7"
"Marion","2020-09-14","14","1661","1","171","6.1","3.1"
"Marion","2020-09-15","4","1665","1","172","9.7","4.9"
"Marion","2020-09-16","44","1709","2","174","9.4","5.2"
"Marion","2020-09-17","19","1728","2","176","10.9","5.9"
"Marion","2020-09-18","14","1742","1","177","9.1","6.4"
"Marion","2020-09-19","8","1750","0","177","7.8","6.4"
"Marion","2020-09-20","1","1751","0","177","7.8","6.4"
"Marion","2020-09-21","5","1756","0","177","6.7","6.4"
"Marion","2020-09-22","5","1761","0","177","3.2","6.4"
"Marion","2020-09-23","11","1772","1","178","3.8","6.6"
"Marion","2020-09-24","10","1782","0","178","2.3","6.6"
"Marion","2020-09-25","7","1789","0","178","1.3","5.2"
"Marion","2020-09-26","3","1792","0","178","1.3","4.5"
"Marion","2020-09-27","4","1796","0","178","1.3","4.5"
"Marion","2020-09-28","15","1811","2","180","3.2","5"
"Marion","2020-09-29","4","1815","0","180","3.2","3.2"
"Marion","2020-09-30","10","1825","0","180","1.9","2.9"
"Marion","2020-10-01","4","1829","0","180","1.9","2.1"
"Marion","2020-10-02","4","1833","0","180","1.9","1.6"
"Marion","2020-10-03","4","1837","0","180","1.9","1.6"
"Marion","2020-10-04","4","1841","0","180","1.9","1.6"
"Marion","2020-10-05","9","1850","0","180","0","1.6"
"Marion","2020-10-06","8","1858","0","180","0","1.6"
"Marion","2020-10-07","22","1880","0","180","0","1"
"Marion","2020-10-08","2","1882","0","180","0","1"
"Marion","2020-10-09","10","1892","0","180","0","1"
"Marion","2020-10-10","5","1897","0","180","0","1"
"Marion","2020-10-11","5","1902","1","181","2.9","2.4"
"Marion","2020-10-12","7","1909","0","181","2.9","1.4"
"Marion","2020-10-13","4","1913","0","181","2.9","1.4"
"Marion","2020-10-14","10","1923","0","181","2.9","1.4"
"Marion","2020-10-15","9","1932","0","181","2.9","1.4"
"Marion","2020-10-16","8","1940","0","181","2.9","1.4"
"Marion","2020-10-17","6","1946","0","181","2.9","1.4"
"Marion","2020-10-18","2","1948","0","181","0","1.4"
"Marion","2020-10-19","7","1955","1","182","2","2.4"
"Marion","2020-10-20","9","1964","0","182","2","2.4"
"Marion","2020-10-21","14","1978","0","182","2","2.4"
"Marion","2020-10-22","4","1982","1","183","5.6","4.2"
"Marion","2020-10-23","5","1987","1","184","8.5","5.7"
"Marion","2020-10-24","3","1990","0","184","8.5","5.7"
"Marion","2020-10-25","3","1993","1","185","13.2","6.6"
"Marion","2020-10-26","10","2003","1","186","12.6","7.3"
"Marion","2020-10-27","3","2006","1","187","17.4","9.7"
"Marion","2020-10-28","9","2015","1","188","19","10.5"
"Marion","2020-10-29","4","2019","0","188","15.4","10.5"
"Marion","2020-10-30","7","2026","0","188","12.5","10.5"
"Marion","2020-10-31","3","2029","0","188","12.5","10.5"
"Marion","2020-11-01","3","2032","0","188","7.8","10.5"
"Marion","2020-11-02","8","2040","2","190","9.9","11.3"
"Marion","2020-11-03","3","2043","0","190","5.2","11.3"
"Marion","2020-11-04","17","2060","2","192","5.3","12.1"
"Marion","2020-11-05","11","2071","1","193","6.6","11"
"Marion","2020-11-06","8","2079","0","193","6.6","9.5"
"Marion","2020-11-07","6","2085","0","193","6.6","9.5"
"Marion","2020-11-08","1","2086","0","193","6.6","7.2"
"Marion","2020-11-09","18","2104","2","195","4.6","7.2"
"Marion","2020-11-10","7","2111","0","195","4.6","4.9"
"Marion","2020-11-11","8","2119","0","195","2.9","4.1"
"Marion","2020-11-12","15","2134","0","195","1.6","4.1"
"Marion","2020-11-13","12","2146","0","195","1.6","4.1"
"Marion","2020-11-14","2","2148","0","195","1.6","4.1"
"Marion","2020-11-15","6","2154","0","195","1.6","4.1"
"Marion","2020-11-16","18","2172","2","197","1.6","3.1"
"Marion","2020-11-17","8","2180","0","197","1.6","3.1"
"Marion","2020-11-18","36","2216","2","199","2.4","2.6"
"Marion","2020-11-19","12","2228","0","199","2.4","2"
"Marion","2020-11-20","16","2244","1","200","3.3","2.4"
"Marion","2020-11-21","10","2254","2","202","6.1","3.9"
"Marion","2020-11-22","4","2258","1","203","9.7","5.6"
"Marion","2020-11-23","26","2284","1","204","8.7","5.1"
"Marion","2020-11-24","3","2287","1","205","13.4","7.5"
"Marion","2020-11-25","18","2305","0","205","12.6","7.5"
"Marion","2020-11-26","0","2305","0","205","12.6","7.5"
"Marion","2020-11-27","6","2311","1","206","14.1","8.7"
"Marion","2020-11-28","7","2318","0","206","11.3","8.7"
"Marion","2020-11-29","4","2322","0","206","7.7","8.7"
"Marion","2020-11-30","19","2341","0","206","7.1","7.9"
"Marion","2020-12-01","5","2346","0","206","2.4","7.9"
"Marion","2020-12-02","6","2352","0","206","2.4","7.5"
"Marion","2020-12-03","4","2356","1","207","6","9.3"
"Marion","2020-12-04","7","2363","0","207","3.6","8.8"
"Marion","2020-12-05","3","2366","0","207","3.6","7.4"
"Marion","2020-12-06","5","2371","0","207","3.6","5.6"
"Marion","2020-12-07","25","2396","1","208","4.1","5.6"
"Marion","2020-12-08","3","2399","0","208","4.1","3.3"
"Marion","2020-12-09","6","2405","1","209","6.5","4.5"
"Marion","2020-12-10","11","2416","0","209","3","4.5"
"Marion","2020-12-11","11","2427","0","209","3","3.3"
"Marion","2020-12-12","1","2428","0","209","3","3.3"
"Marion","2020-12-13","3","2431","2","211","12.5","8"
"Marion","2020-12-14","40","2471","9","220","15.1","9.6"
"Marion","2020-12-15","12","2483","3","223","18.7","11.4"
"Marion","2020-12-16","12","2495","2","225","18.7","12.6"
"Marion","2020-12-17","6","2501","0","225","18.7","10.8"
"Marion","2020-12-18","10","2511","1","226","20.1","11.5"
"Marion","2020-12-19","5","2516","2","228","25.8","14.4"
"Marion","2020-12-20","2","2518","0","228","16.3","14.4"
"Marion","2020-12-21","33","2551","3","231","14.4","14.8"
"Marion","2020-12-22","8","2559","1","232","12.6","15.6"
"Marion","2020-12-23","11","2570","2","234","12.8","15.8"
"Marion","2020-12-24","3","2573","0","234","12.8","15.8"
"Marion","2020-12-25","1","2574","0","234","11.4","15.8"
"Marion","2020-12-26","3","2577","0","234","5.7","15.8"
"Marion","2020-12-27","7","2584","1","235","7.7","12"
"Marion","2020-12-28","10","2594","3","238","10.7","12.6"
"Marion","2020-12-29","15","2609","9","247","17.5","15.1"
"Marion","2020-12-30","7","2616","1","248","16.9","14.9"
"Marion","2020-12-31","10","2626","1","249","18.4","15.6"
"Marion","2021-01-01","0","2626","0","249","18.4","14.9"
"Marion","2021-01-02","3","2629","1","250","23.1","14.4"
"Marion","2021-01-03","2","2631","0","250","21.1","14.4"
"Marion","2021-01-04","108","2739","21","271","19.6","15.1"
"Marion","2021-01-05","10","2749","0","271","11","14.3"
"Marion","2021-01-06","11","2760","1","272","10.3","13.6"
"Marion","2021-01-07","19","2779","8","280","14.9","16.6"
"Marion","2021-01-08","12","2791","4","284","19.6","19"
"Marion","2021-01-09","6","2797","1","285","17.2","20.2"
"Marion","2021-01-10","3","2800","1","286","22","21.5"
"Marion","2021-01-11","54","2854","6","292","20.8","20.2"
"Marion","2021-01-12","15","2869","4","296","24.6","17.8"
"Marion","2021-01-13","14","2883","5","301","28.4","19.3"
"Marion","2021-01-14","18","2901","3","304","24.8","19.8"
"Marion","2021-01-15","12","2913","1","305","21.2","20.4"
"Marion","2021-01-16","4","2917","0","305","18.8","18"
"Marion","2021-01-17","2","2919","0","305","14.1","18"
"Marion","2021-01-18","17","2936","5","310","16.7","18.7"
"Marion","2021-01-19","7","2943","2","312","17","20.8"
"Marion","2021-01-20","11","2954","0","312","11.9","20.1"
"Marion","2021-01-21","6","2960","0","312","9.5","17.1"
"Marion","2021-01-22","15","2975","4","316","12.1","16.7"
"Marion","2021-01-23","6","2981","1","317","14.5","16.7"
"Marion","2021-01-24","3","2984","0","317","14.5","14.3"
"Marion","2021-01-25","12","2996","2","319","12.7","14.7"
"Marion","2021-01-26","8","3004","0","319","8.6","12.8"
"Marion","2021-01-27","0","3004","0","319","8.6","10.2"
"McDuffie","2020-02-01","0","0","0","0",".","."
"McDuffie","2020-02-02","0","0","0","0",".","."
"McDuffie","2020-02-03","0","0","0","0",".","."
"McDuffie","2020-02-04","0","0","0","0",".","."
"McDuffie","2020-02-05","0","0","0","0",".","."
"McDuffie","2020-02-06","0","0","0","0",".","."
"McDuffie","2020-02-07","0","0","0","0","0","."
"McDuffie","2020-02-08","0","0","0","0","0","."
"McDuffie","2020-02-09","0","0","0","0","0","."
"McDuffie","2020-02-10","0","0","0","0","0","."
"McDuffie","2020-02-11","0","0","0","0","0","."
"McDuffie","2020-02-12","0","0","0","0","0","."
"McDuffie","2020-02-13","0","0","0","0","0","."
"McDuffie","2020-02-14","0","0","0","0","0","0"
"McDuffie","2020-02-15","0","0","0","0","0","0"
"McDuffie","2020-02-16","0","0","0","0","0","0"
"McDuffie","2020-02-17","0","0","0","0","0","0"
"McDuffie","2020-02-18","0","0","0","0","0","0"
"McDuffie","2020-02-19","0","0","0","0","0","0"
"McDuffie","2020-02-20","0","0","0","0","0","0"
"McDuffie","2020-02-21","0","0","0","0","0","0"
"McDuffie","2020-02-22","0","0","0","0","0","0"
"McDuffie","2020-02-23","0","0","0","0","0","0"
"McDuffie","2020-02-24","0","0","0","0","0","0"
"McDuffie","2020-02-25","0","0","0","0","0","0"
"McDuffie","2020-02-26","0","0","0","0","0","0"
"McDuffie","2020-02-27","0","0","0","0","0","0"
"McDuffie","2020-02-28","0","0","0","0","0","0"
"McDuffie","2020-02-29","0","0","0","0","0","0"
"McDuffie","2020-03-01","0","0","0","0","0","0"
"McDuffie","2020-03-02","0","0","0","0","0","0"
"McDuffie","2020-03-03","0","0","0","0","0","0"
"McDuffie","2020-03-04","0","0","0","0","0","0"
"McDuffie","2020-03-05","0","0","0","0","0","0"
"McDuffie","2020-03-06","0","0","0","0","0","0"
"McDuffie","2020-03-07","0","0","0","0","0","0"
"McDuffie","2020-03-08","0","0","0","0","0","0"
"McDuffie","2020-03-09","0","0","0","0","0","0"
"McDuffie","2020-03-10","0","0","0","0","0","0"
"McDuffie","2020-03-11","0","0","0","0","0","0"
"McDuffie","2020-03-12","1","1","0","0","0","0"
"McDuffie","2020-03-13","0","1","0","0","0","0"
"McDuffie","2020-03-14","0","1","0","0","0","0"
"McDuffie","2020-03-15","0","1","0","0","0","0"
"McDuffie","2020-03-16","0","1","0","0","0","0"
"McDuffie","2020-03-17","1","2","0","0","0","0"
"McDuffie","2020-03-18","0","2","0","0","0","0"
"McDuffie","2020-03-19","2","4","2","2","14.3","7.1"
"McDuffie","2020-03-20","0","4","0","2","14.3","7.1"
"McDuffie","2020-03-21","1","5","0","2","14.3","7.1"
"McDuffie","2020-03-22","0","5","0","2","14.3","7.1"
"McDuffie","2020-03-23","2","7","1","3","21.4","10.7"
"McDuffie","2020-03-24","0","7","0","3","21.4","10.7"
"McDuffie","2020-03-25","1","8","0","3","21.4","10.7"
"McDuffie","2020-03-26","1","9","0","3","7.1","10.7"
"McDuffie","2020-03-27","3","12","1","4","11.9","13.1"
"McDuffie","2020-03-28","3","15","0","4","11.9","13.1"
"McDuffie","2020-03-29","0","15","0","4","11.9","13.1"
"McDuffie","2020-03-30","0","15","0","4","4.8","13.1"
"McDuffie","2020-03-31","1","16","1","5","19","20.2"
"McDuffie","2020-04-01","2","18","0","5","19","20.2"
"McDuffie","2020-04-02","6","24","0","5","19","13.1"
"McDuffie","2020-04-03","6","30","0","5","14.3","13.1"
"McDuffie","2020-04-04","2","32","1","6","21.4","16.7"
"McDuffie","2020-04-05","1","33","0","6","21.4","16.7"
"McDuffie","2020-04-06","2","35","0","6","21.4","13.1"
"McDuffie","2020-04-07","10","45","2","8","10","14.5"
"McDuffie","2020-04-08","13","58","4","12","14.4","16.7"
"McDuffie","2020-04-09","8","66","0","12","14.4","16.7"
"McDuffie","2020-04-10","7","73","4","16","22.6","18.4"
"McDuffie","2020-04-11","12","85","4","20","20.2","20.8"
"McDuffie","2020-04-12","2","87","2","22","34.5","27.9"
"McDuffie","2020-04-13","8","95","2","24","38","29.7"
"McDuffie","2020-04-14","3","98","1","25","39.9","25"
"McDuffie","2020-04-15","9","107","2","27","38.7","26.6"
"McDuffie","2020-04-16","5","112","1","28","41.6","28"
"McDuffie","2020-04-17","9","121","0","28","33.4","28"
"McDuffie","2020-04-18","0","121","0","28","28.7","24.4"
"McDuffie","2020-04-19","2","123","2","30","28.7","31.6"
"McDuffie","2020-04-20","6","129","0","30","25.1","31.6"
"McDuffie","2020-04-21","9","138","0","30","20.3","30.1"
"McDuffie","2020-04-22","14","152","2","32","19.2","29"
"McDuffie","2020-04-23","4","156","0","32","16.3","29"
"McDuffie","2020-04-24","9","165","0","32","16.3","24.9"
"McDuffie","2020-04-25","10","175","1","33","17.8","23.2"
"McDuffie","2020-04-26","5","180","1","34","6.3","17.5"
"McDuffie","2020-04-27","4","184","0","34","6.3","15.7"
"McDuffie","2020-04-28","10","194","2","36","9.2","14.8"
"McDuffie","2020-04-29","6","200","0","36","7.1","13.2"
"McDuffie","2020-04-30","5","205","0","36","7.1","11.7"
"McDuffie","2020-05-01","8","213","2","38","10.7","13.5"
"McDuffie","2020-05-02","6","219","3","41","16.4","17.1"
"McDuffie","2020-05-03","8","227","1","42","15.4","10.8"
"McDuffie","2020-05-04","13","240","1","43","16.5","11.4"
"McDuffie","2020-05-05","12","252","0","43","13.6","11.4"
"McDuffie","2020-05-06","11","263","2","45","16.2","11.7"
"McDuffie","2020-05-07","10","273","1","46","17.6","12.4"
"McDuffie","2020-05-08","7","280","0","46","14.1","12.4"
"McDuffie","2020-05-09","4","284","0","46","6.9","11.7"
"McDuffie","2020-05-10","0","284","0","46","5.1","10.2"
"McDuffie","2020-05-11","14","298","1","47","5","10.8"
"McDuffie","2020-05-12","17","315","1","48","5.9","9.7"
"McDuffie","2020-05-13","11","326","1","49","4.6","10.4"
"McDuffie","2020-05-14","13","339","3","52","6.5","12"
"McDuffie","2020-05-15","7","346","1","53","8.5","11.3"
"McDuffie","2020-05-16","6","352","0","53","8.5","7.7"
"McDuffie","2020-05-17","5","357","0","53","8.5","6.8"
"McDuffie","2020-05-18","19","376","4","57","10.5","7.8"
"McDuffie","2020-05-19","23","399","3","60","11.5","8.7"
"McDuffie","2020-05-20","10","409","0","60","10.2","7.4"
"McDuffie","2020-05-21","19","428","0","60","6.9","6.7"
"McDuffie","2020-05-22","6","434","0","60","4.9","6.7"
"McDuffie","2020-05-23","4","438","0","60","4.9","6.7"
"McDuffie","2020-05-24","8","446","0","60","4.9","6.7"
"McDuffie","2020-05-25","1","447","0","60","1.9","6.2"
"McDuffie","2020-05-26","7","454","0","60","0","5.8"
"McDuffie","2020-05-27","6","460","0","60","0","5.1"
"McDuffie","2020-05-28","9","469","1","61","1.6","4.2"
"McDuffie","2020-05-29","3","472","0","61","1.6","3.2"
"McDuffie","2020-05-30","1","473","0","61","1.6","3.2"
"McDuffie","2020-05-31","9","482","2","63","4.8","4.8"
"McDuffie","2020-06-01","18","500","0","63","4.8","3.3"
"McDuffie","2020-06-02","19","519","0","63","4.8","2.4"
"McDuffie","2020-06-03","9","528","0","63","4.8","2.4"
"McDuffie","2020-06-04","3","531","0","63","3.2","2.4"
"McDuffie","2020-06-05","6","537","0","63","3.2","2.4"
"McDuffie","2020-06-06","1","538","1","64","17.5","9.5"
"McDuffie","2020-06-07","2","540","0","64","14.3","9.5"
"McDuffie","2020-06-08","3","543","0","64","14.3","9.5"
"McDuffie","2020-06-09","5","548","0","64","14.3","9.5"
"McDuffie","2020-06-10","18","566","0","64","14.3","9.5"
"McDuffie","2020-06-11","16","582","1","65","15.2","9.2"
"McDuffie","2020-06-12","13","595","0","65","15.2","9.2"
"McDuffie","2020-06-13","5","600","0","65","0.9","9.2"
"McDuffie","2020-06-14","10","610","1","66","2.3","8.3"
"McDuffie","2020-06-15","15","625","1","67","3.3","8.8"
"McDuffie","2020-06-16","14","639","0","67","3.3","8.8"
"McDuffie","2020-06-17","7","646","1","68","5.3","9.8"
"McDuffie","2020-06-18","9","655","1","69","6","10.6"
"McDuffie","2020-06-19","4","659","2","71","13.2","14.2"
"McDuffie","2020-06-20","9","668","0","71","13.2","7"
"McDuffie","2020-06-21","2","670","0","71","11.7","7"
"McDuffie","2020-06-22","16","686","3","74","13.4","8.4"
"McDuffie","2020-06-23","18","704","2","76","15","9.2"
"McDuffie","2020-06-24","14","718","2","78","15","10.2"
"McDuffie","2020-06-25","21","739","1","79","14.1","10.1"
"McDuffie","2020-06-26","11","750","1","80","8.3","10.7"
"McDuffie","2020-06-27","17","767","3","83","10.8","12"
"McDuffie","2020-06-28","7","774","1","84","12.8","12.3"
"McDuffie","2020-06-29","49","823","10","94","13.1","13.3"
"McDuffie","2020-06-30","26","849","5","99","14.2","14.6"
"McDuffie","2020-07-01","28","877","6","105","15.3","15.2"
"McDuffie","2020-07-02","22","899","3","108","16.5","15.3"
"McDuffie","2020-07-03","16","915","2","110","17","12.7"
"McDuffie","2020-07-04","7","922","0","110","14.5","12.7"
"McDuffie","2020-07-05","25","947","6","116","15.9","14.4"
"McDuffie","2020-07-06","32","979","6","122","15.6","14.4"
"McDuffie","2020-07-07","25","1004","4","126","15.2","14.7"
"McDuffie","2020-07-08","24","1028","2","128","13.3","14.3"
"McDuffie","2020-07-09","31","1059","3","131","12.8","14.6"
"McDuffie","2020-07-10","28","1087","5","136","13.5","15.3"
"McDuffie","2020-07-11","10","1097","0","136","13.5","14"
"McDuffie","2020-07-12","29","1126","4","140","12.1","14"
"McDuffie","2020-07-13","61","1187","10","150","11.7","13.7"
"McDuffie","2020-07-14","34","1221","5","155","11.5","13.4"
"McDuffie","2020-07-15","38","1259","6","161","12.6","13"
"McDuffie","2020-07-16","36","1295","3","164","12.4","12.6"
"McDuffie","2020-07-17","21","1316","4","168","12.6","13"
"McDuffie","2020-07-18","29","1345","1","169","13.1","13.3"
"McDuffie","2020-07-19","20","1365","2","171","12.5","12.3"
"McDuffie","2020-07-20","45","1410","14","185","14.6","13.2"
"McDuffie","2020-07-21","21","1431","1","186","13.2","12.4"
"McDuffie","2020-07-22","28","1459","11","197","16.6","14.6"
"McDuffie","2020-07-23","35","1494","6","203","17.8","15.1"
"McDuffie","2020-07-24","26","1520","6","209","18.4","15.5"
"McDuffie","2020-07-25","21","1541","4","213","20.6","16.9"
"McDuffie","2020-07-26","23","1564","2","215","20.4","16.5"
"McDuffie","2020-07-27","28","1592","6","221","19.1","16.8"
"McDuffie","2020-07-28","39","1631","5","226","20.2","16.7"
"McDuffie","2020-07-29","23","1654","5","231","17.7","17.1"
"McDuffie","2020-07-30","18","1672","3","234","17.6","17.7"
"McDuffie","2020-07-31","28","1700","9","243","18.9","18.7"
"McDuffie","2020-08-01","17","1717","2","245","17.9","19.3"
"McDuffie","2020-08-02","12","1729","1","246","17.8","19.1"
"McDuffie","2020-08-03","19","1748","3","249","17","18"
"McDuffie","2020-08-04","35","1783","5","254","17.2","18.7"
"McDuffie","2020-08-05","33","1816","7","261","17.2","17.4"
"McDuffie","2020-08-06","23","1839","7","268","19.1","18.4"
"McDuffie","2020-08-07","20","1859","4","272","17.4","18.2"
"McDuffie","2020-08-08","24","1883","1","273","16.3","17.1"
"McDuffie","2020-08-09","26","1909","8","281","19.5","18.7"
"McDuffie","2020-08-10","23","1932","2","283","18.5","17.8"
"McDuffie","2020-08-11","34","1966","7","290","19.4","18.3"
"McDuffie","2020-08-12","23","1989","2","292","17.6","17.4"
"McDuffie","2020-08-13","24","2013","7","299","17.4","18.3"
"McDuffie","2020-08-14","27","2040","8","307","18.8","18.1"
"McDuffie","2020-08-15","18","2058","3","310","20.6","18.5"
"McDuffie","2020-08-16","10","2068","1","311","17.6","18.6"
"McDuffie","2020-08-17","32","2100","5","316","18.6","18.6"
"McDuffie","2020-08-18","12","2112","2","318","18.1","18.7"
"McDuffie","2020-08-19","20","2132","7","325","21.8","19.7"
"McDuffie","2020-08-20","25","2157","4","329","19.9","18.7"
"McDuffie","2020-08-21","26","2183","1","330","16.3","17.5"
"McDuffie","2020-08-22","9","2192","1","331","15.5","18"
"McDuffie","2020-08-23","13","2205","3","334","17.3","17.5"
"McDuffie","2020-08-24","38","2243","8","342","18.1","18.4"
"McDuffie","2020-08-25","23","2266","5","347","18.8","18.4"
"McDuffie","2020-08-26","21","2287","3","350","15.9","18.8"
"McDuffie","2020-08-27","16","2303","2","352","15.4","17.7"
"McDuffie","2020-08-28","38","2341","10","362","18.6","17.4"
"McDuffie","2020-08-29","13","2354","3","365","20.3","17.9"
"McDuffie","2020-08-30","19","2373","2","367","18.5","17.9"
"McDuffie","2020-08-31","13","2386","2","369","17.7","17.9"
"McDuffie","2020-09-01","24","2410","2","371","15.8","17.3"
"McDuffie","2020-09-02","33","2443","0","371","13.7","14.8"
"McDuffie","2020-09-03","22","2465","6","377","15.8","15.6"
"McDuffie","2020-09-04","23","2488","5","382","15.2","16.9"
"McDuffie","2020-09-05","14","2502","2","384","13.9","17.1"
"McDuffie","2020-09-06","8","2510","0","384","12.4","15.5"
"McDuffie","2020-09-07","14","2524","1","385","11.3","14.5"
"McDuffie","2020-09-08","21","2545","9","394","16.2","16"
"McDuffie","2020-09-09","25","2570","3","397","17.9","15.8"
"McDuffie","2020-09-10","30","2600","2","399","15","15.4"
"McDuffie","2020-09-11","17","2617","4","403","15.2","15.2"
"McDuffie","2020-09-12","28","2645","4","407","15.2","14.6"
"McDuffie","2020-09-13","12","2657","1","408","16.4","14.4"
"McDuffie","2020-09-14","27","2684","2","410","16.4","13.8"
"McDuffie","2020-09-15","30","2714","2","412","11.3","13.7"
"McDuffie","2020-09-16","15","2729","1","413","10.5","14.2"
"McDuffie","2020-09-17","17","2746","0","413","9.6","12.3"
"McDuffie","2020-09-18","42","2788","2","415","6.9","11"
"McDuffie","2020-09-19","21","2809","1","416","5.5","10.4"
"McDuffie","2020-09-20","15","2824","0","416","4.3","10.4"
"McDuffie","2020-09-21","30","2854","1","417","3.7","10.1"
"McDuffie","2020-09-22","28","2882","1","418","3.3","7.3"
"McDuffie","2020-09-23","25","2907","0","418","2.3","6.4"
"McDuffie","2020-09-24","19","2926","5","423","6.1","7.8"
"McDuffie","2020-09-25","19","2945","2","425","6.9","6.9"
"McDuffie","2020-09-26","19","2964","2","427","7.8","6.6"
"McDuffie","2020-09-27","6","2970","0","427","7.8","6"
"McDuffie","2020-09-28","26","2996","2","429","8.4","6.1"
"McDuffie","2020-09-29","10","3006","3","432","12.2","7.7"
"McDuffie","2020-09-30","30","3036","1","433","12.6","7.5"
"McDuffie","2020-10-01","29","3065","4","437","10.8","8.5"
"McDuffie","2020-10-02","31","3096","0","437","9.3","8.1"
"McDuffie","2020-10-03","13","3109","3","440","11.1","9.4"
"McDuffie","2020-10-04","15","3124","1","441","12.1","9.9"
"McDuffie","2020-10-05","38","3162","6","447","13.2","10.8"
"McDuffie","2020-10-06","39","3201","0","447","9","10.6"
"McDuffie","2020-10-07","29","3230","3","450","10","11.3"
"McDuffie","2020-10-08","20","3250","0","450","8","9.4"
"McDuffie","2020-10-09","42","3292","4","454","9.3","9.3"
"McDuffie","2020-10-10","17","3309","1","455","6.9","9"
"McDuffie","2020-10-11","15","3324","1","456","6.9","9.5"
"McDuffie","2020-10-12","33","3357","0","456","4.6","8.9"
"McDuffie","2020-10-13","20","3377","5","461","8.2","8.6"
"McDuffie","2020-10-14","21","3398","0","461","6.7","8.3"
"McDuffie","2020-10-15","18","3416","5","466","10.7","9.3"
"McDuffie","2020-10-16","44","3460","1","467","9.7","9.5"
"McDuffie","2020-10-17","21","3481","1","468","9.5","8.2"
"McDuffie","2020-10-18","13","3494","1","469","9.6","8.3"
"McDuffie","2020-10-19","29","3523","2","471","10.6","7.6"
"McDuffie","2020-10-20","27","3550","1","472","7.6","7.9"
"McDuffie","2020-10-21","42","3592","4","476","8.9","7.8"
"McDuffie","2020-10-22","26","3618","1","477","5.5","8.1"
"McDuffie","2020-10-23","37","3655","4","481","6.7","8.2"
"McDuffie","2020-10-24","17","3672","3","484","8.6","9"
"McDuffie","2020-10-25","6","3678","0","484","7.5","8.6"
"McDuffie","2020-10-26","43","3721","9","493","9.5","10.1"
"McDuffie","2020-10-27","23","3744","1","494","9.6","8.6"
"McDuffie","2020-10-28","38","3782","6","500","10.5","9.7"
"McDuffie","2020-10-29","23","3805","4","504","12.4","9"
"McDuffie","2020-10-30","50","3855","9","513","13.4","10.1"
"McDuffie","2020-10-31","12","3867","2","515","13.3","10.9"
"McDuffie","2020-11-01","12","3879","0","515","13.3","10.4"
"McDuffie","2020-11-02","60","3939","8","523","12.2","10.9"
"McDuffie","2020-11-03","31","3970","1","524","12.1","10.8"
"McDuffie","2020-11-04","18","3988","1","525","10.6","10.5"
"McDuffie","2020-11-05","36","4024","7","532","10.9","11.7"
"McDuffie","2020-11-06","57","4081","6","538","9.8","11.6"
"McDuffie","2020-11-07","19","4100","2","540","8.9","11.1"
"McDuffie","2020-11-08","10","4110","3","543","13.2","13.3"
"McDuffie","2020-11-09","38","4148","4","547","12.8","12.5"
"McDuffie","2020-11-10","35","4183","2","549","13.2","12.6"
"McDuffie","2020-11-11","30","4213","3","552","13.8","12.2"
"McDuffie","2020-11-12","37","4250","0","552","11","11"
"McDuffie","2020-11-13","49","4299","2","554","10.1","10"
"McDuffie","2020-11-14","15","4314","3","557","11.5","10.2"
"McDuffie","2020-11-15","14","4328","1","558","8.2","10.7"
"McDuffie","2020-11-16","37","4365","6","564","9","10.9"
"McDuffie","2020-11-17","41","4406","6","570","10.3","11.7"
"McDuffie","2020-11-18","47","4453","5","575","10.4","12.1"
"McDuffie","2020-11-19","28","4481","1","576","10.9","11"
"McDuffie","2020-11-20","64","4545","3","579","11","10.6"
"McDuffie","2020-11-21","32","4577","1","580","8.6","10"
"McDuffie","2020-11-22","19","4596","0","580","7.6","7.9"
"McDuffie","2020-11-23","21","4617","0","580","5.2","7.1"
"McDuffie","2020-11-24","35","4652","1","581","3.6","6.9"
"McDuffie","2020-11-25","27","4679","3","584","3.6","7"
"McDuffie","2020-11-26","5","4684","0","584","3.1","7"
"McDuffie","2020-11-27","19","4703","3","587","4.7","7.8"
"McDuffie","2020-11-28","29","4732","3","590","5.7","7.2"
"McDuffie","2020-11-29","9","4741","1","591","7.3","7.4"
"McDuffie","2020-11-30","32","4773","4","595","9.1","7.2"
"McDuffie","2020-12-01","50","4823","10","605","11.6","7.6"
"McDuffie","2020-12-02","38","4861","6","611","12.2","7.9"
"McDuffie","2020-12-03","47","4908","3","614","13.1","8.1"
"McDuffie","2020-12-04","52","4960","14","628","14.7","9.7"
"McDuffie","2020-12-05","25","4985","4","632","15.5","10.6"
"McDuffie","2020-12-06","16","5001","5","637","18.4","12.9"
"McDuffie","2020-12-07","53","5054","7","644","18.5","13.8"
"McDuffie","2020-12-08","46","5100","5","649","17.2","14.4"
"McDuffie","2020-12-09","36","5136","4","653","16.5","14.4"
"McDuffie","2020-12-10","34","5170","8","661","19","16.1"
"McDuffie","2020-12-11","44","5214","9","670","18.1","16.4"
"McDuffie","2020-12-12","27","5241","0","670","15.8","15.7"
"McDuffie","2020-12-13","12","5253","3","673","14.9","16.6"
"McDuffie","2020-12-14","37","5290","5","678","14.9","16.7"
"McDuffie","2020-12-15","44","5334","9","687","16.3","16.7"
"McDuffie","2020-12-16","34","5368","8","695","18.1","17.3"
"McDuffie","2020-12-17","37","5405","4","699","16.3","17.6"
"McDuffie","2020-12-18","34","5439","2","701","14.2","16.1"
"McDuffie","2020-12-19","21","5460","3","704","16.2","16"
"McDuffie","2020-12-20","22","5482","7","711","17.2","16"
"McDuffie","2020-12-21","47","5529","12","723","18.9","16.9"
"McDuffie","2020-12-22","36","5565","3","726","17.2","16.7"
"McDuffie","2020-12-23","35","5600","6","732","16.3","17.2"
"McDuffie","2020-12-24","19","5619","5","737","18.5","17.4"
"McDuffie","2020-12-25","5","5624","0","737","17.6","15.9"
"McDuffie","2020-12-26","23","5647","9","746","21.2","18.7"
"McDuffie","2020-12-27","18","5665","7","753","22.2","19.7"
"McDuffie","2020-12-28","49","5714","11","764","21.8","20.3"
"McDuffie","2020-12-29","47","5761","11","775","23.9","20.5"
"McDuffie","2020-12-30","49","5810","11","786","24.7","20.5"
"McDuffie","2020-12-31","32","5842","6","792","23.6","21"
"McDuffie","2021-01-01","4","5846","1","793","27.2","22.4"
"McDuffie","2021-01-02","28","5874","8","801","25.6","23.4"
"McDuffie","2021-01-03","11","5885","3","804","24","23.1"
"McDuffie","2021-01-04","31","5916","12","816","26.3","24"
"McDuffie","2021-01-05","77","5993","28","844","28.2","26"
"McDuffie","2021-01-06","60","6053","16","860","28.8","26.7"
"McDuffie","2021-01-07","72","6125","26","886","31.2","27.4"
"McDuffie","2021-01-08","51","6176","15","901","31.9","29.5"
"McDuffie","2021-01-09","41","6217","14","915","32.7","29.2"
"McDuffie","2021-01-10","33","6250","9","924","32.7","28.3"
"McDuffie","2021-01-11","60","6310","16","940","30.9","28.6"
"McDuffie","2021-01-12","71","6381","19","959","29.6","28.9"
"McDuffie","2021-01-13","65","6446","18","977","29.7","29.2"
"McDuffie","2021-01-14","49","6495","13","990","28.4","29.8"
"McDuffie","2021-01-15","61","6556","12","1002","27","29.4"
"McDuffie","2021-01-16","44","6600","10","1012","25.3","29"
"McDuffie","2021-01-17","25","6625","6","1018","24.9","28.8"
"McDuffie","2021-01-18","56","6681","15","1033","24.9","27.9"
"McDuffie","2021-01-19","62","6743","15","1048","24.5","27"
"McDuffie","2021-01-20","49","6792","14","1062","24.6","27.2"
"McDuffie","2021-01-21","48","6840","10","1072","23.8","26.1"
"McDuffie","2021-01-22","53","6893","18","1090","25.9","26.4"
"McDuffie","2021-01-23","27","6920","5","1095","25.3","25.3"
"McDuffie","2021-01-24","27","6947","10","1105","27.1","26"
"McDuffie","2021-01-25","32","6979","12","1117","28.7","26.8"
"McDuffie","2021-01-26","4","6983","2","1119","32.3","28.4"
"McDuffie","2021-01-27","0","6983","0","1119","28.3","26.5"
"McIntosh","2020-02-01","0","0","0","0",".","."
"McIntosh","2020-02-02","0","0","0","0",".","."
"McIntosh","2020-02-03","0","0","0","0",".","."
"McIntosh","2020-02-04","0","0","0","0",".","."
"McIntosh","2020-02-05","0","0","0","0",".","."
"McIntosh","2020-02-06","0","0","0","0",".","."
"McIntosh","2020-02-07","0","0","0","0","0","."
"McIntosh","2020-02-08","0","0","0","0","0","."
"McIntosh","2020-02-09","0","0","0","0","0","."
"McIntosh","2020-02-10","0","0","0","0","0","."
"McIntosh","2020-02-11","0","0","0","0","0","."
"McIntosh","2020-02-12","0","0","0","0","0","."
"McIntosh","2020-02-13","0","0","0","0","0","."
"McIntosh","2020-02-14","0","0","0","0","0","0"
"McIntosh","2020-02-15","0","0","0","0","0","0"
"McIntosh","2020-02-16","0","0","0","0","0","0"
"McIntosh","2020-02-17","0","0","0","0","0","0"
"McIntosh","2020-02-18","0","0","0","0","0","0"
"McIntosh","2020-02-19","0","0","0","0","0","0"
"McIntosh","2020-02-20","0","0","0","0","0","0"
"McIntosh","2020-02-21","0","0","0","0","0","0"
"McIntosh","2020-02-22","0","0","0","0","0","0"
"McIntosh","2020-02-23","0","0","0","0","0","0"
"McIntosh","2020-02-24","0","0","0","0","0","0"
"McIntosh","2020-02-25","0","0","0","0","0","0"
"McIntosh","2020-02-26","0","0","0","0","0","0"
"McIntosh","2020-02-27","0","0","0","0","0","0"
"McIntosh","2020-02-28","0","0","0","0","0","0"
"McIntosh","2020-02-29","0","0","0","0","0","0"
"McIntosh","2020-03-01","0","0","0","0","0","0"
"McIntosh","2020-03-02","0","0","0","0","0","0"
"McIntosh","2020-03-03","0","0","0","0","0","0"
"McIntosh","2020-03-04","0","0","0","0","0","0"
"McIntosh","2020-03-05","0","0","0","0","0","0"
"McIntosh","2020-03-06","0","0","0","0","0","0"
"McIntosh","2020-03-07","0","0","0","0","0","0"
"McIntosh","2020-03-08","0","0","0","0","0","0"
"McIntosh","2020-03-09","0","0","0","0","0","0"
"McIntosh","2020-03-10","0","0","0","0","0","0"
"McIntosh","2020-03-11","0","0","0","0","0","0"
"McIntosh","2020-03-12","0","0","0","0","0","0"
"McIntosh","2020-03-13","0","0","0","0","0","0"
"McIntosh","2020-03-14","0","0","0","0","0","0"
"McIntosh","2020-03-15","0","0","0","0","0","0"
"McIntosh","2020-03-16","2","2","0","0","0","0"
"McIntosh","2020-03-17","1","3","0","0","0","0"
"McIntosh","2020-03-18","0","3","0","0","0","0"
"McIntosh","2020-03-19","5","8","0","0","0","0"
"McIntosh","2020-03-20","4","12","0","0","0","0"
"McIntosh","2020-03-21","3","15","0","0","0","0"
"McIntosh","2020-03-22","0","15","0","0","0","0"
"McIntosh","2020-03-23","4","19","1","1","3.6","1.8"
"McIntosh","2020-03-24","4","23","0","1","3.6","1.8"
"McIntosh","2020-03-25","5","28","0","1","3.6","1.8"
"McIntosh","2020-03-26","2","30","0","1","3.6","1.8"
"McIntosh","2020-03-27","5","35","0","1","3.6","1.8"
"McIntosh","2020-03-28","0","35","0","1","3.6","1.8"
"McIntosh","2020-03-29","0","35","0","1","3.6","1.8"
"McIntosh","2020-03-30","5","40","0","1","0","1.8"
"McIntosh","2020-03-31","9","49","2","3","3.2","3.4"
"McIntosh","2020-04-01","7","56","0","3","3.2","3.4"
"McIntosh","2020-04-02","1","57","0","3","3.2","3.4"
"McIntosh","2020-04-03","4","61","1","4","6.7","5.2"
"McIntosh","2020-04-04","2","63","0","4","6.7","5.2"
"McIntosh","2020-04-05","0","63","0","4","6.7","5.2"
"McIntosh","2020-04-06","1","64","0","4","6.7","3.4"
"McIntosh","2020-04-07","1","65","0","4","3.6","3.4"
"McIntosh","2020-04-08","0","65","0","4","3.6","3.4"
"McIntosh","2020-04-09","0","65","0","4","3.6","3.4"
"McIntosh","2020-04-10","5","70","0","4","0","3.4"
"McIntosh","2020-04-11","0","70","0","4","0","3.4"
"McIntosh","2020-04-12","1","71","0","4","0","3.4"
"McIntosh","2020-04-13","0","71","0","4","0","3.4"
"McIntosh","2020-04-14","6","77","0","4","0","1.8"
"McIntosh","2020-04-15","4","81","2","6","7.1","5.4"
"McIntosh","2020-04-16","2","83","0","6","7.1","5.4"
"McIntosh","2020-04-17","3","86","0","6","7.1","3.6"
"McIntosh","2020-04-18","2","88","0","6","7.1","3.6"
"McIntosh","2020-04-19","1","89","0","6","7.1","3.6"
"McIntosh","2020-04-20","4","93","0","6","7.1","3.6"
"McIntosh","2020-04-21","5","98","0","6","7.1","3.6"
"McIntosh","2020-04-22","0","98","0","6","0","3.6"
"McIntosh","2020-04-23","10","108","0","6","0","3.6"
"McIntosh","2020-04-24","1","109","0","6","0","3.6"
"McIntosh","2020-04-25","0","109","0","6","0","3.6"
"McIntosh","2020-04-26","1","110","0","6","0","3.6"
"McIntosh","2020-04-27","2","112","0","6","0","3.6"
"McIntosh","2020-04-28","4","116","0","6","0","3.6"
"McIntosh","2020-04-29","2","118","0","6","0","0"
"McIntosh","2020-04-30","5","123","0","6","0","0"
"McIntosh","2020-05-01","3","126","0","6","0","0"
"McIntosh","2020-05-02","0","126","0","6","0","0"
"McIntosh","2020-05-03","0","126","0","6","0","0"
"McIntosh","2020-05-04","8","134","0","6","0","0"
"McIntosh","2020-05-05","47","181","1","7","0.3","0.2"
"McIntosh","2020-05-06","1","182","1","8","14.6","7.3"
"McIntosh","2020-05-07","5","187","0","8","14.6","7.3"
"McIntosh","2020-05-08","4","191","0","8","14.6","7.3"
"McIntosh","2020-05-09","5","196","0","8","14.6","7.3"
"McIntosh","2020-05-10","3","199","0","8","14.6","7.3"
"McIntosh","2020-05-11","23","222","0","8","14.6","7.3"
"McIntosh","2020-05-12","150","372","2","10","14.5","7.4"
"McIntosh","2020-05-13","2","374","0","10","0.2","7.4"
"McIntosh","2020-05-14","13","387","0","10","0.2","7.4"
"McIntosh","2020-05-15","5","392","0","10","0.2","7.4"
"McIntosh","2020-05-16","5","397","0","10","0.2","7.4"
"McIntosh","2020-05-17","1","398","0","10","0.2","7.4"
"McIntosh","2020-05-18","5","403","0","10","0.2","7.4"
"McIntosh","2020-05-19","41","444","0","10","0","7.2"
"McIntosh","2020-05-20","2","446","0","10","0","0.1"
"McIntosh","2020-05-21","2","448","0","10","0","0.1"
"McIntosh","2020-05-22","4","452","1","11","3.6","1.9"
"McIntosh","2020-05-23","1","453","0","11","3.6","1.9"
"McIntosh","2020-05-24","1","454","0","11","3.6","1.9"
"McIntosh","2020-05-25","5","459","0","11","3.6","1.9"
"McIntosh","2020-05-26","55","514","5","16","4.9","2.4"
"McIntosh","2020-05-27","4","518","0","16","4.9","2.4"
"McIntosh","2020-05-28","6","524","0","16","4.9","2.4"
"McIntosh","2020-05-29","6","530","0","16","1.3","2.4"
"McIntosh","2020-05-30","1","531","0","16","1.3","2.4"
"McIntosh","2020-05-31","1","532","0","16","1.3","2.4"
"McIntosh","2020-06-01","8","540","0","16","1.3","2.4"
"McIntosh","2020-06-02","4","544","0","16","0","2.4"
"McIntosh","2020-06-03","3","547","0","16","0","2.4"
"McIntosh","2020-06-04","9","556","0","16","0","2.4"
"McIntosh","2020-06-05","4","560","0","16","0","0.6"
"McIntosh","2020-06-06","2","562","0","16","0","0.6"
"McIntosh","2020-06-07","2","564","0","16","0","0.6"
"McIntosh","2020-06-08","16","580","1","17","0.9","1.1"
"McIntosh","2020-06-09","2","582","0","17","0.9","0.4"
"McIntosh","2020-06-10","11","593","0","17","0.9","0.4"
"McIntosh","2020-06-11","9","602","0","17","0.9","0.4"
"McIntosh","2020-06-12","7","609","0","17","0.9","0.4"
"McIntosh","2020-06-13","5","614","1","18","3.8","1.9"
"McIntosh","2020-06-14","5","619","0","18","3.8","1.9"
"McIntosh","2020-06-15","13","632","0","18","2.9","1.9"
"McIntosh","2020-06-16","2","634","0","18","2.9","1.9"
"McIntosh","2020-06-17","4","638","0","18","2.9","1.9"
"McIntosh","2020-06-18","3","641","0","18","2.9","1.9"
"McIntosh","2020-06-19","3","644","0","18","2.9","1.9"
"McIntosh","2020-06-20","0","644","0","18","0","1.9"
"McIntosh","2020-06-21","0","644","0","18","0","1.9"
"McIntosh","2020-06-22","13","657","2","20","2.2","2.5"
"McIntosh","2020-06-23","28","685","1","21","2.7","2.8"
"McIntosh","2020-06-24","19","704","2","23","4.2","3.5"
"McIntosh","2020-06-25","11","715","3","26","8.1","5.5"
"McIntosh","2020-06-26","8","723","2","28","11.7","7.3"
"McIntosh","2020-06-27","7","730","0","28","11.7","5.8"
"McIntosh","2020-06-28","2","732","1","29","18.8","9.4"
"McIntosh","2020-06-29","13","745","3","32","19.9","11.1"
"McIntosh","2020-06-30","27","772","1","33","19.9","11.3"
"McIntosh","2020-07-01","10","782","0","33","18.4","11.3"
"McIntosh","2020-07-02","8","790","2","35","18.1","13.1"
"McIntosh","2020-07-03","5","795","0","35","14.5","13.1"
"McIntosh","2020-07-04","3","798","0","35","14.5","13.1"
"McIntosh","2020-07-05","1","799","0","35","7.4","13.1"
"McIntosh","2020-07-06","6","805","1","36","6.5","13.2"
"McIntosh","2020-07-07","96","901","6","42","6.8","13.4"
"McIntosh","2020-07-08","19","920","1","43","7.6","13"
"McIntosh","2020-07-09","19","939","3","46","6.3","12.2"
"McIntosh","2020-07-10","17","956","0","46","6.3","10.4"
"McIntosh","2020-07-11","4","960","1","47","9.9","12.2"
"McIntosh","2020-07-12","4","964","2","49","17","12.2"
"McIntosh","2020-07-13","16","980","5","54","19.1","12.8"
"McIntosh","2020-07-14","84","1064","5","59","19","12.9"
"McIntosh","2020-07-15","17","1081","5","64","22.5","15"
"McIntosh","2020-07-16","69","1150","1","65","20.4","13.4"
"McIntosh","2020-07-17","13","1163","4","69","24.8","15.6"
"McIntosh","2020-07-18","10","1173","1","70","22.7","16.3"
"McIntosh","2020-07-19","11","1184","0","70","15.5","16.3"
"McIntosh","2020-07-20","20","1204","3","73","13.2","16.2"
"McIntosh","2020-07-21","70","1274","4","77","13.2","16.1"
"McIntosh","2020-07-22","22","1296","4","81","11.6","17"
"McIntosh","2020-07-23","71","1367","4","85","12.2","16.3"
"McIntosh","2020-07-24","22","1389","4","89","10.4","17.6"
"McIntosh","2020-07-25","8","1397","3","92","14.3","18.5"
"McIntosh","2020-07-26","1","1398","0","92","14.3","14.9"
"McIntosh","2020-07-27","28","1426","3","95","13.7","13.5"
"McIntosh","2020-07-28","77","1503","7","102","14.2","13.7"
"McIntosh","2020-07-29","21","1524","2","104","12.9","12.3"
"McIntosh","2020-07-30","58","1582","3","107","12.9","12.5"
"McIntosh","2020-07-31","18","1600","6","113","15","12.7"
"McIntosh","2020-08-01","12","1612","2","115","12.1","13.2"
"McIntosh","2020-08-02","10","1622","4","119","17.8","16.1"
"McIntosh","2020-08-03","23","1645","2","121","17.5","15.6"
"McIntosh","2020-08-04","85","1730","7","128","17.4","15.8"
"McIntosh","2020-08-05","17","1747","1","129","16.9","14.9"
"McIntosh","2020-08-06","72","1819","4","133","16.9","14.9"
"McIntosh","2020-08-07","23","1842","5","138","15.3","15.2"
"McIntosh","2020-08-08","11","1853","1","139","14.2","13.1"
"McIntosh","2020-08-09","11","1864","0","139","8.5","13.1"
"McIntosh","2020-08-10","22","1886","3","142","9.2","13.3"
"McIntosh","2020-08-11","79","1965","7","149","9.3","13.3"
"McIntosh","2020-08-12","25","1990","1","150","9","12.9"
"McIntosh","2020-08-13","55","2045","5","155","9.5","13.2"
"McIntosh","2020-08-14","14","2059","3","158","9.4","12.3"
"McIntosh","2020-08-15","9","2068","2","160","11.3","12.7"
"McIntosh","2020-08-16","6","2074","2","162","16.1","12.3"
"McIntosh","2020-08-17","19","2093","4","166","17.1","13.2"
"McIntosh","2020-08-18","69","2162","7","173","17.3","13.3"
"McIntosh","2020-08-19","27","2189","1","174","17.3","13.1"
"McIntosh","2020-08-20","50","2239","2","176","16.6","13"
"McIntosh","2020-08-21","15","2254","2","178","15.4","12.4"
"McIntosh","2020-08-22","7","2261","1","179","14.3","12.8"
"McIntosh","2020-08-23","10","2271","2","181","12.4","14.2"
"McIntosh","2020-08-24","18","2289","1","182","10.1","13.6"
"McIntosh","2020-08-25","43","2332","3","185","9.7","13.5"
"McIntosh","2020-08-26","26","2358","3","188","10.8","14"
"McIntosh","2020-08-27","30","2388","3","191","11.7","14.1"
"McIntosh","2020-08-28","20","2408","4","195","12.6","14"
"McIntosh","2020-08-29","15","2423","2","197","12.5","13.4"
"McIntosh","2020-08-30","6","2429","2","199","14.4","13.4"
"McIntosh","2020-08-31","9","2438","1","200","15.2","12.7"
"McIntosh","2020-09-01","53","2491","5","205","15.5","12.6"
"McIntosh","2020-09-02","24","2515","1","206","14.5","12.6"
"McIntosh","2020-09-03","37","2552","1","207","13.4","12.6"
"McIntosh","2020-09-04","12","2564","0","207","10.6","11.6"
"McIntosh","2020-09-05","7","2571","0","207","8.7","10.6"
"McIntosh","2020-09-06","6","2577","1","208","6.3","10.3"
"McIntosh","2020-09-07","13","2590","0","208","4.7","9.9"
"McIntosh","2020-09-08","44","2634","2","210","4","9.8"
"McIntosh","2020-09-09","20","2654","0","210","3.4","8.9"
"McIntosh","2020-09-10","36","2690","1","211","3.4","8.4"
"McIntosh","2020-09-11","16","2706","0","211","3.4","7"
"McIntosh","2020-09-12","10","2716","0","211","3.4","6.1"
"McIntosh","2020-09-13","9","2725","1","212","2.6","4.5"
"McIntosh","2020-09-14","26","2751","3","215","4.3","4.5"
"McIntosh","2020-09-15","26","2777","2","217","4.7","4.4"
"McIntosh","2020-09-16","14","2791","0","217","4.7","4.1"
"McIntosh","2020-09-17","41","2832","2","219","5","4.2"
"McIntosh","2020-09-18","11","2843","0","219","5","4.2"
"McIntosh","2020-09-19","11","2854","1","220","6.3","4.9"
"McIntosh","2020-09-20","3","2857","0","220","4.7","3.7"
"McIntosh","2020-09-21","10","2867","2","222","6","5.1"
"McIntosh","2020-09-22","33","2900","1","223","5.3","5"
"McIntosh","2020-09-23","12","2912","0","223","5.3","5"
"McIntosh","2020-09-24","36","2948","4","227","6.2","5.6"
"McIntosh","2020-09-25","6","2954","0","227","6.2","5.6"
"McIntosh","2020-09-26","10","2964","0","227","4.9","5.6"
"McIntosh","2020-09-27","4","2968","1","228","8.4","6.6"
"McIntosh","2020-09-28","11","2979","1","229","6.9","6.4"
"McIntosh","2020-09-29","17","2996","0","229","6.5","5.9"
"McIntosh","2020-09-30","2","2998","0","229","6.5","5.9"
"McIntosh","2020-10-01","28","3026","2","231","5.9","6"
"McIntosh","2020-10-02","6","3032","0","231","5.9","6"
"McIntosh","2020-10-03","12","3044","0","231","5.9","5.4"
"McIntosh","2020-10-04","5","3049","0","231","2.3","5.4"
"McIntosh","2020-10-05","16","3065","0","231","1","4"
"McIntosh","2020-10-06","26","3091","0","231","1","3.7"
"McIntosh","2020-10-07","14","3105","0","231","1","3.7"
"McIntosh","2020-10-08","30","3135","1","232","0.5","3.2"
"McIntosh","2020-10-09","17","3152","0","232","0.5","3.2"
"McIntosh","2020-10-10","18","3170","1","233","1.3","3.6"
"McIntosh","2020-10-11","3","3173","0","233","1.3","1.8"
"McIntosh","2020-10-12","14","3187","1","234","2.3","1.7"
"McIntosh","2020-10-13","28","3215","0","234","2.3","1.7"
"McIntosh","2020-10-14","11","3226","0","234","2.3","1.7"
"McIntosh","2020-10-15","22","3248","0","234","1.8","1.1"
"McIntosh","2020-10-16","14","3262","0","234","1.8","1.1"
"McIntosh","2020-10-17","9","3271","2","236","4.2","2.7"
"McIntosh","2020-10-18","4","3275","0","236","4.2","2.7"
"McIntosh","2020-10-19","11","3286","1","237","4.5","3.4"
"McIntosh","2020-10-20","35","3321","1","238","4.9","3.6"
"McIntosh","2020-10-21","18","3339","1","239","5.7","4"
"McIntosh","2020-10-22","11","3350","0","239","5.7","3.7"
"McIntosh","2020-10-23","16","3366","0","239","5.7","3.7"
"McIntosh","2020-10-24","9","3375","0","239","2.5","3.3"
"McIntosh","2020-10-25","11","3386","1","240","3.8","4"
"McIntosh","2020-10-26","18","3404","2","242","4.1","4.3"
"McIntosh","2020-10-27","34","3438","2","244","4.5","4.7"
"McIntosh","2020-10-28","9","3447","0","244","3.7","4.7"
"McIntosh","2020-10-29","14","3461","0","244","3.7","4.7"
"McIntosh","2020-10-30","8","3469","0","244","3.7","4.7"
"McIntosh","2020-10-31","9","3478","1","245","5.3","3.9"
"McIntosh","2020-11-01","1","3479","0","245","4","3.9"
"McIntosh","2020-11-02","10","3489","0","245","2.4","3.3"
"McIntosh","2020-11-03","31","3520","3","248","3","3.7"
"McIntosh","2020-11-04","19","3539","0","248","3","3.3"
"McIntosh","2020-11-05","20","3559","1","249","3.7","3.7"
"McIntosh","2020-11-06","12","3571","1","250","4.9","4.3"
"McIntosh","2020-11-07","11","3582","2","252","5.9","5.6"
"McIntosh","2020-11-08","7","3589","3","255","12","8"
"McIntosh","2020-11-09","20","3609","1","256","12.7","7.6"
"McIntosh","2020-11-10","9","3618","0","256","11.3","7.2"
"McIntosh","2020-11-11","15","3633","1","257","12.3","7.6"
"McIntosh","2020-11-12","18","3651","0","257","11.6","7.6"
"McIntosh","2020-11-13","12","3663","4","261","15.1","10"
"McIntosh","2020-11-14","5","3668","0","261","12.6","9.2"
"McIntosh","2020-11-15","3","3671","0","261","6.4","9.2"
"McIntosh","2020-11-16","12","3683","1","262","6.9","9.8"
"McIntosh","2020-11-17","48","3731","6","268","8.7","10"
"McIntosh","2020-11-18","25","3756","4","272","10","11.2"
"McIntosh","2020-11-19","22","3778","0","272","10","10.8"
"McIntosh","2020-11-20","15","3793","2","274","7.2","11.2"
"McIntosh","2020-11-21","2","3795","0","274","7.2","9.9"
"McIntosh","2020-11-22","4","3799","0","274","7.2","6.8"
"McIntosh","2020-11-23","15","3814","2","276","7.9","7.4"
"McIntosh","2020-11-24","17","3831","4","280","9.5","9.1"
"McIntosh","2020-11-25","14","3845","0","280","7.2","8.6"
"McIntosh","2020-11-26","8","3853","1","281","9","9.5"
"McIntosh","2020-11-27","13","3866","1","282","8.2","7.7"
"McIntosh","2020-11-28","9","3875","0","282","8.2","7.7"
"McIntosh","2020-11-29","3","3878","1","283","12.9","10"
"McIntosh","2020-11-30","11","3889","0","283","11","9.4"
"McIntosh","2020-12-01","45","3934","3","286","8.6","9"
"McIntosh","2020-12-02","25","3959","5","291","11.5","9.3"
"McIntosh","2020-12-03","13","3972","1","292","10.8","9.9"
"McIntosh","2020-12-04","13","3985","0","292","9.7","8.9"
"McIntosh","2020-12-05","4","3989","0","292","9.7","8.9"
"McIntosh","2020-12-06","9","3998","3","295","9.7","11.3"
"McIntosh","2020-12-07","22","4020","1","296","10.3","10.7"
"McIntosh","2020-12-08","56","4076","7","303","11.2","9.9"
"McIntosh","2020-12-09","17","4093","0","303","8.3","9.9"
"McIntosh","2020-12-10","6","4099","1","304","9.6","10.2"
"McIntosh","2020-12-11","14","4113","2","306","11.6","10.6"
"McIntosh","2020-12-12","13","4126","4","310","16","12.8"
"McIntosh","2020-12-13","3","4129","1","311","16","12.8"
"McIntosh","2020-12-14","16","4145","0","311","15.4","12.8"
"McIntosh","2020-12-15","43","4188","1","312","13.9","12.5"
"McIntosh","2020-12-16","10","4198","0","312","13.9","11.1"
"McIntosh","2020-12-17","22","4220","2","314","12.8","11.2"
"McIntosh","2020-12-18","14","4234","1","315","11.8","11.7"
"McIntosh","2020-12-19","22","4256","5","320","10.7","13.3"
"McIntosh","2020-12-20","6","4262","2","322","10.7","13.3"
"McIntosh","2020-12-21","27","4289","3","325","12.2","13.8"
"McIntosh","2020-12-22","69","4358","7","332","13.4","13.6"
"McIntosh","2020-12-23","26","4384","1","333","13.9","13.9"
"McIntosh","2020-12-24","10","4394","1","334","14","13.4"
"McIntosh","2020-12-25","2","4396","0","334","13","12.4"
"McIntosh","2020-12-26","11","4407","1","335","11.1","10.9"
"McIntosh","2020-12-27","7","4414","2","337","10.4","10.5"
"McIntosh","2020-12-28","23","4437","4","341","11.3","11.8"
"McIntosh","2020-12-29","88","4525","8","349","11.1","12.3"
"McIntosh","2020-12-30","31","4556","4","353","12.4","13.2"
"McIntosh","2020-12-31","11","4567","0","353","11","12.5"
"McIntosh","2021-01-01","4","4571","1","354","14.6","13.8"
"McIntosh","2021-01-02","11","4582","1","355","14.6","12.8"
"McIntosh","2021-01-03","4","4586","2","357","17.6","14"
"McIntosh","2021-01-04","17","4603","1","358","16","13.6"
"McIntosh","2021-01-05","115","4718","9","367","15.8","13.5"
"McIntosh","2021-01-06","20","4738","1","368","14.7","13.6"
"McIntosh","2021-01-07","26","4764","3","371","16.3","13.7"
"McIntosh","2021-01-08","26","4790","4","375","15","14.8"
"McIntosh","2021-01-09","10","4800","1","376","15.1","14.8"
"McIntosh","2021-01-10","3","4803","0","376","7.9","12.8"
"McIntosh","2021-01-11","23","4826","3","379","9","12.5"
"McIntosh","2021-01-12","66","4892","10","389","10","12.9"
"McIntosh","2021-01-13","15","4907","0","389","9.3","12"
"McIntosh","2021-01-14","19","4926","1","390","8.4","12.4"
"McIntosh","2021-01-15","18","4944","0","390","6.2","10.6"
"McIntosh","2021-01-16","18","4962","2","392","6.4","10.7"
"McIntosh","2021-01-17","5","4967","0","392","6.4","7.2"
"McIntosh","2021-01-18","26","4993","1","393","5.1","7"
"McIntosh","2021-01-19","46","5039","4","397","4.1","7.1"
"McIntosh","2021-01-20","17","5056","2","399","5.8","7.6"
"McIntosh","2021-01-21","33","5089","1","400","5.5","6.9"
"McIntosh","2021-01-22","22","5111","3","403","7.4","6.8"
"McIntosh","2021-01-23","15","5126","0","403","5.9","6.1"
"McIntosh","2021-01-24","5","5131","2","405","11.6","9"
"McIntosh","2021-01-25","16","5147","0","405","11","8"
"McIntosh","2021-01-26","1","5148","0","405","9.8","7"
"McIntosh","2021-01-27","0","5148","0","405","8.1","7"
"Meriwether","2020-02-01","0","0","0","0",".","."
"Meriwether","2020-02-02","0","0","0","0",".","."
"Meriwether","2020-02-03","0","0","0","0",".","."
"Meriwether","2020-02-04","0","0","0","0",".","."
"Meriwether","2020-02-05","0","0","0","0",".","."
"Meriwether","2020-02-06","0","0","0","0",".","."
"Meriwether","2020-02-07","0","0","0","0","0","."
"Meriwether","2020-02-08","0","0","0","0","0","."
"Meriwether","2020-02-09","0","0","0","0","0","."
"Meriwether","2020-02-10","0","0","0","0","0","."
"Meriwether","2020-02-11","0","0","0","0","0","."
"Meriwether","2020-02-12","0","0","0","0","0","."
"Meriwether","2020-02-13","0","0","0","0","0","."
"Meriwether","2020-02-14","0","0","0","0","0","0"
"Meriwether","2020-02-15","0","0","0","0","0","0"
"Meriwether","2020-02-16","0","0","0","0","0","0"
"Meriwether","2020-02-17","0","0","0","0","0","0"
"Meriwether","2020-02-18","0","0","0","0","0","0"
"Meriwether","2020-02-19","0","0","0","0","0","0"
"Meriwether","2020-02-20","0","0","0","0","0","0"
"Meriwether","2020-02-21","0","0","0","0","0","0"
"Meriwether","2020-02-22","0","0","0","0","0","0"
"Meriwether","2020-02-23","0","0","0","0","0","0"
"Meriwether","2020-02-24","0","0","0","0","0","0"
"Meriwether","2020-02-25","0","0","0","0","0","0"
"Meriwether","2020-02-26","0","0","0","0","0","0"
"Meriwether","2020-02-27","0","0","0","0","0","0"
"Meriwether","2020-02-28","0","0","0","0","0","0"
"Meriwether","2020-02-29","0","0","0","0","0","0"
"Meriwether","2020-03-01","0","0","0","0","0","0"
"Meriwether","2020-03-02","0","0","0","0","0","0"
"Meriwether","2020-03-03","0","0","0","0","0","0"
"Meriwether","2020-03-04","0","0","0","0","0","0"
"Meriwether","2020-03-05","0","0","0","0","0","0"
"Meriwether","2020-03-06","0","0","0","0","0","0"
"Meriwether","2020-03-07","0","0","0","0","0","0"
"Meriwether","2020-03-08","0","0","0","0","0","0"
"Meriwether","2020-03-09","0","0","0","0","0","0"
"Meriwether","2020-03-10","0","0","0","0","0","0"
"Meriwether","2020-03-11","0","0","0","0","0","0"
"Meriwether","2020-03-12","0","0","0","0","0","0"
"Meriwether","2020-03-13","0","0","0","0","0","0"
"Meriwether","2020-03-14","2","2","1","1","7.1","3.6"
"Meriwether","2020-03-15","0","2","0","1","7.1","3.6"
"Meriwether","2020-03-16","2","4","0","1","7.1","3.6"
"Meriwether","2020-03-17","2","6","0","1","7.1","3.6"
"Meriwether","2020-03-18","0","6","0","1","7.1","3.6"
"Meriwether","2020-03-19","5","11","3","4","15.7","7.9"
"Meriwether","2020-03-20","4","15","1","5","19.3","9.6"
"Meriwether","2020-03-21","2","17","0","5","12.1","9.6"
"Meriwether","2020-03-22","3","20","1","6","16.9","12"
"Meriwether","2020-03-23","3","23","0","6","16.9","12"
"Meriwether","2020-03-24","5","28","1","7","19.8","13.5"
"Meriwether","2020-03-25","6","34","0","7","19.8","13.5"
"Meriwether","2020-03-26","4","38","2","9","18.3","17"
"Meriwether","2020-03-27","11","49","1","10","16.1","17.7"
"Meriwether","2020-03-28","5","54","1","11","18.9","15.5"
"Meriwether","2020-03-29","1","55","0","11","14.2","15.5"
"Meriwether","2020-03-30","13","68","4","15","18.6","17.7"
"Meriwether","2020-03-31","8","76","1","16","17.5","18.6"
"Meriwether","2020-04-01","4","80","0","16","17.5","18.6"
"Meriwether","2020-04-02","4","84","2","18","17.5","17.9"
"Meriwether","2020-04-03","4","88","0","18","16.2","16.1"
"Meriwether","2020-04-04","2","90","0","18","13.3","16.1"
"Meriwether","2020-04-05","0","90","0","18","13.3","13.7"
"Meriwether","2020-04-06","3","93","0","18","8.9","13.7"
"Meriwether","2020-04-07","7","100","1","19","9.2","13.3"
"Meriwether","2020-04-08","6","106","0","19","9.2","13.3"
"Meriwether","2020-04-09","5","111","1","20","4.9","11.2"
"Meriwether","2020-04-10","8","119","1","21","6.7","11.4"
"Meriwether","2020-04-11","2","121","0","21","6.7","10"
"Meriwether","2020-04-12","3","124","0","21","6.7","10"
"Meriwether","2020-04-13","10","134","3","24","11","9.9"
"Meriwether","2020-04-14","13","147","1","25","10","9.6"
"Meriwether","2020-04-15","14","161","2","27","12.1","10.6"
"Meriwether","2020-04-16","8","169","3","30","14.6","9.7"
"Meriwether","2020-04-17","11","180","0","30","12.8","9.7"
"Meriwether","2020-04-18","5","185","0","30","12.8","9.7"
"Meriwether","2020-04-19","2","187","0","30","12.8","9.7"
"Meriwether","2020-04-20","20","207","2","32","9.9","10.4"
"Meriwether","2020-04-21","15","222","3","35","11.7","10.9"
"Meriwether","2020-04-22","14","236","1","36","10.7","11.4"
"Meriwether","2020-04-23","12","248","1","37","6.5","10.5"
"Meriwether","2020-04-24","17","265","0","37","6.5","9.6"
"Meriwether","2020-04-25","5","270","0","37","6.5","9.6"
"Meriwether","2020-04-26","4","274","0","37","6.5","9.6"
"Meriwether","2020-04-27","9","283","0","37","5.1","7.5"
"Meriwether","2020-04-28","10","293","0","37","2.2","6.9"
"Meriwether","2020-04-29","12","305","0","37","1.2","5.9"
"Meriwether","2020-04-30","17","322","1","38","0.8","3.7"
"Meriwether","2020-05-01","11","333","1","39","2.1","4.3"
"Meriwether","2020-05-02","4","337","0","39","2.1","4.3"
"Meriwether","2020-05-03","5","342","0","39","2.1","4.3"
"Meriwether","2020-05-04","9","351","0","39","2.1","3.6"
"Meriwether","2020-05-05","10","361","2","41","5","3.6"
"Meriwether","2020-05-06","10","371","1","42","6.4","3.8"
"Meriwether","2020-05-07","14","385","1","43","6.6","3.7"
"Meriwether","2020-05-08","7","392","0","43","5.3","3.7"
"Meriwether","2020-05-09","6","398","1","44","7.7","4.9"
"Meriwether","2020-05-10","7","405","0","44","7.7","4.9"
"Meriwether","2020-05-11","18","423","2","46","9.3","5.7"
"Meriwether","2020-05-12","17","440","0","46","6.4","5.7"
"Meriwether","2020-05-13","12","452","0","46","5","5.7"
"Meriwether","2020-05-14","128","580","0","46","4","5.3"
"Meriwether","2020-05-15","179","759","3","49","4.2","4.8"
"Meriwether","2020-05-16","6","765","0","49","1.8","4.8"
"Meriwether","2020-05-17","5","770","0","49","1.8","4.8"
"Meriwether","2020-05-18","21","791","0","49","0.2","4.8"
"Meriwether","2020-05-19","27","818","1","50","0.8","3.6"
"Meriwether","2020-05-20","32","850","2","52","1.7","3.3"
"Meriwether","2020-05-21","12","862","0","52","1.7","2.8"
"Meriwether","2020-05-22","13","875","0","52","1.4","2.8"
"Meriwether","2020-05-23","6","881","1","53","3.8","2.8"
"Meriwether","2020-05-24","8","889","1","54","5.6","3.7"
"Meriwether","2020-05-25","7","896","1","55","7.6","3.9"
"Meriwether","2020-05-26","18","914","2","57","8.7","4.7"
"Meriwether","2020-05-27","25","939","3","60","9.5","5.6"
"Meriwether","2020-05-28","17","956","0","60","9.5","5.6"
"Meriwether","2020-05-29","8","964","1","61","11.3","6.4"
"Meriwether","2020-05-30","7","971","1","62","11","7.4"
"Meriwether","2020-05-31","10","981","0","62","9.2","7.4"
"Meriwether","2020-06-01","19","1000","3","65","9.4","8.5"
"Meriwether","2020-06-02","20","1020","2","67","9.2","9"
"Meriwether","2020-06-03","18","1038","1","68","8.3","8.9"
"Meriwether","2020-06-04","24","1062","2","70","9.5","9.5"
"Meriwether","2020-06-05","14","1076","2","72","9.7","10.5"
"Meriwether","2020-06-06","15","1091","1","73","8.7","9.8"
"Meriwether","2020-06-07","1","1092","0","73","8.7","8.9"
"Meriwether","2020-06-08","28","1120","0","73","6.4","7.9"
"Meriwether","2020-06-09","14","1134","2","75","7","8.1"
"Meriwether","2020-06-10","30","1164","2","77","7.2","7.7"
"Meriwether","2020-06-11","30","1194","1","78","6.5","8"
"Meriwether","2020-06-12","19","1213","3","81","6.7","8.2"
"Meriwether","2020-06-13","10","1223","2","83","8.6","8.6"
"Meriwether","2020-06-14","6","1229","0","83","8.6","8.6"
"Meriwether","2020-06-15","24","1253","6","89","12.2","9.3"
"Meriwether","2020-06-16","30","1283","5","94","12.5","9.8"
"Meriwether","2020-06-17","39","1322","4","98","13","10.1"
"Meriwether","2020-06-18","30","1352","4","102","14.4","10.4"
"Meriwether","2020-06-19","22","1374","2","104","13.5","10.1"
"Meriwether","2020-06-20","12","1386","0","104","10.6","9.6"
"Meriwether","2020-06-21","8","1394","1","105","12.4","10.5"
"Meriwether","2020-06-22","38","1432","4","109","10.3","11.2"
"Meriwether","2020-06-23","22","1454","4","113","10.6","11.5"
"Meriwether","2020-06-24","46","1500","4","117","10.3","11.7"
"Meriwether","2020-06-25","31","1531","4","121","10.3","12.4"
"Meriwether","2020-06-26","25","1556","3","124","10.7","12.1"
"Meriwether","2020-06-27","11","1567","2","126","13.3","12"
"Meriwether","2020-06-28","9","1576","1","127","13.1","12.7"
"Meriwether","2020-06-29","34","1610","4","131","13.3","11.8"
"Meriwether","2020-06-30","46","1656","8","139","13.1","11.9"
"Meriwether","2020-07-01","47","1703","12","151","15.6","12.9"
"Meriwether","2020-07-02","31","1734","8","159","17.4","13.8"
"Meriwether","2020-07-03","16","1750","1","160","16.6","13.6"
"Meriwether","2020-07-04","14","1764","1","161","15","14.1"
"Meriwether","2020-07-05","14","1778","1","162","14.4","13.8"
"Meriwether","2020-07-06","26","1804","3","165","14.4","13.8"
"Meriwether","2020-07-07","32","1836","2","167","12.8","13"
"Meriwether","2020-07-08","43","1879","5","172","10.8","13.2"
"Meriwether","2020-07-09","34","1913","5","177","9.2","13.3"
"Meriwether","2020-07-10","38","1951","10","187","12.1","14.3"
"Meriwether","2020-07-11","17","1968","8","195","17.8","16.4"
"Meriwether","2020-07-12","17","1985","3","198","19.3","16.9"
"Meriwether","2020-07-13","36","2021","14","212","23.2","18.8"
"Meriwether","2020-07-14","28","2049","5","217","24.9","18.8"
"Meriwether","2020-07-15","32","2081","4","221","25","17.9"
"Meriwether","2020-07-16","26","2107","1","222","23.4","16.3"
"Meriwether","2020-07-17","20","2127","3","225","21.8","17"
"Meriwether","2020-07-18","16","2143","5","230","19.6","18.7"
"Meriwether","2020-07-19","11","2154","2","232","19.6","19.5"
"Meriwether","2020-07-20","39","2193","5","237","15.9","19.6"
"Meriwether","2020-07-21","19","2212","4","241","16.4","20.6"
"Meriwether","2020-07-22","17","2229","2","243","16.3","20.6"
"Meriwether","2020-07-23","29","2258","6","249","18.7","21.1"
"Meriwether","2020-07-24","26","2284","2","251","17.6","19.7"
"Meriwether","2020-07-25","18","2302","2","253","14.8","17.2"
"Meriwether","2020-07-26","19","2321","0","253","12.2","15.9"
"Meriwether","2020-07-27","143","2464","5","258","10.8","13.4"
"Meriwether","2020-07-28","23","2487","0","258","7.8","12.1"
"Meriwether","2020-07-29","36","2523","2","260","6.9","11.6"
"Meriwether","2020-07-30","22","2545","0","260","4","11.3"
"Meriwether","2020-07-31","35","2580","0","260","2.9","10.3"
"Meriwether","2020-08-01","13","2593","0","260","1.3","8"
"Meriwether","2020-08-02","7","2600","1","261","3.3","7.7"
"Meriwether","2020-08-03","32","2632","5","266","5.1","7.9"
"Meriwether","2020-08-04","27","2659","3","269","6.7","7.2"
"Meriwether","2020-08-05","31","2690","5","274","8.2","7.5"
"Meriwether","2020-08-06","19","2709","3","277","10.4","7.2"
"Meriwether","2020-08-07","18","2727","2","279","12","7.4"
"Meriwether","2020-08-08","9","2736","1","280","13.6","7.4"
"Meriwether","2020-08-09","9","2745","1","281","13.1","8.2"
"Meriwether","2020-08-10","103","2848","5","286","11.6","8.3"
"Meriwether","2020-08-11","29","2877","3","289","11.5","9.1"
"Meriwether","2020-08-12","26","2903","5","294","11.9","10.1"
"Meriwether","2020-08-13","28","2931","5","299","12.2","11.3"
"Meriwether","2020-08-14","41","2972","9","308","13.8","12.9"
"Meriwether","2020-08-15","12","2984","1","309","13.4","13.5"
"Meriwether","2020-08-16","16","3000","1","310","12.7","12.9"
"Meriwether","2020-08-17","52","3052","3","313","12.8","12.2"
"Meriwether","2020-08-18","34","3086","5","318","13.4","12.5"
"Meriwether","2020-08-19","28","3114","1","319","11.2","11.6"
"Meriwether","2020-08-20","34","3148","7","326","11.6","11.9"
"Meriwether","2020-08-21","32","3180","8","334","12","12.9"
"Meriwether","2020-08-22","12","3192","2","336","13.2","13.3"
"Meriwether","2020-08-23","15","3207","1","337","13.3","13"
"Meriwether","2020-08-24","95","3302","4","341","13.1","12.9"
"Meriwether","2020-08-25","57","3359","3","344","11.7","12.6"
"Meriwether","2020-08-26","29","3388","4","348","13.2","12.2"
"Meriwether","2020-08-27","24","3412","2","350","11.4","11.5"
"Meriwether","2020-08-28","25","3437","3","353","9.6","10.8"
"Meriwether","2020-08-29","10","3447","1","354","8.6","10.9"
"Meriwether","2020-08-30","10","3457","4","358","13.4","13.3"
"Meriwether","2020-08-31","33","3490","5","363","14.9","14"
"Meriwether","2020-09-01","32","3522","4","367","16","13.8"
"Meriwether","2020-09-02","18","3540","1","368","14.8","14"
"Meriwether","2020-09-03","15","3555","2","370","15.5","13.5"
"Meriwether","2020-09-04","20","3575","1","371","14.5","12"
"Meriwether","2020-09-05","12","3587","2","373","15.5","12"
"Meriwether","2020-09-06","15","3602","0","373","9.7","11.6"
"Meriwether","2020-09-07","11","3613","0","373","7.6","11.3"
"Meriwether","2020-09-08","34","3647","3","376","7.1","11.5"
"Meriwether","2020-09-09","20","3667","3","379","8.4","11.6"
"Meriwether","2020-09-10","23","3690","4","383","9","12.2"
"Meriwether","2020-09-11","31","3721","2","385","9.2","11.8"
"Meriwether","2020-09-12","5","3726","0","385","6.8","11.1"
"Meriwether","2020-09-13","6","3732","2","387","11.6","10.7"
"Meriwether","2020-09-14","21","3753","1","388","12.3","9.9"
"Meriwether","2020-09-15","36","3789","0","388","11","9"
"Meriwether","2020-09-16","25","3814","2","390","10","9.2"
"Meriwether","2020-09-17","19","3833","3","393","9.8","9.4"
"Meriwether","2020-09-18","37","3870","1","394","9.2","9.2"
"Meriwether","2020-09-19","10","3880","1","395","10.7","8.7"
"Meriwether","2020-09-20","7","3887","0","395","5.9","8.7"
"Meriwether","2020-09-21","24","3911","1","396","5.8","9"
"Meriwether","2020-09-22","21","3932","0","396","5.8","8.4"
"Meriwether","2020-09-23","15","3947","2","398","6.6","8.3"
"Meriwether","2020-09-24","19","3966","1","399","5.1","7.4"
"Meriwether","2020-09-25","27","3993","0","399","4.7","7"
"Meriwether","2020-09-26","23","4016","0","399","3.3","7"
"Meriwether","2020-09-27","6","4022","0","399","3.3","4.6"
"Meriwether","2020-09-28","21","4043","1","400","3.3","4.6"
"Meriwether","2020-09-29","24","4067","0","400","3.3","4.6"
"Meriwether","2020-09-30","29","4096","1","401","1.9","4.2"
"Meriwether","2020-10-01","25","4121","1","402","1.7","3.4"
"Meriwether","2020-10-02","41","4162","0","402","1.7","3.2"
"Meriwether","2020-10-03","7","4169","0","402","1.7","2.5"
"Meriwether","2020-10-04","8","4177","0","402","1.7","2.5"
"Meriwether","2020-10-05","26","4203","0","402","1.1","2.2"
"Meriwether","2020-10-06","46","4249","0","402","1.1","2.2"
"Meriwether","2020-10-07","31","4280","1","403","1","1.5"
"Meriwether","2020-10-08","37","4317","0","403","0.5","1.1"
"Meriwether","2020-10-09","22","4339","1","404","1.1","1.4"
"Meriwether","2020-10-10","17","4356","1","405","2","1.8"
"Meriwether","2020-10-11","11","4367","0","405","2","1.8"
"Meriwether","2020-10-12","32","4399","1","406","2.4","1.7"
"Meriwether","2020-10-13","43","4442","1","407","2.7","1.9"
"Meriwether","2020-10-14","21","4463","1","408","2.9","2"
"Meriwether","2020-10-15","48","4511","0","408","2.9","1.7"
"Meriwether","2020-10-16","30","4541","1","409","2.8","1.9"
"Meriwether","2020-10-17","14","4555","2","411","4","3"
"Meriwether","2020-10-18","7","4562","0","411","4","3"
"Meriwether","2020-10-19","33","4595","4","415","5.3","3.8"
"Meriwether","2020-10-20","16","4611","3","418","7.6","5.2"
"Meriwether","2020-10-21","87","4698","2","420","7.3","5.1"
"Meriwether","2020-10-22","66","4764","3","423","7.9","5.4"
"Meriwether","2020-10-23","42","4806","2","425","8.1","5.4"
"Meriwether","2020-10-24","17","4823","2","427","7.7","5.9"
"Meriwether","2020-10-25","9","4832","1","428","9.3","6.7"
"Meriwether","2020-10-26","25","4857","3","431","9.3","7.3"
"Meriwether","2020-10-27","39","4896","0","431","6.6","7.1"
"Meriwether","2020-10-28","58","4954","3","434","7.1","7.2"
"Meriwether","2020-10-29","66","5020","1","435","6.6","7.3"
"Meriwether","2020-10-30","39","5059","1","436","6.3","7.2"
"Meriwether","2020-10-31","38","5097","0","436","4.6","6.2"
"Meriwether","2020-11-01","4","5101","0","436","3","6.2"
"Meriwether","2020-11-02","26","5127","2","438","2.4","5.9"
"Meriwether","2020-11-03","33","5160","1","439","2.9","4.7"
"Meriwether","2020-11-04","24","5184","2","441","3.3","5.2"
"Meriwether","2020-11-05","27","5211","3","444","4.7","5.6"
"Meriwether","2020-11-06","63","5274","3","447","5","5.6"
"Meriwether","2020-11-07","21","5295","3","450","7","5.8"
"Meriwether","2020-11-08","6","5301","0","450","7","5"
"Meriwether","2020-11-09","23","5324","1","451","6.6","4.5"
"Meriwether","2020-11-10","27","5351","0","451","6.1","4.5"
"Meriwether","2020-11-11","43","5394","0","451","4.9","4.1"
"Meriwether","2020-11-12","33","5427","2","453","4.2","4.4"
"Meriwether","2020-11-13","52","5479","2","455","4.1","4.5"
"Meriwether","2020-11-14","24","5503","2","457","3.2","5.1"
"Meriwether","2020-11-15","15","5518","0","457","3.2","5.1"
"Meriwether","2020-11-16","33","5551","0","457","2.6","4.6"
"Meriwether","2020-11-17","23","5574","0","457","2.6","4.4"
"Meriwether","2020-11-18","25","5599","2","459","3.7","4.3"
"Meriwether","2020-11-19","37","5636","1","460","3.3","3.7"
"Meriwether","2020-11-20","23","5659","1","461","3.3","3.7"
"Meriwether","2020-11-21","35","5694","0","461","2.2","2.7"
"Meriwether","2020-11-22","9","5703","1","462","3.7","3.5"
"Meriwether","2020-11-23","44","5747","3","465","4.7","3.7"
"Meriwether","2020-11-24","51","5798","1","466","5","3.8"
"Meriwether","2020-11-25","29","5827","2","468","4.8","4.3"
"Meriwether","2020-11-26","4","5831","1","469","8","5.6"
"Meriwether","2020-11-27","20","5851","0","469","7.4","5.4"
"Meriwether","2020-11-28","11","5862","0","469","7.4","4.8"
"Meriwether","2020-11-29","8","5870","2","471","9.4","6.6"
"Meriwether","2020-11-30","27","5897","5","476","11.1","7.9"
"Meriwether","2020-12-01","22","5919","2","478","12.1","8.5"
"Meriwether","2020-12-02","37","5956","4","482","12.6","8.7"
"Meriwether","2020-12-03","28","5984","6","488","12.1","10.1"
"Meriwether","2020-12-04","28","6012","2","490","13.1","10.3"
"Meriwether","2020-12-05","13","6025","0","490","13.1","10.3"
"Meriwether","2020-12-06","5","6030","1","491","12.4","10.9"
"Meriwether","2020-12-07","44","6074","4","495","11.1","11.1"
"Meriwether","2020-12-08","48","6122","6","501","11.6","11.8"
"Meriwether","2020-12-09","79","6201","7","508","11.3","12"
"Meriwether","2020-12-10","45","6246","5","513","9.8","11"
"Meriwether","2020-12-11","32","6278","5","518","11","12.1"
"Meriwether","2020-12-12","114","6392","1","519","11.2","12.1"
"Meriwether","2020-12-13","19","6411","1","520","9","10.7"
"Meriwether","2020-12-14","52","6463","15","535","11.9","11.5"
"Meriwether","2020-12-15","69","6532","9","544","11.9","11.8"
"Meriwether","2020-12-16","49","6581","12","556","14.2","12.7"
"Meriwether","2020-12-17","60","6641","9","565","14.7","12.3"
"Meriwether","2020-12-18","39","6680","2","567","13.2","12.1"
"Meriwether","2020-12-19","17","6697","4","571","16.5","13.8"
"Meriwether","2020-12-20","47","6744","5","576","17.2","13.1"
"Meriwether","2020-12-21","40","6784","7","583","15.6","13.7"
"Meriwether","2020-12-22","85","6869","19","602","16.9","14.4"
"Meriwether","2020-12-23","49","6918","7","609","15.5","14.8"
"Meriwether","2020-12-24","31","6949","7","616","16.6","15.7"
"Meriwether","2020-12-25","7","6956","3","619","22","17.6"
"Meriwether","2020-12-26","32","6988","8","627","22.2","19.3"
"Meriwether","2020-12-27","19","7007","5","632","24.4","20.8"
"Meriwether","2020-12-28","65","7072","13","645","24.8","20.2"
"Meriwether","2020-12-29","60","7132","27","672","28","22.5"
"Meriwether","2020-12-30","80","7212","15","687","28.6","22.1"
"Meriwether","2020-12-31","80","7292","20","707","29","22.8"
"Meriwether","2021-01-01","9","7301","2","709","26","24"
"Meriwether","2021-01-02","23","7324","6","715","26.2","24.2"
"Meriwether","2021-01-03","19","7343","5","720","26.2","25.3"
"Meriwether","2021-01-04","57","7400","10","730","25.8","25.3"
"Meriwether","2021-01-05","160","7560","28","758","21.9","25"
"Meriwether","2021-01-06","125","7685","32","790","22.9","25.8"
"Meriwether","2021-01-07","62","7747","14","804","22.5","25.8"
"Meriwether","2021-01-08","86","7833","11","815","21.2","23.6"
"Meriwether","2021-01-09","49","7882","9","824","20.1","23.1"
"Meriwether","2021-01-10","21","7903","4","828","19.1","22.6"
"Meriwether","2021-01-11","59","7962","14","842","19.9","22.9"
"Meriwether","2021-01-12","80","8042","14","856","19.9","20.9"
"Meriwether","2021-01-13","59","8101","8","864","18.2","20.6"
"Meriwether","2021-01-14","113","8214","12","876","16.5","19.5"
"Meriwether","2021-01-15","60","8274","16","892","18.5","19.9"
"Meriwether","2021-01-16","32","8306","10","902","20.3","20.2"
"Meriwether","2021-01-17","28","8334","13","915","24.3","21.7"
"Meriwether","2021-01-18","41","8375","5","920","22.6","21.3"
"Meriwether","2021-01-19","79","8454","17","937","23.2","21.6"
"Meriwether","2021-01-20","81","8535","14","951","23.7","21"
"Meriwether","2021-01-21","124","8659","22","973","24.7","20.6"
"Meriwether","2021-01-22","104","8763","17","990","23.3","20.9"
"Meriwether","2021-01-23","53","8816","7","997","20.7","20.5"
"Meriwether","2021-01-24","7","8823","3","1000","20.2","22.2"
"Meriwether","2021-01-25","12","8835","2","1002","20.8","21.7"
"Meriwether","2021-01-26","1","8836","0","1002","17.7","20.5"
"Meriwether","2021-01-27","0","8836","0","1002","15.3","19.5"
"Miller","2020-02-01","0","0","0","0",".","."
"Miller","2020-02-02","0","0","0","0",".","."
"Miller","2020-02-03","0","0","0","0",".","."
"Miller","2020-02-04","0","0","0","0",".","."
"Miller","2020-02-05","0","0","0","0",".","."
"Miller","2020-02-06","0","0","0","0",".","."
"Miller","2020-02-07","0","0","0","0","0","."
"Miller","2020-02-08","0","0","0","0","0","."
"Miller","2020-02-09","0","0","0","0","0","."
"Miller","2020-02-10","0","0","0","0","0","."
"Miller","2020-02-11","0","0","0","0","0","."
"Miller","2020-02-12","0","0","0","0","0","."
"Miller","2020-02-13","0","0","0","0","0","."
"Miller","2020-02-14","0","0","0","0","0","0"
"Miller","2020-02-15","0","0","0","0","0","0"
"Miller","2020-02-16","0","0","0","0","0","0"
"Miller","2020-02-17","0","0","0","0","0","0"
"Miller","2020-02-18","0","0","0","0","0","0"
"Miller","2020-02-19","0","0","0","0","0","0"
"Miller","2020-02-20","0","0","0","0","0","0"
"Miller","2020-02-21","0","0","0","0","0","0"
"Miller","2020-02-22","0","0","0","0","0","0"
"Miller","2020-02-23","0","0","0","0","0","0"
"Miller","2020-02-24","0","0","0","0","0","0"
"Miller","2020-02-25","0","0","0","0","0","0"
"Miller","2020-02-26","0","0","0","0","0","0"
"Miller","2020-02-27","0","0","0","0","0","0"
"Miller","2020-02-28","0","0","0","0","0","0"
"Miller","2020-02-29","0","0","0","0","0","0"
"Miller","2020-03-01","0","0","0","0","0","0"
"Miller","2020-03-02","0","0","0","0","0","0"
"Miller","2020-03-03","0","0","0","0","0","0"
"Miller","2020-03-04","0","0","0","0","0","0"
"Miller","2020-03-05","0","0","0","0","0","0"
"Miller","2020-03-06","0","0","0","0","0","0"
"Miller","2020-03-07","0","0","0","0","0","0"
"Miller","2020-03-08","0","0","0","0","0","0"
"Miller","2020-03-09","0","0","0","0","0","0"
"Miller","2020-03-10","0","0","0","0","0","0"
"Miller","2020-03-11","1","1","1","1","14.3","7.1"
"Miller","2020-03-12","2","3","0","1","14.3","7.1"
"Miller","2020-03-13","0","3","0","1","14.3","7.1"
"Miller","2020-03-14","1","4","0","1","14.3","7.1"
"Miller","2020-03-15","0","4","0","1","14.3","7.1"
"Miller","2020-03-16","2","6","0","1","14.3","7.1"
"Miller","2020-03-17","2","8","0","1","14.3","7.1"
"Miller","2020-03-18","3","11","0","1","0","7.1"
"Miller","2020-03-19","0","11","0","1","0","7.1"
"Miller","2020-03-20","1","12","0","1","0","7.1"
"Miller","2020-03-21","1","13","0","1","0","7.1"
"Miller","2020-03-22","0","13","0","1","0","7.1"
"Miller","2020-03-23","2","15","0","1","0","7.1"
"Miller","2020-03-24","1","16","0","1","0","7.1"
"Miller","2020-03-25","0","16","0","1","0","0"
"Miller","2020-03-26","1","17","0","1","0","0"
"Miller","2020-03-27","1","18","0","1","0","0"
"Miller","2020-03-28","0","18","0","1","0","0"
"Miller","2020-03-29","0","18","0","1","0","0"
"Miller","2020-03-30","2","20","1","2","7.1","3.6"
"Miller","2020-03-31","0","20","0","2","7.1","3.6"
"Miller","2020-04-01","1","21","1","3","21.4","10.7"
"Miller","2020-04-02","13","34","3","6","24.7","12.4"
"Miller","2020-04-03","26","60","0","6","24.7","12.4"
"Miller","2020-04-04","15","75","0","6","24.7","12.4"
"Miller","2020-04-05","0","75","0","6","24.7","12.4"
"Miller","2020-04-06","8","83","3","9","22.9","15"
"Miller","2020-04-07","12","95","1","10","24.1","15.6"
"Miller","2020-04-08","18","113","0","10","9.8","15.6"
"Miller","2020-04-09","10","123","1","11","8","16.4"
"Miller","2020-04-10","20","143","0","11","8","16.4"
"Miller","2020-04-11","8","151","0","11","8","16.4"
"Miller","2020-04-12","0","151","0","11","8","16.4"
"Miller","2020-04-13","10","161","1","12","4","13.5"
"Miller","2020-04-14","30","191","7","19","6.2","15.2"
"Miller","2020-04-15","18","209","1","20","7","8.4"
"Miller","2020-04-16","36","245","4","24","7.1","7.6"
"Miller","2020-04-17","38","283","1","25","7.5","7.7"
"Miller","2020-04-18","11","294","0","25","7.5","7.7"
"Miller","2020-04-19","0","294","0","25","7.5","7.7"
"Miller","2020-04-20","4","298","1","26","9.7","6.9"
"Miller","2020-04-21","6","304","2","28","11.1","8.6"
"Miller","2020-04-22","27","331","1","29","10.8","8.9"
"Miller","2020-04-23","12","343","0","29","9.2","8.2"
"Miller","2020-04-24","22","365","1","30","9.5","8.5"
"Miller","2020-04-25","21","386","0","30","9.5","8.5"
"Miller","2020-04-26","0","386","0","30","9.5","8.5"
"Miller","2020-04-27","6","392","0","30","5.9","7.8"
"Miller","2020-04-28","12","404","0","30","1.2","6.1"
"Miller","2020-04-29","14","418","0","30","0.6","5.7"
"Miller","2020-04-30","5","423","1","31","3.5","6.4"
"Miller","2020-05-01","17","440","1","32","3.7","6.6"
"Miller","2020-05-02","18","458","0","32","3.7","6.6"
"Miller","2020-05-03","3","461","0","32","3.7","6.6"
"Miller","2020-05-04","11","472","0","32","3.7","4.8"
"Miller","2020-05-05","27","499","1","33","4.2","2.7"
"Miller","2020-05-06","20","519","0","33","4.2","2.4"
"Miller","2020-05-07","42","561","0","33","1.4","2.4"
"Miller","2020-05-08","19","580","0","33","0.5","2.1"
"Miller","2020-05-09","14","594","0","33","0.5","2.1"
"Miller","2020-05-10","0","594","0","33","0.5","2.1"
"Miller","2020-05-11","4","598","0","33","0.5","2.1"
"Miller","2020-05-12","18","616","1","34","0.8","2.5"
"Miller","2020-05-13","23","639","0","34","0.8","2.5"
"Miller","2020-05-14","18","657","0","34","0.8","1.1"
"Miller","2020-05-15","23","680","0","34","0.8","0.7"
"Miller","2020-05-16","10","690","0","34","0.8","0.7"
"Miller","2020-05-17","0","690","0","34","0.8","0.7"
"Miller","2020-05-18","7","697","0","34","0.8","0.7"
"Miller","2020-05-19","40","737","0","34","0","0.4"
"Miller","2020-05-20","83","820","1","35","0.2","0.5"
"Miller","2020-05-21","26","846","1","36","0.7","0.8"
"Miller","2020-05-22","27","873","1","37","1.3","1"
"Miller","2020-05-23","2","875","0","37","1.3","1"
"Miller","2020-05-24","0","875","0","37","1.3","1"
"Miller","2020-05-25","2","877","0","37","1.3","1"
"Miller","2020-05-26","33","910","1","38","1.7","0.8"
"Miller","2020-05-27","19","929","0","38","1.5","0.8"
"Miller","2020-05-28","49","978","0","38","1","0.8"
"Miller","2020-05-29","43","1021","1","39","0.8","1"
"Miller","2020-05-30","8","1029","0","39","0.8","1"
"Miller","2020-05-31","1","1030","0","39","0.8","1"
"Miller","2020-06-01","6","1036","0","39","0.8","1"
"Miller","2020-06-02","26","1062","0","39","0.3","1"
"Miller","2020-06-03","37","1099","1","40","0.7","1.1"
"Miller","2020-06-04","18","1117","1","41","1.5","1.2"
"Miller","2020-06-05","28","1145","0","41","1.2","1"
"Miller","2020-06-06","15","1160","0","41","1.2","1"
"Miller","2020-06-07","0","1160","0","41","1.2","1"
"Miller","2020-06-08","16","1176","0","41","1.2","1"
"Miller","2020-06-09","16","1192","3","44","3.9","2.1"
"Miller","2020-06-10","17","1209","0","44","3.5","2.1"
"Miller","2020-06-11","11","1220","0","44","2.7","2.1"
"Miller","2020-06-12","18","1238","0","44","2.7","1.9"
"Miller","2020-06-13","0","1238","0","44","2.7","1.9"
"Miller","2020-06-14","4","1242","0","44","2.7","1.9"
"Miller","2020-06-15","9","1251","0","44","2.7","1.9"
"Miller","2020-06-16","13","1264","0","44","0","1.9"
"Miller","2020-06-17","26","1290","1","45","0.5","2"
"Miller","2020-06-18","28","1318","0","45","0.5","1.6"
"Miller","2020-06-19","19","1337","0","45","0.5","1.6"
"Miller","2020-06-20","6","1343","0","45","0.5","1.6"
"Miller","2020-06-21","1","1344","0","45","0.5","1.6"
"Miller","2020-06-22","7","1351","0","45","0.5","1.6"
"Miller","2020-06-23","19","1370","2","47","2.1","1"
"Miller","2020-06-24","38","1408","2","49","2.3","1.4"
"Miller","2020-06-25","17","1425","0","49","2.3","1.4"
"Miller","2020-06-26","19","1444","0","49","2.3","1.4"
"Miller","2020-06-27","4","1448","0","49","2.3","1.4"
"Miller","2020-06-28","3","1451","1","50","7","3.8"
"Miller","2020-06-29","19","1470","1","51","7.8","4.2"
"Miller","2020-06-30","17","1487","0","51","6.3","4.2"
"Miller","2020-07-01","16","1503","1","52","6.4","4.3"
"Miller","2020-07-02","32","1535","0","52","6.4","4.3"
"Miller","2020-07-03","21","1556","1","53","7.1","4.7"
"Miller","2020-07-04","2","1558","0","53","7.1","4.7"
"Miller","2020-07-05","2","1560","1","54","9.5","8.2"
"Miller","2020-07-06","21","1581","0","54","8.7","8.2"
"Miller","2020-07-07","3","1584","1","55","13.5","9.9"
"Miller","2020-07-08","22","1606","0","55","12.6","9.5"
"Miller","2020-07-09","29","1635","4","59","14.6","10.5"
"Miller","2020-07-10","11","1646","0","59","13.9","10.5"
"Miller","2020-07-11","22","1668","2","61","15.2","11.1"
"Miller","2020-07-12","21","1689","2","63","9.4","9.4"
"Miller","2020-07-13","31","1720","1","64","9.9","9.3"
"Miller","2020-07-14","20","1740","3","67","7.2","10.4"
"Miller","2020-07-15","19","1759","1","68","8","10.3"
"Miller","2020-07-16","51","1810","6","74","7.7","11.1"
"Miller","2020-07-17","45","1855","4","78","9","11.4"
"Miller","2020-07-18","48","1903","3","81","8.6","11.9"
"Miller","2020-07-19","1","1904","0","81","7.2","8.3"
"Miller","2020-07-20","29","1933","3","84","8.2","9"
"Miller","2020-07-21","61","1994","7","91","7.7","7.5"
"Miller","2020-07-22","48","2042","3","94","7.9","7.9"
"Miller","2020-07-23","35","2077","11","105","10.7","9.2"
"Miller","2020-07-24","94","2171","17","122","12","10.5"
"Miller","2020-07-25","49","2220","10","132","14","11.3"
"Miller","2020-07-26","1","2221","0","132","14","10.6"
"Miller","2020-07-27","16","2237","1","133","13.4","10.8"
"Miller","2020-07-28","35","2272","9","142","15.4","11.6"
"Miller","2020-07-29","53","2325","4","146","15.6","11.7"
"Miller","2020-07-30","41","2366","3","149","12.2","11.4"
"Miller","2020-07-31","30","2396","1","150","10.1","11"
"Miller","2020-08-01","25","2421","3","153","8.9","11.4"
"Miller","2020-08-02","1","2422","0","153","8.9","11.4"
"Miller","2020-08-03","13","2435","1","154","9.1","11.3"
"Miller","2020-08-04","26","2461","2","156","6.5","11"
"Miller","2020-08-05","80","2541","6","162","6.5","11.1"
"Miller","2020-08-06","45","2586","8","170","8","10.1"
"Miller","2020-08-07","67","2653","5","175","8.6","9.3"
"Miller","2020-08-08","54","2707","3","178","7.7","8.3"
"Miller","2020-08-09","3","2710","2","180","17.2","13"
"Miller","2020-08-10","33","2743","1","181","16.5","12.8"
"Miller","2020-08-11","12","2755","3","184","19","12.8"
"Miller","2020-08-12","54","2809","6","190","19.5","13"
"Miller","2020-08-13","23","2832","3","193","18.8","13.4"
"Miller","2020-08-14","34","2866","8","201","21.1","14.9"
"Miller","2020-08-15","25","2891","8","209","24.9","16.3"
"Miller","2020-08-16","1","2892","0","209","15.4","16.3"
"Miller","2020-08-17","18","2910","0","209","15","15.7"
"Miller","2020-08-18","45","2955","11","220","14.9","16.9"
"Miller","2020-08-19","32","2987","7","227","16.4","18"
"Miller","2020-08-20","33","3020","6","233","17.1","18"
"Miller","2020-08-21","40","3060","8","241","16.6","18.9"
"Miller","2020-08-22","30","3090","6","247","14.9","19.9"
"Miller","2020-08-23","1","3091","0","247","14.9","15.2"
"Miller","2020-08-24","24","3115","1","248","15.5","15.2"
"Miller","2020-08-25","36","3151","3","251","13.2","14"
"Miller","2020-08-26","36","3187","7","258","12.9","14.6"
"Miller","2020-08-27","24","3211","2","260","11.5","14.3"
"Miller","2020-08-28","21","3232","2","262","10","13.3"
"Miller","2020-08-29","19","3251","6","268","11.6","13.3"
"Miller","2020-08-30","0","3251","0","268","11.6","13.3"
"Miller","2020-08-31","6","3257","0","268","11","13.3"
"Miller","2020-09-01","35","3292","8","276","13.1","13.2"
"Miller","2020-09-02","26","3318","3","279","12","12.4"
"Miller","2020-09-03","27","3345","4","283","12.9","12.2"
"Miller","2020-09-04","18","3363","2","285","13.1","11.6"
"Miller","2020-09-05","26","3389","0","285","8.6","10.1"
"Miller","2020-09-06","2","3391","0","285","8.6","10.1"
"Miller","2020-09-07","3","3394","0","285","8.6","9.8"
"Miller","2020-09-08","9","3403","1","286","6.9","10"
"Miller","2020-09-09","36","3439","0","286","5.3","8.6"
"Miller","2020-09-10","48","3487","3","289","4.1","8.5"
"Miller","2020-09-11","189","3676","2","291","2.6","7.9"
"Miller","2020-09-12","3","3679","0","291","2.6","5.6"
"Miller","2020-09-13","2","3681","0","291","2.6","5.6"
"Miller","2020-09-14","65","3746","2","293","3.1","5.8"
"Miller","2020-09-15","28","3774","0","293","1.5","4.2"
"Miller","2020-09-16","37","3811","0","293","1.5","3.4"
"Miller","2020-09-17","109","3920","1","294","0.7","2.4"
"Miller","2020-09-18","83","4003","0","294","0.6","1.6"
"Miller","2020-09-19","21","4024","3","297","2.6","2.6"
"Miller","2020-09-20","1","4025","0","297","2.6","2.6"
"Miller","2020-09-21","62","4087","0","297","2.2","2.6"
"Miller","2020-09-22","37","4124","6","303","4.5","3"
"Miller","2020-09-23","56","4180","6","309","6","3.8"
"Miller","2020-09-24","126","4306","2","311","6.1","3.4"
"Miller","2020-09-25","88","4394","8","319","7.4","4"
"Miller","2020-09-26","21","4415","2","321","6.7","4.7"
"Miller","2020-09-27","1","4416","0","321","6.7","4.7"
"Miller","2020-09-28","46","4462","0","321","6.7","4.5"
"Miller","2020-09-29","62","4524","4","325","5.3","4.9"
"Miller","2020-09-30","62","4586","3","328","4.5","5.3"
"Miller","2020-10-01","167","4753","6","334","4.8","5.5"
"Miller","2020-10-02","76","4829","4","338","4.2","5.8"
"Miller","2020-10-03","25","4854","1","339","3.4","5.1"
"Miller","2020-10-04","1","4855","0","339","3.4","5.1"
"Miller","2020-10-05","55","4910","2","341","4","5.4"
"Miller","2020-10-06","44","4954","2","343","3.7","4.5"
"Miller","2020-10-07","52","5006","4","347","4.1","4.3"
"Miller","2020-10-08","164","5170","3","350","3.9","4.3"
"Miller","2020-10-09","45","5215","2","352","3.7","4"
"Miller","2020-10-10","26","5241","1","353","3.7","3.6"
"Miller","2020-10-11","0","5241","0","353","3.7","3.6"
"Miller","2020-10-12","39","5280","0","353","3.2","3.6"
"Miller","2020-10-13","38","5318","3","356","3.7","3.7"
"Miller","2020-10-14","53","5371","0","356","2.6","3.3"
"Miller","2020-10-15","93","5464","1","357","2.5","3.2"
"Miller","2020-10-16","33","5497","2","359","2.7","3.2"
"Miller","2020-10-17","27","5524","2","361","3.2","3.5"
"Miller","2020-10-18","2","5526","1","362","10.3","7"
"Miller","2020-10-19","47","5573","0","362","10.3","6.8"
"Miller","2020-10-20","39","5612","4","366","10.7","7.2"
"Miller","2020-10-21","41","5653","4","370","12.1","7.3"
"Miller","2020-10-22","164","5817","7","377","12.5","7.5"
"Miller","2020-10-23","27","5844","3","380","13.3","8"
"Miller","2020-10-24","19","5863","5","385","16","9.6"
"Miller","2020-10-25","1","5864","0","385","8.8","9.6"
"Miller","2020-10-26","57","5921","0","385","8.8","9.6"
"Miller","2020-10-27","17","5938","1","386","8.2","9.4"
"Miller","2020-10-28","42","5980","0","386","6.8","9.4"
"Miller","2020-10-29","143","6123","5","391","6.7","9.6"
"Miller","2020-10-30","18","6141","2","393","6.7","10"
"Miller","2020-10-31","22","6163","4","397","5.5","10.7"
"Miller","2020-11-01","0","6163","0","397","5.5","7.2"
"Miller","2020-11-02","46","6209","3","400","6.5","7.6"
"Miller","2020-11-03","8","6217","0","400","5.6","6.9"
"Miller","2020-11-04","60","6277","2","402","6.1","6.4"
"Miller","2020-11-05","147","6424","4","406","6","6.3"
"Miller","2020-11-06","37","6461","1","407","4.8","5.7"
"Miller","2020-11-07","47","6508","5","412","3.7","4.6"
"Miller","2020-11-08","3","6511","0","412","3.7","4.6"
"Miller","2020-11-09","43","6554","1","413","3.1","4.8"
"Miller","2020-11-10","62","6616","2","415","3.6","4.6"
"Miller","2020-11-11","61","6677","3","418","3.8","4.9"
"Miller","2020-11-12","110","6787","6","424","4.2","5.1"
"Miller","2020-11-13","32","6819","1","425","4.2","4.5"
"Miller","2020-11-14","25","6844","4","429","5","4.4"
"Miller","2020-11-15","2","6846","0","429","5","4.4"
"Miller","2020-11-16","70","6916","1","430","4.9","4"
"Miller","2020-11-17","75","6991","1","431","4.6","4.1"
"Miller","2020-11-18","37","7028","0","431","3.9","3.8"
"Miller","2020-11-19","99","7127","0","431","3.1","3.7"
"Miller","2020-11-20","53","7180","4","435","3.8","4"
"Miller","2020-11-21","20","7200","1","436","2.2","3.6"
"Miller","2020-11-22","2","7202","0","436","2.2","3.6"
"Miller","2020-11-23","18","7220","1","437","2.8","3.8"
"Miller","2020-11-24","67","7287","4","441","3.4","4"
"Miller","2020-11-25","71","7358","8","449","5","4.5"
"Miller","2020-11-26","58","7416","0","449","5","4.1"
"Miller","2020-11-27","66","7482","3","452","4.6","4.2"
"Miller","2020-11-28","33","7515","5","457","6.1","4.1"
"Miller","2020-11-29","1","7516","0","457","6.1","4.1"
"Miller","2020-11-30","33","7549","0","457","5.3","4"
"Miller","2020-12-01","64","7613","0","457","4.4","3.9"
"Miller","2020-12-02","57","7670","3","460","3.6","4.3"
"Miller","2020-12-03","77","7747","4","464","4.3","4.7"
"Miller","2020-12-04","63","7810","0","464","3.7","4.1"
"Miller","2020-12-05","28","7838","0","464","1.5","3.8"
"Miller","2020-12-06","3","7841","0","464","1.5","3.8"
"Miller","2020-12-07","52","7893","3","467","2.3","3.8"
"Miller","2020-12-08","90","7983","2","469","2.6","3.5"
"Miller","2020-12-09","61","8044","6","475","3.3","3.4"
"Miller","2020-12-10","103","8147","3","478","3","3.6"
"Miller","2020-12-11","32","8179","2","480","3.9","3.8"
"Miller","2020-12-12","48","8227","5","485","5.3","3.4"
"Miller","2020-12-13","1","8228","0","485","5.3","3.4"
"Miller","2020-12-14","80","8308","0","485","4.5","3.4"
"Miller","2020-12-15","110","8418","5","490","4.9","3.7"
"Miller","2020-12-16","173","8591","15","505","4.7","4"
"Miller","2020-12-17","85","8676","4","509","4.9","4"
"Miller","2020-12-18","74","8750","10","519","6","4.9"
"Miller","2020-12-19","92","8842","8","527","5.7","5.5"
"Miller","2020-12-20","10","8852","1","528","7.2","6.3"
"Miller","2020-12-21","184","9036","10","538","7.9","6.2"
"Miller","2020-12-22","267","9303","31","569","8.9","6.9"
"Miller","2020-12-23","209","9512","18","587","8.9","6.8"
"Miller","2020-12-24","157","9669","23","610","10.4","7.7"
"Miller","2020-12-25","19","9688","0","610","8.4","7.2"
"Miller","2020-12-26","12","9700","3","613","10.8","8.2"
"Miller","2020-12-27","17","9717","2","615","11","9.1"
"Miller","2020-12-28","175","9892","8","623","10.9","9.4"
"Miller","2020-12-29","176","10068","6","629","9.7","9.3"
"Miller","2020-12-30","185","10253","24","653","10.3","9.6"
"Miller","2020-12-31","134","10387","19","672","10.3","10.3"
"Miller","2021-01-01","62","10449","1","673","10.5","9.5"
"Miller","2021-01-02","2","10451","0","673","6.9","8.8"
"Miller","2021-01-03","2","10453","0","673","5.2","8.1"
"Miller","2021-01-04","52","10505","8","681","6.8","8.8"
"Miller","2021-01-05","143","10648","29","710","9.2","9.5"
"Miller","2021-01-06","63","10711","10","720","9.6","10"
"Miller","2021-01-07","112","10823","8","728","8.6","9.4"
"Miller","2021-01-08","34","10857","3","731","9.6","10.1"
"Miller","2021-01-09","30","10887","6","737","12.5","9.7"
"Miller","2021-01-10","5","10892","0","737","12.5","8.9"
"Miller","2021-01-11","45","10937","1","738","10.6","8.7"
"Miller","2021-01-12","87","11024","7","745","8.9","9"
"Miller","2021-01-13","56","11080","6","751","8.1","8.9"
"Miller","2021-01-14","130","11210","4","755","7.6","8.1"
"Miller","2021-01-15","70","11280","7","762","7.7","8.7"
"Miller","2021-01-16","32","11312","4","766","6.7","9.6"
"Miller","2021-01-17","0","11312","0","766","6.7","9.6"
"Miller","2021-01-18","43","11355","4","770","7.7","9.1"
"Miller","2021-01-19","70","11425","5","775","7.5","8.2"
"Miller","2021-01-20","88","11513","2","777","6.3","7.2"
"Miller","2021-01-21","133","11646","3","780","6.2","6.9"
"Miller","2021-01-22","48","11694","5","785","6.3","7"
"Miller","2021-01-23","20","11714","1","786","5.2","5.9"
"Miller","2021-01-24","0","11714","0","786","5.2","5.9"
"Miller","2021-01-25","0","11714","0","786","3.9","5.8"
"Miller","2021-01-26","1","11715","0","786","2.8","5.2"
"Miller","2021-01-27","0","11715","0","786","2.5","4.4"
"Mitchell","2020-02-01","0","0","0","0",".","."
"Mitchell","2020-02-02","0","0","0","0",".","."
"Mitchell","2020-02-03","0","0","0","0",".","."
"Mitchell","2020-02-04","0","0","0","0",".","."
"Mitchell","2020-02-05","0","0","0","0",".","."
"Mitchell","2020-02-06","0","0","0","0",".","."
"Mitchell","2020-02-07","0","0","0","0","0","."
"Mitchell","2020-02-08","0","0","0","0","0","."
"Mitchell","2020-02-09","0","0","0","0","0","."
"Mitchell","2020-02-10","0","0","0","0","0","."
"Mitchell","2020-02-11","0","0","0","0","0","."
"Mitchell","2020-02-12","0","0","0","0","0","."
"Mitchell","2020-02-13","0","0","0","0","0","."
"Mitchell","2020-02-14","0","0","0","0","0","0"
"Mitchell","2020-02-15","0","0","0","0","0","0"
"Mitchell","2020-02-16","0","0","0","0","0","0"
"Mitchell","2020-02-17","0","0","0","0","0","0"
"Mitchell","2020-02-18","0","0","0","0","0","0"
"Mitchell","2020-02-19","0","0","0","0","0","0"
"Mitchell","2020-02-20","0","0","0","0","0","0"
"Mitchell","2020-02-21","0","0","0","0","0","0"
"Mitchell","2020-02-22","0","0","0","0","0","0"
"Mitchell","2020-02-23","0","0","0","0","0","0"
"Mitchell","2020-02-24","0","0","0","0","0","0"
"Mitchell","2020-02-25","0","0","0","0","0","0"
"Mitchell","2020-02-26","0","0","0","0","0","0"
"Mitchell","2020-02-27","0","0","0","0","0","0"
"Mitchell","2020-02-28","0","0","0","0","0","0"
"Mitchell","2020-02-29","0","0","0","0","0","0"
"Mitchell","2020-03-01","0","0","0","0","0","0"
"Mitchell","2020-03-02","0","0","0","0","0","0"
"Mitchell","2020-03-03","0","0","0","0","0","0"
"Mitchell","2020-03-04","0","0","0","0","0","0"
"Mitchell","2020-03-05","0","0","0","0","0","0"
"Mitchell","2020-03-06","0","0","0","0","0","0"
"Mitchell","2020-03-07","0","0","0","0","0","0"
"Mitchell","2020-03-08","0","0","0","0","0","0"
"Mitchell","2020-03-09","0","0","0","0","0","0"
"Mitchell","2020-03-10","0","0","0","0","0","0"
"Mitchell","2020-03-11","1","1","0","0","0","0"
"Mitchell","2020-03-12","1","2","1","1","14.3","7.1"
"Mitchell","2020-03-13","2","4","0","1","14.3","7.1"
"Mitchell","2020-03-14","1","5","0","1","14.3","7.1"
"Mitchell","2020-03-15","4","9","3","4","25","12.5"
"Mitchell","2020-03-16","2","11","0","4","25","12.5"
"Mitchell","2020-03-17","8","19","1","5","26.8","13.4"
"Mitchell","2020-03-18","3","22","1","6","31.5","15.8"
"Mitchell","2020-03-19","3","25","3","9","31.5","22.9"
"Mitchell","2020-03-20","4","29","1","10","35.1","24.7"
"Mitchell","2020-03-21","3","32","0","10","35.1","24.7"
"Mitchell","2020-03-22","2","34","1","11","31.5","28.3"
"Mitchell","2020-03-23","13","47","2","13","33.7","29.4"
"Mitchell","2020-03-24","32","79","17","30","39.5","33.2"
"Mitchell","2020-03-25","26","105","14","44","42.5","37"
"Mitchell","2020-03-26","23","128","12","56","35.6","33.6"
"Mitchell","2020-03-27","19","147","16","72","44.1","39.6"
"Mitchell","2020-03-28","13","160","9","81","54","44.6"
"Mitchell","2020-03-29","24","184","21","102","59.4","45.5"
"Mitchell","2020-03-30","14","198","6","108","63.3","48.5"
"Mitchell","2020-03-31","24","222","11","119","62.2","50.9"
"Mitchell","2020-04-01","21","243","11","130","62","52.3"
"Mitchell","2020-04-02","18","261","6","136","59.3","47.5"
"Mitchell","2020-04-03","18","279","10","146","55.2","49.7"
"Mitchell","2020-04-04","8","287","4","150","52.5","53.2"
"Mitchell","2020-04-05","6","293","3","153","47.1","53.2"
"Mitchell","2020-04-06","25","318","12","165","47.9","55.6"
"Mitchell","2020-04-07","4","322","1","166","44.9","53.6"
"Mitchell","2020-04-08","15","337","10","176","46.9","54.5"
"Mitchell","2020-04-09","22","359","11","187","49.3","54.3"
"Mitchell","2020-04-10","21","380","12","199","49.5","52.4"
"Mitchell","2020-04-11","6","386","3","202","49.5","51"
"Mitchell","2020-04-12","6","392","4","206","51.9","49.5"
"Mitchell","2020-04-13","17","409","15","221","57.7","52.8"
"Mitchell","2020-04-14","25","434","10","231","59.8","52.4"
"Mitchell","2020-04-15","55","489","45","276","62","54.5"
"Mitchell","2020-04-16","21","510","13","289","63.7","56.5"
"Mitchell","2020-04-17","12","522","10","299","67.4","58.5"
"Mitchell","2020-04-18","8","530","4","303","67.4","58.5"
"Mitchell","2020-04-19","6","536","2","305","62.7","57.3"
"Mitchell","2020-04-20","13","549","4","309","54.5","56.1"
"Mitchell","2020-04-21","41","590","12","321","52.9","56.4"
"Mitchell","2020-04-22","97","687","12","333","43","52.5"
"Mitchell","2020-04-23","22","709","2","335","35.5","49.6"
"Mitchell","2020-04-24","92","801","7","342","24.6","46"
"Mitchell","2020-04-25","24","825","3","345","19.3","43.3"
"Mitchell","2020-04-26","8","833","3","348","19.9","41.3"
"Mitchell","2020-04-27","54","887","3","351","16.3","35.4"
"Mitchell","2020-04-28","62","949","8","359","13.9","33.4"
"Mitchell","2020-04-29","18","967","0","359","12.2","27.6"
"Mitchell","2020-04-30","23","990","8","367","15.8","25.6"
"Mitchell","2020-05-01","98","1088","31","398","19.3","22"
"Mitchell","2020-05-02","8","1096","0","398","17.5","18.4"
"Mitchell","2020-05-03","6","1102","2","400","16.9","18.4"
"Mitchell","2020-05-04","34","1136","2","402","16.9","16.6"
"Mitchell","2020-05-05","48","1184","7","409","17.2","15.6"
"Mitchell","2020-05-06","52","1236","3","412","18","15.1"
"Mitchell","2020-05-07","18","1254","4","416","16.2","16"
"Mitchell","2020-05-08","47","1301","4","420","12.9","16.1"
"Mitchell","2020-05-09","27","1328","2","422","14","15.7"
"Mitchell","2020-05-10","3","1331","3","425","23.5","20.2"
"Mitchell","2020-05-11","30","1361","3","428","24.1","20.5"
"Mitchell","2020-05-12","35","1396","3","431","23.2","20.2"
"Mitchell","2020-05-13","33","1429","1","432","22.8","20.4"
"Mitchell","2020-05-14","75","1504","7","439","21","18.6"
"Mitchell","2020-05-15","8","1512","1","440","21.5","17.2"
"Mitchell","2020-05-16","13","1525","4","444","24.9","19.4"
"Mitchell","2020-05-17","27","1552","1","445","11.1","17.3"
"Mitchell","2020-05-18","32","1584","4","449","11.5","17.8"
"Mitchell","2020-05-19","57","1641","4","453","11.3","17.2"
"Mitchell","2020-05-20","27","1668","1","454","11.4","17.1"
"Mitchell","2020-05-21","87","1755","3","457","10.5","15.7"
"Mitchell","2020-05-22","68","1823","4","461","9.6","15.6"
"Mitchell","2020-05-23","13","1836","0","461","5.2","15"
"Mitchell","2020-05-24","6","1842","0","461","4.7","7.9"
"Mitchell","2020-05-25","8","1850","2","463","6.4","9"
"Mitchell","2020-05-26","48","1898","9","472","8.1","9.7"
"Mitchell","2020-05-27","17","1915","1","473","8.4","9.9"
"Mitchell","2020-05-28","25","1940","0","473","7.9","9.2"
"Mitchell","2020-05-29","69","2009","6","479","8.3","9"
"Mitchell","2020-05-30","8","2017","0","479","8.3","6.8"
"Mitchell","2020-05-31","1","2018","0","479","8.3","6.5"
"Mitchell","2020-06-01","27","2045","2","481","5.8","6.1"
"Mitchell","2020-06-02","44","2089","1","482","3.5","5.8"
"Mitchell","2020-06-03","37","2126","0","482","2.6","5.5"
"Mitchell","2020-06-04","106","2232","1","483","2.8","5.3"
"Mitchell","2020-06-05","24","2256","0","483","1.5","4.9"
"Mitchell","2020-06-06","8","2264","0","483","1.5","4.9"
"Mitchell","2020-06-07","9","2273","1","484","3.1","5.7"
"Mitchell","2020-06-08","39","2312","0","484","2","3.9"
"Mitchell","2020-06-09","27","2339","0","484","1.7","2.6"
"Mitchell","2020-06-10","19","2358","3","487","4","3.3"
"Mitchell","2020-06-11","83","2441","4","491","4.5","3.6"
"Mitchell","2020-06-12","22","2463","1","492","5.2","3.3"
"Mitchell","2020-06-13","1","2464","0","492","5.2","3.3"
"Mitchell","2020-06-14","6","2470","3","495","10.7","6.9"
"Mitchell","2020-06-15","31","2501","0","495","10.7","6.4"
"Mitchell","2020-06-16","61","2562","1","496","11","6.3"
"Mitchell","2020-06-17","19","2581","0","496","8.7","6.3"
"Mitchell","2020-06-18","97","2678","2","498","8.3","6.4"
"Mitchell","2020-06-19","26","2704","1","499","8.2","6.7"
"Mitchell","2020-06-20","6","2710","3","502","15.4","10.3"
"Mitchell","2020-06-21","7","2717","1","503","10.3","10.5"
"Mitchell","2020-06-22","39","2756","1","504","10.6","10.7"
"Mitchell","2020-06-23","33","2789","0","504","10.4","10.7"
"Mitchell","2020-06-24","13","2802","2","506","12.6","10.7"
"Mitchell","2020-06-25","66","2868","3","509","12.9","10.6"
"Mitchell","2020-06-26","23","2891","3","512","14.3","11.2"
"Mitchell","2020-06-27","6","2897","0","512","7.1","11.2"
"Mitchell","2020-06-28","7","2904","1","513","7.1","8.7"
"Mitchell","2020-06-29","16","2920","1","514","7.6","9.1"
"Mitchell","2020-06-30","27","2947","4","518","9.8","10.1"
"Mitchell","2020-07-01","14","2961","1","519","8.6","10.6"
"Mitchell","2020-07-02","23","2984","5","524","11","12"
"Mitchell","2020-07-03","107","3091","8","532","10.2","12.3"
"Mitchell","2020-07-04","4","3095","0","532","10.2","8.7"
"Mitchell","2020-07-05","10","3105","0","532","8.2","7.7"
"Mitchell","2020-07-06","30","3135","4","536","9.2","8.4"
"Mitchell","2020-07-07","46","3181","3","539","8","8.9"
"Mitchell","2020-07-08","44","3225","1","540","7.3","8"
"Mitchell","2020-07-09","124","3349","12","552","5.6","8.3"
"Mitchell","2020-07-10","32","3381","3","555","5.9","8.1"
"Mitchell","2020-07-11","12","3393","2","557","8.3","9.3"
"Mitchell","2020-07-12","7","3400","1","558","10.3","9.3"
"Mitchell","2020-07-13","30","3430","3","561","9.8","9.5"
"Mitchell","2020-07-14","36","3466","6","567","11.3","9.7"
"Mitchell","2020-07-15","33","3499","5","572","13.1","10.2"
"Mitchell","2020-07-16","132","3631","21","593","14","9.8"
"Mitchell","2020-07-17","32","3663","2","595","13.6","9.7"
"Mitchell","2020-07-18","4","3667","1","596","14.8","11.5"
"Mitchell","2020-07-19","7","3674","2","598","16.8","13.5"
"Mitchell","2020-07-20","27","3701","2","600","16.4","13.1"
"Mitchell","2020-07-21","34","3735","3","603","15.3","13.3"
"Mitchell","2020-07-22","31","3766","3","606","14.5","13.8"
"Mitchell","2020-07-23","184","3950","14","620","13.3","13.7"
"Mitchell","2020-07-24","63","4013","4","624","13.3","13.5"
"Mitchell","2020-07-25","6","4019","1","625","12.2","13.5"
"Mitchell","2020-07-26","12","4031","2","627","10.5","13.6"
"Mitchell","2020-07-27","35","4066","2","629","10.2","13.3"
"Mitchell","2020-07-28","33","4099","5","634","11.1","13.2"
"Mitchell","2020-07-29","16","4115","7","641","16","15.3"
"Mitchell","2020-07-30","185","4300","10","651","15.7","14.5"
"Mitchell","2020-07-31","24","4324","3","654","16.6","14.9"
"Mitchell","2020-08-01","35","4359","1","655","14.6","13.4"
"Mitchell","2020-08-02","11","4370","2","657","14.8","12.6"
"Mitchell","2020-08-03","47","4417","8","665","16.4","13.3"
"Mitchell","2020-08-04","35","4452","3","668","15.5","13.3"
"Mitchell","2020-08-05","29","4481","0","668","9.2","12.6"
"Mitchell","2020-08-06","129","4610","2","670","8.7","12.2"
"Mitchell","2020-08-07","35","4645","3","673","8.1","12.3"
"Mitchell","2020-08-08","21","4666","0","673","7.7","11.1"
"Mitchell","2020-08-09","12","4678","0","673","5.1","9.9"
"Mitchell","2020-08-10","36","4714","6","679","5.1","10.7"
"Mitchell","2020-08-11","21","4735","4","683","6.5","11"
"Mitchell","2020-08-12","25","4760","2","685","7.7","8.5"
"Mitchell","2020-08-13","98","4858","7","692","8.5","8.6"
"Mitchell","2020-08-14","18","4876","2","694","8.9","8.5"
"Mitchell","2020-08-15","7","4883","1","695","10.9","9.3"
"Mitchell","2020-08-16","9","4892","0","695","10.9","8"
"Mitchell","2020-08-17","25","4917","3","698","10.2","7.6"
"Mitchell","2020-08-18","19","4936","2","700","9","7.8"
"Mitchell","2020-08-19","18","4954","1","701","8.7","8.2"
"Mitchell","2020-08-20","106","5060","8","709","8.7","8.6"
"Mitchell","2020-08-21","33","5093","5","714","9.3","9.1"
"Mitchell","2020-08-22","6","5099","1","715","9.6","10.3"
"Mitchell","2020-08-23","8","5107","3","718","15","12.9"
"Mitchell","2020-08-24","20","5127","2","720","14.7","12.5"
"Mitchell","2020-08-25","21","5148","2","722","14.6","11.8"
"Mitchell","2020-08-26","23","5171","5","727","16.9","12.8"
"Mitchell","2020-08-27","83","5254","8","735","17.2","12.9"
"Mitchell","2020-08-28","18","5272","3","738","17.4","13.3"
"Mitchell","2020-08-29","9","5281","2","740","18.2","13.9"
"Mitchell","2020-08-30","9","5290","1","741","14.4","14.7"
"Mitchell","2020-08-31","16","5306","4","745","16.6","15.6"
"Mitchell","2020-09-01","24","5330","2","747","16.4","15.5"
"Mitchell","2020-09-02","26","5356","3","750","14.9","15.9"
"Mitchell","2020-09-03","74","5430","9","759","15.3","16.2"
"Mitchell","2020-09-04","51","5481","2","761","13.5","15.4"
"Mitchell","2020-09-05","11","5492","6","767","18.1","18.1"
"Mitchell","2020-09-06","2","5494","0","767","16.5","15.5"
"Mitchell","2020-09-07","6","5500","1","768","15.3","15.9"
"Mitchell","2020-09-08","38","5538","4","772","15.6","16"
"Mitchell","2020-09-09","142","5680","2","774","14.2","14.6"
"Mitchell","2020-09-10","76","5756","8","782","13.9","14.6"
"Mitchell","2020-09-11","25","5781","3","785","15.1","14.3"
"Mitchell","2020-09-12","25","5806","0","785","7.3","12.7"
"Mitchell","2020-09-13","5","5811","1","786","10.2","13.3"
"Mitchell","2020-09-14","41","5852","5","791","9.5","12.4"
"Mitchell","2020-09-15","21","5873","2","793","9.4","12.5"
"Mitchell","2020-09-16","21","5894","3","796","11.2","12.7"
"Mitchell","2020-09-17","19","5913","0","796","9.7","11.8"
"Mitchell","2020-09-18","48","5961","3","799","8.9","12"
"Mitchell","2020-09-19","4","5965","0","799","8.9","8.1"
"Mitchell","2020-09-20","11","5976","2","801","8.6","9.4"
"Mitchell","2020-09-21","21","5997","0","801","6.9","8.2"
"Mitchell","2020-09-22","32","6029","3","804","6.9","8.1"
"Mitchell","2020-09-23","35","6064","4","808","6.5","8.8"
"Mitchell","2020-09-24","78","6142","8","816","7.9","8.8"
"Mitchell","2020-09-25","23","6165","2","818","8.3","8.6"
"Mitchell","2020-09-26","8","6173","6","824","19","13.9"
"Mitchell","2020-09-27","5","6178","1","825","19.3","13.9"
"Mitchell","2020-09-28","31","6209","0","825","19.3","13.1"
"Mitchell","2020-09-29","29","6238","0","825","17.9","12.4"
"Mitchell","2020-09-30","23","6261","2","827","17.5","12"
"Mitchell","2020-10-01","25","6286","2","829","17.2","12.6"
"Mitchell","2020-10-02","46","6332","2","831","16.6","12.4"
"Mitchell","2020-10-03","7","6339","0","831","5.9","12.4"
"Mitchell","2020-10-04","7","6346","0","831","3","11.1"
"Mitchell","2020-10-05","20","6366","0","831","3","11.1"
"Mitchell","2020-10-06","31","6397","2","833","3.9","10.9"
"Mitchell","2020-10-07","34","6431","0","833","2.7","10.1"
"Mitchell","2020-10-08","66","6497","4","837","2.4","9.8"
"Mitchell","2020-10-09","19","6516","0","837","1.8","9.2"
"Mitchell","2020-10-10","13","6529","0","837","1.8","3.8"
"Mitchell","2020-10-11","7","6536","1","838","3.8","3.4"
"Mitchell","2020-10-12","26","6562","0","838","3.8","3.4"
"Mitchell","2020-10-13","22","6584","1","839","3.6","3.7"
"Mitchell","2020-10-14","23","6607","1","840","4.2","3.4"
"Mitchell","2020-10-15","12","6619","0","840","3.3","2.9"
"Mitchell","2020-10-16","48","6667","1","841","3.6","2.7"
"Mitchell","2020-10-17","9","6676","0","841","3.6","2.7"
"Mitchell","2020-10-18","4","6680","0","841","1.6","2.7"
"Mitchell","2020-10-19","32","6712","1","842","2","2.9"
"Mitchell","2020-10-20","28","6740","3","845","2.9","3.2"
"Mitchell","2020-10-21","19","6759","0","845","2.3","3.2"
"Mitchell","2020-10-22","70","6829","4","849","3.1","3.2"
"Mitchell","2020-10-23","23","6852","1","850","3.4","3.5"
"Mitchell","2020-10-24","15","6867","0","850","3.4","3.5"
"Mitchell","2020-10-25","2","6869","0","850","3.4","2.5"
"Mitchell","2020-10-26","26","6895","3","853","4.6","3.3"
"Mitchell","2020-10-27","21","6916","1","854","3.8","3.3"
"Mitchell","2020-10-28","29","6945","1","855","4.3","3.3"
"Mitchell","2020-10-29","16","6961","0","855","3.4","3.3"
"Mitchell","2020-10-30","20","6981","1","856","3.5","3.5"
"Mitchell","2020-10-31","33","7014","2","858","4.4","3.9"
"Mitchell","2020-11-01","16","7030","0","858","4.4","3.9"
"Mitchell","2020-11-02","25","7055","2","860","3.9","4.3"
"Mitchell","2020-11-03","19","7074","1","861","4","3.9"
"Mitchell","2020-11-04","31","7105","0","861","3.5","3.9"
"Mitchell","2020-11-05","55","7160","5","866","4.8","4.1"
"Mitchell","2020-11-06","15","7175","4","870","7.9","5.7"
"Mitchell","2020-11-07","5","7180","0","870","7","5.7"
"Mitchell","2020-11-08","7","7187","0","870","7","5.7"
"Mitchell","2020-11-09","22","7209","2","872","7.2","5.5"
"Mitchell","2020-11-10","22","7231","1","873","7.1","5.5"
"Mitchell","2020-11-11","36","7267","1","874","7.5","5.5"
"Mitchell","2020-11-12","13","7280","0","874","6.2","5.5"
"Mitchell","2020-11-13","18","7298","1","875","3.1","5.5"
"Mitchell","2020-11-14","28","7326","1","876","3.6","5.3"
"Mitchell","2020-11-15","3","7329","2","878","13.2","10.1"
"Mitchell","2020-11-16","29","7358","1","879","12.4","9.8"
"Mitchell","2020-11-17","19","7377","1","880","12.5","9.8"
"Mitchell","2020-11-18","56","7433","0","880","12.1","9.8"
"Mitchell","2020-11-19","49","7482","4","884","13.2","9.7"
"Mitchell","2020-11-20","16","7498","0","884","12.4","7.8"
"Mitchell","2020-11-21","35","7533","6","890","14.4","9"
"Mitchell","2020-11-22","9","7542","2","892","8","10.6"
"Mitchell","2020-11-23","30","7572","1","893","8","10.2"
"Mitchell","2020-11-24","23","7595","1","894","7.9","10.2"
"Mitchell","2020-11-25","25","7620","2","896","9","10.6"
"Mitchell","2020-11-26","27","7647","2","898","8.9","11.1"
"Mitchell","2020-11-27","15","7662","1","899","9.9","11.2"
"Mitchell","2020-11-28","11","7673","2","901","10","12.2"
"Mitchell","2020-11-29","6","7679","0","901","6.8","7.4"
"Mitchell","2020-11-30","35","7714","4","905","8","8"
"Mitchell","2020-12-01","33","7747","3","908","8.7","8.3"
"Mitchell","2020-12-02","30","7777","2","910","8.5","8.8"
"Mitchell","2020-12-03","24","7801","3","913","9.2","9.1"
"Mitchell","2020-12-04","21","7822","0","913","8.3","9.1"
"Mitchell","2020-12-05","7","7829","3","916","11.8","10.9"
"Mitchell","2020-12-06","6","7835","5","921","23.7","15.3"
"Mitchell","2020-12-07","48","7883","3","924","23","15.5"
"Mitchell","2020-12-08","35","7918","6","930","24.1","16.4"
"Mitchell","2020-12-09","52","7970","6","936","24.8","16.6"
"Mitchell","2020-12-10","50","8020","9","945","25.6","17.4"
"Mitchell","2020-12-11","41","8061","7","952","28","18.1"
"Mitchell","2020-12-12","15","8076","0","952","21.9","16.8"
"Mitchell","2020-12-13","12","8088","4","956","14.8","19.2"
"Mitchell","2020-12-14","39","8127","4","960","15.3","19.1"
"Mitchell","2020-12-15","31","8158","8","968","16.6","20.3"
"Mitchell","2020-12-16","207","8365","21","989","16.4","20.6"
"Mitchell","2020-12-17","39","8404","12","1001","18.2","21.9"
"Mitchell","2020-12-18","23","8427","8","1009","20.7","24.4"
"Mitchell","2020-12-19","12","8439","2","1011","23.1","22.5"
"Mitchell","2020-12-20","5","8444","0","1011","18.3","16.6"
"Mitchell","2020-12-21","35","8479","6","1017","19.3","17.3"
"Mitchell","2020-12-22","93","8572","30","1047","20.3","18.4"
"Mitchell","2020-12-23","140","8712","23","1070","21.1","18.8"
"Mitchell","2020-12-24","20","8732","2","1072","18.2","18.2"
"Mitchell","2020-12-25","15","8747","7","1079","19.9","20.3"
"Mitchell","2020-12-26","14","8761","6","1085","23.6","23.4"
"Mitchell","2020-12-27","17","8778","8","1093","30.3","24.3"
"Mitchell","2020-12-28","40","8818","10","1103","31.5","25.4"
"Mitchell","2020-12-29","52","8870","15","1118","31","25.6"
"Mitchell","2020-12-30","249","9119","31","1149","30.4","25.8"
"Mitchell","2020-12-31","40","9159","9","1158","32.2","25.2"
"Mitchell","2021-01-01","10","9169","4","1162","31.2","25.6"
"Mitchell","2021-01-02","37","9206","6","1168","27.4","25.5"
"Mitchell","2021-01-03","39","9245","4","1172","22.2","26.3"
"Mitchell","2021-01-04","45","9290","6","1178","20.5","26"
"Mitchell","2021-01-05","39","9329","5","1183","18.2","24.6"
"Mitchell","2021-01-06","169","9498","22","1205","18.3","24.4"
"Mitchell","2021-01-07","95","9593","6","1211","16","24.1"
"Mitchell","2021-01-08","43","9636","6","1217","12.3","21.8"
"Mitchell","2021-01-09","10","9646","2","1219","12.8","20.1"
"Mitchell","2021-01-10","17","9663","2","1221","13","17.6"
"Mitchell","2021-01-11","47","9710","15","1236","15.7","18.1"
"Mitchell","2021-01-12","42","9752","5","1241","15.6","16.9"
"Mitchell","2021-01-13","112","9864","17","1258","15.9","17.1"
"Mitchell","2021-01-14","34","9898","5","1263","17.1","16.5"
"Mitchell","2021-01-15","43","9941","4","1267","16.4","14.3"
"Mitchell","2021-01-16","9","9950","0","1267","13.5","13.2"
"Mitchell","2021-01-17","12","9962","3","1270","15.4","14.2"
"Mitchell","2021-01-18","39","10001","11","1281","14.9","15.3"
"Mitchell","2021-01-19","22","10023","1","1282","13.8","14.7"
"Mitchell","2021-01-20","202","10225","11","1293","12.5","14.2"
"Mitchell","2021-01-21","133","10358","31","1324","13.7","15.4"
"Mitchell","2021-01-22","37","10395","3","1327","13.5","15"
"Mitchell","2021-01-23","21","10416","0","1327","13.5","13.5"
"Mitchell","2021-01-24","9","10425","0","1327","9.9","12.7"
"Mitchell","2021-01-25","16","10441","2","1329","7.7","11.3"
"Mitchell","2021-01-26","3","10444","0","1329","7.1","10.4"
"Mitchell","2021-01-27","0","10444","0","1329","6.3","9.4"
"Monroe","2020-02-01","0","0","0","0",".","."
"Monroe","2020-02-02","0","0","0","0",".","."
"Monroe","2020-02-03","0","0","0","0",".","."
"Monroe","2020-02-04","0","0","0","0",".","."
"Monroe","2020-02-05","0","0","0","0",".","."
"Monroe","2020-02-06","0","0","0","0",".","."
"Monroe","2020-02-07","0","0","0","0","0","."
"Monroe","2020-02-08","0","0","0","0","0","."
"Monroe","2020-02-09","0","0","0","0","0","."
"Monroe","2020-02-10","0","0","0","0","0","."
"Monroe","2020-02-11","0","0","0","0","0","."
"Monroe","2020-02-12","0","0","0","0","0","."
"Monroe","2020-02-13","0","0","0","0","0","."
"Monroe","2020-02-14","0","0","0","0","0","0"
"Monroe","2020-02-15","0","0","0","0","0","0"
"Monroe","2020-02-16","0","0","0","0","0","0"
"Monroe","2020-02-17","0","0","0","0","0","0"
"Monroe","2020-02-18","0","0","0","0","0","0"
"Monroe","2020-02-19","0","0","0","0","0","0"
"Monroe","2020-02-20","0","0","0","0","0","0"
"Monroe","2020-02-21","0","0","0","0","0","0"
"Monroe","2020-02-22","0","0","0","0","0","0"
"Monroe","2020-02-23","0","0","0","0","0","0"
"Monroe","2020-02-24","0","0","0","0","0","0"
"Monroe","2020-02-25","0","0","0","0","0","0"
"Monroe","2020-02-26","0","0","0","0","0","0"
"Monroe","2020-02-27","0","0","0","0","0","0"
"Monroe","2020-02-28","0","0","0","0","0","0"
"Monroe","2020-02-29","0","0","0","0","0","0"
"Monroe","2020-03-01","0","0","0","0","0","0"
"Monroe","2020-03-02","0","0","0","0","0","0"
"Monroe","2020-03-03","0","0","0","0","0","0"
"Monroe","2020-03-04","0","0","0","0","0","0"
"Monroe","2020-03-05","0","0","0","0","0","0"
"Monroe","2020-03-06","0","0","0","0","0","0"
"Monroe","2020-03-07","0","0","0","0","0","0"
"Monroe","2020-03-08","0","0","0","0","0","0"
"Monroe","2020-03-09","0","0","0","0","0","0"
"Monroe","2020-03-10","0","0","0","0","0","0"
"Monroe","2020-03-11","0","0","0","0","0","0"
"Monroe","2020-03-12","0","0","0","0","0","0"
"Monroe","2020-03-13","3","3","0","0","0","0"
"Monroe","2020-03-14","0","3","0","0","0","0"
"Monroe","2020-03-15","1","4","0","0","0","0"
"Monroe","2020-03-16","5","9","0","0","0","0"
"Monroe","2020-03-17","7","16","0","0","0","0"
"Monroe","2020-03-18","4","20","1","1","3.6","1.8"
"Monroe","2020-03-19","6","26","0","1","3.6","1.8"
"Monroe","2020-03-20","11","37","2","3","6.2","3.1"
"Monroe","2020-03-21","1","38","0","3","6.2","3.1"
"Monroe","2020-03-22","4","42","1","4","9.7","4.9"
"Monroe","2020-03-23","13","55","2","6","11.9","6"
"Monroe","2020-03-24","8","63","0","6","11.9","6"
"Monroe","2020-03-25","5","68","1","7","11.2","7.4"
"Monroe","2020-03-26","12","80","1","8","12.4","8"
"Monroe","2020-03-27","13","93","1","9","10.9","8.5"
"Monroe","2020-03-28","0","93","0","9","10.9","8.5"
"Monroe","2020-03-29","1","94","0","9","7.3","8.5"
"Monroe","2020-03-30","4","98","0","9","5.1","8.5"
"Monroe","2020-03-31","7","105","0","9","5.1","8.5"
"Monroe","2020-04-01","14","119","0","9","2.3","6.8"
"Monroe","2020-04-02","11","130","3","12","5","8.7"
"Monroe","2020-04-03","20","150","4","16","6.8","8.8"
"Monroe","2020-04-04","0","150","0","16","6.8","8.8"
"Monroe","2020-04-05","3","153","0","16","6.8","7"
"Monroe","2020-04-06","12","165","1","17","7.9","6.5"
"Monroe","2020-04-07","7","172","0","17","7.9","6.5"
"Monroe","2020-04-08","7","179","0","17","7.9","5.1"
"Monroe","2020-04-09","4","183","0","17","4","4.5"
"Monroe","2020-04-10","9","192","1","18","2.8","4.8"
"Monroe","2020-04-11","3","195","0","18","2.8","4.8"
"Monroe","2020-04-12","0","195","0","18","2.8","4.8"
"Monroe","2020-04-13","22","217","0","18","1.6","4.8"
"Monroe","2020-04-14","9","226","1","19","3.2","5.6"
"Monroe","2020-04-15","13","239","0","19","3.2","5.6"
"Monroe","2020-04-16","8","247","0","19","3.2","3.6"
"Monroe","2020-04-17","9","256","0","19","1.6","2.2"
"Monroe","2020-04-18","2","258","0","19","1.6","2.2"
"Monroe","2020-04-19","1","259","0","19","1.6","2.2"
"Monroe","2020-04-20","14","273","4","23","5.7","3.6"
"Monroe","2020-04-21","12","285","2","25","6.5","4.8"
"Monroe","2020-04-22","18","303","1","26","7.3","5.2"
"Monroe","2020-04-23","12","315","0","26","7.3","5.2"
"Monroe","2020-04-24","17","332","1","27","8.1","4.8"
"Monroe","2020-04-25","14","346","6","33","14.2","7.9"
"Monroe","2020-04-26","4","350","0","33","14.2","7.9"
"Monroe","2020-04-27","12","362","0","33","10.1","7.9"
"Monroe","2020-04-28","10","372","0","33","7.8","7.1"
"Monroe","2020-04-29","15","387","1","34","7.9","7.6"
"Monroe","2020-04-30","13","400","0","34","7.9","7.6"
"Monroe","2020-05-01","11","411","1","35","8.4","8.2"
"Monroe","2020-05-02","4","415","0","35","2.3","8.2"
"Monroe","2020-05-03","6","421","0","35","2.3","8.2"
"Monroe","2020-05-04","16","437","5","40","6.7","8.4"
"Monroe","2020-05-05","12","449","1","41","7.9","7.8"
"Monroe","2020-05-06","20","469","0","41","7","7.4"
"Monroe","2020-05-07","8","477","0","41","7","7.4"
"Monroe","2020-05-08","16","493","1","42","6.5","7.5"
"Monroe","2020-05-09","6","499","1","43","8.9","5.6"
"Monroe","2020-05-10","4","503","1","44","12.5","7.4"
"Monroe","2020-05-11","22","525","3","47","10","8.3"
"Monroe","2020-05-12","18","543","2","49","10.4","9.1"
"Monroe","2020-05-13","6","549","2","51","15.1","11"
"Monroe","2020-05-14","13","562","2","53","17.3","12.1"
"Monroe","2020-05-15","111","673","5","58","17.1","11.8"
"Monroe","2020-05-16","2","675","1","59","21.9","15.4"
"Monroe","2020-05-17","5","680","2","61","24","18.2"
"Monroe","2020-05-18","20","700","5","66","25.6","17.8"
"Monroe","2020-05-19","29","729","2","68","25","17.7"
"Monroe","2020-05-20","69","798","3","71","20.9","18"
"Monroe","2020-05-21","23","821","0","71","18.7","18"
"Monroe","2020-05-22","28","849","2","73","19.1","18.1"
"Monroe","2020-05-23","13","862","3","76","15.2","18.5"
"Monroe","2020-05-24","8","870","2","78","13.1","18.5"
"Monroe","2020-05-25","10","880","3","81","13.8","19.7"
"Monroe","2020-05-26","26","906","3","84","14.4","19.7"
"Monroe","2020-05-27","14","920","0","84","13.8","17.3"
"Monroe","2020-05-28","7","927","0","84","13.8","16.3"
"Monroe","2020-05-29","13","940","2","86","15","17"
"Monroe","2020-05-30","14","954","4","90","15.8","15.5"
"Monroe","2020-05-31","6","960","1","91","14.6","13.8"
"Monroe","2020-06-01","21","981","1","92","11","12.4"
"Monroe","2020-06-02","18","999","0","92","9.3","11.9"
"Monroe","2020-06-03","53","1052","2","94","9.9","11.9"
"Monroe","2020-06-04","21","1073","2","96","11.2","12.5"
"Monroe","2020-06-05","23","1096","0","96","9","12"
"Monroe","2020-06-06","4","1100","0","96","5","10.4"
"Monroe","2020-06-07","1","1101","0","96","2.6","8.6"
"Monroe","2020-06-08","24","1125","1","97","2.5","6.7"
"Monroe","2020-06-09","23","1148","0","97","2.5","5.9"
"Monroe","2020-06-10","44","1192","2","99","2.6","6.2"
"Monroe","2020-06-11","32","1224","4","103","3","7.1"
"Monroe","2020-06-12","30","1254","3","106","4.5","6.8"
"Monroe","2020-06-13","1","1255","0","106","4.5","4.7"
"Monroe","2020-06-14","2","1257","0","106","4.5","3.5"
"Monroe","2020-06-15","20","1277","1","107","4.6","3.5"
"Monroe","2020-06-16","33","1310","0","107","4.6","3.5"
"Monroe","2020-06-17","60","1370","2","109","4.4","3.5"
"Monroe","2020-06-18","26","1396","3","112","4.3","3.6"
"Monroe","2020-06-19","43","1439","8","120","5.5","5"
"Monroe","2020-06-20","15","1454","7","127","12.2","8.3"
"Monroe","2020-06-21","13","1467","0","127","12.2","8.3"
"Monroe","2020-06-22","63","1530","3","130","12.1","8.4"
"Monroe","2020-06-23","43","1573","2","132","12.8","8.7"
"Monroe","2020-06-24","75","1648","10","142","14.2","9.3"
"Monroe","2020-06-25","45","1693","5","147","14.2","9.2"
"Monroe","2020-06-26","33","1726","6","153","14.1","9.8"
"Monroe","2020-06-27","12","1738","2","155","9.8","11"
"Monroe","2020-06-28","11","1749","1","156","11.1","11.6"
"Monroe","2020-06-29","74","1823","5","161","11.4","11.8"
"Monroe","2020-06-30","89","1912","23","184","14.4","13.6"
"Monroe","2020-07-01","113","2025","12","196","14","14.1"
"Monroe","2020-07-02","69","2094","7","203","13.9","14"
"Monroe","2020-07-03","19","2113","3","206","13.6","13.8"
"Monroe","2020-07-04","10","2123","7","213","21.2","15.5"
"Monroe","2020-07-05","11","2134","2","215","22.5","16.8"
"Monroe","2020-07-06","115","2249","13","228","23.1","17.3"
"Monroe","2020-07-07","81","2330","12","240","21.6","18"
"Monroe","2020-07-08","104","2434","10","250","21.4","17.7"
"Monroe","2020-07-09","67","2501","14","264","22.9","18.4"
"Monroe","2020-07-10","70","2571","10","274","22.7","18.1"
"Monroe","2020-07-11","16","2587","5","279","17.2","19.2"
"Monroe","2020-07-12","15","2602","6","285","20.3","21.4"
"Monroe","2020-07-13","133","2735","42","327","23.2","23.2"
"Monroe","2020-07-14","62","2797","14","341","24.3","22.9"
"Monroe","2020-07-15","119","2916","12","353","24.4","22.9"
"Monroe","2020-07-16","45","2961","11","364","24.9","23.9"
"Monroe","2020-07-17","76","3037","8","372","24.4","23.5"
"Monroe","2020-07-18","15","3052","3","375","22.7","20"
"Monroe","2020-07-19","20","3072","5","380","20.6","20.5"
"Monroe","2020-07-20","53","3125","19","399","21.2","22.2"
"Monroe","2020-07-21","51","3176","9","408","20.5","22.4"
"Monroe","2020-07-22","82","3258","17","425","22","23.2"
"Monroe","2020-07-23","103","3361","11","436","20.1","22.5"
"Monroe","2020-07-24","81","3442","28","464","23.5","23.9"
"Monroe","2020-07-25","18","3460","4","468","23.8","23.3"
"Monroe","2020-07-26","25","3485","5","473","23.1","21.9"
"Monroe","2020-07-27","65","3550","11","484","20.4","20.8"
"Monroe","2020-07-28","50","3600","12","496","21.3","20.9"
"Monroe","2020-07-29","104","3704","9","505","19.6","20.8"
"Monroe","2020-07-30","46","3750","11","516","21.5","20.8"
"Monroe","2020-07-31","71","3821","14","530","19.3","21.4"
"Monroe","2020-08-01","21","3842","5","535","19.6","21.7"
"Monroe","2020-08-02","25","3867","2","537","17.9","20.5"
"Monroe","2020-08-03","53","3920","6","543","17.1","18.7"
"Monroe","2020-08-04","39","3959","3","546","14.7","18"
"Monroe","2020-08-05","69","4028","10","556","15.6","17.6"
"Monroe","2020-08-06","52","4080","5","561","13.5","17.5"
"Monroe","2020-08-07","101","4181","12","573","12.4","15.9"
"Monroe","2020-08-08","24","4205","7","580","13.2","16.4"
"Monroe","2020-08-09","78","4283","10","590","13.9","15.9"
"Monroe","2020-08-10","39","4322","8","598","15.2","16.1"
"Monroe","2020-08-11","42","4364","6","604","16.1","15.4"
"Monroe","2020-08-12","112","4476","17","621","16.2","15.9"
"Monroe","2020-08-13","47","4523","7","628","17","15.2"
"Monroe","2020-08-14","72","4595","6","634","16.5","14.4"
"Monroe","2020-08-15","73","4668","6","640","13.5","13.3"
"Monroe","2020-08-16","26","4694","8","648","16","14.9"
"Monroe","2020-08-17","43","4737","8","656","15.8","15.5"
"Monroe","2020-08-18","41","4778","5","661","15.5","15.8"
"Monroe","2020-08-19","63","4841","6","667","14.6","15.4"
"Monroe","2020-08-20","38","4879","5","672","14.4","15.7"
"Monroe","2020-08-21","47","4926","6","678","15","15.7"
"Monroe","2020-08-22","14","4940","3","681","16.9","15.2"
"Monroe","2020-08-23","30","4970","2","683","13.5","14.8"
"Monroe","2020-08-24","43","5013","5","688","12.5","14.1"
"Monroe","2020-08-25","47","5060","11","699","14.1","14.8"
"Monroe","2020-08-26","45","5105","5","704","14.3","14.5"
"Monroe","2020-08-27","27","5132","3","707","14","14.2"
"Monroe","2020-08-28","110","5242","15","722","14.1","14.6"
"Monroe","2020-08-29","62","5304","2","724","11.5","14.2"
"Monroe","2020-08-30","24","5328","0","724","10.6","12"
"Monroe","2020-08-31","47","5375","6","730","10.8","11.6"
"Monroe","2020-09-01","36","5411","3","733","8.6","11.3"
"Monroe","2020-09-02","67","5478","3","736","7.7","11"
"Monroe","2020-09-03","28","5506","3","739","7.6","10.8"
"Monroe","2020-09-04","80","5586","8","747","7.1","10.6"
"Monroe","2020-09-05","41","5627","2","749","7.3","9.4"
"Monroe","2020-09-06","16","5643","2","751","9.1","9.8"
"Monroe","2020-09-07","6","5649","2","753","12","11.4"
"Monroe","2020-09-08","27","5676","1","754","11.4","10"
"Monroe","2020-09-09","22","5698","5","759","14","10.8"
"Monroe","2020-09-10","44","5742","4","763","13.7","10.7"
"Monroe","2020-09-11","117","5859","1","764","12.4","9.8"
"Monroe","2020-09-12","32","5891","4","768","13.5","10.4"
"Monroe","2020-09-13","12","5903","3","771","15.3","12.2"
"Monroe","2020-09-14","24","5927","1","772","11.1","11.6"
"Monroe","2020-09-15","38","5965","4","776","12.1","11.7"
"Monroe","2020-09-16","58","6023","4","780","9.9","11.9"
"Monroe","2020-09-17","59","6082","3","783","9.3","11.5"
"Monroe","2020-09-18","30","6112","2","785","10.1","11.3"
"Monroe","2020-09-19","13","6125","3","788","11.6","12.6"
"Monroe","2020-09-20","10","6135","1","789","9.5","12.4"
"Monroe","2020-09-21","45","6180","6","795","10.8","11"
"Monroe","2020-09-22","43","6223","4","799","10.6","11.4"
"Monroe","2020-09-23","35","6258","2","801","10.5","10.2"
"Monroe","2020-09-24","43","6301","4","805","11.1","10.2"
"Monroe","2020-09-25","30","6331","0","805","10.1","10.1"
"Monroe","2020-09-26","22","6353","6","811","10.7","11.2"
"Monroe","2020-09-27","15","6368","1","812","10.2","9.9"
"Monroe","2020-09-28","33","6401","4","816","10.1","10.4"
"Monroe","2020-09-29","39","6440","1","817","9.1","9.9"
"Monroe","2020-09-30","36","6476","4","821","9.9","10.2"
"Monroe","2020-10-01","38","6514","3","824","9.7","10.4"
"Monroe","2020-10-02","38","6552","5","829","11.5","10.8"
"Monroe","2020-10-03","16","6568","3","832","10.3","10.5"
"Monroe","2020-10-04","11","6579","1","833","10.7","10.4"
"Monroe","2020-10-05","66","6645","6","839","10.2","10.1"
"Monroe","2020-10-06","134","6779","3","842","10.2","9.6"
"Monroe","2020-10-07","75","6854","3","845","9.2","9.5"
"Monroe","2020-10-08","46","6900","1","846","8.4","9"
"Monroe","2020-10-09","32","6932","3","849","7.8","9.7"
"Monroe","2020-10-10","34","6966","2","851","6","8.2"
"Monroe","2020-10-11","12","6978","1","852","5.9","8.3"
"Monroe","2020-10-12","37","7015","1","853","5","7.6"
"Monroe","2020-10-13","41","7056","3","856","5.7","7.9"
"Monroe","2020-10-14","31","7087","5","861","7.4","8.3"
"Monroe","2020-10-15","34","7121","5","866","9.2","8.8"
"Monroe","2020-10-16","26","7147","0","866","7.9","7.8"
"Monroe","2020-10-17","7","7154","1","867","9.1","7.5"
"Monroe","2020-10-18","6","7160","1","868","10.3","8.1"
"Monroe","2020-10-19","52","7212","3","871","10.7","7.8"
"Monroe","2020-10-20","45","7257","2","873","10.3","8"
"Monroe","2020-10-21","29","7286","3","876","9.5","8.4"
"Monroe","2020-10-22","29","7315","2","878","8.3","8.8"
"Monroe","2020-10-23","46","7361","3","881","9.3","8.6"
"Monroe","2020-10-24","11","7372","0","881","7.2","8.2"
"Monroe","2020-10-25","14","7386","4","885","8.9","9.6"
"Monroe","2020-10-26","48","7434","4","889","9.3","10"
"Monroe","2020-10-27","37","7471","2","891","9.4","9.9"
"Monroe","2020-10-28","51","7522","6","897","9.6","9.6"
"Monroe","2020-10-29","42","7564","3","900","9.7","9"
"Monroe","2020-10-30","34","7598","4","904","10.4","9.9"
"Monroe","2020-10-31","16","7614","4","908","14","10.6"
"Monroe","2020-11-01","6","7620","0","908","9.9","9.4"
"Monroe","2020-11-02","39","7659","7","915","11.3","10.3"
"Monroe","2020-11-03","44","7703","5","920","12.1","10.8"
"Monroe","2020-11-04","28","7731","1","921","11","10.3"
"Monroe","2020-11-05","34","7765","4","925","11.6","10.7"
"Monroe","2020-11-06","40","7805","3","928","11","10.7"
"Monroe","2020-11-07","15","7820","3","931","10.3","12.2"
"Monroe","2020-11-08","13","7833","3","934","13.6","11.8"
"Monroe","2020-11-09","46","7879","4","938","12.3","11.8"
"Monroe","2020-11-10","44","7923","6","944","12.6","12.4"
"Monroe","2020-11-11","46","7969","10","954","15.2","13.1"
"Monroe","2020-11-12","35","8004","3","957","14.7","13.2"
"Monroe","2020-11-13","49","8053","4","961","14.8","12.9"
"Monroe","2020-11-14","18","8071","3","964","14.4","12.3"
"Monroe","2020-11-15","13","8084","2","966","13.3","13.4"
"Monroe","2020-11-16","59","8143","8","974","14","13.1"
"Monroe","2020-11-17","43","8186","6","980","14","13.3"
"Monroe","2020-11-18","55","8241","6","986","12.5","13.8"
"Monroe","2020-11-19","50","8291","13","999","14.9","14.8"
"Monroe","2020-11-20","41","8332","7","1006","16.2","15.5"
"Monroe","2020-11-21","11","8343","3","1009","17.7","16.1"
"Monroe","2020-11-22","14","8357","4","1013","19.6","16.4"
"Monroe","2020-11-23","33","8390","3","1016","19","16.5"
"Monroe","2020-11-24","30","8420","5","1021","19.4","16.7"
"Monroe","2020-11-25","43","8463","11","1032","21.5","17"
"Monroe","2020-11-26","4","8467","1","1033","21.3","18.1"
"Monroe","2020-11-27","32","8499","7","1040","22","19.1"
"Monroe","2020-11-28","13","8512","1","1041","19.2","18.5"
"Monroe","2020-11-29","15","8527","2","1043","17","18.3"
"Monroe","2020-11-30","56","8583","13","1056","19.1","19"
"Monroe","2020-12-01","47","8630","10","1066","19.7","19.5"
"Monroe","2020-12-02","56","8686","10","1076","18.6","20"
"Monroe","2020-12-03","24","8710","2","1078","16.2","18.8"
"Monroe","2020-12-04","43","8753","3","1081","14.1","18.1"
"Monroe","2020-12-05","20","8773","4","1085","15.9","17.5"
"Monroe","2020-12-06","24","8797","6","1091","17.5","17.3"
"Monroe","2020-12-07","68","8865","12","1103","16.7","17.9"
"Monroe","2020-12-08","76","8941","15","1118","16.5","18.1"
"Monroe","2020-12-09","96","9037","18","1136","16.6","17.6"
"Monroe","2020-12-10","115","9152","15","1151","17.3","16.8"
"Monroe","2020-12-11","53","9205","15","1166","20.4","17.2"
"Monroe","2020-12-12","27","9232","5","1171","20.1","18"
"Monroe","2020-12-13","26","9258","4","1175","18.8","18.1"
"Monroe","2020-12-14","96","9354","16","1191","18.6","17.7"
"Monroe","2020-12-15","73","9427","18","1209","19.3","17.9"
"Monroe","2020-12-16","85","9512","14","1223","19","17.8"
"Monroe","2020-12-17","68","9580","18","1241","20.9","19.1"
"Monroe","2020-12-18","71","9651","10","1251","18.9","19.6"
"Monroe","2020-12-19","26","9677","11","1262","22.3","21.2"
"Monroe","2020-12-20","24","9701","5","1267","23.1","20.9"
"Monroe","2020-12-21","101","9802","30","1297","24.9","21.8"
"Monroe","2020-12-22","69","9871","19","1316","25.3","22.3"
"Monroe","2020-12-23","107","9978","27","1343","26.6","22.8"
"Monroe","2020-12-24","47","10025","15","1358","27.4","24.1"
"Monroe","2020-12-25","10","10035","4","1362","31.1","25"
"Monroe","2020-12-26","40","10075","11","1373","29","25.6"
"Monroe","2020-12-27","39","10114","13","1386","30.7","26.9"
"Monroe","2020-12-28","93","10207","24","1410","30.2","27.6"
"Monroe","2020-12-29","73","10280","10","1420","28.2","26.8"
"Monroe","2020-12-30","93","10373","21","1441","27.8","27.2"
"Monroe","2020-12-31","68","10441","17","1458","26.8","27.1"
"Monroe","2021-01-01","15","10456","3","1461","24","27.5"
"Monroe","2021-01-02","14","10470","3","1464","23.1","26"
"Monroe","2021-01-03","13","10483","5","1469","23.9","27.3"
"Monroe","2021-01-04","74","10557","19","1488","23.8","27"
"Monroe","2021-01-05","90","10647","15","1503","24.3","26.2"
"Monroe","2021-01-06","84","10731","20","1523","24.4","26.1"
"Monroe","2021-01-07","80","10811","14","1537","23.4","25.1"
"Monroe","2021-01-08","164","10975","19","1556","22.2","23.1"
"Monroe","2021-01-09","17","10992","4","1560","22.5","22.8"
"Monroe","2021-01-10","30","11022","5","1565","19.3","21.6"
"Monroe","2021-01-11","88","11110","24","1589","19.6","21.7"
"Monroe","2021-01-12","78","11188","11","1600","19.2","21.7"
"Monroe","2021-01-13","74","11262","14","1614","18.5","21.5"
"Monroe","2021-01-14","55","11317","7","1621","17.8","20.6"
"Monroe","2021-01-15","78","11395","15","1636","18.9","20.5"
"Monroe","2021-01-16","22","11417","2","1638","16.9","19.7"
"Monroe","2021-01-17","23","11440","5","1643","17.6","18.5"
"Monroe","2021-01-18","57","11497","13","1656","16.9","18.3"
"Monroe","2021-01-19","69","11566","15","1671","18","18.6"
"Monroe","2021-01-20","74","11640","7","1678","16.7","17.6"
"Monroe","2021-01-21","69","11709","10","1688","16.9","17.4"
"Monroe","2021-01-22","93","11802","18","1706","17","17.9"
"Monroe","2021-01-23","20","11822","5","1711","19.2","18"
"Monroe","2021-01-24","9","11831","1","1712","17.7","17.6"
"Monroe","2021-01-25","16","11847","1","1713","15.3","16.1"
"Monroe","2021-01-26","1","11848","0","1713","12.2","15.1"
"Monroe","2021-01-27","0","11848","0","1713","10.9","13.8"
"Montgomery","2020-02-01","0","0","0","0",".","."
"Montgomery","2020-02-02","0","0","0","0",".","."
"Montgomery","2020-02-03","0","0","0","0",".","."
"Montgomery","2020-02-04","0","0","0","0",".","."
"Montgomery","2020-02-05","0","0","0","0",".","."
"Montgomery","2020-02-06","0","0","0","0",".","."
"Montgomery","2020-02-07","0","0","0","0","0","."
"Montgomery","2020-02-08","0","0","0","0","0","."
"Montgomery","2020-02-09","0","0","0","0","0","."
"Montgomery","2020-02-10","0","0","0","0","0","."
"Montgomery","2020-02-11","0","0","0","0","0","."
"Montgomery","2020-02-12","0","0","0","0","0","."
"Montgomery","2020-02-13","0","0","0","0","0","."
"Montgomery","2020-02-14","0","0","0","0","0","0"
"Montgomery","2020-02-15","0","0","0","0","0","0"
"Montgomery","2020-02-16","0","0","0","0","0","0"
"Montgomery","2020-02-17","0","0","0","0","0","0"
"Montgomery","2020-02-18","0","0","0","0","0","0"
"Montgomery","2020-02-19","0","0","0","0","0","0"
"Montgomery","2020-02-20","0","0","0","0","0","0"
"Montgomery","2020-02-21","0","0","0","0","0","0"
"Montgomery","2020-02-22","0","0","0","0","0","0"
"Montgomery","2020-02-23","0","0","0","0","0","0"
"Montgomery","2020-02-24","0","0","0","0","0","0"
"Montgomery","2020-02-25","0","0","0","0","0","0"
"Montgomery","2020-02-26","0","0","0","0","0","0"
"Montgomery","2020-02-27","0","0","0","0","0","0"
"Montgomery","2020-02-28","0","0","0","0","0","0"
"Montgomery","2020-02-29","0","0","0","0","0","0"
"Montgomery","2020-03-01","0","0","0","0","0","0"
"Montgomery","2020-03-02","0","0","0","0","0","0"
"Montgomery","2020-03-03","0","0","0","0","0","0"
"Montgomery","2020-03-04","0","0","0","0","0","0"
"Montgomery","2020-03-05","0","0","0","0","0","0"
"Montgomery","2020-03-06","0","0","0","0","0","0"
"Montgomery","2020-03-07","0","0","0","0","0","0"
"Montgomery","2020-03-08","0","0","0","0","0","0"
"Montgomery","2020-03-09","0","0","0","0","0","0"
"Montgomery","2020-03-10","0","0","0","0","0","0"
"Montgomery","2020-03-11","0","0","0","0","0","0"
"Montgomery","2020-03-12","0","0","0","0","0","0"
"Montgomery","2020-03-13","0","0","0","0","0","0"
"Montgomery","2020-03-14","0","0","0","0","0","0"
"Montgomery","2020-03-15","0","0","0","0","0","0"
"Montgomery","2020-03-16","1","1","0","0","0","0"
"Montgomery","2020-03-17","5","6","0","0","0","0"
"Montgomery","2020-03-18","0","6","0","0","0","0"
"Montgomery","2020-03-19","0","6","0","0","0","0"
"Montgomery","2020-03-20","2","8","0","0","0","0"
"Montgomery","2020-03-21","0","8","0","0","0","0"
"Montgomery","2020-03-22","0","8","0","0","0","0"
"Montgomery","2020-03-23","0","8","0","0","0","0"
"Montgomery","2020-03-24","2","10","0","0","0","0"
"Montgomery","2020-03-25","2","12","0","0","0","0"
"Montgomery","2020-03-26","1","13","0","0","0","0"
"Montgomery","2020-03-27","0","13","0","0","0","0"
"Montgomery","2020-03-28","0","13","0","0","0","0"
"Montgomery","2020-03-29","0","13","0","0","0","0"
"Montgomery","2020-03-30","1","14","0","0","0","0"
"Montgomery","2020-03-31","0","14","0","0","0","0"
"Montgomery","2020-04-01","0","14","0","0","0","0"
"Montgomery","2020-04-02","0","14","0","0","0","0"
"Montgomery","2020-04-03","0","14","0","0","0","0"
"Montgomery","2020-04-04","0","14","0","0","0","0"
"Montgomery","2020-04-05","1","15","0","0","0","0"
"Montgomery","2020-04-06","0","15","0","0","0","0"
"Montgomery","2020-04-07","3","18","1","1","4.8","2.4"
"Montgomery","2020-04-08","4","22","0","1","4.8","2.4"
"Montgomery","2020-04-09","0","22","0","1","4.8","2.4"
"Montgomery","2020-04-10","4","26","1","2","8.3","4.2"
"Montgomery","2020-04-11","3","29","0","2","8.3","4.2"
"Montgomery","2020-04-12","0","29","0","2","8.3","4.2"
"Montgomery","2020-04-13","0","29","0","2","8.3","4.2"
"Montgomery","2020-04-14","0","29","0","2","3.6","4.2"
"Montgomery","2020-04-15","2","31","1","3","10.7","7.7"
"Montgomery","2020-04-16","1","32","0","3","10.7","7.7"
"Montgomery","2020-04-17","1","33","0","3","7.1","7.7"
"Montgomery","2020-04-18","1","34","1","4","21.4","14.9"
"Montgomery","2020-04-19","1","35","0","4","21.4","14.9"
"Montgomery","2020-04-20","3","38","0","4","21.4","14.9"
"Montgomery","2020-04-21","1","39","0","4","21.4","12.5"
"Montgomery","2020-04-22","2","41","0","4","14.3","12.5"
"Montgomery","2020-04-23","3","44","1","5","19","14.9"
"Montgomery","2020-04-24","2","46","0","5","19","13.1"
"Montgomery","2020-04-25","0","46","0","5","4.8","13.1"
"Montgomery","2020-04-26","0","46","0","5","4.8","13.1"
"Montgomery","2020-04-27","4","50","0","5","4.8","13.1"
"Montgomery","2020-04-28","3","53","0","5","4.8","13.1"
"Montgomery","2020-04-29","3","56","0","5","4.8","9.5"
"Montgomery","2020-04-30","1","57","0","5","0","9.5"
"Montgomery","2020-05-01","4","61","1","6","3.6","11.3"
"Montgomery","2020-05-02","0","61","0","6","3.6","4.2"
"Montgomery","2020-05-03","1","62","1","7","17.9","11.3"
"Montgomery","2020-05-04","2","64","0","7","17.9","11.3"
"Montgomery","2020-05-05","3","67","0","7","17.9","11.3"
"Montgomery","2020-05-06","5","72","0","7","17.9","11.3"
"Montgomery","2020-05-07","6","78","3","10","25","12.5"
"Montgomery","2020-05-08","4","82","0","10","21.4","12.5"
"Montgomery","2020-05-09","4","86","0","10","21.4","12.5"
"Montgomery","2020-05-10","1","87","0","10","7.1","12.5"
"Montgomery","2020-05-11","1","88","0","10","7.1","12.5"
"Montgomery","2020-05-12","5","93","1","11","10","13.9"
"Montgomery","2020-05-13","2","95","0","11","10","13.9"
"Montgomery","2020-05-14","0","95","0","11","2.9","13.9"
"Montgomery","2020-05-15","1","96","0","11","2.9","12.1"
"Montgomery","2020-05-16","0","96","0","11","2.9","12.1"
"Montgomery","2020-05-17","0","96","0","11","2.9","5"
"Montgomery","2020-05-18","3","99","0","11","2.9","5"
"Montgomery","2020-05-19","5","104","1","12","2.9","6.4"
"Montgomery","2020-05-20","2","106","0","12","2.9","6.4"
"Montgomery","2020-05-21","3","109","0","12","2.9","2.9"
"Montgomery","2020-05-22","2","111","0","12","2.9","2.9"
"Montgomery","2020-05-23","1","112","0","12","2.9","2.9"
"Montgomery","2020-05-24","0","112","0","12","2.9","2.9"
"Montgomery","2020-05-25","3","115","1","13","7.6","5.2"
"Montgomery","2020-05-26","4","119","0","13","4.8","3.8"
"Montgomery","2020-05-27","10","129","0","13","4.8","3.8"
"Montgomery","2020-05-28","7","136","0","13","4.8","3.8"
"Montgomery","2020-05-29","2","138","0","13","4.8","3.8"
"Montgomery","2020-05-30","5","143","0","13","4.8","3.8"
"Montgomery","2020-05-31","0","143","0","13","4.8","3.8"
"Montgomery","2020-06-01","13","156","1","14","1.1","4.4"
"Montgomery","2020-06-02","8","164","3","17","6.5","5.6"
"Montgomery","2020-06-03","11","175","0","17","6.5","5.6"
"Montgomery","2020-06-04","5","180","0","17","6.5","5.6"
"Montgomery","2020-06-05","1","181","1","18","20.7","12.8"
"Montgomery","2020-06-06","7","188","1","19","22.8","13.8"
"Montgomery","2020-06-07","1","189","0","19","22.8","13.8"
"Montgomery","2020-06-08","9","198","2","21","24.9","13"
"Montgomery","2020-06-09","9","207","1","22","21.1","13.8"
"Montgomery","2020-06-10","10","217","0","22","21.1","13.8"
"Montgomery","2020-06-11","7","224","2","24","25.2","15.8"
"Montgomery","2020-06-12","4","228","0","24","10.9","15.8"
"Montgomery","2020-06-13","3","231","1","25","13.6","18.2"
"Montgomery","2020-06-14","2","233","0","25","13.6","18.2"
"Montgomery","2020-06-15","12","245","0","25","10.4","17.6"
"Montgomery","2020-06-16","11","256","2","27","11.4","16.3"
"Montgomery","2020-06-17","4","260","0","27","11.4","16.3"
"Montgomery","2020-06-18","3","263","0","27","7.4","16.3"
"Montgomery","2020-06-19","0","263","0","27","7.4","9.1"
"Montgomery","2020-06-20","2","265","0","27","2.6","8.1"
"Montgomery","2020-06-21","0","265","0","27","2.6","8.1"
"Montgomery","2020-06-22","7","272","2","29","6.7","8.6"
"Montgomery","2020-06-23","9","281","2","31","7.3","9.3"
"Montgomery","2020-06-24","11","292","1","32","8.6","10"
"Montgomery","2020-06-25","13","305","0","32","8.6","8"
"Montgomery","2020-06-26","9","314","1","33","10.1","8.8"
"Montgomery","2020-06-27","4","318","0","33","10.1","6.4"
"Montgomery","2020-06-28","3","321","1","34","14.9","8.8"
"Montgomery","2020-06-29","11","332","1","35","12.1","9.4"
"Montgomery","2020-06-30","12","344","6","41","16.1","11.7"
"Montgomery","2020-07-01","14","358","3","44","17.9","13.2"
"Montgomery","2020-07-02","9","367","3","47","22.6","15.6"
"Montgomery","2020-07-03","6","373","0","47","21","15.6"
"Montgomery","2020-07-04","1","374","0","47","21","15.6"
"Montgomery","2020-07-05","3","377","1","48","21","18"
"Montgomery","2020-07-06","17","394","3","51","22.2","17.2"
"Montgomery","2020-07-07","16","410","3","54","17.8","16.9"
"Montgomery","2020-07-08","13","423","5","59","20.2","19"
"Montgomery","2020-07-09","10","433","4","63","21.2","21.9"
"Montgomery","2020-07-10","12","445","4","67","25.9","23.5"
"Montgomery","2020-07-11","3","448","2","69","35.5","28.2"
"Montgomery","2020-07-12","9","457","0","69","30.7","25.9"
"Montgomery","2020-07-13","15","472","0","69","28.2","25.2"
"Montgomery","2020-07-14","22","494","4","73","28.1","22.9"
"Montgomery","2020-07-15","9","503","2","75","25.8","23"
"Montgomery","2020-07-16","10","513","5","80","27.2","24.2"
"Montgomery","2020-07-17","5","518","2","82","28.2","27"
"Montgomery","2020-07-18","8","526","3","85","24","29.7"
"Montgomery","2020-07-19","8","534","5","90","32.9","31.8"
"Montgomery","2020-07-20","12","546","5","95","38.9","33.5"
"Montgomery","2020-07-21","12","558","6","101","43.4","35.8"
"Montgomery","2020-07-22","15","573","2","103","42.1","34"
"Montgomery","2020-07-23","20","593","1","104","35.7","31.5"
"Montgomery","2020-07-24","10","603","2","106","32.9","30.5"
"Montgomery","2020-07-25","2","605","0","106","27.5","25.7"
"Montgomery","2020-07-26","3","608","1","107","23.3","28.1"
"Montgomery","2020-07-27","13","621","4","111","21.8","30.3"
"Montgomery","2020-07-28","14","635","4","115","18.7","31.1"
"Montgomery","2020-07-29","13","648","2","117","19","30.6"
"Montgomery","2020-07-30","11","659","2","119","20.9","28.3"
"Montgomery","2020-07-31","11","670","3","122","21.9","27.4"
"Montgomery","2020-08-01","4","674","1","123","25.5","26.5"
"Montgomery","2020-08-02","11","685","7","130","29.8","26.6"
"Montgomery","2020-08-03","15","700","5","135","30.2","26"
"Montgomery","2020-08-04","11","711","2","137","28.7","23.7"
"Montgomery","2020-08-05","13","724","4","141","30.9","25"
"Montgomery","2020-08-06","9","733","1","142","29.9","25.4"
"Montgomery","2020-08-07","14","747","0","142","26","24"
"Montgomery","2020-08-08","9","756","2","144","25.6","25.6"
"Montgomery","2020-08-09","7","763","2","146","20.6","25.2"
"Montgomery","2020-08-10","8","771","1","147","17.6","23.9"
"Montgomery","2020-08-11","12","783","3","150","18.6","23.7"
"Montgomery","2020-08-12","16","799","3","153","16.9","23.9"
"Montgomery","2020-08-13","11","810","2","155","17.9","23.9"
"Montgomery","2020-08-14","5","815","1","156","20.7","23.4"
"Montgomery","2020-08-15","8","823","3","159","22.9","24.3"
"Montgomery","2020-08-16","2","825","0","159","18.8","19.7"
"Montgomery","2020-08-17","9","834","1","160","18.6","18.1"
"Montgomery","2020-08-18","13","847","2","162","17.3","17.9"
"Montgomery","2020-08-19","19","866","3","165","16.9","16.9"
"Montgomery","2020-08-20","9","875","0","165","14.3","16.1"
"Montgomery","2020-08-21","25","900","2","167","12.5","16.6"
"Montgomery","2020-08-22","10","910","0","167","7.2","15.1"
"Montgomery","2020-08-23","4","914","1","168","10.8","14.8"
"Montgomery","2020-08-24","13","927","0","168","9.2","13.9"
"Montgomery","2020-08-25","20","947","4","172","9.8","13.6"
"Montgomery","2020-08-26","6","953","1","173","10","13.4"
"Montgomery","2020-08-27","16","969","3","176","12.6","13.4"
"Montgomery","2020-08-28","9","978","4","180","17.8","15.2"
"Montgomery","2020-08-29","12","990","6","186","25","16.1"
"Montgomery","2020-08-30","7","997","1","187","23.4","17.1"
"Montgomery","2020-08-31","10","1007","4","191","29.2","19.2"
"Montgomery","2020-09-01","13","1020","2","193","28.5","19.2"
"Montgomery","2020-09-02","51","1071","1","194","26.4","18.2"
"Montgomery","2020-09-03","8","1079","1","195","25.5","19.1"
"Montgomery","2020-09-04","10","1089","8","203","30.6","24.2"
"Montgomery","2020-09-05","4","1093","2","205","30.6","27.8"
"Montgomery","2020-09-06","4","1097","1","206","32.1","27.8"
"Montgomery","2020-09-07","4","1101","1","207","30","29.6"
"Montgomery","2020-09-08","8","1109","2","209","31.4","29.9"
"Montgomery","2020-09-09","47","1156","4","213","32.3","29.3"
"Montgomery","2020-09-10","10","1166","3","216","34.8","30.1"
"Montgomery","2020-09-11","11","1177","4","220","28.6","29.6"
"Montgomery","2020-09-12","5","1182","1","221","24.3","27.4"
"Montgomery","2020-09-13","2","1184","0","221","20.7","26.4"
"Montgomery","2020-09-14","13","1197","2","223","19.3","24.7"
"Montgomery","2020-09-15","17","1214","7","230","21.6","26.5"
"Montgomery","2020-09-16","51","1265","11","241","23.5","27.9"
"Montgomery","2020-09-17","16","1281","0","241","19.2","27"
"Montgomery","2020-09-18","8","1289","3","244","19.4","24"
"Montgomery","2020-09-19","8","1297","1","245","18.3","21.3"
"Montgomery","2020-09-20","0","1297","0","245","18.3","19.5"
"Montgomery","2020-09-21","17","1314","2","247","17.8","18.6"
"Montgomery","2020-09-22","2","1316","1","248","19","20.3"
"Montgomery","2020-09-23","40","1356","7","255","18.5","21"
"Montgomery","2020-09-24","12","1368","1","256","19.7","19.4"
"Montgomery","2020-09-25","7","1375","1","257","16.3","17.9"
"Montgomery","2020-09-26","0","1375","0","257","14.6","16.4"
"Montgomery","2020-09-27","0","1375","0","257","14.6","16.4"
"Montgomery","2020-09-28","7","1382","0","257","12.9","15.3"
"Montgomery","2020-09-29","10","1392","1","258","7.2","13.1"
"Montgomery","2020-09-30","51","1443","11","269","7.7","13.1"
"Montgomery","2020-10-01","12","1455","1","270","7.7","13.7"
"Montgomery","2020-10-02","18","1473","3","273","8.1","12.2"
"Montgomery","2020-10-03","7","1480","1","274","10.1","12.3"
"Montgomery","2020-10-04","3","1483","2","276","19.6","17.1"
"Montgomery","2020-10-05","13","1496","5","281","25.1","19"
"Montgomery","2020-10-06","7","1503","0","281","23.7","15.4"
"Montgomery","2020-10-07","48","1551","12","293","24.2","16"
"Montgomery","2020-10-08","21","1572","1","294","23.7","15.7"
"Montgomery","2020-10-09","7","1579","0","294","21.3","14.7"
"Montgomery","2020-10-10","6","1585","2","296","24","17.1"
"Montgomery","2020-10-11","6","1591","1","297","16.9","18.3"
"Montgomery","2020-10-12","13","1604","1","298","12.5","18.8"
"Montgomery","2020-10-13","15","1619","3","301","15.4","19.5"
"Montgomery","2020-10-14","24","1643","2","303","13","18.6"
"Montgomery","2020-10-15","5","1648","1","304","15.1","19.4"
"Montgomery","2020-10-16","8","1656","1","305","16.9","19.1"
"Montgomery","2020-10-17","11","1667","2","307","14.8","19.4"
"Montgomery","2020-10-18","1","1668","0","307","12.4","14.6"
"Montgomery","2020-10-19","14","1682","1","308","12.3","12.4"
"Montgomery","2020-10-20","7","1689","1","309","11.5","13.4"
"Montgomery","2020-10-21","35","1724","1","310","10.7","11.8"
"Montgomery","2020-10-22","36","1760","17","327","14.6","14.9"
"Montgomery","2020-10-23","9","1769","1","328","14.4","15.7"
"Montgomery","2020-10-24","19","1788","1","329","12.6","13.7"
"Montgomery","2020-10-25","3","1791","0","329","12.6","12.5"
"Montgomery","2020-10-26","7","1798","2","331","15.6","14"
"Montgomery","2020-10-27","10","1808","2","333","16.4","14"
"Montgomery","2020-10-28","47","1855","1","334","16.3","13.5"
"Montgomery","2020-10-29","8","1863","1","335","11.4","13"
"Montgomery","2020-10-30","5","1868","0","335","9.8","12.1"
"Montgomery","2020-10-31","3","1871","1","336","13.8","13.2"
"Montgomery","2020-11-01","6","1877","3","339","20.9","16.7"
"Montgomery","2020-11-02","13","1890","0","339","16.9","16.2"
"Montgomery","2020-11-03","10","1900","1","340","15.4","15.9"
"Montgomery","2020-11-04","31","1931","1","341","15.6","16"
"Montgomery","2020-11-05","7","1938","2","343","17.9","14.6"
"Montgomery","2020-11-06","10","1948","0","343","17.9","13.8"
"Montgomery","2020-11-07","5","1953","0","343","13.1","13.5"
"Montgomery","2020-11-08","0","1953","0","343","6","13.5"
"Montgomery","2020-11-09","15","1968","3","346","8.8","12.8"
"Montgomery","2020-11-10","16","1984","3","349","10.1","12.8"
"Montgomery","2020-11-11","5","1989","1","350","12.5","14"
"Montgomery","2020-11-12","9","1998","1","351","10","13.9"
"Montgomery","2020-11-13","11","2009","1","352","11.3","14.6"
"Montgomery","2020-11-14","5","2014","1","353","14.1","13.6"
"Montgomery","2020-11-15","3","2017","1","354","18.9","12.4"
"Montgomery","2020-11-16","16","2033","2","356","17.8","13.3"
"Montgomery","2020-11-17","19","2052","1","357","15.9","13"
"Montgomery","2020-11-18","48","2100","4","361","14.2","13.4"
"Montgomery","2020-11-19","20","2120","0","361","12.6","11.3"
"Montgomery","2020-11-20","11","2131","0","361","11.3","11.3"
"Montgomery","2020-11-21","5","2136","0","361","8.5","11.3"
"Montgomery","2020-11-22","4","2140","1","362","7.3","13.1"
"Montgomery","2020-11-23","19","2159","4","366","8.5","13.2"
"Montgomery","2020-11-24","12","2171","0","366","7.8","11.8"
"Montgomery","2020-11-25","38","2209","4","370","8.1","11.2"
"Montgomery","2020-11-26","3","2212","1","371","12.8","12.7"
"Montgomery","2020-11-27","9","2221","1","372","14.4","12.9"
"Montgomery","2020-11-28","9","2230","0","372","14.4","11.5"
"Montgomery","2020-11-29","10","2240","2","374","13.7","10.5"
"Montgomery","2020-11-30","14","2254","1","375","11.7","10.1"
"Montgomery","2020-12-01","29","2283","0","375","11.7","9.7"
"Montgomery","2020-12-02","27","2310","2","377","11.3","9.7"
"Montgomery","2020-12-03","18","2328","2","379","8.1","10.5"
"Montgomery","2020-12-04","11","2339","3","382","10.4","12.4"
"Montgomery","2020-12-05","9","2348","2","384","13.6","14"
"Montgomery","2020-12-06","7","2355","3","387","16.9","15.3"
"Montgomery","2020-12-07","9","2364","0","387","15.8","13.8"
"Montgomery","2020-12-08","12","2376","1","388","17","14.4"
"Montgomery","2020-12-09","46","2422","3","391","16.9","14.1"
"Montgomery","2020-12-10","18","2440","1","392","16.1","12.1"
"Montgomery","2020-12-11","12","2452","1","393","13.4","11.9"
"Montgomery","2020-12-12","3","2455","1","394","15","14.3"
"Montgomery","2020-12-13","12","2467","0","394","8.9","12.9"
"Montgomery","2020-12-14","14","2481","1","395","9.9","12.9"
"Montgomery","2020-12-15","28","2509","5","400","11.2","14.1"
"Montgomery","2020-12-16","77","2586","16","416","13.3","15.1"
"Montgomery","2020-12-17","79","2665","7","423","13.8","14.9"
"Montgomery","2020-12-18","25","2690","9","432","17.7","15.6"
"Montgomery","2020-12-19","13","2703","3","435","16.2","15.6"
"Montgomery","2020-12-20","16","2719","7","442","22.5","15.7"
"Montgomery","2020-12-21","25","2744","8","450","26","18"
"Montgomery","2020-12-22","37","2781","6","456","25.8","18.5"
"Montgomery","2020-12-23","79","2860","16","472","25.7","19.5"
"Montgomery","2020-12-24","13","2873","4","476","28.9","21.3"
"Montgomery","2020-12-25","3","2876","2","478","33.2","25.5"
"Montgomery","2020-12-26","9","2885","6","484","39.5","27.9"
"Montgomery","2020-12-27","13","2898","6","490","39.8","31.2"
"Montgomery","2020-12-28","26","2924","11","501","41.3","33.7"
"Montgomery","2020-12-29","32","2956","13","514","44.8","35.3"
"Montgomery","2020-12-30","115","3071","25","539","45","35.4"
"Montgomery","2020-12-31","20","3091","10","549","47.7","38.3"
"Montgomery","2021-01-01","4","3095","3","552","48.9","41.1"
"Montgomery","2021-01-02","10","3105","6","558","48","43.7"
"Montgomery","2021-01-03","5","3110","3","561","50","44.9"
"Montgomery","2021-01-04","12","3122","4","565","48.7","45"
"Montgomery","2021-01-05","45","3167","11","576","46.4","45.6"
"Montgomery","2021-01-06","97","3264","11","587","44.9","44.9"
"Montgomery","2021-01-07","18","3282","4","591","40.9","44.3"
"Montgomery","2021-01-08","20","3302","8","599","35.9","42.4"
"Montgomery","2021-01-09","14","3316","1","600","28.4","38.2"
"Montgomery","2021-01-10","15","3331","3","603","22.6","36.3"
"Montgomery","2021-01-11","27","3358","11","614","23.7","36.2"
"Montgomery","2021-01-12","15","3373","4","618","24","35.2"
"Montgomery","2021-01-13","14","3387","2","620","24.4","34.7"
"Montgomery","2021-01-14","12","3399","1","621","22.5","31.7"
"Montgomery","2021-01-15","20","3419","3","624","18.9","27.4"
"Montgomery","2021-01-16","4","3423","1","625","21.4","24.9"
"Montgomery","2021-01-17","3","3426","1","626","23.3","23"
"Montgomery","2021-01-18","12","3438","2","628","19.9","21.8"
"Montgomery","2021-01-19","14","3452","2","630","18.1","21.1"
"Montgomery","2021-01-20","102","3554","15","645","18.2","21.3"
"Montgomery","2021-01-21","22","3576","4","649","19.6","21"
"Montgomery","2021-01-22","15","3591","4","653","21.3","20.1"
"Montgomery","2021-01-23","8","3599","1","654","19.5","20.5"
"Montgomery","2021-01-24","1","3600","0","654","14.7","19"
"Montgomery","2021-01-25","3","3603","1","655","17.1","18.5"
"Montgomery","2021-01-26","4","3607","0","655","15.1","16.6"
"Montgomery","2021-01-27","0","3607","0","655","13","15.6"
"Morgan","2020-02-01","0","0","0","0",".","."
"Morgan","2020-02-02","0","0","0","0",".","."
"Morgan","2020-02-03","0","0","0","0",".","."
"Morgan","2020-02-04","0","0","0","0",".","."
"Morgan","2020-02-05","0","0","0","0",".","."
"Morgan","2020-02-06","0","0","0","0",".","."
"Morgan","2020-02-07","0","0","0","0","0","."
"Morgan","2020-02-08","0","0","0","0","0","."
"Morgan","2020-02-09","0","0","0","0","0","."
"Morgan","2020-02-10","0","0","0","0","0","."
"Morgan","2020-02-11","0","0","0","0","0","."
"Morgan","2020-02-12","0","0","0","0","0","."
"Morgan","2020-02-13","0","0","0","0","0","."
"Morgan","2020-02-14","0","0","0","0","0","0"
"Morgan","2020-02-15","0","0","0","0","0","0"
"Morgan","2020-02-16","0","0","0","0","0","0"
"Morgan","2020-02-17","0","0","0","0","0","0"
"Morgan","2020-02-18","0","0","0","0","0","0"
"Morgan","2020-02-19","0","0","0","0","0","0"
"Morgan","2020-02-20","0","0","0","0","0","0"
"Morgan","2020-02-21","0","0","0","0","0","0"
"Morgan","2020-02-22","0","0","0","0","0","0"
"Morgan","2020-02-23","0","0","0","0","0","0"
"Morgan","2020-02-24","0","0","0","0","0","0"
"Morgan","2020-02-25","0","0","0","0","0","0"
"Morgan","2020-02-26","0","0","0","0","0","0"
"Morgan","2020-02-27","0","0","0","0","0","0"
"Morgan","2020-02-28","0","0","0","0","0","0"
"Morgan","2020-02-29","0","0","0","0","0","0"
"Morgan","2020-03-01","0","0","0","0","0","0"
"Morgan","2020-03-02","0","0","0","0","0","0"
"Morgan","2020-03-03","0","0","0","0","0","0"
"Morgan","2020-03-04","0","0","0","0","0","0"
"Morgan","2020-03-05","0","0","0","0","0","0"
"Morgan","2020-03-06","0","0","0","0","0","0"
"Morgan","2020-03-07","0","0","0","0","0","0"
"Morgan","2020-03-08","0","0","0","0","0","0"
"Morgan","2020-03-09","0","0","0","0","0","0"
"Morgan","2020-03-10","0","0","0","0","0","0"
"Morgan","2020-03-11","0","0","0","0","0","0"
"Morgan","2020-03-12","8","8","0","0","0","0"
"Morgan","2020-03-13","5","13","0","0","0","0"
"Morgan","2020-03-14","0","13","0","0","0","0"
"Morgan","2020-03-15","0","13","0","0","0","0"
"Morgan","2020-03-16","3","16","0","0","0","0"
"Morgan","2020-03-17","10","26","1","1","1.4","0.7"
"Morgan","2020-03-18","4","30","0","1","1.4","0.7"
"Morgan","2020-03-19","7","37","0","1","1.4","0.7"
"Morgan","2020-03-20","11","48","0","1","1.4","0.7"
"Morgan","2020-03-21","6","54","0","1","1.4","0.7"
"Morgan","2020-03-22","10","64","0","1","1.4","0.7"
"Morgan","2020-03-23","8","72","1","2","3.2","1.6"
"Morgan","2020-03-24","17","89","0","2","1.8","1.6"
"Morgan","2020-03-25","13","102","0","2","1.8","1.6"
"Morgan","2020-03-26","6","108","1","3","4.2","2.8"
"Morgan","2020-03-27","10","118","1","4","5.6","3.5"
"Morgan","2020-03-28","2","120","1","5","12.7","7.1"
"Morgan","2020-03-29","10","130","0","5","12.7","7.1"
"Morgan","2020-03-30","22","152","1","6","11.6","7.4"
"Morgan","2020-03-31","6","158","0","6","11.6","6.7"
"Morgan","2020-04-01","17","175","1","7","12.4","7.1"
"Morgan","2020-04-02","11","186","1","8","11.4","7.8"
"Morgan","2020-04-03","9","195","1","9","11.5","8.6"
"Morgan","2020-04-04","6","201","0","9","4.4","8.6"
"Morgan","2020-04-05","0","201","0","9","4.4","8.6"
"Morgan","2020-04-06","6","207","0","9","3.7","7.7"
"Morgan","2020-04-07","27","234","4","13","5.8","8.7"
"Morgan","2020-04-08","29","263","0","13","5","8.7"
"Morgan","2020-04-09","23","286","1","14","4.3","7.8"
"Morgan","2020-04-10","23","309","0","14","2.7","7.1"
"Morgan","2020-04-11","13","322","2","16","4.9","4.7"
"Morgan","2020-04-12","2","324","0","16","4.9","4.7"
"Morgan","2020-04-13","15","339","1","17","5.9","4.8"
"Morgan","2020-04-14","19","358","4","21","6.8","6.3"
"Morgan","2020-04-15","10","368","0","21","6.8","5.9"
"Morgan","2020-04-16","12","380","3","24","9.7","7"
"Morgan","2020-04-17","15","395","0","24","9.7","6.2"
"Morgan","2020-04-18","8","403","0","24","7.5","6.2"
"Morgan","2020-04-19","2","405","0","24","7.5","6.2"
"Morgan","2020-04-20","9","414","0","24","6.6","6.2"
"Morgan","2020-04-21","10","424","0","24","3.6","5.2"
"Morgan","2020-04-22","18","442","1","25","4.4","5.6"
"Morgan","2020-04-23","15","457","1","26","1.7","5.7"
"Morgan","2020-04-24","7","464","0","26","1.7","5.7"
"Morgan","2020-04-25","3","467","0","26","1.7","4.6"
"Morgan","2020-04-26","4","471","0","26","1.7","4.6"
"Morgan","2020-04-27","30","501","2","28","2.7","4.6"
"Morgan","2020-04-28","17","518","1","29","3.5","3.6"
"Morgan","2020-04-29","25","543","0","29","2.7","3.6"
"Morgan","2020-04-30","16","559","2","31","3.6","2.7"
"Morgan","2020-05-01","26","585","3","34","5.2","3.5"
"Morgan","2020-05-02","11","596","3","37","9.1","5.4"
"Morgan","2020-05-03","8","604","1","38","10.9","6.3"
"Morgan","2020-05-04","25","629","1","39","10.5","6.6"
"Morgan","2020-05-05","42","671","4","43","11","7.3"
"Morgan","2020-05-06","34","705","0","43","11","6.9"
"Morgan","2020-05-07","15","720","1","44","10.2","6.9"
"Morgan","2020-05-08","16","736","0","44","8.6","6.9"
"Morgan","2020-05-09","12","748","1","45","5.9","7.5"
"Morgan","2020-05-10","2","750","0","45","4.1","7.5"
"Morgan","2020-05-11","29","779","0","45","3.5","7"
"Morgan","2020-05-12","19","798","1","46","2.9","7"
"Morgan","2020-05-13","25","823","4","50","5.2","8.1"
"Morgan","2020-05-14","15","838","0","50","4.2","7.2"
"Morgan","2020-05-15","13","851","1","51","5.3","6.9"
"Morgan","2020-05-16","6","857","0","51","4.1","5"
"Morgan","2020-05-17","3","860","0","51","4.1","4.1"
"Morgan","2020-05-18","17","877","5","56","8.3","5.9"
"Morgan","2020-05-19","18","895","0","56","7.6","5.2"
"Morgan","2020-05-20","34","929","2","58","6.1","5.7"
"Morgan","2020-05-21","29","958","0","58","6.1","5.2"
"Morgan","2020-05-22","11","969","0","58","5","5.2"
"Morgan","2020-05-23","3","972","0","58","5","4.6"
"Morgan","2020-05-24","5","977","0","58","5","4.6"
"Morgan","2020-05-25","6","983","0","58","0.8","4.6"
"Morgan","2020-05-26","12","995","1","59","2","4.8"
"Morgan","2020-05-27","29","1024","0","59","1.2","3.7"
"Morgan","2020-05-28","29","1053","2","61","2.2","4.2"
"Morgan","2020-05-29","15","1068","0","61","2.2","3.6"
"Morgan","2020-05-30","5","1073","0","61","2.2","3.6"
"Morgan","2020-05-31","7","1080","0","61","2.2","3.6"
"Morgan","2020-06-01","19","1099","0","61","2.2","1.5"
"Morgan","2020-06-02","13","1112","0","61","1","1.5"
"Morgan","2020-06-03","16","1128","0","61","1","1.1"
"Morgan","2020-06-04","27","1155","0","61","0","1.1"
"Morgan","2020-06-05","27","1182","0","61","0","1.1"
"Morgan","2020-06-06","4","1186","0","61","0","1.1"
"Morgan","2020-06-07","3","1189","0","61","0","1.1"
"Morgan","2020-06-08","18","1207","0","61","0","1.1"
"Morgan","2020-06-09","22","1229","1","62","0.6","0.8"
"Morgan","2020-06-10","14","1243","1","63","1.7","1.3"
"Morgan","2020-06-11","23","1266","2","65","2.9","1.5"
"Morgan","2020-06-12","19","1285","0","65","2.9","1.5"
"Morgan","2020-06-13","1","1286","0","65","2.9","1.5"
"Morgan","2020-06-14","10","1296","0","65","2.9","1.5"
"Morgan","2020-06-15","26","1322","2","67","4","2"
"Morgan","2020-06-16","14","1336","1","68","4.4","2.5"
"Morgan","2020-06-17","21","1357","0","68","3.4","2.5"
"Morgan","2020-06-18","28","1385","0","68","2.1","2.5"
"Morgan","2020-06-19","24","1409","0","68","2.1","2.5"
"Morgan","2020-06-20","13","1422","0","68","2.1","2.5"
"Morgan","2020-06-21","10","1432","1","69","3.5","3.2"
"Morgan","2020-06-22","26","1458","0","69","2.4","3.2"
"Morgan","2020-06-23","28","1486","2","71","2.4","3.4"
"Morgan","2020-06-24","42","1528","2","73","3.1","3.2"
"Morgan","2020-06-25","35","1563","3","76","4.4","3.2"
"Morgan","2020-06-26","50","1613","1","77","4.6","3.4"
"Morgan","2020-06-27","13","1626","0","77","4.6","3.4"
"Morgan","2020-06-28","7","1633","1","78","5.3","4.4"
"Morgan","2020-06-29","41","1674","1","79","5.6","4"
"Morgan","2020-06-30","37","1711","12","91","9.2","5.8"
"Morgan","2020-07-01","48","1759","6","97","10.3","6.7"
"Morgan","2020-07-02","46","1805","5","102","10.6","7.5"
"Morgan","2020-07-03","26","1831","2","104","11.5","8"
"Morgan","2020-07-04","16","1847","1","105","12.4","8.5"
"Morgan","2020-07-05","14","1861","3","108","13.4","9.3"
"Morgan","2020-07-06","30","1891","5","113","15.4","10.5"
"Morgan","2020-07-07","25","1916","2","115","11.9","10.6"
"Morgan","2020-07-08","52","1968","11","126","13.2","11.7"
"Morgan","2020-07-09","42","2010","5","131","13.3","12"
"Morgan","2020-07-10","38","2048","5","136","14.1","12.8"
"Morgan","2020-07-11","33","2081","8","144","16.7","14.5"
"Morgan","2020-07-12","20","2101","3","147","15.7","14.6"
"Morgan","2020-07-13","65","2166","9","156","15.3","15.4"
"Morgan","2020-07-14","50","2216","9","165","16.8","14.3"
"Morgan","2020-07-15","38","2254","4","169","15.2","14.2"
"Morgan","2020-07-16","42","2296","2","171","14.2","13.8"
"Morgan","2020-07-17","45","2341","6","177","14.2","14.2"
"Morgan","2020-07-18","16","2357","3","180","13.5","15.1"
"Morgan","2020-07-19","7","2364","1","181","13.4","14.5"
"Morgan","2020-07-20","83","2447","15","196","14","14.6"
"Morgan","2020-07-21","50","2497","17","213","16.2","16.5"
"Morgan","2020-07-22","54","2551","9","222","17.1","16.2"
"Morgan","2020-07-23","52","2603","16","238","20.8","17.5"
"Morgan","2020-07-24","63","2666","15","253","22.3","18.3"
"Morgan","2020-07-25","26","2692","10","263","25.2","19.3"
"Morgan","2020-07-26","13","2705","4","267","27.5","20.4"
"Morgan","2020-07-27","52","2757","18","285","29.9","21.9"
"Morgan","2020-07-28","47","2804","19","304","30.8","23.5"
"Morgan","2020-07-29","57","2861","22","326","33.9","25.5"
"Morgan","2020-07-30","42","2903","7","333","31.9","26.4"
"Morgan","2020-07-31","34","2937","14","347","34.4","28.4"
"Morgan","2020-08-01","12","2949","1","348","30.1","27.6"
"Morgan","2020-08-02","9","2958","2","350","28.9","28.2"
"Morgan","2020-08-03","42","3000","9","359","27","28.4"
"Morgan","2020-08-04","66","3066","16","375","24.7","27.7"
"Morgan","2020-08-05","44","3110","7","382","21.4","27.7"
"Morgan","2020-08-06","39","3149","7","389","21.6","26.8"
"Morgan","2020-08-07","35","3184","7","396","18.6","26.5"
"Morgan","2020-08-08","21","3205","4","400","20.1","25.1"
"Morgan","2020-08-09","17","3222","6","406","22","25.4"
"Morgan","2020-08-10","40","3262","8","414","21.8","24.4"
"Morgan","2020-08-11","34","3296","7","421","21.3","23"
"Morgan","2020-08-12","33","3329","1","422","19.4","20.4"
"Morgan","2020-08-13","44","3373","10","432","20.1","20.9"
"Morgan","2020-08-14","35","3408","5","437","19.3","18.9"
"Morgan","2020-08-15","25","3433","7","444","20.6","20.3"
"Morgan","2020-08-16","12","3445","5","449","21.5","21.7"
"Morgan","2020-08-17","28","3473","3","452","20.1","21"
"Morgan","2020-08-18","35","3508","4","456","18.8","20"
"Morgan","2020-08-19","26","3534","8","464","22.8","21.1"
"Morgan","2020-08-20","21","3555","4","468","22.3","21.2"
"Morgan","2020-08-21","18","3573","1","469","21","20.2"
"Morgan","2020-08-22","6","3579","0","469","17","18.8"
"Morgan","2020-08-23","7","3586","0","469","11.1","16.3"
"Morgan","2020-08-24","23","3609","6","475","13.3","16.7"
"Morgan","2020-08-25","14","3623","3","478","14.7","16.8"
"Morgan","2020-08-26","20","3643","1","479","11","16.9"
"Morgan","2020-08-27","14","3657","2","481","10.3","16.3"
"Morgan","2020-08-28","23","3680","3","484","11.4","16.2"
"Morgan","2020-08-29","6","3686","1","485","13.8","15.4"
"Morgan","2020-08-30","6","3692","1","486","16.2","13.6"
"Morgan","2020-08-31","24","3716","3","489","14.2","13.7"
"Morgan","2020-09-01","41","3757","6","495","13.3","14"
"Morgan","2020-09-02","12","3769","2","497","14.9","13"
"Morgan","2020-09-03","19","3788","2","499","14.4","12.4"
"Morgan","2020-09-04","25","3813","3","502","14.2","12.8"
"Morgan","2020-09-05","11","3824","1","503","13.2","13.5"
"Morgan","2020-09-06","7","3831","0","503","10.8","13.5"
"Morgan","2020-09-07","4","3835","0","503","9","11.6"
"Morgan","2020-09-08","27","3862","1","504","7.4","10.3"
"Morgan","2020-09-09","21","3883","3","507","7.1","11"
"Morgan","2020-09-10","19","3902","1","508","6.3","10.4"
"Morgan","2020-09-11","26","3928","1","509","5.2","9.7"
"Morgan","2020-09-12","4","3932","2","511","11","12.1"
"Morgan","2020-09-13","8","3940","0","511","11","10.9"
"Morgan","2020-09-14","20","3960","0","511","11","10"
"Morgan","2020-09-15","25","3985","3","514","12.2","9.8"
"Morgan","2020-09-16","15","4000","2","516","12.1","9.6"
"Morgan","2020-09-17","17","4017","1","517","12.2","9.2"
"Morgan","2020-09-18","15","4032","0","517","11.6","8.4"
"Morgan","2020-09-19","5","4037","1","518","7.3","9.2"
"Morgan","2020-09-20","3","4040","0","518","7.3","9.2"
"Morgan","2020-09-21","26","4066","3","521","9","10"
"Morgan","2020-09-22","21","4087","1","522","7.9","10.1"
"Morgan","2020-09-23","15","4102","1","523","7","9.5"
"Morgan","2020-09-24","20","4122","1","524","6.9","9.5"
"Morgan","2020-09-25","19","4141","1","525","7.6","9.6"
"Morgan","2020-09-26","5","4146","0","525","4.7","6"
"Morgan","2020-09-27","3","4149","0","525","4.7","6"
"Morgan","2020-09-28","17","4166","0","525","3.1","6"
"Morgan","2020-09-29","19","4185","2","527","3.9","5.9"
"Morgan","2020-09-30","14","4199","2","529","5","6"
"Morgan","2020-10-01","24","4223","1","530","4.9","5.9"
"Morgan","2020-10-02","17","4240","1","531","5","6.3"
"Morgan","2020-10-03","10","4250","1","532","6.4","5.6"
"Morgan","2020-10-04","3","4253","1","533","11.2","8"
"Morgan","2020-10-05","21","4274","2","535","12.5","7.8"
"Morgan","2020-10-06","26","4300","3","538","12.7","8.3"
"Morgan","2020-10-07","22","4322","1","539","11.3","8.1"
"Morgan","2020-10-08","22","4344","2","541","12","8.4"
"Morgan","2020-10-09","19","4363","2","543","12.7","8.8"
"Morgan","2020-10-10","7","4370","1","544","13.3","9.8"
"Morgan","2020-10-11","4","4374","0","544","8.5","9.8"
"Morgan","2020-10-12","21","4395","2","546","8.5","10.5"
"Morgan","2020-10-13","19","4414","1","547","7.6","10.1"
"Morgan","2020-10-14","13","4427","1","548","8.1","9.7"
"Morgan","2020-10-15","33","4460","2","550","7.6","9.8"
"Morgan","2020-10-16","11","4471","1","551","7.4","10"
"Morgan","2020-10-17","5","4476","0","551","5.4","9.3"
"Morgan","2020-10-18","1","4477","0","551","5.4","6.9"
"Morgan","2020-10-19","16","4493","3","554","6.7","7.6"
"Morgan","2020-10-20","20","4513","2","556","7.4","7.5"
"Morgan","2020-10-21","29","4542","5","561","8.7","8.4"
"Morgan","2020-10-22","16","4558","1","562","8.8","8.2"
"Morgan","2020-10-23","19","4577","2","564","9","8.2"
"Morgan","2020-10-24","8","4585","1","565","10.8","8.1"
"Morgan","2020-10-25","4","4589","0","565","10.8","8.1"
"Morgan","2020-10-26","15","4604","3","568","10.9","8.8"
"Morgan","2020-10-27","20","4624","2","570","10.9","9.2"
"Morgan","2020-10-28","21","4645","4","574","11.2","10"
"Morgan","2020-10-29","20","4665","2","576","11.7","10.2"
"Morgan","2020-10-30","12","4677","2","578","12.6","10.8"
"Morgan","2020-10-31","12","4689","3","581","14.4","12.6"
"Morgan","2020-11-01","9","4698","2","583","17.6","14.2"
"Morgan","2020-11-02","12","4710","2","585","17.1","14"
"Morgan","2020-11-03","15","4725","0","585","15.7","13.3"
"Morgan","2020-11-04","29","4754","1","586","13.4","12.3"
"Morgan","2020-11-05","10","4764","1","587","13.4","12.6"
"Morgan","2020-11-06","15","4779","0","587","11","11.8"
"Morgan","2020-11-07","2","4781","0","587","7.5","10.9"
"Morgan","2020-11-08","4","4785","1","588","7.9","12.7"
"Morgan","2020-11-09","31","4816","5","593","7.8","12.4"
"Morgan","2020-11-10","20","4836","2","595","9.2","12.4"
"Morgan","2020-11-11","18","4854","2","597","10.3","11.9"
"Morgan","2020-11-12","16","4870","0","597","8.9","11.2"
"Morgan","2020-11-13","20","4890","1","598","9.6","10.3"
"Morgan","2020-11-14","9","4899","2","600","12.8","10.1"
"Morgan","2020-11-15","8","4907","2","602","12.8","10.3"
"Morgan","2020-11-16","25","4932","2","604","11.6","9.7"
"Morgan","2020-11-17","24","4956","1","605","10.8","10"
"Morgan","2020-11-18","37","4993","2","607","10","10.1"
"Morgan","2020-11-19","22","5015","0","607","10","9.4"
"Morgan","2020-11-20","23","5038","0","607","9.3","9.4"
"Morgan","2020-11-21","3","5041","1","608","10.8","11.8"
"Morgan","2020-11-22","10","5051","1","609","8.7","10.7"
"Morgan","2020-11-23","34","5085","0","609","7.6","9.6"
"Morgan","2020-11-24","24","5109","3","612","8.7","9.8"
"Morgan","2020-11-25","31","5140","0","612","8","9"
"Morgan","2020-11-26","2","5142","0","612","8","9"
"Morgan","2020-11-27","21","5163","1","613","8.7","9"
"Morgan","2020-11-28","7","5170","1","614","5.9","8.4"
"Morgan","2020-11-29","10","5180","0","614","4.5","6.6"
"Morgan","2020-11-30","31","5211","5","619","6.8","7.2"
"Morgan","2020-12-01","30","5241","8","627","8.8","8.8"
"Morgan","2020-12-02","36","5277","3","630","10","9"
"Morgan","2020-12-03","24","5301","5","635","13","10.5"
"Morgan","2020-12-04","24","5325","1","636","12.9","10.8"
"Morgan","2020-12-05","9","5334","0","636","10.9","8.4"
"Morgan","2020-12-06","13","5347","3","639","14.2","9.3"
"Morgan","2020-12-07","37","5384","4","643","13.4","10.1"
"Morgan","2020-12-08","22","5406","5","648","12.8","10.8"
"Morgan","2020-12-09","47","5453","6","654","13.5","11.8"
"Morgan","2020-12-10","45","5498","8","662","13","13"
"Morgan","2020-12-11","31","5529","5","667","14.8","13.8"
"Morgan","2020-12-12","22","5551","3","670","16.7","13.8"
"Morgan","2020-12-13","16","5567","5","675","17.9","16"
"Morgan","2020-12-14","43","5610","6","681","18.3","15.9"
"Morgan","2020-12-15","22","5632","2","683","16.4","14.6"
"Morgan","2020-12-16","96","5728","9","692","15.9","14.7"
"Morgan","2020-12-17","28","5756","7","699","16.9","15"
"Morgan","2020-12-18","39","5795","4","703","16.1","15.4"
"Morgan","2020-12-19","26","5821","3","706","15.8","16.2"
"Morgan","2020-12-20","19","5840","9","715","18.1","18"
"Morgan","2020-12-21","34","5874","9","724","19.9","19.1"
"Morgan","2020-12-22","38","5912","7","731","21.2","18.8"
"Morgan","2020-12-23","43","5955","7","738","22.2","19"
"Morgan","2020-12-24","30","5985","6","744","21.5","19.2"
"Morgan","2020-12-25","7","5992","2","746","24.1","20.1"
"Morgan","2020-12-26","22","6014","8","754","27.6","21.7"
"Morgan","2020-12-27","20","6034","5","759","24.4","21.3"
"Morgan","2020-12-28","47","6081","15","774","25.2","22.5"
"Morgan","2020-12-29","41","6122","8","782","25.4","23.3"
"Morgan","2020-12-30","25","6147","5","787","25.9","24"
"Morgan","2020-12-31","32","6179","6","793","25.7","23.6"
"Morgan","2021-01-01","14","6193","4","797","25.7","24.9"
"Morgan","2021-01-02","17","6210","2","799","22.2","24.9"
"Morgan","2021-01-03","18","6228","4","803","21.8","23.1"
"Morgan","2021-01-04","46","6274","14","817","21.6","23.4"
"Morgan","2021-01-05","67","6341","18","835","22.7","24"
"Morgan","2021-01-06","59","6400","19","854","24.4","25.2"
"Morgan","2021-01-07","40","6440","11","865","25.7","25.7"
"Morgan","2021-01-08","41","6481","10","875","25.1","25.4"
"Morgan","2021-01-09","19","6500","7","882","28.6","25.4"
"Morgan","2021-01-10","17","6517","3","885","28","24.9"
"Morgan","2021-01-11","55","6572","11","896","26.5","24.1"
"Morgan","2021-01-12","38","6610","10","906","26.4","24.5"
"Morgan","2021-01-13","36","6646","8","914","25","24.7"
"Morgan","2021-01-14","40","6686","6","920","23.2","24.4"
"Morgan","2021-01-15","28","6714","3","923","21.2","23.2"
"Morgan","2021-01-16","21","6735","5","928","19.4","24"
"Morgan","2021-01-17","19","6754","3","931","19.1","23.6"
"Morgan","2021-01-18","25","6779","4","935","18.6","22.5"
"Morgan","2021-01-19","47","6826","6","941","16.6","21.5"
"Morgan","2021-01-20","42","6868","6","947","15.5","20.2"
"Morgan","2021-01-21","44","6912","3","950","14.3","18.8"
"Morgan","2021-01-22","47","6959","8","958","15.2","18.2"
"Morgan","2021-01-23","12","6971","2","960","14.2","16.8"
"Morgan","2021-01-24","6","6977","4","964","21.5","20.3"
"Morgan","2021-01-25","20","6997","2","966","20.6","19.6"
"Morgan","2021-01-26","4","7001","0","966","18.8","17.7"
"Morgan","2021-01-27","0","7001","0","966","16.7","16.1"
"Murray","2020-02-01","0","0","0","0",".","."
"Murray","2020-02-02","0","0","0","0",".","."
"Murray","2020-02-03","0","0","0","0",".","."
"Murray","2020-02-04","0","0","0","0",".","."
"Murray","2020-02-05","0","0","0","0",".","."
"Murray","2020-02-06","0","0","0","0",".","."
"Murray","2020-02-07","0","0","0","0","0","."
"Murray","2020-02-08","0","0","0","0","0","."
"Murray","2020-02-09","0","0","0","0","0","."
"Murray","2020-02-10","0","0","0","0","0","."
"Murray","2020-02-11","0","0","0","0","0","."
"Murray","2020-02-12","0","0","0","0","0","."
"Murray","2020-02-13","0","0","0","0","0","."
"Murray","2020-02-14","0","0","0","0","0","0"
"Murray","2020-02-15","0","0","0","0","0","0"
"Murray","2020-02-16","0","0","0","0","0","0"
"Murray","2020-02-17","0","0","0","0","0","0"
"Murray","2020-02-18","0","0","0","0","0","0"
"Murray","2020-02-19","0","0","0","0","0","0"
"Murray","2020-02-20","0","0","0","0","0","0"
"Murray","2020-02-21","0","0","0","0","0","0"
"Murray","2020-02-22","0","0","0","0","0","0"
"Murray","2020-02-23","0","0","0","0","0","0"
"Murray","2020-02-24","0","0","0","0","0","0"
"Murray","2020-02-25","0","0","0","0","0","0"
"Murray","2020-02-26","0","0","0","0","0","0"
"Murray","2020-02-27","0","0","0","0","0","0"
"Murray","2020-02-28","0","0","0","0","0","0"
"Murray","2020-02-29","0","0","0","0","0","0"
"Murray","2020-03-01","0","0","0","0","0","0"
"Murray","2020-03-02","0","0","0","0","0","0"
"Murray","2020-03-03","0","0","0","0","0","0"
"Murray","2020-03-04","0","0","0","0","0","0"
"Murray","2020-03-05","0","0","0","0","0","0"
"Murray","2020-03-06","0","0","0","0","0","0"
"Murray","2020-03-07","0","0","0","0","0","0"
"Murray","2020-03-08","0","0","0","0","0","0"
"Murray","2020-03-09","0","0","0","0","0","0"
"Murray","2020-03-10","0","0","0","0","0","0"
"Murray","2020-03-11","0","0","0","0","0","0"
"Murray","2020-03-12","2","2","0","0","0","0"
"Murray","2020-03-13","5","7","0","0","0","0"
"Murray","2020-03-14","0","7","0","0","0","0"
"Murray","2020-03-15","0","7","0","0","0","0"
"Murray","2020-03-16","4","11","0","0","0","0"
"Murray","2020-03-17","7","18","0","0","0","0"
"Murray","2020-03-18","7","25","1","1","2","1"
"Murray","2020-03-19","5","30","0","1","2","1"
"Murray","2020-03-20","4","34","0","1","2","1"
"Murray","2020-03-21","7","41","3","4","8.2","4.1"
"Murray","2020-03-22","2","43","0","4","8.2","4.1"
"Murray","2020-03-23","5","48","1","5","11","5.5"
"Murray","2020-03-24","5","53","0","5","11","5.5"
"Murray","2020-03-25","6","59","0","5","9","5.5"
"Murray","2020-03-26","5","64","0","5","9","5.5"
"Murray","2020-03-27","3","67","1","6","13.7","7.9"
"Murray","2020-03-28","0","67","0","6","7.6","7.9"
"Murray","2020-03-29","0","67","0","6","7.6","7.9"
"Murray","2020-03-30","10","77","0","6","4.8","7.9"
"Murray","2020-03-31","5","82","0","6","4.8","7.9"
"Murray","2020-04-01","2","84","0","6","4.8","6.9"
"Murray","2020-04-02","1","85","0","6","4.8","6.9"
"Murray","2020-04-03","6","91","0","6","0","6.9"
"Murray","2020-04-04","3","94","0","6","0","3.8"
"Murray","2020-04-05","1","95","0","6","0","3.8"
"Murray","2020-04-06","7","102","1","7","2","3.4"
"Murray","2020-04-07","3","105","0","7","2","3.4"
"Murray","2020-04-08","4","109","1","8","5.6","5.2"
"Murray","2020-04-09","4","113","0","8","5.6","5.2"
"Murray","2020-04-10","7","120","0","8","5.6","2.8"
"Murray","2020-04-11","3","123","0","8","5.6","2.8"
"Murray","2020-04-12","1","124","0","8","5.6","2.8"
"Murray","2020-04-13","3","127","0","8","3.6","2.8"
"Murray","2020-04-14","2","129","0","8","3.6","2.8"
"Murray","2020-04-15","8","137","0","8","0","2.8"
"Murray","2020-04-16","6","143","1","9","2.4","4"
"Murray","2020-04-17","7","150","0","9","2.4","4"
"Murray","2020-04-18","5","155","1","10","5.2","5.4"
"Murray","2020-04-19","3","158","0","10","5.2","5.4"
"Murray","2020-04-20","12","170","5","15","11.2","7.4"
"Murray","2020-04-21","10","180","0","15","11.2","7.4"
"Murray","2020-04-22","10","190","3","18","15.5","7.7"
"Murray","2020-04-23","6","196","1","19","15.5","8.9"
"Murray","2020-04-24","20","216","1","20","16.2","9.3"
"Murray","2020-04-25","10","226","1","21","14.8","10"
"Murray","2020-04-26","1","227","0","21","14.8","10"
"Murray","2020-04-27","13","240","0","21","8.8","10"
"Murray","2020-04-28","9","249","0","21","8.8","10"
"Murray","2020-04-29","13","262","0","21","4.5","10"
"Murray","2020-04-30","66","328","5","26","3.2","9.4"
"Murray","2020-05-01","16","344","0","26","2.5","9.4"
"Murray","2020-05-02","8","352","0","26","1.1","7.9"
"Murray","2020-05-03","5","357","0","26","1.1","7.9"
"Murray","2020-05-04","8","365","1","27","2.9","5.8"
"Murray","2020-05-05","21","386","1","28","3.5","6.2"
"Murray","2020-05-06","13","399","1","29","4.6","4.6"
"Murray","2020-05-07","37","436","1","30","4","3.6"
"Murray","2020-05-08","25","461","2","32","5.1","3.8"
"Murray","2020-05-09","18","479","0","32","5.1","3.1"
"Murray","2020-05-10","13","492","0","32","5.1","3.1"
"Murray","2020-05-11","32","524","5","37","5.5","4.2"
"Murray","2020-05-12","39","563","5","42","6.7","5.1"
"Murray","2020-05-13","14","577","4","46","9.7","7.2"
"Murray","2020-05-14","38","615","1","47","9.7","6.8"
"Murray","2020-05-15","11","626","3","50","12.4","8.8"
"Murray","2020-05-16","15","641","0","50","12.4","8.8"
"Murray","2020-05-17","10","651","1","51","13.8","9.5"
"Murray","2020-05-18","14","665","0","51","11.6","8.6"
"Murray","2020-05-19","16","681","1","52","10.7","8.7"
"Murray","2020-05-20","31","712","2","54","7.5","8.6"
"Murray","2020-05-21","87","799","6","60","8.1","8.9"
"Murray","2020-05-22","16","815","2","62","6","9.2"
"Murray","2020-05-23","39","854","3","65","7.1","9.8"
"Murray","2020-05-24","4","858","0","65","5.7","9.8"
"Murray","2020-05-25","6","864","0","65","5.7","8.6"
"Murray","2020-05-26","27","891","2","67","5.8","8.3"
"Murray","2020-05-27","25","916","5","72","7.8","7.7"
"Murray","2020-05-28","73","989","2","74","7.2","7.7"
"Murray","2020-05-29","21","1010","0","74","5.4","5.7"
"Murray","2020-05-30","5","1015","0","74","4.3","5.7"
"Murray","2020-05-31","6","1021","0","74","4.3","5"
"Murray","2020-06-01","57","1078","8","82","6.3","6"
"Murray","2020-06-02","45","1123","1","83","5.6","5.7"
"Murray","2020-06-03","37","1160","4","87","4.3","6"
"Murray","2020-06-04","76","1236","6","93","5","6.1"
"Murray","2020-06-05","26","1262","2","95","6.1","5.7"
"Murray","2020-06-06","7","1269","1","96","8.1","6.2"
"Murray","2020-06-07","4","1273","0","96","8.1","6.2"
"Murray","2020-06-08","64","1337","10","106","8.4","7.3"
"Murray","2020-06-09","46","1383","5","111","9.6","7.6"
"Murray","2020-06-10","23","1406","2","113","9.3","6.8"
"Murray","2020-06-11","74","1480","10","123","10.1","7.5"
"Murray","2020-06-12","29","1509","2","125","10","8"
"Murray","2020-06-13","8","1517","0","125","7.9","8"
"Murray","2020-06-14","8","1525","0","125","7.9","8"
"Murray","2020-06-15","23","1548","4","129","8.2","8.3"
"Murray","2020-06-16","21","1569","3","132","8.7","9.1"
"Murray","2020-06-17","23","1592","3","135","9.3","9.3"
"Murray","2020-06-18","23","1615","1","136","8","9"
"Murray","2020-06-19","24","1639","1","137","7.6","8.8"
"Murray","2020-06-20","10","1649","2","139","10.5","9.2"
"Murray","2020-06-21","10","1659","1","140","11.9","9.9"
"Murray","2020-06-22","39","1698","8","148","12.3","10.3"
"Murray","2020-06-23","24","1722","2","150","11.5","10.1"
"Murray","2020-06-24","32","1754","6","156","12.3","10.8"
"Murray","2020-06-25","26","1780","5","161","14.4","11.2"
"Murray","2020-06-26","32","1812","4","165","15.6","11.6"
"Murray","2020-06-27","17","1829","4","169","16.1","13.3"
"Murray","2020-06-28","13","1842","2","171","16.9","14.4"
"Murray","2020-06-29","31","1873","3","174","15.3","13.8"
"Murray","2020-06-30","37","1910","4","178","15.7","13.6"
"Murray","2020-07-01","54","1964","9","187","15.4","13.9"
"Murray","2020-07-02","40","2004","7","194","15.2","14.8"
"Murray","2020-07-03","21","2025","5","199","16.8","16.2"
"Murray","2020-07-04","5","2030","2","201","19.1","17.6"
"Murray","2020-07-05","13","2043","3","204","20.2","18.6"
"Murray","2020-07-06","50","2093","12","216","22.3","18.8"
"Murray","2020-07-07","60","2153","14","230","24.1","19.9"
"Murray","2020-07-08","57","2210","7","237","23.4","19.4"
"Murray","2020-07-09","65","2275","16","253","24.4","19.8"
"Murray","2020-07-10","51","2326","6","259","22.7","19.7"
"Murray","2020-07-11","13","2339","1","260","18.1","18.6"
"Murray","2020-07-12","13","2352","4","264","19.2","19.7"
"Murray","2020-07-13","53","2405","12","276","19","20.6"
"Murray","2020-07-14","59","2464","7","283","17.4","20.7"
"Murray","2020-07-15","64","2528","13","296","18.5","21"
"Murray","2020-07-16","37","2565","4","300","16.6","20.5"
"Murray","2020-07-17","39","2604","16","316","20.7","21.7"
"Murray","2020-07-18","14","2618","2","318","21.7","19.9"
"Murray","2020-07-19","15","2633","2","320","19.2","19.2"
"Murray","2020-07-20","52","2685","10","330","18.7","18.9"
"Murray","2020-07-21","26","2711","5","335","19.7","18.6"
"Murray","2020-07-22","31","2742","2","337","17.8","18.1"
"Murray","2020-07-23","47","2789","7","344","18.4","17.5"
"Murray","2020-07-24","47","2836","7","351","14.6","17.7"
"Murray","2020-07-25","20","2856","3","354","14.7","18.2"
"Murray","2020-07-26","17","2873","8","362","19.5","19.4"
"Murray","2020-07-27","47","2920","6","368","18.6","18.7"
"Murray","2020-07-28","39","2959","3","371","17","18.4"
"Murray","2020-07-29","45","3004","6","377","17.9","17.9"
"Murray","2020-07-30","33","3037","2","379","16.7","17.5"
"Murray","2020-07-31","44","3081","5","384","16.2","15.4"
"Murray","2020-08-01","16","3097","3","387","16.7","15.7"
"Murray","2020-08-02","13","3110","3","390","13.3","16.4"
"Murray","2020-08-03","37","3147","5","395","13.4","16"
"Murray","2020-08-04","16","3163","3","398","15","16"
"Murray","2020-08-05","39","3202","3","401","14.2","16.1"
"Murray","2020-08-06","28","3230","4","405","15.3","16"
"Murray","2020-08-07","35","3265","6","411","16.2","16.2"
"Murray","2020-08-08","19","3284","2","413","15","15.9"
"Murray","2020-08-09","15","3299","0","413","11.7","12.5"
"Murray","2020-08-10","46","3345","8","421","12.3","12.8"
"Murray","2020-08-11","46","3391","3","424","10.5","12.7"
"Murray","2020-08-12","48","3439","5","429","10.9","12.5"
"Murray","2020-08-13","24","3463","5","434","11.8","13.6"
"Murray","2020-08-14","53","3516","0","434","9.4","12.8"
"Murray","2020-08-15","10","3526","1","435","9.3","12.2"
"Murray","2020-08-16","18","3544","1","436","10.1","10.9"
"Murray","2020-08-17","45","3589","5","441","9.2","10.7"
"Murray","2020-08-18","48","3637","3","444","9.2","9.8"
"Murray","2020-08-19","32","3669","2","446","8.6","9.7"
"Murray","2020-08-20","24","3693","1","447","6.2","9"
"Murray","2020-08-21","39","3732","1","448","6.6","8"
"Murray","2020-08-22","17","3749","2","450","6.8","8.1"
"Murray","2020-08-23","10","3759","2","452","8.9","9.5"
"Murray","2020-08-24","36","3795","4","456","8.9","9"
"Murray","2020-08-25","43","3838","3","459","9","9.1"
"Murray","2020-08-26","39","3877","3","462","9.2","8.9"
"Murray","2020-08-27","29","3906","1","463","9.1","7.6"
"Murray","2020-08-28","48","3954","1","464","9","7.8"
"Murray","2020-08-29","13","3967","0","464","7.3","7.1"
"Murray","2020-08-30","16","3983","0","464","4.5","6.7"
"Murray","2020-08-31","44","4027","2","466","3.5","6.2"
"Murray","2020-09-01","53","4080","3","469","3.3","6.2"
"Murray","2020-09-02","44","4124","0","469","2.2","5.7"
"Murray","2020-09-03","38","4162","2","471","2.5","5.8"
"Murray","2020-09-04","36","4198","0","471","2.2","5.6"
"Murray","2020-09-05","13","4211","0","471","2.2","4.8"
"Murray","2020-09-06","13","4224","1","472","3.3","3.9"
"Murray","2020-09-07","11","4235","0","472","2.7","3.1"
"Murray","2020-09-08","149","4384","2","474","2","2.7"
"Murray","2020-09-09","48","4432","6","480","3.8","3"
"Murray","2020-09-10","68","4500","2","482","3.5","3"
"Murray","2020-09-11","126","4626","2","484","3.7","3"
"Murray","2020-09-12","12","4638","2","486","6.1","4.2"
"Murray","2020-09-13","19","4657","4","490","8","5.7"
"Murray","2020-09-14","60","4717","4","494","9","5.8"
"Murray","2020-09-15","153","4870","2","496","9","5.5"
"Murray","2020-09-16","41","4911","0","496","7.2","5.5"
"Murray","2020-09-17","51","4962","1","497","7","5.3"
"Murray","2020-09-18","42","5004","3","500","7.8","5.8"
"Murray","2020-09-19","22","5026","3","503","7.4","6.7"
"Murray","2020-09-20","16","5042","0","503","4.4","6.2"
"Murray","2020-09-21","58","5100","4","507","4.4","6.7"
"Murray","2020-09-22","78","5178","4","511","5","7"
"Murray","2020-09-23","57","5235","5","516","6.2","6.7"
"Murray","2020-09-24","39","5274","3","519","7","7"
"Murray","2020-09-25","37","5311","2","521","6.8","7.3"
"Murray","2020-09-26","16","5327","2","523","6.6","7"
"Murray","2020-09-27","17","5344","1","524","7.5","5.9"
"Murray","2020-09-28","36","5380","4","528","8.1","6.2"
"Murray","2020-09-29","60","5440","1","529","7.6","6.3"
"Murray","2020-09-30","43","5483","0","529","6.3","6.3"
"Murray","2020-10-01","23","5506","3","532","7.1","7.1"
"Murray","2020-10-02","33","5539","4","536","8","7.4"
"Murray","2020-10-03","14","5553","2","538","8.3","7.5"
"Murray","2020-10-04","13","5566","2","540","9.7","8.6"
"Murray","2020-10-05","40","5606","1","541","8.4","8.2"
"Murray","2020-10-06","61","5667","0","541","8.2","7.9"
"Murray","2020-10-07","36","5703","0","541","8.2","7.3"
"Murray","2020-10-08","47","5750","6","547","8.2","7.6"
"Murray","2020-10-09","24","5774","2","549","7.6","7.8"
"Murray","2020-10-10","6","5780","1","550","8","8.1"
"Murray","2020-10-11","7","5787","0","550","5.8","7.7"
"Murray","2020-10-12","43","5830","7","557","7.7","8.1"
"Murray","2020-10-13","37","5867","7","564","10.4","9.3"
"Murray","2020-10-14","35","5902","4","568","12.1","10.1"
"Murray","2020-10-15","50","5952","5","573","11.7","9.9"
"Murray","2020-10-16","40","5992","2","575","11.2","9.4"
"Murray","2020-10-17","14","6006","1","576","9.8","8.9"
"Murray","2020-10-18","10","6016","1","577","11.3","8.5"
"Murray","2020-10-19","52","6068","3","580","9.8","8.7"
"Murray","2020-10-20","44","6112","9","589","10","10.2"
"Murray","2020-10-21","42","6154","4","593","9.7","10.9"
"Murray","2020-10-22","25","6179","1","594","8.8","10.3"
"Murray","2020-10-23","58","6237","2","596","8.6","9.9"
"Murray","2020-10-24","15","6252","4","600","11.4","10.6"
"Murray","2020-10-25","19","6271","4","604","13","12.1"
"Murray","2020-10-26","59","6330","4","608","13.1","11.4"
"Murray","2020-10-27","67","6397","4","612","11.1","10.5"
"Murray","2020-10-28","42","6439","6","618","11.7","10.7"
"Murray","2020-10-29","62","6501","10","628","13.5","11.2"
"Murray","2020-10-30","38","6539","3","631","14.1","11.4"
"Murray","2020-10-31","35","6574","9","640","14","12.7"
"Murray","2020-11-01","24","6598","3","643","12.8","12.9"
"Murray","2020-11-02","63","6661","3","646","12.5","12.8"
"Murray","2020-11-03","66","6727","15","661","14.9","13"
"Murray","2020-11-04","63","6790","4","665","13.7","12.7"
"Murray","2020-11-05","63","6853","9","674","13.5","13.5"
"Murray","2020-11-06","50","6903","7","681","14.3","14.2"
"Murray","2020-11-07","29","6932","9","690","15.1","14.5"
"Murray","2020-11-08","22","6954","4","694","15.9","14.3"
"Murray","2020-11-09","79","7033","6","700","16.3","14.4"
"Murray","2020-11-10","64","7097","6","706","14.4","14.6"
"Murray","2020-11-11","58","7155","8","714","15.5","14.6"
"Murray","2020-11-12","77","7232","12","726","15.7","14.6"
"Murray","2020-11-13","69","7301","17","743","17.2","15.8"
"Murray","2020-11-14","24","7325","2","745","13.9","14.5"
"Murray","2020-11-15","29","7354","6","751","14.3","15.1"
"Murray","2020-11-16","74","7428","12","763","15.5","15.9"
"Murray","2020-11-17","76","7504","10","773","16.1","15.2"
"Murray","2020-11-18","72","7576","9","782","15.9","15.7"
"Murray","2020-11-19","74","7650","18","800","17.1","16.4"
"Murray","2020-11-20","74","7724","13","813","16.1","16.6"
"Murray","2020-11-21","42","7766","16","829","20.4","17.1"
"Murray","2020-11-22","16","7782","4","833","21","17.6"
"Murray","2020-11-23","78","7860","18","851","22","18.7"
"Murray","2020-11-24","66","7926","14","865","23.1","19.6"
"Murray","2020-11-25","74","8000","13","878","23.8","19.9"
"Murray","2020-11-26","15","8015","6","884","26.1","21.6"
"Murray","2020-11-27","58","8073","14","898","27","21.6"
"Murray","2020-11-28","42","8115","13","911","26","23.2"
"Murray","2020-11-29","43","8158","15","926","27.4","24.2"
"Murray","2020-11-30","142","8300","25","951","26.6","24.3"
"Murray","2020-12-01","107","8407","21","972","26.4","24.8"
"Murray","2020-12-02","119","8526","10","982","25.1","24.5"
"Murray","2020-12-03","89","8615","22","1004","22.9","24.5"
"Murray","2020-12-04","90","8705","16","1020","22","24.5"
"Murray","2020-12-05","53","8758","13","1033","21.1","23.5"
"Murray","2020-12-06","53","8811","10","1043","18.8","23.1"
"Murray","2020-12-07","112","8923","17","1060","18.4","22.5"
"Murray","2020-12-08","101","9024","18","1078","18.2","22.3"
"Murray","2020-12-09","145","9169","15","1093","18.5","21.8"
"Murray","2020-12-10","92","9261","9","1102","16.3","19.6"
"Murray","2020-12-11","61","9322","14","1116","17.1","19.5"
"Murray","2020-12-12","42","9364","13","1129","18","19.5"
"Murray","2020-12-13","43","9407","10","1139","18.6","18.7"
"Murray","2020-12-14","101","9508","15","1154","18.6","18.5"
"Murray","2020-12-15","103","9611","25","1179","19.5","18.8"
"Murray","2020-12-16","100","9711","13","1192","19.9","19.2"
"Murray","2020-12-17","98","9809","12","1204","20.2","18.3"
"Murray","2020-12-18","67","9876","20","1224","21.2","19.1"
"Murray","2020-12-19","52","9928","9","1233","19.3","18.6"
"Murray","2020-12-20","42","9970","13","1246","20.4","19.5"
"Murray","2020-12-21","133","10103","29","1275","21.3","20"
"Murray","2020-12-22","110","10213","24","1299","21","20.2"
"Murray","2020-12-23","136","10349","31","1330","22.4","21.1"
"Murray","2020-12-24","67","10416","21","1351","25.1","22.7"
"Murray","2020-12-25","12","10428","1","1352","22.1","21.6"
"Murray","2020-12-26","75","10503","33","1385","25.9","22.6"
"Murray","2020-12-27","49","10552","16","1401","26.1","23.2"
"Murray","2020-12-28","139","10691","34","1435","26.5","23.9"
"Murray","2020-12-29","124","10815","18","1453","25.4","23.2"
"Murray","2020-12-30","139","10954","19","1472","24.1","23.3"
"Murray","2020-12-31","77","11031","19","1491","23.2","24.2"
"Murray","2021-01-01","16","11047","6","1497","27.4","24.7"
"Murray","2021-01-02","31","11078","10","1507","25.7","25.8"
"Murray","2021-01-03","39","11117","13","1520","25.8","25.9"
"Murray","2021-01-04","53","11170","14","1534","26.1","26.3"
"Murray","2021-01-05","113","11283","23","1557","26.9","26.2"
"Murray","2021-01-06","147","11430","29","1586","27.8","25.9"
"Murray","2021-01-07","86","11516","19","1605","27.4","25.3"
"Murray","2021-01-08","91","11607","24","1629","25.8","26.6"
"Murray","2021-01-09","43","11650","15","1644","26.2","25.9"
"Murray","2021-01-10","55","11705","15","1659","25.3","25.5"
"Murray","2021-01-11","132","11837","23","1682","24","25"
"Murray","2021-01-12","144","11981","27","1709","23.8","25.3"
"Murray","2021-01-13","113","12094","20","1729","23.5","25.6"
"Murray","2021-01-14","98","12192","21","1750","23.4","25.4"
"Murray","2021-01-15","84","12276","25","1775","23.9","24.8"
"Murray","2021-01-16","43","12319","12","1787","22.9","24.5"
"Murray","2021-01-17","40","12359","13","1800","23.6","24.5"
"Murray","2021-01-18","119","12478","15","1815","23","23.5"
"Murray","2021-01-19","124","12602","19","1834","22.5","23.1"
"Murray","2021-01-20","116","12718","20","1854","22.4","22.9"
"Murray","2021-01-21","81","12799","24","1878","23.6","23.5"
"Murray","2021-01-22","70","12869","13","1891","22","22.9"
"Murray","2021-01-23","47","12916","12","1903","21.6","22.3"
"Murray","2021-01-24","27","12943","10","1913","22.3","23"
"Murray","2021-01-25","36","12979","6","1919","22.9","22.9"
"Murray","2021-01-26","0","12979","0","1919","20.7","21.6"
"Murray","2021-01-27","0","12979","0","1919","18.2","20.3"
"Muscogee","2020-02-01","0","0","0","0",".","."
"Muscogee","2020-02-02","0","0","0","0",".","."
"Muscogee","2020-02-03","0","0","0","0",".","."
"Muscogee","2020-02-04","0","0","0","0",".","."
"Muscogee","2020-02-05","0","0","0","0",".","."
"Muscogee","2020-02-06","0","0","0","0",".","."
"Muscogee","2020-02-07","0","0","0","0","0","."
"Muscogee","2020-02-08","0","0","0","0","0","."
"Muscogee","2020-02-09","0","0","0","0","0","."
"Muscogee","2020-02-10","0","0","0","0","0","."
"Muscogee","2020-02-11","0","0","0","0","0","."
"Muscogee","2020-02-12","0","0","0","0","0","."
"Muscogee","2020-02-13","0","0","0","0","0","."
"Muscogee","2020-02-14","0","0","0","0","0","0"
"Muscogee","2020-02-15","0","0","0","0","0","0"
"Muscogee","2020-02-16","0","0","0","0","0","0"
"Muscogee","2020-02-17","0","0","0","0","0","0"
"Muscogee","2020-02-18","0","0","0","0","0","0"
"Muscogee","2020-02-19","0","0","0","0","0","0"
"Muscogee","2020-02-20","0","0","0","0","0","0"
"Muscogee","2020-02-21","0","0","0","0","0","0"
"Muscogee","2020-02-22","0","0","0","0","0","0"
"Muscogee","2020-02-23","0","0","0","0","0","0"
"Muscogee","2020-02-24","0","0","0","0","0","0"
"Muscogee","2020-02-25","0","0","0","0","0","0"
"Muscogee","2020-02-26","0","0","0","0","0","0"
"Muscogee","2020-02-27","0","0","0","0","0","0"
"Muscogee","2020-02-28","0","0","0","0","0","0"
"Muscogee","2020-02-29","0","0","0","0","0","0"
"Muscogee","2020-03-01","0","0","0","0","0","0"
"Muscogee","2020-03-02","0","0","0","0","0","0"
"Muscogee","2020-03-03","0","0","0","0","0","0"
"Muscogee","2020-03-04","0","0","0","0","0","0"
"Muscogee","2020-03-05","0","0","0","0","0","0"
"Muscogee","2020-03-06","0","0","0","0","0","0"
"Muscogee","2020-03-07","0","0","0","0","0","0"
"Muscogee","2020-03-08","0","0","0","0","0","0"
"Muscogee","2020-03-09","1","1","0","0","0","0"
"Muscogee","2020-03-10","5","6","0","0","0","0"
"Muscogee","2020-03-11","6","12","0","0","0","0"
"Muscogee","2020-03-12","3","15","0","0","0","0"
"Muscogee","2020-03-13","4","19","0","0","0","0"
"Muscogee","2020-03-14","1","20","1","1","14.3","7.1"
"Muscogee","2020-03-15","0","20","0","1","14.3","7.1"
"Muscogee","2020-03-16","13","33","1","2","15.4","7.7"
"Muscogee","2020-03-17","15","48","0","2","15.4","7.7"
"Muscogee","2020-03-18","29","77","2","4","16.4","8.2"
"Muscogee","2020-03-19","61","138","3","7","17.1","8.5"
"Muscogee","2020-03-20","33","171","4","11","18.8","9.4"
"Muscogee","2020-03-21","5","176","1","12","7.4","10.8"
"Muscogee","2020-03-22","13","189","0","12","7.4","10.8"
"Muscogee","2020-03-23","44","233","2","14","6.9","11.2"
"Muscogee","2020-03-24","102","335","2","16","7.2","11.3"
"Muscogee","2020-03-25","73","408","8","24","7.8","12.1"
"Muscogee","2020-03-26","93","501","9","33","8.5","12.8"
"Muscogee","2020-03-27","85","586","6","39","7.7","13.3"
"Muscogee","2020-03-28","1","587","0","39","4.9","6.1"
"Muscogee","2020-03-29","13","600","5","44","10.4","8.9"
"Muscogee","2020-03-30","57","657","5","49","11","9"
"Muscogee","2020-03-31","27","684","6","55","13.9","10.5"
"Muscogee","2020-04-01","101","785","13","68","14.2","11"
"Muscogee","2020-04-02","72","857","3","71","13.4","10.9"
"Muscogee","2020-04-03","36","893","3","74","13.5","10.6"
"Muscogee","2020-04-04","15","908","1","75","14.5","9.7"
"Muscogee","2020-04-05","9","917","1","76","10.6","10.5"
"Muscogee","2020-04-06","29","946","2","78","10.3","10.7"
"Muscogee","2020-04-07","44","990","5","83","8.8","11.3"
"Muscogee","2020-04-08","105","1095","12","95","8.6","11.4"
"Muscogee","2020-04-09","69","1164","11","106","10.2","11.8"
"Muscogee","2020-04-10","145","1309","18","124","10.8","12.2"
"Muscogee","2020-04-11","33","1342","3","127","11.2","12.8"
"Muscogee","2020-04-12","17","1359","2","129","11.3","10.9"
"Muscogee","2020-04-13","90","1449","8","137","11.6","10.9"
"Muscogee","2020-04-14","71","1520","7","144","11.3","10.1"
"Muscogee","2020-04-15","80","1600","10","154","11.5","10"
"Muscogee","2020-04-16","86","1686","12","166","11.2","10.7"
"Muscogee","2020-04-17","83","1769","7","173","10.6","10.7"
"Muscogee","2020-04-18","47","1816","3","176","10.3","10.7"
"Muscogee","2020-04-19","15","1831","2","178","10.5","10.9"
"Muscogee","2020-04-20","120","1951","4","182","9.7","10.6"
"Muscogee","2020-04-21","136","2087","12","194","9.5","10.4"
"Muscogee","2020-04-22","145","2232","12","206","8.9","10.2"
"Muscogee","2020-04-23","52","2284","0","206","6.9","9.1"
"Muscogee","2020-04-24","204","2488","11","217","6.5","8.6"
"Muscogee","2020-04-25","91","2579","4","221","6.2","8.2"
"Muscogee","2020-04-26","42","2621","1","222","4.7","7.6"
"Muscogee","2020-04-27","164","2785","8","230","4.9","7.3"
"Muscogee","2020-04-28","128","2913","4","234","4.1","6.8"
"Muscogee","2020-04-29","120","3033","4","238","3.4","6.1"
"Muscogee","2020-04-30","173","3206","5","243","3.8","5.4"
"Muscogee","2020-05-01","86","3292","7","250","4.2","5.3"
"Muscogee","2020-05-02","146","3438","11","261","4.6","5.4"
"Muscogee","2020-05-03","169","3607","4","265","4.6","4.6"
"Muscogee","2020-05-04","121","3728","9","274","5","4.9"
"Muscogee","2020-05-05","127","3855","2","276","4.8","4.4"
"Muscogee","2020-05-06","198","4053","7","283","4.8","4.1"
"Muscogee","2020-05-07","170","4223","2","285","4.5","4.2"
"Muscogee","2020-05-08","127","4350","6","291","4.1","4.1"
"Muscogee","2020-05-09","300","4650","3","294","3.1","3.9"
"Muscogee","2020-05-10","50","4700","0","294","2.8","3.7"
"Muscogee","2020-05-11","268","4968","13","307","2.4","3.7"
"Muscogee","2020-05-12","237","5205","9","316","2.7","3.7"
"Muscogee","2020-05-13","217","5422","16","332","3.3","4"
"Muscogee","2020-05-14","252","5674","20","352","4.2","4.4"
"Muscogee","2020-05-15","237","5911","18","370","4.7","4.4"
"Muscogee","2020-05-16","467","6378","24","394","5.2","4.2"
"Muscogee","2020-05-17","65","6443","2","396","5.7","4.2"
"Muscogee","2020-05-18","155","6598","13","409","6.2","4.3"
"Muscogee","2020-05-19","257","6855","15","424","6.5","4.6"
"Muscogee","2020-05-20","420","7275","16","440","6","4.6"
"Muscogee","2020-05-21","222","7497","9","449","5.4","4.8"
"Muscogee","2020-05-22","176","7673","8","457","5","4.8"
"Muscogee","2020-05-23","22","7695","3","460","6.2","5.7"
"Muscogee","2020-05-24","29","7724","0","460","5.8","5.7"
"Muscogee","2020-05-25","80","7804","5","465","5.4","5.8"
"Muscogee","2020-05-26","124","7928","12","477","6","6.2"
"Muscogee","2020-05-27","208","8136","10","487","6.1","6.1"
"Muscogee","2020-05-28","619","8755","33","520","6.3","5.9"
"Muscogee","2020-05-29","398","9153","27","547","6.6","5.8"
"Muscogee","2020-05-30","341","9494","31","578","6","6.1"
"Muscogee","2020-05-31","83","9577","9","587","7.5","6.6"
"Muscogee","2020-06-01","342","9919","36","623","8.2","6.8"
"Muscogee","2020-06-02","331","10250","28","651","8","7"
"Muscogee","2020-06-03","354","10604","34","685","8.7","7.4"
"Muscogee","2020-06-04","276","10880","26","711","9.2","7.8"
"Muscogee","2020-06-05","272","11152","26","737","9.6","8.1"
"Muscogee","2020-06-06","131","11283","13","750","9.8","7.9"
"Muscogee","2020-06-07","92","11375","11","761","9.9","8.7"
"Muscogee","2020-06-08","478","11853","35","796","9.5","8.8"
"Muscogee","2020-06-09","314","12167","23","819","9.3","8.6"
"Muscogee","2020-06-10","309","12476","25","844","9.1","8.9"
"Muscogee","2020-06-11","404","12880","35","879","9","9.1"
"Muscogee","2020-06-12","282","13162","31","910","9.2","9.4"
"Muscogee","2020-06-13","87","13249","21","931","11.2","10.5"
"Muscogee","2020-06-14","134","13383","10","941","10.6","10.2"
"Muscogee","2020-06-15","362","13745","50","991","11.5","10.5"
"Muscogee","2020-06-16","338","14083","45","1036","12.4","10.8"
"Muscogee","2020-06-17","358","14441","25","1061","12.2","10.6"
"Muscogee","2020-06-18","389","14830","54","1115","12.9","11"
"Muscogee","2020-06-19","378","15208","64","1179","13.8","11.5"
"Muscogee","2020-06-20","225","15433","31","1210","12.3","11.8"
"Muscogee","2020-06-21","88","15521","15","1225","13.7","12.1"
"Muscogee","2020-06-22","552","16073","103","1328","14.4","12.9"
"Muscogee","2020-06-23","443","16516","70","1398","14.7","13.5"
"Muscogee","2020-06-24","423","16939","84","1482","16.6","14.4"
"Muscogee","2020-06-25","469","17408","91","1573","17.4","15.1"
"Muscogee","2020-06-26","509","17917","78","1651","17.1","15.5"
"Muscogee","2020-06-27","325","18242","56","1707","17.6","15"
"Muscogee","2020-06-28","146","18388","38","1745","18.9","16.3"
"Muscogee","2020-06-29","602","18990","140","1885","19.6","17"
"Muscogee","2020-06-30","678","19668","106","1991","19.5","17.1"
"Muscogee","2020-07-01","729","20397","119","2110","19","17.8"
"Muscogee","2020-07-02","729","21126","142","2252","19","18.2"
"Muscogee","2020-07-03","573","21699","81","2333","18.9","18"
"Muscogee","2020-07-04","89","21788","24","2357","20.3","18.9"
"Muscogee","2020-07-05","326","22114","68","2425","19.5","19.2"
"Muscogee","2020-07-06","733","22847","168","2593","19.5","19.5"
"Muscogee","2020-07-07","717","23564","132","2725","19.9","19.7"
"Muscogee","2020-07-08","792","24356","114","2839","19.6","19.3"
"Muscogee","2020-07-09","729","25085","91","2930","18.6","18.8"
"Muscogee","2020-07-10","885","25970","130","3060","18.7","18.8"
"Muscogee","2020-07-11","208","26178","35","3095","17.2","18.7"
"Muscogee","2020-07-12","111","26289","23","3118","17.2","18.4"
"Muscogee","2020-07-13","556","26845","102","3220","16.6","18"
"Muscogee","2020-07-14","407","27252","69","3289","16.3","18.1"
"Muscogee","2020-07-15","497","27749","54","3343","15.8","17.7"
"Muscogee","2020-07-16","615","28364","68","3411","15.6","17.1"
"Muscogee","2020-07-17","566","28930","67","3478","15.2","17"
"Muscogee","2020-07-18","534","29464","55","3533","14.3","15.8"
"Muscogee","2020-07-19","137","29601","14","3547","12.8","15"
"Muscogee","2020-07-20","600","30201","64","3611","11.7","14.1"
"Muscogee","2020-07-21","392","30593","49","3660","11.1","13.7"
"Muscogee","2020-07-22","462","31055","48","3708","11","13.4"
"Muscogee","2020-07-23","600","31655","68","3776","11","13.3"
"Muscogee","2020-07-24","539","32194","50","3826","10.7","12.9"
"Muscogee","2020-07-25","572","32766","73","3899","11","12.7"
"Muscogee","2020-07-26","126","32892","13","3912","11","11.9"
"Muscogee","2020-07-27","545","33437","75","3987","11.5","11.6"
"Muscogee","2020-07-28","443","33880","57","4044","11.5","11.3"
"Muscogee","2020-07-29","445","34325","53","4097","11.7","11.4"
"Muscogee","2020-07-30","464","34789","47","4144","11.6","11.3"
"Muscogee","2020-07-31","384","35173","42","4186","11.8","11.2"
"Muscogee","2020-08-01","395","35568","25","4211","10.9","11"
"Muscogee","2020-08-02","76","35644","11","4222","11.5","11.3"
"Muscogee","2020-08-03","557","36201","63","4285","11.1","11.3"
"Muscogee","2020-08-04","444","36645","39","4324","10.6","11"
"Muscogee","2020-08-05","477","37122","39","4363","10","10.9"
"Muscogee","2020-08-06","412","37534","54","4417","10.4","11"
"Muscogee","2020-08-07","442","37976","25","4442","9.7","10.8"
"Muscogee","2020-08-08","216","38192","22","4464","10.2","10.6"
"Muscogee","2020-08-09","144","38336","16","4480","9.8","10.6"
"Muscogee","2020-08-10","458","38794","51","4531","9.7","10.4"
"Muscogee","2020-08-11","297","39091","39","4570","10.4","10.5"
"Muscogee","2020-08-12","358","39449","32","4602","10.5","10.2"
"Muscogee","2020-08-13","397","39846","38","4640","10","10.2"
"Muscogee","2020-08-14","469","40315","32","4672","10.1","9.9"
"Muscogee","2020-08-15","258","40573","17","4689","9.6","9.9"
"Muscogee","2020-08-16","149","40722","17","4706","9.7","9.7"
"Muscogee","2020-08-17","237","40959","22","4728","9.4","9.6"
"Muscogee","2020-08-18","310","41269","34","4762","9.1","9.7"
"Muscogee","2020-08-19","326","41595","31","4793","9.2","9.8"
"Muscogee","2020-08-20","317","41912","31","4824","9.2","9.6"
"Muscogee","2020-08-21","456","42368","35","4859","9.3","9.7"
"Muscogee","2020-08-22","213","42581","11","4870","9.1","9.4"
"Muscogee","2020-08-23","104","42685","7","4877","8.4","9.1"
"Muscogee","2020-08-24","248","42933","20","4897","8.3","8.8"
"Muscogee","2020-08-25","298","43231","21","4918","7.7","8.4"
"Muscogee","2020-08-26","328","43559","19","4937","7.2","8.2"
"Muscogee","2020-08-27","257","43816","27","4964","7.3","8.2"
"Muscogee","2020-08-28","263","44079","19","4983","7.2","8.3"
"Muscogee","2020-08-29","170","44249","21","5004","8.2","8.7"
"Muscogee","2020-08-30","136","44385","10","5014","8.3","8.4"
"Muscogee","2020-08-31","320","44705","24","5038","8.3","8.3"
"Muscogee","2020-09-01","241","44946","23","5061","8.6","8.2"
"Muscogee","2020-09-02","244","45190","22","5083","9.1","8.1"
"Muscogee","2020-09-03","325","45515","14","5097","8.2","7.7"
"Muscogee","2020-09-04","339","45854","20","5117","8","7.6"
"Muscogee","2020-09-05","259","46113","11","5128","6.8","7.5"
"Muscogee","2020-09-06","233","46346","10","5138","6.4","7.4"
"Muscogee","2020-09-07","84","46430","2","5140","5.7","7"
"Muscogee","2020-09-08","328","46758","31","5171","5.7","7.1"
"Muscogee","2020-09-09","274","47032","14","5185","5.1","7.1"
"Muscogee","2020-09-10","291","47323","25","5210","5.7","6.9"
"Muscogee","2020-09-11","323","47646","21","5231","5.8","6.9"
"Muscogee","2020-09-12","128","47774","6","5237","5.9","6.3"
"Muscogee","2020-09-13","99","47873","9","5246","6.5","6.5"
"Muscogee","2020-09-14","304","48177","15","5261","6.9","6.3"
"Muscogee","2020-09-15","198","48375","15","5276","6.6","6.1"
"Muscogee","2020-09-16","278","48653","13","5289","6.6","5.8"
"Muscogee","2020-09-17","246","48899","9","5298","5.9","5.8"
"Muscogee","2020-09-18","354","49253","19","5317","5.7","5.8"
"Muscogee","2020-09-19","196","49449","17","5334","6.3","6.1"
"Muscogee","2020-09-20","113","49562","8","5342","6","6.3"
"Muscogee","2020-09-21","291","49853","12","5354","5.9","6.4"
"Muscogee","2020-09-22","297","50150","24","5378","6","6.3"
"Muscogee","2020-09-23","337","50487","16","5394","6","6.3"
"Muscogee","2020-09-24","275","50762","14","5408","6.2","6"
"Muscogee","2020-09-25","309","51071","24","5432","6.5","6.1"
"Muscogee","2020-09-26","185","51256","11","5443","6.1","6.2"
"Muscogee","2020-09-27","78","51334","7","5450","6.4","6.2"
"Muscogee","2020-09-28","367","51701","8","5458","6.1","6"
"Muscogee","2020-09-29","326","52027","9","5467","5.4","5.7"
"Muscogee","2020-09-30","300","52327","13","5480","5.3","5.6"
"Muscogee","2020-10-01","368","52695","8","5488","4.9","5.5"
"Muscogee","2020-10-02","435","53130","14","5502","4.2","5.4"
"Muscogee","2020-10-03","294","53424","5","5507","3.6","4.9"
"Muscogee","2020-10-04","133","53557","6","5513","3","4.7"
"Muscogee","2020-10-05","370","53927","13","5526","3.2","4.6"
"Muscogee","2020-10-06","373","54300","16","5542","3.4","4.4"
"Muscogee","2020-10-07","381","54681","5","5547","3","4.1"
"Muscogee","2020-10-08","457","55138","12","5559","3","4"
"Muscogee","2020-10-09","534","55672","13","5572","2.9","3.6"
"Muscogee","2020-10-10","270","55942","14","5586","3.4","3.5"
"Muscogee","2020-10-11","149","56091","5","5591","3.2","3.1"
"Muscogee","2020-10-12","343","56434","8","5599","3.1","3.1"
"Muscogee","2020-10-13","311","56745","11","5610","3","3.2"
"Muscogee","2020-10-14","319","57064","13","5623","3.4","3.2"
"Muscogee","2020-10-15","384","57448","12","5635","3.4","3.2"
"Muscogee","2020-10-16","235","57683","11","5646","3.8","3.3"
"Muscogee","2020-10-17","386","58069","7","5653","3.3","3.3"
"Muscogee","2020-10-18","103","58172","8","5661","3.9","3.6"
"Muscogee","2020-10-19","380","58552","19","5680","4.3","3.7"
"Muscogee","2020-10-20","265","58817","6","5686","4.1","3.5"
"Muscogee","2020-10-21","329","59146","12","5698","4","3.7"
"Muscogee","2020-10-22","352","59498","15","5713","4.2","3.8"
"Muscogee","2020-10-23","397","59895","8","5721","3.8","3.8"
"Muscogee","2020-10-24","136","60031","7","5728","4.3","3.8"
"Muscogee","2020-10-25","86","60117","7","5735","4.4","4.1"
"Muscogee","2020-10-26","375","60492","19","5754","4.4","4.3"
"Muscogee","2020-10-27","301","60793","12","5766","4.6","4.4"
"Muscogee","2020-10-28","341","61134","13","5779","4.6","4.3"
"Muscogee","2020-10-29","331","61465","12","5791","4.5","4.4"
"Muscogee","2020-10-30","376","61841","14","5805","4.8","4.3"
"Muscogee","2020-10-31","146","61987","13","5818","5.3","4.8"
"Muscogee","2020-11-01","128","62115","12","5830","5.5","4.9"
"Muscogee","2020-11-02","317","62432","5","5835","5","4.7"
"Muscogee","2020-11-03","239","62671","10","5845","5","4.8"
"Muscogee","2020-11-04","394","63065","20","5865","5.2","4.9"
"Muscogee","2020-11-05","348","63413","10","5875","5.1","4.8"
"Muscogee","2020-11-06","299","63712","14","5889","5.2","5"
"Muscogee","2020-11-07","130","63842","9","5898","5","5.1"
"Muscogee","2020-11-08","86","63928","9","5907","5.1","5.3"
"Muscogee","2020-11-09","292","64220","16","5923","5.7","5.3"
"Muscogee","2020-11-10","337","64557","17","5940","5.8","5.4"
"Muscogee","2020-11-11","291","64848","7","5947","5.4","5.3"
"Muscogee","2020-11-12","310","65158","9","5956","5.4","5.3"
"Muscogee","2020-11-13","440","65598","14","5970","5.2","5.2"
"Muscogee","2020-11-14","353","65951","10","5980","4.6","4.8"
"Muscogee","2020-11-15","217","66168","8","5988","3.6","4.4"
"Muscogee","2020-11-16","302","66470","9","5997","3.3","4.5"
"Muscogee","2020-11-17","412","66882","18","6015","3.2","4.5"
"Muscogee","2020-11-18","450","67332","16","6031","3.4","4.4"
"Muscogee","2020-11-19","382","67714","12","6043","3.4","4.4"
"Muscogee","2020-11-20","496","68210","35","6078","3.9","4.6"
"Muscogee","2020-11-21","348","68558","16","6094","4.2","4.4"
"Muscogee","2020-11-22","260","68818","9","6103","4.2","3.9"
"Muscogee","2020-11-23","544","69362","27","6130","4.4","3.9"
"Muscogee","2020-11-24","331","69693","24","6154","4.9","4"
"Muscogee","2020-11-25","477","70170","24","6178","5.1","4.2"
"Muscogee","2020-11-26","69","70239","0","6178","4.6","4"
"Muscogee","2020-11-27","290","70529","21","6199","4.6","4.3"
"Muscogee","2020-11-28","252","70781","34","6233","5.9","5.1"
"Muscogee","2020-11-29","184","70965","26","6259","7.4","5.8"
"Muscogee","2020-11-30","541","71506","46","6305","7.9","6.2"
"Muscogee","2020-12-01","349","71855","35","6340","8.3","6.6"
"Muscogee","2020-12-02","609","72464","49","6389","8.8","6.9"
"Muscogee","2020-12-03","559","73023","58","6447","10.3","7.4"
"Muscogee","2020-12-04","537","73560","54","6501","10.7","7.7"
"Muscogee","2020-12-05","473","74033","39","6540","9.9","7.9"
"Muscogee","2020-12-06","165","74198","25","6565","10.1","8.8"
"Muscogee","2020-12-07","568","74766","64","6629","10.5","9.2"
"Muscogee","2020-12-08","502","75268","46","6675","10.3","9.3"
"Muscogee","2020-12-09","559","75827","55","6730","10.6","9.7"
"Muscogee","2020-12-10","623","76450","63","6793","10.5","10.4"
"Muscogee","2020-12-11","563","77013","75","6868","11","10.8"
"Muscogee","2020-12-12","412","77425","46","6914","11.4","10.7"
"Muscogee","2020-12-13","174","77599","34","6948","12.1","11.1"
"Muscogee","2020-12-14","798","78397","104","7052","12.3","11.4"
"Muscogee","2020-12-15","653","79050","94","7146","13.1","11.7"
"Muscogee","2020-12-16","472","79522","55","7201","13.3","12"
"Muscogee","2020-12-17","724","80246","83","7284","13.5","12"
"Muscogee","2020-12-18","681","80927","73","7357","13.1","12.1"
"Muscogee","2020-12-19","637","81564","59","7416","12.9","12.1"
"Muscogee","2020-12-20","238","81802","38","7454","12.4","12.2"
"Muscogee","2020-12-21","694","82496","99","7553","12.5","12.4"
"Muscogee","2020-12-22","698","83194","80","7633","12.1","12.6"
"Muscogee","2020-12-23","687","83881","99","7732","12.5","12.9"
"Muscogee","2020-12-24","732","84613","79","7811","12.4","13"
"Muscogee","2020-12-25","56","84669","11","7822","13.7","13.4"
"Muscogee","2020-12-26","403","85072","95","7917","15.7","14.3"
"Muscogee","2020-12-27","232","85304","55","7972","16.8","14.6"
"Muscogee","2020-12-28","786","86090","142","8114","17.4","15"
"Muscogee","2020-12-29","754","86844","171","8285","19","15.5"
"Muscogee","2020-12-30","1045","87889","169","8454","19.2","15.9"
"Muscogee","2020-12-31","957","88846","120","8574","19.5","15.9"
"Muscogee","2021-01-01","195","89041","32","8606","19","16.4"
"Muscogee","2021-01-02","357","89398","81","8687","18.9","17.3"
"Muscogee","2021-01-03","188","89586","54","8741","19.6","18.2"
"Muscogee","2021-01-04","742","90328","150","8891","19.9","18.6"
"Muscogee","2021-01-05","1260","91588","235","9126","19.3","19.2"
"Muscogee","2021-01-06","898","92486","152","9278","19.5","19.3"
"Muscogee","2021-01-07","869","93355","137","9415","19.9","19.7"
"Muscogee","2021-01-08","670","94025","112","9527","20","19.5"
"Muscogee","2021-01-09","621","94646","120","9647","19.5","19.2"
"Muscogee","2021-01-10","205","94851","49","9696","18.8","19.2"
"Muscogee","2021-01-11","573","95424","101","9797","18.4","19.2"
"Muscogee","2021-01-12","769","96193","155","9952","18.6","19"
"Muscogee","2021-01-13","864","97057","121","10073","18.2","18.8"
"Muscogee","2021-01-14","819","97876","106","10179","17.8","18.9"
"Muscogee","2021-01-15","645","98521","120","10299","18.1","19"
"Muscogee","2021-01-16","444","98965","77","10376","17.8","18.6"
"Muscogee","2021-01-17","212","99177","37","10413","16.9","17.8"
"Muscogee","2021-01-18","408","99585","81","10494","17.2","17.8"
"Muscogee","2021-01-19","730","100315","136","10630","17","17.8"
"Muscogee","2021-01-20","697","101012","83","10713","16.7","17.4"
"Muscogee","2021-01-21","685","101697","106","10819","17","17.4"
"Muscogee","2021-01-22","650","102347","82","10901","16.2","17.1"
"Muscogee","2021-01-23","332","102679","53","10954","16","16.9"
"Muscogee","2021-01-24","123","102802","28","10982","16.7","16.8"
"Muscogee","2021-01-25","291","103093","46","11028","16.2","16.7"
"Muscogee","2021-01-26","16","103109","2","11030","15.3","16.1"
"Muscogee","2021-01-27","0","103109","0","11030","13.6","15.1"
"Newton","2020-02-01","0","0","0","0",".","."
"Newton","2020-02-02","0","0","0","0",".","."
"Newton","2020-02-03","0","0","0","0",".","."
"Newton","2020-02-04","0","0","0","0",".","."
"Newton","2020-02-05","0","0","0","0",".","."
"Newton","2020-02-06","0","0","0","0",".","."
"Newton","2020-02-07","0","0","0","0","0","."
"Newton","2020-02-08","0","0","0","0","0","."
"Newton","2020-02-09","0","0","0","0","0","."
"Newton","2020-02-10","0","0","0","0","0","."
"Newton","2020-02-11","0","0","0","0","0","."
"Newton","2020-02-12","0","0","0","0","0","."
"Newton","2020-02-13","0","0","0","0","0","."
"Newton","2020-02-14","0","0","0","0","0","0"
"Newton","2020-02-15","0","0","0","0","0","0"
"Newton","2020-02-16","0","0","0","0","0","0"
"Newton","2020-02-17","0","0","0","0","0","0"
"Newton","2020-02-18","0","0","0","0","0","0"
"Newton","2020-02-19","0","0","0","0","0","0"
"Newton","2020-02-20","0","0","0","0","0","0"
"Newton","2020-02-21","0","0","0","0","0","0"
"Newton","2020-02-22","0","0","0","0","0","0"
"Newton","2020-02-23","0","0","0","0","0","0"
"Newton","2020-02-24","0","0","0","0","0","0"
"Newton","2020-02-25","0","0","0","0","0","0"
"Newton","2020-02-26","0","0","0","0","0","0"
"Newton","2020-02-27","0","0","0","0","0","0"
"Newton","2020-02-28","0","0","0","0","0","0"
"Newton","2020-02-29","0","0","0","0","0","0"
"Newton","2020-03-01","1","1","0","0","0","0"
"Newton","2020-03-02","0","1","0","0","0","0"
"Newton","2020-03-03","0","1","0","0","0","0"
"Newton","2020-03-04","0","1","0","0","0","0"
"Newton","2020-03-05","2","3","0","0","0","0"
"Newton","2020-03-06","0","3","0","0","0","0"
"Newton","2020-03-07","0","3","0","0","0","0"
"Newton","2020-03-08","0","3","0","0","0","0"
"Newton","2020-03-09","1","4","0","0","0","0"
"Newton","2020-03-10","0","4","0","0","0","0"
"Newton","2020-03-11","3","7","0","0","0","0"
"Newton","2020-03-12","5","12","1","1","2.9","1.4"
"Newton","2020-03-13","3","15","2","3","12.4","6.2"
"Newton","2020-03-14","4","19","0","3","12.4","6.2"
"Newton","2020-03-15","1","20","1","4","26.7","13.3"
"Newton","2020-03-16","13","33","3","7","30","15"
"Newton","2020-03-17","12","45","1","8","31.2","15.6"
"Newton","2020-03-18","15","60","2","10","33.1","16.5"
"Newton","2020-03-19","12","72","1","11","31.4","17.1"
"Newton","2020-03-20","18","90","4","15","25","18.7"
"Newton","2020-03-21","17","107","2","17","26.7","19.6"
"Newton","2020-03-22","16","123","2","19","14.2","20.4"
"Newton","2020-03-23","27","150","4","23","13","21.5"
"Newton","2020-03-24","38","188","9","32","15.2","23.2"
"Newton","2020-03-25","32","220","5","37","15.6","24.3"
"Newton","2020-03-26","41","261","2","39","15.1","23.2"
"Newton","2020-03-27","22","283","5","44","15.1","20.1"
"Newton","2020-03-28","5","288","0","44","13.5","20.1"
"Newton","2020-03-29","2","290","0","44","11.7","12.9"
"Newton","2020-03-30","24","314","4","48","11.9","12.5"
"Newton","2020-03-31","27","341","2","50","9.6","12.4"
"Newton","2020-04-01","31","372","4","54","9.2","12.4"
"Newton","2020-04-02","28","400","1","55","9","12.1"
"Newton","2020-04-03","26","426","5","60","8.5","11.8"
"Newton","2020-04-04","18","444","6","66","13.3","13.4"
"Newton","2020-04-05","9","453","3","69","18.1","14.9"
"Newton","2020-04-06","39","492","5","74","17.5","14.7"
"Newton","2020-04-07","54","546","5","79","17.8","13.7"
"Newton","2020-04-08","43","589","9","88","18.9","14.1"
"Newton","2020-04-09","37","626","6","94","20.7","14.9"
"Newton","2020-04-10","32","658","7","101","21.1","14.8"
"Newton","2020-04-11","28","686","1","102","16.9","15.1"
"Newton","2020-04-12","11","697","2","104","14.7","16.4"
"Newton","2020-04-13","52","749","7","111","14.8","16.1"
"Newton","2020-04-14","57","806","8","119","15.5","16.6"
"Newton","2020-04-15","47","853","4","123","13.7","16.3"
"Newton","2020-04-16","177","1030","12","135","12.3","16.5"
"Newton","2020-04-17","71","1101","1","136","9.4","15.3"
"Newton","2020-04-18","29","1130","5","141","11.4","14.1"
"Newton","2020-04-19","25","1155","3","144","10.5","12.6"
"Newton","2020-04-20","58","1213","5","149","9.8","12.3"
"Newton","2020-04-21","91","1304","5","154","8.6","12"
"Newton","2020-04-22","104","1408","8","162","8.5","11.1"
"Newton","2020-04-23","121","1529","9","171","8.6","10.5"
"Newton","2020-04-24","107","1636","7","178","9.3","9.4"
"Newton","2020-04-25","47","1683","4","182","8","9.7"
"Newton","2020-04-26","21","1704","3","185","8.4","9.4"
"Newton","2020-04-27","164","1868","6","191","7.7","8.7"
"Newton","2020-04-28","145","2013","9","200","7.8","8.2"
"Newton","2020-04-29","91","2104","2","202","7","7.7"
"Newton","2020-04-30","298","2402","16","218","6.7","7.6"
"Newton","2020-05-01","319","2721","18","236","6.6","7.9"
"Newton","2020-05-02","24","2745","2","238","6.5","7.3"
"Newton","2020-05-03","32","2777","2","240","5.4","6.9"
"Newton","2020-05-04","119","2896","7","247","5.7","6.7"
"Newton","2020-05-05","138","3034","14","261","6.3","7"
"Newton","2020-05-06","104","3138","7","268","6.9","6.9"
"Newton","2020-05-07","149","3287","1","269","6.2","6.5"
"Newton","2020-05-08","47","3334","2","271","6","6.3"
"Newton","2020-05-09","14","3348","1","272","5.9","6.2"
"Newton","2020-05-10","34","3382","2","274","5.8","5.6"
"Newton","2020-05-11","174","3556","11","285","5.9","5.8"
"Newton","2020-05-12","176","3732","4","289","4.8","5.5"
"Newton","2020-05-13","141","3873","9","298","4.7","5.8"
"Newton","2020-05-14","156","4029","8","306","5.3","5.8"
"Newton","2020-05-15","152","4181","4","310","5.1","5.6"
"Newton","2020-05-16","47","4228","2","312","4.7","5.3"
"Newton","2020-05-17","47","4275","4","316","5.1","5.4"
"Newton","2020-05-18","175","4450","6","322","4.7","5.3"
"Newton","2020-05-19","179","4629","15","337","5.5","5.1"
"Newton","2020-05-20","183","4812","20","357","6.2","5.4"
"Newton","2020-05-21","90","4902","11","368","7.2","6.3"
"Newton","2020-05-22","200","5102","9","377","7.5","6.3"
"Newton","2020-05-23","36","5138","5","382","8.8","6.8"
"Newton","2020-05-24","41","5179","3","385","8.7","6.9"
"Newton","2020-05-25","26","5205","2","387","9.3","7"
"Newton","2020-05-26","182","5387","12","399","9","7.3"
"Newton","2020-05-27","175","5562","5","404","7.9","7"
"Newton","2020-05-28","119","5681","4","408","6.6","6.9"
"Newton","2020-05-29","109","5790","5","413","6.6","7"
"Newton","2020-05-30","41","5831","2","415","5.3","7.1"
"Newton","2020-05-31","54","5885","5","420","5.6","7.1"
"Newton","2020-06-01","143","6028","5","425","5","7.1"
"Newton","2020-06-02","143","6171","4","429","4.5","6.7"
"Newton","2020-06-03","148","6319","7","436","4.7","6.3"
"Newton","2020-06-04","111","6430","4","440","4.8","5.7"
"Newton","2020-06-05","95","6525","7","447","5.2","5.9"
"Newton","2020-06-06","42","6567","2","449","5.1","5.2"
"Newton","2020-06-07","40","6607","3","452","4.9","5.2"
"Newton","2020-06-08","131","6738","6","458","5","5"
"Newton","2020-06-09","130","6868","7","465","5.4","4.9"
"Newton","2020-06-10","148","7016","9","474","5.6","5.2"
"Newton","2020-06-11","127","7143","13","487","6.6","5.7"
"Newton","2020-06-12","122","7265","9","496","6.6","5.9"
"Newton","2020-06-13","49","7314","5","501","7.3","6.2"
"Newton","2020-06-14","25","7339","5","506","9.1","7"
"Newton","2020-06-15","185","7524","18","524","9.9","7.5"
"Newton","2020-06-16","147","7671","7","531","9.8","7.6"
"Newton","2020-06-17","143","7814","7","538","9.6","7.6"
"Newton","2020-06-18","174","7988","18","556","9.6","8.1"
"Newton","2020-06-19","169","8157","12","568","9.6","8.1"
"Newton","2020-06-20","52","8209","8","576","10.3","8.8"
"Newton","2020-06-21","39","8248","4","580","8.9","9"
"Newton","2020-06-22","218","8466","32","612","9.6","9.7"
"Newton","2020-06-23","174","8640","23","635","10.8","10.3"
"Newton","2020-06-24","222","8862","19","654","11.4","10.5"
"Newton","2020-06-25","198","9060","21","675","11.4","10.5"
"Newton","2020-06-26","188","9248","30","705","12.7","11.1"
"Newton","2020-06-27","68","9316","11","716","12.8","11.5"
"Newton","2020-06-28","55","9371","4","720","12.4","10.6"
"Newton","2020-06-29","285","9656","24","744","11.5","10.5"
"Newton","2020-06-30","304","9960","38","782","11.4","11.1"
"Newton","2020-07-01","288","10248","26","808","11.4","11.4"
"Newton","2020-07-02","239","10487","27","835","11.5","11.5"
"Newton","2020-07-03","96","10583","15","850","11.5","12.1"
"Newton","2020-07-04","20","10603","5","855","12.7","12.8"
"Newton","2020-07-05","58","10661","13","868","14.9","13.6"
"Newton","2020-07-06","282","10943","52","920","16.3","13.9"
"Newton","2020-07-07","307","11250","37","957","16.3","13.8"
"Newton","2020-07-08","269","11519","38","995","17","14.2"
"Newton","2020-07-09","273","11792","37","1032","17.3","14.4"
"Newton","2020-07-10","254","12046","33","1065","16.9","14.2"
"Newton","2020-07-11","78","12124","15","1080","16.1","14.4"
"Newton","2020-07-12","50","12174","12","1092","16.3","15.6"
"Newton","2020-07-13","192","12366","25","1117","15.6","15.9"
"Newton","2020-07-14","170","12536","34","1151","16.7","16.5"
"Newton","2020-07-15","148","12684","35","1186","18.1","17.5"
"Newton","2020-07-16","164","12848","29","1215","18.7","18"
"Newton","2020-07-17","140","12988","19","1234","18.7","17.8"
"Newton","2020-07-18","69","13057","21","1255","20.3","18.2"
"Newton","2020-07-19","67","13124","12","1267","19.5","17.9"
"Newton","2020-07-20","152","13276","34","1301","20.8","18.2"
"Newton","2020-07-21","152","13428","24","1325","20.2","18.5"
"Newton","2020-07-22","163","13591","18","1343","18.4","18.2"
"Newton","2020-07-23","135","13726","29","1372","18.9","18.8"
"Newton","2020-07-24","212","13938","32","1404","19.2","18.9"
"Newton","2020-07-25","111","14049","25","1429","18","19.2"
"Newton","2020-07-26","66","14115","10","1439","17.6","18.6"
"Newton","2020-07-27","290","14405","26","1465","15.7","18.3"
"Newton","2020-07-28","252","14657","27","1492","15","17.6"
"Newton","2020-07-29","239","14896","29","1521","15.2","16.8"
"Newton","2020-07-30","264","15160","35","1556","14","16.5"
"Newton","2020-07-31","295","15455","27","1583","13.1","16.1"
"Newton","2020-08-01","86","15541","7","1590","11.1","14.6"
"Newton","2020-08-02","41","15582","6","1596","11","14.3"
"Newton","2020-08-03","238","15820","22","1618","11","13.4"
"Newton","2020-08-04","236","16056","33","1651","11.5","13.3"
"Newton","2020-08-05","213","16269","27","1678","11.6","13.4"
"Newton","2020-08-06","239","16508","34","1712","11.7","12.8"
"Newton","2020-08-07","208","16716","28","1740","12.3","12.7"
"Newton","2020-08-08","96","16812","11","1751","12.8","11.9"
"Newton","2020-08-09","74","16886","15","1766","13.6","12.3"
"Newton","2020-08-10","292","17178","30","1796","13.8","12.4"
"Newton","2020-08-11","157","17335","19","1815","13.5","12.5"
"Newton","2020-08-12","263","17598","33","1848","13.5","12.5"
"Newton","2020-08-13","257","17855","29","1877","13.1","12.4"
"Newton","2020-08-14","254","18109","18","1895","12.1","12.2"
"Newton","2020-08-15","100","18209","13","1908","12.4","12.6"
"Newton","2020-08-16","93","18302","12","1920","11.3","12.5"
"Newton","2020-08-17","260","18562","13","1933","10.6","12.2"
"Newton","2020-08-18","170","18732","13","1946","9.9","11.7"
"Newton","2020-08-19","197","18929","16","1962","9.3","11.4"
"Newton","2020-08-20","161","19090","16","1978","9.1","11.1"
"Newton","2020-08-21","200","19290","13","1991","9","10.6"
"Newton","2020-08-22","87","19377","11","2002","9","10.7"
"Newton","2020-08-23","51","19428","5","2007","8.5","9.9"
"Newton","2020-08-24","218","19646","23","2030","9.3","9.9"
"Newton","2020-08-25","206","19852","21","2051","9.7","9.8"
"Newton","2020-08-26","243","20095","26","2077","10","9.7"
"Newton","2020-08-27","192","20287","13","2090","9.6","9.3"
"Newton","2020-08-28","240","20527","21","2111","9.9","9.5"
"Newton","2020-08-29","66","20593","7","2118","9.6","9.3"
"Newton","2020-08-30","52","20645","11","2129","11.2","9.9"
"Newton","2020-08-31","198","20843","24","2153","11.5","10.4"
"Newton","2020-09-01","149","20992","9","2162","10.9","10.3"
"Newton","2020-09-02","169","21161","10","2172","10.2","10.1"
"Newton","2020-09-03","150","21311","4","2176","9.6","9.6"
"Newton","2020-09-04","170","21481","11","2187","9.3","9.6"
"Newton","2020-09-05","77","21558","8","2195","9.3","9.4"
"Newton","2020-09-06","85","21643","13","2208","8.4","9.8"
"Newton","2020-09-07","53","21696","1","2209","7","9.2"
"Newton","2020-09-08","169","21865","15","2224","7.4","9.1"
"Newton","2020-09-09","220","22085","13","2237","7.4","8.8"
"Newton","2020-09-10","161","22246","14","2251","8.2","8.9"
"Newton","2020-09-11","238","22484","6","2257","7.7","8.5"
"Newton","2020-09-12","40","22524","6","2263","8.3","8.8"
"Newton","2020-09-13","39","22563","3","2266","7.2","7.8"
"Newton","2020-09-14","271","22834","11","2277","7.5","7.2"
"Newton","2020-09-15","156","22990","10","2287","7.2","7.3"
"Newton","2020-09-16","246","23236","14","2301","7.2","7.3"
"Newton","2020-09-17","132","23368","8","2309","6.8","7.5"
"Newton","2020-09-18","305","23673","9","2318","6.8","7.2"
"Newton","2020-09-19","58","23731","2","2320","5.2","6.7"
"Newton","2020-09-20","30","23761","2","2322","5","6.1"
"Newton","2020-09-21","277","24038","14","2336","5.2","6.4"
"Newton","2020-09-22","146","24184","8","2344","5.1","6.1"
"Newton","2020-09-23","205","24389","5","2349","4.6","5.9"
"Newton","2020-09-24","120","24509","8","2357","4.7","5.7"
"Newton","2020-09-25","275","24784","18","2375","5.2","6"
"Newton","2020-09-26","49","24833","4","2379","5.9","5.5"
"Newton","2020-09-27","43","24876","6","2385","6.9","6"
"Newton","2020-09-28","254","25130","6","2391","6.5","5.8"
"Newton","2020-09-29","182","25312","9","2400","6.4","5.7"
"Newton","2020-09-30","239","25551","13","2413","6.9","5.7"
"Newton","2020-10-01","155","25706","7","2420","6.6","5.6"
"Newton","2020-10-02","234","25940","9","2429","6.2","5.7"
"Newton","2020-10-03","55","25995","4","2433","6","6"
"Newton","2020-10-04","37","26032","0","2433","4.1","5.5"
"Newton","2020-10-05","260","26292","9","2442","4.2","5.4"
"Newton","2020-10-06","144","26436","10","2452","4.5","5.5"
"Newton","2020-10-07","175","26611","5","2457","4.1","5.5"
"Newton","2020-10-08","161","26772","12","2469","4.5","5.6"
"Newton","2020-10-09","204","26976","11","2480","4.8","5.5"
"Newton","2020-10-10","57","27033","4","2484","4.7","5.4"
"Newton","2020-10-11","43","27076","1","2485","5.1","4.6"
"Newton","2020-10-12","131","27207","9","2494","5.6","4.9"
"Newton","2020-10-13","176","27383","12","2506","5.5","5"
"Newton","2020-10-14","151","27534","10","2516","6.1","5.1"
"Newton","2020-10-15","154","27688","6","2522","5.6","5.1"
"Newton","2020-10-16","99","27787","6","2528","5.7","5.2"
"Newton","2020-10-17","35","27822","2","2530","5.5","5.1"
"Newton","2020-10-18","27","27849","2","2532","6.2","5.6"
"Newton","2020-10-19","180","28029","11","2543","6.1","5.8"
"Newton","2020-10-20","166","28195","10","2553","6","5.8"
"Newton","2020-10-21","180","28375","14","2567","6.1","6.1"
"Newton","2020-10-22","149","28524","8","2575","6.4","6"
"Newton","2020-10-23","219","28743","20","2595","6.8","6.2"
"Newton","2020-10-24","61","28804","1","2596","6.2","5.8"
"Newton","2020-10-25","81","28885","11","2607","7.1","6.6"
"Newton","2020-10-26","172","29057","11","2618","7.1","6.6"
"Newton","2020-10-27","212","29269","15","2633","7.3","6.6"
"Newton","2020-10-28","189","29458","14","2647","7.2","6.7"
"Newton","2020-10-29","128","29586","10","2657","7.6","7"
"Newton","2020-10-30","229","29815","13","2670","7.1","6.9"
"Newton","2020-10-31","70","29885","9","2679","8.7","7.4"
"Newton","2020-11-01","75","29960","12","2691","9","8.1"
"Newton","2020-11-02","204","30164","17","2708","9.3","8.2"
"Newton","2020-11-03","175","30339","19","2727","9.8","8.6"
"Newton","2020-11-04","242","30581","21","2748","10","8.6"
"Newton","2020-11-05","217","30798","26","2774","10.6","9.1"
"Newton","2020-11-06","226","31024","25","2799","11.4","9.2"
"Newton","2020-11-07","94","31118","15","2814","11.8","10.3"
"Newton","2020-11-08","52","31170","9","2823","12","10.5"
"Newton","2020-11-09","227","31397","20","2843","12.1","10.7"
"Newton","2020-11-10","260","31657","28","2871","12.1","11"
"Newton","2020-11-11","161","31818","12","2883","11.9","11"
"Newton","2020-11-12","209","32027","19","2902","11.5","11.1"
"Newton","2020-11-13","219","32246","17","2919","11","11.2"
"Newton","2020-11-14","103","32349","9","2928","10","10.9"
"Newton","2020-11-15","71","32420","17","2945","10.9","11.5"
"Newton","2020-11-16","226","32646","23","2968","11.1","11.6"
"Newton","2020-11-17","273","32919","19","2987","10.6","11.3"
"Newton","2020-11-18","268","33187","30","3017","11.1","11.5"
"Newton","2020-11-19","233","33420","21","3038","11.1","11.3"
"Newton","2020-11-20","214","33634","20","3058","11.3","11.2"
"Newton","2020-11-21","89","33723","14","3072","12.3","11.2"
"Newton","2020-11-22","96","33819","9","3081","10.3","10.6"
"Newton","2020-11-23","276","34095","30","3111","10.4","10.7"
"Newton","2020-11-24","243","34338","23","3134","10.7","10.7"
"Newton","2020-11-25","223","34561","21","3155","10.5","10.8"
"Newton","2020-11-26","33","34594","5","3160","11.3","11.2"
"Newton","2020-11-27","129","34723","22","3182","12.4","11.9"
"Newton","2020-11-28","96","34819","18","3200","12.9","12.6"
"Newton","2020-11-29","80","34899","14","3214","14","12.1"
"Newton","2020-11-30","339","35238","56","3270","14.8","12.6"
"Newton","2020-12-01","280","35518","48","3318","15.9","13.3"
"Newton","2020-12-02","311","35829","47","3365","16.7","13.6"
"Newton","2020-12-03","299","36128","48","3413","16.9","14.1"
"Newton","2020-12-04","271","36399","37","3450","16.4","14.4"
"Newton","2020-12-05","154","36553","36","3486","17.1","15"
"Newton","2020-12-06","88","36641","15","3501","17","15.5"
"Newton","2020-12-07","348","36989","54","3555","16.8","15.8"
"Newton","2020-12-08","361","37350","57","3612","16.6","16.3"
"Newton","2020-12-09","346","37696","61","3673","17","16.9"
"Newton","2020-12-10","322","38018","65","3738","17.6","17.2"
"Newton","2020-12-11","268","38286","46","3784","18.1","17.2"
"Newton","2020-12-12","153","38439","39","3823","18.4","17.7"
"Newton","2020-12-13","95","38534","26","3849","19.9","18.4"
"Newton","2020-12-14","411","38945","56","3905","19.6","18.2"
"Newton","2020-12-15","402","39347","62","3967","19.6","18.1"
"Newton","2020-12-16","381","39728","72","4039","19.7","18.4"
"Newton","2020-12-17","376","40104","73","4112","19.6","18.6"
"Newton","2020-12-18","395","40499","72","4184","19.8","18.9"
"Newton","2020-12-19","160","40659","25","4209","18.4","18.4"
"Newton","2020-12-20","102","40761","15","4224","16.6","18.2"
"Newton","2020-12-21","355","41116","63","4287","17.1","18.4"
"Newton","2020-12-22","338","41454","68","4355","17.8","18.7"
"Newton","2020-12-23","296","41750","81","4436","19","19.4"
"Newton","2020-12-24","158","41908","37","4473","19.6","19.6"
"Newton","2020-12-25","34","41942","8","4481","20.4","20.1"
"Newton","2020-12-26","137","42079","36","4517","21.9","20.1"
"Newton","2020-12-27","109","42188","26","4543","23.2","19.9"
"Newton","2020-12-28","334","42522","79","4622","24","20.6"
"Newton","2020-12-29","360","42882","103","4725","25.2","21.5"
"Newton","2020-12-30","367","43249","91","4816","24.9","22"
"Newton","2020-12-31","291","43540","55","4871","24.2","21.9"
"Newton","2021-01-01","62","43602","21","4892","25.7","23"
"Newton","2021-01-02","137","43739","24","4916","24.5","23.2"
"Newton","2021-01-03","108","43847","20","4936","23.7","23.4"
"Newton","2021-01-04","294","44141","62","4998","23.3","23.7"
"Newton","2021-01-05","423","44564","88","5086","22.2","23.7"
"Newton","2021-01-06","374","44938","86","5172","22","23.4"
"Newton","2021-01-07","432","45370","102","5274","22.6","23.4"
"Newton","2021-01-08","374","45744","83","5357","21","23.3"
"Newton","2021-01-09","153","45897","42","5399","22.4","23.4"
"Newton","2021-01-10","116","46013","25","5424","22.8","23.3"
"Newton","2021-01-11","384","46397","79","5503","22.7","23"
"Newton","2021-01-12","369","46766","84","5587","23","22.6"
"Newton","2021-01-13","319","47085","46","5633","21.8","21.9"
"Newton","2021-01-14","293","47378","62","5695","21.4","22"
"Newton","2021-01-15","326","47704","66","5761","21.2","21.1"
"Newton","2021-01-16","168","47872","35","5796","20.2","21.3"
"Newton","2021-01-17","113","47985","17","5813","19.3","21.1"
"Newton","2021-01-18","206","48191","51","5864","19.9","21.3"
"Newton","2021-01-19","376","48567","53","5917","18.7","20.8"
"Newton","2021-01-20","342","48909","56","5973","18.9","20.4"
"Newton","2021-01-21","307","49216","45","6018","18","19.7"
"Newton","2021-01-22","296","49512","38","6056","16.9","19.1"
"Newton","2021-01-23","158","49670","20","6076","15.8","18"
"Newton","2021-01-24","49","49719","15","6091","18","18.6"
"Newton","2021-01-25","101","49820","19","6110","17.1","18.5"
"Newton","2021-01-26","5","49825","0","6110","15.1","16.9"
"Newton","2021-01-27","0","49825","0","6110","12.8","15.9"
"Oconee","2020-02-01","0","0","0","0",".","."
"Oconee","2020-02-02","0","0","0","0",".","."
"Oconee","2020-02-03","0","0","0","0",".","."
"Oconee","2020-02-04","0","0","0","0",".","."
"Oconee","2020-02-05","0","0","0","0",".","."
"Oconee","2020-02-06","0","0","0","0",".","."
"Oconee","2020-02-07","0","0","0","0","0","."
"Oconee","2020-02-08","0","0","0","0","0","."
"Oconee","2020-02-09","0","0","0","0","0","."
"Oconee","2020-02-10","0","0","0","0","0","."
"Oconee","2020-02-11","0","0","0","0","0","."
"Oconee","2020-02-12","0","0","0","0","0","."
"Oconee","2020-02-13","0","0","0","0","0","."
"Oconee","2020-02-14","0","0","0","0","0","0"
"Oconee","2020-02-15","0","0","0","0","0","0"
"Oconee","2020-02-16","0","0","0","0","0","0"
"Oconee","2020-02-17","0","0","0","0","0","0"
"Oconee","2020-02-18","0","0","0","0","0","0"
"Oconee","2020-02-19","0","0","0","0","0","0"
"Oconee","2020-02-20","0","0","0","0","0","0"
"Oconee","2020-02-21","0","0","0","0","0","0"
"Oconee","2020-02-22","0","0","0","0","0","0"
"Oconee","2020-02-23","0","0","0","0","0","0"
"Oconee","2020-02-24","0","0","0","0","0","0"
"Oconee","2020-02-25","0","0","0","0","0","0"
"Oconee","2020-02-26","0","0","0","0","0","0"
"Oconee","2020-02-27","0","0","0","0","0","0"
"Oconee","2020-02-28","0","0","0","0","0","0"
"Oconee","2020-02-29","0","0","0","0","0","0"
"Oconee","2020-03-01","0","0","0","0","0","0"
"Oconee","2020-03-02","0","0","0","0","0","0"
"Oconee","2020-03-03","0","0","0","0","0","0"
"Oconee","2020-03-04","0","0","0","0","0","0"
"Oconee","2020-03-05","0","0","0","0","0","0"
"Oconee","2020-03-06","0","0","0","0","0","0"
"Oconee","2020-03-07","0","0","0","0","0","0"
"Oconee","2020-03-08","1","1","0","0","0","0"
"Oconee","2020-03-09","1","2","0","0","0","0"
"Oconee","2020-03-10","2","4","0","0","0","0"
"Oconee","2020-03-11","0","4","0","0","0","0"
"Oconee","2020-03-12","11","15","1","1","1.3","0.6"
"Oconee","2020-03-13","8","23","0","1","1.3","0.6"
"Oconee","2020-03-14","1","24","0","1","1.3","0.6"
"Oconee","2020-03-15","3","27","1","2","6.1","3"
"Oconee","2020-03-16","11","38","1","3","7.4","3.7"
"Oconee","2020-03-17","8","46","0","3","7.4","3.7"
"Oconee","2020-03-18","13","59","0","3","7.4","3.7"
"Oconee","2020-03-19","24","83","3","6","7.8","4.6"
"Oconee","2020-03-20","19","102","1","7","8.6","4.9"
"Oconee","2020-03-21","4","106","0","7","8.6","4.9"
"Oconee","2020-03-22","1","107","0","7","3.8","4.9"
"Oconee","2020-03-23","11","118","0","7","2.5","4.9"
"Oconee","2020-03-24","29","147","7","14","6","6.7"
"Oconee","2020-03-25","13","160","3","17","9.3","8.3"
"Oconee","2020-03-26","17","177","1","18","8.3","8.1"
"Oconee","2020-03-27","13","190","0","18","7.6","8.1"
"Oconee","2020-03-28","3","193","1","19","12.3","10.5"
"Oconee","2020-03-29","2","195","0","19","12.3","8.1"
"Oconee","2020-03-30","10","205","1","20","13.8","8.2"
"Oconee","2020-03-31","9","214","0","20","10.3","8.2"
"Oconee","2020-04-01","9","223","0","20","7","8.2"
"Oconee","2020-04-02","4","227","0","20","6.2","7.3"
"Oconee","2020-04-03","30","257","2","22","7.1","7.4"
"Oconee","2020-04-04","0","257","0","22","2.4","7.4"
"Oconee","2020-04-05","1","258","0","22","2.4","7.4"
"Oconee","2020-04-06","11","269","2","24","3.5","8.7"
"Oconee","2020-04-07","5","274","0","24","3.5","6.9"
"Oconee","2020-04-08","12","286","2","26","5.9","6.5"
"Oconee","2020-04-09","17","303","3","29","8.5","7.3"
"Oconee","2020-04-10","29","332","6","35","10.5","8.8"
"Oconee","2020-04-11","3","335","0","35","10.5","6.4"
"Oconee","2020-04-12","3","338","0","35","10.5","6.4"
"Oconee","2020-04-13","8","346","0","35","7.9","5.7"
"Oconee","2020-04-14","9","355","1","36","9.4","6.5"
"Oconee","2020-04-15","9","364","0","36","7.1","6.5"
"Oconee","2020-04-16","8","372","0","36","4.5","6.5"
"Oconee","2020-04-17","7","379","0","36","1.6","6"
"Oconee","2020-04-18","2","381","0","36","1.6","6"
"Oconee","2020-04-19","1","382","0","36","1.6","6"
"Oconee","2020-04-20","10","392","0","36","1.6","4.7"
"Oconee","2020-04-21","11","403","1","37","1.3","5.4"
"Oconee","2020-04-22","8","411","0","37","1.3","4.2"
"Oconee","2020-04-23","9","420","2","39","4.5","4.5"
"Oconee","2020-04-24","3","423","0","39","4.5","3"
"Oconee","2020-04-25","2","425","0","39","4.5","3"
"Oconee","2020-04-26","2","427","0","39","4.5","3"
"Oconee","2020-04-27","16","443","0","39","4.5","3"
"Oconee","2020-04-28","12","455","1","40","4.4","2.8"
"Oconee","2020-04-29","20","475","1","41","5.1","3.2"
"Oconee","2020-04-30","5","480","0","41","1.9","3.2"
"Oconee","2020-05-01","18","498","1","42","2.7","3.6"
"Oconee","2020-05-02","5","503","0","42","2.7","3.6"
"Oconee","2020-05-03","1","504","1","43","17","10.7"
"Oconee","2020-05-04","18","522","1","44","17.8","11.1"
"Oconee","2020-05-05","11","533","0","44","16.6","10.5"
"Oconee","2020-05-06","26","559","0","44","15.9","10.5"
"Oconee","2020-05-07","13","572","0","44","15.9","8.9"
"Oconee","2020-05-08","13","585","1","45","16.2","9.4"
"Oconee","2020-05-09","3","588","1","46","20.9","11.8"
"Oconee","2020-05-10","2","590","0","46","6.7","11.8"
"Oconee","2020-05-11","31","621","1","47","6.3","12"
"Oconee","2020-05-12","26","647","2","49","7.4","12"
"Oconee","2020-05-13","17","664","0","49","7.4","11.6"
"Oconee","2020-05-14","10","674","0","49","7.4","11.6"
"Oconee","2020-05-15","22","696","1","50","7","11.6"
"Oconee","2020-05-16","11","707","0","50","2.2","11.6"
"Oconee","2020-05-17","10","717","2","52","5.1","5.9"
"Oconee","2020-05-18","24","741","0","52","4.6","5.5"
"Oconee","2020-05-19","32","773","2","54","4.4","5.9"
"Oconee","2020-05-20","19","792","0","54","4.4","5.9"
"Oconee","2020-05-21","20","812","0","54","4.4","5.9"
"Oconee","2020-05-22","25","837","0","54","3.8","5.4"
"Oconee","2020-05-23","12","849","1","55","4.9","3.6"
"Oconee","2020-05-24","2","851","0","55","2.1","3.6"
"Oconee","2020-05-25","6","857","0","55","2.1","3.3"
"Oconee","2020-05-26","37","894","3","58","2.3","3.4"
"Oconee","2020-05-27","40","934","0","58","2.3","3.4"
"Oconee","2020-05-28","29","963","0","58","2.3","3.4"
"Oconee","2020-05-29","31","994","2","60","3.3","3.5"
"Oconee","2020-05-30","11","1005","0","60","2.1","3.5"
"Oconee","2020-05-31","8","1013","0","60","2.1","2.1"
"Oconee","2020-06-01","27","1040","0","60","2.1","2.1"
"Oconee","2020-06-02","21","1061","1","61","1.6","2"
"Oconee","2020-06-03","31","1092","2","63","2.5","2.4"
"Oconee","2020-06-04","31","1123","0","63","2.5","2.4"
"Oconee","2020-06-05","55","1178","1","64","1.9","2.6"
"Oconee","2020-06-06","19","1197","0","64","1.9","2"
"Oconee","2020-06-07","10","1207","0","64","1.9","2"
"Oconee","2020-06-08","32","1239","1","65","2.3","2.2"
"Oconee","2020-06-09","32","1271","0","65","1.6","1.6"
"Oconee","2020-06-10","28","1299","0","65","0.7","1.6"
"Oconee","2020-06-11","30","1329","0","65","0.7","1.6"
"Oconee","2020-06-12","44","1373","1","66","0.8","1.3"
"Oconee","2020-06-13","11","1384","1","67","2.1","2"
"Oconee","2020-06-14","10","1394","0","67","2.1","2"
"Oconee","2020-06-15","41","1435","2","69","2.3","2.3"
"Oconee","2020-06-16","31","1466","1","70","2.8","2.2"
"Oconee","2020-06-17","34","1500","1","71","3.2","2"
"Oconee","2020-06-18","46","1546","3","74","4.1","2.4"
"Oconee","2020-06-19","25","1571","0","74","3.8","2.3"
"Oconee","2020-06-20","17","1588","1","75","3.3","2.7"
"Oconee","2020-06-21","13","1601","0","75","3.3","2.7"
"Oconee","2020-06-22","82","1683","3","78","3.2","2.7"
"Oconee","2020-06-23","45","1728","5","83","4.3","3.5"
"Oconee","2020-06-24","55","1783","4","87","4.9","4.1"
"Oconee","2020-06-25","76","1859","8","95","5.5","4.8"
"Oconee","2020-06-26","66","1925","6","101","6.8","5.3"
"Oconee","2020-06-27","53","1978","6","107","7.6","5.5"
"Oconee","2020-06-28","35","2013","6","113","10","6.7"
"Oconee","2020-06-29","85","2098","11","124","11.3","7.3"
"Oconee","2020-06-30","65","2163","8","132","11.5","7.9"
"Oconee","2020-07-01","59","2222","6","138","11.9","8.4"
"Oconee","2020-07-02","87","2309","14","152","12.7","9.1"
"Oconee","2020-07-03","48","2357","5","157","12.9","9.9"
"Oconee","2020-07-04","7","2364","0","157","11.3","9.4"
"Oconee","2020-07-05","29","2393","2","159","9.8","9.9"
"Oconee","2020-07-06","95","2488","13","172","9.9","10.6"
"Oconee","2020-07-07","68","2556","9","181","10.1","10.8"
"Oconee","2020-07-08","56","2612","7","188","10.4","11.2"
"Oconee","2020-07-09","81","2693","13","201","10.4","11.6"
"Oconee","2020-07-10","77","2770","4","205","9.7","11.3"
"Oconee","2020-07-11","15","2785","1","206","10.6","10.9"
"Oconee","2020-07-12","16","2801","5","211","14.1","12"
"Oconee","2020-07-13","52","2853","7","218","14.1","12"
"Oconee","2020-07-14","44","2897","8","226","14.8","12.4"
"Oconee","2020-07-15","54","2951","8","234","15.1","12.7"
"Oconee","2020-07-16","65","3016","7","241","14.3","12.4"
"Oconee","2020-07-17","49","3065","5","246","15","12.4"
"Oconee","2020-07-18","26","3091","2","248","15.2","12.9"
"Oconee","2020-07-19","29","3120","4","252","12.7","13.4"
"Oconee","2020-07-20","67","3187","11","263","13.1","13.6"
"Oconee","2020-07-21","44","3231","3","266","11.5","13.1"
"Oconee","2020-07-22","46","3277","3","269","10.3","12.7"
"Oconee","2020-07-23","56","3333","13","282","12.1","13.2"
"Oconee","2020-07-24","47","3380","4","286","11.9","13.5"
"Oconee","2020-07-25","26","3406","5","291","13.5","14.3"
"Oconee","2020-07-26","12","3418","4","295","16.3","14.5"
"Oconee","2020-07-27","47","3465","6","301","15.8","14.4"
"Oconee","2020-07-28","59","3524","6","307","16.2","13.9"
"Oconee","2020-07-29","48","3572","6","313","17.1","13.7"
"Oconee","2020-07-30","43","3615","4","317","15.1","13.6"
"Oconee","2020-07-31","49","3664","4","321","15.1","13.5"
"Oconee","2020-08-01","17","3681","3","324","14.8","14.2"
"Oconee","2020-08-02","14","3695","1","325","11.1","13.7"
"Oconee","2020-08-03","40","3735","7","332","11.8","13.8"
"Oconee","2020-08-04","52","3787","6","338","12","14.1"
"Oconee","2020-08-05","42","3829","3","341","11.2","14.2"
"Oconee","2020-08-06","53","3882","4","345","11","13"
"Oconee","2020-08-07","63","3945","4","349","10.7","12.9"
"Oconee","2020-08-08","22","3967","1","350","8.8","11.8"
"Oconee","2020-08-09","24","3991","1","351","8.4","9.7"
"Oconee","2020-08-10","59","4050","1","352","6.1","9"
"Oconee","2020-08-11","73","4123","5","357","5.5","8.7"
"Oconee","2020-08-12","57","4180","5","362","5.7","8.5"
"Oconee","2020-08-13","57","4237","1","363","4.9","7.9"
"Oconee","2020-08-14","49","4286","2","365","4.6","7.6"
"Oconee","2020-08-15","18","4304","2","367","5.5","7.2"
"Oconee","2020-08-16","24","4328","2","369","6.1","7.2"
"Oconee","2020-08-17","63","4391","6","375","7.2","6.7"
"Oconee","2020-08-18","94","4485","9","384","7.6","6.5"
"Oconee","2020-08-19","103","4588","10","394","7.7","6.7"
"Oconee","2020-08-20","92","4680","7","401","8.6","6.7"
"Oconee","2020-08-21","119","4799","8","409","8.9","6.7"
"Oconee","2020-08-22","36","4835","4","413","8.9","7.2"
"Oconee","2020-08-23","22","4857","3","416","9.7","7.9"
"Oconee","2020-08-24","90","4947","3","419","8.8","8"
"Oconee","2020-08-25","85","5032","1","420","7.6","7.6"
"Oconee","2020-08-26","87","5119","6","426","7.2","7.5"
"Oconee","2020-08-27","80","5199","4","430","6.8","7.7"
"Oconee","2020-08-28","99","5298","8","438","7","8"
"Oconee","2020-08-29","44","5342","4","442","6.7","7.8"
"Oconee","2020-08-30","31","5373","3","445","6.2","7.9"
"Oconee","2020-08-31","80","5453","13","458","8","8.4"
"Oconee","2020-09-01","94","5547","10","468","9.4","8.5"
"Oconee","2020-09-02","90","5637","11","479","10.1","8.7"
"Oconee","2020-09-03","70","5707","5","484","10.4","8.6"
"Oconee","2020-09-04","98","5805","9","493","10.6","8.8"
"Oconee","2020-09-05","42","5847","2","495","10","8.4"
"Oconee","2020-09-06","12","5859","4","499","13.4","9.8"
"Oconee","2020-09-07","26","5885","0","499","11","9.5"
"Oconee","2020-09-08","99","5984","9","508","10.8","10.1"
"Oconee","2020-09-09","81","6065","5","513","10","10"
"Oconee","2020-09-10","98","6163","10","523","10.4","10.4"
"Oconee","2020-09-11","80","6243","4","527","9.8","10.2"
"Oconee","2020-09-12","21","6264","2","529","10.5","10.2"
"Oconee","2020-09-13","26","6290","2","531","6.8","10.1"
"Oconee","2020-09-14","65","6355","8","539","8.6","9.8"
"Oconee","2020-09-15","90","6445","8","547","8.5","9.7"
"Oconee","2020-09-16","52","6497","2","549","8.2","9.1"
"Oconee","2020-09-17","66","6563","2","551","7.2","8.8"
"Oconee","2020-09-18","56","6619","2","553","7","8.4"
"Oconee","2020-09-19","36","6655","1","554","6","8.2"
"Oconee","2020-09-20","14","6669","2","556","7","6.9"
"Oconee","2020-09-21","66","6735","6","562","6.5","7.5"
"Oconee","2020-09-22","50","6785","3","565","6.1","7.3"
"Oconee","2020-09-23","52","6837","1","566","5.8","7"
"Oconee","2020-09-24","44","6881","3","569","6.4","6.8"
"Oconee","2020-09-25","64","6945","7","576","7.4","7.2"
"Oconee","2020-09-26","15","6960","3","579","9.9","7.9"
"Oconee","2020-09-27","23","6983","3","582","9.7","8.3"
"Oconee","2020-09-28","114","7097","10","592","9.6","8.1"
"Oconee","2020-09-29","107","7204","2","594","9.1","7.6"
"Oconee","2020-09-30","85","7289","1","595","8.9","7.4"
"Oconee","2020-10-01","112","7401","9","604","9.1","7.7"
"Oconee","2020-10-02","92","7493","3","607","8","7.7"
"Oconee","2020-10-03","31","7524","6","613","7.9","8.9"
"Oconee","2020-10-04","21","7545","3","616","8.1","8.9"
"Oconee","2020-10-05","78","7623","6","622","8","8.8"
"Oconee","2020-10-06","107","7730","3","625","8.1","8.6"
"Oconee","2020-10-07","70","7800","2","627","8.3","8.6"
"Oconee","2020-10-08","77","7877","2","629","7.6","8.3"
"Oconee","2020-10-09","65","7942","2","631","7.5","7.8"
"Oconee","2020-10-10","29","7971","2","633","5.7","6.8"
"Oconee","2020-10-11","22","7993","2","635","5","6.6"
"Oconee","2020-10-12","67","8060","3","638","4.5","6.2"
"Oconee","2020-10-13","68","8128","3","641","4.8","6.4"
"Oconee","2020-10-14","72","8200","5","646","5.4","6.8"
"Oconee","2020-10-15","62","8262","6","652","6.4","7"
"Oconee","2020-10-16","57","8319","5","657","7.2","7.4"
"Oconee","2020-10-17","36","8355","3","660","7.4","6.6"
"Oconee","2020-10-18","10","8365","1","661","7.5","6.3"
"Oconee","2020-10-19","84","8449","8","669","8.2","6.4"
"Oconee","2020-10-20","76","8525","4","673","8.4","6.6"
"Oconee","2020-10-21","89","8614","3","676","7.8","6.6"
"Oconee","2020-10-22","55","8669","5","681","7.8","7.1"
"Oconee","2020-10-23","37","8706","1","682","6.9","7"
"Oconee","2020-10-24","30","8736","0","682","5.7","6.5"
"Oconee","2020-10-25","20","8756","2","684","5.7","6.6"
"Oconee","2020-10-26","68","8824","3","687","5","6.6"
"Oconee","2020-10-27","72","8896","1","688","4.4","6.4"
"Oconee","2020-10-28","63","8959","0","688","3.9","5.9"
"Oconee","2020-10-29","51","9010","3","691","3.5","5.6"
"Oconee","2020-10-30","60","9070","4","695","4","5.5"
"Oconee","2020-10-31","23","9093","2","697","5.3","5.5"
"Oconee","2020-11-01","24","9117","3","700","5.6","5.7"
"Oconee","2020-11-02","72","9189","6","706","6.2","5.6"
"Oconee","2020-11-03","62","9251","1","707","6.2","5.3"
"Oconee","2020-11-04","74","9325","3","710","6.8","5.4"
"Oconee","2020-11-05","78","9403","3","713","6.5","5"
"Oconee","2020-11-06","57","9460","6","719","7.1","5.6"
"Oconee","2020-11-07","26","9486","4","723","8","6.7"
"Oconee","2020-11-08","16","9502","0","723","6.3","6"
"Oconee","2020-11-09","84","9586","10","733","6.8","6.5"
"Oconee","2020-11-10","83","9669","5","738","7.4","6.8"
"Oconee","2020-11-11","91","9760","7","745","7.9","7.4"
"Oconee","2020-11-12","81","9841","2","747","7.7","7.1"
"Oconee","2020-11-13","65","9906","5","752","7.3","7.2"
"Oconee","2020-11-14","31","9937","4","756","7","7.5"
"Oconee","2020-11-15","19","9956","1","757","7.7","7"
"Oconee","2020-11-16","81","10037","4","761","6.7","6.7"
"Oconee","2020-11-17","85","10122","4","765","6.5","7"
"Oconee","2020-11-18","108","10230","4","769","6","6.9"
"Oconee","2020-11-19","141","10371","9","778","6.5","7.1"
"Oconee","2020-11-20","164","10535","4","782","5.8","6.5"
"Oconee","2020-11-21","58","10593","4","786","4.9","5.9"
"Oconee","2020-11-22","48","10641","4","790","5.3","6.5"
"Oconee","2020-11-23","124","10765","9","799","5.7","6.2"
"Oconee","2020-11-24","115","10880","9","808","6.1","6.3"
"Oconee","2020-11-25","89","10969","10","818","7.2","6.6"
"Oconee","2020-11-26","15","10984","4","822","10.1","8.3"
"Oconee","2020-11-27","74","11058","13","835","12.3","9"
"Oconee","2020-11-28","44","11102","7","842","13.5","9.2"
"Oconee","2020-11-29","40","11142","4","846","13.8","9.6"
"Oconee","2020-11-30","106","11248","14","860","14.6","10.2"
"Oconee","2020-12-01","99","11347","8","868","14.7","10.4"
"Oconee","2020-12-02","143","11490","14","882","14.5","10.8"
"Oconee","2020-12-03","109","11599","7","889","11.6","10.8"
"Oconee","2020-12-04","108","11707","17","906","11.3","11.8"
"Oconee","2020-12-05","61","11768","8","914","10.9","12.2"
"Oconee","2020-12-06","34","11802","1","915","9.9","11.8"
"Oconee","2020-12-07","133","11935","16","931","9.7","12.2"
"Oconee","2020-12-08","129","12064","10","941","9.7","12.2"
"Oconee","2020-12-09","118","12182","22","963","10.9","12.7"
"Oconee","2020-12-10","118","12300","10","973","11.2","11.4"
"Oconee","2020-12-11","139","12439","25","998","11.6","11.4"
"Oconee","2020-12-12","87","12526","14","1012","12","11.4"
"Oconee","2020-12-13","35","12561","9","1021","15.2","12.6"
"Oconee","2020-12-14","138","12699","16","1037","15.2","12.5"
"Oconee","2020-12-15","164","12863","26","1063","16.3","13"
"Oconee","2020-12-16","147","13010","24","1087","16","13.5"
"Oconee","2020-12-17","160","13170","36","1123","18","14.6"
"Oconee","2020-12-18","176","13346","22","1145","17.2","14.4"
"Oconee","2020-12-19","88","13434","23","1168","18.7","15.3"
"Oconee","2020-12-20","78","13512","21","1189","18.8","17"
"Oconee","2020-12-21","187","13699","37","1226","20","17.6"
"Oconee","2020-12-22","204","13903","36","1262","20.3","18.3"
"Oconee","2020-12-23","199","14102","41","1303","20.9","18.4"
"Oconee","2020-12-24","124","14226","34","1337","21.6","19.8"
"Oconee","2020-12-25","7","14233","3","1340","25.9","21.6"
"Oconee","2020-12-26","131","14364","31","1371","25.6","22.1"
"Oconee","2020-12-27","76","14440","22","1393","25.8","22.3"
"Oconee","2020-12-28","174","14614","50","1443","27.1","23.6"
"Oconee","2020-12-29","162","14776","51","1494","29.1","24.7"
"Oconee","2020-12-30","152","14928","42","1536","30.1","25.5"
"Oconee","2020-12-31","127","15055","36","1572","30.2","25.9"
"Oconee","2021-01-01","56","15111","16","1588","28.2","27.1"
"Oconee","2021-01-02","63","15174","21","1609","29.6","27.6"
"Oconee","2021-01-03","70","15244","26","1635","30.7","28.3"
"Oconee","2021-01-04","146","15390","28","1663","29.4","28.3"
"Oconee","2021-01-05","156","15546","43","1706","28.8","29"
"Oconee","2021-01-06","242","15788","46","1752","27.6","28.8"
"Oconee","2021-01-07","197","15985","39","1791","26.4","28.3"
"Oconee","2021-01-08","163","16148","31","1822","25","26.6"
"Oconee","2021-01-09","99","16247","31","1853","24.7","27.1"
"Oconee","2021-01-10","94","16341","21","1874","22.6","26.7"
"Oconee","2021-01-11","195","16536","38","1912","22.6","26"
"Oconee","2021-01-12","174","16710","30","1942","21.2","25"
"Oconee","2021-01-13","152","16862","25","1967","20.8","24.2"
"Oconee","2021-01-14","159","17021","29","1996","20.6","23.5"
"Oconee","2021-01-15","133","17154","25","2021","20.6","22.8"
"Oconee","2021-01-16","68","17222","9","2030","18","21.3"
"Oconee","2021-01-17","71","17293","13","2043","17.4","20"
"Oconee","2021-01-18","108","17401","13","2056","16.3","19.5"
"Oconee","2021-01-19","141","17542","22","2078","16.1","18.6"
"Oconee","2021-01-20","141","17683","21","2099","15.9","18.3"
"Oconee","2021-01-21","147","17830","19","2118","15.1","17.8"
"Oconee","2021-01-22","116","17946","13","2131","14","17.3"
"Oconee","2021-01-23","68","18014","17","2148","15.7","16.8"
"Oconee","2021-01-24","38","18052","3","2151","14.2","15.8"
"Oconee","2021-01-25","77","18129","13","2164","14.9","15.6"
"Oconee","2021-01-26","11","18140","4","2168","17.9","17"
"Oconee","2021-01-27","0","18140","0","2168","15.8","15.8"
"Oglethorpe","2020-02-01","0","0","0","0",".","."
"Oglethorpe","2020-02-02","0","0","0","0",".","."
"Oglethorpe","2020-02-03","0","0","0","0",".","."
"Oglethorpe","2020-02-04","0","0","0","0",".","."
"Oglethorpe","2020-02-05","0","0","0","0",".","."
"Oglethorpe","2020-02-06","0","0","0","0",".","."
"Oglethorpe","2020-02-07","0","0","0","0","0","."
"Oglethorpe","2020-02-08","0","0","0","0","0","."
"Oglethorpe","2020-02-09","0","0","0","0","0","."
"Oglethorpe","2020-02-10","0","0","0","0","0","."
"Oglethorpe","2020-02-11","0","0","0","0","0","."
"Oglethorpe","2020-02-12","0","0","0","0","0","."
"Oglethorpe","2020-02-13","0","0","0","0","0","."
"Oglethorpe","2020-02-14","0","0","0","0","0","0"
"Oglethorpe","2020-02-15","0","0","0","0","0","0"
"Oglethorpe","2020-02-16","0","0","0","0","0","0"
"Oglethorpe","2020-02-17","0","0","0","0","0","0"
"Oglethorpe","2020-02-18","0","0","0","0","0","0"
"Oglethorpe","2020-02-19","0","0","0","0","0","0"
"Oglethorpe","2020-02-20","0","0","0","0","0","0"
"Oglethorpe","2020-02-21","0","0","0","0","0","0"
"Oglethorpe","2020-02-22","0","0","0","0","0","0"
"Oglethorpe","2020-02-23","0","0","0","0","0","0"
"Oglethorpe","2020-02-24","0","0","0","0","0","0"
"Oglethorpe","2020-02-25","0","0","0","0","0","0"
"Oglethorpe","2020-02-26","0","0","0","0","0","0"
"Oglethorpe","2020-02-27","0","0","0","0","0","0"
"Oglethorpe","2020-02-28","0","0","0","0","0","0"
"Oglethorpe","2020-02-29","0","0","0","0","0","0"
"Oglethorpe","2020-03-01","0","0","0","0","0","0"
"Oglethorpe","2020-03-02","0","0","0","0","0","0"
"Oglethorpe","2020-03-03","0","0","0","0","0","0"
"Oglethorpe","2020-03-04","0","0","0","0","0","0"
"Oglethorpe","2020-03-05","0","0","0","0","0","0"
"Oglethorpe","2020-03-06","0","0","0","0","0","0"
"Oglethorpe","2020-03-07","0","0","0","0","0","0"
"Oglethorpe","2020-03-08","0","0","0","0","0","0"
"Oglethorpe","2020-03-09","0","0","0","0","0","0"
"Oglethorpe","2020-03-10","0","0","0","0","0","0"
"Oglethorpe","2020-03-11","0","0","0","0","0","0"
"Oglethorpe","2020-03-12","0","0","0","0","0","0"
"Oglethorpe","2020-03-13","0","0","0","0","0","0"
"Oglethorpe","2020-03-14","0","0","0","0","0","0"
"Oglethorpe","2020-03-15","0","0","0","0","0","0"
"Oglethorpe","2020-03-16","1","1","0","0","0","0"
"Oglethorpe","2020-03-17","0","1","0","0","0","0"
"Oglethorpe","2020-03-18","3","4","0","0","0","0"
"Oglethorpe","2020-03-19","4","8","0","0","0","0"
"Oglethorpe","2020-03-20","5","13","0","0","0","0"
"Oglethorpe","2020-03-21","1","14","0","0","0","0"
"Oglethorpe","2020-03-22","2","16","1","1","7.1","3.6"
"Oglethorpe","2020-03-23","2","18","0","1","7.1","3.6"
"Oglethorpe","2020-03-24","7","25","0","1","7.1","3.6"
"Oglethorpe","2020-03-25","12","37","0","1","7.1","3.6"
"Oglethorpe","2020-03-26","3","40","0","1","7.1","3.6"
"Oglethorpe","2020-03-27","3","43","0","1","7.1","3.6"
"Oglethorpe","2020-03-28","1","44","0","1","7.1","3.6"
"Oglethorpe","2020-03-29","0","44","0","1","0","3.6"
"Oglethorpe","2020-03-30","0","44","0","1","0","3.6"
"Oglethorpe","2020-03-31","4","48","0","1","0","3.6"
"Oglethorpe","2020-04-01","7","55","0","1","0","3.6"
"Oglethorpe","2020-04-02","2","57","0","1","0","3.6"
"Oglethorpe","2020-04-03","3","60","0","1","0","3.6"
"Oglethorpe","2020-04-04","1","61","0","1","0","3.6"
"Oglethorpe","2020-04-05","0","61","0","1","0","0"
"Oglethorpe","2020-04-06","2","63","1","2","7.1","3.6"
"Oglethorpe","2020-04-07","2","65","0","2","7.1","3.6"
"Oglethorpe","2020-04-08","4","69","0","2","7.1","3.6"
"Oglethorpe","2020-04-09","4","73","2","4","14.3","7.1"
"Oglethorpe","2020-04-10","1","74","0","4","14.3","7.1"
"Oglethorpe","2020-04-11","0","74","0","4","14.3","7.1"
"Oglethorpe","2020-04-12","2","76","0","4","14.3","7.1"
"Oglethorpe","2020-04-13","2","78","0","4","7.1","7.1"
"Oglethorpe","2020-04-14","6","84","0","4","7.1","7.1"
"Oglethorpe","2020-04-15","4","88","0","4","7.1","7.1"
"Oglethorpe","2020-04-16","7","95","0","4","0","7.1"
"Oglethorpe","2020-04-17","5","100","0","4","0","7.1"
"Oglethorpe","2020-04-18","0","100","0","4","0","7.1"
"Oglethorpe","2020-04-19","2","102","1","5","7.1","10.7"
"Oglethorpe","2020-04-20","4","106","0","5","7.1","7.1"
"Oglethorpe","2020-04-21","12","118","3","8","10.7","8.9"
"Oglethorpe","2020-04-22","12","130","0","8","10.7","8.9"
"Oglethorpe","2020-04-23","7","137","0","8","10.7","5.4"
"Oglethorpe","2020-04-24","0","137","0","8","10.7","5.4"
"Oglethorpe","2020-04-25","2","139","0","8","10.7","5.4"
"Oglethorpe","2020-04-26","1","140","0","8","3.6","5.4"
"Oglethorpe","2020-04-27","7","147","0","8","3.6","5.4"
"Oglethorpe","2020-04-28","10","157","1","9","1.4","6.1"
"Oglethorpe","2020-04-29","10","167","0","9","1.4","6.1"
"Oglethorpe","2020-04-30","6","173","0","9","1.4","6.1"
"Oglethorpe","2020-05-01","8","181","0","9","1.4","6.1"
"Oglethorpe","2020-05-02","3","184","0","9","1.4","6.1"
"Oglethorpe","2020-05-03","1","185","0","9","1.4","2.5"
"Oglethorpe","2020-05-04","6","191","1","10","3.8","3.7"
"Oglethorpe","2020-05-05","10","201","0","10","2.4","1.9"
"Oglethorpe","2020-05-06","16","217","0","10","2.4","1.9"
"Oglethorpe","2020-05-07","9","226","0","10","2.4","1.9"
"Oglethorpe","2020-05-08","8","234","0","10","2.4","1.9"
"Oglethorpe","2020-05-09","0","234","0","10","2.4","1.9"
"Oglethorpe","2020-05-10","1","235","0","10","2.4","1.9"
"Oglethorpe","2020-05-11","11","246","0","10","0","1.9"
"Oglethorpe","2020-05-12","6","252","0","10","0","1.2"
"Oglethorpe","2020-05-13","15","267","0","10","0","1.2"
"Oglethorpe","2020-05-14","12","279","1","11","1.2","1.8"
"Oglethorpe","2020-05-15","12","291","0","11","1.2","1.8"
"Oglethorpe","2020-05-16","5","296","0","11","1.2","1.8"
"Oglethorpe","2020-05-17","4","300","1","12","4.8","3.6"
"Oglethorpe","2020-05-18","9","309","0","12","4.8","2.4"
"Oglethorpe","2020-05-19","17","326","0","12","4.8","2.4"
"Oglethorpe","2020-05-20","7","333","0","12","4.8","2.4"
"Oglethorpe","2020-05-21","8","341","0","12","3.6","2.4"
"Oglethorpe","2020-05-22","5","346","0","12","3.6","2.4"
"Oglethorpe","2020-05-23","11","357","1","13","4.9","3"
"Oglethorpe","2020-05-24","2","359","0","13","1.3","3"
"Oglethorpe","2020-05-25","2","361","0","13","1.3","3"
"Oglethorpe","2020-05-26","14","375","2","15","3.3","4.1"
"Oglethorpe","2020-05-27","12","387","0","15","3.3","4.1"
"Oglethorpe","2020-05-28","13","400","2","17","5.5","4.6"
"Oglethorpe","2020-05-29","7","407","0","17","5.5","4.6"
"Oglethorpe","2020-05-30","0","407","0","17","4.2","4.6"
"Oglethorpe","2020-05-31","9","416","0","17","4.2","2.8"
"Oglethorpe","2020-06-01","8","424","3","20","9.6","5.4"
"Oglethorpe","2020-06-02","7","431","0","20","7.6","5.4"
"Oglethorpe","2020-06-03","14","445","0","20","7.6","5.4"
"Oglethorpe","2020-06-04","11","456","1","21","6.7","6.1"
"Oglethorpe","2020-06-05","13","469","1","22","7.8","6.6"
"Oglethorpe","2020-06-06","2","471","0","22","7.8","6"
"Oglethorpe","2020-06-07","6","477","0","22","7.8","6"
"Oglethorpe","2020-06-08","11","488","0","22","2.4","6"
"Oglethorpe","2020-06-09","23","511","2","24","3.6","5.6"
"Oglethorpe","2020-06-10","15","526","0","24","3.6","5.6"
"Oglethorpe","2020-06-11","21","547","3","27","4.4","5.5"
"Oglethorpe","2020-06-12","11","558","0","27","3.3","5.5"
"Oglethorpe","2020-06-13","10","568","2","29","6.1","6.9"
"Oglethorpe","2020-06-14","3","571","0","29","6.1","6.9"
"Oglethorpe","2020-06-15","11","582","2","31","8.7","5.6"
"Oglethorpe","2020-06-16","18","600","3","34","9.9","6.8"
"Oglethorpe","2020-06-17","14","614","2","36","11.9","7.8"
"Oglethorpe","2020-06-18","12","626","3","39","13.4","8.9"
"Oglethorpe","2020-06-19","13","639","2","41","15.6","9.5"
"Oglethorpe","2020-06-20","4","643","0","41","12.8","9.5"
"Oglethorpe","2020-06-21","4","647","0","41","12.8","9.5"
"Oglethorpe","2020-06-22","16","663","0","41","10.2","9.5"
"Oglethorpe","2020-06-23","18","681","2","43","9.4","9.6"
"Oglethorpe","2020-06-24","20","701","2","45","8.8","10.4"
"Oglethorpe","2020-06-25","13","714","0","45","5.2","9.3"
"Oglethorpe","2020-06-26","18","732","1","46","3.8","9.7"
"Oglethorpe","2020-06-27","11","743","1","47","5.1","8.9"
"Oglethorpe","2020-06-28","4","747","1","48","8.7","10.7"
"Oglethorpe","2020-06-29","18","765","0","48","8.7","9.4"
"Oglethorpe","2020-06-30","19","784","1","49","7.8","8.6"
"Oglethorpe","2020-07-01","25","809","3","52","8.1","8.5"
"Oglethorpe","2020-07-02","17","826","2","54","9.8","7.5"
"Oglethorpe","2020-07-03","20","846","4","58","11.9","7.8"
"Oglethorpe","2020-07-04","8","854","1","59","12.4","8.7"
"Oglethorpe","2020-07-05","12","866","0","59","8.8","8.7"
"Oglethorpe","2020-07-06","28","894","6","65","11.9","10.3"
"Oglethorpe","2020-07-07","31","925","8","73","14.8","11.3"
"Oglethorpe","2020-07-08","16","941","3","76","15.7","11.9"
"Oglethorpe","2020-07-09","46","987","8","84","16.6","13.2"
"Oglethorpe","2020-07-10","31","1018","8","92","17.4","14.6"
"Oglethorpe","2020-07-11","14","1032","7","99","22.7","17.6"
"Oglethorpe","2020-07-12","6","1038","1","100","25.1","17"
"Oglethorpe","2020-07-13","19","1057","4","104","25.1","18.5"
"Oglethorpe","2020-07-14","25","1082","3","107","23.1","18.9"
"Oglethorpe","2020-07-15","21","1103","0","107","20.4","18.1"
"Oglethorpe","2020-07-16","18","1121","2","109","19.5","18"
"Oglethorpe","2020-07-17","16","1137","0","109","15.8","16.6"
"Oglethorpe","2020-07-18","6","1143","1","110","11.1","16.9"
"Oglethorpe","2020-07-19","9","1152","2","112","11.9","18.5"
"Oglethorpe","2020-07-20","22","1174","5","117","12.1","18.6"
"Oglethorpe","2020-07-21","20","1194","3","120","12.5","17.8"
"Oglethorpe","2020-07-22","14","1208","1","121","13.6","17"
"Oglethorpe","2020-07-23","22","1230","1","122","12.6","16.1"
"Oglethorpe","2020-07-24","14","1244","2","124","14.7","15.2"
"Oglethorpe","2020-07-25","13","1257","2","126","14.5","12.8"
"Oglethorpe","2020-07-26","12","1269","1","127","12.5","12.2"
"Oglethorpe","2020-07-27","13","1282","1","128","10.3","11.2"
"Oglethorpe","2020-07-28","24","1306","7","135","12.4","12.4"
"Oglethorpe","2020-07-29","25","1331","4","139","13.6","13.6"
"Oglethorpe","2020-07-30","9","1340","2","141","16.2","14.4"
"Oglethorpe","2020-07-31","14","1354","2","143","16.2","15.4"
"Oglethorpe","2020-08-01","10","1364","4","147","19.7","17.1"
"Oglethorpe","2020-08-02","9","1373","1","148","20.1","16.3"
"Oglethorpe","2020-08-03","22","1395","4","152","21.6","16"
"Oglethorpe","2020-08-04","26","1421","3","155","19","15.7"
"Oglethorpe","2020-08-05","23","1444","3","158","18.6","16.1"
"Oglethorpe","2020-08-06","31","1475","7","165","18.7","17.4"
"Oglethorpe","2020-08-07","20","1495","3","168","18.8","17.5"
"Oglethorpe","2020-08-08","8","1503","1","169","14.9","17.3"
"Oglethorpe","2020-08-09","6","1509","3","172","20.4","20.2"
"Oglethorpe","2020-08-10","18","1527","4","176","21","21.3"
"Oglethorpe","2020-08-11","20","1547","5","181","22.9","21"
"Oglethorpe","2020-08-12","19","1566","1","182","21.8","20.2"
"Oglethorpe","2020-08-13","20","1586","3","185","20.7","19.7"
"Oglethorpe","2020-08-14","20","1606","2","187","20","19.4"
"Oglethorpe","2020-08-15","6","1612","0","187","18.2","16.5"
"Oglethorpe","2020-08-16","12","1624","1","188","12.3","16.3"
"Oglethorpe","2020-08-17","29","1653","2","190","10.1","15.5"
"Oglethorpe","2020-08-18","19","1672","0","190","6.5","14.7"
"Oglethorpe","2020-08-19","18","1690","3","193","8.1","15"
"Oglethorpe","2020-08-20","25","1715","1","194","6.6","13.6"
"Oglethorpe","2020-08-21","28","1743","1","195","5.6","12.8"
"Oglethorpe","2020-08-22","8","1751","1","196","7.4","12.8"
"Oglethorpe","2020-08-23","9","1760","0","196","6.2","9.2"
"Oglethorpe","2020-08-24","31","1791","2","198","6.2","8.1"
"Oglethorpe","2020-08-25","20","1811","1","199","6.9","6.7"
"Oglethorpe","2020-08-26","24","1835","0","199","4.5","6.3"
"Oglethorpe","2020-08-27","25","1860","3","202","5.6","6.1"
"Oglethorpe","2020-08-28","20","1880","2","204","6.6","6.1"
"Oglethorpe","2020-08-29","17","1897","2","206","6.5","6.9"
"Oglethorpe","2020-08-30","4","1901","0","206","6.5","6.3"
"Oglethorpe","2020-08-31","24","1925","1","207","6.1","6.2"
"Oglethorpe","2020-09-01","18","1943","3","210","7.8","7.3"
"Oglethorpe","2020-09-02","23","1966","3","213","9.7","7.1"
"Oglethorpe","2020-09-03","23","1989","1","214","8.6","7.1"
"Oglethorpe","2020-09-04","17","2006","1","215","8","7.3"
"Oglethorpe","2020-09-05","10","2016","1","216","7.7","7.1"
"Oglethorpe","2020-09-06","8","2024","0","216","7.7","7.1"
"Oglethorpe","2020-09-07","4","2028","0","216","7.1","6.6"
"Oglethorpe","2020-09-08","22","2050","3","219","6.7","7.3"
"Oglethorpe","2020-09-09","23","2073","1","220","5.5","7.6"
"Oglethorpe","2020-09-10","31","2104","2","222","5.8","7.2"
"Oglethorpe","2020-09-11","17","2121","1","223","5.8","6.9"
"Oglethorpe","2020-09-12","9","2130","0","223","4.3","6"
"Oglethorpe","2020-09-13","10","2140","0","223","4.3","6"
"Oglethorpe","2020-09-14","21","2161","0","223","4.3","5.7"
"Oglethorpe","2020-09-15","36","2197","1","224","2.8","4.7"
"Oglethorpe","2020-09-16","20","2217","2","226","3.6","4.5"
"Oglethorpe","2020-09-17","30","2247","2","228","3.6","4.7"
"Oglethorpe","2020-09-18","18","2265","2","230","4.4","5.1"
"Oglethorpe","2020-09-19","15","2280","1","231","5.3","4.8"
"Oglethorpe","2020-09-20","2","2282","0","231","5.3","4.8"
"Oglethorpe","2020-09-21","20","2302","2","233","6.7","5.5"
"Oglethorpe","2020-09-22","23","2325","0","233","6.3","4.6"
"Oglethorpe","2020-09-23","8","2333","1","234","6.7","5.1"
"Oglethorpe","2020-09-24","15","2348","0","234","5.8","4.7"
"Oglethorpe","2020-09-25","26","2374","0","234","4.2","4.3"
"Oglethorpe","2020-09-26","5","2379","0","234","3.2","4.3"
"Oglethorpe","2020-09-27","8","2387","2","236","6.8","6.1"
"Oglethorpe","2020-09-28","18","2405","2","238","6.9","6.8"
"Oglethorpe","2020-09-29","13","2418","2","240","9.1","7.7"
"Oglethorpe","2020-09-30","13","2431","1","241","8.5","7.6"
"Oglethorpe","2020-10-01","12","2443","1","242","9.6","7.7"
"Oglethorpe","2020-10-02","21","2464","1","243","10.3","7.2"
"Oglethorpe","2020-10-03","7","2471","2","245","14.4","8.8"
"Oglethorpe","2020-10-04","5","2476","1","246","13.7","10.2"
"Oglethorpe","2020-10-05","32","2508","6","252","14.8","10.9"
"Oglethorpe","2020-10-06","20","2528","2","254","14","11.6"
"Oglethorpe","2020-10-07","27","2555","5","259","15.6","12"
"Oglethorpe","2020-10-08","13","2568","2","261","16.6","13.1"
"Oglethorpe","2020-10-09","22","2590","0","261","15.9","13.1"
"Oglethorpe","2020-10-10","4","2594","1","262","15.4","14.9"
"Oglethorpe","2020-10-11","7","2601","2","264","16.6","15.1"
"Oglethorpe","2020-10-12","16","2617","1","265","14.8","14.8"
"Oglethorpe","2020-10-13","21","2638","3","268","15.4","14.7"
"Oglethorpe","2020-10-14","16","2654","2","270","14.6","15.1"
"Oglethorpe","2020-10-15","25","2679","4","274","14.7","15.6"
"Oglethorpe","2020-10-16","17","2696","2","276","16.3","16.1"
"Oglethorpe","2020-10-17","7","2703","1","277","14.8","15.1"
"Oglethorpe","2020-10-18","3","2706","1","278","15.5","16"
"Oglethorpe","2020-10-19","24","2730","3","281","16.4","15.6"
"Oglethorpe","2020-10-20","17","2747","2","283","16","15.7"
"Oglethorpe","2020-10-21","22","2769","6","289","18.1","16.4"
"Oglethorpe","2020-10-22","26","2795","3","292","17.5","16.1"
"Oglethorpe","2020-10-23","18","2813","2","294","17.4","16.9"
"Oglethorpe","2020-10-24","4","2817","0","294","15.4","15.1"
"Oglethorpe","2020-10-25","3","2820","2","296","20.1","17.8"
"Oglethorpe","2020-10-26","29","2849","5","301","20.8","18.6"
"Oglethorpe","2020-10-27","23","2872","3","304","21","18.5"
"Oglethorpe","2020-10-28","22","2894","2","306","18.4","18.3"
"Oglethorpe","2020-10-29","29","2923","3","309","18.2","17.9"
"Oglethorpe","2020-10-30","31","2954","4","313","18.5","17.9"
"Oglethorpe","2020-10-31","8","2962","2","315","22","18.7"
"Oglethorpe","2020-11-01","4","2966","1","316","16.1","18.1"
"Oglethorpe","2020-11-02","20","2986","6","322","17.9","19.4"
"Oglethorpe","2020-11-03","14","3000","0","322","16","18.5"
"Oglethorpe","2020-11-04","14","3014","0","322","14.7","16.6"
"Oglethorpe","2020-11-05","21","3035","1","323","14","16.1"
"Oglethorpe","2020-11-06","20","3055","0","323","12.1","15.3"
"Oglethorpe","2020-11-07","6","3061","2","325","13.3","17.7"
"Oglethorpe","2020-11-08","8","3069","0","325","9.7","12.9"
"Oglethorpe","2020-11-09","33","3102","1","326","5.9","11.9"
"Oglethorpe","2020-11-10","26","3128","0","326","5.9","11"
"Oglethorpe","2020-11-11","17","3145","0","326","5.9","10.3"
"Oglethorpe","2020-11-12","16","3161","0","326","5.2","9.6"
"Oglethorpe","2020-11-13","26","3187","1","327","5.7","8.9"
"Oglethorpe","2020-11-14","7","3194","1","328","3","8.2"
"Oglethorpe","2020-11-15","14","3208","2","330","5.1","7.4"
"Oglethorpe","2020-11-16","35","3243","3","333","5.9","5.9"
"Oglethorpe","2020-11-17","34","3277","2","335","6.7","6.3"
"Oglethorpe","2020-11-18","28","3305","5","340","9.2","7.6"
"Oglethorpe","2020-11-19","25","3330","2","342","10.4","7.8"
"Oglethorpe","2020-11-20","30","3360","5","347","12.2","9"
"Oglethorpe","2020-11-21","9","3369","3","350","14.9","9"
"Oglethorpe","2020-11-22","11","3380","0","350","12.9","9"
"Oglethorpe","2020-11-23","38","3418","6","356","13.9","9.9"
"Oglethorpe","2020-11-24","20","3438","4","360","15.9","11.3"
"Oglethorpe","2020-11-25","25","3463","3","363","15.1","12.2"
"Oglethorpe","2020-11-26","4","3467","1","364","17.5","14"
"Oglethorpe","2020-11-27","22","3489","1","365","15.8","14"
"Oglethorpe","2020-11-28","8","3497","1","366","12.8","13.9"
"Oglethorpe","2020-11-29","10","3507","1","367","14.3","13.6"
"Oglethorpe","2020-11-30","36","3543","7","374","14.8","14.4"
"Oglethorpe","2020-12-01","82","3625","4","378","12.6","14.3"
"Oglethorpe","2020-12-02","37","3662","3","381","12.1","13.6"
"Oglethorpe","2020-12-03","29","3691","4","385","10.5","14"
"Oglethorpe","2020-12-04","31","3722","3","388","11.2","13.5"
"Oglethorpe","2020-12-05","15","3737","1","389","10.4","11.6"
"Oglethorpe","2020-12-06","14","3751","3","392","12","13.1"
"Oglethorpe","2020-12-07","39","3790","6","398","11.4","13.1"
"Oglethorpe","2020-12-08","37","3827","5","403","12.7","12.6"
"Oglethorpe","2020-12-09","38","3865","7","410","14.1","13.1"
"Oglethorpe","2020-12-10","50","3915","10","420","15","12.7"
"Oglethorpe","2020-12-11","27","3942","5","425","16.3","13.7"
"Oglethorpe","2020-12-12","26","3968","9","434","20.3","15.3"
"Oglethorpe","2020-12-13","18","3986","4","438","20.4","16.2"
"Oglethorpe","2020-12-14","99","4085","16","454","20.5","16"
"Oglethorpe","2020-12-15","49","4134","9","463","21.2","16.9"
"Oglethorpe","2020-12-16","49","4183","13","476","22.3","18.2"
"Oglethorpe","2020-12-17","40","4223","11","487","23.4","19.2"
"Oglethorpe","2020-12-18","47","4270","13","500","24.7","20.5"
"Oglethorpe","2020-12-19","19","4289","1","501","20.5","20.4"
"Oglethorpe","2020-12-20","14","4303","2","503","19.4","19.9"
"Oglethorpe","2020-12-21","50","4353","10","513","19.9","20.2"
"Oglethorpe","2020-12-22","51","4404","12","525","20.7","20.9"
"Oglethorpe","2020-12-23","47","4451","21","546","23.3","22.8"
"Oglethorpe","2020-12-24","22","4473","7","553","23.9","23.7"
"Oglethorpe","2020-12-25","7","4480","1","554","22","23.4"
"Oglethorpe","2020-12-26","26","4506","5","559","24","22.3"
"Oglethorpe","2020-12-27","24","4530","11","570","28.5","23.9"
"Oglethorpe","2020-12-28","86","4616","8","578","27","23.4"
"Oglethorpe","2020-12-29","44","4660","14","592","28.1","24.4"
"Oglethorpe","2020-12-30","37","4697","21","613","29.9","26.6"
"Oglethorpe","2020-12-31","46","4743","12","625","29","26.5"
"Oglethorpe","2021-01-01","22","4765","11","636","34.1","28.1"
"Oglethorpe","2021-01-02","19","4784","11","647","39.7","31.8"
"Oglethorpe","2021-01-03","15","4799","5","652","37.9","33.2"
"Oglethorpe","2021-01-04","50","4849","11","663","39.7","33.3"
"Oglethorpe","2021-01-05","40","4889","12","675","39.4","33.8"
"Oglethorpe","2021-01-06","80","4969","23","698","35.4","32.7"
"Oglethorpe","2021-01-07","53","5022","15","713","35.8","32.4"
"Oglethorpe","2021-01-08","38","5060","13","726","33.5","33.8"
"Oglethorpe","2021-01-09","13","5073","1","727","26.3","33"
"Oglethorpe","2021-01-10","19","5092","6","733","26.1","32"
"Oglethorpe","2021-01-11","41","5133","7","740","25.4","32.5"
"Oglethorpe","2021-01-12","47","5180","8","748","23.5","31.5"
"Oglethorpe","2021-01-13","45","5225","9","757","22.3","28.9"
"Oglethorpe","2021-01-14","46","5271","9","766","21","28.4"
"Oglethorpe","2021-01-15","45","5316","9","775","19","26.2"
"Oglethorpe","2021-01-16","18","5334","4","779","21.1","23.7"
"Oglethorpe","2021-01-17","12","5346","3","782","20.1","23.1"
"Oglethorpe","2021-01-18","42","5388","9","791","20.7","23.1"
"Oglethorpe","2021-01-19","33","5421","9","800","22.2","22.9"
"Oglethorpe","2021-01-20","35","5456","6","806","21.8","22"
"Oglethorpe","2021-01-21","48","5504","13","819","22.9","21.9"
"Oglethorpe","2021-01-22","43","5547","11","830","23.7","21.3"
"Oglethorpe","2021-01-23","27","5574","4","834","22.6","21.8"
"Oglethorpe","2021-01-24","9","5583","2","836","22.2","21.2"
"Oglethorpe","2021-01-25","14","5597","3","839","22.2","21.5"
"Oglethorpe","2021-01-26","0","5597","0","839","18.3","20.3"
"Oglethorpe","2021-01-27","0","5597","0","839","15.9","18.8"
"Paulding","2020-02-01","0","0","0","0",".","."
"Paulding","2020-02-02","0","0","0","0",".","."
"Paulding","2020-02-03","0","0","0","0",".","."
"Paulding","2020-02-04","0","0","0","0",".","."
"Paulding","2020-02-05","0","0","0","0",".","."
"Paulding","2020-02-06","0","0","0","0",".","."
"Paulding","2020-02-07","0","0","0","0","0","."
"Paulding","2020-02-08","0","0","0","0","0","."
"Paulding","2020-02-09","0","0","0","0","0","."
"Paulding","2020-02-10","0","0","0","0","0","."
"Paulding","2020-02-11","0","0","0","0","0","."
"Paulding","2020-02-12","0","0","0","0","0","."
"Paulding","2020-02-13","0","0","0","0","0","."
"Paulding","2020-02-14","0","0","0","0","0","0"
"Paulding","2020-02-15","0","0","0","0","0","0"
"Paulding","2020-02-16","0","0","0","0","0","0"
"Paulding","2020-02-17","0","0","0","0","0","0"
"Paulding","2020-02-18","0","0","0","0","0","0"
"Paulding","2020-02-19","0","0","0","0","0","0"
"Paulding","2020-02-20","0","0","0","0","0","0"
"Paulding","2020-02-21","0","0","0","0","0","0"
"Paulding","2020-02-22","0","0","0","0","0","0"
"Paulding","2020-02-23","0","0","0","0","0","0"
"Paulding","2020-02-24","0","0","0","0","0","0"
"Paulding","2020-02-25","0","0","0","0","0","0"
"Paulding","2020-02-26","0","0","0","0","0","0"
"Paulding","2020-02-27","0","0","0","0","0","0"
"Paulding","2020-02-28","0","0","0","0","0","0"
"Paulding","2020-02-29","0","0","0","0","0","0"
"Paulding","2020-03-01","0","0","0","0","0","0"
"Paulding","2020-03-02","0","0","0","0","0","0"
"Paulding","2020-03-03","0","0","0","0","0","0"
"Paulding","2020-03-04","0","0","0","0","0","0"
"Paulding","2020-03-05","0","0","0","0","0","0"
"Paulding","2020-03-06","0","0","0","0","0","0"
"Paulding","2020-03-07","0","0","0","0","0","0"
"Paulding","2020-03-08","0","0","0","0","0","0"
"Paulding","2020-03-09","0","0","0","0","0","0"
"Paulding","2020-03-10","2","2","0","0","0","0"
"Paulding","2020-03-11","1","3","0","0","0","0"
"Paulding","2020-03-12","7","10","2","2","4.1","2"
"Paulding","2020-03-13","5","15","0","2","4.1","2"
"Paulding","2020-03-14","2","17","0","2","4.1","2"
"Paulding","2020-03-15","4","21","3","5","14.8","7.4"
"Paulding","2020-03-16","6","27","0","5","14.8","7.4"
"Paulding","2020-03-17","24","51","3","8","16.6","8.3"
"Paulding","2020-03-18","19","70","1","9","17.3","8.7"
"Paulding","2020-03-19","22","92","3","12","15.2","9.6"
"Paulding","2020-03-20","18","110","6","18","20","12"
"Paulding","2020-03-21","2","112","1","19","27.1","15.6"
"Paulding","2020-03-22","6","118","0","19","16.4","15.6"
"Paulding","2020-03-23","20","138","6","25","20.7","17.7"
"Paulding","2020-03-24","28","166","10","35","24","20.3"
"Paulding","2020-03-25","39","205","4","39","24.7","21"
"Paulding","2020-03-26","47","252","8","47","25.2","20.2"
"Paulding","2020-03-27","34","286","9","56","24.2","22.1"
"Paulding","2020-03-28","30","316","6","62","19.9","23.5"
"Paulding","2020-03-29","17","333","4","66","23.3","19.8"
"Paulding","2020-03-30","31","364","5","71","21.3","21"
"Paulding","2020-03-31","36","400","11","82","20.6","22.3"
"Paulding","2020-04-01","26","426","2","84","20.2","22.5"
"Paulding","2020-04-02","27","453","8","92","22","23.6"
"Paulding","2020-04-03","29","482","7","99","21.7","22.9"
"Paulding","2020-04-04","19","501","3","102","21.1","20.5"
"Paulding","2020-04-05","5","506","0","102","17.7","20.5"
"Paulding","2020-04-06","39","545","2","104","16.1","18.7"
"Paulding","2020-04-07","42","587","5","109","13.5","17"
"Paulding","2020-04-08","55","642","8","117","14.4","17.3"
"Paulding","2020-04-09","47","689","7","124","12.3","17.2"
"Paulding","2020-04-10","46","735","4","128","10.1","15.9"
"Paulding","2020-04-11","19","754","3","131","10.1","15.6"
"Paulding","2020-04-12","7","761","1","132","12.2","14.9"
"Paulding","2020-04-13","29","790","4","136","13.4","14.8"
"Paulding","2020-04-14","42","832","6","142","13.8","13.6"
"Paulding","2020-04-15","31","863","2","144","12.6","13.5"
"Paulding","2020-04-16","43","906","5","149","12.1","12.2"
"Paulding","2020-04-17","39","945","5","154","12.7","11.4"
"Paulding","2020-04-18","29","974","2","156","11.5","10.8"
"Paulding","2020-04-19","8","982","0","156","9.4","10.8"
"Paulding","2020-04-20","52","1034","6","162","9.1","11.3"
"Paulding","2020-04-21","72","1106","4","166","7.8","10.8"
"Paulding","2020-04-22","67","1173","9","175","8.8","10.7"
"Paulding","2020-04-23","37","1210","3","178","8.3","10.2"
"Paulding","2020-04-24","93","1303","4","182","7.1","9.9"
"Paulding","2020-04-25","33","1336","2","184","7","9.2"
"Paulding","2020-04-26","14","1350","0","184","7","8.2"
"Paulding","2020-04-27","62","1412","6","190","6.7","7.9"
"Paulding","2020-04-28","84","1496","8","198","7.3","7.6"
"Paulding","2020-04-29","61","1557","3","201","6.1","7.5"
"Paulding","2020-04-30","130","1687","6","207","5.6","7"
"Paulding","2020-05-01","59","1746","4","211","5.9","6.5"
"Paulding","2020-05-02","25","1771","0","211","5.1","6"
"Paulding","2020-05-03","35","1806","3","214","6.3","6.6"
"Paulding","2020-05-04","88","1894","8","222","6.2","6.5"
"Paulding","2020-05-05","61","1955","1","223","5.1","6.2"
"Paulding","2020-05-06","76","2031","3","226","4.9","5.5"
"Paulding","2020-05-07","78","2109","0","226","4.3","4.9"
"Paulding","2020-05-08","113","2222","6","232","4.1","5"
"Paulding","2020-05-09","89","2311","1","233","4.2","4.7"
"Paulding","2020-05-10","16","2327","1","234","3.9","5.1"
"Paulding","2020-05-11","150","2477","9","243","3.5","4.8"
"Paulding","2020-05-12","146","2623","4","247","3.6","4.4"
"Paulding","2020-05-13","187","2810","9","256","3.7","4.3"
"Paulding","2020-05-14","153","2963","5","261","4.2","4.3"
"Paulding","2020-05-15","171","3134","7","268","4","4.1"
"Paulding","2020-05-16","109","3243","8","276","4.9","4.6"
"Paulding","2020-05-17","197","3440","6","282","4.5","4.2"
"Paulding","2020-05-18","102","3542","6","288","4.5","4"
"Paulding","2020-05-19","181","3723","7","295","4.6","4.1"
"Paulding","2020-05-20","162","3885","3","298","4.2","4"
"Paulding","2020-05-21","170","4055","4","302","4.1","4.1"
"Paulding","2020-05-22","126","4181","4","306","3.9","4"
"Paulding","2020-05-23","29","4210","5","311","5.3","5.1"
"Paulding","2020-05-24","20","4230","1","312","5.6","5"
"Paulding","2020-05-25","10","4240","1","313","6.2","5.3"
"Paulding","2020-05-26","171","4411","6","319","6.2","5.4"
"Paulding","2020-05-27","149","4560","5","324","6.4","5.3"
"Paulding","2020-05-28","124","4684","10","334","7.2","5.6"
"Paulding","2020-05-29","94","4778","7","341","7.8","5.9"
"Paulding","2020-05-30","80","4858","7","348","6.6","6"
"Paulding","2020-05-31","31","4889","4","352","7.7","6.7"
"Paulding","2020-06-01","171","5060","11","363","7.2","6.7"
"Paulding","2020-06-02","159","5219","8","371","7.4","6.8"
"Paulding","2020-06-03","176","5395","5","376","7.4","6.9"
"Paulding","2020-06-04","90","5485","3","379","6.7","6.9"
"Paulding","2020-06-05","118","5603","10","389","6.8","7.3"
"Paulding","2020-06-06","94","5697","4","393","6.2","6.4"
"Paulding","2020-06-07","35","5732","2","395","5.2","6.4"
"Paulding","2020-06-08","165","5897","7","402","4.8","6"
"Paulding","2020-06-09","150","6047","10","412","5.1","6.3"
"Paulding","2020-06-10","184","6231","6","418","5.1","6.2"
"Paulding","2020-06-11","182","6413","12","430","5.6","6.1"
"Paulding","2020-06-12","157","6570","7","437","5","5.9"
"Paulding","2020-06-13","80","6650","3","440","5","5.6"
"Paulding","2020-06-14","31","6681","0","440","4.1","4.6"
"Paulding","2020-06-15","172","6853","8","448","4.2","4.5"
"Paulding","2020-06-16","174","7027","12","460","4.2","4.7"
"Paulding","2020-06-17","168","7195","19","479","5.4","5.3"
"Paulding","2020-06-18","184","7379","16","495","5.7","5.6"
"Paulding","2020-06-19","166","7545","16","511","6.4","5.7"
"Paulding","2020-06-20","110","7655","6","517","6.7","5.8"
"Paulding","2020-06-21","38","7693","5","522","8.5","6.3"
"Paulding","2020-06-22","284","7977","26","548","9.2","6.7"
"Paulding","2020-06-23","257","8234","17","565","9.1","6.7"
"Paulding","2020-06-24","264","8498","17","582","8.5","6.9"
"Paulding","2020-06-25","304","8802","32","614","8.7","7.2"
"Paulding","2020-06-26","300","9102","39","653","9.2","7.8"
"Paulding","2020-06-27","90","9192","8","661","9.7","8.2"
"Paulding","2020-06-28","44","9236","4","665","9.1","8.8"
"Paulding","2020-06-29","417","9653","50","715","9.5","9.3"
"Paulding","2020-06-30","435","10088","49","764","10.2","9.7"
"Paulding","2020-07-01","412","10500","40","804","10.6","9.5"
"Paulding","2020-07-02","344","10844","44","848","11","9.8"
"Paulding","2020-07-03","108","10952","8","856","10.2","9.7"
"Paulding","2020-07-04","45","10997","3","859","9.8","9.8"
"Paulding","2020-07-05","41","11038","3","862","9.6","9.3"
"Paulding","2020-07-06","432","11470","65","927","10","9.8"
"Paulding","2020-07-07","471","11941","60","987","10.2","10.2"
"Paulding","2020-07-08","356","12297","33","1020","10.2","10.4"
"Paulding","2020-07-09","364","12661","33","1053","9.6","10.3"
"Paulding","2020-07-10","388","13049","31","1084","9.7","9.9"
"Paulding","2020-07-11","69","13118","9","1093","10.6","10.2"
"Paulding","2020-07-12","55","13173","5","1098","10.9","10.2"
"Paulding","2020-07-13","351","13524","39","1137","10.3","10.2"
"Paulding","2020-07-14","344","13868","54","1191","10.8","10.5"
"Paulding","2020-07-15","335","14203","43","1234","11.3","10.7"
"Paulding","2020-07-16","330","14533","36","1270","11.5","10.6"
"Paulding","2020-07-17","337","14870","30","1300","11.7","10.7"
"Paulding","2020-07-18","239","15109","19","1319","10.9","10.8"
"Paulding","2020-07-19","44","15153","6","1325","11.6","11.2"
"Paulding","2020-07-20","327","15480","49","1374","12.1","11.2"
"Paulding","2020-07-21","321","15801","36","1410","11.5","11.1"
"Paulding","2020-07-22","298","16099","40","1450","11.6","11.4"
"Paulding","2020-07-23","335","16434","35","1485","11.5","11.5"
"Paulding","2020-07-24","303","16737","23","1508","11.3","11.5"
"Paulding","2020-07-25","65","16802","10","1518","12.4","11.7"
"Paulding","2020-07-26","43","16845","3","1521","11.4","11.5"
"Paulding","2020-07-27","347","17192","29","1550","10.5","11.3"
"Paulding","2020-07-28","327","17519","25","1575","10","10.7"
"Paulding","2020-07-29","296","17815","23","1598","9.2","10.4"
"Paulding","2020-07-30","275","18090","18","1616","8.6","10.1"
"Paulding","2020-07-31","271","18361","17","1633","8.4","9.9"
"Paulding","2020-08-01","141","18502","16","1649","7.8","10.1"
"Paulding","2020-08-02","78","18580","3","1652","7.4","9.4"
"Paulding","2020-08-03","324","18904","38","1690","7.9","9.2"
"Paulding","2020-08-04","321","19225","40","1730","8.6","9.3"
"Paulding","2020-08-05","280","19505","42","1772","9.6","9.4"
"Paulding","2020-08-06","357","19862","26","1798","9.7","9.2"
"Paulding","2020-08-07","330","20192","28","1826","10","9.2"
"Paulding","2020-08-08","75","20267","9","1835","10.1","9"
"Paulding","2020-08-09","58","20325","9","1844","11.8","9.6"
"Paulding","2020-08-10","343","20668","36","1880","11.6","9.7"
"Paulding","2020-08-11","364","21032","32","1912","11.1","9.8"
"Paulding","2020-08-12","340","21372","19","1931","9.7","9.7"
"Paulding","2020-08-13","330","21702","16","1947","9.4","9.5"
"Paulding","2020-08-14","293","21995","20","1967","9.2","9.6"
"Paulding","2020-08-15","108","22103","12","1979","9","9.6"
"Paulding","2020-08-16","52","22155","4","1983","7.9","9.8"
"Paulding","2020-08-17","128","22283","8","1991","7.3","9.5"
"Paulding","2020-08-18","313","22596","16","2007","6.8","8.9"
"Paulding","2020-08-19","319","22915","17","2024","6.7","8.2"
"Paulding","2020-08-20","305","23220","28","2052","7.4","8.4"
"Paulding","2020-08-21","279","23499","23","2075","7.6","8.4"
"Paulding","2020-08-22","57","23556","3","2078","6.7","7.9"
"Paulding","2020-08-23","57","23613","6","2084","7.1","7.5"
"Paulding","2020-08-24","296","23909","16","2100","7","7.2"
"Paulding","2020-08-25","275","24184","27","2127","7.7","7.2"
"Paulding","2020-08-26","249","24433","24","2151","8.3","7.5"
"Paulding","2020-08-27","254","24687","18","2169","8","7.7"
"Paulding","2020-08-28","259","24946","22","2191","8","7.8"
"Paulding","2020-08-29","78","25024","5","2196","8.2","7.5"
"Paulding","2020-08-30","35","25059","3","2199","7.9","7.5"
"Paulding","2020-08-31","310","25369","36","2235","8.8","7.9"
"Paulding","2020-09-01","139","25508","19","2254","9.4","8.5"
"Paulding","2020-09-02","101","25609","10","2264","9.4","8.8"
"Paulding","2020-09-03","333","25942","28","2292","9.6","8.8"
"Paulding","2020-09-04","236","26178","22","2314","9.7","8.9"
"Paulding","2020-09-05","77","26255","4","2318","9.5","8.9"
"Paulding","2020-09-06","59","26314","6","2324","9.8","8.8"
"Paulding","2020-09-07","77","26391","10","2334","10","9.4"
"Paulding","2020-09-08","134","26525","14","2348","9.5","9.4"
"Paulding","2020-09-09","158","26683","15","2363","9.4","9.4"
"Paulding","2020-09-10","276","26959","20","2383","9.3","9.4"
"Paulding","2020-09-11","255","27214","14","2397","8.7","9.2"
"Paulding","2020-09-12","51","27265","5","2402","9.4","9.5"
"Paulding","2020-09-13","47","27312","4","2406","9.1","9.4"
"Paulding","2020-09-14","282","27594","18","2424","8.2","9.1"
"Paulding","2020-09-15","126","27720","6","2430","7.4","8.4"
"Paulding","2020-09-16","135","27855","6","2436","6.7","8"
"Paulding","2020-09-17","131","27986","11","2447","6.8","8"
"Paulding","2020-09-18","303","28289","11","2458","6.6","7.6"
"Paulding","2020-09-19","95","28384","11","2469","6.8","8.1"
"Paulding","2020-09-20","32","28416","2","2471","6.5","7.8"
"Paulding","2020-09-21","225","28641","19","2490","6.8","7.5"
"Paulding","2020-09-22","110","28751","7","2497","7","7.2"
"Paulding","2020-09-23","110","28861","4","2501","6.9","6.8"
"Paulding","2020-09-24","184","29045","12","2513","6.6","6.7"
"Paulding","2020-09-25","208","29253","11","2524","6.9","6.7"
"Paulding","2020-09-26","49","29302","3","2527","6.1","6.5"
"Paulding","2020-09-27","45","29347","2","2529","5.8","6.2"
"Paulding","2020-09-28","161","29508","9","2538","5.4","6.1"
"Paulding","2020-09-29","97","29605","6","2544","5.4","6.2"
"Paulding","2020-09-30","116","29721","5","2549","5.5","6.2"
"Paulding","2020-10-01","227","29948","17","2566","5.6","6.1"
"Paulding","2020-10-02","194","30142","7","2573","5.4","6.1"
"Paulding","2020-10-03","64","30206","10","2583","6.8","6.4"
"Paulding","2020-10-04","40","30246","1","2584","6.5","6.2"
"Paulding","2020-10-05","216","30462","8","2592","6.2","5.8"
"Paulding","2020-10-06","178","30640","12","2604","6.3","5.8"
"Paulding","2020-10-07","155","30795","6","2610","6.2","5.9"
"Paulding","2020-10-08","138","30933","5","2615","5.7","5.7"
"Paulding","2020-10-09","110","31043","5","2620","5.8","5.6"
"Paulding","2020-10-10","57","31100","6","2626","5.1","5.9"
"Paulding","2020-10-11","48","31148","0","2626","4.7","5.6"
"Paulding","2020-10-12","126","31274","11","2637","5.4","5.8"
"Paulding","2020-10-13","133","31407","5","2642","5","5.6"
"Paulding","2020-10-14","103","31510","3","2645","4.9","5.5"
"Paulding","2020-10-15","124","31634","5","2650","4.9","5.3"
"Paulding","2020-10-16","267","31901","22","2672","5.5","5.6"
"Paulding","2020-10-17","63","31964","4","2676","4.9","5"
"Paulding","2020-10-18","49","32013","1","2677","5.2","4.9"
"Paulding","2020-10-19","214","32227","16","2693","5","5.2"
"Paulding","2020-10-20","151","32378","10","2703","5.4","5.2"
"Paulding","2020-10-21","137","32515","16","2719","6.6","5.8"
"Paulding","2020-10-22","141","32656","10","2729","7.1","6"
"Paulding","2020-10-23","285","32941","14","2743","6.6","6"
"Paulding","2020-10-24","73","33014","11","2754","7.8","6.4"
"Paulding","2020-10-25","46","33060","5","2759","9.1","7.1"
"Paulding","2020-10-26","205","33265","23","2782","9.6","7.3"
"Paulding","2020-10-27","164","33429","16","2798","10.1","7.7"
"Paulding","2020-10-28","177","33606","8","2806","9.1","7.8"
"Paulding","2020-10-29","118","33724","11","2817","9.4","8.2"
"Paulding","2020-10-30","254","33978","22","2839","9.9","8.3"
"Paulding","2020-10-31","95","34073","11","2850","9.4","8.6"
"Paulding","2020-11-01","65","34138","12","2862","10.5","9.8"
"Paulding","2020-11-02","267","34405","35","2897","10.8","10.2"
"Paulding","2020-11-03","137","34542","12","2909","10.6","10.4"
"Paulding","2020-11-04","189","34731","10","2919","10.7","9.9"
"Paulding","2020-11-05","298","35029","22","2941","10.5","9.9"
"Paulding","2020-11-06","259","35288","17","2958","10.2","10"
"Paulding","2020-11-07","100","35388","17","2975","10.9","10.2"
"Paulding","2020-11-08","59","35447","4","2979","9.3","9.9"
"Paulding","2020-11-09","288","35735","38","3017","9.3","10"
"Paulding","2020-11-10","180","35915","18","3035","9.5","10"
"Paulding","2020-11-11","169","36084","22","3057","10.6","10.7"
"Paulding","2020-11-12","398","36482","65","3122","11.8","11.2"
"Paulding","2020-11-13","358","36840","39","3161","12.5","11.3"
"Paulding","2020-11-14","99","36939","17","3178","12.5","11.7"
"Paulding","2020-11-15","74","37013","12","3190","13.8","11.6"
"Paulding","2020-11-16","363","37376","38","3228","13.4","11.4"
"Paulding","2020-11-17","248","37624","29","3257","13.7","11.6"
"Paulding","2020-11-18","230","37854","33","3290","13.9","12.2"
"Paulding","2020-11-19","517","38371","58","3348","13.1","12.5"
"Paulding","2020-11-20","470","38841","40","3388","12.8","12.6"
"Paulding","2020-11-21","100","38941","9","3397","11.6","12.1"
"Paulding","2020-11-22","79","39020","8","3405","10.8","12.3"
"Paulding","2020-11-23","554","39574","79","3484","11.3","12.4"
"Paulding","2020-11-24","217","39791","23","3507","11.2","12.4"
"Paulding","2020-11-25","206","39997","18","3525","10.4","12.1"
"Paulding","2020-11-26","27","40024","2","3527","9.8","11.5"
"Paulding","2020-11-27","193","40217","34","3561","11.1","12"
"Paulding","2020-11-28","109","40326","25","3586","13.1","12.4"
"Paulding","2020-11-29","87","40413","19","3605","14.8","12.8"
"Paulding","2020-11-30","528","40941","82","3687","15","13.1"
"Paulding","2020-12-01","405","41346","82","3769","16.3","13.7"
"Paulding","2020-12-02","274","41620","46","3815","17.5","13.9"
"Paulding","2020-12-03","632","42252","90","3905","18.5","14.1"
"Paulding","2020-12-04","498","42750","55","3960","17.5","14.3"
"Paulding","2020-12-05","101","42851","22","3982","17.4","15.2"
"Paulding","2020-12-06","67","42918","10","3992","16.4","15.6"
"Paulding","2020-12-07","569","43487","103","4095","16.7","15.8"
"Paulding","2020-12-08","489","43976","73","4168","16","16.2"
"Paulding","2020-12-09","284","44260","33","4201","15.2","16.4"
"Paulding","2020-12-10","718","44978","103","4304","15.2","16.9"
"Paulding","2020-12-11","579","45557","89","4393","15.9","16.7"
"Paulding","2020-12-12","159","45716","31","4424","15.5","16.4"
"Paulding","2020-12-13","103","45819","19","4443","16","16.2"
"Paulding","2020-12-14","673","46492","125","4568","16.1","16.4"
"Paulding","2020-12-15","756","47248","133","4701","16.5","16.2"
"Paulding","2020-12-16","298","47546","28","4729","16.2","15.7"
"Paulding","2020-12-17","813","48359","129","4858","16.4","15.8"
"Paulding","2020-12-18","766","49125","124","4982","16.5","16.2"
"Paulding","2020-12-19","142","49267","29","5011","16.6","16.1"
"Paulding","2020-12-20","135","49402","23","5034","16.4","16.2"
"Paulding","2020-12-21","914","50316","181","5215","16.6","16.4"
"Paulding","2020-12-22","831","51147","159","5374","16.8","16.7"
"Paulding","2020-12-23","329","51476","68","5442","18.4","17.3"
"Paulding","2020-12-24","198","51674","33","5475","18.6","17.5"
"Paulding","2020-12-25","39","51713","5","5480","18.1","17.3"
"Paulding","2020-12-26","134","51847","37","5517","19.1","17.9"
"Paulding","2020-12-27","90","51937","33","5550","21.9","19.2"
"Paulding","2020-12-28","1029","52966","210","5760","22","19.3"
"Paulding","2020-12-29","855","53821","154","5914","21.8","19.3"
"Paulding","2020-12-30","390","54211","84","5998","22","20.2"
"Paulding","2020-12-31","920","55131","201","6199","22.7","20.6"
"Paulding","2021-01-01","65","55196","14","6213","23.9","21"
"Paulding","2021-01-02","153","55349","47","6260","24.4","21.7"
"Paulding","2021-01-03","100","55449","24","6284","22.6","22.2"
"Paulding","2021-01-04","1046","56495","196","6480","22.3","22.2"
"Paulding","2021-01-05","1081","57576","179","6659","22.1","22"
"Paulding","2021-01-06","547","58123","105","6764","21.8","21.9"
"Paulding","2021-01-07","1008","59131","173","6937","21.1","21.9"
"Paulding","2021-01-08","730","59861","117","7054","20.3","22.1"
"Paulding","2021-01-09","173","60034","45","7099","19.7","22"
"Paulding","2021-01-10","114","60148","21","7120","18.9","20.7"
"Paulding","2021-01-11","525","60673","69","7189","18.1","20.2"
"Paulding","2021-01-12","892","61565","112","7301","17.5","19.8"
"Paulding","2021-01-13","442","62007","60","7361","16.7","19.2"
"Paulding","2021-01-14","778","62785","107","7468","16.2","18.7"
"Paulding","2021-01-15","774","63559","84","7552","15.5","17.9"
"Paulding","2021-01-16","246","63805","57","7609","15.1","17.4"
"Paulding","2021-01-17","124","63929","20","7629","14.7","16.8"
"Paulding","2021-01-18","443","64372","33","7662","13.9","16"
"Paulding","2021-01-19","533","64905","81","7743","14.3","15.9"
"Paulding","2021-01-20","397","65302","46","7789","14","15.4"
"Paulding","2021-01-21","330","65632","59","7848","14.6","15.4"
"Paulding","2021-01-22","652","66284","98","7946","15.2","15.3"
"Paulding","2021-01-23","198","66482","34","7980","14.3","14.7"
"Paulding","2021-01-24","66","66548","5","7985","13.1","13.9"
"Paulding","2021-01-25","193","66741","10","7995","12.8","13.4"
"Paulding","2021-01-26","40","66781","5","8000","12.4","13.4"
"Paulding","2021-01-27","0","66781","0","8000","10.8","12.4"
"Peach","2020-02-01","0","0","0","0",".","."
"Peach","2020-02-02","0","0","0","0",".","."
"Peach","2020-02-03","0","0","0","0",".","."
"Peach","2020-02-04","0","0","0","0",".","."
"Peach","2020-02-05","0","0","0","0",".","."
"Peach","2020-02-06","0","0","0","0",".","."
"Peach","2020-02-07","0","0","0","0","0","."
"Peach","2020-02-08","0","0","0","0","0","."
"Peach","2020-02-09","0","0","0","0","0","."
"Peach","2020-02-10","0","0","0","0","0","."
"Peach","2020-02-11","0","0","0","0","0","."
"Peach","2020-02-12","0","0","0","0","0","."
"Peach","2020-02-13","0","0","0","0","0","."
"Peach","2020-02-14","0","0","0","0","0","0"
"Peach","2020-02-15","0","0","0","0","0","0"
"Peach","2020-02-16","0","0","0","0","0","0"
"Peach","2020-02-17","0","0","0","0","0","0"
"Peach","2020-02-18","0","0","0","0","0","0"
"Peach","2020-02-19","0","0","0","0","0","0"
"Peach","2020-02-20","0","0","0","0","0","0"
"Peach","2020-02-21","0","0","0","0","0","0"
"Peach","2020-02-22","0","0","0","0","0","0"
"Peach","2020-02-23","0","0","0","0","0","0"
"Peach","2020-02-24","0","0","0","0","0","0"
"Peach","2020-02-25","0","0","0","0","0","0"
"Peach","2020-02-26","0","0","0","0","0","0"
"Peach","2020-02-27","0","0","0","0","0","0"
"Peach","2020-02-28","0","0","0","0","0","0"
"Peach","2020-02-29","0","0","0","0","0","0"
"Peach","2020-03-01","0","0","0","0","0","0"
"Peach","2020-03-02","0","0","0","0","0","0"
"Peach","2020-03-03","0","0","0","0","0","0"
"Peach","2020-03-04","0","0","0","0","0","0"
"Peach","2020-03-05","0","0","0","0","0","0"
"Peach","2020-03-06","0","0","0","0","0","0"
"Peach","2020-03-07","0","0","0","0","0","0"
"Peach","2020-03-08","0","0","0","0","0","0"
"Peach","2020-03-09","0","0","0","0","0","0"
"Peach","2020-03-10","0","0","0","0","0","0"
"Peach","2020-03-11","0","0","0","0","0","0"
"Peach","2020-03-12","0","0","0","0","0","0"
"Peach","2020-03-13","2","2","0","0","0","0"
"Peach","2020-03-14","0","2","0","0","0","0"
"Peach","2020-03-15","0","2","0","0","0","0"
"Peach","2020-03-16","1","3","0","0","0","0"
"Peach","2020-03-17","1","4","1","1","14.3","7.1"
"Peach","2020-03-18","3","7","1","2","19","9.5"
"Peach","2020-03-19","2","9","0","2","19","9.5"
"Peach","2020-03-20","11","20","5","7","25.5","12.8"
"Peach","2020-03-21","0","20","0","7","25.5","12.8"
"Peach","2020-03-22","9","29","4","11","31.9","15.9"
"Peach","2020-03-23","4","33","2","13","39","19.5"
"Peach","2020-03-24","5","38","1","14","27.6","20.9"
"Peach","2020-03-25","7","45","0","14","22.8","20.9"
"Peach","2020-03-26","5","50","1","15","25.7","22.4"
"Peach","2020-03-27","4","54","0","15","19.2","22.4"
"Peach","2020-03-28","2","56","0","15","19.2","22.4"
"Peach","2020-03-29","3","59","1","16","17.6","24.8"
"Peach","2020-03-30","12","71","2","18","12.9","25.9"
"Peach","2020-03-31","12","83","1","19","11.2","19.4"
"Peach","2020-04-01","12","95","1","20","12.4","17.6"
"Peach","2020-04-02","9","104","3","23","14.3","20"
"Peach","2020-04-03","14","118","6","29","20.4","19.8"
"Peach","2020-04-04","1","119","0","29","20.4","19.8"
"Peach","2020-04-05","5","124","0","29","15.6","16.6"
"Peach","2020-04-06","8","132","1","30","15.1","14"
"Peach","2020-04-07","7","139","2","32","17.9","14.6"
"Peach","2020-04-08","5","144","1","33","19.6","16"
"Peach","2020-04-09","5","149","1","34","17.7","16"
"Peach","2020-04-10","5","154","0","34","11.6","16"
"Peach","2020-04-11","1","155","0","34","11.6","16"
"Peach","2020-04-12","4","159","1","35","15.2","15.4"
"Peach","2020-04-13","16","175","7","42","19.6","17.3"
"Peach","2020-04-14","7","182","0","42","15.5","16.7"
"Peach","2020-04-15","7","189","1","43","14.7","17.2"
"Peach","2020-04-16","4","193","2","45","19","18.4"
"Peach","2020-04-17","2","195","0","45","19","15.3"
"Peach","2020-04-18","2","197","1","46","26.1","18.9"
"Peach","2020-04-19","7","204","0","46","22.6","18.9"
"Peach","2020-04-20","10","214","1","47","17.8","18.7"
"Peach","2020-04-21","11","225","4","51","22.9","19.2"
"Peach","2020-04-22","13","238","3","54","24.2","19.5"
"Peach","2020-04-23","3","241","1","55","21.8","20.4"
"Peach","2020-04-24","7","248","1","56","23.9","21.4"
"Peach","2020-04-25","3","251","0","56","16.7","21.4"
"Peach","2020-04-26","4","255","0","56","16.7","19.6"
"Peach","2020-04-27","6","261","0","56","15.3","16.5"
"Peach","2020-04-28","19","280","1","57","10.9","16.9"
"Peach","2020-04-29","17","297","3","60","10.1","17.1"
"Peach","2020-04-30","6","303","0","60","5.3","13.6"
"Peach","2020-05-01","11","314","2","62","5.9","14.9"
"Peach","2020-05-02","8","322","0","62","5.9","11.3"
"Peach","2020-05-03","2","324","0","62","5.9","11.3"
"Peach","2020-05-04","13","337","2","64","8.1","11.7"
"Peach","2020-05-05","18","355","2","66","8.9","9.9"
"Peach","2020-05-06","4","359","0","66","6.4","8.2"
"Peach","2020-05-07","15","374","0","66","6.4","5.8"
"Peach","2020-05-08","6","380","0","66","3.8","4.8"
"Peach","2020-05-09","5","385","1","67","6.6","6.3"
"Peach","2020-05-10","3","388","1","68","11.4","8.6"
"Peach","2020-05-11","38","426","5","73","11.1","9.6"
"Peach","2020-05-12","53","479","1","74","9.8","9.3"
"Peach","2020-05-13","49","528","1","75","10.1","8.2"
"Peach","2020-05-14","12","540","0","75","10.1","8.2"
"Peach","2020-05-15","2","542","1","76","17.2","10.5"
"Peach","2020-05-16","1","543","0","76","14.3","10.5"
"Peach","2020-05-17","2","545","0","76","9.6","10.5"
"Peach","2020-05-18","9","554","0","76","7.7","9.4"
"Peach","2020-05-19","11","565","0","76","7.4","8.6"
"Peach","2020-05-20","53","618","1","77","7.4","8.7"
"Peach","2020-05-21","21","639","2","79","8.8","9.4"
"Peach","2020-05-22","15","654","0","79","1.6","9.4"
"Peach","2020-05-23","7","661","0","79","1.6","8"
"Peach","2020-05-24","6","667","0","79","1.6","5.6"
"Peach","2020-05-25","3","670","0","79","1.6","4.7"
"Peach","2020-05-26","15","685","1","80","2.6","5"
"Peach","2020-05-27","35","720","1","81","2.7","5.1"
"Peach","2020-05-28","11","731","2","83","4","6.4"
"Peach","2020-05-29","7","738","0","83","4","2.8"
"Peach","2020-05-30","9","747","0","83","4","2.8"
"Peach","2020-05-31","2","749","0","83","4","2.8"
"Peach","2020-06-01","22","771","1","84","4.6","3.1"
"Peach","2020-06-02","14","785","2","86","5.7","4.1"
"Peach","2020-06-03","24","809","0","86","5.3","4"
"Peach","2020-06-04","24","833","1","87","3.3","3.6"
"Peach","2020-06-05","13","846","0","87","3.3","3.6"
"Peach","2020-06-06","6","852","1","88","5.7","4.8"
"Peach","2020-06-07","9","861","1","89","7.3","5.6"
"Peach","2020-06-08","20","881","0","89","6.6","5.6"
"Peach","2020-06-09","14","895","1","90","5.6","5.6"
"Peach","2020-06-10","27","922","2","92","6.6","6"
"Peach","2020-06-11","15","937","2","94","8","5.6"
"Peach","2020-06-12","9","946","0","94","8","5.6"
"Peach","2020-06-13","4","950","0","94","5.6","5.6"
"Peach","2020-06-14","3","953","0","94","4","5.6"
"Peach","2020-06-15","15","968","1","95","4.9","5.8"
"Peach","2020-06-16","18","986","1","96","4.7","5.1"
"Peach","2020-06-17","34","1020","1","97","4.1","5.4"
"Peach","2020-06-18","15","1035","0","97","2.2","5.1"
"Peach","2020-06-19","14","1049","0","97","2.2","5.1"
"Peach","2020-06-20","1","1050","0","97","2.2","3.9"
"Peach","2020-06-21","15","1065","0","97","2.2","3.1"
"Peach","2020-06-22","22","1087","1","98","1.9","3.4"
"Peach","2020-06-23","27","1114","1","99","1.6","3.2"
"Peach","2020-06-24","34","1148","0","99","1.2","2.6"
"Peach","2020-06-25","38","1186","3","102","2.3","2.2"
"Peach","2020-06-26","27","1213","0","102","2.3","2.2"
"Peach","2020-06-27","9","1222","0","102","2.3","2.2"
"Peach","2020-06-28","13","1235","1","103","3.4","2.8"
"Peach","2020-06-29","31","1266","3","106","4.1","3"
"Peach","2020-06-30","33","1299","5","111","5.8","3.7"
"Peach","2020-07-01","53","1352","5","116","7.1","4.1"
"Peach","2020-07-02","46","1398","3","119","6.9","4.6"
"Peach","2020-07-03","13","1411","1","120","8","5.2"
"Peach","2020-07-04","10","1421","5","125","15.2","8.7"
"Peach","2020-07-05","3","1424","2","127","23.6","13.5"
"Peach","2020-07-06","64","1488","12","139","24.9","14.5"
"Peach","2020-07-07","34","1522","9","148","26.5","16.1"
"Peach","2020-07-08","59","1581","9","157","27.3","17.2"
"Peach","2020-07-09","29","1610","4","161","28.4","17.7"
"Peach","2020-07-10","27","1637","7","168","31","19.5"
"Peach","2020-07-11","18","1655","3","171","26.2","20.7"
"Peach","2020-07-12","14","1669","5","176","21.8","22.7"
"Peach","2020-07-13","45","1714","7","183","21.3","23.1"
"Peach","2020-07-14","32","1746","4","187","19.3","22.9"
"Peach","2020-07-15","67","1813","9","196","19.1","23.2"
"Peach","2020-07-16","31","1844","1","197","17.6","23"
"Peach","2020-07-17","25","1869","5","202","16.7","23.9"
"Peach","2020-07-18","9","1878","2","204","17.5","21.9"
"Peach","2020-07-19","17","1895","3","207","14.9","18.4"
"Peach","2020-07-20","48","1943","12","219","16.3","18.8"
"Peach","2020-07-21","27","1970","4","223","16.6","18"
"Peach","2020-07-22","88","2058","19","242","17.8","18.4"
"Peach","2020-07-23","27","2085","4","246","19.4","18.5"
"Peach","2020-07-24","37","2122","4","250","18.1","17.4"
"Peach","2020-07-25","13","2135","2","252","17.2","17.3"
"Peach","2020-07-26","8","2143","1","253","16.4","15.7"
"Peach","2020-07-27","40","2183","11","264","16.8","16.5"
"Peach","2020-07-28","33","2216","8","272","18.1","17.4"
"Peach","2020-07-29","83","2299","9","281","16.6","17.2"
"Peach","2020-07-30","39","2338","9","290","17.8","18.6"
"Peach","2020-07-31","32","2370","9","299","20.2","19.2"
"Peach","2020-08-01","9","2379","6","305","27.6","22.4"
"Peach","2020-08-02","19","2398","3","308","28","22.2"
"Peach","2020-08-03","69","2467","9","317","26","21.4"
"Peach","2020-08-04","32","2499","3","320","23.8","21"
"Peach","2020-08-05","96","2595","10","330","23.8","20.2"
"Peach","2020-08-06","31","2626","6","336","23.3","20.5"
"Peach","2020-08-07","24","2650","4","340","21.6","20.9"
"Peach","2020-08-08","9","2659","2","342","15.3","21.4"
"Peach","2020-08-09","10","2669","1","343","14.4","21.2"
"Peach","2020-08-10","30","2699","8","351","16.4","21.2"
"Peach","2020-08-11","29","2728","8","359","19","21.4"
"Peach","2020-08-12","68","2796","11","370","19.8","21.8"
"Peach","2020-08-13","25","2821","7","377","21","22.1"
"Peach","2020-08-14","29","2850","9","386","23.1","22.4"
"Peach","2020-08-15","9","2859","3","389","24.7","20"
"Peach","2020-08-16","19","2878","4","393","26.3","20.4"
"Peach","2020-08-17","28","2906","6","399","25.5","21"
"Peach","2020-08-18","19","2925","5","404","25.3","22.2"
"Peach","2020-08-19","66","2991","4","408","23.9","21.8"
"Peach","2020-08-20","33","3024","4","412","21.6","21.3"
"Peach","2020-08-21","84","3108","8","420","18.5","20.8"
"Peach","2020-08-22","12","3120","1","421","15","19.8"
"Peach","2020-08-23","14","3134","4","425","16.1","21.2"
"Peach","2020-08-24","14","3148","1","426","14","19.8"
"Peach","2020-08-25","34","3182","3","429","11.5","18.4"
"Peach","2020-08-26","60","3242","7","436","12.3","18.1"
"Peach","2020-08-27","15","3257","1","437","11.5","16.6"
"Peach","2020-08-28","25","3282","2","439","11.3","14.9"
"Peach","2020-08-29","17","3299","2","441","11.8","13.4"
"Peach","2020-08-30","5","3304","1","442","10.6","13.3"
"Peach","2020-08-31","28","3332","3","445","11.1","12.6"
"Peach","2020-09-01","36","3368","6","451","12.2","11.9"
"Peach","2020-09-02","26","3394","3","454","12.2","12.3"
"Peach","2020-09-03","20","3414","3","457","13.4","12.5"
"Peach","2020-09-04","30","3444","4","461","14.1","12.7"
"Peach","2020-09-05","5","3449","1","462","15.3","13.6"
"Peach","2020-09-06","7","3456","0","462","12.5","11.5"
"Peach","2020-09-07","10","3466","3","465","15.2","13.2"
"Peach","2020-09-08","22","3488","5","470","16.1","14.1"
"Peach","2020-09-09","37","3525","5","475","16.4","14.3"
"Peach","2020-09-10","27","3552","0","475","14.2","13.8"
"Peach","2020-09-11","25","3577","0","475","12.3","13.2"
"Peach","2020-09-12","19","3596","4","479","12.5","13.9"
"Peach","2020-09-13","16","3612","2","481","14.3","13.4"
"Peach","2020-09-14","21","3633","3","484","12","13.6"
"Peach","2020-09-15","31","3664","2","486","9.7","12.9"
"Peach","2020-09-16","43","3707","3","489","8.8","12.6"
"Peach","2020-09-17","24","3731","1","490","9.3","11.8"
"Peach","2020-09-18","36","3767","3","493","10.5","11.4"
"Peach","2020-09-19","8","3775","1","494","9.3","10.9"
"Peach","2020-09-20","5","3780","0","494","7.5","10.9"
"Peach","2020-09-21","26","3806","4","498","7.7","9.8"
"Peach","2020-09-22","15","3821","2","500","8.7","9.2"
"Peach","2020-09-23","30","3851","3","503","9.1","8.9"
"Peach","2020-09-24","20","3871","2","505","9.9","9.6"
"Peach","2020-09-25","24","3895","1","506","9.3","9.9"
"Peach","2020-09-26","8","3903","0","506","7.6","8.4"
"Peach","2020-09-27","5","3908","0","506","7.6","7.5"
"Peach","2020-09-28","19","3927","4","510","8.4","8"
"Peach","2020-09-29","24","3951","2","512","7.7","8.2"
"Peach","2020-09-30","33","3984","1","513","6.7","7.9"
"Peach","2020-10-01","29","4013","1","514","5.7","7.8"
"Peach","2020-10-02","27","4040","2","516","6.2","7.8"
"Peach","2020-10-03","5","4045","0","516","6.2","6.9"
"Peach","2020-10-04","13","4058","0","516","6.2","6.9"
"Peach","2020-10-05","32","4090","1","517","3.6","6"
"Peach","2020-10-06","32","4122","5","522","4.7","6.2"
"Peach","2020-10-07","32","4154","2","524","5.1","5.9"
"Peach","2020-10-08","17","4171","1","525","5.5","5.6"
"Peach","2020-10-09","26","4197","3","528","6.1","6.1"
"Peach","2020-10-10","10","4207","0","528","6.1","6.1"
"Peach","2020-10-11","8","4215","1","529","7.8","7"
"Peach","2020-10-12","26","4241","5","534","10.1","6.9"
"Peach","2020-10-13","36","4277","2","536","8.7","6.7"
"Peach","2020-10-14","24","4301","0","536","7.8","6.5"
"Peach","2020-10-15","33","4334","5","541","9.1","7.3"
"Peach","2020-10-16","18","4352","1","542","8.3","7.2"
"Peach","2020-10-17","8","4360","2","544","11.9","9"
"Peach","2020-10-18","7","4367","3","547","16.2","12"
"Peach","2020-10-19","33","4400","2","549","14.3","12.2"
"Peach","2020-10-20","24","4424","3","552","15.3","12"
"Peach","2020-10-21","51","4475","7","559","17.3","12.5"
"Peach","2020-10-22","34","4509","5","564","17.2","13.2"
"Peach","2020-10-23","29","4538","4","568","18.4","13.3"
"Peach","2020-10-24","12","4550","0","568","14.8","13.3"
"Peach","2020-10-25","10","4560","2","570","11.5","13.9"
"Peach","2020-10-26","43","4603","10","580","14","14.2"
"Peach","2020-10-27","23","4626","2","582","13.5","14.4"
"Peach","2020-10-28","48","4674","8","590","13.9","15.6"
"Peach","2020-10-29","32","4706","3","593","13.1","15.2"
"Peach","2020-10-30","43","4749","7","600","13.5","15.9"
"Peach","2020-10-31","22","4771","0","600","13.5","14.1"
"Peach","2020-11-01","9","4780","2","602","13.8","12.7"
"Peach","2020-11-02","34","4814","3","605","11.7","12.9"
"Peach","2020-11-03","23","4837","5","610","13.6","13.5"
"Peach","2020-11-04","53","4890","7","617","13.1","13.5"
"Peach","2020-11-05","23","4913","1","618","12.4","12.7"
"Peach","2020-11-06","31","4944","4","622","11.9","12.7"
"Peach","2020-11-07","14","4958","3","625","15","14.2"
"Peach","2020-11-08","9","4967","4","629","18.1","16"
"Peach","2020-11-09","44","5011","9","638","19.8","15.8"
"Peach","2020-11-10","37","5048","4","642","18.2","15.9"
"Peach","2020-11-11","38","5086","5","647","18.2","15.7"
"Peach","2020-11-12","34","5120","3","650","18.9","15.6"
"Peach","2020-11-13","24","5144","4","654","19.4","15.6"
"Peach","2020-11-14","17","5161","3","657","18.9","16.9"
"Peach","2020-11-15","14","5175","2","659","14.5","16.3"
"Peach","2020-11-16","36","5211","3","662","12.8","16.3"
"Peach","2020-11-17","45","5256","5","667","12.9","15.5"
"Peach","2020-11-18","55","5311","8","675","13.1","15.6"
"Peach","2020-11-19","41","5352","7","682","14.2","16.5"
"Peach","2020-11-20","38","5390","4","686","13.4","16.4"
"Peach","2020-11-21","18","5408","4","690","14","16.4"
"Peach","2020-11-22","15","5423","0","690","12","13.3"
"Peach","2020-11-23","28","5451","1","691","11.3","12.1"
"Peach","2020-11-24","49","5500","10","701","12.6","12.7"
"Peach","2020-11-25","51","5551","10","711","13.3","13.2"
"Peach","2020-11-26","2","5553","1","712","18","16.1"
"Peach","2020-11-27","32","5585","3","715","17.9","15.6"
"Peach","2020-11-28","21","5606","4","719","17.4","15.7"
"Peach","2020-11-29","25","5631","4","723","19.7","15.8"
"Peach","2020-11-30","52","5683","12","735","22.5","16.9"
"Peach","2020-12-01","35","5718","5","740","21.6","17.1"
"Peach","2020-12-02","52","5770","6","746","20.5","16.9"
"Peach","2020-12-03","40","5810","5","751","15.1","16.6"
"Peach","2020-12-04","52","5862","5","756","15.2","16.5"
"Peach","2020-12-05","30","5892","5","761","14.8","16.1"
"Peach","2020-12-06","23","5915","2","763","13.8","16.7"
"Peach","2020-12-07","47","5962","6","769","12.3","17.4"
"Peach","2020-12-08","37","5999","4","773","11.8","16.7"
"Peach","2020-12-09","51","6050","12","785","13.5","17"
"Peach","2020-12-10","41","6091","2","787","12.4","13.8"
"Peach","2020-12-11","31","6122","5","792","13.4","14.3"
"Peach","2020-12-12","27","6149","3","795","12.6","13.7"
"Peach","2020-12-13","14","6163","3","798","14.4","14.1"
"Peach","2020-12-14","39","6202","8","806","15.5","13.9"
"Peach","2020-12-15","43","6245","6","812","15.9","13.9"
"Peach","2020-12-16","72","6317","18","830","16.1","14.8"
"Peach","2020-12-17","60","6377","13","843","18.5","15.5"
"Peach","2020-12-18","47","6424","3","846","17.2","15.3"
"Peach","2020-12-19","41","6465","6","852","17.7","15.1"
"Peach","2020-12-20","40","6505","10","862","18.2","16.3"
"Peach","2020-12-21","43","6548","9","871","18.2","16.9"
"Peach","2020-12-22","36","6584","15","886","22.2","19.1"
"Peach","2020-12-23","88","6672","19","905","21.7","18.9"
"Peach","2020-12-24","27","6699","12","917","24.9","21.7"
"Peach","2020-12-25","9","6708","3","920","28.8","23"
"Peach","2020-12-26","33","6741","8","928","30.2","23.9"
"Peach","2020-12-27","31","6772","9","937","30.7","24.5"
"Peach","2020-12-28","85","6857","26","963","32.1","25.2"
"Peach","2020-12-29","66","6923","16","979","29.6","25.9"
"Peach","2020-12-30","47","6970","17","996","31.7","26.7"
"Peach","2020-12-31","53","7023","10","1006","28.1","26.5"
"Peach","2021-01-01","16","7039","5","1011","27.8","28.3"
"Peach","2021-01-02","22","7061","10","1021","30.8","30.5"
"Peach","2021-01-03","27","7088","6","1027","29.8","30.3"
"Peach","2021-01-04","60","7148","18","1045","29.7","30.9"
"Peach","2021-01-05","91","7239","20","1065","29.4","29.5"
"Peach","2021-01-06","85","7324","18","1083","27.3","29.5"
"Peach","2021-01-07","67","7391","13","1096","27.4","27.7"
"Peach","2021-01-08","52","7443","8","1104","25.1","26.4"
"Peach","2021-01-09","38","7481","12","1116","23.1","27"
"Peach","2021-01-10","40","7521","7","1123","22.4","26.1"
"Peach","2021-01-11","73","7594","8","1131","19.7","24.7"
"Peach","2021-01-12","73","7667","19","1150","20.3","24.9"
"Peach","2021-01-13","66","7733","11","1161","19.6","23.5"
"Peach","2021-01-14","49","7782","7","1168","18.9","23.1"
"Peach","2021-01-15","58","7840","15","1183","20.4","22.7"
"Peach","2021-01-16","27","7867","7","1190","19.6","21.4"
"Peach","2021-01-17","18","7885","7","1197","22.7","22.5"
"Peach","2021-01-18","53","7938","8","1205","23.3","21.5"
"Peach","2021-01-19","65","8003","10","1215","21.7","21"
"Peach","2021-01-20","67","8070","21","1236","23.8","21.7"
"Peach","2021-01-21","54","8124","13","1249","25.2","22.1"
"Peach","2021-01-22","60","8184","11","1260","24.1","22.3"
"Peach","2021-01-23","18","8202","2","1262","22","20.8"
"Peach","2021-01-24","11","8213","3","1265","20.4","21.5"
"Peach","2021-01-25","10","8223","2","1267","21.1","22.2"
"Peach","2021-01-26","0","8223","0","1267","18.9","20.3"
"Peach","2021-01-27","0","8223","0","1267","14.4","19.1"
"Pickens","2020-02-01","0","0","0","0",".","."
"Pickens","2020-02-02","0","0","0","0",".","."
"Pickens","2020-02-03","0","0","0","0",".","."
"Pickens","2020-02-04","0","0","0","0",".","."
"Pickens","2020-02-05","0","0","0","0",".","."
"Pickens","2020-02-06","0","0","0","0",".","."
"Pickens","2020-02-07","0","0","0","0","0","."
"Pickens","2020-02-08","0","0","0","0","0","."
"Pickens","2020-02-09","0","0","0","0","0","."
"Pickens","2020-02-10","0","0","0","0","0","."
"Pickens","2020-02-11","0","0","0","0","0","."
"Pickens","2020-02-12","0","0","0","0","0","."
"Pickens","2020-02-13","0","0","0","0","0","."
"Pickens","2020-02-14","0","0","0","0","0","0"
"Pickens","2020-02-15","0","0","0","0","0","0"
"Pickens","2020-02-16","0","0","0","0","0","0"
"Pickens","2020-02-17","0","0","0","0","0","0"
"Pickens","2020-02-18","0","0","0","0","0","0"
"Pickens","2020-02-19","0","0","0","0","0","0"
"Pickens","2020-02-20","0","0","0","0","0","0"
"Pickens","2020-02-21","0","0","0","0","0","0"
"Pickens","2020-02-22","0","0","0","0","0","0"
"Pickens","2020-02-23","0","0","0","0","0","0"
"Pickens","2020-02-24","0","0","0","0","0","0"
"Pickens","2020-02-25","0","0","0","0","0","0"
"Pickens","2020-02-26","0","0","0","0","0","0"
"Pickens","2020-02-27","0","0","0","0","0","0"
"Pickens","2020-02-28","0","0","0","0","0","0"
"Pickens","2020-02-29","0","0","0","0","0","0"
"Pickens","2020-03-01","0","0","0","0","0","0"
"Pickens","2020-03-02","0","0","0","0","0","0"
"Pickens","2020-03-03","0","0","0","0","0","0"
"Pickens","2020-03-04","0","0","0","0","0","0"
"Pickens","2020-03-05","0","0","0","0","0","0"
"Pickens","2020-03-06","0","0","0","0","0","0"
"Pickens","2020-03-07","0","0","0","0","0","0"
"Pickens","2020-03-08","0","0","0","0","0","0"
"Pickens","2020-03-09","0","0","0","0","0","0"
"Pickens","2020-03-10","0","0","0","0","0","0"
"Pickens","2020-03-11","0","0","0","0","0","0"
"Pickens","2020-03-12","0","0","0","0","0","0"
"Pickens","2020-03-13","1","1","0","0","0","0"
"Pickens","2020-03-14","0","1","0","0","0","0"
"Pickens","2020-03-15","0","1","0","0","0","0"
"Pickens","2020-03-16","1","2","0","0","0","0"
"Pickens","2020-03-17","5","7","0","0","0","0"
"Pickens","2020-03-18","2","9","1","1","7.1","3.6"
"Pickens","2020-03-19","1","10","0","1","7.1","3.6"
"Pickens","2020-03-20","4","14","1","2","10.7","5.4"
"Pickens","2020-03-21","1","15","0","2","10.7","5.4"
"Pickens","2020-03-22","3","18","1","3","15.5","7.7"
"Pickens","2020-03-23","8","26","0","3","15.5","7.7"
"Pickens","2020-03-24","8","34","1","4","17.3","8.6"
"Pickens","2020-03-25","6","40","0","4","10.1","8.6"
"Pickens","2020-03-26","9","49","0","4","10.1","8.6"
"Pickens","2020-03-27","4","53","0","4","6.5","8.6"
"Pickens","2020-03-28","3","56","0","4","6.5","8.6"
"Pickens","2020-03-29","3","59","0","4","1.8","8.6"
"Pickens","2020-03-30","10","69","1","5","3.2","9.3"
"Pickens","2020-03-31","3","72","1","6","6.2","11.7"
"Pickens","2020-04-01","10","82","1","7","7.6","8.9"
"Pickens","2020-04-02","10","92","0","7","7.6","8.9"
"Pickens","2020-04-03","2","94","0","7","7.6","7.1"
"Pickens","2020-04-04","0","94","0","7","7.6","7.1"
"Pickens","2020-04-05","0","94","0","7","7.6","4.7"
"Pickens","2020-04-06","16","110","1","8","7.1","5.1"
"Pickens","2020-04-07","4","114","0","8","2.3","4.3"
"Pickens","2020-04-08","14","128","4","12","5","6.3"
"Pickens","2020-04-09","8","136","0","12","5","6.3"
"Pickens","2020-04-10","12","148","1","13","6.2","6.9"
"Pickens","2020-04-11","3","151","0","13","6.2","6.9"
"Pickens","2020-04-12","1","152","0","13","6.2","6.9"
"Pickens","2020-04-13","10","162","0","13","5.3","6.2"
"Pickens","2020-04-14","7","169","0","13","5.3","3.8"
"Pickens","2020-04-15","4","173","0","13","1.2","3.1"
"Pickens","2020-04-16","6","179","0","13","1.2","3.1"
"Pickens","2020-04-17","18","197","0","13","0","3.1"
"Pickens","2020-04-18","4","201","0","13","0","3.1"
"Pickens","2020-04-19","0","201","0","13","0","3.1"
"Pickens","2020-04-20","8","209","0","13","0","2.6"
"Pickens","2020-04-21","8","217","0","13","0","2.6"
"Pickens","2020-04-22","10","227","0","13","0","0.6"
"Pickens","2020-04-23","5","232","0","13","0","0.6"
"Pickens","2020-04-24","13","245","1","14","1.1","0.5"
"Pickens","2020-04-25","11","256","0","14","1.1","0.5"
"Pickens","2020-04-26","2","258","0","14","1.1","0.5"
"Pickens","2020-04-27","5","263","0","14","1.1","0.5"
"Pickens","2020-04-28","16","279","1","15","2","1"
"Pickens","2020-04-29","24","303","0","15","2","1"
"Pickens","2020-04-30","19","322","0","15","2","1"
"Pickens","2020-05-01","4","326","0","15","0.9","1"
"Pickens","2020-05-02","11","337","0","15","0.9","1"
"Pickens","2020-05-03","15","352","0","15","0.9","1"
"Pickens","2020-05-04","24","376","0","15","0.9","1"
"Pickens","2020-05-05","30","406","2","17","1","1.5"
"Pickens","2020-05-06","66","472","3","20","1.6","1.8"
"Pickens","2020-05-07","36","508","3","23","2.8","2.4"
"Pickens","2020-05-08","26","534","0","23","2.8","1.8"
"Pickens","2020-05-09","5","539","0","23","2.8","1.8"
"Pickens","2020-05-10","12","551","0","23","2.8","1.8"
"Pickens","2020-05-11","25","576","1","24","3.4","2.1"
"Pickens","2020-05-12","37","613","1","25","2.8","1.9"
"Pickens","2020-05-13","42","655","0","25","2.1","1.9"
"Pickens","2020-05-14","25","680","1","26","1.5","2.2"
"Pickens","2020-05-15","44","724","0","26","1.5","2.2"
"Pickens","2020-05-16","5","729","0","26","1.5","2.2"
"Pickens","2020-05-17","14","743","0","26","1.5","2.2"
"Pickens","2020-05-18","17","760","0","26","1","2.2"
"Pickens","2020-05-19","42","802","0","26","0.6","1.7"
"Pickens","2020-05-20","118","920","2","28","0.8","1.5"
"Pickens","2020-05-21","47","967","0","28","0.2","0.9"
"Pickens","2020-05-22","29","996","0","28","0.2","0.9"
"Pickens","2020-05-23","13","1009","0","28","0.2","0.9"
"Pickens","2020-05-24","15","1024","0","28","0.2","0.9"
"Pickens","2020-05-25","11","1035","0","28","0.2","0.6"
"Pickens","2020-05-26","39","1074","1","29","0.6","0.6"
"Pickens","2020-05-27","72","1146","2","31","0.8","0.8"
"Pickens","2020-05-28","23","1169","0","31","0.8","0.5"
"Pickens","2020-05-29","43","1212","0","31","0.8","0.5"
"Pickens","2020-05-30","13","1225","0","31","0.8","0.5"
"Pickens","2020-05-31","17","1242","0","31","0.8","0.5"
"Pickens","2020-06-01","33","1275","1","32","1.2","0.7"
"Pickens","2020-06-02","50","1325","0","32","0.8","0.7"
"Pickens","2020-06-03","76","1401","4","36","1.2","1"
"Pickens","2020-06-04","41","1442","1","37","1.5","1.1"
"Pickens","2020-06-05","35","1477","1","38","1.9","1.4"
"Pickens","2020-06-06","19","1496","2","40","3.4","2.1"
"Pickens","2020-06-07","17","1513","0","40","3.4","2.1"
"Pickens","2020-06-08","42","1555","7","47","5.4","3.3"
"Pickens","2020-06-09","33","1588","1","48","5.8","3.3"
"Pickens","2020-06-10","75","1663","3","51","5.6","3.4"
"Pickens","2020-06-11","43","1706","1","52","5.6","3.6"
"Pickens","2020-06-12","51","1757","3","55","6.1","4"
"Pickens","2020-06-13","7","1764","0","55","4.6","4"
"Pickens","2020-06-14","21","1785","0","55","4.6","4"
"Pickens","2020-06-15","23","1808","3","58","4","4.7"
"Pickens","2020-06-16","49","1857","0","58","3.6","4.7"
"Pickens","2020-06-17","24","1881","0","58","3","4.3"
"Pickens","2020-06-18","22","1903","0","58","2.7","4.2"
"Pickens","2020-06-19","32","1935","3","61","3.2","4.6"
"Pickens","2020-06-20","6","1941","0","61","3.2","3.9"
"Pickens","2020-06-21","9","1950","0","61","3.2","3.9"
"Pickens","2020-06-22","29","1979","0","61","1.3","2.7"
"Pickens","2020-06-23","28","2007","0","61","1.3","2.5"
"Pickens","2020-06-24","38","2045","3","64","2.5","2.8"
"Pickens","2020-06-25","17","2062","0","64","2.5","2.6"
"Pickens","2020-06-26","42","2104","0","64","1.1","2.2"
"Pickens","2020-06-27","20","2124","1","65","1.8","2.5"
"Pickens","2020-06-28","17","2141","0","65","1.8","2.5"
"Pickens","2020-06-29","42","2183","1","66","2.2","1.8"
"Pickens","2020-06-30","31","2214","0","66","2.2","1.8"
"Pickens","2020-07-01","36","2250","3","69","2.2","2.4"
"Pickens","2020-07-02","46","2296","1","70","2.6","2.5"
"Pickens","2020-07-03","21","2317","2","72","3.9","2.5"
"Pickens","2020-07-04","16","2333","0","72","3.2","2.5"
"Pickens","2020-07-05","24","2357","0","72","3.2","2.5"
"Pickens","2020-07-06","88","2445","6","78","3.8","3"
"Pickens","2020-07-07","59","2504","4","82","4.8","3.5"
"Pickens","2020-07-08","64","2568","4","86","4.5","3.4"
"Pickens","2020-07-09","58","2626","5","91","5.4","4"
"Pickens","2020-07-10","63","2689","6","97","5.4","4.7"
"Pickens","2020-07-11","11","2700","1","98","6.7","5"
"Pickens","2020-07-12","15","2715","2","100","8.6","5.9"
"Pickens","2020-07-13","80","2795","11","111","9.6","6.7"
"Pickens","2020-07-14","60","2855","15","126","12.2","8.5"
"Pickens","2020-07-15","66","2921","12","138","13.9","9.2"
"Pickens","2020-07-16","54","2975","1","139","13","9.2"
"Pickens","2020-07-17","51","3026","9","148","14.1","9.8"
"Pickens","2020-07-18","24","3050","3","151","14.6","10.7"
"Pickens","2020-07-19","11","3061","0","151","12.7","10.7"
"Pickens","2020-07-20","51","3112","11","162","13.8","11.7"
"Pickens","2020-07-21","46","3158","6","168","12.1","12.2"
"Pickens","2020-07-22","47","3205","2","170","10.1","12"
"Pickens","2020-07-23","81","3286","3","173","10.4","11.7"
"Pickens","2020-07-24","56","3342","7","180","9.7","11.9"
"Pickens","2020-07-25","21","3363","2","182","9.2","11.9"
"Pickens","2020-07-26","15","3378","3","185","12.1","12.4"
"Pickens","2020-07-27","82","3460","20","205","12.5","13.2"
"Pickens","2020-07-28","57","3517","9","214","12.9","12.5"
"Pickens","2020-07-29","60","3577","6","220","13.7","11.9"
"Pickens","2020-07-30","73","3650","8","228","14.7","12.6"
"Pickens","2020-07-31","67","3717","9","237","14.9","12.3"
"Pickens","2020-08-01","21","3738","4","241","16.2","12.7"
"Pickens","2020-08-02","16","3754","3","244","16.1","14.1"
"Pickens","2020-08-03","72","3826","4","248","13.4","12.9"
"Pickens","2020-08-04","48","3874","5","253","12.6","12.7"
"Pickens","2020-08-05","48","3922","2","255","11.8","12.7"
"Pickens","2020-08-06","32","3954","0","255","10.2","12.5"
"Pickens","2020-08-07","47","4001","6","261","10.1","12.5"
"Pickens","2020-08-08","20","4021","4","265","10.2","13.2"
"Pickens","2020-08-09","77","4098","11","276","9.6","12.8"
"Pickens","2020-08-10","83","4181","7","283","10","11.7"
"Pickens","2020-08-11","47","4228","3","286","9.4","11"
"Pickens","2020-08-12","34","4262","3","289","10.1","10.9"
"Pickens","2020-08-13","46","4308","4","293","11.3","10.8"
"Pickens","2020-08-14","65","4373","4","297","10.4","10.2"
"Pickens","2020-08-15","23","4396","0","297","7.5","8.9"
"Pickens","2020-08-16","38","4434","1","298","5.9","7.7"
"Pickens","2020-08-17","52","4486","2","300","5.2","7.6"
"Pickens","2020-08-18","34","4520","2","302","5.1","7.3"
"Pickens","2020-08-19","53","4573","4","306","5","7.5"
"Pickens","2020-08-20","44","4617","8","314","6.3","8.8"
"Pickens","2020-08-21","53","4670","2","316","6","8.2"
"Pickens","2020-08-22","17","4687","2","318","7.7","7.6"
"Pickens","2020-08-23","29","4716","2","320","8.3","7.1"
"Pickens","2020-08-24","64","4780","4","324","8.6","6.9"
"Pickens","2020-08-25","46","4826","5","329","9.3","7.2"
"Pickens","2020-08-26","61","4887","3","332","9","7"
"Pickens","2020-08-27","55","4942","3","335","7.1","6.7"
"Pickens","2020-08-28","56","4998","6","341","8.1","7.1"
"Pickens","2020-08-29","21","5019","3","344","8.5","8.1"
"Pickens","2020-08-30","18","5037","0","344","7.5","7.9"
"Pickens","2020-08-31","52","5089","1","345","6.9","7.7"
"Pickens","2020-09-01","50","5139","2","347","5.9","7.6"
"Pickens","2020-09-02","48","5187","3","350","6.1","7.5"
"Pickens","2020-09-03","63","5250","3","353","6","6.6"
"Pickens","2020-09-04","76","5326","7","360","5.8","6.9"
"Pickens","2020-09-05","50","5376","4","364","4.9","6.7"
"Pickens","2020-09-06","33","5409","2","366","5.7","6.6"
"Pickens","2020-09-07","9","5418","2","368","8.6","7.8"
"Pickens","2020-09-08","77","5495","2","370","8.4","7.2"
"Pickens","2020-09-09","49","5544","5","375","9","7.5"
"Pickens","2020-09-10","44","5588","3","378","9.3","7.6"
"Pickens","2020-09-11","33","5621","4","382","9.7","7.7"
"Pickens","2020-09-12","18","5639","1","383","9.4","7.1"
"Pickens","2020-09-13","22","5661","6","389","12.4","9.1"
"Pickens","2020-09-14","44","5705","1","390","9.5","9.1"
"Pickens","2020-09-15","123","5828","3","393","9.5","9"
"Pickens","2020-09-16","52","5880","2","395","8.6","8.8"
"Pickens","2020-09-17","50","5930","6","401","9.4","9.3"
"Pickens","2020-09-18","44","5974","3","404","8.6","9.2"
"Pickens","2020-09-19","24","5998","0","404","7.8","8.6"
"Pickens","2020-09-20","14","6012","1","405","4.9","8.7"
"Pickens","2020-09-21","29","6041","1","406","5.1","7.3"
"Pickens","2020-09-22","45","6086","0","406","4.8","7.1"
"Pickens","2020-09-23","48","6134","3","409","5.1","6.9"
"Pickens","2020-09-24","49","6183","3","412","4.3","6.8"
"Pickens","2020-09-25","45","6228","0","412","3.3","5.9"
"Pickens","2020-09-26","29","6257","0","412","3.3","5.5"
"Pickens","2020-09-27","12","6269","2","414","4.6","4.8"
"Pickens","2020-09-28","50","6319","1","415","4.4","4.8"
"Pickens","2020-09-29","57","6376","4","419","5.4","5.1"
"Pickens","2020-09-30","46","6422","0","419","4.5","4.8"
"Pickens","2020-10-01","61","6483","2","421","4.1","4.2"
"Pickens","2020-10-02","68","6551","2","423","4.6","3.9"
"Pickens","2020-10-03","48","6599","2","425","5.2","4.2"
"Pickens","2020-10-04","18","6617","2","427","4.4","4.5"
"Pickens","2020-10-05","57","6674","1","428","4.3","4.4"
"Pickens","2020-10-06","99","6773","3","431","3.8","4.6"
"Pickens","2020-10-07","98","6871","3","434","4.2","4.4"
"Pickens","2020-10-08","43","6914","2","436","4.4","4.3"
"Pickens","2020-10-09","80","6994","7","443","5.2","4.9"
"Pickens","2020-10-10","34","7028","3","446","5.9","5.5"
"Pickens","2020-10-11","9","7037","1","447","5.9","5.1"
"Pickens","2020-10-12","50","7087","3","450","6.5","5.4"
"Pickens","2020-10-13","50","7137","3","453","6.9","5.3"
"Pickens","2020-10-14","93","7230","5","458","7.2","5.7"
"Pickens","2020-10-15","49","7279","2","460","7.2","5.8"
"Pickens","2020-10-16","60","7339","1","461","6.2","5.7"
"Pickens","2020-10-17","26","7365","4","465","7.1","6.5"
"Pickens","2020-10-18","27","7392","8","473","9.7","7.8"
"Pickens","2020-10-19","48","7440","8","481","11.3","8.9"
"Pickens","2020-10-20","57","7497","3","484","11.2","9"
"Pickens","2020-10-21","83","7580","3","487","10.9","9.1"
"Pickens","2020-10-22","45","7625","6","493","12.2","9.7"
"Pickens","2020-10-23","68","7693","6","499","13.2","9.7"
"Pickens","2020-10-24","31","7724","3","502","12.4","9.8"
"Pickens","2020-10-25","15","7739","0","502","8.2","9"
"Pickens","2020-10-26","75","7814","9","511","7.5","9.4"
"Pickens","2020-10-27","102","7916","8","519","7.9","9.5"
"Pickens","2020-10-28","60","7976","3","522","8.1","9.5"
"Pickens","2020-10-29","60","8036","3","525","6.9","9.6"
"Pickens","2020-10-30","66","8102","6","531","6.9","10.1"
"Pickens","2020-10-31","18","8120","3","534","7.9","10.2"
"Pickens","2020-11-01","18","8138","3","537","10.3","9.3"
"Pickens","2020-11-02","51","8189","4","541","9.7","8.6"
"Pickens","2020-11-03","63","8252","6","547","10","8.9"
"Pickens","2020-11-04","43","8295","9","556","12.2","10.2"
"Pickens","2020-11-05","66","8361","2","558","12","9.4"
"Pickens","2020-11-06","89","8450","5","563","11.5","9.2"
"Pickens","2020-11-07","27","8477","4","567","11.2","9.6"
"Pickens","2020-11-08","20","8497","4","571","11.7","11"
"Pickens","2020-11-09","57","8554","6","577","12.1","10.9"
"Pickens","2020-11-10","46","8600","1","578","11","10.5"
"Pickens","2020-11-11","40","8640","3","581","9.1","10.7"
"Pickens","2020-11-12","86","8726","12","593","10.7","11.3"
"Pickens","2020-11-13","54","8780","6","599","11.4","11.5"
"Pickens","2020-11-14","60","8840","3","602","10","10.6"
"Pickens","2020-11-15","33","8873","2","604","8","9.9"
"Pickens","2020-11-16","61","8934","5","609","7.7","9.9"
"Pickens","2020-11-17","44","8978","8","617","10","10.5"
"Pickens","2020-11-18","62","9040","7","624","10.5","9.8"
"Pickens","2020-11-19","70","9110","6","630","9.8","10.2"
"Pickens","2020-11-20","79","9189","6","636","9.3","10.4"
"Pickens","2020-11-21","42","9231","2","638","9.2","9.6"
"Pickens","2020-11-22","24","9255","0","638","8.4","8.2"
"Pickens","2020-11-23","54","9309","11","649","10.1","8.9"
"Pickens","2020-11-24","64","9373","7","656","9.1","9.5"
"Pickens","2020-11-25","51","9424","8","664","9.7","10.1"
"Pickens","2020-11-26","17","9441","3","667","11","10.4"
"Pickens","2020-11-27","74","9515","14","681","12.6","10.9"
"Pickens","2020-11-28","39","9554","9","690","15.2","12.2"
"Pickens","2020-11-29","27","9581","3","693","16.8","12.6"
"Pickens","2020-11-30","99","9680","21","714","16.9","13.5"
"Pickens","2020-12-01","76","9756","11","725","17.4","13.3"
"Pickens","2020-12-02","53","9809","7","732","17.1","13.4"
"Pickens","2020-12-03","62","9871","10","742","16.9","13.9"
"Pickens","2020-12-04","79","9950","14","756","16.7","14.7"
"Pickens","2020-12-05","38","9988","6","762","15.7","15.4"
"Pickens","2020-12-06","37","10025","9","771","17.6","17.2"
"Pickens","2020-12-07","99","10124","26","797","18.3","17.6"
"Pickens","2020-12-08","113","10237","16","813","18.2","17.8"
"Pickens","2020-12-09","68","10305","8","821","18","17.6"
"Pickens","2020-12-10","135","10440","13","834","17.1","17"
"Pickens","2020-12-11","76","10516","8","842","16.1","16.4"
"Pickens","2020-12-12","26","10542","4","846","16","15.8"
"Pickens","2020-12-13","37","10579","15","861","18.3","17.9"
"Pickens","2020-12-14","70","10649","17","878","18","18.2"
"Pickens","2020-12-15","150","10799","14","892","17.4","17.8"
"Pickens","2020-12-16","71","10870","14","906","18.5","18.3"
"Pickens","2020-12-17","87","10957","19","925","20.2","18.7"
"Pickens","2020-12-18","86","11043","9","934","20.2","18.1"
"Pickens","2020-12-19","43","11086","8","942","20.7","18.3"
"Pickens","2020-12-20","45","11131","15","957","19.7","19"
"Pickens","2020-12-21","91","11222","18","975","19","18.5"
"Pickens","2020-12-22","144","11366","23","998","20","18.7"
"Pickens","2020-12-23","92","11458","19","1017","20.1","19.3"
"Pickens","2020-12-24","95","11553","13","1030","18.9","19.6"
"Pickens","2020-12-25","14","11567","3","1033","20.5","20.4"
"Pickens","2020-12-26","61","11628","21","1054","22.8","21.7"
"Pickens","2020-12-27","42","11670","18","1072","24.1","21.9"
"Pickens","2020-12-28","94","11764","30","1102","25.8","22.4"
"Pickens","2020-12-29","177","11941","39","1141","26.7","23.3"
"Pickens","2020-12-30","96","12037","32","1173","28.5","24.3"
"Pickens","2020-12-31","81","12118","17","1190","29.6","24.2"
"Pickens","2021-01-01","30","12148","10","1200","31.3","25.9"
"Pickens","2021-01-02","36","12184","14","1214","31.9","27.3"
"Pickens","2021-01-03","38","12222","16","1230","31.8","28"
"Pickens","2021-01-04","63","12285","16","1246","30.9","28.4"
"Pickens","2021-01-05","96","12381","26","1272","31.6","29.2"
"Pickens","2021-01-06","124","12505","42","1314","31.7","30.1"
"Pickens","2021-01-07","136","12641","31","1345","31.9","30.7"
"Pickens","2021-01-08","147","12788","25","1370","29.6","30.4"
"Pickens","2021-01-09","22","12810","5","1375","27.3","29.6"
"Pickens","2021-01-10","32","12842","15","1390","28","29.9"
"Pickens","2021-01-11","132","12974","13","1403","25.7","28.3"
"Pickens","2021-01-12","74","13048","20","1423","25.7","28.7"
"Pickens","2021-01-13","88","13136","17","1440","23.7","27.7"
"Pickens","2021-01-14","92","13228","18","1458","23.2","27.6"
"Pickens","2021-01-15","97","13325","13","1471","22.7","26.1"
"Pickens","2021-01-16","43","13368","10","1481","22.8","25"
"Pickens","2021-01-17","24","13392","6","1487","19.6","23.8"
"Pickens","2021-01-18","146","13538","18","1505","20","22.9"
"Pickens","2021-01-19","76","13614","14","1519","18.8","22.2"
"Pickens","2021-01-20","84","13698","11","1530","17.9","20.8"
"Pickens","2021-01-21","104","13802","26","1556","18.6","20.9"
"Pickens","2021-01-22","107","13909","17","1573","19","20.8"
"Pickens","2021-01-23","54","13963","9","1582","18.1","20.4"
"Pickens","2021-01-24","22","13985","4","1586","17.1","18.4"
"Pickens","2021-01-25","108","14093","7","1593","16.2","18.1"
"Pickens","2021-01-26","5","14098","0","1593","13.6","16.2"
"Pickens","2021-01-27","0","14098","0","1593","11.7","14.8"
"Pierce","2020-02-01","0","0","0","0",".","."
"Pierce","2020-02-02","0","0","0","0",".","."
"Pierce","2020-02-03","0","0","0","0",".","."
"Pierce","2020-02-04","0","0","0","0",".","."
"Pierce","2020-02-05","0","0","0","0",".","."
"Pierce","2020-02-06","0","0","0","0",".","."
"Pierce","2020-02-07","0","0","0","0","0","."
"Pierce","2020-02-08","0","0","0","0","0","."
"Pierce","2020-02-09","0","0","0","0","0","."
"Pierce","2020-02-10","0","0","0","0","0","."
"Pierce","2020-02-11","0","0","0","0","0","."
"Pierce","2020-02-12","0","0","0","0","0","."
"Pierce","2020-02-13","0","0","0","0","0","."
"Pierce","2020-02-14","0","0","0","0","0","0"
"Pierce","2020-02-15","0","0","0","0","0","0"
"Pierce","2020-02-16","0","0","0","0","0","0"
"Pierce","2020-02-17","0","0","0","0","0","0"
"Pierce","2020-02-18","0","0","0","0","0","0"
"Pierce","2020-02-19","0","0","0","0","0","0"
"Pierce","2020-02-20","0","0","0","0","0","0"
"Pierce","2020-02-21","0","0","0","0","0","0"
"Pierce","2020-02-22","0","0","0","0","0","0"
"Pierce","2020-02-23","0","0","0","0","0","0"
"Pierce","2020-02-24","0","0","0","0","0","0"
"Pierce","2020-02-25","0","0","0","0","0","0"
"Pierce","2020-02-26","0","0","0","0","0","0"
"Pierce","2020-02-27","0","0","0","0","0","0"
"Pierce","2020-02-28","0","0","0","0","0","0"
"Pierce","2020-02-29","0","0","0","0","0","0"
"Pierce","2020-03-01","0","0","0","0","0","0"
"Pierce","2020-03-02","0","0","0","0","0","0"
"Pierce","2020-03-03","0","0","0","0","0","0"
"Pierce","2020-03-04","0","0","0","0","0","0"
"Pierce","2020-03-05","0","0","0","0","0","0"
"Pierce","2020-03-06","0","0","0","0","0","0"
"Pierce","2020-03-07","0","0","0","0","0","0"
"Pierce","2020-03-08","0","0","0","0","0","0"
"Pierce","2020-03-09","0","0","0","0","0","0"
"Pierce","2020-03-10","0","0","0","0","0","0"
"Pierce","2020-03-11","0","0","0","0","0","0"
"Pierce","2020-03-12","0","0","0","0","0","0"
"Pierce","2020-03-13","0","0","0","0","0","0"
"Pierce","2020-03-14","0","0","0","0","0","0"
"Pierce","2020-03-15","0","0","0","0","0","0"
"Pierce","2020-03-16","7","7","0","0","0","0"
"Pierce","2020-03-17","13","20","0","0","0","0"
"Pierce","2020-03-18","2","22","1","1","7.1","3.6"
"Pierce","2020-03-19","4","26","0","1","7.1","3.6"
"Pierce","2020-03-20","2","28","0","1","7.1","3.6"
"Pierce","2020-03-21","2","30","0","1","7.1","3.6"
"Pierce","2020-03-22","3","33","1","2","11.9","6"
"Pierce","2020-03-23","7","40","1","3","13.9","7"
"Pierce","2020-03-24","5","45","2","5","19.7","9.8"
"Pierce","2020-03-25","6","51","2","7","17.3","12.2"
"Pierce","2020-03-26","10","61","4","11","23","15.1"
"Pierce","2020-03-27","8","69","3","14","28.4","17.7"
"Pierce","2020-03-28","0","69","0","14","28.4","17.7"
"Pierce","2020-03-29","0","69","0","14","23.6","17.7"
"Pierce","2020-03-30","6","75","1","15","23.9","18.9"
"Pierce","2020-03-31","4","79","2","17","25.4","22.5"
"Pierce","2020-04-01","8","87","1","18","22.4","19.8"
"Pierce","2020-04-02","6","93","3","21","23.8","23.4"
"Pierce","2020-04-03","6","99","0","21","18.5","23.4"
"Pierce","2020-04-04","3","102","2","23","28","28.2"
"Pierce","2020-04-05","0","102","0","23","28","25.8"
"Pierce","2020-04-06","12","114","3","26","29.2","26.5"
"Pierce","2020-04-07","7","121","0","26","22","23.7"
"Pierce","2020-04-08","7","128","1","27","22.3","22.3"
"Pierce","2020-04-09","3","131","2","29","24.7","24.2"
"Pierce","2020-04-10","4","135","0","29","24.7","21.6"
"Pierce","2020-04-11","4","139","1","30","18.7","23.3"
"Pierce","2020-04-12","0","139","0","30","18.7","23.3"
"Pierce","2020-04-13","5","144","0","30","15.1","22.2"
"Pierce","2020-04-14","7","151","0","30","15.1","18.6"
"Pierce","2020-04-15","8","159","0","30","13.1","17.7"
"Pierce","2020-04-16","7","166","0","30","3.6","14.1"
"Pierce","2020-04-17","15","181","2","32","5.5","15.1"
"Pierce","2020-04-18","0","181","0","32","1.9","10.3"
"Pierce","2020-04-19","5","186","0","32","1.9","10.3"
"Pierce","2020-04-20","7","193","0","32","1.9","8.5"
"Pierce","2020-04-21","1","194","0","32","1.9","8.5"
"Pierce","2020-04-22","12","206","0","32","1.9","7.5"
"Pierce","2020-04-23","2","208","0","32","1.9","2.7"
"Pierce","2020-04-24","4","212","0","32","0","2.7"
"Pierce","2020-04-25","0","212","0","32","0","1"
"Pierce","2020-04-26","0","212","0","32","0","1"
"Pierce","2020-04-27","4","216","0","32","0","1"
"Pierce","2020-04-28","11","227","0","32","0","1"
"Pierce","2020-04-29","15","242","1","33","1","1.4"
"Pierce","2020-04-30","7","249","1","34","3","2.4"
"Pierce","2020-05-01","4","253","0","34","3","1.5"
"Pierce","2020-05-02","1","254","0","34","3","1.5"
"Pierce","2020-05-03","0","254","0","34","3","1.5"
"Pierce","2020-05-04","10","264","0","34","3","1.5"
"Pierce","2020-05-05","9","273","0","34","3","1.5"
"Pierce","2020-05-06","7","280","0","34","2","1.5"
"Pierce","2020-05-07","8","288","1","35","1.8","2.4"
"Pierce","2020-05-08","1","289","0","35","1.8","2.4"
"Pierce","2020-05-09","3","292","1","36","6.5","4.8"
"Pierce","2020-05-10","0","292","0","36","6.5","4.8"
"Pierce","2020-05-11","14","306","0","36","6.5","4.8"
"Pierce","2020-05-12","11","317","3","39","10.4","6.7"
"Pierce","2020-05-13","15","332","0","39","10.4","6.2"
"Pierce","2020-05-14","10","342","3","42","12.9","7.4"
"Pierce","2020-05-15","7","349","0","42","12.9","7.4"
"Pierce","2020-05-16","4","353","2","44","15.3","10.9"
"Pierce","2020-05-17","1","354","0","44","15.3","10.9"
"Pierce","2020-05-18","18","372","1","45","16.1","11.3"
"Pierce","2020-05-19","14","386","4","49","16.3","13.4"
"Pierce","2020-05-20","21","407","2","51","17.7","14.1"
"Pierce","2020-05-21","21","428","3","54","15.4","14.2"
"Pierce","2020-05-22","5","433","0","54","15.4","14.2"
"Pierce","2020-05-23","2","435","0","54","8.3","11.8"
"Pierce","2020-05-24","0","435","0","54","8.3","11.8"
"Pierce","2020-05-25","2","437","1","55","14.6","15.4"
"Pierce","2020-05-26","26","463","4","59","12.7","14.5"
"Pierce","2020-05-27","20","483","0","59","11.4","14.5"
"Pierce","2020-05-28","30","513","2","61","10.3","12.9"
"Pierce","2020-05-29","7","520","2","63","14.4","14.9"
"Pierce","2020-05-30","2","522","0","63","14.4","11.3"
"Pierce","2020-05-31","1","523","0","63","14.4","11.3"
"Pierce","2020-06-01","19","542","3","66","9.5","12.1"
"Pierce","2020-06-02","10","552","3","69","11.6","12.2"
"Pierce","2020-06-03","22","574","5","74","14.8","13.1"
"Pierce","2020-06-04","36","610","1","75","14.3","12.3"
"Pierce","2020-06-05","16","626","0","75","10.2","12.3"
"Pierce","2020-06-06","0","626","0","75","10.2","12.3"
"Pierce","2020-06-07","3","629","0","75","10.2","12.3"
"Pierce","2020-06-08","28","657","1","76","8.4","9"
"Pierce","2020-06-09","25","682","0","76","4.2","7.9"
"Pierce","2020-06-10","23","705","2","78","2.1","8.5"
"Pierce","2020-06-11","44","749","0","78","1.8","8"
"Pierce","2020-06-12","21","770","1","79","2.4","6.3"
"Pierce","2020-06-13","4","774","0","79","2.4","6.3"
"Pierce","2020-06-14","1","775","0","79","2.4","6.3"
"Pierce","2020-06-15","34","809","3","82","3.2","5.8"
"Pierce","2020-06-16","31","840","3","85","4.6","4.4"
"Pierce","2020-06-17","35","875","2","87","4.1","3.1"
"Pierce","2020-06-18","40","915","0","87","4.1","2.9"
"Pierce","2020-06-19","18","933","4","91","6.6","4.5"
"Pierce","2020-06-20","3","936","1","92","11.4","6.9"
"Pierce","2020-06-21","2","938","1","93","18.5","10.5"
"Pierce","2020-06-22","35","973","6","99","19.7","11.5"
"Pierce","2020-06-23","47","1020","7","106","20.5","12.5"
"Pierce","2020-06-24","20","1040","3","109","21.8","13"
"Pierce","2020-06-25","74","1114","5","114","22.8","13.5"
"Pierce","2020-06-26","54","1168","5","119","20.9","13.8"
"Pierce","2020-06-27","13","1181","3","122","19.4","15.4"
"Pierce","2020-06-28","9","1190","1","123","13.9","16.2"
"Pierce","2020-06-29","39","1229","5","128","13.3","16.5"
"Pierce","2020-06-30","59","1288","13","141","14.3","17.4"
"Pierce","2020-07-01","31","1319","7","148","15.4","18.6"
"Pierce","2020-07-02","58","1377","4","152","15.4","19.1"
"Pierce","2020-07-03","34","1411","4","156","15.8","18.3"
"Pierce","2020-07-04","8","1419","3","159","17.8","18.6"
"Pierce","2020-07-05","6","1425","3","162","23.4","18.6"
"Pierce","2020-07-06","30","1455","5","167","23.9","18.6"
"Pierce","2020-07-07","51","1506","10","177","23.6","18.9"
"Pierce","2020-07-08","29","1535","7","184","23.8","19.6"
"Pierce","2020-07-09","81","1616","12","196","24.9","20.2"
"Pierce","2020-07-10","11","1627","2","198","25.8","20.8"
"Pierce","2020-07-11","5","1632","2","200","26.2","22"
"Pierce","2020-07-12","5","1637","1","201","21.9","22.6"
"Pierce","2020-07-13","32","1669","7","208","22.7","23.3"
"Pierce","2020-07-14","14","1683","2","210","21.9","22.7"
"Pierce","2020-07-15","30","1713","1","211","18.9","21.4"
"Pierce","2020-07-16","39","1752","2","213","17.5","21.2"
"Pierce","2020-07-17","28","1780","1","214","15.5","20.7"
"Pierce","2020-07-18","7","1787","2","216","13.8","20"
"Pierce","2020-07-19","1","1788","0","216","11","16.4"
"Pierce","2020-07-20","29","1817","4","220","9.8","16.2"
"Pierce","2020-07-21","16","1833","5","225","12.2","17.1"
"Pierce","2020-07-22","40","1873","1","226","12.1","15.5"
"Pierce","2020-07-23","14","1887","2","228","13.4","15.5"
"Pierce","2020-07-24","17","1904","2","230","14.6","15"
"Pierce","2020-07-25","5","1909","1","231","13.4","13.6"
"Pierce","2020-07-26","6","1915","0","231","13.4","12.2"
"Pierce","2020-07-27","46","1961","4","235","12.6","11.2"
"Pierce","2020-07-28","40","2001","4","239","9.6","10.9"
"Pierce","2020-07-29","26","2027","2","241","10.3","11.2"
"Pierce","2020-07-30","28","2055","3","244","9.8","11.6"
"Pierce","2020-07-31","4","2059","0","244","8.2","11.4"
"Pierce","2020-08-01","17","2076","1","245","6.1","9.8"
"Pierce","2020-08-02","10","2086","1","246","7.6","10.5"
"Pierce","2020-08-03","43","2129","1","247","6.7","9.7"
"Pierce","2020-08-04","32","2161","3","250","6.6","8.1"
"Pierce","2020-08-05","28","2189","3","253","7","8.7"
"Pierce","2020-08-06","20","2209","2","255","6.9","8.4"
"Pierce","2020-08-07","9","2218","0","255","6.9","7.5"
"Pierce","2020-08-08","7","2225","0","255","6.1","6.1"
"Pierce","2020-08-09","5","2230","1","256","7.5","7.5"
"Pierce","2020-08-10","50","2280","2","258","7.7","7.2"
"Pierce","2020-08-11","42","2322","7","265","8.8","7.7"
"Pierce","2020-08-12","41","2363","4","269","8.6","7.8"
"Pierce","2020-08-13","27","2390","1","270","7.7","7.3"
"Pierce","2020-08-14","50","2440","27","297","15.4","11.2"
"Pierce","2020-08-15","10","2450","2","299","18.3","12.2"
"Pierce","2020-08-16","1","2451","0","299","15.4","11.5"
"Pierce","2020-08-17","39","2490","2","301","15.6","11.7"
"Pierce","2020-08-18","35","2525","5","306","15.3","12"
"Pierce","2020-08-19","39","2564","7","313","16.4","12.5"
"Pierce","2020-08-20","13","2577","3","316","19.2","13.5"
"Pierce","2020-08-21","14","2591","3","319","14.6","15"
"Pierce","2020-08-22","5","2596","2","321","17.4","17.9"
"Pierce","2020-08-23","3","2599","0","321","17.4","16.4"
"Pierce","2020-08-24","36","2635","3","324","17.9","16.7"
"Pierce","2020-08-25","36","2671","0","324","15.8","15.5"
"Pierce","2020-08-26","26","2697","3","327","14.9","15.7"
"Pierce","2020-08-27","16","2713","2","329","13.4","16.3"
"Pierce","2020-08-28","10","2723","0","329","10.3","12.4"
"Pierce","2020-08-29","5","2728","1","330","7.5","12.4"
"Pierce","2020-08-30","14","2742","1","331","8.5","13"
"Pierce","2020-08-31","45","2787","6","337","9.2","13.5"
"Pierce","2020-09-01","41","2828","2","339","9.9","12.9"
"Pierce","2020-09-02","41","2869","0","339","8.3","11.6"
"Pierce","2020-09-03","16","2885","0","339","6.5","9.9"
"Pierce","2020-09-04","15","2900","2","341","8.4","9.4"
"Pierce","2020-09-05","7","2907","0","341","5.5","6.5"
"Pierce","2020-09-06","12","2919","3","344","8.1","8.3"
"Pierce","2020-09-07","28","2947","2","346","7.2","8.2"
"Pierce","2020-09-08","67","3014","4","350","7.3","8.6"
"Pierce","2020-09-09","34","3048","5","355","9.5","8.9"
"Pierce","2020-09-10","29","3077","4","359","11.4","8.9"
"Pierce","2020-09-11","23","3100","3","362","11.4","9.9"
"Pierce","2020-09-12","6","3106","1","363","13.8","9.6"
"Pierce","2020-09-13","10","3116","1","364","11.6","9.8"
"Pierce","2020-09-14","44","3160","1","365","10.9","9.1"
"Pierce","2020-09-15","47","3207","2","367","10.7","9"
"Pierce","2020-09-16","47","3254","2","369","9.2","9.3"
"Pierce","2020-09-17","27","3281","2","371","8.3","9.8"
"Pierce","2020-09-18","18","3299","0","371","6.4","8.9"
"Pierce","2020-09-19","5","3304","0","371","4","8.9"
"Pierce","2020-09-20","2","3306","0","371","2.6","7.1"
"Pierce","2020-09-21","47","3353","1","372","2.6","6.7"
"Pierce","2020-09-22","43","3396","2","374","2.6","6.7"
"Pierce","2020-09-23","31","3427","1","375","2.5","5.8"
"Pierce","2020-09-24","15","3442","1","376","2.4","5.3"
"Pierce","2020-09-25","15","3457","0","376","2.4","4.4"
"Pierce","2020-09-26","7","3464","0","376","2.4","3.2"
"Pierce","2020-09-27","8","3472","1","377","4.2","3.4"
"Pierce","2020-09-28","46","3518","3","380","4.8","3.7"
"Pierce","2020-09-29","53","3571","1","381","4.4","3.5"
"Pierce","2020-09-30","24","3595","0","381","3.9","3.2"
"Pierce","2020-10-01","13","3608","0","381","3","2.7"
"Pierce","2020-10-02","19","3627","0","381","3","2.7"
"Pierce","2020-10-03","5","3632","0","381","3","2.7"
"Pierce","2020-10-04","9","3641","0","381","1.2","2.7"
"Pierce","2020-10-05","54","3695","0","381","0.3","2.5"
"Pierce","2020-10-06","47","3742","0","381","0","2.2"
"Pierce","2020-10-07","37","3779","3","384","1.2","2.5"
"Pierce","2020-10-08","48","3827","0","384","1.2","2.1"
"Pierce","2020-10-09","25","3852","0","384","1.2","2.1"
"Pierce","2020-10-10","8","3860","0","384","1.2","2.1"
"Pierce","2020-10-11","2","3862","0","384","1.2","1.2"
"Pierce","2020-10-12","49","3911","1","385","1.4","0.9"
"Pierce","2020-10-13","44","3955","2","387","2.1","1"
"Pierce","2020-10-14","21","3976","1","388","1.6","1.4"
"Pierce","2020-10-15","19","3995","1","389","2.4","1.8"
"Pierce","2020-10-16","39","4034","4","393","3.8","2.5"
"Pierce","2020-10-17","9","4043","1","394","5.4","3.3"
"Pierce","2020-10-18","33","4076","3","397","6.7","3.9"
"Pierce","2020-10-19","67","4143","3","400","7.1","4.3"
"Pierce","2020-10-20","50","4193","2","402","7","4.5"
"Pierce","2020-10-21","26","4219","3","405","8","4.8"
"Pierce","2020-10-22","18","4237","5","410","11.2","6.8"
"Pierce","2020-10-23","46","4283","1","411","10","6.9"
"Pierce","2020-10-24","28","4311","0","411","8.4","6.9"
"Pierce","2020-10-25","10","4321","3","414","11.4","9.1"
"Pierce","2020-10-26","73","4394","2","416","11.2","9.1"
"Pierce","2020-10-27","29","4423","2","418","11.6","9.3"
"Pierce","2020-10-28","33","4456","2","420","10.8","9.4"
"Pierce","2020-10-29","44","4500","5","425","8.5","9.8"
"Pierce","2020-10-30","40","4540","4","429","9.6","9.8"
"Pierce","2020-10-31","43","4583","0","429","9.6","9"
"Pierce","2020-11-01","7","4590","1","430","7.3","9.4"
"Pierce","2020-11-02","53","4643","1","431","7.2","9.2"
"Pierce","2020-11-03","44","4687","3","434","7.2","9.4"
"Pierce","2020-11-04","37","4724","3","437","7.5","9.2"
"Pierce","2020-11-05","31","4755","4","441","7.7","8.1"
"Pierce","2020-11-06","19","4774","1","442","7","8.3"
"Pierce","2020-11-07","38","4812","2","444","7.8","8.7"
"Pierce","2020-11-08","4","4816","0","444","5.7","6.5"
"Pierce","2020-11-09","58","4874","0","444","5.5","6.3"
"Pierce","2020-11-10","28","4902","0","444","4.5","5.9"
"Pierce","2020-11-11","37","4939","2","446","4.1","5.8"
"Pierce","2020-11-12","28","4967","2","448","3.3","5.5"
"Pierce","2020-11-13","17","4984","1","449","3.4","5.2"
"Pierce","2020-11-14","8","4992","0","449","2.6","5.2"
"Pierce","2020-11-15","4","4996","0","449","2.6","4.2"
"Pierce","2020-11-16","55","5051","1","450","2.9","4.2"
"Pierce","2020-11-17","87","5138","1","451","3.1","3.8"
"Pierce","2020-11-18","26","5164","2","453","3.4","3.8"
"Pierce","2020-11-19","17","5181","0","453","2.4","2.8"
"Pierce","2020-11-20","13","5194","0","453","1.5","2.5"
"Pierce","2020-11-21","9","5203","0","453","1.5","2.1"
"Pierce","2020-11-22","55","5258","0","453","1.5","2.1"
"Pierce","2020-11-23","64","5322","4","457","2.2","2.5"
"Pierce","2020-11-24","35","5357","1","458","2.4","2.7"
"Pierce","2020-11-25","48","5405","1","459","1.6","2.5"
"Pierce","2020-11-26","14","5419","0","459","1.6","2"
"Pierce","2020-11-27","13","5432","2","461","3.8","2.7"
"Pierce","2020-11-28","9","5441","1","462","5.4","3.5"
"Pierce","2020-11-29","28","5469","1","463","5.9","3.7"
"Pierce","2020-11-30","56","5525","1","464","5.3","3.7"
"Pierce","2020-12-01","54","5579","4","468","5.9","4.2"
"Pierce","2020-12-02","19","5598","3","471","7.9","4.7"
"Pierce","2020-12-03","18","5616","1","472","8.7","5.1"
"Pierce","2020-12-04","11","5627","0","472","6.5","5.1"
"Pierce","2020-12-05","9","5636","1","473","6.5","5.9"
"Pierce","2020-12-06","7","5643","4","477","14.1","10"
"Pierce","2020-12-07","65","5708","4","481","14.7","10"
"Pierce","2020-12-08","49","5757","2","483","14.3","10.1"
"Pierce","2020-12-09","37","5794","6","489","14.3","11.1"
"Pierce","2020-12-10","30","5824","3","492","15","11.8"
"Pierce","2020-12-11","29","5853","3","495","16.4","11.4"
"Pierce","2020-12-12","7","5860","0","495","14.8","10.7"
"Pierce","2020-12-13","10","5870","1","496","8.1","11.1"
"Pierce","2020-12-14","67","5937","4","500","8.1","11.4"
"Pierce","2020-12-15","47","5984","6","506","9.3","11.8"
"Pierce","2020-12-16","36","6020","4","510","8.6","11.5"
"Pierce","2020-12-17","29","6049","3","513","8.6","11.8"
"Pierce","2020-12-18","19","6068","4","517","10.2","13.3"
"Pierce","2020-12-19","67","6135","5","522","11.2","13"
"Pierce","2020-12-20","13","6148","2","524","12","10.1"
"Pierce","2020-12-21","76","6224","10","534","13","10.6"
"Pierce","2020-12-22","45","6269","3","537","12.2","10.7"
"Pierce","2020-12-23","41","6310","8","545","13.4","11"
"Pierce","2020-12-24","24","6334","4","549","14.3","11.5"
"Pierce","2020-12-25","7","6341","5","554","21.5","15.8"
"Pierce","2020-12-26","64","6405","5","559","21.5","16.4"
"Pierce","2020-12-27","18","6423","2","561","20.9","16.5"
"Pierce","2020-12-28","79","6502","10","571","20.8","16.9"
"Pierce","2020-12-29","57","6559","9","580","22.1","17.2"
"Pierce","2020-12-30","38","6597","4","584","20.9","17.1"
"Pierce","2020-12-31","16","6613","3","587","21.2","17.7"
"Pierce","2021-01-01","10","6623","6","593","19.5","20.5"
"Pierce","2021-01-02","18","6641","6","599","23.2","22.3"
"Pierce","2021-01-03","63","6704","4","603","22.5","21.7"
"Pierce","2021-01-04","89","6793","10","613","22.3","21.6"
"Pierce","2021-01-05","72","6865","17","630","23.4","22.8"
"Pierce","2021-01-06","24","6889","5","635","24.9","22.9"
"Pierce","2021-01-07","73","6962","7","642","23.6","22.4"
"Pierce","2021-01-08","64","7026","13","655","17.9","18.7"
"Pierce","2021-01-09","50","7076","3","658","14","18.6"
"Pierce","2021-01-10","12","7088","6","664","20.2","21.4"
"Pierce","2021-01-11","80","7168","11","675","20.6","21.4"
"Pierce","2021-01-12","56","7224","10","685","19.8","21.6"
"Pierce","2021-01-13","39","7263","5","690","18.6","21.7"
"Pierce","2021-01-14","74","7337","8","698","18.8","21.2"
"Pierce","2021-01-15","85","7422","6","704","16.9","17.4"
"Pierce","2021-01-16","12","7434","1","705","17.2","15.6"
"Pierce","2021-01-17","7","7441","2","707","14.2","17.2"
"Pierce","2021-01-18","75","7516","11","718","14.3","17.4"
"Pierce","2021-01-19","48","7564","7","725","13.8","16.8"
"Pierce","2021-01-20","48","7612","7","732","14.1","16.4"
"Pierce","2021-01-21","89","7701","10","742","14.1","16.5"
"Pierce","2021-01-22","55","7756","3","745","13.9","15.4"
"Pierce","2021-01-23","40","7796","5","750","14.5","15.9"
"Pierce","2021-01-24","8","7804","0","750","10.4","12.3"
"Pierce","2021-01-25","51","7855","5","755","9.7","12"
"Pierce","2021-01-26","2","7857","0","755","7.7","10.7"
"Pierce","2021-01-27","0","7857","0","755","5.6","9.8"
"Pike","2020-02-01","0","0","0","0",".","."
"Pike","2020-02-02","0","0","0","0",".","."
"Pike","2020-02-03","0","0","0","0",".","."
"Pike","2020-02-04","0","0","0","0",".","."
"Pike","2020-02-05","0","0","0","0",".","."
"Pike","2020-02-06","0","0","0","0",".","."
"Pike","2020-02-07","0","0","0","0","0","."
"Pike","2020-02-08","0","0","0","0","0","."
"Pike","2020-02-09","0","0","0","0","0","."
"Pike","2020-02-10","0","0","0","0","0","."
"Pike","2020-02-11","0","0","0","0","0","."
"Pike","2020-02-12","0","0","0","0","0","."
"Pike","2020-02-13","0","0","0","0","0","."
"Pike","2020-02-14","0","0","0","0","0","0"
"Pike","2020-02-15","0","0","0","0","0","0"
"Pike","2020-02-16","0","0","0","0","0","0"
"Pike","2020-02-17","0","0","0","0","0","0"
"Pike","2020-02-18","0","0","0","0","0","0"
"Pike","2020-02-19","0","0","0","0","0","0"
"Pike","2020-02-20","0","0","0","0","0","0"
"Pike","2020-02-21","0","0","0","0","0","0"
"Pike","2020-02-22","0","0","0","0","0","0"
"Pike","2020-02-23","0","0","0","0","0","0"
"Pike","2020-02-24","0","0","0","0","0","0"
"Pike","2020-02-25","0","0","0","0","0","0"
"Pike","2020-02-26","0","0","0","0","0","0"
"Pike","2020-02-27","0","0","0","0","0","0"
"Pike","2020-02-28","0","0","0","0","0","0"
"Pike","2020-02-29","0","0","0","0","0","0"
"Pike","2020-03-01","0","0","0","0","0","0"
"Pike","2020-03-02","0","0","0","0","0","0"
"Pike","2020-03-03","0","0","0","0","0","0"
"Pike","2020-03-04","0","0","0","0","0","0"
"Pike","2020-03-05","0","0","0","0","0","0"
"Pike","2020-03-06","0","0","0","0","0","0"
"Pike","2020-03-07","0","0","0","0","0","0"
"Pike","2020-03-08","0","0","0","0","0","0"
"Pike","2020-03-09","0","0","0","0","0","0"
"Pike","2020-03-10","1","1","0","0","0","0"
"Pike","2020-03-11","0","1","0","0","0","0"
"Pike","2020-03-12","0","1","0","0","0","0"
"Pike","2020-03-13","1","2","0","0","0","0"
"Pike","2020-03-14","0","2","0","0","0","0"
"Pike","2020-03-15","0","2","0","0","0","0"
"Pike","2020-03-16","4","6","0","0","0","0"
"Pike","2020-03-17","0","6","0","0","0","0"
"Pike","2020-03-18","5","11","0","0","0","0"
"Pike","2020-03-19","12","23","1","1","1.2","0.6"
"Pike","2020-03-20","5","28","0","1","1.2","0.6"
"Pike","2020-03-21","3","31","1","2","6","3"
"Pike","2020-03-22","4","35","1","3","9.5","4.8"
"Pike","2020-03-23","16","51","3","6","12.2","6.1"
"Pike","2020-03-24","4","55","0","6","12.2","6.1"
"Pike","2020-03-25","8","63","0","6","12.2","6.1"
"Pike","2020-03-26","4","67","1","7","14.6","7.9"
"Pike","2020-03-27","11","78","1","8","15.9","8.5"
"Pike","2020-03-28","5","83","0","8","11.1","8.5"
"Pike","2020-03-29","6","89","0","8","7.5","8.5"
"Pike","2020-03-30","13","102","1","9","6","9.1"
"Pike","2020-03-31","5","107","0","9","6","9.1"
"Pike","2020-04-01","6","113","1","10","8.3","10.3"
"Pike","2020-04-02","6","119","0","10","4.8","9.7"
"Pike","2020-04-03","5","124","1","11","6.3","11.1"
"Pike","2020-04-04","3","127","0","11","6.3","8.7"
"Pike","2020-04-05","1","128","0","11","6.3","6.9"
"Pike","2020-04-06","16","144","1","12","6.1","6"
"Pike","2020-04-07","7","151","0","12","6.1","6"
"Pike","2020-04-08","9","160","1","13","5.3","6.8"
"Pike","2020-04-09","10","170","3","16","9.6","7.2"
"Pike","2020-04-10","2","172","0","16","6.8","6.6"
"Pike","2020-04-11","4","176","1","17","10.3","8.3"
"Pike","2020-04-12","5","181","2","19","16.1","11.2"
"Pike","2020-04-13","8","189","3","22","20.5","13.3"
"Pike","2020-04-14","7","196","0","22","20.5","13.3"
"Pike","2020-04-15","17","213","0","22","18.9","12.1"
"Pike","2020-04-16","9","222","1","23","16.2","12.9"
"Pike","2020-04-17","8","230","0","23","16.2","11.5"
"Pike","2020-04-18","4","234","1","24","16.2","13.3"
"Pike","2020-04-19","2","236","1","25","17.7","16.9"
"Pike","2020-04-20","25","261","0","25","12.3","16.4"
"Pike","2020-04-21","27","288","1","26","12.8","16.7"
"Pike","2020-04-22","35","323","3","29","14.1","16.5"
"Pike","2020-04-23","10","333","0","29","12.5","14.3"
"Pike","2020-04-24","19","352","0","29","12.5","14.3"
"Pike","2020-04-25","3","355","0","29","8.9","12.6"
"Pike","2020-04-26","5","360","0","29","1.8","9.7"
"Pike","2020-04-27","20","380","0","29","1.8","7"
"Pike","2020-04-28","14","394","0","29","1.2","7"
"Pike","2020-04-29","14","408","0","29","0","7"
"Pike","2020-04-30","9","417","0","29","0","6.2"
"Pike","2020-05-01","12","429","0","29","0","6.2"
"Pike","2020-05-02","4","433","0","29","0","4.4"
"Pike","2020-05-03","3","436","0","29","0","0.9"
"Pike","2020-05-04","14","450","1","30","1","1.4"
"Pike","2020-05-05","3","453","0","30","1","1.1"
"Pike","2020-05-06","10","463","3","33","5.3","2.7"
"Pike","2020-05-07","7","470","0","33","5.3","2.7"
"Pike","2020-05-08","12","482","1","34","6.5","3.2"
"Pike","2020-05-09","5","487","1","35","9.4","4.7"
"Pike","2020-05-10","4","491","1","36","12.9","6.5"
"Pike","2020-05-11","13","504","1","37","13","7"
"Pike","2020-05-12","14","518","1","38","14","7.5"
"Pike","2020-05-13","10","528","0","38","9.7","7.5"
"Pike","2020-05-14","20","548","1","39","10.5","7.9"
"Pike","2020-05-15","14","562","1","40","10.3","8.4"
"Pike","2020-05-16","10","572","1","41","8.9","9.1"
"Pike","2020-05-17","4","576","0","41","5.3","9.1"
"Pike","2020-05-18","19","595","3","44","6.4","9.7"
"Pike","2020-05-19","106","701","5","49","6.1","10.1"
"Pike","2020-05-20","14","715","1","50","7.1","8.4"
"Pike","2020-05-21","13","728","2","52","8.6","9.5"
"Pike","2020-05-22","9","737","2","54","10.8","10.5"
"Pike","2020-05-23","5","742","0","54","9.3","9.1"
"Pike","2020-05-24","1","743","0","54","9.3","7.3"
"Pike","2020-05-25","3","746","0","54","7.1","6.8"
"Pike","2020-05-26","10","756","1","55","7.8","7"
"Pike","2020-05-27","20","776","2","57","8.2","7.7"
"Pike","2020-05-28","10","786","1","58","7.5","8"
"Pike","2020-05-29","6","792","0","58","4.3","7.5"
"Pike","2020-05-30","7","799","0","58","4.3","6.8"
"Pike","2020-05-31","3","802","0","58","4.3","6.8"
"Pike","2020-06-01","13","815","1","59","5.4","6.2"
"Pike","2020-06-02","15","830","2","61","5.9","6.8"
"Pike","2020-06-03","10","840","1","62","5.9","7"
"Pike","2020-06-04","12","852","0","62","4.4","5.9"
"Pike","2020-06-05","22","874","1","63","5.1","4.7"
"Pike","2020-06-06","10","884","0","63","5.1","4.7"
"Pike","2020-06-07","7","891","0","63","5.1","4.7"
"Pike","2020-06-08","23","914","1","64","4.6","5"
"Pike","2020-06-09","10","924","0","64","2.7","4.3"
"Pike","2020-06-10","15","939","2","66","3.2","4.5"
"Pike","2020-06-11","20","959","5","71","6.7","5.6"
"Pike","2020-06-12","17","976","5","76","10.3","7.7"
"Pike","2020-06-13","4","980","1","77","13.9","9.5"
"Pike","2020-06-14","4","984","1","78","17.4","11.3"
"Pike","2020-06-15","21","1005","3","81","18.9","11.7"
"Pike","2020-06-16","19","1024","1","82","19.6","11.2"
"Pike","2020-06-17","20","1044","2","84","19.1","11.2"
"Pike","2020-06-18","27","1071","1","85","16.1","11.4"
"Pike","2020-06-19","10","1081","0","85","11.9","11.1"
"Pike","2020-06-20","7","1088","1","86","10.4","12.1"
"Pike","2020-06-21","1","1089","0","86","6.8","12.1"
"Pike","2020-06-22","31","1120","3","89","6.1","12.5"
"Pike","2020-06-23","15","1135","0","89","5.4","12.5"
"Pike","2020-06-24","18","1153","2","91","5.5","12.3"
"Pike","2020-06-25","12","1165","1","92","6.2","11.1"
"Pike","2020-06-26","15","1180","1","93","7.2","9.5"
"Pike","2020-06-27","9","1189","1","94","6.7","8.5"
"Pike","2020-06-28","3","1192","2","96","16.2","11.5"
"Pike","2020-06-29","27","1219","3","99","16.4","11.3"
"Pike","2020-06-30","16","1235","2","101","18.2","11.8"
"Pike","2020-07-01","22","1257","2","103","17.9","11.7"
"Pike","2020-07-02","20","1277","1","104","17.4","11.8"
"Pike","2020-07-03","13","1290","3","107","19.8","13.5"
"Pike","2020-07-04","8","1298","1","108","20","13.3"
"Pike","2020-07-05","10","1308","3","111","14.8","15.5"
"Pike","2020-07-06","36","1344","4","115","14.8","15.6"
"Pike","2020-07-07","47","1391","0","115","13","15.6"
"Pike","2020-07-08","18","1409","3","118","14.1","16"
"Pike","2020-07-09","34","1443","3","121","14.6","16"
"Pike","2020-07-10","17","1460","2","123","13","16.4"
"Pike","2020-07-11","6","1466","2","125","16","18"
"Pike","2020-07-12","7","1473","2","127","15.8","15.3"
"Pike","2020-07-13","23","1496","2","129","15.4","15.1"
"Pike","2020-07-14","41","1537","4","133","16.8","14.9"
"Pike","2020-07-15","22","1559","4","137","17","15.5"
"Pike","2020-07-16","12","1571","1","138","16.9","15.8"
"Pike","2020-07-17","16","1587","5","143","19.7","16.4"
"Pike","2020-07-18","6","1593","1","144","17.4","16.7"
"Pike","2020-07-19","5","1598","2","146","19","17.4"
"Pike","2020-07-20","21","1619","1","147","18.4","16.9"
"Pike","2020-07-21","37","1656","4","151","18.6","17.7"
"Pike","2020-07-22","12","1668","2","153","18.4","17.7"
"Pike","2020-07-23","22","1690","7","160","21.7","19.3"
"Pike","2020-07-24","16","1706","2","162","19","19.4"
"Pike","2020-07-25","14","1720","3","165","19.7","18.5"
"Pike","2020-07-26","7","1727","0","165","14","16.5"
"Pike","2020-07-27","18","1745","3","168","15.7","17.1"
"Pike","2020-07-28","41","1786","1","169","14.5","16.5"
"Pike","2020-07-29","20","1806","1","170","12.8","15.6"
"Pike","2020-07-30","25","1831","3","173","10","15.9"
"Pike","2020-07-31","18","1849","0","173","8.2","13.6"
"Pike","2020-08-01","13","1862","0","173","5.2","12.4"
"Pike","2020-08-02","6","1868","2","175","9.9","12"
"Pike","2020-08-03","32","1900","1","176","8","11.8"
"Pike","2020-08-04","45","1945","3","179","8.6","11.5"
"Pike","2020-08-05","19","1964","4","183","10.9","11.9"
"Pike","2020-08-06","15","1979","3","186","12","11"
"Pike","2020-08-07","16","1995","3","189","14.7","11.5"
"Pike","2020-08-08","21","2016","6","195","18.8","12"
"Pike","2020-08-09","8","2024","2","197","17.6","13.8"
"Pike","2020-08-10","27","2051","4","201","19.3","13.6"
"Pike","2020-08-11","66","2117","4","205","19.2","13.9"
"Pike","2020-08-12","20","2137","1","206","16.9","13.9"
"Pike","2020-08-13","17","2154","1","207","14.9","13.4"
"Pike","2020-08-14","26","2180","5","212","14.9","14.8"
"Pike","2020-08-15","9","2189","2","214","14","16.4"
"Pike","2020-08-16","45","2234","3","217","11.4","14.5"
"Pike","2020-08-17","28","2262","3","220","10.8","15"
"Pike","2020-08-18","55","2317","5","225","11.3","15.2"
"Pike","2020-08-19","22","2339","2","227","11.8","14.4"
"Pike","2020-08-20","25","2364","0","227","11","12.9"
"Pike","2020-08-21","21","2385","1","228","8.9","11.9"
"Pike","2020-08-22","15","2400","4","232","9.6","11.8"
"Pike","2020-08-23","9","2409","2","234","11.8","11.6"
"Pike","2020-08-24","16","2425","1","235","11.2","11"
"Pike","2020-08-25","46","2471","1","236","10.2","10.7"
"Pike","2020-08-26","9","2480","0","236","8.9","10.4"
"Pike","2020-08-27","21","2501","1","237","9.5","10.3"
"Pike","2020-08-28","20","2521","2","239","10.3","9.6"
"Pike","2020-08-29","10","2531","0","239","6.5","8"
"Pike","2020-08-30","2","2533","1","240","10.5","11.1"
"Pike","2020-08-31","20","2553","5","245","13.1","12.1"
"Pike","2020-09-01","49","2602","1","246","13.1","11.6"
"Pike","2020-09-02","10","2612","2","248","16","12.4"
"Pike","2020-09-03","17","2629","3","251","17.8","13.7"
"Pike","2020-09-04","10","2639","0","251","16.4","13.3"
"Pike","2020-09-05","8","2647","0","251","16.4","11.4"
"Pike","2020-09-06","8","2655","1","252","11","10.7"
"Pike","2020-09-07","12","2667","0","252","7.5","10.3"
"Pike","2020-09-08","26","2693","5","257","9.9","11.5"
"Pike","2020-09-09","19","2712","2","259","8.6","12.3"
"Pike","2020-09-10","10","2722","1","260","7.5","12.6"
"Pike","2020-09-11","17","2739","0","260","7.5","11.9"
"Pike","2020-09-12","6","2745","0","260","7.5","11.9"
"Pike","2020-09-13","2","2747","0","260","5.7","8.4"
"Pike","2020-09-14","19","2766","0","260","5.7","6.6"
"Pike","2020-09-15","35","2801","4","264","4.6","7.2"
"Pike","2020-09-16","26","2827","1","265","3.6","6.1"
"Pike","2020-09-17","18","2845","1","266","3","5.2"
"Pike","2020-09-18","11","2856","2","268","5.6","6.5"
"Pike","2020-09-19","4","2860","0","268","5.6","6.5"
"Pike","2020-09-20","5","2865","0","268","5.6","5.6"
"Pike","2020-09-21","18","2883","1","269","6.4","6"
"Pike","2020-09-22","35","2918","6","275","7.2","5.9"
"Pike","2020-09-23","12","2930","1","276","7.8","5.7"
"Pike","2020-09-24","25","2955","1","277","7.6","5.3"
"Pike","2020-09-25","16","2971","3","280","7.7","6.6"
"Pike","2020-09-26","13","2984","1","281","8.8","7.2"
"Pike","2020-09-27","6","2990","0","281","8.8","7.2"
"Pike","2020-09-28","22","3012","9","290","13.8","10.1"
"Pike","2020-09-29","30","3042","2","292","12.3","9.8"
"Pike","2020-09-30","17","3059","0","292","11.1","9.5"
"Pike","2020-10-01","15","3074","1","293","11.5","9.6"
"Pike","2020-10-02","22","3096","2","295","10.1","8.9"
"Pike","2020-10-03","14","3110","2","297","11.1","9.9"
"Pike","2020-10-04","16","3126","0","297","11.1","9.9"
"Pike","2020-10-05","27","3153","1","298","5.8","9.8"
"Pike","2020-10-06","46","3199","5","303","6.4","9.4"
"Pike","2020-10-07","18","3217","1","304","7.2","9.2"
"Pike","2020-10-08","21","3238","1","305","6.9","9.2"
"Pike","2020-10-09","22","3260","4","309","8.2","9.2"
"Pike","2020-10-10","14","3274","2","311","8.2","9.6"
"Pike","2020-10-11","10","3284","0","311","8.2","9.6"
"Pike","2020-10-12","19","3303","2","313","9.2","7.5"
"Pike","2020-10-13","32","3335","1","314","8.1","7.2"
"Pike","2020-10-14","19","3354","2","316","8.8","8"
"Pike","2020-10-15","17","3371","3","319","10.6","8.8"
"Pike","2020-10-16","15","3386","0","319","8","8.1"
"Pike","2020-10-17","8","3394","1","320","7.8","8"
"Pike","2020-10-18","3","3397","0","320","7.8","8"
"Pike","2020-10-19","23","3420","2","322","7.5","8.3"
"Pike","2020-10-20","43","3463","2","324","7.7","7.9"
"Pike","2020-10-21","25","3488","4","328","8.5","8.6"
"Pike","2020-10-22","20","3508","3","331","8.1","9.4"
"Pike","2020-10-23","16","3524","2","333","9.9","9"
"Pike","2020-10-24","14","3538","0","333","8.1","7.9"
"Pike","2020-10-25","5","3543","0","333","8.1","7.9"
"Pike","2020-10-26","24","3567","3","336","8.7","8.1"
"Pike","2020-10-27","43","3610","4","340","9.3","8.5"
"Pike","2020-10-28","16","3626","0","340","7","7.8"
"Pike","2020-10-29","13","3639","1","341","6","7.1"
"Pike","2020-10-30","16","3655","0","341","4.2","7.1"
"Pike","2020-10-31","11","3666","0","341","4.2","6.2"
"Pike","2020-11-01","9","3675","2","343","7.4","7.8"
"Pike","2020-11-02","27","3702","1","344","6.1","7.4"
"Pike","2020-11-03","42","3744","1","345","5.1","7.2"
"Pike","2020-11-04","23","3767","3","348","7","7"
"Pike","2020-11-05","10","3777","1","349","7.3","6.7"
"Pike","2020-11-06","16","3793","1","350","8.2","6.2"
"Pike","2020-11-07","8","3801","0","350","8.2","6.2"
"Pike","2020-11-08","4","3805","0","350","5.1","6.2"
"Pike","2020-11-09","29","3834","5","355","7","6.6"
"Pike","2020-11-10","49","3883","4","359","7.8","6.5"
"Pike","2020-11-11","24","3907","4","363","8.3","7.7"
"Pike","2020-11-12","31","3938","1","364","7.4","7.3"
"Pike","2020-11-13","21","3959","3","367","8.5","8.4"
"Pike","2020-11-14","18","3977","2","369","10.1","9.2"
"Pike","2020-11-15","16","3993","3","372","12.8","8.9"
"Pike","2020-11-16","39","4032","7","379","12.9","9.9"
"Pike","2020-11-17","67","4099","6","385","13","10.4"
"Pike","2020-11-18","33","4132","4","389","12.3","10.3"
"Pike","2020-11-19","28","4160","5","394","14.4","10.9"
"Pike","2020-11-20","20","4180","1","395","13.1","10.8"
"Pike","2020-11-21","8","4188","0","395","11.5","10.8"
"Pike","2020-11-22","11","4199","3","398","12.7","12.8"
"Pike","2020-11-23","25","4224","4","402","12.5","12.7"
"Pike","2020-11-24","22","4246","2","404","12.5","12.7"
"Pike","2020-11-25","32","4278","3","407","12.1","12.2"
"Pike","2020-11-26","2","4280","0","407","9.5","12"
"Pike","2020-11-27","19","4299","4","411","11.8","12.5"
"Pike","2020-11-28","7","4306","2","413","15.9","13.7"
"Pike","2020-11-29","6","4312","0","413","12","12.4"
"Pike","2020-11-30","37","4349","6","419","12","12.3"
"Pike","2020-12-01","28","4377","6","425","13.8","13.1"
"Pike","2020-12-02","26","4403","5","430","15.2","13.6"
"Pike","2020-12-03","26","4429","3","433","16.9","13.2"
"Pike","2020-12-04","33","4462","6","439","16.5","14.1"
"Pike","2020-12-05","13","4475","1","440","13.5","14.7"
"Pike","2020-12-06","10","4485","3","443","17.8","14.9"
"Pike","2020-12-07","38","4523","5","448","17.3","14.7"
"Pike","2020-12-08","22","4545","2","450","15.6","14.7"
"Pike","2020-12-09","27","4572","4","454","14.9","15.1"
"Pike","2020-12-10","31","4603","7","461","16.5","16.7"
"Pike","2020-12-11","29","4632","6","467","16.9","16.7"
"Pike","2020-12-12","23","4655","3","470","17.6","15.5"
"Pike","2020-12-13","16","4671","3","473","16","16.9"
"Pike","2020-12-14","44","4715","10","483","17.4","17.4"
"Pike","2020-12-15","100","4815","11","494","17.7","16.6"
"Pike","2020-12-16","37","4852","3","497","16.7","15.8"
"Pike","2020-12-17","45","4897","8","505","16","16.3"
"Pike","2020-12-18","30","4927","5","510","15.4","16.1"
"Pike","2020-12-19","14","4941","3","513","16.6","17.1"
"Pike","2020-12-20","11","4952","0","513","14","15"
"Pike","2020-12-21","39","4991","5","518","12.5","15"
"Pike","2020-12-22","51","5042","7","525","12.9","15.3"
"Pike","2020-12-23","33","5075","8","533","15.2","16"
"Pike","2020-12-24","22","5097","6","539","16.6","16.3"
"Pike","2020-12-25","6","5103","1","540","16.6","16"
"Pike","2020-12-26","19","5122","5","545","17.3","17"
"Pike","2020-12-27","11","5133","4","549","22.5","18.2"
"Pike","2020-12-28","72","5205","18","567","24.2","18.4"
"Pike","2020-12-29","103","5308","20","587","25","19"
"Pike","2020-12-30","41","5349","13","600","26.1","20.7"
"Pike","2020-12-31","34","5383","7","607","25.2","20.9"
"Pike","2021-01-01","5","5388","1","608","25.6","21.1"
"Pike","2021-01-02","21","5409","6","614","25.9","21.6"
"Pike","2021-01-03","21","5430","8","622","26.2","24.3"
"Pike","2021-01-04","98","5528","19","641","25.4","24.8"
"Pike","2021-01-05","60","5588","11","652","25.2","25.1"
"Pike","2021-01-06","40","5628","9","661","23.9","25"
"Pike","2021-01-07","49","5677","10","671","23.9","24.5"
"Pike","2021-01-08","37","5714","9","680","24.5","25.1"
"Pike","2021-01-09","29","5743","2","682","21.4","23.7"
"Pike","2021-01-10","8","5751","3","685","21.3","23.8"
"Pike","2021-01-11","32","5783","6","691","21.2","23.3"
"Pike","2021-01-12","104","5887","11","702","20.1","22.7"
"Pike","2021-01-13","40","5927","9","711","20.1","22"
"Pike","2021-01-14","40","5967","8","719","20.1","22"
"Pike","2021-01-15","37","6004","6","725","18.9","21.7"
"Pike","2021-01-16","32","6036","4","729","19.7","20.6"
"Pike","2021-01-17","8","6044","2","731","17.9","19.6"
"Pike","2021-01-18","30","6074","6","737","18.1","19.7"
"Pike","2021-01-19","33","6107","7","744","19.6","19.9"
"Pike","2021-01-20","40","6147","7","751","18.9","19.5"
"Pike","2021-01-21","48","6195","5","756","17.5","18.8"
"Pike","2021-01-22","34","6229","4","760","16.9","17.9"
"Pike","2021-01-23","20","6249","3","763","17.3","18.5"
"Pike","2021-01-24","8","6257","0","763","13.7","15.8"
"Pike","2021-01-25","12","6269","1","764","12","15.1"
"Pike","2021-01-26","1","6270","0","764","9","14.3"
"Pike","2021-01-27","0","6270","0","764","6.5","12.7"
"Polk","2020-02-01","0","0","0","0",".","."
"Polk","2020-02-02","0","0","0","0",".","."
"Polk","2020-02-03","0","0","0","0",".","."
"Polk","2020-02-04","0","0","0","0",".","."
"Polk","2020-02-05","0","0","0","0",".","."
"Polk","2020-02-06","0","0","0","0",".","."
"Polk","2020-02-07","0","0","0","0","0","."
"Polk","2020-02-08","0","0","0","0","0","."
"Polk","2020-02-09","0","0","0","0","0","."
"Polk","2020-02-10","0","0","0","0","0","."
"Polk","2020-02-11","0","0","0","0","0","."
"Polk","2020-02-12","0","0","0","0","0","."
"Polk","2020-02-13","0","0","0","0","0","."
"Polk","2020-02-14","0","0","0","0","0","0"
"Polk","2020-02-15","0","0","0","0","0","0"
"Polk","2020-02-16","0","0","0","0","0","0"
"Polk","2020-02-17","0","0","0","0","0","0"
"Polk","2020-02-18","0","0","0","0","0","0"
"Polk","2020-02-19","0","0","0","0","0","0"
"Polk","2020-02-20","0","0","0","0","0","0"
"Polk","2020-02-21","0","0","0","0","0","0"
"Polk","2020-02-22","0","0","0","0","0","0"
"Polk","2020-02-23","0","0","0","0","0","0"
"Polk","2020-02-24","0","0","0","0","0","0"
"Polk","2020-02-25","0","0","0","0","0","0"
"Polk","2020-02-26","0","0","0","0","0","0"
"Polk","2020-02-27","0","0","0","0","0","0"
"Polk","2020-02-28","0","0","0","0","0","0"
"Polk","2020-02-29","0","0","0","0","0","0"
"Polk","2020-03-01","0","0","0","0","0","0"
"Polk","2020-03-02","0","0","0","0","0","0"
"Polk","2020-03-03","0","0","0","0","0","0"
"Polk","2020-03-04","0","0","0","0","0","0"
"Polk","2020-03-05","0","0","0","0","0","0"
"Polk","2020-03-06","0","0","0","0","0","0"
"Polk","2020-03-07","0","0","0","0","0","0"
"Polk","2020-03-08","0","0","0","0","0","0"
"Polk","2020-03-09","1","1","0","0","0","0"
"Polk","2020-03-10","5","6","0","0","0","0"
"Polk","2020-03-11","7","13","0","0","0","0"
"Polk","2020-03-12","7","20","0","0","0","0"
"Polk","2020-03-13","4","24","1","1","3.6","1.8"
"Polk","2020-03-14","2","26","0","1","3.6","1.8"
"Polk","2020-03-15","3","29","1","2","8.3","4.2"
"Polk","2020-03-16","11","40","0","2","8.3","4.2"
"Polk","2020-03-17","21","61","0","2","8.3","4.2"
"Polk","2020-03-18","15","76","1","3","9.3","4.6"
"Polk","2020-03-19","8","84","0","3","9.3","4.6"
"Polk","2020-03-20","9","93","0","3","5.7","4.6"
"Polk","2020-03-21","2","95","0","3","5.7","4.6"
"Polk","2020-03-22","7","102","5","8","11.2","9.7"
"Polk","2020-03-23","12","114","4","12","15.9","12.1"
"Polk","2020-03-24","4","118","0","12","15.9","12.1"
"Polk","2020-03-25","13","131","0","12","15","12.1"
"Polk","2020-03-26","10","141","2","14","17.8","13.6"
"Polk","2020-03-27","8","149","2","16","21.4","13.6"
"Polk","2020-03-28","12","161","4","20","26.2","15.9"
"Polk","2020-03-29","9","170","0","20","16","13.6"
"Polk","2020-03-30","16","186","2","22","13","14.4"
"Polk","2020-03-31","8","194","0","22","13","14.4"
"Polk","2020-04-01","9","203","1","23","14.6","14.8"
"Polk","2020-04-02","17","220","0","23","11.7","14.8"
"Polk","2020-04-03","9","229","1","24","9.7","15.6"
"Polk","2020-04-04","11","240","1","25","6.3","16.2"
"Polk","2020-04-05","5","245","0","25","6.3","11.1"
"Polk","2020-04-06","5","250","2","27","10.2","11.6"
"Polk","2020-04-07","11","261","1","28","11.5","12.2"
"Polk","2020-04-08","16","277","2","30","11.7","13.1"
"Polk","2020-04-09","14","291","0","30","11.7","11.7"
"Polk","2020-04-10","12","303","1","31","11.3","10.5"
"Polk","2020-04-11","14","317","3","34","13.1","9.7"
"Polk","2020-04-12","10","327","3","37","17.3","11.8"
"Polk","2020-04-13","15","342","4","41","15.4","12.8"
"Polk","2020-04-14","17","359","3","44","16.7","14.1"
"Polk","2020-04-15","15","374","1","45","15.8","13.8"
"Polk","2020-04-16","15","389","3","48","18.7","15.2"
"Polk","2020-04-17","21","410","1","49","18.2","14.7"
"Polk","2020-04-18","18","428","2","51","16.7","14.9"
"Polk","2020-04-19","3","431","0","51","12.4","14.9"
"Polk","2020-04-20","9","440","0","51","8.6","12"
"Polk","2020-04-21","21","461","2","53","7.4","12"
"Polk","2020-04-22","17","478","2","55","8.2","12"
"Polk","2020-04-23","17","495","0","55","5.3","12"
"Polk","2020-04-24","12","507","2","57","7","12.6"
"Polk","2020-04-25","13","520","1","58","6.5","11.6"
"Polk","2020-04-26","5","525","1","59","9.4","10.9"
"Polk","2020-04-27","15","540","2","61","11.3","9.9"
"Polk","2020-04-28","21","561","1","62","10.6","9"
"Polk","2020-04-29","21","582","0","62","8.9","8.5"
"Polk","2020-04-30","19","601","1","63","9.7","7.5"
"Polk","2020-05-01","21","622","3","66","9.3","8.2"
"Polk","2020-05-02","10","632","0","66","8.2","7.4"
"Polk","2020-05-03","6","638","0","66","5.4","7.4"
"Polk","2020-05-04","7","645","2","68","7.6","9.4"
"Polk","2020-05-05","25","670","1","69","7.4","9"
"Polk","2020-05-06","15","685","2","71","9.4","9.1"
"Polk","2020-05-07","27","712","2","73","9.7","9.7"
"Polk","2020-05-08","25","737","0","73","7.6","8.5"
"Polk","2020-05-09","14","751","0","73","7.6","7.9"
"Polk","2020-05-10","6","757","0","73","7.6","6.5"
"Polk","2020-05-11","15","772","1","74","4.5","6"
"Polk","2020-05-12","29","801","3","77","5.4","6.4"
"Polk","2020-05-13","21","822","1","78","4.2","6.8"
"Polk","2020-05-14","27","849","1","79","3.6","6.6"
"Polk","2020-05-15","18","867","2","81","5.2","6.4"
"Polk","2020-05-16","14","881","2","83","7.3","7.4"
"Polk","2020-05-17","6","887","0","83","7.3","7.4"
"Polk","2020-05-18","13","900","1","84","7.4","6"
"Polk","2020-05-19","40","940","6","90","8.1","6.7"
"Polk","2020-05-20","15","955","1","91","8.4","6.3"
"Polk","2020-05-21","23","978","5","96","10.9","7.3"
"Polk","2020-05-22","24","1002","2","98","10.5","7.9"
"Polk","2020-05-23","9","1011","1","99","10.1","8.7"
"Polk","2020-05-24","6","1017","1","100","12.5","9.9"
"Polk","2020-05-25","10","1027","2","102","14.2","10.8"
"Polk","2020-05-26","35","1062","0","102","12.1","10.1"
"Polk","2020-05-27","28","1090","1","103","11.6","10"
"Polk","2020-05-28","22","1112","0","103","8.5","9.7"
"Polk","2020-05-29","26","1138","4","107","9.5","10"
"Polk","2020-05-30","14","1152","1","108","9","9.5"
"Polk","2020-05-31","7","1159","1","109","8.6","10.5"
"Polk","2020-06-01","25","1184","1","110","6.3","10.3"
"Polk","2020-06-02","24","1208","2","112","7.5","9.8"
"Polk","2020-06-03","25","1233","4","116","9.3","10.5"
"Polk","2020-06-04","24","1257","1","117","9.9","9.2"
"Polk","2020-06-05","30","1287","1","118","8.2","8.9"
"Polk","2020-06-06","18","1305","1","119","8","8.5"
"Polk","2020-06-07","6","1311","1","120","8.3","8.5"
"Polk","2020-06-08","30","1341","3","123","9.2","7.7"
"Polk","2020-06-09","32","1373","1","124","8.4","8"
"Polk","2020-06-10","22","1395","1","125","6.8","8"
"Polk","2020-06-11","33","1428","0","125","6.2","8"
"Polk","2020-06-12","36","1464","1","126","6.1","7.1"
"Polk","2020-06-13","17","1481","1","127","6.1","7"
"Polk","2020-06-14","10","1491","2","129","6.6","7.5"
"Polk","2020-06-15","35","1526","0","129","5.2","7.2"
"Polk","2020-06-16","37","1563","4","133","6.3","7.3"
"Polk","2020-06-17","29","1592","4","137","7.6","7.2"
"Polk","2020-06-18","22","1614","1","138","8.3","7.2"
"Polk","2020-06-19","32","1646","2","140","8.8","7.4"
"Polk","2020-06-20","20","1666","1","141","8.6","7.4"
"Polk","2020-06-21","9","1675","0","141","5.8","6.2"
"Polk","2020-06-22","39","1714","2","143","6.5","5.8"
"Polk","2020-06-23","40","1754","5","148","6.7","6.5"
"Polk","2020-06-24","40","1794","4","152","6.2","6.9"
"Polk","2020-06-25","39","1833","3","155","6.7","7.5"
"Polk","2020-06-26","57","1890","1","156","6","7.4"
"Polk","2020-06-27","35","1925","1","157","5.7","7.2"
"Polk","2020-06-28","12","1937","3","160","9.3","7.5"
"Polk","2020-06-29","51","1988","10","170","11.3","8.9"
"Polk","2020-06-30","53","2041","6","176","11.2","9"
"Polk","2020-07-01","62","2103","11","187","12.3","9.2"
"Polk","2020-07-02","57","2160","11","198","13.9","10.3"
"Polk","2020-07-03","38","2198","8","206","16.7","11.4"
"Polk","2020-07-04","28","2226","8","214","20.4","13"
"Polk","2020-07-05","11","2237","5","219","23.3","16.3"
"Polk","2020-07-06","90","2327","27","246","24.8","18.1"
"Polk","2020-07-07","84","2411","16","262","25.9","18.5"
"Polk","2020-07-08","55","2466","9","271","25.7","19"
"Polk","2020-07-09","107","2573","18","289","25.3","19.6"
"Polk","2020-07-10","93","2666","10","299","23.9","20.3"
"Polk","2020-07-11","81","2747","17","316","22.8","21.6"
"Polk","2020-07-12","33","2780","14","330","22.3","22.8"
"Polk","2020-07-13","67","2847","15","345","21.3","23"
"Polk","2020-07-14","97","2944","15","360","20.7","23.3"
"Polk","2020-07-15","69","3013","10","370","20.5","23.1"
"Polk","2020-07-16","71","3084","14","384","20.9","23.1"
"Polk","2020-07-17","55","3139","12","396","22.5","23.2"
"Polk","2020-07-18","32","3171","9","405","23.5","23.1"
"Polk","2020-07-19","18","3189","2","407","19","20.7"
"Polk","2020-07-20","50","3239","8","415","18.1","19.7"
"Polk","2020-07-21","77","3316","13","428","18.3","19.5"
"Polk","2020-07-22","55","3371","15","443","20.1","20.3"
"Polk","2020-07-23","79","3450","12","455","19.5","20.2"
"Polk","2020-07-24","87","3537","13","468","18.5","20.5"
"Polk","2020-07-25","40","3577","12","480","18.8","21.1"
"Polk","2020-07-26","21","3598","3","483","19.2","19.1"
"Polk","2020-07-27","53","3651","13","496","20.4","19.3"
"Polk","2020-07-28","68","3719","15","511","21.2","19.7"
"Polk","2020-07-29","44","3763","10","521","20.5","20.3"
"Polk","2020-07-30","57","3820","6","527","19.9","19.7"
"Polk","2020-07-31","61","3881","13","540","20.8","19.6"
"Polk","2020-08-01","52","3933","12","552","19.8","19.3"
"Polk","2020-08-02","17","3950","4","556","21.1","20.2"
"Polk","2020-08-03","36","3986","10","566","21.6","21"
"Polk","2020-08-04","84","4070","19","585","21.7","21.4"
"Polk","2020-08-05","76","4146","8","593","19.9","20.2"
"Polk","2020-08-06","78","4224","10","603","20.2","20.1"
"Polk","2020-08-07","82","4306","12","615","19.3","20"
"Polk","2020-08-08","69","4375","8","623","17.6","18.7"
"Polk","2020-08-09","19","4394","3","626","16.5","18.8"
"Polk","2020-08-10","84","4478","10","636","14.3","17.9"
"Polk","2020-08-11","130","4608","22","658","13.5","17.6"
"Polk","2020-08-12","117","4725","18","676","14.2","17"
"Polk","2020-08-13","84","4809","8","684","13.7","17"
"Polk","2020-08-14","124","4933","15","699","13.3","16.3"
"Polk","2020-08-15","49","4982","7","706","13.7","15.7"
"Polk","2020-08-16","31","5013","0","706","11.4","14"
"Polk","2020-08-17","36","5049","8","714","12.9","13.6"
"Polk","2020-08-18","58","5107","13","727","13.7","13.6"
"Polk","2020-08-19","86","5193","7","734","12.7","13.4"
"Polk","2020-08-20","46","5239","7","741","13.5","13.6"
"Polk","2020-08-21","67","5306","3","744","12.4","12.9"
"Polk","2020-08-22","72","5378","17","761","13.7","13.7"
"Polk","2020-08-23","13","5391","1","762","14.8","13.1"
"Polk","2020-08-24","57","5448","11","773","14.4","13.7"
"Polk","2020-08-25","63","5511","7","780","12.8","13.2"
"Polk","2020-08-26","75","5586","8","788","13.2","12.9"
"Polk","2020-08-27","50","5636","6","794","12.7","13.1"
"Polk","2020-08-28","36","5672","5","799","14","13.2"
"Polk","2020-08-29","26","5698","1","800","11.2","12.5"
"Polk","2020-08-30","15","5713","0","800","10.1","12.5"
"Polk","2020-08-31","27","5740","2","802","8.4","11.4"
"Polk","2020-09-01","114","5854","12","814","8.3","10.6"
"Polk","2020-09-02","38","5892","5","819","8.7","10.9"
"Polk","2020-09-03","46","5938","4","823","8.2","10.5"
"Polk","2020-09-04","41","5979","2","825","6.9","10.5"
"Polk","2020-09-05","26","6005","0","825","6.4","8.8"
"Polk","2020-09-06","17","6022","2","827","8.1","9.1"
"Polk","2020-09-07","10","6032","2","829","9.9","9.1"
"Polk","2020-09-08","129","6161","9","838","9.4","8.8"
"Polk","2020-09-09","66","6227","12","850","10.1","9.4"
"Polk","2020-09-10","63","6290","7","857","10.4","9.3"
"Polk","2020-09-11","30","6320","2","859","10.7","8.8"
"Polk","2020-09-12","18","6338","0","859","10.7","8.5"
"Polk","2020-09-13","21","6359","2","861","10.4","9.2"
"Polk","2020-09-14","43","6402","6","867","9.5","9.7"
"Polk","2020-09-15","128","6530","9","876","9.5","9.4"
"Polk","2020-09-16","45","6575","0","876","6.9","8.5"
"Polk","2020-09-17","30","6605","4","880","7.2","8.8"
"Polk","2020-09-18","61","6666","9","889","8.4","9.5"
"Polk","2020-09-19","28","6694","3","892","9.9","10.3"
"Polk","2020-09-20","20","6714","1","893","9.3","9.8"
"Polk","2020-09-21","34","6748","4","897","8.9","9.2"
"Polk","2020-09-22","133","6881","9","906","8.9","9.2"
"Polk","2020-09-23","44","6925","3","909","9.9","8.4"
"Polk","2020-09-24","65","6990","3","912","8.6","7.9"
"Polk","2020-09-25","37","7027","2","914","7.3","7.8"
"Polk","2020-09-26","43","7070","3","917","6.8","8.3"
"Polk","2020-09-27","20","7090","2","919","7.5","8.4"
"Polk","2020-09-28","28","7118","1","920","6.3","7.6"
"Polk","2020-09-29","98","7216","9","929","6.7","7.8"
"Polk","2020-09-30","21","7237","2","931","7","8.5"
"Polk","2020-10-01","32","7269","1","932","6.8","7.7"
"Polk","2020-10-02","72","7341","2","934","6.5","6.9"
"Polk","2020-10-03","34","7375","1","935","5.9","6.3"
"Polk","2020-10-04","15","7390","1","936","5.4","6.4"
"Polk","2020-10-05","21","7411","2","938","6.2","6.3"
"Polk","2020-10-06","101","7512","13","951","6.8","6.7"
"Polk","2020-10-07","92","7604","3","954","5.9","6.5"
"Polk","2020-10-08","64","7668","5","959","6.6","6.7"
"Polk","2020-10-09","48","7716","5","964","7.6","7"
"Polk","2020-10-10","35","7751","3","967","8.4","7.2"
"Polk","2020-10-11","15","7766","2","969","9.4","7.4"
"Polk","2020-10-12","42","7808","4","973","9.4","7.8"
"Polk","2020-10-13","153","7961","17","990","9.1","8"
"Polk","2020-10-14","91","8052","4","994","9.3","7.6"
"Polk","2020-10-15","49","8101","7","1001","10.2","8.4"
"Polk","2020-10-16","50","8151","3","1004","9.6","8.6"
"Polk","2020-10-17","52","8203","11","1015","11.4","9.9"
"Polk","2020-10-18","11","8214","2","1017","12.1","10.7"
"Polk","2020-10-19","29","8243","3","1020","12.2","10.8"
"Polk","2020-10-20","121","8364","12","1032","12","10.6"
"Polk","2020-10-21","41","8405","7","1039","13.9","11.6"
"Polk","2020-10-22","62","8467","6","1045","13.2","11.7"
"Polk","2020-10-23","53","8520","8","1053","14.5","12"
"Polk","2020-10-24","42","8562","3","1056","12.5","11.9"
"Polk","2020-10-25","14","8576","1","1057","10.9","11.5"
"Polk","2020-10-26","33","8609","4","1061","11.2","11.7"
"Polk","2020-10-27","115","8724","12","1073","11.2","11.6"
"Polk","2020-10-28","62","8786","9","1082","10.9","12.4"
"Polk","2020-10-29","44","8830","3","1085","10.5","11.8"
"Polk","2020-10-30","17","8847","1","1086","9.2","11.8"
"Polk","2020-10-31","40","8887","6","1092","10.3","11.4"
"Polk","2020-11-01","19","8906","1","1093","10","10.5"
"Polk","2020-11-02","32","8938","6","1099","11","11.1"
"Polk","2020-11-03","118","9056","12","1111","10.9","11.1"
"Polk","2020-11-04","52","9108","4","1115","9.9","10.4"
"Polk","2020-11-05","44","9152","5","1120","10.6","10.5"
"Polk","2020-11-06","52","9204","3","1123","10.6","9.9"
"Polk","2020-11-07","35","9239","11","1134","12.9","11.6"
"Polk","2020-11-08","28","9267","9","1143","16.8","13.4"
"Polk","2020-11-09","53","9320","10","1153","16.8","13.9"
"Polk","2020-11-10","128","9448","20","1173","17.6","14.2"
"Polk","2020-11-11","50","9498","8","1181","18.7","14.3"
"Polk","2020-11-12","51","9549","9","1190","19.6","15.1"
"Polk","2020-11-13","50","9599","9","1199","21.4","16"
"Polk","2020-11-14","44","9643","4","1203","18.2","15.6"
"Polk","2020-11-15","30","9673","4","1207","15.5","16.1"
"Polk","2020-11-16","55","9728","14","1221","16.5","16.6"
"Polk","2020-11-17","101","9829","11","1232","15.8","16.7"
"Polk","2020-11-18","57","9886","4","1236","14.5","16.6"
"Polk","2020-11-19","56","9942","7","1243","13.8","16.7"
"Polk","2020-11-20","54","9996","6","1249","12.8","17.1"
"Polk","2020-11-21","57","10053","7","1256","13.2","15.7"
"Polk","2020-11-22","22","10075","4","1260","13.9","14.7"
"Polk","2020-11-23","47","10122","9","1269","13","14.7"
"Polk","2020-11-24","192","10314","23","1292","13.2","14.5"
"Polk","2020-11-25","70","10384","8","1300","13.8","14.1"
"Polk","2020-11-26","16","10400","3","1303","14.7","14.2"
"Polk","2020-11-27","52","10452","9","1312","15.6","14.2"
"Polk","2020-11-28","38","10490","8","1320","16.8","15"
"Polk","2020-11-29","26","10516","8","1328","18.6","16.3"
"Polk","2020-11-30","70","10586","13","1341","18.6","15.8"
"Polk","2020-12-01","76","10662","13","1354","19.3","16.2"
"Polk","2020-12-02","73","10735","11","1365","19.8","16.8"
"Polk","2020-12-03","91","10826","11","1376","18.9","16.8"
"Polk","2020-12-04","86","10912","9","1385","17.9","16.7"
"Polk","2020-12-05","42","10954","7","1392","17.2","17"
"Polk","2020-12-06","18","10972","3","1395","15.2","16.9"
"Polk","2020-12-07","97","11069","9","1404","13.9","16.2"
"Polk","2020-12-08","93","11162","10","1414","13","16.1"
"Polk","2020-12-09","97","11259","11","1425","12.5","16.1"
"Polk","2020-12-10","104","11363","9","1434","12","15.4"
"Polk","2020-12-11","140","11503","17","1451","12.2","15"
"Polk","2020-12-12","83","11586","15","1466","12.4","14.8"
"Polk","2020-12-13","29","11615","6","1472","13","14.1"
"Polk","2020-12-14","92","11707","21","1493","14.9","14.4"
"Polk","2020-12-15","146","11853","19","1512","15.2","14.1"
"Polk","2020-12-16","119","11972","19","1531","15.9","14.2"
"Polk","2020-12-17","94","12066","19","1550","17.6","14.8"
"Polk","2020-12-18","88","12154","21","1571","19.2","15.7"
"Polk","2020-12-19","70","12224","28","1599","22.4","17.4"
"Polk","2020-12-20","21","12245","8","1607","24.9","18.9"
"Polk","2020-12-21","96","12341","30","1637","26.1","20.5"
"Polk","2020-12-22","144","12485","34","1671","27.6","21.4"
"Polk","2020-12-23","114","12599","31","1702","29.2","22.5"
"Polk","2020-12-24","70","12669","21","1723","30.6","24.1"
"Polk","2020-12-25","22","12691","12","1735","35","27.1"
"Polk","2020-12-26","57","12748","14","1749","32.8","27.6"
"Polk","2020-12-27","42","12790","17","1766","33.1","29"
"Polk","2020-12-28","127","12917","29","1795","31.9","29"
"Polk","2020-12-29","187","13104","55","1850","32.7","30.1"
"Polk","2020-12-30","195","13299","62","1912","33.4","31.3"
"Polk","2020-12-31","216","13515","74","1986","34","32.3"
"Polk","2021-01-01","14","13529","3","1989","29.3","32.1"
"Polk","2021-01-02","35","13564","7","1996","28.6","30.7"
"Polk","2021-01-03","66","13630","22","2018","27.6","30.3"
"Polk","2021-01-04","172","13802","70","2088","30.1","31"
"Polk","2021-01-05","261","14063","96","2184","31.2","32"
"Polk","2021-01-06","160","14223","40","2224","30.2","31.8"
"Polk","2021-01-07","117","14340","23","2247","28.1","31.1"
"Polk","2021-01-08","147","14487","34","2281","28.4","28.8"
"Polk","2021-01-09","89","14576","19","2300","28.6","28.6"
"Polk","2021-01-10","44","14620","17","2317","29.3","28.5"
"Polk","2021-01-11","115","14735","29","2346","27.1","28.6"
"Polk","2021-01-12","141","14876","33","2379","25.2","28.2"
"Polk","2021-01-13","131","15007","29","2408","24.8","27.5"
"Polk","2021-01-14","126","15133","29","2437","25.3","26.7"
"Polk","2021-01-15","119","15252","27","2464","25.2","26.8"
"Polk","2021-01-16","81","15333","18","2482","25.3","26.9"
"Polk","2021-01-17","32","15365","8","2490","23.4","26.4"
"Polk","2021-01-18","84","15449","16","2506","22.5","24.8"
"Polk","2021-01-19","120","15569","19","2525","21.4","23.3"
"Polk","2021-01-20","99","15668","14","2539","20.3","22.5"
"Polk","2021-01-21","91","15759","18","2557","19.8","22.5"
"Polk","2021-01-22","72","15831","5","2562","17.6","21.4"
"Polk","2021-01-23","55","15886","11","2573","17.2","21.3"
"Polk","2021-01-24","14","15900","2","2575","15.7","19.6"
"Polk","2021-01-25","22","15922","3","2578","14.9","18.7"
"Polk","2021-01-26","3","15925","2","2580","22.2","21.8"
"Polk","2021-01-27","0","15925","0","2580","20.2","20.2"
"Pulaski","2020-02-01","0","0","0","0",".","."
"Pulaski","2020-02-02","0","0","0","0",".","."
"Pulaski","2020-02-03","0","0","0","0",".","."
"Pulaski","2020-02-04","0","0","0","0",".","."
"Pulaski","2020-02-05","0","0","0","0",".","."
"Pulaski","2020-02-06","0","0","0","0",".","."
"Pulaski","2020-02-07","0","0","0","0","0","."
"Pulaski","2020-02-08","0","0","0","0","0","."
"Pulaski","2020-02-09","0","0","0","0","0","."
"Pulaski","2020-02-10","0","0","0","0","0","."
"Pulaski","2020-02-11","0","0","0","0","0","."
"Pulaski","2020-02-12","0","0","0","0","0","."
"Pulaski","2020-02-13","0","0","0","0","0","."
"Pulaski","2020-02-14","0","0","0","0","0","0"
"Pulaski","2020-02-15","0","0","0","0","0","0"
"Pulaski","2020-02-16","0","0","0","0","0","0"
"Pulaski","2020-02-17","0","0","0","0","0","0"
"Pulaski","2020-02-18","0","0","0","0","0","0"
"Pulaski","2020-02-19","0","0","0","0","0","0"
"Pulaski","2020-02-20","0","0","0","0","0","0"
"Pulaski","2020-02-21","0","0","0","0","0","0"
"Pulaski","2020-02-22","0","0","0","0","0","0"
"Pulaski","2020-02-23","0","0","0","0","0","0"
"Pulaski","2020-02-24","0","0","0","0","0","0"
"Pulaski","2020-02-25","0","0","0","0","0","0"
"Pulaski","2020-02-26","0","0","0","0","0","0"
"Pulaski","2020-02-27","0","0","0","0","0","0"
"Pulaski","2020-02-28","0","0","0","0","0","0"
"Pulaski","2020-02-29","0","0","0","0","0","0"
"Pulaski","2020-03-01","0","0","0","0","0","0"
"Pulaski","2020-03-02","0","0","0","0","0","0"
"Pulaski","2020-03-03","0","0","0","0","0","0"
"Pulaski","2020-03-04","0","0","0","0","0","0"
"Pulaski","2020-03-05","0","0","0","0","0","0"
"Pulaski","2020-03-06","0","0","0","0","0","0"
"Pulaski","2020-03-07","0","0","0","0","0","0"
"Pulaski","2020-03-08","0","0","0","0","0","0"
"Pulaski","2020-03-09","0","0","0","0","0","0"
"Pulaski","2020-03-10","0","0","0","0","0","0"
"Pulaski","2020-03-11","0","0","0","0","0","0"
"Pulaski","2020-03-12","0","0","0","0","0","0"
"Pulaski","2020-03-13","0","0","0","0","0","0"
"Pulaski","2020-03-14","0","0","0","0","0","0"
"Pulaski","2020-03-15","0","0","0","0","0","0"
"Pulaski","2020-03-16","0","0","0","0","0","0"
"Pulaski","2020-03-17","1","1","0","0","0","0"
"Pulaski","2020-03-18","4","5","0","0","0","0"
"Pulaski","2020-03-19","3","8","0","0","0","0"
"Pulaski","2020-03-20","4","12","1","1","3.6","1.8"
"Pulaski","2020-03-21","2","14","0","1","3.6","1.8"
"Pulaski","2020-03-22","0","14","0","1","3.6","1.8"
"Pulaski","2020-03-23","9","23","0","1","3.6","1.8"
"Pulaski","2020-03-24","4","27","0","1","3.6","1.8"
"Pulaski","2020-03-25","3","30","1","2","8.3","4.2"
"Pulaski","2020-03-26","0","30","0","2","8.3","4.2"
"Pulaski","2020-03-27","4","34","1","3","8.3","6"
"Pulaski","2020-03-28","1","35","0","3","8.3","6"
"Pulaski","2020-03-29","0","35","0","3","8.3","6"
"Pulaski","2020-03-30","1","36","0","3","8.3","6"
"Pulaski","2020-03-31","8","44","0","3","8.3","6"
"Pulaski","2020-04-01","1","45","0","3","3.6","6"
"Pulaski","2020-04-02","2","47","0","3","3.6","6"
"Pulaski","2020-04-03","6","53","0","3","0","4.2"
"Pulaski","2020-04-04","2","55","1","4","7.1","7.7"
"Pulaski","2020-04-05","1","56","0","4","7.1","7.7"
"Pulaski","2020-04-06","3","59","1","5","11.9","10.1"
"Pulaski","2020-04-07","1","60","0","5","11.9","10.1"
"Pulaski","2020-04-08","1","61","1","6","26.2","14.9"
"Pulaski","2020-04-09","3","64","0","6","26.2","14.9"
"Pulaski","2020-04-10","1","65","0","6","26.2","13.1"
"Pulaski","2020-04-11","5","70","2","8","24.8","16"
"Pulaski","2020-04-12","0","70","0","8","24.8","16"
"Pulaski","2020-04-13","7","77","4","12","28.2","20"
"Pulaski","2020-04-14","10","87","5","17","35.3","23.6"
"Pulaski","2020-04-15","7","94","2","19","25.1","25.6"
"Pulaski","2020-04-16","2","96","1","20","32.2","29.2"
"Pulaski","2020-04-17","4","100","0","20","32.2","29.2"
"Pulaski","2020-04-18","2","102","0","20","26.5","25.6"
"Pulaski","2020-04-19","6","108","4","24","36.1","30.4"
"Pulaski","2020-04-20","7","115","2","26","32","30.1"
"Pulaski","2020-04-21","1","116","0","26","24.8","30.1"
"Pulaski","2020-04-22","3","119","1","27","25.5","25.3"
"Pulaski","2020-04-23","8","127","2","29","21.9","27.1"
"Pulaski","2020-04-24","2","129","0","29","21.9","27.1"
"Pulaski","2020-04-25","1","130","0","29","21.9","24.2"
"Pulaski","2020-04-26","0","130","0","29","12.4","24.2"
"Pulaski","2020-04-27","10","140","2","31","11.2","21.6"
"Pulaski","2020-04-28","5","145","1","32","14","19.4"
"Pulaski","2020-04-29","5","150","2","34","15","20.3"
"Pulaski","2020-04-30","5","155","0","34","11.4","16.7"
"Pulaski","2020-05-01","1","156","0","34","11.4","16.7"
"Pulaski","2020-05-02","4","160","0","34","11.4","16.7"
"Pulaski","2020-05-03","1","161","0","34","11.4","11.9"
"Pulaski","2020-05-04","5","166","0","34","8.6","9.9"
"Pulaski","2020-05-05","3","169","0","34","5.7","9.9"
"Pulaski","2020-05-06","2","171","0","34","0","7.5"
"Pulaski","2020-05-07","6","177","0","34","0","5.7"
"Pulaski","2020-05-08","2","179","0","34","0","5.7"
"Pulaski","2020-05-09","4","183","0","34","0","5.7"
"Pulaski","2020-05-10","2","185","0","34","0","5.7"
"Pulaski","2020-05-11","2","187","0","34","0","4.3"
"Pulaski","2020-05-12","5","192","0","34","0","2.9"
"Pulaski","2020-05-13","1","193","0","34","0","0"
"Pulaski","2020-05-14","6","199","0","34","0","0"
"Pulaski","2020-05-15","4","203","0","34","0","0"
"Pulaski","2020-05-16","2","205","0","34","0","0"
"Pulaski","2020-05-17","1","206","0","34","0","0"
"Pulaski","2020-05-18","4","210","0","34","0","0"
"Pulaski","2020-05-19","1","211","0","34","0","0"
"Pulaski","2020-05-20","265","476","2","36","0.1","0.1"
"Pulaski","2020-05-21","2","478","0","36","0.1","0.1"
"Pulaski","2020-05-22","5","483","0","36","0.1","0.1"
"Pulaski","2020-05-23","3","486","0","36","0.1","0.1"
"Pulaski","2020-05-24","1","487","0","36","0.1","0.1"
"Pulaski","2020-05-25","2","489","0","36","0.1","0.1"
"Pulaski","2020-05-26","11","500","1","37","1.4","0.7"
"Pulaski","2020-05-27","2","502","0","37","1.3","0.7"
"Pulaski","2020-05-28","3","505","0","37","1.3","0.7"
"Pulaski","2020-05-29","2","507","0","37","1.3","0.7"
"Pulaski","2020-05-30","1","508","1","38","15.6","7.8"
"Pulaski","2020-05-31","1","509","0","38","15.6","7.8"
"Pulaski","2020-06-01","6","515","0","38","15.6","7.8"
"Pulaski","2020-06-02","2","517","0","38","14.3","7.8"
"Pulaski","2020-06-03","9","526","2","40","17.5","9.4"
"Pulaski","2020-06-04","3","529","0","40","17.5","9.4"
"Pulaski","2020-06-05","1","530","0","40","17.5","9.4"
"Pulaski","2020-06-06","1","531","0","40","3.2","9.4"
"Pulaski","2020-06-07","0","531","0","40","3.2","9.4"
"Pulaski","2020-06-08","6","537","1","41","5.6","10.6"
"Pulaski","2020-06-09","1","538","0","41","5.6","9.9"
"Pulaski","2020-06-10","2","540","0","41","2.4","9.9"
"Pulaski","2020-06-11","5","545","0","41","2.4","9.9"
"Pulaski","2020-06-12","2","547","0","41","2.4","9.9"
"Pulaski","2020-06-13","0","547","0","41","2.4","2.8"
"Pulaski","2020-06-14","3","550","0","41","2.4","2.8"
"Pulaski","2020-06-15","18","568","0","41","0","2.8"
"Pulaski","2020-06-16","6","574","0","41","0","2.8"
"Pulaski","2020-06-17","0","574","0","41","0","1.2"
"Pulaski","2020-06-18","3","577","0","41","0","1.2"
"Pulaski","2020-06-19","4","581","0","41","0","1.2"
"Pulaski","2020-06-20","1","582","1","42","14.3","8.3"
"Pulaski","2020-06-21","2","584","0","42","14.3","8.3"
"Pulaski","2020-06-22","7","591","0","42","14.3","7.1"
"Pulaski","2020-06-23","7","598","0","42","14.3","7.1"
"Pulaski","2020-06-24","4","602","0","42","14.3","7.1"
"Pulaski","2020-06-25","6","608","1","43","16.7","8.3"
"Pulaski","2020-06-26","2","610","0","43","16.7","8.3"
"Pulaski","2020-06-27","2","612","1","44","9.5","11.9"
"Pulaski","2020-06-28","1","613","0","44","9.5","11.9"
"Pulaski","2020-06-29","27","640","0","44","9.5","11.9"
"Pulaski","2020-06-30","4","644","0","44","9.5","11.9"
"Pulaski","2020-07-01","9","653","0","44","9.5","11.9"
"Pulaski","2020-07-02","8","661","0","44","7.1","11.9"
"Pulaski","2020-07-03","5","666","1","45","10","13.3"
"Pulaski","2020-07-04","1","667","1","46","17.1","13.3"
"Pulaski","2020-07-05","0","667","0","46","17.1","13.3"
"Pulaski","2020-07-06","45","712","2","48","17.8","13.7"
"Pulaski","2020-07-07","8","720","0","48","17.8","13.7"
"Pulaski","2020-07-08","5","725","0","48","17.8","13.7"
"Pulaski","2020-07-09","5","730","0","48","17.8","12.5"
"Pulaski","2020-07-10","4","734","0","48","14.9","12.5"
"Pulaski","2020-07-11","1","735","0","48","0.6","8.9"
"Pulaski","2020-07-12","1","736","0","48","0.6","8.9"
"Pulaski","2020-07-13","69","805","6","54","1.2","9.5"
"Pulaski","2020-07-14","9","814","0","54","1.2","9.5"
"Pulaski","2020-07-15","13","827","0","54","1.2","9.5"
"Pulaski","2020-07-16","2","829","0","54","1.2","9.5"
"Pulaski","2020-07-17","3","832","0","54","1.2","8.1"
"Pulaski","2020-07-18","3","835","0","54","1.2","0.9"
"Pulaski","2020-07-19","3","838","1","55","6","3.3"
"Pulaski","2020-07-20","7","845","1","56","6.8","4"
"Pulaski","2020-07-21","3","848","0","56","6.8","4"
"Pulaski","2020-07-22","7","855","0","56","6.8","4"
"Pulaski","2020-07-23","10","865","1","57","8.2","4.7"
"Pulaski","2020-07-24","3","868","0","57","8.2","4.7"
"Pulaski","2020-07-25","2","870","0","57","8.2","4.7"
"Pulaski","2020-07-26","1","871","0","57","3.5","4.7"
"Pulaski","2020-07-27","15","886","2","59","3.3","5.1"
"Pulaski","2020-07-28","5","891","0","59","3.3","5.1"
"Pulaski","2020-07-29","4","895","1","60","6.9","6.9"
"Pulaski","2020-07-30","2","897","0","60","5.5","6.9"
"Pulaski","2020-07-31","11","908","1","61","6.8","7.5"
"Pulaski","2020-08-01","5","913","1","62","9.6","8.9"
"Pulaski","2020-08-02","1","914","0","62","9.6","6.6"
"Pulaski","2020-08-03","50","964","6","68","9.4","6.4"
"Pulaski","2020-08-04","5","969","2","70","15.2","9.2"
"Pulaski","2020-08-05","7","976","1","71","13.6","10.3"
"Pulaski","2020-08-06","6","982","0","71","13.6","9.6"
"Pulaski","2020-08-07","8","990","1","72","14.1","10.4"
"Pulaski","2020-08-08","4","994","1","73","14.8","12.2"
"Pulaski","2020-08-09","3","997","1","74","19.6","14.6"
"Pulaski","2020-08-10","32","1029","1","75","18.3","13.9"
"Pulaski","2020-08-11","7","1036","2","77","16.7","15.9"
"Pulaski","2020-08-12","11","1047","2","79","17.2","15.4"
"Pulaski","2020-08-13","11","1058","2","81","19.8","16.7"
"Pulaski","2020-08-14","10","1068","1","82","19.5","16.8"
"Pulaski","2020-08-15","5","1073","1","83","18.8","16.8"
"Pulaski","2020-08-16","6","1079","0","83","14","16.8"
"Pulaski","2020-08-17","11","1090","2","85","16.2","17.2"
"Pulaski","2020-08-18","20","1110","4","89","14.9","15.8"
"Pulaski","2020-08-19","10","1120","3","92","16.6","16.9"
"Pulaski","2020-08-20","6","1126","3","95","21.2","20.5"
"Pulaski","2020-08-21","5","1131","1","96","22.6","21"
"Pulaski","2020-08-22","3","1134","2","98","29.3","24"
"Pulaski","2020-08-23","8","1142","2","100","32.8","23.4"
"Pulaski","2020-08-24","135","1277","17","117","32","24.1"
"Pulaski","2020-08-25","11","1288","9","126","40.9","27.9"
"Pulaski","2020-08-26","11","1299","7","133","45.7","31.1"
"Pulaski","2020-08-27","5","1304","1","134","41.4","31.3"
"Pulaski","2020-08-28","17","1321","10","144","46.9","34.8"
"Pulaski","2020-08-29","2","1323","1","145","44.6","36.9"
"Pulaski","2020-08-30","2","1325","2","147","55.3","44.1"
"Pulaski","2020-08-31","162","1487","18","165","55.1","43.5"
"Pulaski","2020-09-01","8","1495","3","168","48.7","44.8"
"Pulaski","2020-09-02","7","1502","6","174","51.9","48.8"
"Pulaski","2020-09-03","6","1508","4","178","58.5","50"
"Pulaski","2020-09-04","2","1510","1","179","57.3","52.1"
"Pulaski","2020-09-05","0","1510","0","179","50.1","47.3"
"Pulaski","2020-09-06","3","1513","0","179","35.9","45.6"
"Pulaski","2020-09-07","0","1513","0","179","34.3","44.7"
"Pulaski","2020-09-08","15","1528","11","190","39.4","44.1"
"Pulaski","2020-09-09","13","1541","10","200","38.1","45"
"Pulaski","2020-09-10","34","1575","3","203","29.9","44.2"
"Pulaski","2020-09-11","4","1579","0","203","22.7","40"
"Pulaski","2020-09-12","1","1580","0","203","22.7","36.4"
"Pulaski","2020-09-13","2","1582","0","203","22.7","29.3"
"Pulaski","2020-09-14","47","1629","4","207","23.9","29.1"
"Pulaski","2020-09-15","3","1632","1","208","18.2","28.8"
"Pulaski","2020-09-16","7","1639","1","209","9.3","23.7"
"Pulaski","2020-09-17","9","1648","2","211","11.2","20.5"
"Pulaski","2020-09-18","7","1655","1","212","13.2","18"
"Pulaski","2020-09-19","3","1658","0","212","13.2","18"
"Pulaski","2020-09-20","3","1661","0","212","13.2","18"
"Pulaski","2020-09-21","49","1710","0","212","12","18"
"Pulaski","2020-09-22","4","1714","1","213","10.8","14.5"
"Pulaski","2020-09-23","0","1714","0","213","8.8","9"
"Pulaski","2020-09-24","8","1722","1","214","7.4","9.3"
"Pulaski","2020-09-25","2","1724","0","214","5.4","9.3"
"Pulaski","2020-09-26","1","1725","0","214","5.4","9.3"
"Pulaski","2020-09-27","1","1726","1","215","19.6","16.4"
"Pulaski","2020-09-28","55","1781","1","216","19.9","16"
"Pulaski","2020-09-29","5","1786","2","218","22","16.4"
"Pulaski","2020-09-30","0","1786","0","218","22","15.4"
"Pulaski","2020-10-01","6","1792","0","218","20.3","13.8"
"Pulaski","2020-10-02","2","1794","0","218","20.3","12.8"
"Pulaski","2020-10-03","0","1794","0","218","20.3","12.8"
"Pulaski","2020-10-04","0","1794","0","218","6","12.8"
"Pulaski","2020-10-05","48","1842","0","218","5.7","12.8"
"Pulaski","2020-10-06","5","1847","0","218","0","11"
"Pulaski","2020-10-07","2","1849","0","218","0","11"
"Pulaski","2020-10-08","2","1851","0","218","0","10.1"
"Pulaski","2020-10-09","1","1852","0","218","0","10.1"
"Pulaski","2020-10-10","4","1856","1","219","3.6","11.9"
"Pulaski","2020-10-11","1","1857","0","219","3.6","4.8"
"Pulaski","2020-10-12","11","1868","1","220","4.9","5.3"
"Pulaski","2020-10-13","4","1872","0","220","4.9","2.4"
"Pulaski","2020-10-14","6","1878","2","222","9.6","4.8"
"Pulaski","2020-10-15","5","1883","1","223","12.5","6.2"
"Pulaski","2020-10-16","7","1890","0","223","12.5","6.2"
"Pulaski","2020-10-17","2","1892","1","224","16.1","9.8"
"Pulaski","2020-10-18","1","1893","0","224","16.1","9.8"
"Pulaski","2020-10-19","59","1952","8","232","16.7","10.8"
"Pulaski","2020-10-20","4","1956","1","233","20.3","12.6"
"Pulaski","2020-10-21","5","1961","1","234","18.4","14"
"Pulaski","2020-10-22","4","1965","0","234","15.5","14"
"Pulaski","2020-10-23","7","1972","1","235","17.5","15"
"Pulaski","2020-10-24","0","1972","0","235","10.4","13.2"
"Pulaski","2020-10-25","3","1975","1","236","15.2","15.6"
"Pulaski","2020-10-26","70","2045","4","240","14","15.4"
"Pulaski","2020-10-27","6","2051","1","241","12.9","16.6"
"Pulaski","2020-10-28","3","2054","1","242","14.8","16.6"
"Pulaski","2020-10-29","3","2057","0","242","14.8","15.1"
"Pulaski","2020-10-30","6","2063","0","242","12.7","15.1"
"Pulaski","2020-10-31","2","2065","0","242","12.7","11.6"
"Pulaski","2020-11-01","3","2068","0","242","8","11.6"
"Pulaski","2020-11-02","26","2094","1","243","7.7","10.9"
"Pulaski","2020-11-03","24","2118","4","247","7.7","10.3"
"Pulaski","2020-11-04","30","2148","3","250","4.4","9.6"
"Pulaski","2020-11-05","4","2152","1","251","7.9","11.3"
"Pulaski","2020-11-06","3","2155","0","251","7.9","10.3"
"Pulaski","2020-11-07","0","2155","0","251","7.9","10.3"
"Pulaski","2020-11-08","1","2156","0","251","7.9","7.9"
"Pulaski","2020-11-09","60","2216","10","261","9.8","8.7"
"Pulaski","2020-11-10","19","2235","0","261","7.4","7.5"
"Pulaski","2020-11-11","6","2241","0","261","6","5.2"
"Pulaski","2020-11-12","4","2245","0","261","2.4","5.2"
"Pulaski","2020-11-13","5","2250","0","261","2.4","5.2"
"Pulaski","2020-11-14","3","2253","0","261","2.4","5.2"
"Pulaski","2020-11-15","6","2259","0","261","2.4","5.2"
"Pulaski","2020-11-16","15","2274","1","262","1","5.4"
"Pulaski","2020-11-17","7","2281","1","263","3","5.2"
"Pulaski","2020-11-18","2","2283","0","263","3","4.5"
"Pulaski","2020-11-19","2","2285","1","264","10.1","6.3"
"Pulaski","2020-11-20","6","2291","0","264","10.1","6.3"
"Pulaski","2020-11-21","2","2293","1","265","17.3","9.8"
"Pulaski","2020-11-22","3","2296","0","265","17.3","9.8"
"Pulaski","2020-11-23","32","2328","3","268","17.7","9.3"
"Pulaski","2020-11-24","7","2335","2","270","19.7","11.3"
"Pulaski","2020-11-25","2","2337","1","271","26.8","14.9"
"Pulaski","2020-11-26","0","2337","0","271","19.7","14.9"
"Pulaski","2020-11-27","9","2346","0","271","19.7","14.9"
"Pulaski","2020-11-28","4","2350","1","272","16.1","16.7"
"Pulaski","2020-11-29","3","2353","1","273","20.9","19.1"
"Pulaski","2020-11-30","76","2429","7","280","20.9","19.3"
"Pulaski","2020-12-01","6","2435","1","281","19.2","19.4"
"Pulaski","2020-12-02","2","2437","1","282","19.2","23"
"Pulaski","2020-12-03","13","2450","0","282","19.2","19.4"
"Pulaski","2020-12-04","10","2460","0","282","19.2","19.4"
"Pulaski","2020-12-05","2","2462","0","282","15.6","15.9"
"Pulaski","2020-12-06","2","2464","0","282","10.8","15.9"
"Pulaski","2020-12-07","60","2524","4","286","10.5","15.7"
"Pulaski","2020-12-08","5","2529","3","289","16.7","17.9"
"Pulaski","2020-12-09","3","2532","0","289","9.5","14.3"
"Pulaski","2020-12-10","4","2536","0","289","9.5","14.3"
"Pulaski","2020-12-11","10","2546","0","289","9.5","14.3"
"Pulaski","2020-12-12","3","2549","1","290","14.3","14.9"
"Pulaski","2020-12-13","1","2550","0","290","14.3","12.6"
"Pulaski","2020-12-14","50","2600","3","293","14.2","12.3"
"Pulaski","2020-12-15","10","2610","0","293","5.6","11.1"
"Pulaski","2020-12-16","6","2616","1","294","8","8.8"
"Pulaski","2020-12-17","7","2623","0","294","8","8.8"
"Pulaski","2020-12-18","3","2626","0","294","8","8.8"
"Pulaski","2020-12-19","3","2629","0","294","3.2","8.8"
"Pulaski","2020-12-20","3","2632","1","295","8","11.1"
"Pulaski","2020-12-21","88","2720","9","304","8.6","11.4"
"Pulaski","2020-12-22","3","2723","0","304","8.6","7.1"
"Pulaski","2020-12-23","7","2730","2","306","10.3","9.2"
"Pulaski","2020-12-24","9","2739","1","307","11.9","9.9"
"Pulaski","2020-12-25","3","2742","1","308","16.7","12.3"
"Pulaski","2020-12-26","1","2743","0","308","16.7","9.9"
"Pulaski","2020-12-27","1","2744","0","308","11.9","9.9"
"Pulaski","2020-12-28","118","2862","14","322","12.1","10.4"
"Pulaski","2020-12-29","9","2871","0","322","12.1","10.4"
"Pulaski","2020-12-30","10","2881","4","326","13.8","12"
"Pulaski","2020-12-31","11","2892","2","328","14.8","13.3"
"Pulaski","2021-01-01","0","2892","0","328","10","13.3"
"Pulaski","2021-01-02","1","2893","0","328","10","13.3"
"Pulaski","2021-01-03","12","2905","3","331","13.6","12.7"
"Pulaski","2021-01-04","164","3069","20","351","13.6","12.9"
"Pulaski","2021-01-05","16","3085","2","353","15.4","13.8"
"Pulaski","2021-01-06","9","3094","4","357","16","14.9"
"Pulaski","2021-01-07","8","3102","1","358","15.2","15"
"Pulaski","2021-01-08","9","3111","2","360","18.4","14.2"
"Pulaski","2021-01-09","3","3114","0","360","18.4","14.2"
"Pulaski","2021-01-10","6","3120","1","361","17.2","15.4"
"Pulaski","2021-01-11","5","3125","2","363","21.2","17.4"
"Pulaski","2021-01-12","19","3144","3","366","21.7","18.5"
"Pulaski","2021-01-13","5","3149","2","368","21","18.5"
"Pulaski","2021-01-14","9","3158","1","369","20.8","18"
"Pulaski","2021-01-15","14","3172","5","374","22.8","20.6"
"Pulaski","2021-01-16","6","3178","0","374","22.8","20.6"
"Pulaski","2021-01-17","2","3180","0","374","20.4","18.8"
"Pulaski","2021-01-18","75","3255","16","390","17.7","19.4"
"Pulaski","2021-01-19","12","3267","2","392","17.8","19.7"
"Pulaski","2021-01-20","8","3275","2","394","15.7","18.4"
"Pulaski","2021-01-21","2","3277","0","394","14.1","17.5"
"Pulaski","2021-01-22","4","3281","1","395","12.6","17.7"
"Pulaski","2021-01-23","1","3282","0","395","12.6","17.7"
"Pulaski","2021-01-24","3","3285","2","397","22.1","21.2"
"Pulaski","2021-01-25","2","3287","0","397","19","18.4"
"Pulaski","2021-01-26","1","3288","0","397","16.7","17.2"
"Pulaski","2021-01-27","0","3288","0","397","13.1","14.4"
"Putnam","2020-02-01","0","0","0","0",".","."
"Putnam","2020-02-02","0","0","0","0",".","."
"Putnam","2020-02-03","0","0","0","0",".","."
"Putnam","2020-02-04","0","0","0","0",".","."
"Putnam","2020-02-05","0","0","0","0",".","."
"Putnam","2020-02-06","0","0","0","0",".","."
"Putnam","2020-02-07","0","0","0","0","0","."
"Putnam","2020-02-08","0","0","0","0","0","."
"Putnam","2020-02-09","0","0","0","0","0","."
"Putnam","2020-02-10","0","0","0","0","0","."
"Putnam","2020-02-11","0","0","0","0","0","."
"Putnam","2020-02-12","0","0","0","0","0","."
"Putnam","2020-02-13","0","0","0","0","0","."
"Putnam","2020-02-14","0","0","0","0","0","0"
"Putnam","2020-02-15","0","0","0","0","0","0"
"Putnam","2020-02-16","0","0","0","0","0","0"
"Putnam","2020-02-17","0","0","0","0","0","0"
"Putnam","2020-02-18","0","0","0","0","0","0"
"Putnam","2020-02-19","0","0","0","0","0","0"
"Putnam","2020-02-20","0","0","0","0","0","0"
"Putnam","2020-02-21","0","0","0","0","0","0"
"Putnam","2020-02-22","0","0","0","0","0","0"
"Putnam","2020-02-23","0","0","0","0","0","0"
"Putnam","2020-02-24","0","0","0","0","0","0"
"Putnam","2020-02-25","0","0","0","0","0","0"
"Putnam","2020-02-26","0","0","0","0","0","0"
"Putnam","2020-02-27","0","0","0","0","0","0"
"Putnam","2020-02-28","0","0","0","0","0","0"
"Putnam","2020-02-29","0","0","0","0","0","0"
"Putnam","2020-03-01","0","0","0","0","0","0"
"Putnam","2020-03-02","0","0","0","0","0","0"
"Putnam","2020-03-03","0","0","0","0","0","0"
"Putnam","2020-03-04","0","0","0","0","0","0"
"Putnam","2020-03-05","0","0","0","0","0","0"
"Putnam","2020-03-06","0","0","0","0","0","0"
"Putnam","2020-03-07","0","0","0","0","0","0"
"Putnam","2020-03-08","0","0","0","0","0","0"
"Putnam","2020-03-09","0","0","0","0","0","0"
"Putnam","2020-03-10","1","1","0","0","0","0"
"Putnam","2020-03-11","0","1","0","0","0","0"
"Putnam","2020-03-12","3","4","0","0","0","0"
"Putnam","2020-03-13","2","6","0","0","0","0"
"Putnam","2020-03-14","0","6","0","0","0","0"
"Putnam","2020-03-15","0","6","0","0","0","0"
"Putnam","2020-03-16","3","9","0","0","0","0"
"Putnam","2020-03-17","1","10","0","0","0","0"
"Putnam","2020-03-18","6","16","0","0","0","0"
"Putnam","2020-03-19","1","17","0","0","0","0"
"Putnam","2020-03-20","3","20","0","0","0","0"
"Putnam","2020-03-21","1","21","0","0","0","0"
"Putnam","2020-03-22","2","23","0","0","0","0"
"Putnam","2020-03-23","2","25","0","0","0","0"
"Putnam","2020-03-24","1","26","0","0","0","0"
"Putnam","2020-03-25","1","27","0","0","0","0"
"Putnam","2020-03-26","6","33","0","0","0","0"
"Putnam","2020-03-27","4","37","0","0","0","0"
"Putnam","2020-03-28","0","37","0","0","0","0"
"Putnam","2020-03-29","0","37","0","0","0","0"
"Putnam","2020-03-30","2","39","1","1","7.1","3.6"
"Putnam","2020-03-31","4","43","0","1","7.1","3.6"
"Putnam","2020-04-01","7","50","0","1","7.1","3.6"
"Putnam","2020-04-02","7","57","0","1","7.1","3.6"
"Putnam","2020-04-03","3","60","0","1","7.1","3.6"
"Putnam","2020-04-04","11","71","0","1","7.1","3.6"
"Putnam","2020-04-05","8","79","3","4","12.5","6.3"
"Putnam","2020-04-06","5","84","0","4","5.4","6.3"
"Putnam","2020-04-07","1","85","0","4","5.4","6.3"
"Putnam","2020-04-08","8","93","0","4","5.4","6.3"
"Putnam","2020-04-09","5","98","1","5","8.2","7.7"
"Putnam","2020-04-10","3","101","1","6","13","10.1"
"Putnam","2020-04-11","5","106","4","10","24.4","15.8"
"Putnam","2020-04-12","1","107","0","10","19","15.8"
"Putnam","2020-04-13","6","113","0","10","19","12.2"
"Putnam","2020-04-14","14","127","3","13","22.1","13.7"
"Putnam","2020-04-15","13","140","1","14","23.2","14.3"
"Putnam","2020-04-16","16","156","6","20","25.7","17"
"Putnam","2020-04-17","24","180","4","24","23.3","18.2"
"Putnam","2020-04-18","15","195","0","24","11.9","18.2"
"Putnam","2020-04-19","4","199","0","24","11.9","15.5"
"Putnam","2020-04-20","12","211","0","24","11.9","15.5"
"Putnam","2020-04-21","16","227","0","24","8.8","15.5"
"Putnam","2020-04-22","12","239","0","24","7.7","15.5"
"Putnam","2020-04-23","27","266","6","30","5.6","15.6"
"Putnam","2020-04-24","8","274","0","30","3.2","13.3"
"Putnam","2020-04-25","20","294","5","35","6.7","9.3"
"Putnam","2020-04-26","4","298","0","35","6.7","9.3"
"Putnam","2020-04-27","10","308","3","38","11","11.5"
"Putnam","2020-04-28","19","327","1","39","11.8","10.3"
"Putnam","2020-04-29","7","334","2","41","15.9","11.8"
"Putnam","2020-04-30","10","344","0","41","12.7","9.1"
"Putnam","2020-05-01","20","364","3","44","14.8","9"
"Putnam","2020-05-02","14","378","2","46","13.3","10"
"Putnam","2020-05-03","7","385","2","48","17.4","12.1"
"Putnam","2020-05-04","15","400","2","50","15","13"
"Putnam","2020-05-05","13","413","1","51","15.4","13.6"
"Putnam","2020-05-06","50","463","1","52","11.6","13.7"
"Putnam","2020-05-07","24","487","1","53","12.1","12.4"
"Putnam","2020-05-08","12","499","0","53","10","12.4"
"Putnam","2020-05-09","12","511","1","54","9.2","11.2"
"Putnam","2020-05-10","3","514","0","54","5.1","11.2"
"Putnam","2020-05-11","9","523","0","54","3.2","9.1"
"Putnam","2020-05-12","15","538","1","55","3","9.2"
"Putnam","2020-05-13","18","556","0","55","2.7","7.1"
"Putnam","2020-05-14","7","563","0","55","2.1","7.1"
"Putnam","2020-05-15","20","583","0","55","2.1","6.1"
"Putnam","2020-05-16","11","594","1","56","2.3","5.7"
"Putnam","2020-05-17","6","600","0","56","2.3","3.7"
"Putnam","2020-05-18","18","618","1","57","3","3.1"
"Putnam","2020-05-19","16","634","1","58","3","3"
"Putnam","2020-05-20","9","643","1","59","4.6","3.7"
"Putnam","2020-05-21","46","689","2","61","5.2","3.7"
"Putnam","2020-05-22","14","703","0","61","5.2","3.7"
"Putnam","2020-05-23","6","709","0","61","3.9","3.1"
"Putnam","2020-05-24","3","712","0","61","3.9","3.1"
"Putnam","2020-05-25","7","719","0","61","3.1","3.1"
"Putnam","2020-05-26","19","738","1","62","3","3"
"Putnam","2020-05-27","23","761","1","63","2","3.3"
"Putnam","2020-05-28","22","783","0","63","1.4","3.3"
"Putnam","2020-05-29","12","795","0","63","1.4","3.3"
"Putnam","2020-05-30","7","802","0","63","1.4","2.6"
"Putnam","2020-05-31","3","805","0","63","1.4","2.6"
"Putnam","2020-06-01","7","812","1","64","3.4","3.3"
"Putnam","2020-06-02","26","838","2","66","3.8","3.4"
"Putnam","2020-06-03","19","857","1","67","3.9","2.9"
"Putnam","2020-06-04","78","935","0","67","3.9","2.6"
"Putnam","2020-06-05","29","964","2","69","4.9","3.1"
"Putnam","2020-06-06","7","971","1","70","6.9","4.1"
"Putnam","2020-06-07","2","973","0","70","6.9","4.1"
"Putnam","2020-06-08","19","992","2","72","6.4","4.9"
"Putnam","2020-06-09","28","1020","1","73","5.8","4.8"
"Putnam","2020-06-10","28","1048","2","75","6.1","5"
"Putnam","2020-06-11","59","1107","3","78","6.8","5.3"
"Putnam","2020-06-12","21","1128","0","78","5.8","5.3"
"Putnam","2020-06-13","2","1130","0","78","3.8","5.3"
"Putnam","2020-06-14","4","1134","0","78","3.8","5.3"
"Putnam","2020-06-15","23","1157","2","80","3.5","4.9"
"Putnam","2020-06-16","17","1174","2","82","4.7","5.2"
"Putnam","2020-06-17","14","1188","1","83","4.7","5.4"
"Putnam","2020-06-18","65","1253","2","85","4.4","5.6"
"Putnam","2020-06-19","31","1284","3","88","5.8","5.8"
"Putnam","2020-06-20","9","1293","1","89","7.4","5.6"
"Putnam","2020-06-21","3","1296","0","89","7.4","5.6"
"Putnam","2020-06-22","28","1324","2","91","7.1","5.3"
"Putnam","2020-06-23","41","1365","17","108","11.4","8"
"Putnam","2020-06-24","22","1387","2","110","11.7","8.2"
"Putnam","2020-06-25","117","1504","21","131","13.8","9.1"
"Putnam","2020-06-26","41","1545","8","139","15.2","10.5"
"Putnam","2020-06-27","24","1569","3","142","15.4","11.4"
"Putnam","2020-06-28","5","1574","1","143","18.2","12.8"
"Putnam","2020-06-29","42","1616","7","150","19.6","13.4"
"Putnam","2020-06-30","30","1646","3","153","15.1","13.2"
"Putnam","2020-07-01","32","1678","4","157","15.6","13.6"
"Putnam","2020-07-02","100","1778","4","161","13.6","13.7"
"Putnam","2020-07-03","11","1789","1","162","12.1","13.6"
"Putnam","2020-07-04","6","1795","1","163","12.7","14"
"Putnam","2020-07-05","7","1802","2","165","13.9","16.1"
"Putnam","2020-07-06","64","1866","9","174","13.6","16.6"
"Putnam","2020-07-07","21","1887","4","178","14.8","15"
"Putnam","2020-07-08","89","1976","4","182","13.7","14.6"
"Putnam","2020-07-09","97","2073","9","191","14.5","14"
"Putnam","2020-07-10","22","2095","4","195","15.8","13.9"
"Putnam","2020-07-11","7","2102","1","196","15.4","14.1"
"Putnam","2020-07-12","9","2111","1","197","12.9","13.4"
"Putnam","2020-07-13","24","2135","2","199","12.1","12.8"
"Putnam","2020-07-14","31","2166","5","204","11.7","13.3"
"Putnam","2020-07-15","45","2211","8","212","13.6","13.6"
"Putnam","2020-07-16","94","2305","7","219","13.3","13.9"
"Putnam","2020-07-17","23","2328","5","224","13.8","14.8"
"Putnam","2020-07-18","7","2335","0","224","11.8","13.6"
"Putnam","2020-07-19","2","2337","0","224","10.2","11.6"
"Putnam","2020-07-20","121","2458","9","233","10.1","11.1"
"Putnam","2020-07-21","30","2488","6","239","10.6","11.2"
"Putnam","2020-07-22","22","2510","8","247","13.3","13.4"
"Putnam","2020-07-23","81","2591","9","256","13.8","13.6"
"Putnam","2020-07-24","20","2611","2","258","12.1","13"
"Putnam","2020-07-25","9","2620","3","261","16.9","14.3"
"Putnam","2020-07-26","9","2629","1","262","18.5","14.3"
"Putnam","2020-07-27","81","2710","3","265","17.9","14"
"Putnam","2020-07-28","24","2734","9","274","20.4","15.5"
"Putnam","2020-07-29","27","2761","3","277","16.8","15.1"
"Putnam","2020-07-30","106","2867","8","285","16.3","15.1"
"Putnam","2020-07-31","29","2896","8","293","18.8","15.5"
"Putnam","2020-08-01","12","2908","0","293","14.1","15.5"
"Putnam","2020-08-02","10","2918","1","294","13.9","16.2"
"Putnam","2020-08-03","95","3013","8","302","14.6","16.3"
"Putnam","2020-08-04","16","3029","5","307","13.7","17.1"
"Putnam","2020-08-05","21","3050","4","311","14.8","15.8"
"Putnam","2020-08-06","62","3112","5","316","14.9","15.6"
"Putnam","2020-08-07","36","3148","4","320","12.6","15.7"
"Putnam","2020-08-08","13","3161","0","320","12.6","13.3"
"Putnam","2020-08-09","12","3173","4","324","15.9","14.9"
"Putnam","2020-08-10","44","3217","3","327","15.7","15.1"
"Putnam","2020-08-11","21","3238","1","328","11.9","12.8"
"Putnam","2020-08-12","18","3256","4","332","12.3","13.6"
"Putnam","2020-08-13","25","3281","4","336","13.5","14.2"
"Putnam","2020-08-14","22","3303","3","339","13.8","13.2"
"Putnam","2020-08-15","2","3305","0","339","13.8","13.2"
"Putnam","2020-08-16","7","3312","1","340","11.1","13.5"
"Putnam","2020-08-17","20","3332","2","342","11.6","13.6"
"Putnam","2020-08-18","25","3357","3","345","12.6","12.2"
"Putnam","2020-08-19","24","3381","4","349","11.8","12.1"
"Putnam","2020-08-20","53","3434","13","362","13","13.2"
"Putnam","2020-08-21","32","3466","0","362","11.1","12.4"
"Putnam","2020-08-22","6","3472","1","363","13.4","13.6"
"Putnam","2020-08-23","10","3482","2","365","14.3","12.7"
"Putnam","2020-08-24","43","3525","3","368","13.8","12.7"
"Putnam","2020-08-25","25","3550","2","370","13.3","12.9"
"Putnam","2020-08-26","25","3575","3","373","12.6","12.2"
"Putnam","2020-08-27","49","3624","5","378","10.5","11.8"
"Putnam","2020-08-28","26","3650","1","379","11.1","11.1"
"Putnam","2020-08-29","7","3657","1","380","10.8","12.1"
"Putnam","2020-08-30","9","3666","1","381","9.5","11.9"
"Putnam","2020-08-31","46","3712","3","384","9.4","11.6"
"Putnam","2020-09-01","29","3741","2","386","9.3","11.3"
"Putnam","2020-09-02","15","3756","2","388","9.5","11"
"Putnam","2020-09-03","53","3809","4","392","9.1","9.8"
"Putnam","2020-09-04","28","3837","0","392","8.5","9.8"
"Putnam","2020-09-05","11","3848","0","392","6.5","8.6"
"Putnam","2020-09-06","9","3857","3","395","9.7","9.6"
"Putnam","2020-09-07","36","3893","1","396","9.1","9.3"
"Putnam","2020-09-08","25","3918","1","397","8.7","9"
"Putnam","2020-09-09","33","3951","2","399","7.7","8.6"
"Putnam","2020-09-10","26","3977","1","400","7.1","8.1"
"Putnam","2020-09-11","27","4004","2","402","8.2","8.4"
"Putnam","2020-09-12","9","4013","1","403","9.8","8.1"
"Putnam","2020-09-13","3","4016","1","404","9.8","9.7"
"Putnam","2020-09-14","50","4066","3","407","10.3","9.7"
"Putnam","2020-09-15","24","4090","0","407","9.7","9.2"
"Putnam","2020-09-16","41","4131","0","407","8.8","8.2"
"Putnam","2020-09-17","47","4178","3","410","9.2","8.2"
"Putnam","2020-09-18","37","4215","1","411","8.5","8.4"
"Putnam","2020-09-19","13","4228","2","413","9.1","9.5"
"Putnam","2020-09-20","21","4249","0","413","4.4","7.1"
"Putnam","2020-09-21","41","4290","2","415","4.2","7.2"
"Putnam","2020-09-22","33","4323","2","417","5.1","7.4"
"Putnam","2020-09-23","13","4336","1","418","6.2","7.5"
"Putnam","2020-09-24","33","4369","5","423","7.4","8.3"
"Putnam","2020-09-25","45","4414","1","424","7.3","7.9"
"Putnam","2020-09-26","27","4441","3","427","6.7","7.9"
"Putnam","2020-09-27","4","4445","0","427","6.7","5.5"
"Putnam","2020-09-28","54","4499","2","429","6.6","5.4"
"Putnam","2020-09-29","22","4521","2","431","7","6"
"Putnam","2020-09-30","21","4542","4","435","8.6","7.4"
"Putnam","2020-10-01","44","4586","7","442","8.7","8.1"
"Putnam","2020-10-02","33","4619","6","448","11","9.2"
"Putnam","2020-10-03","22","4641","1","449","10.1","8.4"
"Putnam","2020-10-04","8","4649","1","450","11.9","9.3"
"Putnam","2020-10-05","59","4708","8","458","13.3","9.9"
"Putnam","2020-10-06","32","4740","4","462","13.7","10.4"
"Putnam","2020-10-07","26","4766","2","464","12.1","10.4"
"Putnam","2020-10-08","44","4810","5","469","11.5","10.1"
"Putnam","2020-10-09","34","4844","1","470","9.3","10.2"
"Putnam","2020-10-10","7","4851","0","470","8.7","9.4"
"Putnam","2020-10-11","8","4859","1","471","8.7","10.3"
"Putnam","2020-10-12","27","4886","2","473","7.8","10.5"
"Putnam","2020-10-13","37","4923","5","478","7.9","10.8"
"Putnam","2020-10-14","21","4944","1","479","7.5","9.8"
"Putnam","2020-10-15","42","4986","5","484","7.6","9.5"
"Putnam","2020-10-16","22","5008","0","484","7.2","8.2"
"Putnam","2020-10-17","6","5014","0","484","7.2","7.9"
"Putnam","2020-10-18","8","5022","0","484","5.4","7"
"Putnam","2020-10-19","35","5057","3","487","5.5","6.7"
"Putnam","2020-10-20","24","5081","0","487","3.6","5.8"
"Putnam","2020-10-21","26","5107","1","488","3.5","5.5"
"Putnam","2020-10-22","44","5151","5","493","3.4","5.5"
"Putnam","2020-10-23","31","5182","1","494","3.9","5.5"
"Putnam","2020-10-24","10","5192","1","495","5.3","6.2"
"Putnam","2020-10-25","9","5201","0","495","5.3","5.3"
"Putnam","2020-10-26","42","5243","2","497","4.7","5.1"
"Putnam","2020-10-27","35","5278","2","499","5.6","4.6"
"Putnam","2020-10-28","40","5318","7","506","7.5","5.5"
"Putnam","2020-10-29","34","5352","3","509","7.1","5.3"
"Putnam","2020-10-30","31","5383","1","510","7.1","5.5"
"Putnam","2020-10-31","16","5399","0","510","5.7","5.5"
"Putnam","2020-11-01","8","5407","1","511","7.5","6.4"
"Putnam","2020-11-02","39","5446","3","514","7.9","6.3"
"Putnam","2020-11-03","40","5486","9","523","10.3","7.9"
"Putnam","2020-11-04","42","5528","3","526","8.8","8.2"
"Putnam","2020-11-05","35","5563","3","529","8.8","8"
"Putnam","2020-11-06","38","5601","2","531","9.1","8.1"
"Putnam","2020-11-07","11","5612","0","531","9.1","7.4"
"Putnam","2020-11-08","15","5627","0","531","7.3","7.4"
"Putnam","2020-11-09","23","5650","1","532","6.8","7.4"
"Putnam","2020-11-10","37","5687","3","535","4.8","7.5"
"Putnam","2020-11-11","24","5711","2","537","4.9","6.9"
"Putnam","2020-11-12","56","5767","3","540","4.5","6.6"
"Putnam","2020-11-13","27","5794","2","542","4.8","6.9"
"Putnam","2020-11-14","10","5804","0","542","4.8","6.9"
"Putnam","2020-11-15","8","5812","1","543","6.6","6.9"
"Putnam","2020-11-16","56","5868","1","544","6.2","6.5"
"Putnam","2020-11-17","38","5906","1","545","5.4","5.1"
"Putnam","2020-11-18","36","5942","3","548","5.4","5.2"
"Putnam","2020-11-19","29","5971","4","552","6.6","5.6"
"Putnam","2020-11-20","30","6001","2","554","6.5","5.7"
"Putnam","2020-11-21","8","6009","2","556","10.1","7.4"
"Putnam","2020-11-22","10","6019","0","556","8.3","7.4"
"Putnam","2020-11-23","29","6048","2","558","9","7.6"
"Putnam","2020-11-24","34","6082","4","562","10.4","7.9"
"Putnam","2020-11-25","35","6117","2","564","10","7.7"
"Putnam","2020-11-26","13","6130","1","565","9.1","7.9"
"Putnam","2020-11-27","31","6161","4","569","10","8.3"
"Putnam","2020-11-28","9","6170","0","569","6.4","8.3"
"Putnam","2020-11-29","13","6183","1","570","7.5","7.9"
"Putnam","2020-11-30","44","6227","5","575","8.2","8.6"
"Putnam","2020-12-01","37","6264","4","579","8","9.2"
"Putnam","2020-12-02","32","6296","3","582","8.5","9.3"
"Putnam","2020-12-03","61","6357","8","590","9.3","9.2"
"Putnam","2020-12-04","47","6404","3","593","8.4","9.2"
"Putnam","2020-12-05","17","6421","3","596","10.9","8.7"
"Putnam","2020-12-06","10","6431","3","599","14.1","10.8"
"Putnam","2020-12-07","35","6466","4","603","14.1","11.1"
"Putnam","2020-12-08","37","6503","4","607","14.1","11.1"
"Putnam","2020-12-09","41","6544","5","612","14.5","11.5"
"Putnam","2020-12-10","61","6605","15","627","16.2","12.7"
"Putnam","2020-12-11","30","6635","2","629","16.2","12.3"
"Putnam","2020-12-12","13","6648","1","630","14.8","12.8"
"Putnam","2020-12-13","13","6661","3","633","13.8","13.9"
"Putnam","2020-12-14","63","6724","15","648","15.5","14.8"
"Putnam","2020-12-15","62","6786","7","655","15.6","14.9"
"Putnam","2020-12-16","76","6862","11","666","15.9","15.2"
"Putnam","2020-12-17","125","6987","11","677","13.7","14.9"
"Putnam","2020-12-18","46","7033","7","684","14.9","15.5"
"Putnam","2020-12-19","17","7050","4","688","17.2","16"
"Putnam","2020-12-20","19","7069","5","693","17.6","15.7"
"Putnam","2020-12-21","61","7130","15","708","17.7","16.6"
"Putnam","2020-12-22","40","7170","8","716","19","17.3"
"Putnam","2020-12-23","40","7210","7","723","19.4","17.7"
"Putnam","2020-12-24","32","7242","14","737","24.4","19.1"
"Putnam","2020-12-25","6","7248","0","737","22.2","18.6"
"Putnam","2020-12-26","28","7276","12","749","25","21.1"
"Putnam","2020-12-27","26","7302","7","756","25.1","21.4"
"Putnam","2020-12-28","70","7372","19","775","25.5","21.6"
"Putnam","2020-12-29","46","7418","17","792","27.9","23.4"
"Putnam","2020-12-30","29","7447","4","796","27.3","23.4"
"Putnam","2020-12-31","81","7528","16","812","23.9","24.2"
"Putnam","2021-01-01","17","7545","5","817","28.1","25.2"
"Putnam","2021-01-02","25","7570","2","819","23.1","24.1"
"Putnam","2021-01-03","13","7583","3","822","22.6","23.8"
"Putnam","2021-01-04","66","7649","15","837","22","23.7"
"Putnam","2021-01-05","115","7764","6","843","17.4","22.7"
"Putnam","2021-01-06","84","7848","18","861","18.5","22.9"
"Putnam","2021-01-07","137","7985","30","891","18.8","21.4"
"Putnam","2021-01-08","81","8066","24","915","18.9","23.5"
"Putnam","2021-01-09","19","8085","6","921","22.2","22.7"
"Putnam","2021-01-10","22","8107","3","924","20.9","21.7"
"Putnam","2021-01-11","55","8162","9","933","20","21"
"Putnam","2021-01-12","56","8218","14","947","22.8","20.1"
"Putnam","2021-01-13","73","8291","20","967","23.6","21.1"
"Putnam","2021-01-14","94","8385","16","983","22.9","20.9"
"Putnam","2021-01-15","54","8439","9","992","21.1","20"
"Putnam","2021-01-16","18","8457","4","996","19.8","21"
"Putnam","2021-01-17","24","8481","3","999","19.6","20.2"
"Putnam","2021-01-18","43","8524","7","1006","19.6","19.8"
"Putnam","2021-01-19","58","8582","9","1015","18.2","20.5"
"Putnam","2021-01-20","45","8627","7","1022","16.5","20.1"
"Putnam","2021-01-21","80","8707","12","1034","16.2","19.6"
"Putnam","2021-01-22","46","8753","9","1043","16.7","18.9"
"Putnam","2021-01-23","27","8780","2","1045","14.5","17.2"
"Putnam","2021-01-24","7","8787","2","1047","16.8","18.2"
"Putnam","2021-01-25","26","8813","6","1053","17.8","18.7"
"Putnam","2021-01-26","4","8817","0","1053","15.6","16.9"
"Putnam","2021-01-27","0","8817","0","1053","13.4","15"
"Quitman","2020-02-01","0","0","0","0",".","."
"Quitman","2020-02-02","0","0","0","0",".","."
"Quitman","2020-02-03","0","0","0","0",".","."
"Quitman","2020-02-04","0","0","0","0",".","."
"Quitman","2020-02-05","0","0","0","0",".","."
"Quitman","2020-02-06","0","0","0","0",".","."
"Quitman","2020-02-07","0","0","0","0","0","."
"Quitman","2020-02-08","0","0","0","0","0","."
"Quitman","2020-02-09","0","0","0","0","0","."
"Quitman","2020-02-10","0","0","0","0","0","."
"Quitman","2020-02-11","0","0","0","0","0","."
"Quitman","2020-02-12","0","0","0","0","0","."
"Quitman","2020-02-13","0","0","0","0","0","."
"Quitman","2020-02-14","0","0","0","0","0","0"
"Quitman","2020-02-15","0","0","0","0","0","0"
"Quitman","2020-02-16","0","0","0","0","0","0"
"Quitman","2020-02-17","0","0","0","0","0","0"
"Quitman","2020-02-18","0","0","0","0","0","0"
"Quitman","2020-02-19","0","0","0","0","0","0"
"Quitman","2020-02-20","0","0","0","0","0","0"
"Quitman","2020-02-21","0","0","0","0","0","0"
"Quitman","2020-02-22","0","0","0","0","0","0"
"Quitman","2020-02-23","0","0","0","0","0","0"
"Quitman","2020-02-24","0","0","0","0","0","0"
"Quitman","2020-02-25","0","0","0","0","0","0"
"Quitman","2020-02-26","0","0","0","0","0","0"
"Quitman","2020-02-27","0","0","0","0","0","0"
"Quitman","2020-02-28","0","0","0","0","0","0"
"Quitman","2020-02-29","0","0","0","0","0","0"
"Quitman","2020-03-01","0","0","0","0","0","0"
"Quitman","2020-03-02","0","0","0","0","0","0"
"Quitman","2020-03-03","0","0","0","0","0","0"
"Quitman","2020-03-04","0","0","0","0","0","0"
"Quitman","2020-03-05","0","0","0","0","0","0"
"Quitman","2020-03-06","0","0","0","0","0","0"
"Quitman","2020-03-07","0","0","0","0","0","0"
"Quitman","2020-03-08","0","0","0","0","0","0"
"Quitman","2020-03-09","0","0","0","0","0","0"
"Quitman","2020-03-10","0","0","0","0","0","0"
"Quitman","2020-03-11","0","0","0","0","0","0"
"Quitman","2020-03-12","0","0","0","0","0","0"
"Quitman","2020-03-13","0","0","0","0","0","0"
"Quitman","2020-03-14","0","0","0","0","0","0"
"Quitman","2020-03-15","0","0","0","0","0","0"
"Quitman","2020-03-16","0","0","0","0","0","0"
"Quitman","2020-03-17","0","0","0","0","0","0"
"Quitman","2020-03-18","0","0","0","0","0","0"
"Quitman","2020-03-19","1","1","0","0","0","0"
"Quitman","2020-03-20","0","1","0","0","0","0"
"Quitman","2020-03-21","0","1","0","0","0","0"
"Quitman","2020-03-22","0","1","0","0","0","0"
"Quitman","2020-03-23","0","1","0","0","0","0"
"Quitman","2020-03-24","0","1","0","0","0","0"
"Quitman","2020-03-25","0","1","0","0","0","0"
"Quitman","2020-03-26","0","1","0","0","0","0"
"Quitman","2020-03-27","0","1","0","0","0","0"
"Quitman","2020-03-28","0","1","0","0","0","0"
"Quitman","2020-03-29","1","2","0","0","0","0"
"Quitman","2020-03-30","1","3","0","0","0","0"
"Quitman","2020-03-31","2","5","1","1","7.1","3.6"
"Quitman","2020-04-01","0","5","0","1","7.1","3.6"
"Quitman","2020-04-02","2","7","0","1","7.1","3.6"
"Quitman","2020-04-03","2","9","1","2","14.3","7.1"
"Quitman","2020-04-04","1","10","1","3","28.6","14.3"
"Quitman","2020-04-05","0","10","0","3","28.6","14.3"
"Quitman","2020-04-06","4","14","1","4","32.1","16.1"
"Quitman","2020-04-07","2","16","0","4","25","16.1"
"Quitman","2020-04-08","1","17","0","4","25","16.1"
"Quitman","2020-04-09","1","18","0","4","25","16.1"
"Quitman","2020-04-10","0","18","0","4","17.9","16.1"
"Quitman","2020-04-11","0","18","0","4","3.6","16.1"
"Quitman","2020-04-12","0","18","0","4","3.6","16.1"
"Quitman","2020-04-13","1","19","0","4","0","16.1"
"Quitman","2020-04-14","2","21","0","4","0","12.5"
"Quitman","2020-04-15","3","24","0","4","0","12.5"
"Quitman","2020-04-16","1","25","0","4","0","12.5"
"Quitman","2020-04-17","0","25","0","4","0","8.9"
"Quitman","2020-04-18","0","25","0","4","0","1.8"
"Quitman","2020-04-19","0","25","0","4","0","1.8"
"Quitman","2020-04-20","2","27","0","4","0","0"
"Quitman","2020-04-21","9","36","0","4","0","0"
"Quitman","2020-04-22","0","36","0","4","0","0"
"Quitman","2020-04-23","3","39","1","5","4.8","2.4"
"Quitman","2020-04-24","0","39","0","5","4.8","2.4"
"Quitman","2020-04-25","1","40","0","5","4.8","2.4"
"Quitman","2020-04-26","0","40","0","5","4.8","2.4"
"Quitman","2020-04-27","1","41","0","5","4.8","2.4"
"Quitman","2020-04-28","2","43","0","5","4.8","2.4"
"Quitman","2020-04-29","1","44","1","6","19","9.5"
"Quitman","2020-04-30","0","44","0","6","14.3","9.5"
"Quitman","2020-05-01","1","45","0","6","14.3","9.5"
"Quitman","2020-05-02","0","45","0","6","14.3","9.5"
"Quitman","2020-05-03","0","45","0","6","14.3","9.5"
"Quitman","2020-05-04","2","47","0","6","14.3","9.5"
"Quitman","2020-05-05","5","52","0","6","14.3","9.5"
"Quitman","2020-05-06","1","53","0","6","0","9.5"
"Quitman","2020-05-07","2","55","0","6","0","7.1"
"Quitman","2020-05-08","2","57","0","6","0","7.1"
"Quitman","2020-05-09","0","57","0","6","0","7.1"
"Quitman","2020-05-10","1","58","0","6","0","7.1"
"Quitman","2020-05-11","0","58","0","6","0","7.1"
"Quitman","2020-05-12","11","69","1","7","1.3","7.8"
"Quitman","2020-05-13","2","71","0","7","1.3","0.6"
"Quitman","2020-05-14","0","71","0","7","1.3","0.6"
"Quitman","2020-05-15","4","75","0","7","1.3","0.6"
"Quitman","2020-05-16","0","75","0","7","1.3","0.6"
"Quitman","2020-05-17","1","76","0","7","1.3","0.6"
"Quitman","2020-05-18","2","78","0","7","1.3","0.6"
"Quitman","2020-05-19","7","85","1","8","2","1.7"
"Quitman","2020-05-20","0","85","0","8","2","1.7"
"Quitman","2020-05-21","0","85","0","8","2","1.7"
"Quitman","2020-05-22","1","86","0","8","2","1.7"
"Quitman","2020-05-23","1","87","0","8","2","1.7"
"Quitman","2020-05-24","3","90","0","8","2","1.7"
"Quitman","2020-05-25","0","90","0","8","2","1.7"
"Quitman","2020-05-26","5","95","1","9","2.9","2.4"
"Quitman","2020-05-27","7","102","0","9","2.9","2.4"
"Quitman","2020-05-28","2","104","0","9","2.9","2.4"
"Quitman","2020-05-29","2","106","0","9","2.9","2.4"
"Quitman","2020-05-30","0","106","0","9","2.9","2.4"
"Quitman","2020-05-31","0","106","0","9","2.9","2.4"
"Quitman","2020-06-01","1","107","0","9","2.9","2.4"
"Quitman","2020-06-02","4","111","0","9","0","1.4"
"Quitman","2020-06-03","7","118","1","10","2","2.4"
"Quitman","2020-06-04","6","124","0","10","2","2.4"
"Quitman","2020-06-05","3","127","0","10","2","2.4"
"Quitman","2020-06-06","0","127","0","10","2","2.4"
"Quitman","2020-06-07","1","128","0","10","2","2.4"
"Quitman","2020-06-08","1","129","0","10","2","2.4"
"Quitman","2020-06-09","9","138","1","11","3.6","1.8"
"Quitman","2020-06-10","0","138","0","11","1.6","1.8"
"Quitman","2020-06-11","5","143","1","12","4.4","3.2"
"Quitman","2020-06-12","2","145","0","12","4.4","3.2"
"Quitman","2020-06-13","0","145","0","12","4.4","3.2"
"Quitman","2020-06-14","0","145","0","12","4.4","3.2"
"Quitman","2020-06-15","4","149","0","12","4.4","3.2"
"Quitman","2020-06-16","2","151","0","12","2.9","3.2"
"Quitman","2020-06-17","1","152","0","12","2.9","2.2"
"Quitman","2020-06-18","2","154","0","12","0","2.2"
"Quitman","2020-06-19","2","156","0","12","0","2.2"
"Quitman","2020-06-20","1","157","0","12","0","2.2"
"Quitman","2020-06-21","0","157","0","12","0","2.2"
"Quitman","2020-06-22","2","159","0","12","0","2.2"
"Quitman","2020-06-23","2","161","0","12","0","1.4"
"Quitman","2020-06-24","2","163","0","12","0","1.4"
"Quitman","2020-06-25","6","169","0","12","0","0"
"Quitman","2020-06-26","2","171","1","13","7.1","3.6"
"Quitman","2020-06-27","1","172","0","13","7.1","3.6"
"Quitman","2020-06-28","0","172","0","13","7.1","3.6"
"Quitman","2020-06-29","2","174","0","13","7.1","3.6"
"Quitman","2020-06-30","16","190","0","13","7.1","3.6"
"Quitman","2020-07-01","2","192","0","13","7.1","3.6"
"Quitman","2020-07-02","0","192","0","13","7.1","3.6"
"Quitman","2020-07-03","0","192","0","13","0","3.6"
"Quitman","2020-07-04","0","192","0","13","0","3.6"
"Quitman","2020-07-05","0","192","0","13","0","3.6"
"Quitman","2020-07-06","3","195","0","13","0","3.6"
"Quitman","2020-07-07","23","218","4","17","2.5","4.8"
"Quitman","2020-07-08","1","219","1","18","16.8","12"
"Quitman","2020-07-09","0","219","0","18","16.8","12"
"Quitman","2020-07-10","2","221","0","18","16.8","8.4"
"Quitman","2020-07-11","0","221","0","18","16.8","8.4"
"Quitman","2020-07-12","0","221","0","18","16.8","8.4"
"Quitman","2020-07-13","2","223","1","19","23.9","12"
"Quitman","2020-07-14","1","224","0","19","21.4","12"
"Quitman","2020-07-15","0","224","0","19","7.1","12"
"Quitman","2020-07-16","1","225","0","19","7.1","12"
"Quitman","2020-07-17","1","226","0","19","7.1","12"
"Quitman","2020-07-18","0","226","0","19","7.1","12"
"Quitman","2020-07-19","0","226","0","19","7.1","12"
"Quitman","2020-07-20","4","230","0","19","0","12"
"Quitman","2020-07-21","9","239","0","19","0","10.7"
"Quitman","2020-07-22","4","243","0","19","0","3.6"
"Quitman","2020-07-23","2","245","0","19","0","3.6"
"Quitman","2020-07-24","0","245","0","19","0","3.6"
"Quitman","2020-07-25","0","245","0","19","0","3.6"
"Quitman","2020-07-26","0","245","0","19","0","3.6"
"Quitman","2020-07-27","4","249","0","19","0","0"
"Quitman","2020-07-28","6","255","0","19","0","0"
"Quitman","2020-07-29","1","256","0","19","0","0"
"Quitman","2020-07-30","0","256","0","19","0","0"
"Quitman","2020-07-31","2","258","0","19","0","0"
"Quitman","2020-08-01","0","258","0","19","0","0"
"Quitman","2020-08-02","1","259","0","19","0","0"
"Quitman","2020-08-03","1","260","0","19","0","0"
"Quitman","2020-08-04","9","269","0","19","0","0"
"Quitman","2020-08-05","1","270","0","19","0","0"
"Quitman","2020-08-06","0","270","0","19","0","0"
"Quitman","2020-08-07","2","272","0","19","0","0"
"Quitman","2020-08-08","1","273","0","19","0","0"
"Quitman","2020-08-09","2","275","0","19","0","0"
"Quitman","2020-08-10","0","275","0","19","0","0"
"Quitman","2020-08-11","4","279","0","19","0","0"
"Quitman","2020-08-12","4","283","0","19","0","0"
"Quitman","2020-08-13","3","286","1","20","4.8","2.4"
"Quitman","2020-08-14","0","286","0","20","4.8","2.4"
"Quitman","2020-08-15","1","287","0","20","4.8","2.4"
"Quitman","2020-08-16","1","288","0","20","4.8","2.4"
"Quitman","2020-08-17","1","289","0","20","4.8","2.4"
"Quitman","2020-08-18","1","290","0","20","4.8","2.4"
"Quitman","2020-08-19","0","290","0","20","4.8","2.4"
"Quitman","2020-08-20","0","290","0","20","0","2.4"
"Quitman","2020-08-21","0","290","0","20","0","2.4"
"Quitman","2020-08-22","0","290","0","20","0","2.4"
"Quitman","2020-08-23","1","291","0","20","0","2.4"
"Quitman","2020-08-24","0","291","0","20","0","2.4"
"Quitman","2020-08-25","3","294","0","20","0","2.4"
"Quitman","2020-08-26","0","294","0","20","0","2.4"
"Quitman","2020-08-27","1","295","0","20","0","0"
"Quitman","2020-08-28","0","295","0","20","0","0"
"Quitman","2020-08-29","0","295","0","20","0","0"
"Quitman","2020-08-30","0","295","0","20","0","0"
"Quitman","2020-08-31","1","296","0","20","0","0"
"Quitman","2020-09-01","2","298","0","20","0","0"
"Quitman","2020-09-02","2","300","0","20","0","0"
"Quitman","2020-09-03","1","301","0","20","0","0"
"Quitman","2020-09-04","0","301","0","20","0","0"
"Quitman","2020-09-05","0","301","0","20","0","0"
"Quitman","2020-09-06","0","301","0","20","0","0"
"Quitman","2020-09-07","0","301","0","20","0","0"
"Quitman","2020-09-08","7","308","2","22","4.1","2"
"Quitman","2020-09-09","0","308","0","22","4.1","2"
"Quitman","2020-09-10","2","310","0","22","4.1","2"
"Quitman","2020-09-11","0","310","0","22","4.1","2"
"Quitman","2020-09-12","0","310","0","22","4.1","2"
"Quitman","2020-09-13","3","313","0","22","4.1","2"
"Quitman","2020-09-14","1","314","0","22","4.1","2"
"Quitman","2020-09-15","8","322","0","22","0","2"
"Quitman","2020-09-16","0","322","0","22","0","2"
"Quitman","2020-09-17","0","322","0","22","0","2"
"Quitman","2020-09-18","1","323","0","22","0","2"
"Quitman","2020-09-19","0","323","0","22","0","2"
"Quitman","2020-09-20","1","324","0","22","0","2"
"Quitman","2020-09-21","1","325","0","22","0","2"
"Quitman","2020-09-22","0","325","0","22","0","0"
"Quitman","2020-09-23","1","326","0","22","0","0"
"Quitman","2020-09-24","0","326","0","22","0","0"
"Quitman","2020-09-25","5","331","1","23","2.9","1.4"
"Quitman","2020-09-26","0","331","0","23","2.9","1.4"
"Quitman","2020-09-27","0","331","0","23","2.9","1.4"
"Quitman","2020-09-28","1","332","0","23","2.9","1.4"
"Quitman","2020-09-29","15","347","1","24","3.8","1.9"
"Quitman","2020-09-30","1","348","0","24","3.8","1.9"
"Quitman","2020-10-01","2","350","0","24","3.8","1.9"
"Quitman","2020-10-02","1","351","0","24","1","1.9"
"Quitman","2020-10-03","2","353","0","24","1","1.9"
"Quitman","2020-10-04","0","353","0","24","1","1.9"
"Quitman","2020-10-05","2","355","2","26","15.2","9"
"Quitman","2020-10-06","10","365","1","27","15.7","9.8"
"Quitman","2020-10-07","4","369","0","27","15.7","9.8"
"Quitman","2020-10-08","0","369","0","27","15.7","9.8"
"Quitman","2020-10-09","1","370","0","27","15.7","8.3"
"Quitman","2020-10-10","0","370","0","27","15.7","8.3"
"Quitman","2020-10-11","0","370","0","27","15.7","8.3"
"Quitman","2020-10-12","0","370","0","27","1.4","8.3"
"Quitman","2020-10-13","7","377","0","27","0","7.9"
"Quitman","2020-10-14","1","378","0","27","0","7.9"
"Quitman","2020-10-15","4","382","3","30","10.7","13.2"
"Quitman","2020-10-16","2","384","0","30","10.7","13.2"
"Quitman","2020-10-17","0","384","0","30","10.7","13.2"
"Quitman","2020-10-18","0","384","0","30","10.7","13.2"
"Quitman","2020-10-19","0","384","0","30","10.7","6.1"
"Quitman","2020-10-20","3","387","0","30","10.7","5.4"
"Quitman","2020-10-21","2","389","0","30","10.7","5.4"
"Quitman","2020-10-22","0","389","0","30","0","5.4"
"Quitman","2020-10-23","0","389","0","30","0","5.4"
"Quitman","2020-10-24","0","389","0","30","0","5.4"
"Quitman","2020-10-25","1","390","0","30","0","5.4"
"Quitman","2020-10-26","1","391","0","30","0","5.4"
"Quitman","2020-10-27","5","396","1","31","2.9","6.8"
"Quitman","2020-10-28","1","397","1","32","17.1","13.9"
"Quitman","2020-10-29","0","397","0","32","17.1","8.6"
"Quitman","2020-10-30","1","398","0","32","17.1","8.6"
"Quitman","2020-10-31","0","398","0","32","17.1","8.6"
"Quitman","2020-11-01","0","398","0","32","17.1","8.6"
"Quitman","2020-11-02","2","400","1","33","24.3","12.1"
"Quitman","2020-11-03","5","405","0","33","21.4","12.1"
"Quitman","2020-11-04","1","406","0","33","7.1","12.1"
"Quitman","2020-11-05","4","410","1","34","10.7","13.9"
"Quitman","2020-11-06","2","412","0","34","10.7","13.9"
"Quitman","2020-11-07","0","412","0","34","10.7","13.9"
"Quitman","2020-11-08","0","412","0","34","10.7","13.9"
"Quitman","2020-11-09","1","413","0","34","3.6","13.9"
"Quitman","2020-11-10","8","421","0","34","3.6","12.5"
"Quitman","2020-11-11","1","422","0","34","3.6","5.4"
"Quitman","2020-11-12","1","423","0","34","0","5.4"
"Quitman","2020-11-13","3","426","1","35","4.8","7.7"
"Quitman","2020-11-14","1","427","0","35","4.8","7.7"
"Quitman","2020-11-15","0","427","0","35","4.8","7.7"
"Quitman","2020-11-16","1","428","0","35","4.8","4.2"
"Quitman","2020-11-17","5","433","0","35","4.8","4.2"
"Quitman","2020-11-18","0","433","0","35","4.8","4.2"
"Quitman","2020-11-19","2","435","0","35","4.8","2.4"
"Quitman","2020-11-20","0","435","0","35","0","2.4"
"Quitman","2020-11-21","0","435","0","35","0","2.4"
"Quitman","2020-11-22","0","435","0","35","0","2.4"
"Quitman","2020-11-23","1","436","0","35","0","2.4"
"Quitman","2020-11-24","6","442","0","35","0","2.4"
"Quitman","2020-11-25","1","443","0","35","0","2.4"
"Quitman","2020-11-26","0","443","0","35","0","2.4"
"Quitman","2020-11-27","1","444","0","35","0","0"
"Quitman","2020-11-28","1","445","0","35","0","0"
"Quitman","2020-11-29","0","445","0","35","0","0"
"Quitman","2020-11-30","1","446","1","36","14.3","7.1"
"Quitman","2020-12-01","5","451","0","36","14.3","7.1"
"Quitman","2020-12-02","1","452","0","36","14.3","7.1"
"Quitman","2020-12-03","2","454","0","36","14.3","7.1"
"Quitman","2020-12-04","1","455","0","36","14.3","7.1"
"Quitman","2020-12-05","0","455","0","36","14.3","7.1"
"Quitman","2020-12-06","0","455","0","36","14.3","7.1"
"Quitman","2020-12-07","1","456","0","36","0","7.1"
"Quitman","2020-12-08","1","457","0","36","0","7.1"
"Quitman","2020-12-09","4","461","0","36","0","7.1"
"Quitman","2020-12-10","1","462","0","36","0","7.1"
"Quitman","2020-12-11","1","463","0","36","0","7.1"
"Quitman","2020-12-12","1","464","0","36","0","7.1"
"Quitman","2020-12-13","0","464","0","36","0","7.1"
"Quitman","2020-12-14","0","464","0","36","0","0"
"Quitman","2020-12-15","11","475","1","37","1.3","0.6"
"Quitman","2020-12-16","1","476","0","37","1.3","0.6"
"Quitman","2020-12-17","1","477","0","37","1.3","0.6"
"Quitman","2020-12-18","2","479","0","37","1.3","0.6"
"Quitman","2020-12-19","0","479","0","37","1.3","0.6"
"Quitman","2020-12-20","0","479","0","37","1.3","0.6"
"Quitman","2020-12-21","0","479","0","37","1.3","0.6"
"Quitman","2020-12-22","9","488","1","38","1.6","1.4"
"Quitman","2020-12-23","1","489","0","38","1.6","1.4"
"Quitman","2020-12-24","2","491","0","38","1.6","1.4"
"Quitman","2020-12-25","0","491","0","38","1.6","1.4"
"Quitman","2020-12-26","0","491","0","38","1.6","1.4"
"Quitman","2020-12-27","0","491","0","38","1.6","1.4"
"Quitman","2020-12-28","5","496","1","39","4.4","2.9"
"Quitman","2020-12-29","6","502","0","39","2.9","2.2"
"Quitman","2020-12-30","5","507","1","40","5.7","3.7"
"Quitman","2020-12-31","0","507","0","40","5.7","3.7"
"Quitman","2021-01-01","0","507","0","40","5.7","3.7"
"Quitman","2021-01-02","0","507","0","40","5.7","3.7"
"Quitman","2021-01-03","3","510","3","43","20","10.8"
"Quitman","2021-01-04","1","511","0","43","17.1","10.8"
"Quitman","2021-01-05","15","526","4","47","21","11.9"
"Quitman","2021-01-06","2","528","0","47","18.1","11.9"
"Quitman","2021-01-07","5","533","1","48","21","13.3"
"Quitman","2021-01-08","1","534","0","48","21","13.3"
"Quitman","2021-01-09","1","535","0","48","21","13.3"
"Quitman","2021-01-10","2","537","1","49","13.8","16.9"
"Quitman","2021-01-11","3","540","0","49","13.8","15.5"
"Quitman","2021-01-12","6","546","1","50","12.4","16.7"
"Quitman","2021-01-13","1","547","1","51","26.7","22.4"
"Quitman","2021-01-14","5","552","0","51","23.8","22.4"
"Quitman","2021-01-15","2","554","0","51","23.8","22.4"
"Quitman","2021-01-16","0","554","0","51","23.8","22.4"
"Quitman","2021-01-17","2","556","1","52","23.8","18.8"
"Quitman","2021-01-18","0","556","0","52","23.8","18.8"
"Quitman","2021-01-19","17","573","5","57","25.6","19"
"Quitman","2021-01-20","3","576","0","57","11.3","19"
"Quitman","2021-01-21","5","581","0","57","11.3","17.6"
"Quitman","2021-01-22","3","584","1","58","16.1","20"
"Quitman","2021-01-23","1","585","0","58","16.1","20"
"Quitman","2021-01-24","1","586","0","58","9","16.4"
"Quitman","2021-01-25","1","587","0","58","9","16.4"
"Quitman","2021-01-26","1","588","0","58","4.8","15.2"
"Quitman","2021-01-27","0","588","0","58","4.8","8.1"
"Rabun","2020-02-01","0","0","0","0",".","."
"Rabun","2020-02-02","0","0","0","0",".","."
"Rabun","2020-02-03","0","0","0","0",".","."
"Rabun","2020-02-04","0","0","0","0",".","."
"Rabun","2020-02-05","0","0","0","0",".","."
"Rabun","2020-02-06","0","0","0","0",".","."
"Rabun","2020-02-07","0","0","0","0","0","."
"Rabun","2020-02-08","0","0","0","0","0","."
"Rabun","2020-02-09","0","0","0","0","0","."
"Rabun","2020-02-10","0","0","0","0","0","."
"Rabun","2020-02-11","0","0","0","0","0","."
"Rabun","2020-02-12","0","0","0","0","0","."
"Rabun","2020-02-13","0","0","0","0","0","."
"Rabun","2020-02-14","0","0","0","0","0","0"
"Rabun","2020-02-15","0","0","0","0","0","0"
"Rabun","2020-02-16","0","0","0","0","0","0"
"Rabun","2020-02-17","0","0","0","0","0","0"
"Rabun","2020-02-18","0","0","0","0","0","0"
"Rabun","2020-02-19","0","0","0","0","0","0"
"Rabun","2020-02-20","0","0","0","0","0","0"
"Rabun","2020-02-21","0","0","0","0","0","0"
"Rabun","2020-02-22","0","0","0","0","0","0"
"Rabun","2020-02-23","0","0","0","0","0","0"
"Rabun","2020-02-24","0","0","0","0","0","0"
"Rabun","2020-02-25","0","0","0","0","0","0"
"Rabun","2020-02-26","0","0","0","0","0","0"
"Rabun","2020-02-27","0","0","0","0","0","0"
"Rabun","2020-02-28","0","0","0","0","0","0"
"Rabun","2020-02-29","0","0","0","0","0","0"
"Rabun","2020-03-01","0","0","0","0","0","0"
"Rabun","2020-03-02","0","0","0","0","0","0"
"Rabun","2020-03-03","0","0","0","0","0","0"
"Rabun","2020-03-04","0","0","0","0","0","0"
"Rabun","2020-03-05","0","0","0","0","0","0"
"Rabun","2020-03-06","1","1","0","0","0","0"
"Rabun","2020-03-07","0","1","0","0","0","0"
"Rabun","2020-03-08","0","1","0","0","0","0"
"Rabun","2020-03-09","0","1","0","0","0","0"
"Rabun","2020-03-10","0","1","0","0","0","0"
"Rabun","2020-03-11","1","2","0","0","0","0"
"Rabun","2020-03-12","3","5","0","0","0","0"
"Rabun","2020-03-13","1","6","0","0","0","0"
"Rabun","2020-03-14","0","6","0","0","0","0"
"Rabun","2020-03-15","1","7","0","0","0","0"
"Rabun","2020-03-16","2","9","0","0","0","0"
"Rabun","2020-03-17","6","15","0","0","0","0"
"Rabun","2020-03-18","3","18","0","0","0","0"
"Rabun","2020-03-19","4","22","0","0","0","0"
"Rabun","2020-03-20","4","26","0","0","0","0"
"Rabun","2020-03-21","1","27","0","0","0","0"
"Rabun","2020-03-22","2","29","0","0","0","0"
"Rabun","2020-03-23","4","33","0","0","0","0"
"Rabun","2020-03-24","2","35","0","0","0","0"
"Rabun","2020-03-25","3","38","0","0","0","0"
"Rabun","2020-03-26","5","43","0","0","0","0"
"Rabun","2020-03-27","0","43","0","0","0","0"
"Rabun","2020-03-28","0","43","0","0","0","0"
"Rabun","2020-03-29","0","43","0","0","0","0"
"Rabun","2020-03-30","0","43","0","0","0","0"
"Rabun","2020-03-31","2","45","0","0","0","0"
"Rabun","2020-04-01","3","48","0","0","0","0"
"Rabun","2020-04-02","2","50","0","0","0","0"
"Rabun","2020-04-03","4","54","0","0","0","0"
"Rabun","2020-04-04","1","55","0","0","0","0"
"Rabun","2020-04-05","0","55","0","0","0","0"
"Rabun","2020-04-06","0","55","0","0","0","0"
"Rabun","2020-04-07","5","60","0","0","0","0"
"Rabun","2020-04-08","0","60","0","0","0","0"
"Rabun","2020-04-09","3","63","0","0","0","0"
"Rabun","2020-04-10","1","64","0","0","0","0"
"Rabun","2020-04-11","0","64","0","0","0","0"
"Rabun","2020-04-12","0","64","0","0","0","0"
"Rabun","2020-04-13","2","66","0","0","0","0"
"Rabun","2020-04-14","2","68","0","0","0","0"
"Rabun","2020-04-15","1","69","0","0","0","0"
"Rabun","2020-04-16","11","80","0","0","0","0"
"Rabun","2020-04-17","4","84","0","0","0","0"
"Rabun","2020-04-18","1","85","0","0","0","0"
"Rabun","2020-04-19","1","86","0","0","0","0"
"Rabun","2020-04-20","5","91","0","0","0","0"
"Rabun","2020-04-21","7","98","0","0","0","0"
"Rabun","2020-04-22","5","103","0","0","0","0"
"Rabun","2020-04-23","8","111","0","0","0","0"
"Rabun","2020-04-24","9","120","0","0","0","0"
"Rabun","2020-04-25","2","122","0","0","0","0"
"Rabun","2020-04-26","0","122","0","0","0","0"
"Rabun","2020-04-27","3","125","0","0","0","0"
"Rabun","2020-04-28","7","132","0","0","0","0"
"Rabun","2020-04-29","12","144","0","0","0","0"
"Rabun","2020-04-30","22","166","0","0","0","0"
"Rabun","2020-05-01","14","180","0","0","0","0"
"Rabun","2020-05-02","6","186","0","0","0","0"
"Rabun","2020-05-03","4","190","0","0","0","0"
"Rabun","2020-05-04","5","195","0","0","0","0"
"Rabun","2020-05-05","13","208","1","1","1.1","0.5"
"Rabun","2020-05-06","10","218","0","1","1.1","0.5"
"Rabun","2020-05-07","6","224","0","1","1.1","0.5"
"Rabun","2020-05-08","10","234","0","1","1.1","0.5"
"Rabun","2020-05-09","6","240","0","1","1.1","0.5"
"Rabun","2020-05-10","0","240","0","1","1.1","0.5"
"Rabun","2020-05-11","10","250","0","1","1.1","0.5"
"Rabun","2020-05-12","10","260","0","1","0","0.5"
"Rabun","2020-05-13","11","271","0","1","0","0.5"
"Rabun","2020-05-14","5","276","0","1","0","0.5"
"Rabun","2020-05-15","7","283","0","1","0","0.5"
"Rabun","2020-05-16","3","286","0","1","0","0.5"
"Rabun","2020-05-17","2","288","0","1","0","0.5"
"Rabun","2020-05-18","5","293","0","1","0","0.5"
"Rabun","2020-05-19","6","299","0","1","0","0"
"Rabun","2020-05-20","13","312","0","1","0","0"
"Rabun","2020-05-21","4","316","0","1","0","0"
"Rabun","2020-05-22","2","318","0","1","0","0"
"Rabun","2020-05-23","0","318","0","1","0","0"
"Rabun","2020-05-24","2","320","0","1","0","0"
"Rabun","2020-05-25","1","321","0","1","0","0"
"Rabun","2020-05-26","3","324","0","1","0","0"
"Rabun","2020-05-27","14","338","1","2","1","0.5"
"Rabun","2020-05-28","12","350","0","2","1","0.5"
"Rabun","2020-05-29","9","359","0","2","1","0.5"
"Rabun","2020-05-30","3","362","0","2","1","0.5"
"Rabun","2020-05-31","1","363","0","2","1","0.5"
"Rabun","2020-06-01","16","379","1","3","1.9","1"
"Rabun","2020-06-02","18","397","0","3","1.9","1"
"Rabun","2020-06-03","15","412","0","3","0.9","1"
"Rabun","2020-06-04","22","434","0","3","0.9","1"
"Rabun","2020-06-05","14","448","0","3","0.9","1"
"Rabun","2020-06-06","6","454","0","3","0.9","1"
"Rabun","2020-06-07","0","454","0","3","0.9","1"
"Rabun","2020-06-08","11","465","0","3","0","1"
"Rabun","2020-06-09","18","483","0","3","0","1"
"Rabun","2020-06-10","15","498","0","3","0","0.4"
"Rabun","2020-06-11","11","509","0","3","0","0.4"
"Rabun","2020-06-12","9","518","2","5","3.2","2"
"Rabun","2020-06-13","10","528","0","5","3.2","2"
"Rabun","2020-06-14","3","531","0","5","3.2","2"
"Rabun","2020-06-15","8","539","0","5","3.2","1.6"
"Rabun","2020-06-16","19","558","0","5","3.2","1.6"
"Rabun","2020-06-17","15","573","1","6","4.1","2.1"
"Rabun","2020-06-18","12","585","1","7","5.3","2.7"
"Rabun","2020-06-19","14","599","0","7","2.1","2.7"
"Rabun","2020-06-20","9","608","0","7","2.1","2.7"
"Rabun","2020-06-21","0","608","0","7","2.1","2.7"
"Rabun","2020-06-22","13","621","1","8","3.2","3.2"
"Rabun","2020-06-23","20","641","1","9","4","3.6"
"Rabun","2020-06-24","22","663","2","11","4.3","4.2"
"Rabun","2020-06-25","13","676","1","12","4.2","4.8"
"Rabun","2020-06-26","22","698","0","12","4.2","3.2"
"Rabun","2020-06-27","10","708","4","16","9.9","6"
"Rabun","2020-06-28","3","711","0","16","9.9","6"
"Rabun","2020-06-29","15","726","1","17","9.8","6.5"
"Rabun","2020-06-30","31","757","5","22","11.4","7.7"
"Rabun","2020-07-01","34","791","4","26","11.8","8"
"Rabun","2020-07-02","39","830","4","30","12.1","8.2"
"Rabun","2020-07-03","12","842","1","31","13.3","8.8"
"Rabun","2020-07-04","7","849","0","31","7.6","8.8"
"Rabun","2020-07-05","2","851","0","31","7.6","8.8"
"Rabun","2020-07-06","46","897","9","40","9.4","9.6"
"Rabun","2020-07-07","26","923","0","40","7.1","9.2"
"Rabun","2020-07-08","58","981","11","51","8.2","10"
"Rabun","2020-07-09","49","1030","10","61","9.6","10.9"
"Rabun","2020-07-10","43","1073","6","67","10.4","11.9"
"Rabun","2020-07-11","13","1086","6","73","17","12.3"
"Rabun","2020-07-12","4","1090","0","73","17","12.3"
"Rabun","2020-07-13","36","1126","8","81","17.4","13.4"
"Rabun","2020-07-14","25","1151","5","86","20.2","13.7"
"Rabun","2020-07-15","29","1180","8","94","21.5","14.8"
"Rabun","2020-07-16","31","1211","7","101","21.8","15.7"
"Rabun","2020-07-17","37","1248","6","107","22.1","16.3"
"Rabun","2020-07-18","9","1257","2","109","18.7","17.8"
"Rabun","2020-07-19","4","1261","1","110","22.3","19.6"
"Rabun","2020-07-20","33","1294","5","115","21.3","19.3"
"Rabun","2020-07-21","22","1316","4","119","21","20.6"
"Rabun","2020-07-22","17","1333","1","120","17.9","19.7"
"Rabun","2020-07-23","30","1363","8","128","18.5","20.1"
"Rabun","2020-07-24","32","1395","5","133","18.4","20.2"
"Rabun","2020-07-25","9","1404","0","133","15.2","17"
"Rabun","2020-07-26","3","1407","2","135","21.2","21.7"
"Rabun","2020-07-27","22","1429","7","142","23.5","22.4"
"Rabun","2020-07-28","31","1460","2","144","21.9","21.4"
"Rabun","2020-07-29","30","1490","3","147","22.5","20.2"
"Rabun","2020-07-30","17","1507","1","148","19.5","19"
"Rabun","2020-07-31","13","1520","1","149","18.4","18.4"
"Rabun","2020-08-01","18","1538","4","153","21.5","18.4"
"Rabun","2020-08-02","7","1545","2","155","16.1","18.6"
"Rabun","2020-08-03","12","1557","1","156","12.7","18.1"
"Rabun","2020-08-04","11","1568","0","156","11.8","16.8"
"Rabun","2020-08-05","19","1587","2","158","11.9","17.2"
"Rabun","2020-08-06","9","1596","1","159","12.6","16.1"
"Rabun","2020-08-07","15","1611","1","160","12.5","15.4"
"Rabun","2020-08-08","6","1617","1","161","11.7","16.6"
"Rabun","2020-08-09","5","1622","0","161","7.6","11.9"
"Rabun","2020-08-10","13","1635","0","161","6.4","9.6"
"Rabun","2020-08-11","21","1656","1","162","7.1","9.5"
"Rabun","2020-08-12","19","1675","0","162","5.6","8.7"
"Rabun","2020-08-13","8","1683","0","162","4","8.3"
"Rabun","2020-08-14","17","1700","0","162","3.1","7.8"
"Rabun","2020-08-15","4","1704","0","162","0.7","6.2"
"Rabun","2020-08-16","4","1708","0","162","0.7","4.1"
"Rabun","2020-08-17","11","1719","0","162","0.7","3.6"
"Rabun","2020-08-18","10","1729","0","162","0","3.6"
"Rabun","2020-08-19","11","1740","1","163","1.3","3.4"
"Rabun","2020-08-20","9","1749","1","164","2.9","3.4"
"Rabun","2020-08-21","16","1765","1","165","3.8","3.4"
"Rabun","2020-08-22","13","1778","0","165","3.8","2.2"
"Rabun","2020-08-23","5","1783","0","165","3.8","2.2"
"Rabun","2020-08-24","11","1794","0","165","3.8","2.2"
"Rabun","2020-08-25","11","1805","1","166","5.1","2.5"
"Rabun","2020-08-26","25","1830","3","169","5.5","3.4"
"Rabun","2020-08-27","18","1848","0","169","3.9","3.4"
"Rabun","2020-08-28","11","1859","0","169","3","3.4"
"Rabun","2020-08-29","28","1887","3","172","4.5","4.2"
"Rabun","2020-08-30","5","1892","0","172","4.5","4.2"
"Rabun","2020-08-31","7","1899","1","173","6.6","5.2"
"Rabun","2020-09-01","26","1925","0","173","5.3","5.2"
"Rabun","2020-09-02","24","1949","0","173","3.6","4.5"
"Rabun","2020-09-03","9","1958","0","173","3.6","3.7"
"Rabun","2020-09-04","37","1995","5","178","5.5","4.3"
"Rabun","2020-09-05","10","2005","1","179","5.4","5"
"Rabun","2020-09-06","4","2009","0","179","5.4","5"
"Rabun","2020-09-07","3","2012","0","179","3.4","5"
"Rabun","2020-09-08","13","2025","0","179","3.4","4.3"
"Rabun","2020-09-09","15","2040","2","181","5.3","4.4"
"Rabun","2020-09-10","15","2055","2","183","7.2","5.4"
"Rabun","2020-09-11","14","2069","1","184","6.3","5.9"
"Rabun","2020-09-12","5","2074","0","184","4.8","5.1"
"Rabun","2020-09-13","3","2077","0","184","4.8","5.1"
"Rabun","2020-09-14","12","2089","1","185","6","4.7"
"Rabun","2020-09-15","14","2103","0","185","6","4.7"
"Rabun","2020-09-16","18","2121","1","186","4.9","5.1"
"Rabun","2020-09-17","19","2140","3","189","5.3","6.2"
"Rabun","2020-09-18","18","2158","0","189","4.2","5.2"
"Rabun","2020-09-19","11","2169","0","189","4.2","4.5"
"Rabun","2020-09-20","6","2175","2","191","9","6.9"
"Rabun","2020-09-21","24","2199","0","191","7.8","6.9"
"Rabun","2020-09-22","19","2218","2","193","9.3","7.7"
"Rabun","2020-09-23","16","2234","4","197","12.1","8.5"
"Rabun","2020-09-24","8","2242","0","197","9.8","7.5"
"Rabun","2020-09-25","19","2261","3","200","12.1","8.2"
"Rabun","2020-09-26","11","2272","1","201","13.4","8.8"
"Rabun","2020-09-27","4","2276","0","201","8.6","8.8"
"Rabun","2020-09-28","18","2294","1","202","9.4","8.6"
"Rabun","2020-09-29","9","2303","1","203","9.5","9.4"
"Rabun","2020-09-30","8","2311","1","204","7.7","9.9"
"Rabun","2020-10-01","16","2327","2","206","9.5","9.7"
"Rabun","2020-10-02","21","2348","2","208","8.6","10.4"
"Rabun","2020-10-03","16","2364","1","209","8.2","10.8"
"Rabun","2020-10-04","2","2366","0","209","8.2","8.4"
"Rabun","2020-10-05","24","2390","0","209","7.4","8.4"
"Rabun","2020-10-06","13","2403","1","210","6.9","8.2"
"Rabun","2020-10-07","18","2421","3","213","7.5","7.6"
"Rabun","2020-10-08","25","2446","3","216","7.4","8.5"
"Rabun","2020-10-09","32","2478","4","220","7.9","8.2"
"Rabun","2020-10-10","23","2501","1","221","7.6","7.9"
"Rabun","2020-10-11","4","2505","0","221","7.6","7.9"
"Rabun","2020-10-12","14","2519","0","221","7.6","7.5"
"Rabun","2020-10-13","14","2533","2","223","8.5","7.7"
"Rabun","2020-10-14","21","2554","1","224","6.8","7.2"
"Rabun","2020-10-15","41","2595","1","225","5.5","6.5"
"Rabun","2020-10-16","18","2613","2","227","5.3","6.6"
"Rabun","2020-10-17","7","2620","0","227","4.7","6.1"
"Rabun","2020-10-18","4","2624","0","227","4.7","6.1"
"Rabun","2020-10-19","20","2644","0","227","4.7","6.1"
"Rabun","2020-10-20","17","2661","0","227","2.6","5.6"
"Rabun","2020-10-21","19","2680","2","229","3.4","5.1"
"Rabun","2020-10-22","19","2699","4","233","6.1","5.8"
"Rabun","2020-10-23","14","2713","0","233","4.5","4.9"
"Rabun","2020-10-24","20","2733","3","236","6.7","5.7"
"Rabun","2020-10-25","2","2735","0","236","6.7","5.7"
"Rabun","2020-10-26","15","2750","0","236","6.7","5.7"
"Rabun","2020-10-27","16","2766","1","237","7.5","5.1"
"Rabun","2020-10-28","17","2783","1","238","6.9","5.2"
"Rabun","2020-10-29","21","2804","3","241","5.9","6"
"Rabun","2020-10-30","17","2821","1","242","6.8","5.6"
"Rabun","2020-10-31","8","2829","0","242","4.6","5.6"
"Rabun","2020-11-01","5","2834","0","242","4.6","5.6"
"Rabun","2020-11-02","20","2854","3","245","6.8","6.7"
"Rabun","2020-11-03","14","2868","0","245","5.9","6.7"
"Rabun","2020-11-04","20","2888","2","247","6.5","6.7"
"Rabun","2020-11-05","43","2931","11","258","8.1","7"
"Rabun","2020-11-06","30","2961","3","261","8.7","7.7"
"Rabun","2020-11-07","16","2977","1","262","9.5","7.1"
"Rabun","2020-11-08","9","2986","4","266","15.9","10.3"
"Rabun","2020-11-09","26","3012","5","271","16.5","11.6"
"Rabun","2020-11-10","24","3036","5","276","19.5","12.7"
"Rabun","2020-11-11","47","3083","12","288","21.7","14.1"
"Rabun","2020-11-12","55","3138","14","302","21.7","14.9"
"Rabun","2020-11-13","41","3179","7","309","22.7","15.7"
"Rabun","2020-11-14","9","3188","2","311","25","17.3"
"Rabun","2020-11-15","10","3198","2","313","21.5","18.7"
"Rabun","2020-11-16","29","3227","3","316","20.2","18.4"
"Rabun","2020-11-17","39","3266","6","322","19.4","19.5"
"Rabun","2020-11-18","35","3301","4","326","17.4","19.6"
"Rabun","2020-11-19","51","3352","6","332","15.5","18.6"
"Rabun","2020-11-20","41","3393","3","335","14.1","18.4"
"Rabun","2020-11-21","26","3419","4","339","13.1","19"
"Rabun","2020-11-22","16","3435","1","340","11.1","16.3"
"Rabun","2020-11-23","32","3467","4","344","11.4","15.8"
"Rabun","2020-11-24","39","3506","9","353","12.5","16"
"Rabun","2020-11-25","32","3538","4","357","12.7","15.1"
"Rabun","2020-11-26","10","3548","4","361","16.7","16.1"
"Rabun","2020-11-27","37","3585","11","372","19.9","17"
"Rabun","2020-11-28","14","3599","4","376","21.8","17.4"
"Rabun","2020-11-29","15","3614","8","384","28.5","19.8"
"Rabun","2020-11-30","72","3686","15","399","29.7","20.6"
"Rabun","2020-12-01","49","3735","15","414","30.8","21.7"
"Rabun","2020-12-02","58","3793","15","429","32.7","22.7"
"Rabun","2020-12-03","43","3836","12","441","31","23.8"
"Rabun","2020-12-04","67","3903","12","453","29.3","24.6"
"Rabun","2020-12-05","80","3983","17","470","28.2","25"
"Rabun","2020-12-06","13","3996","6","476","27.2","27.9"
"Rabun","2020-12-07","71","4067","16","492","27.5","28.6"
"Rabun","2020-12-08","90","4157","16","508","25.6","28.2"
"Rabun","2020-12-09","79","4236","20","528","25.6","29.1"
"Rabun","2020-12-10","41","4277","3","531","22.6","26.8"
"Rabun","2020-12-11","79","4356","18","549","23.3","26.3"
"Rabun","2020-12-12","44","4400","16","565","25.5","26.9"
"Rabun","2020-12-13","8","4408","5","570","27.8","27.5"
"Rabun","2020-12-14","75","4483","13","583","27.1","27.3"
"Rabun","2020-12-15","77","4560","15","598","27.3","26.5"
"Rabun","2020-12-16","109","4669","30","628","27.6","26.6"
"Rabun","2020-12-17","88","4757","25","653","30.6","26.6"
"Rabun","2020-12-18","82","4839","18","671","30.5","26.9"
"Rabun","2020-12-19","26","4865","8","679","29.7","27.6"
"Rabun","2020-12-20","12","4877","6","685","27.9","27.9"
"Rabun","2020-12-21","63","4940","9","694","27.5","27.3"
"Rabun","2020-12-22","109","5049","27","721","28.2","27.8"
"Rabun","2020-12-23","85","5134","35","756","30.2","28.9"
"Rabun","2020-12-24","43","5177","21","777","33.1","31.9"
"Rabun","2020-12-25","3","5180","0","777","30","30.2"
"Rabun","2020-12-26","12","5192","5","782","31.5","30.6"
"Rabun","2020-12-27","17","5209","10","792","32.8","30.4"
"Rabun","2020-12-28","54","5263","15","807","34.7","31.1"
"Rabun","2020-12-29","72","5335","19","826","35","31.6"
"Rabun","2020-12-30","103","5438","27","853","32.8","31.5"
"Rabun","2020-12-31","79","5517","21","874","29.6","31.4"
"Rabun","2021-01-01","14","5531","6","880","35.8","32.9"
"Rabun","2021-01-02","8","5539","1","881","31.6","31.6"
"Rabun","2021-01-03","12","5551","5","886","29.1","31"
"Rabun","2021-01-04","56","5607","6","892","26.7","30.7"
"Rabun","2021-01-05","122","5729","36","928","27.1","31.1"
"Rabun","2021-01-06","71","5800","19","947","27.2","30"
"Rabun","2021-01-07","184","5984","22","969","25.1","27.4"
"Rabun","2021-01-08","57","6041","14","983","22.5","29.1"
"Rabun","2021-01-09","18","6059","2","985","22.3","27"
"Rabun","2021-01-10","15","6074","4","989","20.2","24.7"
"Rabun","2021-01-11","63","6137","13","1002","21.6","24.2"
"Rabun","2021-01-12","47","6184","17","1019","22.6","24.9"
"Rabun","2021-01-13","62","6246","16","1035","22.4","24.8"
"Rabun","2021-01-14","83","6329","12","1047","22.8","24"
"Rabun","2021-01-15","37","6366","9","1056","22.7","22.6"
"Rabun","2021-01-16","25","6391","5","1061","24","23.2"
"Rabun","2021-01-17","13","6404","2","1063","22.4","21.3"
"Rabun","2021-01-18","33","6437","11","1074","24.2","22.9"
"Rabun","2021-01-19","47","6484","16","1090","23.9","23.2"
"Rabun","2021-01-20","29","6513","5","1095","22.7","22.5"
"Rabun","2021-01-21","50","6563","11","1106","23.8","23.3"
"Rabun","2021-01-22","56","6619","10","1116","22.8","22.8"
"Rabun","2021-01-23","18","6637","3","1119","22.4","23.2"
"Rabun","2021-01-24","6","6643","1","1120","22.5","22.5"
"Rabun","2021-01-25","9","6652","2","1122","21","22.6"
"Rabun","2021-01-26","0","6652","0","1122","16.1","20"
"Rabun","2021-01-27","0","6652","0","1122","13.6","18.2"
"Randolph","2020-02-01","0","0","0","0",".","."
"Randolph","2020-02-02","0","0","0","0",".","."
"Randolph","2020-02-03","0","0","0","0",".","."
"Randolph","2020-02-04","0","0","0","0",".","."
"Randolph","2020-02-05","0","0","0","0",".","."
"Randolph","2020-02-06","0","0","0","0",".","."
"Randolph","2020-02-07","0","0","0","0","0","."
"Randolph","2020-02-08","0","0","0","0","0","."
"Randolph","2020-02-09","0","0","0","0","0","."
"Randolph","2020-02-10","0","0","0","0","0","."
"Randolph","2020-02-11","0","0","0","0","0","."
"Randolph","2020-02-12","0","0","0","0","0","."
"Randolph","2020-02-13","0","0","0","0","0","."
"Randolph","2020-02-14","0","0","0","0","0","0"
"Randolph","2020-02-15","0","0","0","0","0","0"
"Randolph","2020-02-16","0","0","0","0","0","0"
"Randolph","2020-02-17","0","0","0","0","0","0"
"Randolph","2020-02-18","0","0","0","0","0","0"
"Randolph","2020-02-19","0","0","0","0","0","0"
"Randolph","2020-02-20","0","0","0","0","0","0"
"Randolph","2020-02-21","0","0","0","0","0","0"
"Randolph","2020-02-22","0","0","0","0","0","0"
"Randolph","2020-02-23","0","0","0","0","0","0"
"Randolph","2020-02-24","0","0","0","0","0","0"
"Randolph","2020-02-25","0","0","0","0","0","0"
"Randolph","2020-02-26","0","0","0","0","0","0"
"Randolph","2020-02-27","0","0","0","0","0","0"
"Randolph","2020-02-28","0","0","0","0","0","0"
"Randolph","2020-02-29","0","0","0","0","0","0"
"Randolph","2020-03-01","0","0","0","0","0","0"
"Randolph","2020-03-02","0","0","0","0","0","0"
"Randolph","2020-03-03","0","0","0","0","0","0"
"Randolph","2020-03-04","0","0","0","0","0","0"
"Randolph","2020-03-05","0","0","0","0","0","0"
"Randolph","2020-03-06","0","0","0","0","0","0"
"Randolph","2020-03-07","0","0","0","0","0","0"
"Randolph","2020-03-08","0","0","0","0","0","0"
"Randolph","2020-03-09","0","0","0","0","0","0"
"Randolph","2020-03-10","0","0","0","0","0","0"
"Randolph","2020-03-11","1","1","1","1","14.3","7.1"
"Randolph","2020-03-12","0","1","0","1","14.3","7.1"
"Randolph","2020-03-13","2","3","0","1","14.3","7.1"
"Randolph","2020-03-14","1","4","0","1","14.3","7.1"
"Randolph","2020-03-15","0","4","0","1","14.3","7.1"
"Randolph","2020-03-16","1","5","0","1","14.3","7.1"
"Randolph","2020-03-17","0","5","0","1","14.3","7.1"
"Randolph","2020-03-18","1","6","0","1","0","7.1"
"Randolph","2020-03-19","2","8","0","1","0","7.1"
"Randolph","2020-03-20","7","15","3","4","6.1","10.2"
"Randolph","2020-03-21","2","17","2","6","20.4","17.3"
"Randolph","2020-03-22","2","19","1","7","27.6","20.9"
"Randolph","2020-03-23","10","29","3","10","31.8","23.1"
"Randolph","2020-03-24","1","30","1","11","46.1","30.2"
"Randolph","2020-03-25","7","37","2","13","50.2","25.1"
"Randolph","2020-03-26","16","53","8","21","57.3","28.7"
"Randolph","2020-03-27","6","59","3","24","58.4","32.2"
"Randolph","2020-03-28","5","64","3","27","52.7","36.5"
"Randolph","2020-03-29","8","72","5","32","54.4","41"
"Randolph","2020-03-30","8","80","5","37","59.1","45.5"
"Randolph","2020-03-31","12","92","6","43","51.9","49"
"Randolph","2020-04-01","11","103","9","52","59.5","54.9"
"Randolph","2020-04-02","12","115","8","60","61.9","59.6"
"Randolph","2020-04-03","66","181","44","104","64.3","61.3"
"Randolph","2020-04-04","10","191","7","111","65.7","59.2"
"Randolph","2020-04-05","11","202","7","118","65.9","60.2"
"Randolph","2020-04-06","15","217","8","126","64.6","61.8"
"Randolph","2020-04-07","7","224","3","129","63.6","57.8"
"Randolph","2020-04-08","6","230","3","132","59","59.3"
"Randolph","2020-04-09","17","247","11","143","58.7","60.3"
"Randolph","2020-04-10","7","254","2","145","53.3","58.8"
"Randolph","2020-04-11","11","265","4","149","48.5","57.1"
"Randolph","2020-04-12","1","266","0","149","39.4","52.7"
"Randolph","2020-04-13","16","282","6","155","37.1","50.9"
"Randolph","2020-04-14","8","290","2","157","34.6","49.1"
"Randolph","2020-04-15","18","308","0","157","27.4","43.2"
"Randolph","2020-04-16","26","334","2","159","19.3","39"
"Randolph","2020-04-17","17","351","1","160","16.1","34.7"
"Randolph","2020-04-18","11","362","2","162","13.5","31"
"Randolph","2020-04-19","6","368","0","162","13.5","26.4"
"Randolph","2020-04-20","14","382","5","167","13.2","25.2"
"Randolph","2020-04-21","13","395","4","171","14","24.3"
"Randolph","2020-04-22","8","403","2","173","17.6","22.5"
"Randolph","2020-04-23","16","419","2","175","18.3","18.8"
"Randolph","2020-04-24","10","429","2","177","20.3","18.2"
"Randolph","2020-04-25","3","432","0","177","17.7","15.6"
"Randolph","2020-04-26","3","435","1","178","22.5","18"
"Randolph","2020-04-27","26","461","18","196","27.3","20.2"
"Randolph","2020-04-28","12","473","2","198","25.2","19.6"
"Randolph","2020-04-29","9","482","1","199","23.3","20.4"
"Randolph","2020-04-30","15","497","5","204","26.2","22.3"
"Randolph","2020-05-01","7","504","2","206","27.5","23.9"
"Randolph","2020-05-02","5","509","2","208","33.2","25.4"
"Randolph","2020-05-03","11","520","0","208","28.4","25.4"
"Randolph","2020-05-04","17","537","2","210","20.2","23.7"
"Randolph","2020-05-05","13","550","1","211","18.9","22.1"
"Randolph","2020-05-06","7","557","1","212","19.4","21.3"
"Randolph","2020-05-07","6","563","1","213","17","21.6"
"Randolph","2020-05-08","14","577","2","215","15","21.2"
"Randolph","2020-05-09","0","577","0","215","9.2","21.2"
"Randolph","2020-05-10","3","580","1","216","14","21.2"
"Randolph","2020-05-11","17","597","2","218","14","17.1"
"Randolph","2020-05-12","8","605","2","220","16.5","17.7"
"Randolph","2020-05-13","11","616","0","220","14.4","16.9"
"Randolph","2020-05-14","20","636","2","222","13.5","15.2"
"Randolph","2020-05-15","10","646","0","222","11.4","13.2"
"Randolph","2020-05-16","3","649","0","222","11.4","10.3"
"Randolph","2020-05-17","3","652","0","222","6.7","10.3"
"Randolph","2020-05-18","15","667","2","224","6.9","10.5"
"Randolph","2020-05-19","9","676","1","225","4.9","10.7"
"Randolph","2020-05-20","5","681","0","225","4.9","9.7"
"Randolph","2020-05-21","18","699","0","225","3.5","8.5"
"Randolph","2020-05-22","32","731","3","228","4.8","8.1"
"Randolph","2020-05-23","3","734","0","228","4.8","8.1"
"Randolph","2020-05-24","7","741","0","228","4.8","5.8"
"Randolph","2020-05-25","8","749","0","228","2.9","4.9"
"Randolph","2020-05-26","33","782","0","228","1.3","3.1"
"Randolph","2020-05-27","48","830","5","233","2.8","3.9"
"Randolph","2020-05-28","27","857","1","234","3.4","3.4"
"Randolph","2020-05-29","18","875","1","235","2.8","3.8"
"Randolph","2020-05-30","2","877","0","235","2.8","3.8"
"Randolph","2020-05-31","2","879","0","235","2.8","3.8"
"Randolph","2020-06-01","13","892","0","235","2.8","2.9"
"Randolph","2020-06-02","11","903","1","236","4.1","2.7"
"Randolph","2020-06-03","18","921","0","236","2.6","2.7"
"Randolph","2020-06-04","12","933","0","236","2.1","2.7"
"Randolph","2020-06-05","18","951","0","236","1.3","2.1"
"Randolph","2020-06-06","86","1037","1","237","1.5","2.1"
"Randolph","2020-06-07","6","1043","1","238","3.8","3.3"
"Randolph","2020-06-08","12","1055","1","239","5","3.9"
"Randolph","2020-06-09","6","1061","0","239","3.7","3.9"
"Randolph","2020-06-10","6","1067","1","240","6.1","4.4"
"Randolph","2020-06-11","25","1092","0","240","6.1","4.1"
"Randolph","2020-06-12","12","1104","1","241","7.3","4.3"
"Randolph","2020-06-13","0","1104","0","241","7.1","4.3"
"Randolph","2020-06-14","2","1106","1","242","11.9","7.9"
"Randolph","2020-06-15","12","1118","1","243","11.9","8.5"
"Randolph","2020-06-16","9","1127","2","245","15.1","9.4"
"Randolph","2020-06-17","5","1132","2","247","18.4","12.3"
"Randolph","2020-06-18","24","1156","0","247","18.4","12.3"
"Randolph","2020-06-19","13","1169","0","247","17.2","12.3"
"Randolph","2020-06-20","2","1171","0","247","17.2","12.2"
"Randolph","2020-06-21","2","1173","1","248","17.2","14.6"
"Randolph","2020-06-22","18","1191","2","250","17.6","14.8"
"Randolph","2020-06-23","4","1195","0","250","14.4","14.8"
"Randolph","2020-06-24","14","1209","0","250","8.7","13.6"
"Randolph","2020-06-25","27","1236","1","251","9.3","13.8"
"Randolph","2020-06-26","33","1269","2","253","10.1","13.7"
"Randolph","2020-06-27","1","1270","0","253","10.1","13.7"
"Randolph","2020-06-28","6","1276","2","255","7.7","12.5"
"Randolph","2020-06-29","24","1300","3","258","7.9","12.8"
"Randolph","2020-06-30","2","1302","0","258","7.9","11.2"
"Randolph","2020-07-01","9","1311","1","259","9.5","9.1"
"Randolph","2020-07-02","25","1336","2","261","10.1","9.7"
"Randolph","2020-07-03","4","1340","0","261","9.3","9.7"
"Randolph","2020-07-04","3","1343","0","261","9.3","9.7"
"Randolph","2020-07-05","5","1348","1","262","7.4","7.6"
"Randolph","2020-07-06","18","1366","1","263","6.4","7.2"
"Randolph","2020-07-07","11","1377","1","264","7.7","7.8"
"Randolph","2020-07-08","8","1385","2","266","9.7","9.6"
"Randolph","2020-07-09","40","1425","4","270","9.9","10"
"Randolph","2020-07-10","23","1448","4","274","12.4","10.9"
"Randolph","2020-07-11","3","1451","1","275","17.2","13.2"
"Randolph","2020-07-12","6","1457","4","279","23.9","15.6"
"Randolph","2020-07-13","11","1468","1","280","24.4","15.4"
"Randolph","2020-07-14","11","1479","0","280","23.1","15.4"
"Randolph","2020-07-15","5","1484","1","281","22.4","16"
"Randolph","2020-07-16","9","1493","0","281","20.9","15.4"
"Randolph","2020-07-17","11","1504","0","281","18.4","15.4"
"Randolph","2020-07-18","5","1509","2","283","19.4","18.3"
"Randolph","2020-07-19","6","1515","1","284","12.3","18.1"
"Randolph","2020-07-20","37","1552","3","287","12.1","18.2"
"Randolph","2020-07-21","11","1563","2","289","14.7","18.9"
"Randolph","2020-07-22","19","1582","3","292","14.1","18.2"
"Randolph","2020-07-23","48","1630","6","298","15.9","18.4"
"Randolph","2020-07-24","26","1656","5","303","18.6","18.5"
"Randolph","2020-07-25","6","1662","1","304","15.3","17.4"
"Randolph","2020-07-26","5","1667","2","306","18.6","15.4"
"Randolph","2020-07-27","62","1729","10","316","19.8","15.9"
"Randolph","2020-07-28","38","1767","1","317","17.6","16.1"
"Randolph","2020-07-29","19","1786","4","321","18.3","16.2"
"Randolph","2020-07-30","30","1816","7","328","19.9","17.9"
"Randolph","2020-07-31","29","1845","7","335","20.6","19.6"
"Randolph","2020-08-01","8","1853","3","338","23.5","19.4"
"Randolph","2020-08-02","0","1853","0","338","17.8","18.2"
"Randolph","2020-08-03","16","1869","3","341","18.2","19"
"Randolph","2020-08-04","14","1883","2","343","19.9","18.7"
"Randolph","2020-08-05","13","1896","2","345","19.1","18.7"
"Randolph","2020-08-06","36","1932","1","346","16.1","18"
"Randolph","2020-08-07","57","1989","6","352","14.2","17.4"
"Randolph","2020-08-08","1","1990","0","352","8.8","16.2"
"Randolph","2020-08-09","1","1991","0","352","8.8","13.3"
"Randolph","2020-08-10","13","2004","3","355","9.4","13.8"
"Randolph","2020-08-11","14","2018","1","356","8.4","14.1"
"Randolph","2020-08-12","8","2026","2","358","9.8","14.4"
"Randolph","2020-08-13","34","2060","4","362","11.1","13.6"
"Randolph","2020-08-14","11","2071","3","365","13.5","13.8"
"Randolph","2020-08-15","15","2086","4","369","17.3","13"
"Randolph","2020-08-16","4","2090","1","370","20.8","14.8"
"Randolph","2020-08-17","13","2103","3","373","20.8","15.1"
"Randolph","2020-08-18","11","2114","2","375","22.4","15.4"
"Randolph","2020-08-19","11","2125","2","377","21.4","15.6"
"Randolph","2020-08-20","38","2163","5","382","21.6","16.4"
"Randolph","2020-08-21","22","2185","0","382","17.8","15.6"
"Randolph","2020-08-22","3","2188","1","383","18.7","18"
"Randolph","2020-08-23","9","2197","1","384","16.7","18.8"
"Randolph","2020-08-24","15","2212","2","386","15.3","18.1"
"Randolph","2020-08-25","9","2221","2","388","15.9","19.2"
"Randolph","2020-08-26","9","2230","2","390","16.5","19"
"Randolph","2020-08-27","13","2243","1","391","15.7","18.7"
"Randolph","2020-08-28","10","2253","3","394","20","18.9"
"Randolph","2020-08-29","1","2254","1","395","29.5","24.1"
"Randolph","2020-08-30","3","2257","0","395","27.9","22.3"
"Randolph","2020-08-31","16","2273","3","398","28.7","22"
"Randolph","2020-09-01","10","2283","1","399","27","21.4"
"Randolph","2020-09-02","10","2293","3","402","28.1","22.3"
"Randolph","2020-09-03","18","2311","2","404","28.6","22.1"
"Randolph","2020-09-04","48","2359","3","407","25.2","22.6"
"Randolph","2020-09-05","2","2361","0","407","10.9","20.2"
"Randolph","2020-09-06","5","2366","0","407","10.9","19.4"
"Randolph","2020-09-07","0","2366","0","407","8.2","18.4"
"Randolph","2020-09-08","20","2386","1","408","7.5","17.2"
"Randolph","2020-09-09","10","2396","0","408","3.2","15.6"
"Randolph","2020-09-10","35","2431","0","408","1.6","15.1"
"Randolph","2020-09-11","10","2441","0","408","0.7","12.9"
"Randolph","2020-09-12","6","2447","1","409","3.1","7"
"Randolph","2020-09-13","1","2448","0","409","3.1","7"
"Randolph","2020-09-14","9","2457","1","410","4.7","6.4"
"Randolph","2020-09-15","7","2464","0","410","4","5.7"
"Randolph","2020-09-16","9","2473","0","410","4","3.6"
"Randolph","2020-09-17","11","2484","0","410","4","2.8"
"Randolph","2020-09-18","13","2497","0","410","4","2.3"
"Randolph","2020-09-19","2","2499","0","410","1.6","2.3"
"Randolph","2020-09-20","2","2501","0","410","1.6","2.3"
"Randolph","2020-09-21","9","2510","0","410","0","2.3"
"Randolph","2020-09-22","9","2519","0","410","0","2"
"Randolph","2020-09-23","5","2524","0","410","0","2"
"Randolph","2020-09-24","9","2533","0","410","0","2"
"Randolph","2020-09-25","6","2539","1","411","2.4","3.2"
"Randolph","2020-09-26","2","2541","0","411","2.4","2"
"Randolph","2020-09-27","2","2543","0","411","2.4","2"
"Randolph","2020-09-28","14","2557","1","412","3.4","1.7"
"Randolph","2020-09-29","9","2566","0","412","3.4","1.7"
"Randolph","2020-09-30","7","2573","0","412","3.4","1.7"
"Randolph","2020-10-01","15","2588","0","412","3.4","1.7"
"Randolph","2020-10-02","11","2599","0","412","1","1.7"
"Randolph","2020-10-03","2","2601","0","412","1","1.7"
"Randolph","2020-10-04","4","2605","1","413","4.6","3.5"
"Randolph","2020-10-05","13","2618","1","414","4.7","4"
"Randolph","2020-10-06","7","2625","0","414","4.7","4"
"Randolph","2020-10-07","13","2638","0","414","4.7","4"
"Randolph","2020-10-08","17","2655","1","415","5.5","4.5"
"Randolph","2020-10-09","42","2697","1","416","5.9","3.4"
"Randolph","2020-10-10","5","2702","0","416","5.9","3.4"
"Randolph","2020-10-11","4","2706","0","416","2.3","3.4"
"Randolph","2020-10-12","12","2718","0","416","1.2","2.9"
"Randolph","2020-10-13","12","2730","0","416","1.2","2.9"
"Randolph","2020-10-14","12","2742","0","416","1.2","2.9"
"Randolph","2020-10-15","23","2765","0","416","0.3","2.9"
"Randolph","2020-10-16","7","2772","0","416","0","2.9"
"Randolph","2020-10-17","3","2775","0","416","0","2.9"
"Randolph","2020-10-18","2","2777","0","416","0","1.1"
"Randolph","2020-10-19","14","2791","0","416","0","0.6"
"Randolph","2020-10-20","9","2800","1","417","1.6","1.4"
"Randolph","2020-10-21","6","2806","0","417","1.6","1.4"
"Randolph","2020-10-22","16","2822","1","418","2.5","1.4"
"Randolph","2020-10-23","4","2826","0","418","2.5","1.2"
"Randolph","2020-10-24","4","2830","0","418","2.5","1.2"
"Randolph","2020-10-25","0","2830","0","418","2.5","1.2"
"Randolph","2020-10-26","16","2846","0","418","2.5","1.2"
"Randolph","2020-10-27","6","2852","0","418","0.9","1.2"
"Randolph","2020-10-28","5","2857","0","418","0.9","1.2"
"Randolph","2020-10-29","14","2871","1","419","1","1.8"
"Randolph","2020-10-30","2","2873","0","419","1","1.8"
"Randolph","2020-10-31","1","2874","0","419","1","1.8"
"Randolph","2020-11-01","3","2877","0","419","1","1.8"
"Randolph","2020-11-02","15","2892","0","419","1","1.8"
"Randolph","2020-11-03","4","2896","0","419","1","1"
"Randolph","2020-11-04","11","2907","0","419","1","1"
"Randolph","2020-11-05","12","2919","1","420","1.2","1.1"
"Randolph","2020-11-06","4","2923","0","420","1.2","1.1"
"Randolph","2020-11-07","2","2925","0","420","1.2","1.1"
"Randolph","2020-11-08","2","2927","0","420","1.2","1.1"
"Randolph","2020-11-09","7","2934","0","420","1.2","1.1"
"Randolph","2020-11-10","9","2943","1","421","2.8","1.9"
"Randolph","2020-11-11","12","2955","0","421","2.8","1.9"
"Randolph","2020-11-12","4","2959","0","421","1.6","1.4"
"Randolph","2020-11-13","5","2964","1","422","4.4","2.8"
"Randolph","2020-11-14","3","2967","0","422","4.4","2.8"
"Randolph","2020-11-15","3","2970","0","422","4.4","2.8"
"Randolph","2020-11-16","5","2975","0","422","4.4","2.8"
"Randolph","2020-11-17","6","2981","0","422","2.9","2.8"
"Randolph","2020-11-18","8","2989","0","422","2.9","2.8"
"Randolph","2020-11-19","9","2998","0","422","2.9","2.2"
"Randolph","2020-11-20","6","3004","0","422","0","2.2"
"Randolph","2020-11-21","2","3006","1","423","7.1","5.8"
"Randolph","2020-11-22","1","3007","0","423","7.1","5.8"
"Randolph","2020-11-23","12","3019","1","424","8.3","6.4"
"Randolph","2020-11-24","6","3025","0","424","8.3","5.6"
"Randolph","2020-11-25","8","3033","0","424","8.3","5.6"
"Randolph","2020-11-26","3","3036","0","424","8.3","5.6"
"Randolph","2020-11-27","5","3041","0","424","8.3","4.2"
"Randolph","2020-11-28","0","3041","0","424","1.2","4.2"
"Randolph","2020-11-29","0","3041","0","424","1.2","4.2"
"Randolph","2020-11-30","12","3053","0","424","0","4.2"
"Randolph","2020-12-01","8","3061","0","424","0","4.2"
"Randolph","2020-12-02","13","3074","1","425","1.1","4.7"
"Randolph","2020-12-03","4","3078","0","425","1.1","4.7"
"Randolph","2020-12-04","6","3084","0","425","1.1","4.7"
"Randolph","2020-12-05","2","3086","0","425","1.1","1.1"
"Randolph","2020-12-06","2","3088","0","425","1.1","1.1"
"Randolph","2020-12-07","15","3103","1","426","2.1","1"
"Randolph","2020-12-08","10","3113","0","426","2.1","1"
"Randolph","2020-12-09","3","3116","0","426","1","1"
"Randolph","2020-12-10","7","3123","0","426","1","1"
"Randolph","2020-12-11","9","3132","0","426","1","1"
"Randolph","2020-12-12","2","3134","0","426","1","1"
"Randolph","2020-12-13","4","3138","0","426","1","1"
"Randolph","2020-12-14","21","3159","1","427","0.7","1.4"
"Randolph","2020-12-15","9","3168","0","427","0.7","1.4"
"Randolph","2020-12-16","5","3173","0","427","0.7","0.8"
"Randolph","2020-12-17","4","3177","0","427","0.7","0.8"
"Randolph","2020-12-18","15","3192","1","428","1.6","1.3"
"Randolph","2020-12-19","2","3194","0","428","1.6","1.3"
"Randolph","2020-12-20","9","3203","1","429","3.2","2.1"
"Randolph","2020-12-21","8","3211","2","431","6.1","3.4"
"Randolph","2020-12-22","10","3221","2","433","9","4.8"
"Randolph","2020-12-23","4","3225","0","433","9","4.8"
"Randolph","2020-12-24","4","3229","1","434","12.5","6.6"
"Randolph","2020-12-25","1","3230","0","434","11.6","6.6"
"Randolph","2020-12-26","3","3233","0","434","11.6","6.6"
"Randolph","2020-12-27","1","3234","0","434","10","6.6"
"Randolph","2020-12-28","7","3241","0","434","6.4","6.3"
"Randolph","2020-12-29","6","3247","2","436","8.3","8.7"
"Randolph","2020-12-30","7","3254","0","436","8.3","8.7"
"Randolph","2020-12-31","35","3289","3","439","6","9.3"
"Randolph","2021-01-01","4","3293","1","440","9.6","10.6"
"Randolph","2021-01-02","3","3296","0","440","9.6","10.6"
"Randolph","2021-01-03","3","3299","1","441","14.3","12.2"
"Randolph","2021-01-04","65","3364","3","444","15","10.7"
"Randolph","2021-01-05","12","3376","2","446","12.6","10.5"
"Randolph","2021-01-06","12","3388","1","447","13.8","11.1"
"Randolph","2021-01-07","9","3397","0","447","12.6","9.3"
"Randolph","2021-01-08","8","3405","3","450","14.3","12"
"Randolph","2021-01-09","2","3407","0","450","14.3","12"
"Randolph","2021-01-10","6","3413","2","452","14.3","14.3"
"Randolph","2021-01-11","44","3457","3","455","14.7","14.8"
"Randolph","2021-01-12","14","3471","0","455","12.3","12.4"
"Randolph","2021-01-13","14","3485","1","456","12.1","13"
"Randolph","2021-01-14","13","3498","1","457","13.2","12.9"
"Randolph","2021-01-15","22","3520","5","462","11.1","12.7"
"Randolph","2021-01-16","5","3525","0","462","11.1","12.7"
"Randolph","2021-01-17","4","3529","1","463","9.9","12.1"
"Randolph","2021-01-18","9","3538","2","465","12.1","13.4"
"Randolph","2021-01-19","13","3551","1","466","13.2","12.7"
"Randolph","2021-01-20","15","3566","1","467","13.1","12.6"
"Randolph","2021-01-21","10","3576","3","470","16.3","14.8"
"Randolph","2021-01-22","9","3585","2","472","16.3","13.7"
"Randolph","2021-01-23","6","3591","0","472","16.3","13.7"
"Randolph","2021-01-24","3","3594","1","473","17.4","13.7"
"Randolph","2021-01-25","4","3598","0","473","14.3","13.2"
"Randolph","2021-01-26","2","3600","2","475","27.5","20.3"
"Randolph","2021-01-27","0","3600","0","475","26.5","19.8"
"Richmond","2020-02-01","0","0","0","0",".","."
"Richmond","2020-02-02","0","0","0","0",".","."
"Richmond","2020-02-03","0","0","0","0",".","."
"Richmond","2020-02-04","0","0","0","0",".","."
"Richmond","2020-02-05","0","0","0","0",".","."
"Richmond","2020-02-06","0","0","0","0",".","."
"Richmond","2020-02-07","0","0","0","0","0","."
"Richmond","2020-02-08","0","0","0","0","0","."
"Richmond","2020-02-09","0","0","0","0","0","."
"Richmond","2020-02-10","0","0","0","0","0","."
"Richmond","2020-02-11","0","0","0","0","0","."
"Richmond","2020-02-12","0","0","0","0","0","."
"Richmond","2020-02-13","0","0","0","0","0","."
"Richmond","2020-02-14","0","0","0","0","0","0"
"Richmond","2020-02-15","0","0","0","0","0","0"
"Richmond","2020-02-16","0","0","0","0","0","0"
"Richmond","2020-02-17","0","0","0","0","0","0"
"Richmond","2020-02-18","0","0","0","0","0","0"
"Richmond","2020-02-19","0","0","0","0","0","0"
"Richmond","2020-02-20","0","0","0","0","0","0"
"Richmond","2020-02-21","0","0","0","0","0","0"
"Richmond","2020-02-22","0","0","0","0","0","0"
"Richmond","2020-02-23","0","0","0","0","0","0"
"Richmond","2020-02-24","0","0","0","0","0","0"
"Richmond","2020-02-25","0","0","0","0","0","0"
"Richmond","2020-02-26","0","0","0","0","0","0"
"Richmond","2020-02-27","0","0","0","0","0","0"
"Richmond","2020-02-28","0","0","0","0","0","0"
"Richmond","2020-02-29","0","0","0","0","0","0"
"Richmond","2020-03-01","0","0","0","0","0","0"
"Richmond","2020-03-02","0","0","0","0","0","0"
"Richmond","2020-03-03","0","0","0","0","0","0"
"Richmond","2020-03-04","0","0","0","0","0","0"
"Richmond","2020-03-05","0","0","0","0","0","0"
"Richmond","2020-03-06","0","0","0","0","0","0"
"Richmond","2020-03-07","3","3","0","0","0","0"
"Richmond","2020-03-08","1","4","0","0","0","0"
"Richmond","2020-03-09","4","8","0","0","0","0"
"Richmond","2020-03-10","0","8","0","0","0","0"
"Richmond","2020-03-11","2","10","0","0","0","0"
"Richmond","2020-03-12","1","11","0","0","0","0"
"Richmond","2020-03-13","3","14","0","0","0","0"
"Richmond","2020-03-14","7","21","0","0","0","0"
"Richmond","2020-03-15","12","33","0","0","0","0"
"Richmond","2020-03-16","46","79","1","1","0.3","0.2"
"Richmond","2020-03-17","39","118","2","3","1","0.5"
"Richmond","2020-03-18","14","132","1","4","2.1","1"
"Richmond","2020-03-19","17","149","0","4","2.1","1"
"Richmond","2020-03-20","27","176","5","9","4.7","2.4"
"Richmond","2020-03-21","13","189","2","11","6.9","3.5"
"Richmond","2020-03-22","3","192","0","11","6.9","3.5"
"Richmond","2020-03-23","16","208","2","13","8.4","4.3"
"Richmond","2020-03-24","26","234","6","19","10.9","6"
"Richmond","2020-03-25","12","246","1","20","11.1","6.6"
"Richmond","2020-03-26","20","266","2","22","12.5","7.3"
"Richmond","2020-03-27","21","287","2","24","11.3","8"
"Richmond","2020-03-28","3","290","1","25","13.8","10.4"
"Richmond","2020-03-29","2","292","0","25","13.8","10.4"
"Richmond","2020-03-30","18","310","2","27","13.6","11"
"Richmond","2020-03-31","22","332","1","28","11","11"
"Richmond","2020-04-01","50","382","2","30","10.4","10.7"
"Richmond","2020-04-02","115","497","13","43","10.5","11.5"
"Richmond","2020-04-03","230","727","39","82","11.6","11.4"
"Richmond","2020-04-04","288","1015","30","112","8.3","11.1"
"Richmond","2020-04-05","109","1124","22","134","11.2","12.5"
"Richmond","2020-04-06","121","1245","22","156","12.2","12.9"
"Richmond","2020-04-07","165","1410","15","171","12.9","11.9"
"Richmond","2020-04-08","151","1561","15","186","13.7","12"
"Richmond","2020-04-09","225","1786","77","263","17","13.8"
"Richmond","2020-04-10","138","1924","21","284","16.7","14.2"
"Richmond","2020-04-11","80","2004","9","293","16.9","12.6"
"Richmond","2020-04-12","34","2038","10","303","18.2","14.7"
"Richmond","2020-04-13","111","2149","10","313","16.9","14.6"
"Richmond","2020-04-14","113","2262","18","331","17.9","15.4"
"Richmond","2020-04-15","120","2382","14","345","18.1","15.9"
"Richmond","2020-04-16","106","2488","20","365","15.9","16.5"
"Richmond","2020-04-17","120","2608","11","376","15","15.9"
"Richmond","2020-04-18","91","2699","19","395","16.4","16.6"
"Richmond","2020-04-19","52","2751","16","411","16.6","17.4"
"Richmond","2020-04-20","226","2977","24","435","16.8","16.9"
"Richmond","2020-04-21","405","3382","25","460","15.4","16.7"
"Richmond","2020-04-22","181","3563","14","474","14.9","16.5"
"Richmond","2020-04-23","166","3729","12","486","13.2","14.6"
"Richmond","2020-04-24","295","4024","25","511","13.1","14.1"
"Richmond","2020-04-25","131","4155","11","522","11.3","13.9"
"Richmond","2020-04-26","81","4236","9","531","8.5","12.6"
"Richmond","2020-04-27","195","4431","13","544","8","12.4"
"Richmond","2020-04-28","257","4688","9","553","7.6","11.5"
"Richmond","2020-04-29","210","4898","18","571","7.7","11.3"
"Richmond","2020-04-30","208","5106","16","587","7.8","10.5"
"Richmond","2020-05-01","271","5377","16","603","7.4","10.3"
"Richmond","2020-05-02","197","5574","11","614","7","9.2"
"Richmond","2020-05-03","130","5704","12","626","6.7","7.6"
"Richmond","2020-05-04","218","5922","13","639","6.6","7.3"
"Richmond","2020-05-05","249","6171","12","651","6.8","7.2"
"Richmond","2020-05-06","327","6498","28","679","6.8","7.3"
"Richmond","2020-05-07","219","6717","14","693","6.6","7.2"
"Richmond","2020-05-08","244","6961","10","703","6.4","6.9"
"Richmond","2020-05-09","222","7183","9","712","6.2","6.6"
"Richmond","2020-05-10","28","7211","4","716","6.9","6.8"
"Richmond","2020-05-11","240","7451","4","720","6.3","6.5"
"Richmond","2020-05-12","322","7773","5","725","5.8","6.3"
"Richmond","2020-05-13","205","7978","12","737","5.4","6.1"
"Richmond","2020-05-14","573","8551","27","764","5.2","5.9"
"Richmond","2020-05-15","335","8886","6","770","4.8","5.6"
"Richmond","2020-05-16","288","9174","39","809","6.2","6.2"
"Richmond","2020-05-17","122","9296","4","813","4.6","5.8"
"Richmond","2020-05-18","210","9506","7","820","4.9","5.6"
"Richmond","2020-05-19","582","10088","25","845","5.3","5.5"
"Richmond","2020-05-20","226","10314","8","853","4.9","5.2"
"Richmond","2020-05-21","324","10638","18","871","5","5.1"
"Richmond","2020-05-22","218","10856","10","881","5.4","5.1"
"Richmond","2020-05-23","148","11004","9","890","4.4","5.3"
"Richmond","2020-05-24","155","11159","8","898","4.7","4.6"
"Richmond","2020-05-25","84","11243","1","899","4.3","4.6"
"Richmond","2020-05-26","219","11462","1","900","3.8","4.5"
"Richmond","2020-05-27","59","11521","1","901","3.5","4.2"
"Richmond","2020-05-28","191","11712","8","909","3.3","4.2"
"Richmond","2020-05-29","111","11823","4","913","3.2","4.3"
"Richmond","2020-05-30","42","11865","1","914","2.7","3.5"
"Richmond","2020-05-31","136","12001","8","922","2.8","3.7"
"Richmond","2020-06-01","222","12223","11","933","3.3","3.8"
"Richmond","2020-06-02","270","12493","11","944","3.8","3.8"
"Richmond","2020-06-03","203","12696","16","960","4.7","4.1"
"Richmond","2020-06-04","142","12838","8","968","4.9","4.1"
"Richmond","2020-06-05","140","12978","4","972","4.8","4"
"Richmond","2020-06-06","107","13085","8","980","5.5","4.1"
"Richmond","2020-06-07","59","13144","7","987","6.4","4.6"
"Richmond","2020-06-08","54","13198","2","989","6.2","4.8"
"Richmond","2020-06-09","227","13425","13","1002","6.4","5.1"
"Richmond","2020-06-10","280","13705","38","1040","7.3","6"
"Richmond","2020-06-11","238","13943","6","1046","6.8","5.9"
"Richmond","2020-06-12","192","14135","5","1051","6.8","5.8"
"Richmond","2020-06-13","136","14271","4","1055","6.1","5.8"
"Richmond","2020-06-14","146","14417","9","1064","5.3","5.9"
"Richmond","2020-06-15","296","14713","9","1073","5.2","5.7"
"Richmond","2020-06-16","363","15076","16","1089","5","5.7"
"Richmond","2020-06-17","70","15146","9","1098","4.9","6.1"
"Richmond","2020-06-18","174","15320","15","1113","5.8","6.3"
"Richmond","2020-06-19","234","15554","18","1131","6.5","6.7"
"Richmond","2020-06-20","174","15728","5","1136","6.5","6.3"
"Richmond","2020-06-21","70","15798","11","1147","7.9","6.6"
"Richmond","2020-06-22","360","16158","63","1210","10","7.6"
"Richmond","2020-06-23","338","16496","30","1240","10.6","7.8"
"Richmond","2020-06-24","324","16820","35","1275","10.3","7.6"
"Richmond","2020-06-25","343","17163","27","1302","10.2","8"
"Richmond","2020-06-26","329","17492","43","1345","11","8.7"
"Richmond","2020-06-27","252","17744","38","1383","12.7","9.6"
"Richmond","2020-06-28","193","17937","32","1415","12.8","10.4"
"Richmond","2020-06-29","414","18351","76","1491","12.9","11.5"
"Richmond","2020-06-30","653","19004","68","1559","13.2","11.9"
"Richmond","2020-07-01","570","19574","99","1658","14.1","12.2"
"Richmond","2020-07-02","552","20126","64","1722","14.6","12.4"
"Richmond","2020-07-03","456","20582","55","1777","14.5","12.7"
"Richmond","2020-07-04","103","20685","18","1795","14.8","13.8"
"Richmond","2020-07-05","310","20995","44","1839","14.5","13.7"
"Richmond","2020-07-06","647","21642","100","1939","14.1","13.5"
"Richmond","2020-07-07","572","22214","74","2013","14.4","13.8"
"Richmond","2020-07-08","623","22837","84","2097","13.9","14"
"Richmond","2020-07-09","646","23483","78","2175","14","14.3"
"Richmond","2020-07-10","696","24179","123","2298","14.8","14.6"
"Richmond","2020-07-11","523","24702","106","2404","15.2","15"
"Richmond","2020-07-12","512","25214","88","2492","15.6","15"
"Richmond","2020-07-13","650","25864","105","2597","15.7","14.9"
"Richmond","2020-07-14","744","26608","75","2672","15.3","14.9"
"Richmond","2020-07-15","700","27308","90","2762","15.2","14.5"
"Richmond","2020-07-16","742","28050","95","2857","15.3","14.6"
"Richmond","2020-07-17","481","28531","65","2922","14.7","14.7"
"Richmond","2020-07-18","439","28970","73","2995","14.2","14.7"
"Richmond","2020-07-19","515","29485","52","3047","13.2","14.4"
"Richmond","2020-07-20","648","30133","106","3153","13.2","14.4"
"Richmond","2020-07-21","675","30808","106","3259","14","14.6"
"Richmond","2020-07-22","666","31474","148","3407","15.3","15.3"
"Richmond","2020-07-23","674","32148","109","3516","15.8","15.6"
"Richmond","2020-07-24","589","32737","112","3628","16.6","15.6"
"Richmond","2020-07-25","509","33246","104","3732","17.1","15.7"
"Richmond","2020-07-26","389","33635","68","3800","18.2","15.7"
"Richmond","2020-07-27","1087","34722","167","3967","18.1","15.6"
"Richmond","2020-07-28","866","35588","149","4116","18.3","16.1"
"Richmond","2020-07-29","671","36259","126","4242","17.8","16.6"
"Richmond","2020-07-30","694","36953","143","4385","18.4","17.1"
"Richmond","2020-07-31","549","37502","97","4482","18.2","17.4"
"Richmond","2020-08-01","466","37968","81","4563","17.8","17.5"
"Richmond","2020-08-02","396","38364","75","4638","18","18.1"
"Richmond","2020-08-03","532","38896","124","4762","19.1","18.6"
"Richmond","2020-08-04","630","39526","122","4884","19.4","18.9"
"Richmond","2020-08-05","556","40082","95","4979","19.2","18.5"
"Richmond","2020-08-06","630","40712","105","5084","18.6","18.5"
"Richmond","2020-08-07","564","41276","89","5173","18.4","18.3"
"Richmond","2020-08-08","374","41650","59","5232","18.1","18"
"Richmond","2020-08-09","397","42047","55","5287","17.4","17.7"
"Richmond","2020-08-10","625","42672","99","5386","16.3","17.7"
"Richmond","2020-08-11","646","43318","130","5516","16.4","17.9"
"Richmond","2020-08-12","591","43909","109","5625","16.6","17.9"
"Richmond","2020-08-13","648","44557","112","5737","16.7","17.7"
"Richmond","2020-08-14","572","45129","96","5833","16.9","17.6"
"Richmond","2020-08-15","363","45492","64","5897","17.1","17.6"
"Richmond","2020-08-16","408","45900","56","5953","17.1","17.3"
"Richmond","2020-08-17","655","46555","76","6029","16.5","16.4"
"Richmond","2020-08-18","609","47164","102","6131","16","16.2"
"Richmond","2020-08-19","585","47749","85","6216","15.5","16.1"
"Richmond","2020-08-20","508","48257","47","6263","14.3","15.5"
"Richmond","2020-08-21","569","48826","78","6341","13.9","15.4"
"Richmond","2020-08-22","311","49137","50","6391","13.7","15.4"
"Richmond","2020-08-23","319","49456","28","6419","13","15"
"Richmond","2020-08-24","475","49931","93","6512","14.1","15.3"
"Richmond","2020-08-25","460","50391","69","6581","13.8","14.9"
"Richmond","2020-08-26","479","50870","77","6658","14.1","14.8"
"Richmond","2020-08-27","492","51362","60","6718","14.5","14.4"
"Richmond","2020-08-28","468","51830","51","6769","14.1","14"
"Richmond","2020-08-29","277","52107","35","6804","13.6","13.6"
"Richmond","2020-08-30","320","52427","56","6860","14.8","13.9"
"Richmond","2020-08-31","439","52866","46","6906","13.5","13.8"
"Richmond","2020-09-01","466","53332","50","6956","12.9","13.4"
"Richmond","2020-09-02","517","53849","54","7010","12.1","13.1"
"Richmond","2020-09-03","421","54270","67","7077","12.7","13.6"
"Richmond","2020-09-04","423","54693","81","7158","13.8","14"
"Richmond","2020-09-05","212","54905","20","7178","13.4","13.5"
"Richmond","2020-09-06","147","55052","25","7203","13.3","14.1"
"Richmond","2020-09-07","225","55277","14","7217","12.7","13.1"
"Richmond","2020-09-08","546","55823","88","7305","13.5","13.2"
"Richmond","2020-09-09","498","56321","59","7364","13.7","12.9"
"Richmond","2020-09-10","465","56786","68","7432","13.5","13.1"
"Richmond","2020-09-11","505","57291","74","7506","12.8","13.3"
"Richmond","2020-09-12","295","57586","39","7545","13.4","13.4"
"Richmond","2020-09-13","162","57748","17","7562","12.5","12.9"
"Richmond","2020-09-14","576","58324","59","7621","13","12.9"
"Richmond","2020-09-15","492","58816","59","7680","12.4","13"
"Richmond","2020-09-16","508","59324","63","7743","12.5","13.1"
"Richmond","2020-09-17","368","59692","51","7794","12.4","12.9"
"Richmond","2020-09-18","558","60250","71","7865","12.1","12.5"
"Richmond","2020-09-19","263","60513","20","7885","11.3","12.4"
"Richmond","2020-09-20","212","60725","21","7906","11.2","11.9"
"Richmond","2020-09-21","560","61285","37","7943","10.7","11.9"
"Richmond","2020-09-22","497","61782","51","7994","10.5","11.5"
"Richmond","2020-09-23","510","62292","43","8037","9.9","11.2"
"Richmond","2020-09-24","581","62873","64","8101","9.5","11"
"Richmond","2020-09-25","540","63413","40","8141","8.7","10.4"
"Richmond","2020-09-26","283","63696","19","8160","8.6","10"
"Richmond","2020-09-27","141","63837","7","8167","7.9","9.6"
"Richmond","2020-09-28","601","64438","33","8200","7.8","9.2"
"Richmond","2020-09-29","505","64943","31","8231","7.2","8.8"
"Richmond","2020-09-30","530","65473","53","8284","7.4","8.7"
"Richmond","2020-10-01","479","65952","35","8319","6.9","8.2"
"Richmond","2020-10-02","557","66509","32","8351","6.6","7.7"
"Richmond","2020-10-03","297","66806","20","8371","6.6","7.6"
"Richmond","2020-10-04","174","66980","6","8377","6.4","7.2"
"Richmond","2020-10-05","606","67586","40","8417","6.6","7.2"
"Richmond","2020-10-06","558","68144","54","8471","7.1","7.1"
"Richmond","2020-10-07","643","68787","47","8518","6.7","7"
"Richmond","2020-10-08","686","69473","37","8555","6.4","6.6"
"Richmond","2020-10-09","574","70047","42","8597","6.6","6.6"
"Richmond","2020-10-10","284","70331","21","8618","6.7","6.7"
"Richmond","2020-10-11","186","70517","9","8627","6.9","6.7"
"Richmond","2020-10-12","682","71199","37","8664","6.8","6.7"
"Richmond","2020-10-13","674","71873","31","8695","6","6.6"
"Richmond","2020-10-14","600","72473","44","8739","6","6.4"
"Richmond","2020-10-15","637","73110","41","8780","6.2","6.3"
"Richmond","2020-10-16","666","73776","38","8818","6","6.3"
"Richmond","2020-10-17","326","74102","19","8837","5.7","6.2"
"Richmond","2020-10-18","167","74269","9","8846","5.8","6.4"
"Richmond","2020-10-19","752","75021","45","8891","5.9","6.3"
"Richmond","2020-10-20","536","75557","37","8928","6.2","6.1"
"Richmond","2020-10-21","611","76168","35","8963","6","6"
"Richmond","2020-10-22","576","76744","37","9000","6","6.1"
"Richmond","2020-10-23","499","77243","26","9026","5.9","5.9"
"Richmond","2020-10-24","323","77566","24","9050","6.2","5.9"
"Richmond","2020-10-25","198","77764","10","9060","6.1","6"
"Richmond","2020-10-26","801","78565","59","9119","6.3","6.1"
"Richmond","2020-10-27","585","79150","34","9153","6.1","6.2"
"Richmond","2020-10-28","557","79707","43","9196","6.4","6.2"
"Richmond","2020-10-29","690","80397","59","9255","6.7","6.4"
"Richmond","2020-10-30","641","81038","43","9298","6.9","6.4"
"Richmond","2020-10-31","328","81366","22","9320","6.8","6.5"
"Richmond","2020-11-01","162","81528","8","9328","6.8","6.5"
"Richmond","2020-11-02","1136","82664","102","9430","7.1","6.7"
"Richmond","2020-11-03","666","83330","51","9481","7.3","6.7"
"Richmond","2020-11-04","764","84094","49","9530","7.1","6.8"
"Richmond","2020-11-05","944","85038","52","9582","6.7","6.7"
"Richmond","2020-11-06","931","85969","79","9661","7","7"
"Richmond","2020-11-07","500","86469","38","9699","7.1","7"
"Richmond","2020-11-08","372","86841","16","9715","7","6.9"
"Richmond","2020-11-09","1059","87900","85","9800","6.9","7"
"Richmond","2020-11-10","792","88692","67","9867","7","7.1"
"Richmond","2020-11-11","739","89431","51","9918","7","7.1"
"Richmond","2020-11-12","808","90239","59","9977","7.3","7"
"Richmond","2020-11-13","750","90989","43","10020","6.9","6.9"
"Richmond","2020-11-14","401","91390","41","10061","7.3","7.2"
"Richmond","2020-11-15","206","91596","19","10080","8","7.5"
"Richmond","2020-11-16","864","92460","84","10164","8.2","7.5"
"Richmond","2020-11-17","704","93164","67","10231","8.4","7.7"
"Richmond","2020-11-18","704","93868","65","10296","8.7","7.9"
"Richmond","2020-11-19","694","94562","79","10375","9.3","8.3"
"Richmond","2020-11-20","757","95319","61","10436","9.6","8.3"
"Richmond","2020-11-21","359","95678","29","10465","9.3","8.3"
"Richmond","2020-11-22","224","95902","16","10481","9","8.5"
"Richmond","2020-11-23","946","96848","88","10569","9","8.6"
"Richmond","2020-11-24","759","97607","90","10659","9.3","8.8"
"Richmond","2020-11-25","579","98186","45","10704","9.1","8.9"
"Richmond","2020-11-26","94","98280","17","10721","10","9.7"
"Richmond","2020-11-27","407","98687","52","10773","10.7","10.2"
"Richmond","2020-11-28","410","99097","54","10827","11.4","10.4"
"Richmond","2020-11-29","224","99321","31","10858","12.4","10.7"
"Richmond","2020-11-30","934","100255","129","10987","13","11"
"Richmond","2020-12-01","789","101044","117","11104","13.5","11.4"
"Richmond","2020-12-02","964","102008","149","11253","14.6","11.8"
"Richmond","2020-12-03","823","102831","97","11350","13.7","11.9"
"Richmond","2020-12-04","878","103709","124","11474","13.9","12.3"
"Richmond","2020-12-05","535","104244","121","11595","15.2","13.3"
"Richmond","2020-12-06","242","104486","29","11624","14.9","13.7"
"Richmond","2020-12-07","981","105467","114","11738","14.6","13.8"
"Richmond","2020-12-08","1024","106491","166","11904","14.8","14.1"
"Richmond","2020-12-09","1061","107552","171","12075","14.9","14.7"
"Richmond","2020-12-10","1053","108605","139","12214","15.1","14.4"
"Richmond","2020-12-11","980","109585","150","12364","15.3","14.6"
"Richmond","2020-12-12","449","110034","71","12435","14.3","14.8"
"Richmond","2020-12-13","293","110327","43","12478","14.7","14.8"
"Richmond","2020-12-14","1016","111343","147","12625","15.1","14.9"
"Richmond","2020-12-15","1089","112432","151","12776","14.8","14.8"
"Richmond","2020-12-16","963","113395","121","12897","14.3","14.6"
"Richmond","2020-12-17","903","114298","148","13045","14.7","14.9"
"Richmond","2020-12-18","879","115177","102","13147","14.2","14.7"
"Richmond","2020-12-19","469","115646","88","13235","14.6","14.5"
"Richmond","2020-12-20","297","115943","67","13302","15.7","15.2"
"Richmond","2020-12-21","1084","117027","157","13459","15.7","15.4"
"Richmond","2020-12-22","1029","118056","135","13594","15.6","15.2"
"Richmond","2020-12-23","974","119030","128","13722","15.7","15"
"Richmond","2020-12-24","240","119270","44","13766","16","15.4"
"Richmond","2020-12-25","75","119345","15","13781","17.2","15.7"
"Richmond","2020-12-26","396","119741","84","13865","17.5","16.1"
"Richmond","2020-12-27","279","120020","59","13924","17.3","16.5"
"Richmond","2020-12-28","1182","121202","240","14164","18.2","17"
"Richmond","2020-12-29","1021","122223","237","14401","19.6","17.6"
"Richmond","2020-12-30","1123","123346","208","14609","20.4","18.1"
"Richmond","2020-12-31","653","123999","121","14730","20.4","18.2"
"Richmond","2021-01-01","125","124124","42","14772","22.4","19.8"
"Richmond","2021-01-02","379","124503","112","14884","23.6","20.6"
"Richmond","2021-01-03","180","124683","55","14939","24.9","21.1"
"Richmond","2021-01-04","472","125155","121","15060","25.7","21.9"
"Richmond","2021-01-05","1570","126725","376","15436","25.8","22.7"
"Richmond","2021-01-06","1044","127769","238","15674","26.4","23.4"
"Richmond","2021-01-07","954","128723","245","15919","27.4","23.9"
"Richmond","2021-01-08","1059","129782","243","16162","25.9","24.1"
"Richmond","2021-01-09","612","130394","176","16338","25.8","24.7"
"Richmond","2021-01-10","302","130696","71","16409","24.8","24.8"
"Richmond","2021-01-11","1186","131882","278","16687","24.4","25"
"Richmond","2021-01-12","1247","133129","306","16993","24.5","25.1"
"Richmond","2021-01-13","1369","134498","298","17291","24.4","25.4"
"Richmond","2021-01-14","916","135414","193","17484","23.7","25.6"
"Richmond","2021-01-15","892","136306","208","17692","23.8","24.8"
"Richmond","2021-01-16","479","136785","113","17805","23","24.4"
"Richmond","2021-01-17","267","137052","44","17849","22","23.4"
"Richmond","2021-01-18","838","137890","202","18051","22.1","23.3"
"Richmond","2021-01-19","826","138716","160","18211","21.4","23"
"Richmond","2021-01-20","846","139562","192","18403","21.5","22.9"
"Richmond","2021-01-21","780","140342","175","18578","21.7","22.7"
"Richmond","2021-01-22","708","141050","144","18722","21.3","22.5"
"Richmond","2021-01-23","408","141458","88","18810","21","22"
"Richmond","2021-01-24","222","141680","40","18850","21.2","21.6"
"Richmond","2021-01-25","455","142135","61","18911","19.7","20.9"
"Richmond","2021-01-26","10","142145","1","18912","18.4","19.9"
"Richmond","2021-01-27","0","142145","0","18912","15.1","18.3"
"Rockdale","2020-02-01","0","0","0","0",".","."
"Rockdale","2020-02-02","0","0","0","0",".","."
"Rockdale","2020-02-03","0","0","0","0",".","."
"Rockdale","2020-02-04","0","0","0","0",".","."
"Rockdale","2020-02-05","0","0","0","0",".","."
"Rockdale","2020-02-06","0","0","0","0",".","."
"Rockdale","2020-02-07","0","0","0","0","0","."
"Rockdale","2020-02-08","0","0","0","0","0","."
"Rockdale","2020-02-09","0","0","0","0","0","."
"Rockdale","2020-02-10","0","0","0","0","0","."
"Rockdale","2020-02-11","0","0","0","0","0","."
"Rockdale","2020-02-12","0","0","0","0","0","."
"Rockdale","2020-02-13","0","0","0","0","0","."
"Rockdale","2020-02-14","0","0","0","0","0","0"
"Rockdale","2020-02-15","0","0","0","0","0","0"
"Rockdale","2020-02-16","0","0","0","0","0","0"
"Rockdale","2020-02-17","0","0","0","0","0","0"
"Rockdale","2020-02-18","0","0","0","0","0","0"
"Rockdale","2020-02-19","0","0","0","0","0","0"
"Rockdale","2020-02-20","0","0","0","0","0","0"
"Rockdale","2020-02-21","0","0","0","0","0","0"
"Rockdale","2020-02-22","0","0","0","0","0","0"
"Rockdale","2020-02-23","0","0","0","0","0","0"
"Rockdale","2020-02-24","0","0","0","0","0","0"
"Rockdale","2020-02-25","0","0","0","0","0","0"
"Rockdale","2020-02-26","0","0","0","0","0","0"
"Rockdale","2020-02-27","0","0","0","0","0","0"
"Rockdale","2020-02-28","0","0","0","0","0","0"
"Rockdale","2020-02-29","0","0","0","0","0","0"
"Rockdale","2020-03-01","0","0","0","0","0","0"
"Rockdale","2020-03-02","0","0","0","0","0","0"
"Rockdale","2020-03-03","0","0","0","0","0","0"
"Rockdale","2020-03-04","0","0","0","0","0","0"
"Rockdale","2020-03-05","0","0","0","0","0","0"
"Rockdale","2020-03-06","0","0","0","0","0","0"
"Rockdale","2020-03-07","0","0","0","0","0","0"
"Rockdale","2020-03-08","0","0","0","0","0","0"
"Rockdale","2020-03-09","0","0","0","0","0","0"
"Rockdale","2020-03-10","0","0","0","0","0","0"
"Rockdale","2020-03-11","0","0","0","0","0","0"
"Rockdale","2020-03-12","3","3","0","0","0","0"
"Rockdale","2020-03-13","3","6","3","3","14.3","7.1"
"Rockdale","2020-03-14","3","9","0","3","14.3","7.1"
"Rockdale","2020-03-15","1","10","0","3","14.3","7.1"
"Rockdale","2020-03-16","9","19","1","4","15.9","7.9"
"Rockdale","2020-03-17","10","29","1","5","17.3","8.7"
"Rockdale","2020-03-18","9","38","1","6","18.9","9.4"
"Rockdale","2020-03-19","19","57","6","12","23.4","11.7"
"Rockdale","2020-03-20","13","70","1","13","10.2","12.2"
"Rockdale","2020-03-21","3","73","0","13","10.2","12.2"
"Rockdale","2020-03-22","6","79","1","14","12.6","13.4"
"Rockdale","2020-03-23","30","109","10","24","15.8","15.8"
"Rockdale","2020-03-24","26","135","6","30","17.6","17.5"
"Rockdale","2020-03-25","22","157","7","37","20.6","19.7"
"Rockdale","2020-03-26","20","177","7","44","21.1","22.2"
"Rockdale","2020-03-27","27","204","7","51","23.7","17"
"Rockdale","2020-03-28","4","208","4","55","38","24.1"
"Rockdale","2020-03-29","3","211","3","58","49.9","31.2"
"Rockdale","2020-03-30","20","231","8","66","50.8","33.3"
"Rockdale","2020-03-31","16","247","3","69","50.2","33.9"
"Rockdale","2020-04-01","24","271","6","75","49.2","34.9"
"Rockdale","2020-04-02","33","304","6","81","46.8","34"
"Rockdale","2020-04-03","35","339","2","83","43.9","33.8"
"Rockdale","2020-04-04","16","355","3","86","32.3","35.2"
"Rockdale","2020-04-05","10","365","1","87","19.5","34.7"
"Rockdale","2020-04-06","38","403","4","91","15.3","33.1"
"Rockdale","2020-04-07","36","439","2","93","13.4","31.8"
"Rockdale","2020-04-08","46","485","3","96","10.7","30"
"Rockdale","2020-04-09","43","528","7","103","10.5","28.7"
"Rockdale","2020-04-10","39","567","7","110","12.2","28.1"
"Rockdale","2020-04-11","25","592","0","110","9.5","20.9"
"Rockdale","2020-04-12","5","597","0","110","8.1","13.8"
"Rockdale","2020-04-13","30","627","4","114","8.5","11.9"
"Rockdale","2020-04-14","52","679","5","119","9.1","11.2"
"Rockdale","2020-04-15","55","734","7","126","10","10.4"
"Rockdale","2020-04-16","202","936","14","140","8.7","9.6"
"Rockdale","2020-04-17","184","1120","11","151","6.9","9.6"
"Rockdale","2020-04-18","98","1218","2","153","7.2","8.4"
"Rockdale","2020-04-19","19","1237","0","153","7.2","7.7"
"Rockdale","2020-04-20","60","1297","5","158","6.5","7.5"
"Rockdale","2020-04-21","80","1377","8","166","6.6","7.8"
"Rockdale","2020-04-22","89","1466","3","169","5.2","7.6"
"Rockdale","2020-04-23","132","1598","7","176","5","6.8"
"Rockdale","2020-04-24","117","1715","9","185","5.2","6.1"
"Rockdale","2020-04-25","27","1742","3","188","6.5","6.9"
"Rockdale","2020-04-26","21","1763","1","189","7.2","7.2"
"Rockdale","2020-04-27","173","1936","10","199","6.9","6.7"
"Rockdale","2020-04-28","92","2028","10","209","7","6.8"
"Rockdale","2020-04-29","79","2107","3","212","7","6.1"
"Rockdale","2020-04-30","61","2168","3","215","7","6"
"Rockdale","2020-05-01","644","2812","15","230","6.2","5.7"
"Rockdale","2020-05-02","28","2840","2","232","5.7","6.1"
"Rockdale","2020-05-03","27","2867","2","234","6","6.6"
"Rockdale","2020-05-04","121","2988","6","240","5.9","6.4"
"Rockdale","2020-05-05","110","3098","6","246","5.1","6.1"
"Rockdale","2020-05-06","77","3175","2","248","5","6"
"Rockdale","2020-05-07","96","3271","8","256","5.5","6.2"
"Rockdale","2020-05-08","104","3375","3","259","5.5","5.9"
"Rockdale","2020-05-09","10","3385","0","259","4.5","5.1"
"Rockdale","2020-05-10","20","3405","3","262","5.6","5.8"
"Rockdale","2020-05-11","150","3555","2","264","5.1","5.5"
"Rockdale","2020-05-12","156","3711","0","264","4.3","4.7"
"Rockdale","2020-05-13","127","3838","3","267","4.3","4.6"
"Rockdale","2020-05-14","121","3959","0","267","3.1","4.3"
"Rockdale","2020-05-15","117","4076","5","272","3.3","4.4"
"Rockdale","2020-05-16","30","4106","0","272","3.3","3.9"
"Rockdale","2020-05-17","22","4128","0","272","1.1","3.4"
"Rockdale","2020-05-18","171","4299","6","278","1.4","3.3"
"Rockdale","2020-05-19","115","4414","2","280","1.7","3"
"Rockdale","2020-05-20","116","4530","6","286","2.1","3.2"
"Rockdale","2020-05-21","52","4582","0","286","2.1","2.6"
"Rockdale","2020-05-22","84","4666","6","292","2.5","2.9"
"Rockdale","2020-05-23","31","4697","0","292","2.5","2.9"
"Rockdale","2020-05-24","25","4722","2","294","3.7","2.4"
"Rockdale","2020-05-25","13","4735","0","294","3.2","2.3"
"Rockdale","2020-05-26","148","4883","7","301","3.6","2.6"
"Rockdale","2020-05-27","141","5024","3","304","3.1","2.6"
"Rockdale","2020-05-28","114","5138","4","308","3.6","2.9"
"Rockdale","2020-05-29","84","5222","4","312","3.3","2.9"
"Rockdale","2020-05-30","33","5255","1","313","3.7","3.1"
"Rockdale","2020-05-31","13","5268","0","313","2.6","3.1"
"Rockdale","2020-06-01","100","5368","5","318","3.3","3.2"
"Rockdale","2020-06-02","127","5495","7","325","3.4","3.5"
"Rockdale","2020-06-03","111","5606","2","327","3.4","3.3"
"Rockdale","2020-06-04","106","5712","4","331","3.4","3.5"
"Rockdale","2020-06-05","88","5800","5","336","3.5","3.4"
"Rockdale","2020-06-06","44","5844","3","339","4.1","3.9"
"Rockdale","2020-06-07","30","5874","2","341","5","3.8"
"Rockdale","2020-06-08","163","6037","4","345","4.7","4"
"Rockdale","2020-06-09","142","6179","8","353","4.7","4.1"
"Rockdale","2020-06-10","117","6296","4","357","4.9","4.1"
"Rockdale","2020-06-11","148","6444","6","363","5","4.2"
"Rockdale","2020-06-12","93","6537","3","366","4.6","4.1"
"Rockdale","2020-06-13","31","6568","3","369","5","4.6"
"Rockdale","2020-06-14","31","6599","4","373","5.9","5.5"
"Rockdale","2020-06-15","134","6733","9","382","6.5","5.6"
"Rockdale","2020-06-16","158","6891","8","390","6.4","5.6"
"Rockdale","2020-06-17","125","7016","8","398","6.9","5.9"
"Rockdale","2020-06-18","112","7128","4","402","6.8","5.9"
"Rockdale","2020-06-19","116","7244","11","413","7.7","6.1"
"Rockdale","2020-06-20","43","7287","6","419","8.3","6.7"
"Rockdale","2020-06-21","24","7311","6","425","10","8"
"Rockdale","2020-06-22","209","7520","14","439","10","8.3"
"Rockdale","2020-06-23","159","7679","11","450","10.3","8.4"
"Rockdale","2020-06-24","179","7858","16","466","10.7","8.8"
"Rockdale","2020-06-25","201","8059","24","490","11.8","9.3"
"Rockdale","2020-06-26","175","8234","16","506","11.8","9.7"
"Rockdale","2020-06-27","48","8282","7","513","11.9","10.1"
"Rockdale","2020-06-28","21","8303","4","517","11","10.5"
"Rockdale","2020-06-29","232","8535","26","543","11.7","10.9"
"Rockdale","2020-06-30","241","8776","23","566","12.1","11.2"
"Rockdale","2020-07-01","210","8986","24","590","12.4","11.5"
"Rockdale","2020-07-02","228","9214","33","623","12.8","12.3"
"Rockdale","2020-07-03","69","9283","18","641","15.2","13.5"
"Rockdale","2020-07-04","32","9315","9","650","17.1","14.5"
"Rockdale","2020-07-05","44","9359","10","660","17.7","14.3"
"Rockdale","2020-07-06","283","9642","38","698","18","14.8"
"Rockdale","2020-07-07","330","9972","32","730","18","15"
"Rockdale","2020-07-08","247","10219","26","756","17.9","15.1"
"Rockdale","2020-07-09","252","10471","46","802","18.4","15.6"
"Rockdale","2020-07-10","237","10708","40","842","17.1","16.1"
"Rockdale","2020-07-11","85","10793","16","858","15.8","16.4"
"Rockdale","2020-07-12","38","10831","8","866","15.5","16.6"
"Rockdale","2020-07-13","132","10963","16","882","15.3","16.7"
"Rockdale","2020-07-14","121","11084","21","903","16.4","17.2"
"Rockdale","2020-07-15","109","11193","19","922","17.4","17.6"
"Rockdale","2020-07-16","253","11446","23","945","16.1","17.3"
"Rockdale","2020-07-17","107","11553","9","954","14.9","16"
"Rockdale","2020-07-18","65","11618","13","967","15.1","15.4"
"Rockdale","2020-07-19","104","11722","11","978","13.6","14.5"
"Rockdale","2020-07-20","137","11859","24","1002","14.3","14.8"
"Rockdale","2020-07-21","147","12006","18","1020","13.6","15"
"Rockdale","2020-07-22","124","12130","13","1033","12.6","15"
"Rockdale","2020-07-23","142","12272","13","1046","12.6","14.4"
"Rockdale","2020-07-24","230","12502","28","1074","13.2","14"
"Rockdale","2020-07-25","81","12583","12","1086","12.4","13.7"
"Rockdale","2020-07-26","33","12616","3","1089","12.2","12.9"
"Rockdale","2020-07-27","289","12905","47","1136","12","13.2"
"Rockdale","2020-07-28","215","13120","31","1167","12.3","13"
"Rockdale","2020-07-29","220","13340","27","1194","12.6","12.6"
"Rockdale","2020-07-30","226","13566","22","1216","12.7","12.7"
"Rockdale","2020-07-31","200","13766","15","1231","12","12.6"
"Rockdale","2020-08-01","70","13836","3","1234","10.5","11.5"
"Rockdale","2020-08-02","35","13871","5","1239","11.3","11.7"
"Rockdale","2020-08-03","239","14110","20","1259","10.1","11.1"
"Rockdale","2020-08-04","238","14348","21","1280","9.3","10.8"
"Rockdale","2020-08-05","254","14602","27","1307","9.1","10.8"
"Rockdale","2020-08-06","236","14838","23","1330","9.1","10.9"
"Rockdale","2020-08-07","212","15050","19","1349","9.3","10.7"
"Rockdale","2020-08-08","87","15137","6","1355","9.7","10.1"
"Rockdale","2020-08-09","57","15194","7","1362","9.4","10.3"
"Rockdale","2020-08-10","248","15442","20","1382","9.3","9.7"
"Rockdale","2020-08-11","191","15633","22","1404","9.7","9.5"
"Rockdale","2020-08-12","257","15890","15","1419","9","9.1"
"Rockdale","2020-08-13","197","16087","11","1430","8.4","8.8"
"Rockdale","2020-08-14","240","16327","17","1447","8.2","8.7"
"Rockdale","2020-08-15","107","16434","11","1458","8.7","9.2"
"Rockdale","2020-08-16","49","16483","8","1466","9.2","9.3"
"Rockdale","2020-08-17","223","16706","21","1487","9.4","9.4"
"Rockdale","2020-08-18","177","16883","18","1505","9.2","9.5"
"Rockdale","2020-08-19","250","17133","22","1527","9.7","9.4"
"Rockdale","2020-08-20","168","17301","14","1541","10.1","9.3"
"Rockdale","2020-08-21","199","17500","8","1549","9.6","8.9"
"Rockdale","2020-08-22","63","17563","6","1555","9.5","9.1"
"Rockdale","2020-08-23","41","17604","3","1558","8.2","8.7"
"Rockdale","2020-08-24","169","17773","13","1571","8","8.7"
"Rockdale","2020-08-25","153","17926","8","1579","7.3","8.3"
"Rockdale","2020-08-26","142","18068","11","1590","7.1","8.4"
"Rockdale","2020-08-27","178","18246","11","1601","6.8","8.4"
"Rockdale","2020-08-28","200","18446","11","1612","7","8.3"
"Rockdale","2020-08-29","101","18547","12","1624","7.4","8.4"
"Rockdale","2020-08-30","46","18593","4","1628","7.6","7.9"
"Rockdale","2020-08-31","175","18768","10","1638","7.3","7.6"
"Rockdale","2020-09-01","103","18871","3","1641","6.9","7.1"
"Rockdale","2020-09-02","152","19023","5","1646","6.3","6.7"
"Rockdale","2020-09-03","129","19152","12","1658","6.8","6.8"
"Rockdale","2020-09-04","187","19339","8","1666","6.6","6.8"
"Rockdale","2020-09-05","47","19386","2","1668","5.5","6.4"
"Rockdale","2020-09-06","42","19428","3","1671","5.3","6.4"
"Rockdale","2020-09-07","34","19462","2","1673","5.3","6.3"
"Rockdale","2020-09-08","137","19599","11","1684","6","6.5"
"Rockdale","2020-09-09","157","19756","10","1694","6.5","6.4"
"Rockdale","2020-09-10","198","19954","8","1702","5.7","6.2"
"Rockdale","2020-09-11","161","20115","4","1706","5.5","6"
"Rockdale","2020-09-12","45","20160","3","1709","5.8","5.6"
"Rockdale","2020-09-13","22","20182","4","1713","7.4","6.3"
"Rockdale","2020-09-14","150","20332","7","1720","7.2","6.3"
"Rockdale","2020-09-15","141","20473","12","1732","7.3","6.6"
"Rockdale","2020-09-16","168","20641","15","1747","7.6","7.1"
"Rockdale","2020-09-17","115","20756","5","1752","7.7","6.7"
"Rockdale","2020-09-18","108","20864","4","1756","7.9","6.7"
"Rockdale","2020-09-19","83","20947","4","1760","7.6","6.7"
"Rockdale","2020-09-20","34","20981","3","1763","6.3","6.8"
"Rockdale","2020-09-21","141","21122","10","1773","6.6","6.9"
"Rockdale","2020-09-22","143","21265","3","1776","5.7","6.5"
"Rockdale","2020-09-23","179","21444","7","1783","5","6.3"
"Rockdale","2020-09-24","118","21562","5","1788","5","6.3"
"Rockdale","2020-09-25","162","21724","8","1796","5.1","6.5"
"Rockdale","2020-09-26","56","21780","2","1798","5","6.3"
"Rockdale","2020-09-27","36","21816","4","1802","5.3","5.8"
"Rockdale","2020-09-28","117","21933","2","1804","4.5","5.6"
"Rockdale","2020-09-29","149","22082","5","1809","4.7","5.2"
"Rockdale","2020-09-30","135","22217","8","1817","5","5"
"Rockdale","2020-10-01","135","22352","6","1823","5","5"
"Rockdale","2020-10-02","126","22478","2","1825","4.5","4.8"
"Rockdale","2020-10-03","77","22555","3","1828","4.6","4.8"
"Rockdale","2020-10-04","33","22588","1","1829","3.4","4.4"
"Rockdale","2020-10-05","140","22728","7","1836","3.9","4.2"
"Rockdale","2020-10-06","166","22894","10","1846","4.3","4.5"
"Rockdale","2020-10-07","195","23089","8","1854","4","4.5"
"Rockdale","2020-10-08","156","23245","14","1868","4.7","4.8"
"Rockdale","2020-10-09","194","23439","17","1885","5.7","5.1"
"Rockdale","2020-10-10","50","23489","6","1891","6.8","5.7"
"Rockdale","2020-10-11","37","23526","15","1906","12.2","7.8"
"Rockdale","2020-10-12","103","23629","5","1911","12.2","8"
"Rockdale","2020-10-13","139","23768","9","1920","12.2","8.3"
"Rockdale","2020-10-14","145","23913","11","1931","12.7","8.4"
"Rockdale","2020-10-15","162","24075","9","1940","12.3","8.5"
"Rockdale","2020-10-16","117","24192","10","1950","12.2","9"
"Rockdale","2020-10-17","70","24262","5","1955","11.5","9.2"
"Rockdale","2020-10-18","23","24285","3","1958","7.6","9.9"
"Rockdale","2020-10-19","218","24503","11","1969","7.6","9.9"
"Rockdale","2020-10-20","144","24647","14","1983","8.1","10.2"
"Rockdale","2020-10-21","174","24821","27","2010","9.2","11"
"Rockdale","2020-10-22","252","25073","19","2029","9.5","10.9"
"Rockdale","2020-10-23","161","25234","5","2034","8.7","10.5"
"Rockdale","2020-10-24","43","25277","4","2038","9","10.3"
"Rockdale","2020-10-25","51","25328","5","2043","8.6","8.1"
"Rockdale","2020-10-26","183","25511","17","2060","9.2","8.4"
"Rockdale","2020-10-27","141","25652","16","2076","9.4","8.8"
"Rockdale","2020-10-28","164","25816","8","2084","7.9","8.6"
"Rockdale","2020-10-29","130","25946","21","2105","9.1","9.3"
"Rockdale","2020-10-30","206","26152","27","2132","10.6","9.6"
"Rockdale","2020-10-31","67","26219","7","2139","10.7","9.9"
"Rockdale","2020-11-01","55","26274","5","2144","10.6","9.6"
"Rockdale","2020-11-02","213","26487","18","2162","10.5","9.8"
"Rockdale","2020-11-03","143","26630","11","2173","10","9.7"
"Rockdale","2020-11-04","198","26828","19","2192","10.6","9.3"
"Rockdale","2020-11-05","204","27032","11","2203","9.1","9.1"
"Rockdale","2020-11-06","167","27199","12","2215","8.3","9.4"
"Rockdale","2020-11-07","66","27265","6","2221","8.1","9.4"
"Rockdale","2020-11-08","50","27315","9","2230","9.3","10"
"Rockdale","2020-11-09","199","27514","19","2249","9.5","10"
"Rockdale","2020-11-10","203","27717","26","2275","10.2","10.1"
"Rockdale","2020-11-11","139","27856","11","2286","10","10.3"
"Rockdale","2020-11-12","183","28039","14","2300","10.3","9.7"
"Rockdale","2020-11-13","219","28258","16","2316","10.3","9.3"
"Rockdale","2020-11-14","97","28355","7","2323","10.1","9.1"
"Rockdale","2020-11-15","56","28411","14","2337","11.1","10.2"
"Rockdale","2020-11-16","262","28673","20","2357","10.8","10.1"
"Rockdale","2020-11-17","238","28911","20","2377","10.2","10.2"
"Rockdale","2020-11-18","230","29141","23","2400","10.5","10.2"
"Rockdale","2020-11-19","239","29380","19","2419","10.5","10.4"
"Rockdale","2020-11-20","283","29663","15","2434","10.2","10.3"
"Rockdale","2020-11-21","82","29745","9","2443","10.8","10.4"
"Rockdale","2020-11-22","75","29820","7","2450","8.5","9.8"
"Rockdale","2020-11-23","286","30106","28","2478","8.8","9.8"
"Rockdale","2020-11-24","227","30333","24","2502","9.1","9.6"
"Rockdale","2020-11-25","262","30595","26","2528","9.1","9.8"
"Rockdale","2020-11-26","52","30647","7","2535","9.9","10.2"
"Rockdale","2020-11-27","153","30800","24","2559","11.4","10.8"
"Rockdale","2020-11-28","139","30939","20","2579","11.9","11.3"
"Rockdale","2020-11-29","124","31063","11","2590","11.8","10.2"
"Rockdale","2020-11-30","322","31385","39","2629","12.1","10.5"
"Rockdale","2020-12-01","287","31672","38","2667","12.5","10.8"
"Rockdale","2020-12-02","321","31993","42","2709","13","11"
"Rockdale","2020-12-03","332","32325","54","2763","13.4","11.6"
"Rockdale","2020-12-04","292","32617","44","2807","13.3","12.3"
"Rockdale","2020-12-05","206","32823","14","2821","12.2","12"
"Rockdale","2020-12-06","108","32931","18","2839","13.3","12.6"
"Rockdale","2020-12-07","352","33283","47","2886","13.5","12.8"
"Rockdale","2020-12-08","336","33619","59","2945","14.1","13.3"
"Rockdale","2020-12-09","365","33984","72","3017","15.1","14"
"Rockdale","2020-12-10","302","34286","44","3061","14.8","14.1"
"Rockdale","2020-12-11","303","34589","41","3102","14.6","13.9"
"Rockdale","2020-12-12","183","34772","30","3132","16","14.1"
"Rockdale","2020-12-13","104","34876","18","3150","16.1","14.7"
"Rockdale","2020-12-14","374","35250","47","3197","16","14.7"
"Rockdale","2020-12-15","398","35648","56","3253","15.5","14.8"
"Rockdale","2020-12-16","342","35990","36","3289","14.1","14.6"
"Rockdale","2020-12-17","391","36381","53","3342","14","14.4"
"Rockdale","2020-12-18","355","36736","44","3386","13.8","14.2"
"Rockdale","2020-12-19","158","36894","31","3417","14.3","15.1"
"Rockdale","2020-12-20","84","36978","13","3430","14","15"
"Rockdale","2020-12-21","339","37317","40","3470","13.9","14.9"
"Rockdale","2020-12-22","401","37718","63","3533","14.2","14.8"
"Rockdale","2020-12-23","289","38007","64","3597","15.8","15"
"Rockdale","2020-12-24","193","38200","35","3632","16.5","15.2"
"Rockdale","2020-12-25","32","38232","11","3643","19.6","16.7"
"Rockdale","2020-12-26","146","38378","34","3677","20.1","17.2"
"Rockdale","2020-12-27","79","38457","19","3696","21.4","17.7"
"Rockdale","2020-12-28","353","38810","51","3747","21.7","17.8"
"Rockdale","2020-12-29","374","39184","61","3808","21.8","18"
"Rockdale","2020-12-30","406","39590","105","3913","22.4","19.1"
"Rockdale","2020-12-31","311","39901","65","3978","22.7","19.6"
"Rockdale","2021-01-01","48","39949","15","3993","22.3","21"
"Rockdale","2021-01-02","138","40087","24","4017","21.5","20.8"
"Rockdale","2021-01-03","92","40179","27","4044","22.2","21.8"
"Rockdale","2021-01-04","316","40495","59","4103","22.8","22.3"
"Rockdale","2021-01-05","419","40914","94","4197","23.7","22.8"
"Rockdale","2021-01-06","374","41288","79","4276","23","22.7"
"Rockdale","2021-01-07","451","41739","96","4372","23.1","22.9"
"Rockdale","2021-01-08","286","42025","46","4418","20.9","21.6"
"Rockdale","2021-01-09","207","42232","44","4462","21.5","21.5"
"Rockdale","2021-01-10","100","42332","23","4485","20.6","21.4"
"Rockdale","2021-01-11","427","42759","58","4543","19.8","21.3"
"Rockdale","2021-01-12","338","43097","61","4604","19.2","21.4"
"Rockdale","2021-01-13","341","43438","75","4679","19.3","21.2"
"Rockdale","2021-01-14","335","43773","47","4726","18.3","20.7"
"Rockdale","2021-01-15","466","44239","77","4803","18.3","19.6"
"Rockdale","2021-01-16","147","44386","20","4823","17.3","19.4"
"Rockdale","2021-01-17","91","44477","24","4847","17.7","19.1"
"Rockdale","2021-01-18","210","44687","30","4877","17.8","18.8"
"Rockdale","2021-01-19","325","45012","52","4929","17.5","18.4"
"Rockdale","2021-01-20","312","45324","40","4969","16.2","17.8"
"Rockdale","2021-01-21","257","45581","34","5003","16.1","17.2"
"Rockdale","2021-01-22","310","45891","28","5031","15","16.7"
"Rockdale","2021-01-23","107","45998","23","5054","16.2","16.7"
"Rockdale","2021-01-24","40","46038","11","5065","16.3","17"
"Rockdale","2021-01-25","101","46139","13","5078","16.1","17"
"Rockdale","2021-01-26","7","46146","3","5081","20","18.8"
"Rockdale","2021-01-27","0","46146","0","5081","18.1","17.2"
"Schley","2020-02-01","0","0","0","0",".","."
"Schley","2020-02-02","0","0","0","0",".","."
"Schley","2020-02-03","0","0","0","0",".","."
"Schley","2020-02-04","0","0","0","0",".","."
"Schley","2020-02-05","0","0","0","0",".","."
"Schley","2020-02-06","0","0","0","0",".","."
"Schley","2020-02-07","0","0","0","0","0","."
"Schley","2020-02-08","0","0","0","0","0","."
"Schley","2020-02-09","0","0","0","0","0","."
"Schley","2020-02-10","0","0","0","0","0","."
"Schley","2020-02-11","0","0","0","0","0","."
"Schley","2020-02-12","0","0","0","0","0","."
"Schley","2020-02-13","0","0","0","0","0","."
"Schley","2020-02-14","0","0","0","0","0","0"
"Schley","2020-02-15","0","0","0","0","0","0"
"Schley","2020-02-16","0","0","0","0","0","0"
"Schley","2020-02-17","0","0","0","0","0","0"
"Schley","2020-02-18","0","0","0","0","0","0"
"Schley","2020-02-19","0","0","0","0","0","0"
"Schley","2020-02-20","0","0","0","0","0","0"
"Schley","2020-02-21","0","0","0","0","0","0"
"Schley","2020-02-22","0","0","0","0","0","0"
"Schley","2020-02-23","0","0","0","0","0","0"
"Schley","2020-02-24","0","0","0","0","0","0"
"Schley","2020-02-25","0","0","0","0","0","0"
"Schley","2020-02-26","0","0","0","0","0","0"
"Schley","2020-02-27","0","0","0","0","0","0"
"Schley","2020-02-28","0","0","0","0","0","0"
"Schley","2020-02-29","0","0","0","0","0","0"
"Schley","2020-03-01","0","0","0","0","0","0"
"Schley","2020-03-02","0","0","0","0","0","0"
"Schley","2020-03-03","0","0","0","0","0","0"
"Schley","2020-03-04","0","0","0","0","0","0"
"Schley","2020-03-05","0","0","0","0","0","0"
"Schley","2020-03-06","0","0","0","0","0","0"
"Schley","2020-03-07","0","0","0","0","0","0"
"Schley","2020-03-08","0","0","0","0","0","0"
"Schley","2020-03-09","0","0","0","0","0","0"
"Schley","2020-03-10","0","0","0","0","0","0"
"Schley","2020-03-11","0","0","0","0","0","0"
"Schley","2020-03-12","0","0","0","0","0","0"
"Schley","2020-03-13","1","1","0","0","0","0"
"Schley","2020-03-14","0","1","0","0","0","0"
"Schley","2020-03-15","0","1","0","0","0","0"
"Schley","2020-03-16","1","2","0","0","0","0"
"Schley","2020-03-17","1","3","0","0","0","0"
"Schley","2020-03-18","0","3","0","0","0","0"
"Schley","2020-03-19","8","11","1","1","1.8","0.9"
"Schley","2020-03-20","1","12","0","1","1.8","0.9"
"Schley","2020-03-21","0","12","0","1","1.8","0.9"
"Schley","2020-03-22","2","14","2","3","16.1","8"
"Schley","2020-03-23","2","16","0","3","16.1","8"
"Schley","2020-03-24","2","18","1","4","23.2","11.6"
"Schley","2020-03-25","3","21","0","4","23.2","11.6"
"Schley","2020-03-26","1","22","0","4","21.4","11.6"
"Schley","2020-03-27","5","27","1","5","24.3","13"
"Schley","2020-03-28","3","30","1","6","29","15.4"
"Schley","2020-03-29","1","31","1","7","29","22.6"
"Schley","2020-03-30","5","36","0","7","29","22.6"
"Schley","2020-03-31","1","37","0","7","21.9","22.6"
"Schley","2020-04-01","7","44","3","10","28","25.6"
"Schley","2020-04-02","6","50","0","10","28","24.7"
"Schley","2020-04-03","4","54","2","12","32.3","28.3"
"Schley","2020-04-04","1","55","1","13","41.8","35.4"
"Schley","2020-04-05","2","57","0","13","27.6","28.3"
"Schley","2020-04-06","7","64","0","13","27.6","28.3"
"Schley","2020-04-07","9","73","1","14","29.1","25.5"
"Schley","2020-04-08","4","77","1","15","26.6","27.3"
"Schley","2020-04-09","4","81","0","15","26.6","27.3"
"Schley","2020-04-10","1","82","0","15","19.4","25.9"
"Schley","2020-04-11","0","82","0","15","5.2","23.5"
"Schley","2020-04-12","0","82","0","15","5.2","16.4"
"Schley","2020-04-13","5","87","1","16","8","17.8"
"Schley","2020-04-14","6","93","1","17","8.8","19"
"Schley","2020-04-15","3","96","0","17","5.2","15.9"
"Schley","2020-04-16","11","107","2","19","7.8","17.2"
"Schley","2020-04-17","3","110","0","19","7.8","13.6"
"Schley","2020-04-18","3","113","0","19","7.8","6.5"
"Schley","2020-04-19","2","115","0","19","7.8","6.5"
"Schley","2020-04-20","4","119","0","19","5","6.5"
"Schley","2020-04-21","7","126","0","19","2.6","5.7"
"Schley","2020-04-22","9","135","0","19","2.6","3.9"
"Schley","2020-04-23","0","135","0","19","0","3.9"
"Schley","2020-04-24","5","140","0","19","0","3.9"
"Schley","2020-04-25","3","143","1","20","4.8","6.3"
"Schley","2020-04-26","2","145","0","20","4.8","6.3"
"Schley","2020-04-27","5","150","0","20","4.8","4.9"
"Schley","2020-04-28","7","157","0","20","4.8","3.7"
"Schley","2020-04-29","7","164","0","20","4.8","3.7"
"Schley","2020-04-30","5","169","0","20","4.8","2.4"
"Schley","2020-05-01","3","172","0","20","4.8","2.4"
"Schley","2020-05-02","3","175","0","20","0","2.4"
"Schley","2020-05-03","0","175","0","20","0","2.4"
"Schley","2020-05-04","8","183","1","21","1.8","3.3"
"Schley","2020-05-05","6","189","0","21","1.8","3.3"
"Schley","2020-05-06","8","197","0","21","1.8","3.3"
"Schley","2020-05-07","3","200","0","21","1.8","3.3"
"Schley","2020-05-08","2","202","0","21","1.8","3.3"
"Schley","2020-05-09","0","202","0","21","1.8","0.9"
"Schley","2020-05-10","2","204","0","21","1.8","0.9"
"Schley","2020-05-11","8","212","2","23","3.6","2.7"
"Schley","2020-05-12","2","214","0","23","3.6","2.7"
"Schley","2020-05-13","3","217","0","23","3.6","2.7"
"Schley","2020-05-14","5","222","0","23","3.6","2.7"
"Schley","2020-05-15","2","224","0","23","3.6","2.7"
"Schley","2020-05-16","1","225","0","23","3.6","2.7"
"Schley","2020-05-17","1","226","0","23","3.6","2.7"
"Schley","2020-05-18","6","232","0","23","0","1.8"
"Schley","2020-05-19","10","242","0","23","0","1.8"
"Schley","2020-05-20","7","249","0","23","0","1.8"
"Schley","2020-05-21","9","258","0","23","0","1.8"
"Schley","2020-05-22","4","262","0","23","0","1.8"
"Schley","2020-05-23","3","265","0","23","0","1.8"
"Schley","2020-05-24","0","265","0","23","0","1.8"
"Schley","2020-05-25","2","267","0","23","0","0"
"Schley","2020-05-26","2","269","0","23","0","0"
"Schley","2020-05-27","3","272","0","23","0","0"
"Schley","2020-05-28","6","278","0","23","0","0"
"Schley","2020-05-29","9","287","0","23","0","0"
"Schley","2020-05-30","2","289","0","23","0","0"
"Schley","2020-05-31","4","293","0","23","0","0"
"Schley","2020-06-01","5","298","1","24","2.9","1.4"
"Schley","2020-06-02","9","307","1","25","4.4","2.2"
"Schley","2020-06-03","6","313","0","25","4.4","2.2"
"Schley","2020-06-04","16","329","0","25","4.4","2.2"
"Schley","2020-06-05","7","336","0","25","4.4","2.2"
"Schley","2020-06-06","2","338","0","25","4.4","2.2"
"Schley","2020-06-07","3","341","0","25","4.4","2.2"
"Schley","2020-06-08","7","348","0","25","1.6","2.2"
"Schley","2020-06-09","4","352","0","25","0","2.2"
"Schley","2020-06-10","12","364","1","26","1.2","2.8"
"Schley","2020-06-11","4","368","0","26","1.2","2.8"
"Schley","2020-06-12","4","372","0","26","1.2","2.8"
"Schley","2020-06-13","3","375","1","27","6","5.2"
"Schley","2020-06-14","0","375","0","27","6","5.2"
"Schley","2020-06-15","26","401","1","28","6.5","4"
"Schley","2020-06-16","9","410","0","28","6.5","3.3"
"Schley","2020-06-17","6","416","0","28","5.3","3.3"
"Schley","2020-06-18","15","431","0","28","5.3","3.3"
"Schley","2020-06-19","6","437","0","28","5.3","3.3"
"Schley","2020-06-20","2","439","0","28","0.5","3.3"
"Schley","2020-06-21","2","441","0","28","0.5","3.3"
"Schley","2020-06-22","10","451","0","28","0","3.3"
"Schley","2020-06-23","20","471","0","28","0","3.3"
"Schley","2020-06-24","16","487","1","29","0.9","3.1"
"Schley","2020-06-25","12","499","0","29","0.9","3.1"
"Schley","2020-06-26","13","512","2","31","3.1","4.2"
"Schley","2020-06-27","4","516","0","31","3.1","1.8"
"Schley","2020-06-28","1","517","0","31","3.1","1.8"
"Schley","2020-06-29","6","523","0","31","3.1","1.5"
"Schley","2020-06-30","6","529","0","31","3.1","1.5"
"Schley","2020-07-01","7","536","0","31","2.2","1.5"
"Schley","2020-07-02","3","539","0","31","2.2","1.5"
"Schley","2020-07-03","1","540","1","32","14.3","8.7"
"Schley","2020-07-04","1","541","0","32","14.3","8.7"
"Schley","2020-07-05","3","544","0","32","14.3","8.7"
"Schley","2020-07-06","21","565","6","38","18.4","10.7"
"Schley","2020-07-07","8","573","0","38","18.4","10.7"
"Schley","2020-07-08","17","590","0","38","18.4","10.3"
"Schley","2020-07-09","7","597","1","39","20.4","11.3"
"Schley","2020-07-10","9","606","1","40","7.7","11"
"Schley","2020-07-11","0","606","0","40","7.7","11"
"Schley","2020-07-12","2","608","0","40","7.7","11"
"Schley","2020-07-13","21","629","3","43","5.7","12"
"Schley","2020-07-14","23","652","3","46","7.5","12.9"
"Schley","2020-07-15","3","655","0","46","7.5","12.9"
"Schley","2020-07-16","6","661","0","46","5.5","12.9"
"Schley","2020-07-17","5","666","0","46","3.9","5.8"
"Schley","2020-07-18","5","671","1","47","6.8","7.2"
"Schley","2020-07-19","2","673","0","47","6.8","7.2"
"Schley","2020-07-20","31","704","8","55","8.4","7"
"Schley","2020-07-21","1","705","0","55","6.5","7"
"Schley","2020-07-22","3","708","1","56","11.3","9.4"
"Schley","2020-07-23","8","716","0","56","11.3","8.4"
"Schley","2020-07-24","9","725","1","57","12.9","8.4"
"Schley","2020-07-25","3","728","0","57","10","8.4"
"Schley","2020-07-26","3","731","2","59","19.6","13.2"
"Schley","2020-07-27","30","761","1","60","16.3","12.4"
"Schley","2020-07-28","24","785","1","61","16.9","11.7"
"Schley","2020-07-29","5","790","3","64","20.8","16"
"Schley","2020-07-30","6","796","2","66","25.5","18.4"
"Schley","2020-07-31","6","802","2","68","28.7","20.8"
"Schley","2020-08-01","1","803","0","68","28.7","19.4"
"Schley","2020-08-02","2","805","1","69","26.3","22.9"
"Schley","2020-08-03","23","828","1","70","26.5","21.4"
"Schley","2020-08-04","23","851","6","76","29.6","23.3"
"Schley","2020-08-05","3","854","0","76","21","20.9"
"Schley","2020-08-06","10","864","0","76","16.3","20.9"
"Schley","2020-08-07","10","874","0","76","11.5","20.1"
"Schley","2020-08-08","2","876","1","77","18.6","23.7"
"Schley","2020-08-09","3","879","0","77","11.5","18.9"
"Schley","2020-08-10","38","917","4","81","12.4","19.4"
"Schley","2020-08-11","38","955","3","84","9.8","19.7"
"Schley","2020-08-12","5","960","0","84","9.8","15.4"
"Schley","2020-08-13","6","966","0","84","9.8","13"
"Schley","2020-08-14","9","975","1","85","11.4","11.4"
"Schley","2020-08-15","1","976","0","85","4.2","11.4"
"Schley","2020-08-16","6","982","2","87","9","10.2"
"Schley","2020-08-17","9","991","3","90","12.2","12.3"
"Schley","2020-08-18","14","1005","0","90","11.1","10.4"
"Schley","2020-08-19","1","1006","0","90","11.1","10.4"
"Schley","2020-08-20","4","1010","0","90","11.1","10.4"
"Schley","2020-08-21","4","1014","1","91","13.1","12.2"
"Schley","2020-08-22","2","1016","0","91","13.1","8.7"
"Schley","2020-08-23","4","1020","0","91","8.3","8.7"
"Schley","2020-08-24","18","1038","2","93","5.2","8.7"
"Schley","2020-08-25","14","1052","1","94","6.2","8.6"
"Schley","2020-08-26","6","1058","0","94","6.2","8.6"
"Schley","2020-08-27","7","1065","2","96","10.3","10.7"
"Schley","2020-08-28","4","1069","0","96","6.7","9.9"
"Schley","2020-08-29","1","1070","0","96","6.7","9.9"
"Schley","2020-08-30","2","1072","0","96","6.7","7.5"
"Schley","2020-08-31","10","1082","2","98","8","6.6"
"Schley","2020-09-01","7","1089","0","98","6.9","6.6"
"Schley","2020-09-02","2","1091","0","98","6.9","6.6"
"Schley","2020-09-03","2","1093","0","98","2.9","6.6"
"Schley","2020-09-04","7","1100","0","98","2.9","4.8"
"Schley","2020-09-05","6","1106","0","98","2.9","4.8"
"Schley","2020-09-06","3","1109","1","99","7.6","7.2"
"Schley","2020-09-07","1","1110","0","99","4.8","6.4"
"Schley","2020-09-08","8","1118","0","99","4.8","5.9"
"Schley","2020-09-09","1","1119","0","99","4.8","5.9"
"Schley","2020-09-10","6","1125","1","100","7.1","5"
"Schley","2020-09-11","7","1132","1","101","9.2","6"
"Schley","2020-09-12","7","1139","0","101","9.2","6"
"Schley","2020-09-13","2","1141","0","101","4.4","6"
"Schley","2020-09-14","11","1152","0","101","4.4","4.6"
"Schley","2020-09-15","8","1160","1","102","6.2","5.5"
"Schley","2020-09-16","7","1167","0","102","6.2","5.5"
"Schley","2020-09-17","4","1171","0","102","3.8","5.5"
"Schley","2020-09-18","8","1179","1","103","3.6","6.4"
"Schley","2020-09-19","1","1180","0","103","3.6","6.4"
"Schley","2020-09-20","0","1180","0","103","3.6","4"
"Schley","2020-09-21","6","1186","0","103","3.6","4"
"Schley","2020-09-22","4","1190","0","103","1.8","4"
"Schley","2020-09-23","4","1194","0","103","1.8","4"
"Schley","2020-09-24","3","1197","0","103","1.8","2.8"
"Schley","2020-09-25","5","1202","0","103","0","1.8"
"Schley","2020-09-26","4","1206","1","104","3.6","3.6"
"Schley","2020-09-27","0","1206","0","104","3.6","3.6"
"Schley","2020-09-28","8","1214","0","104","3.6","3.6"
"Schley","2020-09-29","4","1218","1","105","7.1","4.5"
"Schley","2020-09-30","6","1224","0","105","7.1","4.5"
"Schley","2020-10-01","5","1229","0","105","7.1","4.5"
"Schley","2020-10-02","3","1232","0","105","7.1","3.6"
"Schley","2020-10-03","1","1233","0","105","3.6","3.6"
"Schley","2020-10-04","2","1235","0","105","3.6","3.6"
"Schley","2020-10-05","11","1246","0","105","3.6","3.6"
"Schley","2020-10-06","5","1251","0","105","0","3.6"
"Schley","2020-10-07","10","1261","1","106","1.4","4.3"
"Schley","2020-10-08","4","1265","0","106","1.4","4.3"
"Schley","2020-10-09","7","1272","1","107","3.5","5.3"
"Schley","2020-10-10","3","1275","1","108","8.2","5.9"
"Schley","2020-10-11","0","1275","0","108","8.2","5.9"
"Schley","2020-10-12","7","1282","0","108","8.2","5.9"
"Schley","2020-10-13","2","1284","0","108","8.2","4.1"
"Schley","2020-10-14","10","1294","1","109","8.2","4.8"
"Schley","2020-10-15","8","1302","0","109","8.2","4.8"
"Schley","2020-10-16","10","1312","0","109","6.2","4.8"
"Schley","2020-10-17","2","1314","0","109","1.4","4.8"
"Schley","2020-10-18","1","1315","0","109","1.4","4.8"
"Schley","2020-10-19","4","1319","0","109","1.4","4.8"
"Schley","2020-10-20","9","1328","0","109","1.4","4.8"
"Schley","2020-10-21","2","1330","0","109","0","4.1"
"Schley","2020-10-22","4","1334","0","109","0","4.1"
"Schley","2020-10-23","5","1339","0","109","0","3.1"
"Schley","2020-10-24","6","1345","0","109","0","0.7"
"Schley","2020-10-25","2","1347","0","109","0","0.7"
"Schley","2020-10-26","6","1353","0","109","0","0.7"
"Schley","2020-10-27","8","1361","1","110","1.8","1.6"
"Schley","2020-10-28","4","1365","0","110","1.8","0.9"
"Schley","2020-10-29","3","1368","0","110","1.8","0.9"
"Schley","2020-10-30","2","1370","0","110","1.8","0.9"
"Schley","2020-10-31","7","1377","0","110","1.8","0.9"
"Schley","2020-11-01","1","1378","0","110","1.8","0.9"
"Schley","2020-11-02","8","1386","0","110","1.8","0.9"
"Schley","2020-11-03","3","1389","0","110","0","0.9"
"Schley","2020-11-04","4","1393","2","112","7.1","4.5"
"Schley","2020-11-05","6","1399","1","113","9.5","5.7"
"Schley","2020-11-06","5","1404","0","113","9.5","5.7"
"Schley","2020-11-07","1","1405","0","113","9.5","5.7"
"Schley","2020-11-08","7","1412","1","114","11.6","6.7"
"Schley","2020-11-09","7","1419","0","114","11.6","6.7"
"Schley","2020-11-10","12","1431","0","114","11.6","5.8"
"Schley","2020-11-11","5","1436","0","114","4.4","5.8"
"Schley","2020-11-12","10","1446","0","114","2","5.8"
"Schley","2020-11-13","10","1456","0","114","2","5.8"
"Schley","2020-11-14","3","1459","0","114","2","5.8"
"Schley","2020-11-15","5","1464","0","114","0","5.8"
"Schley","2020-11-16","6","1470","1","115","2.4","7"
"Schley","2020-11-17","8","1478","1","116","4.2","7.9"
"Schley","2020-11-18","7","1485","0","116","4.2","4.3"
"Schley","2020-11-19","11","1496","1","117","5.5","3.8"
"Schley","2020-11-20","9","1505","1","118","7.1","4.5"
"Schley","2020-11-21","5","1510","0","118","7.1","4.5"
"Schley","2020-11-22","3","1513","0","118","7.1","3.5"
"Schley","2020-11-23","3","1516","0","118","4.7","3.5"
"Schley","2020-11-24","6","1522","1","119","5.3","4.7"
"Schley","2020-11-25","7","1529","1","120","7.3","5.7"
"Schley","2020-11-26","4","1533","0","120","6","5.7"
"Schley","2020-11-27","1","1534","0","120","4.4","5.7"
"Schley","2020-11-28","1","1535","0","120","4.4","5.7"
"Schley","2020-11-29","4","1539","2","122","11.6","9.3"
"Schley","2020-11-30","23","1562","4","126","14","9.4"
"Schley","2020-12-01","6","1568","1","127","14","9.7"
"Schley","2020-12-02","9","1577","0","127","12","9.7"
"Schley","2020-12-03","12","1589","0","127","12","9"
"Schley","2020-12-04","6","1595","2","129","16.8","10.6"
"Schley","2020-12-05","1","1596","0","129","16.8","10.6"
"Schley","2020-12-06","2","1598","0","129","9.6","10.6"
"Schley","2020-12-07","10","1608","1","130","8.6","11.3"
"Schley","2020-12-08","10","1618","0","130","6.2","10.1"
"Schley","2020-12-09","4","1622","0","130","6.2","9.1"
"Schley","2020-12-10","10","1632","2","132","9","10.5"
"Schley","2020-12-11","14","1646","1","133","5.3","11"
"Schley","2020-12-12","3","1649","0","133","5.3","11"
"Schley","2020-12-13","3","1652","0","133","5.3","7.5"
"Schley","2020-12-14","21","1673","1","134","4.6","6.6"
"Schley","2020-12-15","5","1678","2","136","10.3","8.2"
"Schley","2020-12-16","4","1682","0","136","10.3","8.2"
"Schley","2020-12-17","14","1696","1","137","8.4","8.7"
"Schley","2020-12-18","5","1701","1","138","10.3","7.8"
"Schley","2020-12-19","5","1706","0","138","10.3","7.8"
"Schley","2020-12-20","2","1708","0","138","10.3","7.8"
"Schley","2020-12-21","31","1739","3","141","11","7.8"
"Schley","2020-12-22","9","1748","0","141","5.3","7.8"
"Schley","2020-12-23","9","1757","2","143","8.4","9.4"
"Schley","2020-12-24","4","1761","0","143","7.4","7.9"
"Schley","2020-12-25","1","1762","0","143","4.6","7.4"
"Schley","2020-12-26","1","1763","0","143","4.6","7.4"
"Schley","2020-12-27","2","1765","0","143","4.6","7.4"
"Schley","2020-12-28","16","1781","0","143","3.2","7.1"
"Schley","2020-12-29","9","1790","4","147","9.5","7.4"
"Schley","2020-12-30","13","1803","1","148","7.4","7.9"
"Schley","2020-12-31","4","1807","0","148","7.4","7.4"
"Schley","2021-01-01","5","1812","0","148","7.4","6"
"Schley","2021-01-02","1","1813","0","148","7.4","6"
"Schley","2021-01-03","7","1820","2","150","11.5","8"
"Schley","2021-01-04","50","1870","1","151","11.8","7.5"
"Schley","2021-01-05","3","1873","0","151","5.5","7.5"
"Schley","2021-01-06","2","1875","1","152","11.5","9.5"
"Schley","2021-01-07","8","1883","0","152","11.5","9.5"
"Schley","2021-01-08","12","1895","1","153","12.7","10.1"
"Schley","2021-01-09","1","1896","0","153","12.7","10.1"
"Schley","2021-01-10","1","1897","0","153","8.6","10.1"
"Schley","2021-01-11","4","1901","0","153","8.3","10.1"
"Schley","2021-01-12","24","1925","5","158","11.3","8.4"
"Schley","2021-01-13","10","1935","2","160","7","9.3"
"Schley","2021-01-14","8","1943","1","161","8.8","10.2"
"Schley","2021-01-15","6","1949","1","162","10","11.4"
"Schley","2021-01-16","5","1954","1","163","12.9","12.8"
"Schley","2021-01-17","6","1960","1","164","15.2","11.9"
"Schley","2021-01-18","6","1966","2","166","20","14.2"
"Schley","2021-01-19","9","1975","0","166","17","14.2"
"Schley","2021-01-20","9","1984","2","168","17.3","12.2"
"Schley","2021-01-21","4","1988","1","169","19.1","14"
"Schley","2021-01-22","11","1999","1","170","18","14"
"Schley","2021-01-23","3","2002","1","171","19.9","16.4"
"Schley","2021-01-24","2","2004","0","171","17.6","16.4"
"Schley","2021-01-25","2","2006","0","171","12.8","16.4"
"Schley","2021-01-26","4","2010","0","171","12.8","14.9"
"Schley","2021-01-27","0","2010","0","171","9.6","13.5"
"Screven","2020-02-01","0","0","0","0",".","."
"Screven","2020-02-02","0","0","0","0",".","."
"Screven","2020-02-03","0","0","0","0",".","."
"Screven","2020-02-04","0","0","0","0",".","."
"Screven","2020-02-05","0","0","0","0",".","."
"Screven","2020-02-06","0","0","0","0",".","."
"Screven","2020-02-07","0","0","0","0","0","."
"Screven","2020-02-08","0","0","0","0","0","."
"Screven","2020-02-09","0","0","0","0","0","."
"Screven","2020-02-10","0","0","0","0","0","."
"Screven","2020-02-11","0","0","0","0","0","."
"Screven","2020-02-12","0","0","0","0","0","."
"Screven","2020-02-13","0","0","0","0","0","."
"Screven","2020-02-14","0","0","0","0","0","0"
"Screven","2020-02-15","0","0","0","0","0","0"
"Screven","2020-02-16","0","0","0","0","0","0"
"Screven","2020-02-17","0","0","0","0","0","0"
"Screven","2020-02-18","0","0","0","0","0","0"
"Screven","2020-02-19","0","0","0","0","0","0"
"Screven","2020-02-20","0","0","0","0","0","0"
"Screven","2020-02-21","0","0","0","0","0","0"
"Screven","2020-02-22","0","0","0","0","0","0"
"Screven","2020-02-23","0","0","0","0","0","0"
"Screven","2020-02-24","0","0","0","0","0","0"
"Screven","2020-02-25","0","0","0","0","0","0"
"Screven","2020-02-26","0","0","0","0","0","0"
"Screven","2020-02-27","0","0","0","0","0","0"
"Screven","2020-02-28","0","0","0","0","0","0"
"Screven","2020-02-29","0","0","0","0","0","0"
"Screven","2020-03-01","0","0","0","0","0","0"
"Screven","2020-03-02","0","0","0","0","0","0"
"Screven","2020-03-03","0","0","0","0","0","0"
"Screven","2020-03-04","0","0","0","0","0","0"
"Screven","2020-03-05","0","0","0","0","0","0"
"Screven","2020-03-06","0","0","0","0","0","0"
"Screven","2020-03-07","0","0","0","0","0","0"
"Screven","2020-03-08","0","0","0","0","0","0"
"Screven","2020-03-09","0","0","0","0","0","0"
"Screven","2020-03-10","0","0","0","0","0","0"
"Screven","2020-03-11","0","0","0","0","0","0"
"Screven","2020-03-12","0","0","0","0","0","0"
"Screven","2020-03-13","0","0","0","0","0","0"
"Screven","2020-03-14","0","0","0","0","0","0"
"Screven","2020-03-15","0","0","0","0","0","0"
"Screven","2020-03-16","0","0","0","0","0","0"
"Screven","2020-03-17","6","6","0","0","0","0"
"Screven","2020-03-18","0","6","0","0","0","0"
"Screven","2020-03-19","0","6","0","0","0","0"
"Screven","2020-03-20","1","7","0","0","0","0"
"Screven","2020-03-21","0","7","0","0","0","0"
"Screven","2020-03-22","0","7","0","0","0","0"
"Screven","2020-03-23","4","11","0","0","0","0"
"Screven","2020-03-24","5","16","0","0","0","0"
"Screven","2020-03-25","5","21","0","0","0","0"
"Screven","2020-03-26","5","26","0","0","0","0"
"Screven","2020-03-27","3","29","0","0","0","0"
"Screven","2020-03-28","0","29","0","0","0","0"
"Screven","2020-03-29","0","29","0","0","0","0"
"Screven","2020-03-30","3","32","0","0","0","0"
"Screven","2020-03-31","1","33","1","1","14.3","7.1"
"Screven","2020-04-01","0","33","0","1","14.3","7.1"
"Screven","2020-04-02","4","37","1","2","17.9","8.9"
"Screven","2020-04-03","2","39","0","2","17.9","8.9"
"Screven","2020-04-04","1","40","1","3","32.1","16.1"
"Screven","2020-04-05","2","42","0","3","32.1","16.1"
"Screven","2020-04-06","8","50","2","5","35.7","17.9"
"Screven","2020-04-07","4","54","1","6","25","19.6"
"Screven","2020-04-08","4","58","1","7","28.6","21.4"
"Screven","2020-04-09","5","63","0","7","25","21.4"
"Screven","2020-04-10","2","65","0","7","25","21.4"
"Screven","2020-04-11","2","67","0","7","10.7","21.4"
"Screven","2020-04-12","1","68","1","8","25","28.6"
"Screven","2020-04-13","5","73","0","8","21.4","28.6"
"Screven","2020-04-14","7","80","0","8","17.9","21.4"
"Screven","2020-04-15","7","87","0","8","14.3","21.4"
"Screven","2020-04-16","11","98","0","8","14.3","19.6"
"Screven","2020-04-17","4","102","0","8","14.3","19.6"
"Screven","2020-04-18","1","103","0","8","14.3","12.5"
"Screven","2020-04-19","0","103","0","8","0","12.5"
"Screven","2020-04-20","2","105","0","8","0","10.7"
"Screven","2020-04-21","5","110","0","8","0","8.9"
"Screven","2020-04-22","4","114","0","8","0","7.1"
"Screven","2020-04-23","2","116","0","8","0","7.1"
"Screven","2020-04-24","3","119","1","9","4.8","9.5"
"Screven","2020-04-25","0","119","0","9","4.8","9.5"
"Screven","2020-04-26","1","120","0","9","4.8","2.4"
"Screven","2020-04-27","5","125","0","9","4.8","2.4"
"Screven","2020-04-28","4","129","1","10","8.3","4.2"
"Screven","2020-04-29","3","132","0","10","8.3","4.2"
"Screven","2020-04-30","0","132","0","10","8.3","4.2"
"Screven","2020-05-01","5","137","0","10","3.6","4.2"
"Screven","2020-05-02","2","139","1","11","10.7","7.7"
"Screven","2020-05-03","0","139","0","11","10.7","7.7"
"Screven","2020-05-04","4","143","0","11","10.7","7.7"
"Screven","2020-05-05","8","151","0","11","7.1","7.7"
"Screven","2020-05-06","1","152","0","11","7.1","7.7"
"Screven","2020-05-07","5","157","0","11","7.1","7.7"
"Screven","2020-05-08","5","162","0","11","7.1","5.4"
"Screven","2020-05-09","0","162","0","11","0","5.4"
"Screven","2020-05-10","2","164","0","11","0","5.4"
"Screven","2020-05-11","4","168","0","11","0","5.4"
"Screven","2020-05-12","4","172","1","12","3.6","5.4"
"Screven","2020-05-13","5","177","0","12","3.6","5.4"
"Screven","2020-05-14","11","188","0","12","3.6","5.4"
"Screven","2020-05-15","6","194","1","13","6","6.5"
"Screven","2020-05-16","2","196","0","13","6","3"
"Screven","2020-05-17","3","199","1","14","10.7","5.4"
"Screven","2020-05-18","5","204","1","15","13.6","6.8"
"Screven","2020-05-19","2","206","0","15","10","6.8"
"Screven","2020-05-20","3","209","0","15","10","6.8"
"Screven","2020-05-21","13","222","0","15","10","6.8"
"Screven","2020-05-22","9","231","1","16","9.2","7.6"
"Screven","2020-05-23","1","232","0","16","9.2","7.6"
"Screven","2020-05-24","3","235","0","16","4.4","7.6"
"Screven","2020-05-25","2","237","0","16","1.6","7.6"
"Screven","2020-05-26","6","243","2","18","6.3","8.2"
"Screven","2020-05-27","9","252","0","18","6.3","8.2"
"Screven","2020-05-28","2","254","1","19","13.5","11.7"
"Screven","2020-05-29","2","256","0","19","11.9","10.6"
"Screven","2020-05-30","1","257","0","19","11.9","10.6"
"Screven","2020-05-31","1","258","1","20","26.2","15.3"
"Screven","2020-06-01","6","264","0","20","26.2","13.9"
"Screven","2020-06-02","6","270","0","20","21.4","13.9"
"Screven","2020-06-03","8","278","0","20","21.4","13.9"
"Screven","2020-06-04","8","286","1","21","16.1","14.8"
"Screven","2020-06-05","2","288","0","21","16.1","14"
"Screven","2020-06-06","0","288","0","21","16.1","14"
"Screven","2020-06-07","2","290","0","21","1.8","14"
"Screven","2020-06-08","3","293","1","22","6.5","16.4"
"Screven","2020-06-09","5","298","0","22","6.5","14"
"Screven","2020-06-10","3","301","0","22","6.5","14"
"Screven","2020-06-11","3","304","0","22","4.8","10.4"
"Screven","2020-06-12","9","313","0","22","4.8","10.4"
"Screven","2020-06-13","10","323","0","22","4.8","10.4"
"Screven","2020-06-14","2","325","0","22","4.8","3.3"
"Screven","2020-06-15","13","338","1","23","1.1","3.8"
"Screven","2020-06-16","5","343","0","23","1.1","3.8"
"Screven","2020-06-17","4","347","0","23","1.1","3.8"
"Screven","2020-06-18","2","349","0","23","1.1","2.9"
"Screven","2020-06-19","8","357","1","24","2.9","3.8"
"Screven","2020-06-20","4","361","0","24","2.9","3.8"
"Screven","2020-06-21","3","364","0","24","2.9","3.8"
"Screven","2020-06-22","14","378","0","24","1.8","1.4"
"Screven","2020-06-23","4","382","0","24","1.8","1.4"
"Screven","2020-06-24","14","396","1","25","2.8","2"
"Screven","2020-06-25","13","409","0","25","2.8","2"
"Screven","2020-06-26","23","432","1","26","1.6","2.3"
"Screven","2020-06-27","2","434","0","26","1.6","2.3"
"Screven","2020-06-28","2","436","0","26","1.6","2.3"
"Screven","2020-06-29","13","449","0","26","1.6","1.7"
"Screven","2020-06-30","9","458","1","27","3.2","2.5"
"Screven","2020-07-01","12","470","0","27","2.2","2.5"
"Screven","2020-07-02","21","491","1","28","2.9","2.8"
"Screven","2020-07-03","8","499","0","28","2.3","2"
"Screven","2020-07-04","3","502","1","29","7","4.3"
"Screven","2020-07-05","4","506","1","30","10.6","6.1"
"Screven","2020-07-06","20","526","3","33","12.7","7.2"
"Screven","2020-07-07","20","546","1","34","11.9","7.5"
"Screven","2020-07-08","16","562","1","35","12.8","7.5"
"Screven","2020-07-09","22","584","3","38","14","8.5"
"Screven","2020-07-10","20","604","0","38","14","8.1"
"Screven","2020-07-11","5","609","3","41","17.8","12.4"
"Screven","2020-07-12","4","613","0","41","14.3","12.4"
"Screven","2020-07-13","25","638","6","47","15.6","14.1"
"Screven","2020-07-14","15","653","1","48","15.8","13.8"
"Screven","2020-07-15","10","663","1","49","16.3","14.5"
"Screven","2020-07-16","15","678","1","50","15.3","14.7"
"Screven","2020-07-17","26","704","1","51","15.9","15"
"Screven","2020-07-18","6","710","2","53","12.1","15"
"Screven","2020-07-19","2","712","0","53","12.1","13.2"
"Screven","2020-07-20","11","723","2","55","11.2","13.4"
"Screven","2020-07-21","17","740","6","61","15.3","15.6"
"Screven","2020-07-22","17","757","3","64","16.4","16.4"
"Screven","2020-07-23","12","769","0","64","15.5","15.4"
"Screven","2020-07-24","8","777","1","65","16.7","16.3"
"Screven","2020-07-25","5","782","2","67","17.7","14.9"
"Screven","2020-07-26","12","794","2","69","20","16.1"
"Screven","2020-07-27","20","814","4","73","20.3","15.8"
"Screven","2020-07-28","10","824","2","75","18.1","16.7"
"Screven","2020-07-29","10","834","1","76","17","16.7"
"Screven","2020-07-30","12","846","2","78","19.4","17.4"
"Screven","2020-07-31","11","857","2","80","20.2","18.5"
"Screven","2020-08-01","5","862","0","80","14.5","16.1"
"Screven","2020-08-02","2","864","0","80","12.1","16.1"
"Screven","2020-08-03","10","874","4","84","15","17.6"
"Screven","2020-08-04","14","888","7","91","19.3","18.7"
"Screven","2020-08-05","9","897","2","93","21","19"
"Screven","2020-08-06","8","905","2","95","22.2","20.8"
"Screven","2020-08-07","23","928","2","97","20.8","20.5"
"Screven","2020-08-08","5","933","1","98","23.7","19.1"
"Screven","2020-08-09","6","939","1","99","26.1","19.1"
"Screven","2020-08-10","13","952","0","99","20.4","17.7"
"Screven","2020-08-11","21","973","7","106","18","18.6"
"Screven","2020-08-12","17","990","3","109","17.3","19.2"
"Screven","2020-08-13","7","997","1","110","15.8","19"
"Screven","2020-08-14","11","1008","1","111","15.9","18.4"
"Screven","2020-08-15","4","1012","1","112","16.6","20.1"
"Screven","2020-08-16","4","1016","1","113","17.8","21.9"
"Screven","2020-08-17","12","1028","0","113","17.8","19.1"
"Screven","2020-08-18","8","1036","0","113","13","15.5"
"Screven","2020-08-19","7","1043","1","114","12.5","14.9"
"Screven","2020-08-20","8","1051","0","114","10.5","13.1"
"Screven","2020-08-21","18","1069","0","114","9.2","12.5"
"Screven","2020-08-22","3","1072","1","115","10.4","13.5"
"Screven","2020-08-23","4","1076","0","115","6.8","12.3"
"Screven","2020-08-24","12","1088","2","117","9.2","13.5"
"Screven","2020-08-25","12","1100","2","119","11.6","12.3"
"Screven","2020-08-26","9","1109","1","120","11.1","11.8"
"Screven","2020-08-27","11","1120","2","122","13.7","12.1"
"Screven","2020-08-28","13","1133","2","124","15.9","12.5"
"Screven","2020-08-29","5","1138","1","125","14","12.2"
"Screven","2020-08-30","7","1145","2","127","18.1","12.4"
"Screven","2020-08-31","10","1155","2","129","18.6","13.9"
"Screven","2020-09-01","11","1166","0","129","16.2","13.9"
"Screven","2020-09-02","4","1170","0","129","14.6","12.9"
"Screven","2020-09-03","6","1176","0","129","12","12.9"
"Screven","2020-09-04","7","1183","1","130","11.8","13.9"
"Screven","2020-09-05","5","1188","1","131","11.8","12.9"
"Screven","2020-09-06","4","1192","3","134","18.5","18.3"
"Screven","2020-09-07","3","1195","0","134","15.6","17.1"
"Screven","2020-09-08","18","1213","2","136","17.2","16.7"
"Screven","2020-09-09","16","1229","2","138","19","16.8"
"Screven","2020-09-10","12","1241","2","140","21.4","16.7"
"Screven","2020-09-11","8","1249","0","140","19.3","15.6"
"Screven","2020-09-12","1","1250","0","140","16.5","14.2"
"Screven","2020-09-13","5","1255","0","140","5.8","12.1"
"Screven","2020-09-14","18","1273","3","143","8.1","11.9"
"Screven","2020-09-15","15","1288","1","144","7.5","12.3"
"Screven","2020-09-16","64","1352","3","147","6.4","12.7"
"Screven","2020-09-17","85","1437","2","149","4.3","12.9"
"Screven","2020-09-18","26","1463","2","151","5.4","12.4"
"Screven","2020-09-19","5","1468","1","152","8.3","12.4"
"Screven","2020-09-20","5","1473","2","154","14","9.9"
"Screven","2020-09-21","17","1490","2","156","13.3","10.7"
"Screven","2020-09-22","12","1502","0","156","12.4","9.9"
"Screven","2020-09-23","8","1510","3","159","17","11.7"
"Screven","2020-09-24","71","1581","6","165","17.9","11.1"
"Screven","2020-09-25","40","1621","2","167","17.5","11.5"
"Screven","2020-09-26","6","1627","1","168","17.1","12.7"
"Screven","2020-09-27","5","1632","0","168","11.3","12.7"
"Screven","2020-09-28","10","1642","2","170","12.5","12.9"
"Screven","2020-09-29","8","1650","0","170","12.5","12.4"
"Screven","2020-09-30","10","1660","0","170","7.2","12.1"
"Screven","2020-10-01","39","1699","5","175","7.8","12.8"
"Screven","2020-10-02","17","1716","0","175","7.1","12.3"
"Screven","2020-10-03","92","1808","1","176","4.8","10.9"
"Screven","2020-10-04","8","1816","0","176","4.8","8.1"
"Screven","2020-10-05","13","1829","2","178","4.2","8.4"
"Screven","2020-10-06","19","1848","1","179","4.9","8.7"
"Screven","2020-10-07","6","1854","0","179","4.9","6"
"Screven","2020-10-08","57","1911","4","183","4.1","5.9"
"Screven","2020-10-09","41","1952","3","186","5.2","6.1"
"Screven","2020-10-10","52","2004","0","186","5","4.9"
"Screven","2020-10-11","6","2010","0","186","5","4.9"
"Screven","2020-10-12","13","2023","2","188","5","4.6"
"Screven","2020-10-13","13","2036","1","189","5.3","5.1"
"Screven","2020-10-14","5","2041","1","190","8.2","6.6"
"Screven","2020-10-15","29","2070","1","191","7.7","5.9"
"Screven","2020-10-16","21","2091","3","194","8.7","6.9"
"Screven","2020-10-17","115","2206","0","194","8.7","6.8"
"Screven","2020-10-18","6","2212","1","195","11.1","8"
"Screven","2020-10-19","14","2226","0","195","8.9","6.9"
"Screven","2020-10-20","10","2236","0","195","7.8","6.6"
"Screven","2020-10-21","10","2246","1","196","6.3","7.3"
"Screven","2020-10-22","43","2289","1","197","6.2","6.9"
"Screven","2020-10-23","65","2354","3","200","4.8","6.7"
"Screven","2020-10-24","8","2362","0","200","4.8","6.7"
"Screven","2020-10-25","2","2364","0","200","2.4","6.7"
"Screven","2020-10-26","9","2373","0","200","2.4","5.6"
"Screven","2020-10-27","9","2382","2","202","5.6","6.7"
"Screven","2020-10-28","10","2392","1","203","5.6","6"
"Screven","2020-10-29","51","2443","1","204","5.5","5.9"
"Screven","2020-10-30","28","2471","1","205","5.4","5.1"
"Screven","2020-10-31","45","2516","0","205","5.4","5.1"
"Screven","2020-11-01","2","2518","0","205","5.4","3.9"
"Screven","2020-11-02","8","2526","1","206","7.2","4.8"
"Screven","2020-11-03","12","2538","0","206","4","4.8"
"Screven","2020-11-04","5","2543","0","206","2.6","4.1"
"Screven","2020-11-05","25","2568","0","206","2.3","3.9"
"Screven","2020-11-06","16","2584","1","207","2.7","4"
"Screven","2020-11-07","4","2588","0","207","2.7","4"
"Screven","2020-11-08","4","2592","0","207","2.7","4"
"Screven","2020-11-09","14","2606","1","208","1.9","4.5"
"Screven","2020-11-10","11","2617","0","208","1.9","3"
"Screven","2020-11-11","10","2627","0","208","1.9","2.2"
"Screven","2020-11-12","39","2666","3","211","3","2.7"
"Screven","2020-11-13","31","2697","1","212","2.6","2.6"
"Screven","2020-11-14","2","2699","0","212","2.6","2.6"
"Screven","2020-11-15","1","2700","0","212","2.6","2.6"
"Screven","2020-11-16","16","2716","1","213","2.5","2.2"
"Screven","2020-11-17","7","2723","0","213","2.5","2.2"
"Screven","2020-11-18","4","2727","0","213","2.5","2.2"
"Screven","2020-11-19","43","2770","1","214","1.7","2.3"
"Screven","2020-11-20","21","2791","1","215","1.9","2.2"
"Screven","2020-11-21","6","2797","0","215","1.9","2.2"
"Screven","2020-11-22","8","2805","0","215","1.9","2.2"
"Screven","2020-11-23","15","2820","1","216","2","2.2"
"Screven","2020-11-24","6","2826","1","217","4.3","3.4"
"Screven","2020-11-25","8","2834","0","217","4.3","3.4"
"Screven","2020-11-26","2","2836","0","217","4","2.8"
"Screven","2020-11-27","5","2841","0","217","3.3","2.6"
"Screven","2020-11-28","6","2847","0","217","3.3","2.6"
"Screven","2020-11-29","7","2854","0","217","3.3","2.6"
"Screven","2020-11-30","7","2861","0","217","2.4","2.2"
"Screven","2020-12-01","9","2870","2","219","3.2","3.8"
"Screven","2020-12-02","10","2880","0","219","3.2","3.8"
"Screven","2020-12-03","17","2897","1","220","4","4"
"Screven","2020-12-04","8","2905","0","220","4","3.7"
"Screven","2020-12-05","3","2908","1","221","8.8","6.1"
"Screven","2020-12-06","2","2910","0","221","8.8","6.1"
"Screven","2020-12-07","20","2930","1","222","9.5","5.9"
"Screven","2020-12-08","4","2934","0","222","6.3","4.7"
"Screven","2020-12-09","13","2947","2","224","8.5","5.8"
"Screven","2020-12-10","54","3001","7","231","9.5","6.8"
"Screven","2020-12-11","17","3018","2","233","11.2","7.6"
"Screven","2020-12-12","5","3023","1","234","9.3","9"
"Screven","2020-12-13","1","3024","0","234","9.3","9"
"Screven","2020-12-14","19","3043","1","235","9.3","9.4"
"Screven","2020-12-15","13","3056","1","236","10.4","8.4"
"Screven","2020-12-16","12","3068","1","237","9.4","9"
"Screven","2020-12-17","75","3143","8","245","9.1","9.3"
"Screven","2020-12-18","10","3153","2","247","10.3","10.7"
"Screven","2020-12-19","3","3156","0","247","7.4","8.4"
"Screven","2020-12-20","2","3158","1","248","14.6","11.9"
"Screven","2020-12-21","15","3173","2","250","15.7","12.5"
"Screven","2020-12-22","11","3184","1","251","15.9","13.2"
"Screven","2020-12-23","16","3200","3","254","17.4","13.4"
"Screven","2020-12-24","11","3211","5","259","22.4","15.7"
"Screven","2020-12-25","0","3211","0","259","19.5","14.9"
"Screven","2020-12-26","6","3217","1","260","21.9","14.7"
"Screven","2020-12-27","7","3224","1","261","16.8","15.7"
"Screven","2020-12-28","16","3240","5","266","19.4","17.5"
"Screven","2020-12-29","12","3252","4","270","22.8","19.4"
"Screven","2020-12-30","15","3267","3","273","23","20.2"
"Screven","2020-12-31","132","3399","30","303","19.8","21.1"
"Screven","2021-01-01","3","3402","1","304","24.5","22"
"Screven","2021-01-02","6","3408","2","306","26.9","24.4"
"Screven","2021-01-03","5","3413","3","309","33.4","25.1"
"Screven","2021-01-04","27","3440","14","323","36.4","27.9"
"Screven","2021-01-05","25","3465","6","329","35","28.9"
"Screven","2021-01-06","27","3492","4","333","34.3","28.6"
"Screven","2021-01-07","137","3629","14","347","32.5","26.1"
"Screven","2021-01-08","15","3644","6","353","33.5","29"
"Screven","2021-01-09","4","3648","0","353","28.7","27.8"
"Screven","2021-01-10","9","3657","3","356","24.9","29.2"
"Screven","2021-01-11","26","3683","7","363","21.3","28.8"
"Screven","2021-01-12","29","3712","4","367","19.9","27.5"
"Screven","2021-01-13","16","3728","6","373","23.1","28.7"
"Screven","2021-01-14","24","3752","5","378","24.6","28.6"
"Screven","2021-01-15","24","3776","8","386","23.7","28.6"
"Screven","2021-01-16","11","3787","0","386","23.7","26.2"
"Screven","2021-01-17","8","3795","4","390","26.1","25.5"
"Screven","2021-01-18","22","3817","3","393","24.2","22.7"
"Screven","2021-01-19","19","3836","4","397","25.2","22.5"
"Screven","2021-01-20","29","3865","5","402","22.3","22.7"
"Screven","2021-01-21","28","3893","2","404","20.3","22.5"
"Screven","2021-01-22","34","3927","5","409","17.7","20.7"
"Screven","2021-01-23","11","3938","4","413","22.9","23.3"
"Screven","2021-01-24","7","3945","1","414","17.8","21.9"
"Screven","2021-01-25","26","3971","8","422","20.2","22.2"
"Screven","2021-01-26","4","3975","0","422","17.2","21.2"
"Screven","2021-01-27","0","3975","0","422","14.8","18.5"
"Seminole","2020-02-01","0","0","0","0",".","."
"Seminole","2020-02-02","0","0","0","0",".","."
"Seminole","2020-02-03","0","0","0","0",".","."
"Seminole","2020-02-04","0","0","0","0",".","."
"Seminole","2020-02-05","0","0","0","0",".","."
"Seminole","2020-02-06","0","0","0","0",".","."
"Seminole","2020-02-07","0","0","0","0","0","."
"Seminole","2020-02-08","0","0","0","0","0","."
"Seminole","2020-02-09","0","0","0","0","0","."
"Seminole","2020-02-10","0","0","0","0","0","."
"Seminole","2020-02-11","0","0","0","0","0","."
"Seminole","2020-02-12","0","0","0","0","0","."
"Seminole","2020-02-13","0","0","0","0","0","."
"Seminole","2020-02-14","0","0","0","0","0","0"
"Seminole","2020-02-15","0","0","0","0","0","0"
"Seminole","2020-02-16","0","0","0","0","0","0"
"Seminole","2020-02-17","0","0","0","0","0","0"
"Seminole","2020-02-18","0","0","0","0","0","0"
"Seminole","2020-02-19","0","0","0","0","0","0"
"Seminole","2020-02-20","1","1","0","0","0","0"
"Seminole","2020-02-21","0","1","0","0","0","0"
"Seminole","2020-02-22","0","1","0","0","0","0"
"Seminole","2020-02-23","0","1","0","0","0","0"
"Seminole","2020-02-24","0","1","0","0","0","0"
"Seminole","2020-02-25","0","1","0","0","0","0"
"Seminole","2020-02-26","0","1","0","0","0","0"
"Seminole","2020-02-27","0","1","0","0","0","0"
"Seminole","2020-02-28","0","1","0","0","0","0"
"Seminole","2020-02-29","0","1","0","0","0","0"
"Seminole","2020-03-01","0","1","0","0","0","0"
"Seminole","2020-03-02","0","1","0","0","0","0"
"Seminole","2020-03-03","0","1","0","0","0","0"
"Seminole","2020-03-04","0","1","0","0","0","0"
"Seminole","2020-03-05","0","1","0","0","0","0"
"Seminole","2020-03-06","0","1","0","0","0","0"
"Seminole","2020-03-07","0","1","0","0","0","0"
"Seminole","2020-03-08","0","1","0","0","0","0"
"Seminole","2020-03-09","0","1","0","0","0","0"
"Seminole","2020-03-10","0","1","0","0","0","0"
"Seminole","2020-03-11","0","1","0","0","0","0"
"Seminole","2020-03-12","1","2","0","0","0","0"
"Seminole","2020-03-13","1","3","0","0","0","0"
"Seminole","2020-03-14","0","3","0","0","0","0"
"Seminole","2020-03-15","0","3","0","0","0","0"
"Seminole","2020-03-16","6","9","0","0","0","0"
"Seminole","2020-03-17","0","9","0","0","0","0"
"Seminole","2020-03-18","3","12","0","0","0","0"
"Seminole","2020-03-19","0","12","0","0","0","0"
"Seminole","2020-03-20","0","12","0","0","0","0"
"Seminole","2020-03-21","0","12","0","0","0","0"
"Seminole","2020-03-22","0","12","0","0","0","0"
"Seminole","2020-03-23","2","14","0","0","0","0"
"Seminole","2020-03-24","3","17","0","0","0","0"
"Seminole","2020-03-25","2","19","0","0","0","0"
"Seminole","2020-03-26","0","19","0","0","0","0"
"Seminole","2020-03-27","2","21","0","0","0","0"
"Seminole","2020-03-28","1","22","1","1","14.3","7.1"
"Seminole","2020-03-29","0","22","0","1","14.3","7.1"
"Seminole","2020-03-30","2","24","0","1","14.3","7.1"
"Seminole","2020-03-31","0","24","0","1","14.3","7.1"
"Seminole","2020-04-01","2","26","0","1","14.3","7.1"
"Seminole","2020-04-02","12","38","2","3","16.7","8.3"
"Seminole","2020-04-03","6","44","1","4","19","9.5"
"Seminole","2020-04-04","9","53","0","4","4.8","9.5"
"Seminole","2020-04-05","0","53","0","4","4.8","9.5"
"Seminole","2020-04-06","5","58","0","4","4.8","9.5"
"Seminole","2020-04-07","15","73","3","7","7.6","11"
"Seminole","2020-04-08","16","89","1","8","8.5","11.4"
"Seminole","2020-04-09","19","108","0","8","6.1","11.4"
"Seminole","2020-04-10","12","120","0","8","3.8","11.4"
"Seminole","2020-04-11","5","125","2","10","9.5","7.1"
"Seminole","2020-04-12","0","125","0","10","9.5","7.1"
"Seminole","2020-04-13","7","132","1","11","11.5","8.1"
"Seminole","2020-04-14","47","179","7","18","10.8","9.2"
"Seminole","2020-04-15","12","191","0","18","9.9","9.2"
"Seminole","2020-04-16","20","211","0","18","9.9","8"
"Seminole","2020-04-17","7","218","3","21","16","9.9"
"Seminole","2020-04-18","12","230","0","21","10.3","9.9"
"Seminole","2020-04-19","1","231","0","21","10.3","9.9"
"Seminole","2020-04-20","5","236","0","21","8.3","9.9"
"Seminole","2020-04-21","11","247","2","23","8.7","9.7"
"Seminole","2020-04-22","8","255","2","25","12.3","11.1"
"Seminole","2020-04-23","10","265","1","26","13.7","11.8"
"Seminole","2020-04-24","31","296","0","26","7.6","11.8"
"Seminole","2020-04-25","10","306","2","28","10.5","10.4"
"Seminole","2020-04-26","0","306","0","28","10.5","10.4"
"Seminole","2020-04-27","3","309","0","28","10.5","9.4"
"Seminole","2020-04-28","13","322","0","28","7.9","8.3"
"Seminole","2020-04-29","19","341","1","29","5","8.7"
"Seminole","2020-04-30","21","362","0","29","3.6","8.7"
"Seminole","2020-05-01","9","371","2","31","6.8","7.2"
"Seminole","2020-05-02","7","378","1","32","6","8.2"
"Seminole","2020-05-03","0","378","0","32","6","8.2"
"Seminole","2020-05-04","6","384","1","33","8.3","9.4"
"Seminole","2020-05-05","10","394","3","36","12.6","10.2"
"Seminole","2020-05-06","15","409","3","39","14.7","9.9"
"Seminole","2020-05-07","12","421","3","42","18.3","11"
"Seminole","2020-05-08","3","424","2","44","24.7","15.7"
"Seminole","2020-05-09","19","443","0","44","22.6","14.3"
"Seminole","2020-05-10","0","443","0","44","22.6","14.3"
"Seminole","2020-05-11","4","447","0","44","20.2","14.3"
"Seminole","2020-05-12","22","469","4","48","18.5","15.6"
"Seminole","2020-05-13","19","488","1","49","16.4","15.6"
"Seminole","2020-05-14","10","498","0","49","12.9","15.6"
"Seminole","2020-05-15","11","509","1","50","4.6","14.7"
"Seminole","2020-05-16","11","520","1","51","5.9","14.3"
"Seminole","2020-05-17","1","521","0","51","5.9","14.3"
"Seminole","2020-05-18","10","531","1","52","7.4","13.8"
"Seminole","2020-05-19","15","546","1","53","5.7","12.1"
"Seminole","2020-05-20","9","555","0","53","5","10.7"
"Seminole","2020-05-21","23","578","1","54","5.6","9.2"
"Seminole","2020-05-22","9","587","1","55","5.9","5.3"
"Seminole","2020-05-23","1","588","0","55","4.6","5.3"
"Seminole","2020-05-24","0","588","0","55","4.6","5.3"
"Seminole","2020-05-25","0","588","0","55","3.2","5.3"
"Seminole","2020-05-26","10","598","1","56","3.6","4.7"
"Seminole","2020-05-27","29","627","0","56","3.6","4.3"
"Seminole","2020-05-28","59","686","1","57","3.3","4.4"
"Seminole","2020-05-29","101","787","3","60","2.1","4"
"Seminole","2020-05-30","16","803","0","60","2.1","3.3"
"Seminole","2020-05-31","0","803","0","60","2.1","3.3"
"Seminole","2020-06-01","3","806","1","61","6.9","5"
"Seminole","2020-06-02","15","821","0","61","5.4","4.5"
"Seminole","2020-06-03","14","835","1","62","6.4","5"
"Seminole","2020-06-04","12","847","1","63","7.4","5.3"
"Seminole","2020-06-05","9","856","1","64","8.6","5.3"
"Seminole","2020-06-06","15","871","0","64","8.6","5.3"
"Seminole","2020-06-07","0","871","0","64","8.6","5.3"
"Seminole","2020-06-08","15","886","1","65","4.8","5.8"
"Seminole","2020-06-09","12","898","0","65","4.8","5.1"
"Seminole","2020-06-10","8","906","0","65","3.7","5.1"
"Seminole","2020-06-11","14","920","1","66","3.6","5.5"
"Seminole","2020-06-12","12","932","0","66","2","5.3"
"Seminole","2020-06-13","0","932","0","66","2","5.3"
"Seminole","2020-06-14","2","934","0","66","2","5.3"
"Seminole","2020-06-15","10","944","0","66","1","2.9"
"Seminole","2020-06-16","10","954","0","66","1","2.9"
"Seminole","2020-06-17","5","959","0","66","1","2.4"
"Seminole","2020-06-18","17","976","1","67","0.8","2.2"
"Seminole","2020-06-19","9","985","0","67","0.8","1.4"
"Seminole","2020-06-20","9","994","0","67","0.8","1.4"
"Seminole","2020-06-21","1","995","0","67","0.8","1.4"
"Seminole","2020-06-22","6","1001","0","67","0.8","0.9"
"Seminole","2020-06-23","11","1012","0","67","0.8","0.9"
"Seminole","2020-06-24","14","1026","1","68","1.9","1.4"
"Seminole","2020-06-25","11","1037","0","68","1","0.9"
"Seminole","2020-06-26","16","1053","1","69","1.9","1.4"
"Seminole","2020-06-27","10","1063","0","69","1.9","1.4"
"Seminole","2020-06-28","0","1063","0","69","1.9","1.4"
"Seminole","2020-06-29","9","1072","0","69","1.9","1.4"
"Seminole","2020-06-30","15","1087","1","70","2.9","1.9"
"Seminole","2020-07-01","12","1099","1","71","3","2.4"
"Seminole","2020-07-02","13","1112","0","71","3","2"
"Seminole","2020-07-03","2","1114","0","71","2.1","2"
"Seminole","2020-07-04","13","1127","0","71","2.1","2"
"Seminole","2020-07-05","3","1130","0","71","2.1","2"
"Seminole","2020-07-06","8","1138","1","72","3.9","2.9"
"Seminole","2020-07-07","6","1144","1","73","5.4","4.1"
"Seminole","2020-07-08","17","1161","3","76","6.7","4.9"
"Seminole","2020-07-09","6","1167","0","76","6.7","4.9"
"Seminole","2020-07-10","16","1183","2","78","8.5","5.3"
"Seminole","2020-07-11","9","1192","0","78","8.5","5.3"
"Seminole","2020-07-12","9","1201","1","79","10.1","6.1"
"Seminole","2020-07-13","9","1210","1","80","9.9","6.9"
"Seminole","2020-07-14","6","1216","1","81","9.9","7.6"
"Seminole","2020-07-15","14","1230","2","83","9.4","8"
"Seminole","2020-07-16","45","1275","9","92","12.2","9.5"
"Seminole","2020-07-17","15","1290","1","93","11.4","9.9"
"Seminole","2020-07-18","8","1298","0","93","11.4","9.9"
"Seminole","2020-07-19","0","1298","0","93","9.8","9.9"
"Seminole","2020-07-20","28","1326","4","97","10.3","10.1"
"Seminole","2020-07-21","9","1335","3","100","12.7","11.3"
"Seminole","2020-07-22","5","1340","1","101","13.5","11.4"
"Seminole","2020-07-23","42","1382","6","107","12.7","12.4"
"Seminole","2020-07-24","45","1427","13","120","15.8","13.6"
"Seminole","2020-07-25","30","1457","7","127","19.2","15.3"
"Seminole","2020-07-26","25","1482","6","133","22.6","16.2"
"Seminole","2020-07-27","11","1493","3","136","24.4","17.4"
"Seminole","2020-07-28","32","1525","8","144","23.3","18"
"Seminole","2020-07-29","54","1579","20","164","25.7","19.6"
"Seminole","2020-07-30","32","1611","8","172","27.2","19.9"
"Seminole","2020-07-31","24","1635","3","175","24.9","20.4"
"Seminole","2020-08-01","28","1663","9","184","26.1","22.6"
"Seminole","2020-08-02","5","1668","3","187","31.3","26.9"
"Seminole","2020-08-03","14","1682","2","189","29.4","26.9"
"Seminole","2020-08-04","38","1720","12","201","30.4","26.8"
"Seminole","2020-08-05","42","1762","9","210","28.1","26.9"
"Seminole","2020-08-06","50","1812","7","217","26.6","26.9"
"Seminole","2020-08-07","30","1842","5","222","27.2","26"
"Seminole","2020-08-08","37","1879","14","236","28","27.1"
"Seminole","2020-08-09","11","1890","1","237","20.7","26"
"Seminole","2020-08-10","17","1907","3","240","21.2","25.3"
"Seminole","2020-08-11","57","1964","15","255","20.4","25.4"
"Seminole","2020-08-12","26","1990","5","260","20.1","24.1"
"Seminole","2020-08-13","40","2030","5","265","19.9","23.2"
"Seminole","2020-08-14","13","2043","3","268","20.8","24"
"Seminole","2020-08-15","35","2078","5","273","17.4","22.7"
"Seminole","2020-08-16","0","2078","0","273","16.2","18.4"
"Seminole","2020-08-17","8","2086","0","273","13.6","17.4"
"Seminole","2020-08-18","46","2132","5","278","11.4","15.9"
"Seminole","2020-08-19","17","2149","3","281","11.2","15.7"
"Seminole","2020-08-20","29","2178","2","283","10.4","15.1"
"Seminole","2020-08-21","30","2208","6","289","10","15.4"
"Seminole","2020-08-22","33","2241","2","291","8.8","13.1"
"Seminole","2020-08-23","0","2241","0","291","8.8","12.5"
"Seminole","2020-08-24","73","2314","2","293","9.2","11.4"
"Seminole","2020-08-25","35","2349","7","300","10.5","11"
"Seminole","2020-08-26","25","2374","2","302","9.1","10.1"
"Seminole","2020-08-27","26","2400","3","305","9.8","10.1"
"Seminole","2020-08-28","24","2424","2","307","8.1","9"
"Seminole","2020-08-29","20","2444","7","314","12.2","10.5"
"Seminole","2020-08-30","2","2446","0","314","12.2","10.5"
"Seminole","2020-08-31","13","2459","1","315","12.9","11.1"
"Seminole","2020-09-01","43","2502","6","321","12.1","11.3"
"Seminole","2020-09-02","31","2533","9","330","15.1","12.1"
"Seminole","2020-09-03","70","2603","2","332","13.8","11.8"
"Seminole","2020-09-04","45","2648","4","336","13.9","11"
"Seminole","2020-09-05","25","2673","0","336","8.9","10.6"
"Seminole","2020-09-06","3","2676","0","336","8.9","10.6"
"Seminole","2020-09-07","2","2678","0","336","7.8","10.4"
"Seminole","2020-09-08","20","2698","0","336","5.8","8.9"
"Seminole","2020-09-09","44","2742","5","341","3.3","9.2"
"Seminole","2020-09-10","21","2763","5","346","6.3","10.1"
"Seminole","2020-09-11","71","2834","3","349","5.6","9.8"
"Seminole","2020-09-12","0","2834","0","349","5.6","7.3"
"Seminole","2020-09-13","1","2835","1","350","19.9","14.4"
"Seminole","2020-09-14","89","2924","3","353","20.4","14.1"
"Seminole","2020-09-15","38","2962","0","353","20.4","13.1"
"Seminole","2020-09-16","15","2977","1","354","19.7","11.5"
"Seminole","2020-09-17","21","2998","1","355","17","11.6"
"Seminole","2020-09-18","18","3016","0","355","16.4","11"
"Seminole","2020-09-19","13","3029","0","355","16.4","11"
"Seminole","2020-09-20","2","3031","0","355","2.1","11"
"Seminole","2020-09-21","41","3072","0","355","1.6","11"
"Seminole","2020-09-22","44","3116","0","355","1.6","11"
"Seminole","2020-09-23","100","3216","6","361","1.5","10.6"
"Seminole","2020-09-24","36","3252","1","362","1.3","9.1"
"Seminole","2020-09-25","39","3291","4","366","2.7","9.6"
"Seminole","2020-09-26","8","3299","1","367","4.5","10.5"
"Seminole","2020-09-27","3","3302","0","367","4.5","3.3"
"Seminole","2020-09-28","36","3338","0","367","4.5","3.1"
"Seminole","2020-09-29","26","3364","0","367","4.5","3.1"
"Seminole","2020-09-30","84","3448","5","372","4.5","3"
"Seminole","2020-10-01","41","3489","3","375","5.1","3.2"
"Seminole","2020-10-02","36","3525","3","378","4.9","3.8"
"Seminole","2020-10-03","24","3549","1","379","3.7","4.1"
"Seminole","2020-10-04","1","3550","0","379","3.7","4.1"
"Seminole","2020-10-05","21","3571","0","379","3.7","4.1"
"Seminole","2020-10-06","39","3610","1","380","4","4.3"
"Seminole","2020-10-07","68","3678","1","381","3.4","4"
"Seminole","2020-10-08","22","3700","1","382","3","4.1"
"Seminole","2020-10-09","35","3735","3","385","3","4"
"Seminole","2020-10-10","21","3756","0","385","2.5","3.1"
"Seminole","2020-10-11","2","3758","0","385","2.5","3.1"
"Seminole","2020-10-12","27","3785","1","386","3","3.3"
"Seminole","2020-10-13","26","3811","2","388","3.7","3.9"
"Seminole","2020-10-14","24","3835","0","388","3.5","3.5"
"Seminole","2020-10-15","16","3851","2","390","4.6","3.8"
"Seminole","2020-10-16","19","3870","0","390","3.4","3.2"
"Seminole","2020-10-17","19","3889","2","392","4.9","3.7"
"Seminole","2020-10-18","2","3891","0","392","4.9","3.7"
"Seminole","2020-10-19","19","3910","1","393","5.1","4.1"
"Seminole","2020-10-20","25","3935","1","394","4.6","4.2"
"Seminole","2020-10-21","33","3968","4","398","6.3","4.9"
"Seminole","2020-10-22","19","3987","1","399","5.3","5"
"Seminole","2020-10-23","12","3999","1","400","6.5","5"
"Seminole","2020-10-24","17","4016","0","400","5","5"
"Seminole","2020-10-25","1","4017","0","400","5","5"
"Seminole","2020-10-26","21","4038","1","401","4.9","5"
"Seminole","2020-10-27","32","4070","2","403","5.2","4.9"
"Seminole","2020-10-28","70","4140","0","403","3.5","4.9"
"Seminole","2020-10-29","31","4171","2","405","3.7","4.5"
"Seminole","2020-10-30","94","4265","2","407","2.8","4.6"
"Seminole","2020-10-31","18","4283","1","408","3.6","4.3"
"Seminole","2020-11-01","3","4286","2","410","13.1","9.1"
"Seminole","2020-11-02","28","4314","2","412","13.5","9.2"
"Seminole","2020-11-03","5","4319","1","413","15.4","10.3"
"Seminole","2020-11-04","55","4374","1","414","15.7","9.6"
"Seminole","2020-11-05","29","4403","6","420","17.7","10.7"
"Seminole","2020-11-06","20","4423","1","421","18.1","10.5"
"Seminole","2020-11-07","18","4441","3","424","19.7","11.7"
"Seminole","2020-11-08","4","4445","1","425","13.8","13.4"
"Seminole","2020-11-09","31","4476","1","426","13.2","13.3"
"Seminole","2020-11-10","69","4545","6","432","11.6","13.5"
"Seminole","2020-11-11","53","4598","6","438","12.9","14.3"
"Seminole","2020-11-12","30","4628","1","439","10.5","14.1"
"Seminole","2020-11-13","22","4650","4","443","12.3","15.2"
"Seminole","2020-11-14","19","4669","2","445","11.5","15.6"
"Seminole","2020-11-15","0","4669","0","445","7.9","10.8"
"Seminole","2020-11-16","23","4692","1","446","8.1","10.6"
"Seminole","2020-11-17","6","4698","1","447","9.2","10.4"
"Seminole","2020-11-18","20","4718","3","450","9.7","11.3"
"Seminole","2020-11-19","50","4768","5","455","10.7","10.6"
"Seminole","2020-11-20","50","4818","6","461","9.8","11.1"
"Seminole","2020-11-21","28","4846","6","467","11.3","11.4"
"Seminole","2020-11-22","4","4850","0","467","11.3","9.6"
"Seminole","2020-11-23","13","4863","2","469","12.9","10.5"
"Seminole","2020-11-24","47","4910","2","471","11.2","10.2"
"Seminole","2020-11-25","57","4967","3","474","9.8","9.7"
"Seminole","2020-11-26","3","4970","0","474","8.3","9.5"
"Seminole","2020-11-27","71","5041","5","479","7.6","8.7"
"Seminole","2020-11-28","18","5059","1","480","5.4","8.4"
"Seminole","2020-11-29","4","5063","3","483","16.1","13.7"
"Seminole","2020-11-30","34","5097","1","484","14.3","13.6"
"Seminole","2020-12-01","26","5123","1","485","14.2","12.7"
"Seminole","2020-12-02","73","5196","10","495","15.4","12.6"
"Seminole","2020-12-03","47","5243","2","497","16","12.2"
"Seminole","2020-12-04","20","5263","1","498","15.8","11.7"
"Seminole","2020-12-05","16","5279","1","499","15.9","10.6"
"Seminole","2020-12-06","3","5282","0","499","5.1","10.6"
"Seminole","2020-12-07","14","5296","0","499","4.7","9.5"
"Seminole","2020-12-08","70","5366","3","502","4.8","9.5"
"Seminole","2020-12-09","24","5390","2","504","4","9.7"
"Seminole","2020-12-10","17","5407","3","507","5.9","11"
"Seminole","2020-12-11","18","5425","2","509","6.8","11.3"
"Seminole","2020-12-12","18","5443","5","514","9.9","12.9"
"Seminole","2020-12-13","2","5445","1","515","17","11.1"
"Seminole","2020-12-14","23","5468","2","517","18.3","11.5"
"Seminole","2020-12-15","22","5490","1","518","18.3","11.5"
"Seminole","2020-12-16","17","5507","10","528","25.5","14.8"
"Seminole","2020-12-17","12","5519","0","528","23","14.5"
"Seminole","2020-12-18","9","5528","1","529","23","14.9"
"Seminole","2020-12-19","6","5534","1","530","21.4","15.6"
"Seminole","2020-12-20","0","5534","0","530","14.3","15.6"
"Seminole","2020-12-21","7","5541","2","532","17.1","17.7"
"Seminole","2020-12-22","12","5553","4","536","21.2","19.8"
"Seminole","2020-12-23","19","5572","6","542","17.3","21.4"
"Seminole","2020-12-24","8","5580","0","542","17.3","20.2"
"Seminole","2020-12-25","4","5584","0","542","15.7","19.4"
"Seminole","2020-12-26","3","5587","0","542","13.4","17.4"
"Seminole","2020-12-27","2","5589","0","542","13.4","13.8"
"Seminole","2020-12-28","11","5600","1","543","10.6","13.8"
"Seminole","2020-12-29","11","5611","2","545","8.4","14.8"
"Seminole","2020-12-30","26","5637","7","552","7.7","12.5"
"Seminole","2020-12-31","20","5657","6","558","12","14.7"
"Seminole","2021-01-01","0","5657","0","558","12","13.9"
"Seminole","2021-01-02","8","5665","0","558","12","12.7"
"Seminole","2021-01-03","0","5665","0","558","12","12.7"
"Seminole","2021-01-04","24","5689","2","560","11.9","11.2"
"Seminole","2021-01-05","19","5708","4","564","12.3","10.4"
"Seminole","2021-01-06","21","5729","2","566","9.8","8.8"
"Seminole","2021-01-07","34","5763","7","573","8.5","10.3"
"Seminole","2021-01-08","14","5777","2","575","10.5","11.3"
"Seminole","2021-01-09","5","5782","1","576","13.4","12.7"
"Seminole","2021-01-10","1","5783","0","576","13.4","12.7"
"Seminole","2021-01-11","20","5803","2","578","13.6","12.8"
"Seminole","2021-01-12","26","5829","6","584","13.9","13.1"
"Seminole","2021-01-13","23","5852","2","586","13.8","11.8"
"Seminole","2021-01-14","23","5875","1","587","11.5","10"
"Seminole","2021-01-15","80","5955","1","588","9.6","10.1"
"Seminole","2021-01-16","16","5971","2","590","8.6","11"
"Seminole","2021-01-17","2","5973","0","590","8.6","11"
"Seminole","2021-01-18","14","5987","0","590","7.1","10.4"
"Seminole","2021-01-19","15","6002","2","592","5.7","9.8"
"Seminole","2021-01-20","16","6018","1","593","5.4","9.6"
"Seminole","2021-01-21","26","6044","1","594","5.3","8.4"
"Seminole","2021-01-22","15","6059","0","594","5.1","7.4"
"Seminole","2021-01-23","6","6065","3","597","10.5","9.5"
"Seminole","2021-01-24","1","6066","0","597","10.5","9.5"
"Seminole","2021-01-25","3","6069","0","597","10.5","8.8"
"Seminole","2021-01-26","1","6070","1","598","22.9","14.3"
"Seminole","2021-01-27","0","6070","0","598","22","13.7"
"Spalding","2020-02-01","0","0","0","0",".","."
"Spalding","2020-02-02","0","0","0","0",".","."
"Spalding","2020-02-03","0","0","0","0",".","."
"Spalding","2020-02-04","0","0","0","0",".","."
"Spalding","2020-02-05","0","0","0","0",".","."
"Spalding","2020-02-06","0","0","0","0",".","."
"Spalding","2020-02-07","0","0","0","0","0","."
"Spalding","2020-02-08","0","0","0","0","0","."
"Spalding","2020-02-09","0","0","0","0","0","."
"Spalding","2020-02-10","0","0","0","0","0","."
"Spalding","2020-02-11","0","0","0","0","0","."
"Spalding","2020-02-12","0","0","0","0","0","."
"Spalding","2020-02-13","0","0","0","0","0","."
"Spalding","2020-02-14","0","0","0","0","0","0"
"Spalding","2020-02-15","0","0","0","0","0","0"
"Spalding","2020-02-16","0","0","0","0","0","0"
"Spalding","2020-02-17","0","0","0","0","0","0"
"Spalding","2020-02-18","0","0","0","0","0","0"
"Spalding","2020-02-19","0","0","0","0","0","0"
"Spalding","2020-02-20","0","0","0","0","0","0"
"Spalding","2020-02-21","0","0","0","0","0","0"
"Spalding","2020-02-22","0","0","0","0","0","0"
"Spalding","2020-02-23","0","0","0","0","0","0"
"Spalding","2020-02-24","0","0","0","0","0","0"
"Spalding","2020-02-25","0","0","0","0","0","0"
"Spalding","2020-02-26","0","0","0","0","0","0"
"Spalding","2020-02-27","0","0","0","0","0","0"
"Spalding","2020-02-28","0","0","0","0","0","0"
"Spalding","2020-02-29","0","0","0","0","0","0"
"Spalding","2020-03-01","0","0","0","0","0","0"
"Spalding","2020-03-02","0","0","0","0","0","0"
"Spalding","2020-03-03","0","0","0","0","0","0"
"Spalding","2020-03-04","0","0","0","0","0","0"
"Spalding","2020-03-05","0","0","0","0","0","0"
"Spalding","2020-03-06","0","0","0","0","0","0"
"Spalding","2020-03-07","0","0","0","0","0","0"
"Spalding","2020-03-08","0","0","0","0","0","0"
"Spalding","2020-03-09","0","0","0","0","0","0"
"Spalding","2020-03-10","3","3","0","0","0","0"
"Spalding","2020-03-11","1","4","0","0","0","0"
"Spalding","2020-03-12","5","9","1","1","2.9","1.4"
"Spalding","2020-03-13","10","19","2","3","5.7","2.9"
"Spalding","2020-03-14","0","19","0","3","5.7","2.9"
"Spalding","2020-03-15","4","23","0","3","5.7","2.9"
"Spalding","2020-03-16","10","33","4","7","11.4","5.7"
"Spalding","2020-03-17","15","48","6","13","17.1","8.6"
"Spalding","2020-03-18","14","62","2","15","19.2","9.6"
"Spalding","2020-03-19","22","84","1","16","17","9.9"
"Spalding","2020-03-20","13","97","1","17","15.2","10.5"
"Spalding","2020-03-21","18","115","1","18","16","10.9"
"Spalding","2020-03-22","4","119","1","19","19.6","12.6"
"Spalding","2020-03-23","25","144","1","20","14.4","12.9"
"Spalding","2020-03-24","16","160","1","21","9.6","13.4"
"Spalding","2020-03-25","18","178","1","22","8.4","13.8"
"Spalding","2020-03-26","39","217","4","26","9.2","13.1"
"Spalding","2020-03-27","26","243","11","37","14.1","14.7"
"Spalding","2020-03-28","15","258","4","41","17.1","16.6"
"Spalding","2020-03-29","12","270","4","45","18.3","19"
"Spalding","2020-03-30","35","305","7","52","20.6","17.5"
"Spalding","2020-03-31","43","348","10","62","23.1","16.3"
"Spalding","2020-04-01","36","384","9","71","25.8","17.1"
"Spalding","2020-04-02","29","413","1","72","24.9","17"
"Spalding","2020-04-03","26","439","5","77","21.6","17.8"
"Spalding","2020-04-04","19","458","3","80","20","18.6"
"Spalding","2020-04-05","4","462","1","81","18.8","18.6"
"Spalding","2020-04-06","47","509","5","86","17.5","19.1"
"Spalding","2020-04-07","41","550","6","92","16.2","19.7"
"Spalding","2020-04-08","19","569","1","93","13.4","19.6"
"Spalding","2020-04-09","30","599","6","99","15.8","20.3"
"Spalding","2020-04-10","21","620","1","100","13.7","17.6"
"Spalding","2020-04-11","9","629","1","101","13.1","16.5"
"Spalding","2020-04-12","6","635","1","102","11.9","15.3"
"Spalding","2020-04-13","22","657","7","109","14.9","16.2"
"Spalding","2020-04-14","19","676","4","113","15.8","16"
"Spalding","2020-04-15","36","712","0","113","15.1","14.2"
"Spalding","2020-04-16","39","751","3","116","13.3","14.5"
"Spalding","2020-04-17","21","772","4","120","15.3","14.5"
"Spalding","2020-04-18","12","784","1","121","14.9","14"
"Spalding","2020-04-19","8","792","1","122","14.3","13.1"
"Spalding","2020-04-20","47","839","3","125","10.7","12.8"
"Spalding","2020-04-21","56","895","7","132","9.5","12.7"
"Spalding","2020-04-22","109","1004","47","179","15.7","15.4"
"Spalding","2020-04-23","34","1038","1","180","15","14.1"
"Spalding","2020-04-24","40","1078","5","185","14","14.7"
"Spalding","2020-04-25","18","1096","1","186","13.6","14.3"
"Spalding","2020-04-26","9","1105","1","187","13.4","13.9"
"Spalding","2020-04-27","36","1141","4","191","14.1","12.4"
"Spalding","2020-04-28","40","1181","2","193","13","11.3"
"Spalding","2020-04-29","41","1222","4","197","8.3","12"
"Spalding","2020-04-30","44","1266","2","199","8.5","11.7"
"Spalding","2020-05-01","47","1313","4","203","7.9","11"
"Spalding","2020-05-02","16","1329","1","204","8","10.8"
"Spalding","2020-05-03","16","1345","2","206","8.2","10.8"
"Spalding","2020-05-04","44","1389","1","207","7","10.5"
"Spalding","2020-05-05","31","1420","5","212","8.6","10.8"
"Spalding","2020-05-06","19","1439","0","212","7.2","7.7"
"Spalding","2020-05-07","20","1459","2","214","8","8.2"
"Spalding","2020-05-08","19","1478","0","214","6.7","7.3"
"Spalding","2020-05-09","17","1495","2","216","7.5","7.8"
"Spalding","2020-05-10","3","1498","0","216","5.7","7"
"Spalding","2020-05-11","49","1547","3","219","6.3","6.6"
"Spalding","2020-05-12","39","1586","3","222","5.1","6.8"
"Spalding","2020-05-13","190","1776","2","224","5.2","6.2"
"Spalding","2020-05-14","33","1809","0","224","3.8","5.9"
"Spalding","2020-05-15","32","1841","3","227","5.1","5.9"
"Spalding","2020-05-16","22","1863","3","230","5.4","6.5"
"Spalding","2020-05-17","21","1884","2","232","6.8","6.3"
"Spalding","2020-05-18","53","1937","3","235","6.7","6.5"
"Spalding","2020-05-19","93","2030","13","248","7.6","6.3"
"Spalding","2020-05-20","61","2091","2","250","7.9","6.6"
"Spalding","2020-05-21","39","2130","1","251","8.3","6"
"Spalding","2020-05-22","53","2183","2","253","7.5","6.3"
"Spalding","2020-05-23","18","2201","0","253","5.5","5.5"
"Spalding","2020-05-24","8","2209","0","253","4.2","5.5"
"Spalding","2020-05-25","8","2217","1","254","5.2","5.9"
"Spalding","2020-05-26","53","2270","2","256","3.7","5.7"
"Spalding","2020-05-27","51","2321","2","258","3.8","5.9"
"Spalding","2020-05-28","37","2358","5","263","5.4","6.8"
"Spalding","2020-05-29","45","2403","3","266","5.8","6.6"
"Spalding","2020-05-30","13","2416","1","267","6.9","6.2"
"Spalding","2020-05-31","12","2428","1","268","8.1","6.1"
"Spalding","2020-06-01","77","2505","4","272","7","6.1"
"Spalding","2020-06-02","36","2541","2","274","7.3","5.5"
"Spalding","2020-06-03","48","2589","3","277","7.6","5.7"
"Spalding","2020-06-04","54","2643","2","279","6.2","5.8"
"Spalding","2020-06-05","48","2691","2","281","5.8","5.8"
"Spalding","2020-06-06","33","2724","2","283","5.6","6.2"
"Spalding","2020-06-07","23","2747","2","285","5.7","6.9"
"Spalding","2020-06-08","52","2799","3","288","5.7","6.4"
"Spalding","2020-06-09","52","2851","3","291","5.8","6.5"
"Spalding","2020-06-10","58","2909","6","297","6.4","7"
"Spalding","2020-06-11","52","2961","1","298","6.1","6.2"
"Spalding","2020-06-12","64","3025","3","301","6.2","6"
"Spalding","2020-06-13","26","3051","3","304","7","6.3"
"Spalding","2020-06-14","23","3074","2","306","7","6.3"
"Spalding","2020-06-15","68","3142","9","315","8","6.9"
"Spalding","2020-06-16","65","3207","3","318","7.9","6.8"
"Spalding","2020-06-17","63","3270","6","324","7.7","7.1"
"Spalding","2020-06-18","57","3327","4","328","8.5","7.3"
"Spalding","2020-06-19","51","3378","6","334","9.5","7.8"
"Spalding","2020-06-20","24","3402","6","340","11.4","9.2"
"Spalding","2020-06-21","12","3414","1","341","11.4","9.2"
"Spalding","2020-06-22","102","3516","18","359","12","10"
"Spalding","2020-06-23","69","3585","7","366","12.8","10.3"
"Spalding","2020-06-24","66","3651","13","379","14.2","11"
"Spalding","2020-06-25","46","3697","6","385","15.1","11.8"
"Spalding","2020-06-26","59","3756","8","393","15.3","12.4"
"Spalding","2020-06-27","40","3796","5","398","13.6","12.5"
"Spalding","2020-06-28","37","3833","11","409","16.6","14"
"Spalding","2020-06-29","111","3944","12","421","15.6","13.8"
"Spalding","2020-06-30","137","4081","21","442","16.4","14.6"
"Spalding","2020-07-01","125","4206","16","458","15.4","14.8"
"Spalding","2020-07-02","247","4453","13","471","14.3","14.7"
"Spalding","2020-07-03","71","4524","12","483","14.8","15.1"
"Spalding","2020-07-04","27","4551","5","488","15.6","14.6"
"Spalding","2020-07-05","47","4598","7","495","13.5","15.1"
"Spalding","2020-07-06","104","4702","9","504","13.2","14.4"
"Spalding","2020-07-07","113","4815","13","517","12.6","14.5"
"Spalding","2020-07-08","165","4980","14","531","12","13.7"
"Spalding","2020-07-09","108","5088","17","548","13.5","13.9"
"Spalding","2020-07-10","87","5175","14","562","13.4","14.1"
"Spalding","2020-07-11","58","5233","9","571","13","14.3"
"Spalding","2020-07-12","46","5279","14","585","15.2","14.4"
"Spalding","2020-07-13","94","5373","17","602","16.6","14.9"
"Spalding","2020-07-14","77","5450","8","610","16.4","14.5"
"Spalding","2020-07-15","158","5608","19","629","16.9","14.5"
"Spalding","2020-07-16","84","5692","12","641","16.7","15.1"
"Spalding","2020-07-17","75","5767","9","650","16.1","14.8"
"Spalding","2020-07-18","44","5811","10","660","17.1","15.1"
"Spalding","2020-07-19","47","5858","8","668","15.2","15.2"
"Spalding","2020-07-20","88","5946","16","684","15.2","15.9"
"Spalding","2020-07-21","83","6029","10","694","15.5","15.9"
"Spalding","2020-07-22","157","6186","13","707","14.9","15.9"
"Spalding","2020-07-23","115","6301","19","726","15.3","16"
"Spalding","2020-07-24","89","6390","14","740","15.8","15.9"
"Spalding","2020-07-25","52","6442","10","750","15.3","16.2"
"Spalding","2020-07-26","29","6471","5","755","15.3","15.3"
"Spalding","2020-07-27","123","6594","19","774","14.9","15.1"
"Spalding","2020-07-28","87","6681","13","787","15.3","15.4"
"Spalding","2020-07-29","197","6878","16","803","15.3","15.1"
"Spalding","2020-07-30","81","6959","10","813","14.7","15"
"Spalding","2020-07-31","64","7023","11","824","14.9","15.4"
"Spalding","2020-08-01","42","7065","13","837","16.6","15.9"
"Spalding","2020-08-02","31","7096","8","845","17.8","16.6"
"Spalding","2020-08-03","118","7214","14","859","17.3","16.1"
"Spalding","2020-08-04","83","7297","14","873","17.6","16.5"
"Spalding","2020-08-05","219","7516","17","890","17.5","16.4"
"Spalding","2020-08-06","79","7595","4","894","16.5","15.6"
"Spalding","2020-08-07","109","7704","17","911","16.3","15.6"
"Spalding","2020-08-08","96","7800","11","922","13.5","15"
"Spalding","2020-08-09","45","7845","9","931","12.7","15.2"
"Spalding","2020-08-10","91","7936","15","946","13.3","15.3"
"Spalding","2020-08-11","105","8041","8","954","12","14.8"
"Spalding","2020-08-12","188","8229","19","973","12.3","14.9"
"Spalding","2020-08-13","65","8294","6","979","12.9","14.7"
"Spalding","2020-08-14","66","8360","6","985","12","14.1"
"Spalding","2020-08-15","39","8399","7","992","12.9","13.2"
"Spalding","2020-08-16","32","8431","8","1000","13.6","13.1"
"Spalding","2020-08-17","93","8524","7","1007","12.4","12.8"
"Spalding","2020-08-18","88","8612","14","1021","13.5","12.8"
"Spalding","2020-08-19","173","8785","11","1032","13","12.7"
"Spalding","2020-08-20","81","8866","4","1036","12.4","12.7"
"Spalding","2020-08-21","303","9169","34","1070","12.7","12.3"
"Spalding","2020-08-22","61","9230","6","1076","11.5","12.2"
"Spalding","2020-08-23","98","9328","7","1083","9","11.3"
"Spalding","2020-08-24","124","9452","10","1093","9.1","10.7"
"Spalding","2020-08-25","101","9553","9","1102","8.1","10.8"
"Spalding","2020-08-26","106","9659","6","1108","8","10.5"
"Spalding","2020-08-27","92","9751","10","1118","8.8","10.6"
"Spalding","2020-08-28","102","9853","8","1126","8.3","10.5"
"Spalding","2020-08-29","65","9918","5","1131","8","9.8"
"Spalding","2020-08-30","56","9974","6","1137","8.5","8.8"
"Spalding","2020-08-31","124","10098","8","1145","8.3","8.7"
"Spalding","2020-09-01","81","10179","2","1147","7.4","7.7"
"Spalding","2020-09-02","113","10292","7","1154","7.5","7.7"
"Spalding","2020-09-03","66","10358","5","1159","7","7.9"
"Spalding","2020-09-04","151","10509","7","1166","6.5","7.4"
"Spalding","2020-09-05","89","10598","3","1169","5.9","7"
"Spalding","2020-09-06","37","10635","2","1171","5.2","6.8"
"Spalding","2020-09-07","53","10688","3","1174","5","6.7"
"Spalding","2020-09-08","99","10787","6","1180","5.6","6.5"
"Spalding","2020-09-09","127","10914","6","1186","5.3","6.4"
"Spalding","2020-09-10","103","11017","3","1189","4.7","5.8"
"Spalding","2020-09-11","92","11109","1","1190","4.2","5.4"
"Spalding","2020-09-12","27","11136","0","1190","3.7","4.8"
"Spalding","2020-09-13","41","11177","8","1198","5.7","5.4"
"Spalding","2020-09-14","87","11264","5","1203","5.7","5.4"
"Spalding","2020-09-15","98","11362","6","1209","5.7","5.6"
"Spalding","2020-09-16","122","11484","6","1215","5.8","5.6"
"Spalding","2020-09-17","71","11555","4","1219","6.1","5.4"
"Spalding","2020-09-18","83","11638","9","1228","7.5","5.9"
"Spalding","2020-09-19","68","11706","4","1232","8.4","6"
"Spalding","2020-09-20","38","11744","5","1237","7.5","6.6"
"Spalding","2020-09-21","73","11817","9","1246","8.4","7.1"
"Spalding","2020-09-22","65","11882","5","1251","8.6","7.2"
"Spalding","2020-09-23","119","12001","10","1261","9.1","7.4"
"Spalding","2020-09-24","66","12067","3","1264","9","7.6"
"Spalding","2020-09-25","124","12191","3","1267","7.8","7.7"
"Spalding","2020-09-26","76","12267","1","1268","7.1","7.8"
"Spalding","2020-09-27","22","12289","1","1269","5.9","6.7"
"Spalding","2020-09-28","85","12374","7","1276","5.3","6.9"
"Spalding","2020-09-29","98","12472","11","1287","5.8","7.2"
"Spalding","2020-09-30","92","12564","2","1289","4.9","7"
"Spalding","2020-10-01","59","12623","2","1291","4.8","6.9"
"Spalding","2020-10-02","107","12730","10","1301","5.7","6.8"
"Spalding","2020-10-03","41","12771","2","1303","6.3","6.7"
"Spalding","2020-10-04","40","12811","4","1307","7","6.5"
"Spalding","2020-10-05","97","12908","4","1311","6.4","5.9"
"Spalding","2020-10-06","113","13021","15","1326","6.7","6.3"
"Spalding","2020-10-07","97","13118","9","1335","7.8","6.3"
"Spalding","2020-10-08","85","13203","5","1340","8.1","6.4"
"Spalding","2020-10-09","102","13305","14","1354","8.7","7.2"
"Spalding","2020-10-10","68","13373","8","1362","9.7","8"
"Spalding","2020-10-11","46","13419","3","1365","9.2","8.1"
"Spalding","2020-10-12","116","13535","12","1377","10.1","8.3"
"Spalding","2020-10-13","111","13646","8","1385","9.2","8"
"Spalding","2020-10-14","91","13737","8","1393","9.2","8.5"
"Spalding","2020-10-15","90","13827","17","1410","11","9.6"
"Spalding","2020-10-16","95","13922","12","1422","10.9","9.8"
"Spalding","2020-10-17","42","13964","7","1429","11.6","10.7"
"Spalding","2020-10-18","41","14005","2","1431","11.3","10.3"
"Spalding","2020-10-19","128","14133","20","1451","12.1","11.1"
"Spalding","2020-10-20","158","14291","17","1468","12.6","10.9"
"Spalding","2020-10-21","134","14425","10","1478","12.4","10.8"
"Spalding","2020-10-22","107","14532","16","1494","11.9","11.4"
"Spalding","2020-10-23","88","14620","9","1503","11.5","11.2"
"Spalding","2020-10-24","53","14673","9","1512","11.6","11.6"
"Spalding","2020-10-25","30","14703","6","1518","13.7","12.5"
"Spalding","2020-10-26","215","14918","17","1535","12.6","12.4"
"Spalding","2020-10-27","179","15097","14","1549","12.2","12.4"
"Spalding","2020-10-28","101","15198","8","1557","12.3","12.3"
"Spalding","2020-10-29","88","15286","5","1562","10.9","11.4"
"Spalding","2020-10-30","97","15383","17","1579","12","11.7"
"Spalding","2020-10-31","63","15446","6","1585","10.9","11.2"
"Spalding","2020-11-01","32","15478","7","1592","11.2","12.4"
"Spalding","2020-11-02","111","15589","13","1605","11.7","12.2"
"Spalding","2020-11-03","207","15796","23","1628","12.2","12.2"
"Spalding","2020-11-04","100","15896","9","1637","12.3","12.3"
"Spalding","2020-11-05","91","15987","5","1642","12.3","11.6"
"Spalding","2020-11-06","122","16109","17","1659","11.8","11.9"
"Spalding","2020-11-07","53","16162","6","1665","12.1","11.5"
"Spalding","2020-11-08","57","16219","5","1670","10.2","10.7"
"Spalding","2020-11-09","108","16327","7","1677","9.4","10.6"
"Spalding","2020-11-10","198","16525","13","1690","8.8","10.5"
"Spalding","2020-11-11","94","16619","11","1701","9.2","10.8"
"Spalding","2020-11-12","97","16716","9","1710","9.7","11"
"Spalding","2020-11-13","91","16807","15","1725","10.1","10.9"
"Spalding","2020-11-14","101","16908","9","1734","9.7","10.9"
"Spalding","2020-11-15","51","16959","4","1738","9.6","9.9"
"Spalding","2020-11-16","149","17108","17","1755","10.3","9.9"
"Spalding","2020-11-17","163","17271","14","1769","10.6","9.7"
"Spalding","2020-11-18","118","17389","8","1777","9.9","9.5"
"Spalding","2020-11-19","112","17501","12","1789","10.1","9.9"
"Spalding","2020-11-20","106","17607","10","1799","9.1","9.6"
"Spalding","2020-11-21","108","17715","9","1808","9","9.4"
"Spalding","2020-11-22","47","17762","16","1824","12.8","11.2"
"Spalding","2020-11-23","110","17872","15","1839","13.1","11.7"
"Spalding","2020-11-24","103","17975","12","1851","13.5","12.1"
"Spalding","2020-11-25","112","18087","25","1876","15.7","12.8"
"Spalding","2020-11-26","9","18096","1","1877","15.8","12.9"
"Spalding","2020-11-27","93","18189","13","1890","16.4","12.8"
"Spalding","2020-11-28","67","18256","12","1902","17.8","13.4"
"Spalding","2020-11-29","61","18317","16","1918","16.7","14.7"
"Spalding","2020-11-30","139","18456","13","1931","16.1","14.6"
"Spalding","2020-12-01","157","18613","14","1945","15.7","14.6"
"Spalding","2020-12-02","115","18728","15","1960","14.4","15"
"Spalding","2020-12-03","113","18841","9","1969","13.9","14.9"
"Spalding","2020-12-04","129","18970","18","1987","13.9","15.2"
"Spalding","2020-12-05","50","19020","7","1994","13.4","15.6"
"Spalding","2020-12-06","25","19045","9","2003","14.7","15.7"
"Spalding","2020-12-07","167","19212","29","2032","15.9","16"
"Spalding","2020-12-08","156","19368","24","2056","16.8","16.3"
"Spalding","2020-12-09","147","19515","27","2083","17.6","16"
"Spalding","2020-12-10","130","19645","25","2108","19.2","16.5"
"Spalding","2020-12-11","138","19783","21","2129","19.4","16.6"
"Spalding","2020-12-12","88","19871","19","2148","20.5","16.9"
"Spalding","2020-12-13","65","19936","17","2165","19","16.9"
"Spalding","2020-12-14","189","20125","35","2200","19.2","17.6"
"Spalding","2020-12-15","254","20379","40","2240","19.3","18"
"Spalding","2020-12-16","187","20566","23","2263","18.4","18"
"Spalding","2020-12-17","124","20690","21","2284","18.1","18.6"
"Spalding","2020-12-18","140","20830","31","2315","19.1","19.2"
"Spalding","2020-12-19","80","20910","17","2332","19","19.7"
"Spalding","2020-12-20","41","20951","5","2337","17","18"
"Spalding","2020-12-21","153","21104","33","2370","17.4","18.3"
"Spalding","2020-12-22","156","21260","37","2407","18.6","18.9"
"Spalding","2020-12-23","160","21420","35","2442","20","19.2"
"Spalding","2020-12-24","72","21492","10","2452","19.5","18.8"
"Spalding","2020-12-25","19","21511","3","2455","18.6","18.8"
"Spalding","2020-12-26","57","21568","18","2473","20.1","19.5"
"Spalding","2020-12-27","44","21612","17","2490","23.9","20.4"
"Spalding","2020-12-28","161","21773","37","2527","24.1","20.8"
"Spalding","2020-12-29","226","21999","36","2563","23","20.8"
"Spalding","2020-12-30","139","22138","29","2592","22.8","21.4"
"Spalding","2020-12-31","118","22256","26","2618","24","21.7"
"Spalding","2021-01-01","15","22271","3","2621","24.6","21.6"
"Spalding","2021-01-02","85","22356","23","2644","23.9","22"
"Spalding","2021-01-03","61","22417","14","2658","21.7","22.8"
"Spalding","2021-01-04","168","22585","37","2695","21.6","22.8"
"Spalding","2021-01-05","344","22929","48","2743","21.3","22.1"
"Spalding","2021-01-06","169","23098","36","2779","21.3","22.1"
"Spalding","2021-01-07","214","23312","42","2821","21","22.5"
"Spalding","2021-01-08","212","23524","54","2875","21.8","23.2"
"Spalding","2021-01-09","85","23609","22","2897","21.6","22.8"
"Spalding","2021-01-10","58","23667","13","2910","21.5","21.6"
"Spalding","2021-01-11","173","23840","37","2947","21.4","21.5"
"Spalding","2021-01-12","150","23990","25","2972","21.8","21.5"
"Spalding","2021-01-13","134","24124","25","2997","21.4","21.4"
"Spalding","2021-01-14","148","24272","27","3024","21.2","21.1"
"Spalding","2021-01-15","110","24382","26","3050","21","21.4"
"Spalding","2021-01-16","66","24448","14","3064","20.3","21"
"Spalding","2021-01-17","47","24495","10","3074","20.2","20.8"
"Spalding","2021-01-18","139","24634","26","3100","19.8","20.6"
"Spalding","2021-01-19","220","24854","33","3133","19.5","20.7"
"Spalding","2021-01-20","145","24999","20","3153","18.8","20.1"
"Spalding","2021-01-21","112","25111","17","3170","18.4","19.8"
"Spalding","2021-01-22","147","25258","30","3200","17.9","19.5"
"Spalding","2021-01-23","38","25296","6","3206","17.2","18.7"
"Spalding","2021-01-24","46","25342","8","3214","16.6","18.4"
"Spalding","2021-01-25","39","25381","3","3217","15","17.4"
"Spalding","2021-01-26","10","25391","1","3218","14.3","16.9"
"Spalding","2021-01-27","0","25391","0","3218","12.4","15.6"
"Stephens","2020-02-01","0","0","0","0",".","."
"Stephens","2020-02-02","0","0","0","0",".","."
"Stephens","2020-02-03","0","0","0","0",".","."
"Stephens","2020-02-04","0","0","0","0",".","."
"Stephens","2020-02-05","0","0","0","0",".","."
"Stephens","2020-02-06","0","0","0","0",".","."
"Stephens","2020-02-07","0","0","0","0","0","."
"Stephens","2020-02-08","0","0","0","0","0","."
"Stephens","2020-02-09","0","0","0","0","0","."
"Stephens","2020-02-10","0","0","0","0","0","."
"Stephens","2020-02-11","0","0","0","0","0","."
"Stephens","2020-02-12","0","0","0","0","0","."
"Stephens","2020-02-13","0","0","0","0","0","."
"Stephens","2020-02-14","0","0","0","0","0","0"
"Stephens","2020-02-15","0","0","0","0","0","0"
"Stephens","2020-02-16","0","0","0","0","0","0"
"Stephens","2020-02-17","0","0","0","0","0","0"
"Stephens","2020-02-18","0","0","0","0","0","0"
"Stephens","2020-02-19","0","0","0","0","0","0"
"Stephens","2020-02-20","0","0","0","0","0","0"
"Stephens","2020-02-21","0","0","0","0","0","0"
"Stephens","2020-02-22","0","0","0","0","0","0"
"Stephens","2020-02-23","0","0","0","0","0","0"
"Stephens","2020-02-24","0","0","0","0","0","0"
"Stephens","2020-02-25","0","0","0","0","0","0"
"Stephens","2020-02-26","0","0","0","0","0","0"
"Stephens","2020-02-27","0","0","0","0","0","0"
"Stephens","2020-02-28","0","0","0","0","0","0"
"Stephens","2020-02-29","0","0","0","0","0","0"
"Stephens","2020-03-01","0","0","0","0","0","0"
"Stephens","2020-03-02","0","0","0","0","0","0"
"Stephens","2020-03-03","0","0","0","0","0","0"
"Stephens","2020-03-04","0","0","0","0","0","0"
"Stephens","2020-03-05","0","0","0","0","0","0"
"Stephens","2020-03-06","0","0","0","0","0","0"
"Stephens","2020-03-07","0","0","0","0","0","0"
"Stephens","2020-03-08","0","0","0","0","0","0"
"Stephens","2020-03-09","0","0","0","0","0","0"
"Stephens","2020-03-10","0","0","0","0","0","0"
"Stephens","2020-03-11","0","0","0","0","0","0"
"Stephens","2020-03-12","2","2","0","0","0","0"
"Stephens","2020-03-13","1","3","0","0","0","0"
"Stephens","2020-03-14","1","4","0","0","0","0"
"Stephens","2020-03-15","0","4","0","0","0","0"
"Stephens","2020-03-16","4","8","1","1","3.6","1.8"
"Stephens","2020-03-17","3","11","0","1","3.6","1.8"
"Stephens","2020-03-18","2","13","0","1","3.6","1.8"
"Stephens","2020-03-19","3","16","0","1","3.6","1.8"
"Stephens","2020-03-20","6","22","0","1","3.6","1.8"
"Stephens","2020-03-21","1","23","0","1","3.6","1.8"
"Stephens","2020-03-22","1","24","0","1","3.6","1.8"
"Stephens","2020-03-23","6","30","0","1","0","1.8"
"Stephens","2020-03-24","4","34","1","2","3.6","3.6"
"Stephens","2020-03-25","2","36","0","2","3.6","3.6"
"Stephens","2020-03-26","2","38","0","2","3.6","3.6"
"Stephens","2020-03-27","6","44","1","3","6","4.8"
"Stephens","2020-03-28","2","46","0","3","6","4.8"
"Stephens","2020-03-29","1","47","1","4","20.2","11.9"
"Stephens","2020-03-30","3","50","0","4","20.2","10.1"
"Stephens","2020-03-31","10","60","1","5","18.1","10.8"
"Stephens","2020-04-01","3","63","1","6","22.9","13.2"
"Stephens","2020-04-02","1","64","0","6","22.9","13.2"
"Stephens","2020-04-03","0","64","0","6","20.5","13.2"
"Stephens","2020-04-04","1","65","0","6","20.5","13.2"
"Stephens","2020-04-05","0","65","0","6","6.2","13.2"
"Stephens","2020-04-06","0","65","0","6","6.2","13.2"
"Stephens","2020-04-07","1","66","0","6","4.8","11.4"
"Stephens","2020-04-08","2","68","1","7","7.1","15"
"Stephens","2020-04-09","0","68","0","7","7.1","15"
"Stephens","2020-04-10","0","68","0","7","7.1","13.8"
"Stephens","2020-04-11","1","69","0","7","7.1","13.8"
"Stephens","2020-04-12","0","69","0","7","7.1","6.7"
"Stephens","2020-04-13","0","69","0","7","7.1","6.7"
"Stephens","2020-04-14","1","70","0","7","7.1","6"
"Stephens","2020-04-15","3","73","0","7","0","3.6"
"Stephens","2020-04-16","3","76","1","8","4.8","6"
"Stephens","2020-04-17","0","76","0","8","4.8","6"
"Stephens","2020-04-18","0","76","0","8","4.8","6"
"Stephens","2020-04-19","0","76","0","8","4.8","6"
"Stephens","2020-04-20","0","76","0","8","4.8","6"
"Stephens","2020-04-21","5","81","2","10","10.5","8.8"
"Stephens","2020-04-22","0","81","0","10","10.5","5.2"
"Stephens","2020-04-23","4","85","0","10","5.7","5.2"
"Stephens","2020-04-24","7","92","0","10","5.7","5.2"
"Stephens","2020-04-25","1","93","0","10","5.7","5.2"
"Stephens","2020-04-26","0","93","0","10","5.7","5.2"
"Stephens","2020-04-27","1","94","0","10","5.7","5.2"
"Stephens","2020-04-28","2","96","0","10","0","5.2"
"Stephens","2020-04-29","10","106","1","11","1.4","6"
"Stephens","2020-04-30","11","117","1","12","2.7","4.2"
"Stephens","2020-05-01","5","122","0","12","2.7","4.2"
"Stephens","2020-05-02","3","125","0","12","2.7","4.2"
"Stephens","2020-05-03","1","126","0","12","2.7","4.2"
"Stephens","2020-05-04","1","127","0","12","2.7","4.2"
"Stephens","2020-05-05","7","134","0","12","2.7","1.4"
"Stephens","2020-05-06","5","139","0","12","1.3","1.4"
"Stephens","2020-05-07","6","145","1","13","2.4","2.6"
"Stephens","2020-05-08","3","148","0","13","2.4","2.6"
"Stephens","2020-05-09","2","150","0","13","2.4","2.6"
"Stephens","2020-05-10","0","150","0","13","2.4","2.6"
"Stephens","2020-05-11","5","155","0","13","2.4","2.6"
"Stephens","2020-05-12","6","161","0","13","2.4","2.6"
"Stephens","2020-05-13","3","164","1","14","7.1","4.2"
"Stephens","2020-05-14","2","166","0","14","4.8","3.6"
"Stephens","2020-05-15","12","178","0","14","4.8","3.6"
"Stephens","2020-05-16","2","180","0","14","4.8","3.6"
"Stephens","2020-05-17","1","181","0","14","4.8","3.6"
"Stephens","2020-05-18","6","187","0","14","4.8","3.6"
"Stephens","2020-05-19","12","199","1","15","6","4.2"
"Stephens","2020-05-20","11","210","3","18","5.1","6.1"
"Stephens","2020-05-21","44","254","2","20","5.7","5.2"
"Stephens","2020-05-22","6","260","3","23","12.9","8.8"
"Stephens","2020-05-23","2","262","0","23","12.9","8.8"
"Stephens","2020-05-24","2","264","1","24","20","12.4"
"Stephens","2020-05-25","0","264","0","24","20","12.4"
"Stephens","2020-05-26","3","267","0","24","18.8","12.4"
"Stephens","2020-05-27","15","282","6","30","20.6","12.9"
"Stephens","2020-05-28","8","290","2","32","23.6","14.7"
"Stephens","2020-05-29","7","297","1","33","18.5","15.7"
"Stephens","2020-05-30","0","297","0","33","18.5","15.7"
"Stephens","2020-05-31","7","304","6","39","23.6","21.8"
"Stephens","2020-06-01","9","313","0","39","23.6","21.8"
"Stephens","2020-06-02","13","326","1","40","24.7","21.8"
"Stephens","2020-06-03","19","345","6","46","23.5","22.1"
"Stephens","2020-06-04","5","350","1","47","22.8","23.2"
"Stephens","2020-06-05","8","358","4","51","27.9","23.2"
"Stephens","2020-06-06","4","362","0","51","27.9","23.2"
"Stephens","2020-06-07","3","365","3","54","29.9","26.7"
"Stephens","2020-06-08","1","366","0","54","29.9","26.7"
"Stephens","2020-06-09","9","375","0","54","28.8","26.7"
"Stephens","2020-06-10","11","386","2","56","26.9","25.2"
"Stephens","2020-06-11","15","401","11","67","34.5","28.6"
"Stephens","2020-06-12","8","409","1","68","29.1","28.5"
"Stephens","2020-06-13","4","413","0","68","29.1","28.5"
"Stephens","2020-06-14","1","414","0","68","14.9","22.4"
"Stephens","2020-06-15","4","418","0","68","14.9","22.4"
"Stephens","2020-06-16","6","424","0","68","14.9","21.8"
"Stephens","2020-06-17","15","439","8","76","19.9","23.4"
"Stephens","2020-06-18","7","446","2","78","13.5","24"
"Stephens","2020-06-19","19","465","11","89","20","24.6"
"Stephens","2020-06-20","4","469","0","89","20","24.6"
"Stephens","2020-06-21","2","471","1","90","27.1","21"
"Stephens","2020-06-22","16","487","10","100","36","25.5"
"Stephens","2020-06-23","2","489","0","100","36","25.5"
"Stephens","2020-06-24","14","503","7","107","35.6","27.7"
"Stephens","2020-06-25","51","554","39","146","42.4","27.9"
"Stephens","2020-06-26","15","569","3","149","37","28.5"
"Stephens","2020-06-27","11","580","3","152","40.9","30.4"
"Stephens","2020-06-28","13","593","3","155","37","32.1"
"Stephens","2020-06-29","22","615","13","168","36.6","36.3"
"Stephens","2020-06-30","29","644","15","183","43.9","40"
"Stephens","2020-07-01","28","672","22","205","48","41.8"
"Stephens","2020-07-02","11","683","3","208","41","41.7"
"Stephens","2020-07-03","132","815","27","235","41.1","39"
"Stephens","2020-07-04","11","826","1","236","38.5","39.7"
"Stephens","2020-07-05","6","832","0","236","35.2","36.1"
"Stephens","2020-07-06","38","870","13","249","31.6","34.1"
"Stephens","2020-07-07","127","997","33","282","27.9","35.9"
"Stephens","2020-07-08","81","1078","27","309","21.5","34.8"
"Stephens","2020-07-09","18","1096","0","309","17.6","29.3"
"Stephens","2020-07-10","153","1249","55","364","19.8","30.4"
"Stephens","2020-07-11","69","1318","29","393","24.5","31.5"
"Stephens","2020-07-12","94","1412","19","412","27.4","31.3"
"Stephens","2020-07-13","25","1437","1","413","23.1","27.3"
"Stephens","2020-07-14","102","1539","35","448","24.3","26.1"
"Stephens","2020-07-15","224","1763","37","485","21.9","21.7"
"Stephens","2020-07-16","223","1986","45","530","24.7","21.2"
"Stephens","2020-07-17","284","2270","69","599","23.1","21.4"
"Stephens","2020-07-18","4","2274","0","599","17.1","20.8"
"Stephens","2020-07-19","26","2300","4","603","16.4","21.9"
"Stephens","2020-07-20","74","2374","17","620","19.1","21.1"
"Stephens","2020-07-21","52","2426","17","637","18.9","21.6"
"Stephens","2020-07-22","81","2507","33","670","22.3","22.1"
"Stephens","2020-07-23","60","2567","17","687","23.5","24.1"
"Stephens","2020-07-24","42","2609","5","692","21.7","22.4"
"Stephens","2020-07-25","63","2672","16","708","25.3","21.2"
"Stephens","2020-07-26","29","2701","16","724","31","23.7"
"Stephens","2020-07-27","70","2771","15","739","30.8","25"
"Stephens","2020-07-28","40","2811","6","745","28.3","23.6"
"Stephens","2020-07-29","41","2852","9","754","25.6","24"
"Stephens","2020-07-30","75","2927","25","779","26.3","24.9"
"Stephens","2020-07-31","35","2962","6","785","27.1","24.4"
"Stephens","2020-08-01","59","3021","22","807","28.8","27.1"
"Stephens","2020-08-02","29","3050","7","814","24.3","27.7"
"Stephens","2020-08-03","30","3080","7","821","24.6","27.7"
"Stephens","2020-08-04","24","3104","5","826","25.4","26.9"
"Stephens","2020-08-05","75","3179","20","846","26.1","25.9"
"Stephens","2020-08-06","45","3224","10","856","24.5","25.4"
"Stephens","2020-08-07","46","3270","12","868","25.8","26.4"
"Stephens","2020-08-08","42","3312","25","893","29","28.9"
"Stephens","2020-08-09","20","3332","6","899","29.8","27.1"
"Stephens","2020-08-10","77","3409","10","909","28.3","26.5"
"Stephens","2020-08-11","45","3454","10","919","28.5","27"
"Stephens","2020-08-12","55","3509","18","937","29.4","27.8"
"Stephens","2020-08-13","52","3561","12","949","29.5","27"
"Stephens","2020-08-14","38","3599","6","955","28","26.9"
"Stephens","2020-08-15","17","3616","0","955","19.5","24.3"
"Stephens","2020-08-16","65","3681","15","970","18.6","24.2"
"Stephens","2020-08-17","26","3707","3","973","18.3","23.3"
"Stephens","2020-08-18","29","3736","9","982","19.6","24.1"
"Stephens","2020-08-19","126","3862","22","1004","17.4","23.4"
"Stephens","2020-08-20","28","3890","1","1005","14.6","22.1"
"Stephens","2020-08-21","120","4010","8","1013","13.3","20.7"
"Stephens","2020-08-22","69","4079","15","1028","16.4","18"
"Stephens","2020-08-23","26","4105","2","1030","14.2","16.4"
"Stephens","2020-08-24","28","4133","8","1038","16.7","17.5"
"Stephens","2020-08-25","21","4154","9","1047","18.4","19"
"Stephens","2020-08-26","92","4246","23","1070","19.4","18.4"
"Stephens","2020-08-27","60","4306","11","1081","21.6","18.1"
"Stephens","2020-08-28","26","4332","5","1086","23.3","18.3"
"Stephens","2020-08-29","46","4378","0","1086","20.2","18.3"
"Stephens","2020-08-30","64","4442","8","1094","20.9","17.6"
"Stephens","2020-08-31","51","4493","15","1109","21","18.9"
"Stephens","2020-09-01","43","4536","10","1119","18.2","18.3"
"Stephens","2020-09-02","83","4619","11","1130","16.6","18"
"Stephens","2020-09-03","36","4655","2","1132","14.7","18.1"
"Stephens","2020-09-04","54","4709","2","1134","12.5","17.9"
"Stephens","2020-09-05","39","4748","3","1137","13.6","16.9"
"Stephens","2020-09-06","30","4778","3","1140","13.3","17.1"
"Stephens","2020-09-07","15","4793","2","1142","11","16"
"Stephens","2020-09-08","23","4816","1","1143","8.3","13.3"
"Stephens","2020-09-09","44","4860","8","1151","9","12.8"
"Stephens","2020-09-10","34","4894","6","1157","10.7","12.7"
"Stephens","2020-09-11","50","4944","7","1164","12.2","12.3"
"Stephens","2020-09-12","20","4964","2","1166","12.5","13.1"
"Stephens","2020-09-13","38","5002","4","1170","12.6","12.9"
"Stephens","2020-09-14","27","5029","3","1173","12.3","11.6"
"Stephens","2020-09-15","18","5047","3","1176","14","11.1"
"Stephens","2020-09-16","42","5089","7","1183","13.8","11.4"
"Stephens","2020-09-17","19","5108","3","1186","13.5","12.1"
"Stephens","2020-09-18","50","5158","15","1201","15.8","14"
"Stephens","2020-09-19","26","5184","5","1206","17.1","14.8"
"Stephens","2020-09-20","19","5203","5","1211","19.4","16"
"Stephens","2020-09-21","39","5242","8","1219","20.7","16.5"
"Stephens","2020-09-22","36","5278","9","1228","21.9","18"
"Stephens","2020-09-23","41","5319","18","1246","25.8","19.8"
"Stephens","2020-09-24","18","5337","2","1248","25.2","19.3"
"Stephens","2020-09-25","62","5399","15","1263","24.3","20.1"
"Stephens","2020-09-26","29","5428","8","1271","25.5","21.3"
"Stephens","2020-09-27","21","5449","4","1275","24.5","21.9"
"Stephens","2020-09-28","40","5489","5","1280","23.3","22"
"Stephens","2020-09-29","42","5531","9","1289","22.8","22.4"
"Stephens","2020-09-30","40","5571","10","1299","20.1","23"
"Stephens","2020-10-01","50","5621","16","1315","23.1","24.1"
"Stephens","2020-10-02","39","5660","8","1323","22.6","23.5"
"Stephens","2020-10-03","36","5696","14","1337","24.2","24.9"
"Stephens","2020-10-04","36","5732","7","1344","24.3","24.4"
"Stephens","2020-10-05","41","5773","10","1354","26","24.6"
"Stephens","2020-10-06","20","5793","4","1358","25.7","24.3"
"Stephens","2020-10-07","66","5859","24","1382","27.4","23.7"
"Stephens","2020-10-08","41","5900","11","1393","26.6","24.9"
"Stephens","2020-10-09","46","5946","8","1401","26.2","24.4"
"Stephens","2020-10-10","19","5965","5","1406","24.4","24.3"
"Stephens","2020-10-11","25","5990","7","1413","25.6","24.9"
"Stephens","2020-10-12","33","6023","3","1416","23.4","24.7"
"Stephens","2020-10-13","20","6043","1","1417","21.3","23.5"
"Stephens","2020-10-14","31","6074","5","1422","18.4","22.9"
"Stephens","2020-10-15","38","6112","10","1432","18.3","22.5"
"Stephens","2020-10-16","26","6138","8","1440","20.2","23.2"
"Stephens","2020-10-17","15","6153","1","1441","17.4","20.9"
"Stephens","2020-10-18","12","6165","0","1441","13.4","19.5"
"Stephens","2020-10-19","29","6194","2","1443","13.1","18.3"
"Stephens","2020-10-20","22","6216","2","1445","13.7","17.5"
"Stephens","2020-10-21","26","6242","5","1450","14.1","16.3"
"Stephens","2020-10-22","42","6284","7","1457","12.8","15.5"
"Stephens","2020-10-23","18","6302","3","1460","10.7","15.5"
"Stephens","2020-10-24","19","6321","5","1465","13.6","15.5"
"Stephens","2020-10-25","6","6327","0","1465","13.6","13.5"
"Stephens","2020-10-26","24","6351","1","1466","13.2","13.1"
"Stephens","2020-10-27","19","6370","3","1469","14.1","13.9"
"Stephens","2020-10-28","25","6395","2","1471","12.5","13.3"
"Stephens","2020-10-29","28","6423","3","1474","11.7","12.2"
"Stephens","2020-10-30","20","6443","2","1476","10.7","10.7"
"Stephens","2020-10-31","7","6450","2","1478","11","12.3"
"Stephens","2020-11-01","21","6471","6","1484","15.1","14.3"
"Stephens","2020-11-02","16","6487","0","1484","14.5","13.8"
"Stephens","2020-11-03","31","6518","3","1487","13.6","13.9"
"Stephens","2020-11-04","16","6534","2","1489","14.3","13.4"
"Stephens","2020-11-05","27","6561","3","1492","14.3","13"
"Stephens","2020-11-06","21","6582","6","1498","17","13.9"
"Stephens","2020-11-07","8","6590","1","1499","14.7","12.9"
"Stephens","2020-11-08","17","6607","4","1503","14","14.6"
"Stephens","2020-11-09","38","6645","9","1512","17.4","15.9"
"Stephens","2020-11-10","18","6663","5","1517","20","16.8"
"Stephens","2020-11-11","20","6683","3","1520","20.3","17.3"
"Stephens","2020-11-12","35","6718","7","1527","21.6","18"
"Stephens","2020-11-13","26","6744","4","1531","19.7","18.3"
"Stephens","2020-11-14","22","6766","2","1533","19.2","17"
"Stephens","2020-11-15","24","6790","3","1536","17.6","15.8"
"Stephens","2020-11-16","30","6820","4","1540","16.2","16.8"
"Stephens","2020-11-17","42","6862","7","1547","14.6","17.3"
"Stephens","2020-11-18","37","6899","5","1552","14.4","17.3"
"Stephens","2020-11-19","45","6944","5","1557","13.1","17.3"
"Stephens","2020-11-20","56","7000","5","1562","12.2","15.9"
"Stephens","2020-11-21","25","7025","4","1566","13.2","16.2"
"Stephens","2020-11-22","15","7040","3","1569","14.2","15.9"
"Stephens","2020-11-23","42","7082","4","1573","13.7","14.9"
"Stephens","2020-11-24","83","7165","14","1587","13.7","14.1"
"Stephens","2020-11-25","56","7221","11","1598","14.6","14.5"
"Stephens","2020-11-26","2","7223","1","1599","20.1","16.6"
"Stephens","2020-11-27","37","7260","13","1612","23.9","18"
"Stephens","2020-11-28","39","7299","9","1621","24.9","19"
"Stephens","2020-11-29","44","7343","14","1635","26.6","20.4"
"Stephens","2020-11-30","52","7395","6","1641","26.9","20.3"
"Stephens","2020-12-01","54","7449","9","1650","26.8","20.3"
"Stephens","2020-12-02","81","7530","16","1666","26.9","20.7"
"Stephens","2020-12-03","99","7629","22","1688","22.9","21.5"
"Stephens","2020-12-04","73","7702","15","1703","20.8","22.3"
"Stephens","2020-12-05","40","7742","11","1714","21.4","23.2"
"Stephens","2020-12-06","25","7767","7","1721","20.9","23.7"
"Stephens","2020-12-07","87","7854","21","1742","22.7","24.8"
"Stephens","2020-12-08","81","7935","15","1757","23","24.9"
"Stephens","2020-12-09","83","8018","18","1775","23.2","25"
"Stephens","2020-12-10","80","8098","21","1796","23.8","23.3"
"Stephens","2020-12-11","79","8177","24","1820","25.2","23"
"Stephens","2020-12-12","91","8268","26","1846","25.4","23.4"
"Stephens","2020-12-13","58","8326","8","1854","23.3","22.1"
"Stephens","2020-12-14","69","8395","17","1871","23.4","23"
"Stephens","2020-12-15","87","8482","24","1895","24.7","23.8"
"Stephens","2020-12-16","130","8612","27","1922","24.6","23.9"
"Stephens","2020-12-17","81","8693","16","1938","23.6","23.7"
"Stephens","2020-12-18","90","8783","21","1959","22.6","23.9"
"Stephens","2020-12-19","75","8858","21","1980","22.6","24"
"Stephens","2020-12-20","32","8890","13","1993","26.4","24.9"
"Stephens","2020-12-21","86","8976","25","2018","27","25.2"
"Stephens","2020-12-22","87","9063","19","2037","26.2","25.4"
"Stephens","2020-12-23","136","9199","38","2075","27.2","25.9"
"Stephens","2020-12-24","44","9243","12","2087","28.3","26"
"Stephens","2020-12-25","0","9243","0","2087","25","23.8"
"Stephens","2020-12-26","34","9277","9","2096","24.7","23.6"
"Stephens","2020-12-27","32","9309","17","2113","26.5","26.5"
"Stephens","2020-12-28","85","9394","31","2144","27.6","27.3"
"Stephens","2020-12-29","95","9489","24","2168","28.1","27.1"
"Stephens","2020-12-30","84","9573","24","2192","28.2","27.7"
"Stephens","2020-12-31","86","9659","19","2211","27.4","27.9"
"Stephens","2021-01-01","42","9701","14","2225","32.2","28.6"
"Stephens","2021-01-02","31","9732","10","2235","33","28.9"
"Stephens","2021-01-03","81","9813","35","2270","31.6","29.1"
"Stephens","2021-01-04","53","9866","9","2279","28.8","28.2"
"Stephens","2021-01-05","101","9967","22","2301","28.3","28.2"
"Stephens","2021-01-06","177","10144","45","2346","27.9","28"
"Stephens","2021-01-07","97","10241","24","2370","28.2","27.8"
"Stephens","2021-01-08","106","10347","21","2391","26.3","29.3"
"Stephens","2021-01-09","62","10409","13","2404","24.7","28.9"
"Stephens","2021-01-10","48","10457","13","2417","22.4","27"
"Stephens","2021-01-11","50","10507","17","2434","24.8","26.8"
"Stephens","2021-01-12","77","10584","23","2457","26","27.2"
"Stephens","2021-01-13","83","10667","10","2467","24.1","26"
"Stephens","2021-01-14","77","10744","13","2480","23","25.6"
"Stephens","2021-01-15","87","10831","26","2506","24.4","25.4"
"Stephens","2021-01-16","73","10904","18","2524","24.9","24.8"
"Stephens","2021-01-17","19","10923","7","2531","26.3","24.4"
"Stephens","2021-01-18","55","10978","14","2545","25.1","25"
"Stephens","2021-01-19","52","11030","7","2552","22.7","24.4"
"Stephens","2021-01-20","51","11081","10","2562","23.8","24"
"Stephens","2021-01-21","50","11131","12","2574","24.8","23.9"
"Stephens","2021-01-22","61","11192","10","2584","22.9","23.7"
"Stephens","2021-01-23","18","11210","1","2585","20.2","22.6"
"Stephens","2021-01-24","10","11220","6","2591","23.5","24.9"
"Stephens","2021-01-25","28","11248","6","2597","22.9","24"
"Stephens","2021-01-26","0","11248","0","2597","21","21.9"
"Stephens","2021-01-27","0","11248","0","2597","18.2","21"
"Stewart","2020-02-01","0","0","0","0",".","."
"Stewart","2020-02-02","0","0","0","0",".","."
"Stewart","2020-02-03","0","0","0","0",".","."
"Stewart","2020-02-04","0","0","0","0",".","."
"Stewart","2020-02-05","0","0","0","0",".","."
"Stewart","2020-02-06","0","0","0","0",".","."
"Stewart","2020-02-07","0","0","0","0","0","."
"Stewart","2020-02-08","0","0","0","0","0","."
"Stewart","2020-02-09","0","0","0","0","0","."
"Stewart","2020-02-10","0","0","0","0","0","."
"Stewart","2020-02-11","0","0","0","0","0","."
"Stewart","2020-02-12","0","0","0","0","0","."
"Stewart","2020-02-13","0","0","0","0","0","."
"Stewart","2020-02-14","0","0","0","0","0","0"
"Stewart","2020-02-15","0","0","0","0","0","0"
"Stewart","2020-02-16","0","0","0","0","0","0"
"Stewart","2020-02-17","0","0","0","0","0","0"
"Stewart","2020-02-18","0","0","0","0","0","0"
"Stewart","2020-02-19","0","0","0","0","0","0"
"Stewart","2020-02-20","0","0","0","0","0","0"
"Stewart","2020-02-21","0","0","0","0","0","0"
"Stewart","2020-02-22","0","0","0","0","0","0"
"Stewart","2020-02-23","0","0","0","0","0","0"
"Stewart","2020-02-24","0","0","0","0","0","0"
"Stewart","2020-02-25","0","0","0","0","0","0"
"Stewart","2020-02-26","0","0","0","0","0","0"
"Stewart","2020-02-27","0","0","0","0","0","0"
"Stewart","2020-02-28","0","0","0","0","0","0"
"Stewart","2020-02-29","0","0","0","0","0","0"
"Stewart","2020-03-01","0","0","0","0","0","0"
"Stewart","2020-03-02","0","0","0","0","0","0"
"Stewart","2020-03-03","0","0","0","0","0","0"
"Stewart","2020-03-04","0","0","0","0","0","0"
"Stewart","2020-03-05","0","0","0","0","0","0"
"Stewart","2020-03-06","0","0","0","0","0","0"
"Stewart","2020-03-07","0","0","0","0","0","0"
"Stewart","2020-03-08","0","0","0","0","0","0"
"Stewart","2020-03-09","0","0","0","0","0","0"
"Stewart","2020-03-10","0","0","0","0","0","0"
"Stewart","2020-03-11","0","0","0","0","0","0"
"Stewart","2020-03-12","0","0","0","0","0","0"
"Stewart","2020-03-13","0","0","0","0","0","0"
"Stewart","2020-03-14","0","0","0","0","0","0"
"Stewart","2020-03-15","0","0","0","0","0","0"
"Stewart","2020-03-16","0","0","0","0","0","0"
"Stewart","2020-03-17","2","2","0","0","0","0"
"Stewart","2020-03-18","2","4","0","0","0","0"
"Stewart","2020-03-19","2","6","0","0","0","0"
"Stewart","2020-03-20","0","6","0","0","0","0"
"Stewart","2020-03-21","0","6","0","0","0","0"
"Stewart","2020-03-22","0","6","0","0","0","0"
"Stewart","2020-03-23","2","8","0","0","0","0"
"Stewart","2020-03-24","3","11","0","0","0","0"
"Stewart","2020-03-25","2","13","0","0","0","0"
"Stewart","2020-03-26","1","14","0","0","0","0"
"Stewart","2020-03-27","3","17","3","3","14.3","7.1"
"Stewart","2020-03-28","2","19","0","3","14.3","7.1"
"Stewart","2020-03-29","0","19","0","3","14.3","7.1"
"Stewart","2020-03-30","0","19","0","3","14.3","7.1"
"Stewart","2020-03-31","1","20","0","3","14.3","7.1"
"Stewart","2020-04-01","1","21","0","3","14.3","7.1"
"Stewart","2020-04-02","0","21","0","3","14.3","7.1"
"Stewart","2020-04-03","2","23","0","3","0","7.1"
"Stewart","2020-04-04","1","24","0","3","0","7.1"
"Stewart","2020-04-05","0","24","0","3","0","7.1"
"Stewart","2020-04-06","2","26","1","4","7.1","10.7"
"Stewart","2020-04-07","1","27","0","4","7.1","10.7"
"Stewart","2020-04-08","1","28","0","4","7.1","10.7"
"Stewart","2020-04-09","3","31","0","4","7.1","10.7"
"Stewart","2020-04-10","6","37","2","6","11.9","6"
"Stewart","2020-04-11","1","38","0","6","11.9","6"
"Stewart","2020-04-12","2","40","0","6","11.9","6"
"Stewart","2020-04-13","5","45","1","7","7.6","7.4"
"Stewart","2020-04-14","2","47","0","7","7.6","7.4"
"Stewart","2020-04-15","2","49","1","8","14.8","11"
"Stewart","2020-04-16","1","50","0","8","14.8","11"
"Stewart","2020-04-17","0","50","0","8","10","11"
"Stewart","2020-04-18","1","51","0","8","10","11"
"Stewart","2020-04-19","0","51","0","8","10","11"
"Stewart","2020-04-20","4","55","1","9","10.7","9.2"
"Stewart","2020-04-21","3","58","0","9","10.7","9.2"
"Stewart","2020-04-22","3","61","0","9","3.6","9.2"
"Stewart","2020-04-23","6","67","2","11","8.3","11.5"
"Stewart","2020-04-24","3","70","1","12","13.1","11.5"
"Stewart","2020-04-25","0","70","0","12","13.1","11.5"
"Stewart","2020-04-26","2","72","0","12","13.1","11.5"
"Stewart","2020-04-27","1","73","0","12","9.5","10.1"
"Stewart","2020-04-28","0","73","0","12","9.5","10.1"
"Stewart","2020-04-29","7","80","1","13","11.6","7.6"
"Stewart","2020-04-30","6","86","0","13","6.8","7.6"
"Stewart","2020-05-01","5","91","1","14","4.9","9"
"Stewart","2020-05-02","2","93","0","14","4.9","9"
"Stewart","2020-05-03","1","94","0","14","4.9","9"
"Stewart","2020-05-04","4","98","1","15","8.5","9"
"Stewart","2020-05-05","2","100","0","15","8.5","9"
"Stewart","2020-05-06","4","104","2","17","13.6","12.6"
"Stewart","2020-05-07","3","107","1","18","18.3","12.6"
"Stewart","2020-05-08","6","113","2","20","20.2","12.6"
"Stewart","2020-05-09","1","114","1","21","34.5","19.7"
"Stewart","2020-05-10","0","114","0","21","34.5","19.7"
"Stewart","2020-05-11","2","116","0","21","31","19.7"
"Stewart","2020-05-12","3","119","1","22","35.7","22.1"
"Stewart","2020-05-13","8","127","0","22","28.6","21.1"
"Stewart","2020-05-14","2","129","0","22","23.8","21.1"
"Stewart","2020-05-15","12","141","2","24","21.4","20.8"
"Stewart","2020-05-16","2","143","0","24","7.1","20.8"
"Stewart","2020-05-17","2","145","0","24","7.1","20.8"
"Stewart","2020-05-18","9","154","1","25","8.7","19.8"
"Stewart","2020-05-19","5","159","0","25","4","19.8"
"Stewart","2020-05-20","3","162","0","25","4","16.3"
"Stewart","2020-05-21","2","164","0","25","4","13.9"
"Stewart","2020-05-22","12","176","1","26","2.8","12.1"
"Stewart","2020-05-23","0","176","0","26","2.8","5"
"Stewart","2020-05-24","1","177","0","26","2.8","5"
"Stewart","2020-05-25","0","177","0","26","1.2","5"
"Stewart","2020-05-26","3","180","1","27","6","5"
"Stewart","2020-05-27","4","184","1","28","9.5","6.7"
"Stewart","2020-05-28","8","192","0","28","9.5","6.7"
"Stewart","2020-05-29","11","203","0","28","8.3","5.6"
"Stewart","2020-05-30","2","205","0","28","8.3","5.6"
"Stewart","2020-05-31","3","208","0","28","8.3","5.6"
"Stewart","2020-06-01","5","213","2","30","14","7.6"
"Stewart","2020-06-02","5","218","0","30","9.3","7.6"
"Stewart","2020-06-03","38","256","2","32","6.5","8"
"Stewart","2020-06-04","4","260","0","32","6.5","8"
"Stewart","2020-06-05","7","267","0","32","6.5","7.4"
"Stewart","2020-06-06","0","267","0","32","6.5","7.4"
"Stewart","2020-06-07","3","270","0","32","6.5","7.4"
"Stewart","2020-06-08","8","278","0","32","0.8","7.4"
"Stewart","2020-06-09","3","281","0","32","0.8","5"
"Stewart","2020-06-10","6","287","1","33","2.4","4.4"
"Stewart","2020-06-11","7","294","0","33","2.4","4.4"
"Stewart","2020-06-12","3","297","1","34","7.1","6.8"
"Stewart","2020-06-13","2","299","0","34","7.1","6.8"
"Stewart","2020-06-14","2","301","0","34","7.1","6.8"
"Stewart","2020-06-15","3","304","0","34","7.1","3.9"
"Stewart","2020-06-16","4","308","2","36","14.3","7.5"
"Stewart","2020-06-17","17","325","4","40","15.3","8.8"
"Stewart","2020-06-18","1","326","0","40","15.3","8.8"
"Stewart","2020-06-19","15","341","1","41","11.5","9.3"
"Stewart","2020-06-20","0","341","0","41","11.5","9.3"
"Stewart","2020-06-21","1","342","0","41","11.5","9.3"
"Stewart","2020-06-22","9","351","2","43","14.6","10.9"
"Stewart","2020-06-23","4","355","1","44","11.1","12.7"
"Stewart","2020-06-24","21","376","5","49","11.1","13.2"
"Stewart","2020-06-25","6","382","1","50","13.5","14.4"
"Stewart","2020-06-26","16","398","1","51","13.4","12.4"
"Stewart","2020-06-27","1","399","1","52","27.7","19.6"
"Stewart","2020-06-28","5","404","2","54","33.4","22.4"
"Stewart","2020-06-29","129","533","67","121","37.7","26.1"
"Stewart","2020-06-30","5","538","0","121","34.1","22.6"
"Stewart","2020-07-01","24","562","4","125","33.1","22.1"
"Stewart","2020-07-02","3","565","0","125","30.7","22.1"
"Stewart","2020-07-03","5","570","2","127","35.5","24.5"
"Stewart","2020-07-04","2","572","0","127","21.2","24.5"
"Stewart","2020-07-05","4","576","0","127","15.5","24.5"
"Stewart","2020-07-06","20","596","5","132","11.7","24.7"
"Stewart","2020-07-07","3","599","0","132","11.7","22.9"
"Stewart","2020-07-08","34","633","2","134","10.1","21.6"
"Stewart","2020-07-09","4","637","0","134","10.1","20.4"
"Stewart","2020-07-10","20","657","3","137","6.6","21"
"Stewart","2020-07-11","3","660","1","138","11.3","16.3"
"Stewart","2020-07-12","2","662","0","138","11.3","13.4"
"Stewart","2020-07-13","7","669","1","139","9.8","10.7"
"Stewart","2020-07-14","0","669","0","139","9.8","10.7"
"Stewart","2020-07-15","17","686","3","142","11.5","10.8"
"Stewart","2020-07-16","2","688","0","142","11.5","10.8"
"Stewart","2020-07-17","20","708","1","143","10","8.3"
"Stewart","2020-07-18","1","709","1","144","19.6","15.4"
"Stewart","2020-07-19","3","712","2","146","29.1","20.2"
"Stewart","2020-07-20","5","717","2","148","32.8","21.3"
"Stewart","2020-07-21","2","719","0","148","32.8","21.3"
"Stewart","2020-07-22","14","733","3","151","33.3","22.4"
"Stewart","2020-07-23","8","741","2","153","36.9","24.2"
"Stewart","2020-07-24","18","759","4","157","39.3","24.7"
"Stewart","2020-07-25","3","762","1","158","29.8","24.7"
"Stewart","2020-07-26","3","765","0","158","20.3","24.7"
"Stewart","2020-07-27","3","768","0","158","14.6","23.7"
"Stewart","2020-07-28","7","775","1","159","16.6","24.7"
"Stewart","2020-07-29","12","787","4","163","18.3","25.8"
"Stewart","2020-07-30","9","796","3","166","19.5","28.2"
"Stewart","2020-07-31","2","798","0","166","16.3","27.8"
"Stewart","2020-08-01","3","801","2","168","21.1","25.4"
"Stewart","2020-08-02","2","803","0","168","21.1","20.7"
"Stewart","2020-08-03","3","806","0","168","21.1","17.8"
"Stewart","2020-08-04","4","810","1","169","22.6","19.6"
"Stewart","2020-08-05","11","821","0","169","17.9","18.1"
"Stewart","2020-08-06","7","828","3","172","19.2","19.4"
"Stewart","2020-08-07","8","836","0","172","19.2","17.8"
"Stewart","2020-08-08","0","836","0","172","9.7","15.4"
"Stewart","2020-08-09","4","840","1","173","13.3","17.2"
"Stewart","2020-08-10","6","846","1","174","15.6","18.4"
"Stewart","2020-08-11","1","847","0","174","12.1","17.3"
"Stewart","2020-08-12","19","866","1","175","12.8","15.3"
"Stewart","2020-08-13","9","875","0","175","6.7","13"
"Stewart","2020-08-14","9","884","1","176","8.3","13.8"
"Stewart","2020-08-15","2","886","1","177","15.4","12.6"
"Stewart","2020-08-16","4","890","0","177","11.9","12.6"
"Stewart","2020-08-17","3","893","0","177","9.5","12.6"
"Stewart","2020-08-18","1","894","0","177","9.5","10.8"
"Stewart","2020-08-19","1","895","0","177","8.7","10.8"
"Stewart","2020-08-20","3","898","1","178","13.5","10.1"
"Stewart","2020-08-21","23","921","0","178","11.9","10.1"
"Stewart","2020-08-22","1","922","0","178","4.8","10.1"
"Stewart","2020-08-23","3","925","0","178","4.8","8.3"
"Stewart","2020-08-24","3","928","0","178","4.8","7.1"
"Stewart","2020-08-25","3","931","0","178","4.8","7.1"
"Stewart","2020-08-26","8","939","0","178","4.8","6.7"
"Stewart","2020-08-27","2","941","0","178","0","6.7"
"Stewart","2020-08-28","7","948","1","179","2","7"
"Stewart","2020-08-29","2","950","0","179","2","3.4"
"Stewart","2020-08-30","2","952","0","179","2","3.4"
"Stewart","2020-08-31","4","956","0","179","2","3.4"
"Stewart","2020-09-01","3","959","1","180","6.8","5.8"
"Stewart","2020-09-02","6","965","0","180","6.8","5.8"
"Stewart","2020-09-03","14","979","0","180","6.8","3.4"
"Stewart","2020-09-04","6","985","0","180","4.8","3.4"
"Stewart","2020-09-05","2","987","0","180","4.8","3.4"
"Stewart","2020-09-06","2","989","0","180","4.8","3.4"
"Stewart","2020-09-07","0","989","0","180","4.8","3.4"
"Stewart","2020-09-08","3","992","0","180","0","3.4"
"Stewart","2020-09-09","9","1001","0","180","0","3.4"
"Stewart","2020-09-10","3","1004","0","180","0","3.4"
"Stewart","2020-09-11","7","1011","1","181","2","3.4"
"Stewart","2020-09-12","6","1017","1","182","4.4","4.6"
"Stewart","2020-09-13","3","1020","0","182","4.4","4.6"
"Stewart","2020-09-14","3","1023","0","182","4.4","4.6"
"Stewart","2020-09-15","1","1024","0","182","4.4","2.2"
"Stewart","2020-09-16","4","1028","0","182","4.4","2.2"
"Stewart","2020-09-17","2","1030","0","182","4.4","2.2"
"Stewart","2020-09-18","7","1037","0","182","2.4","2.2"
"Stewart","2020-09-19","0","1037","0","182","0","2.2"
"Stewart","2020-09-20","2","1039","0","182","0","2.2"
"Stewart","2020-09-21","1","1040","0","182","0","2.2"
"Stewart","2020-09-22","3","1043","0","182","0","2.2"
"Stewart","2020-09-23","8","1051","1","183","1.8","3.1"
"Stewart","2020-09-24","3","1054","0","183","1.8","3.1"
"Stewart","2020-09-25","4","1058","0","183","1.8","2.1"
"Stewart","2020-09-26","3","1061","0","183","1.8","0.9"
"Stewart","2020-09-27","1","1062","1","184","16.1","8"
"Stewart","2020-09-28","6","1068","0","184","16.1","8"
"Stewart","2020-09-29","1","1069","0","184","16.1","8"
"Stewart","2020-09-30","5","1074","0","184","14.3","8"
"Stewart","2020-10-01","3","1077","0","184","14.3","8"
"Stewart","2020-10-02","2","1079","0","184","14.3","8"
"Stewart","2020-10-03","0","1079","0","184","14.3","8"
"Stewart","2020-10-04","3","1082","0","184","0","8"
"Stewart","2020-10-05","3","1085","0","184","0","8"
"Stewart","2020-10-06","1","1086","0","184","0","8"
"Stewart","2020-10-07","9","1095","0","184","0","7.1"
"Stewart","2020-10-08","5","1100","0","184","0","7.1"
"Stewart","2020-10-09","8","1108","0","184","0","7.1"
"Stewart","2020-10-10","2","1110","0","184","0","7.1"
"Stewart","2020-10-11","2","1112","0","184","0","0"
"Stewart","2020-10-12","5","1117","0","184","0","0"
"Stewart","2020-10-13","3","1120","0","184","0","0"
"Stewart","2020-10-14","5","1125","0","184","0","0"
"Stewart","2020-10-15","7","1132","0","184","0","0"
"Stewart","2020-10-16","7","1139","1","185","2","1"
"Stewart","2020-10-17","2","1141","0","185","2","1"
"Stewart","2020-10-18","2","1143","0","185","2","1"
"Stewart","2020-10-19","3","1146","0","185","2","1"
"Stewart","2020-10-20","0","1146","0","185","2","1"
"Stewart","2020-10-21","6","1152","0","185","2","1"
"Stewart","2020-10-22","1","1153","0","185","2","1"
"Stewart","2020-10-23","2","1155","0","185","0","1"
"Stewart","2020-10-24","1","1156","0","185","0","1"
"Stewart","2020-10-25","1","1157","0","185","0","1"
"Stewart","2020-10-26","1","1158","0","185","0","1"
"Stewart","2020-10-27","3","1161","1","186","4.8","3.4"
"Stewart","2020-10-28","11","1172","2","188","7.4","4.7"
"Stewart","2020-10-29","2","1174","0","188","7.4","4.7"
"Stewart","2020-10-30","5","1179","0","188","7.4","3.7"
"Stewart","2020-10-31","2","1181","0","188","7.4","3.7"
"Stewart","2020-11-01","0","1181","0","188","7.4","3.7"
"Stewart","2020-11-02","2","1183","1","189","14.5","7.3"
"Stewart","2020-11-03","0","1183","0","189","9.7","7.3"
"Stewart","2020-11-04","5","1188","0","189","7.1","7.3"
"Stewart","2020-11-05","6","1194","0","189","7.1","7.3"
"Stewart","2020-11-06","4","1198","0","189","7.1","7.3"
"Stewart","2020-11-07","1","1199","0","189","7.1","7.3"
"Stewart","2020-11-08","3","1202","0","189","7.1","7.3"
"Stewart","2020-11-09","1","1203","0","189","0","7.3"
"Stewart","2020-11-10","2","1205","0","189","0","4.9"
"Stewart","2020-11-11","5","1210","0","189","0","3.6"
"Stewart","2020-11-12","1","1211","0","189","0","3.6"
"Stewart","2020-11-13","4","1215","0","189","0","3.6"
"Stewart","2020-11-14","2","1217","1","190","7.1","7.1"
"Stewart","2020-11-15","1","1218","0","190","7.1","7.1"
"Stewart","2020-11-16","3","1221","0","190","7.1","3.6"
"Stewart","2020-11-17","1","1222","0","190","7.1","3.6"
"Stewart","2020-11-18","5","1227","1","191","10","5"
"Stewart","2020-11-19","2","1229","0","191","10","5"
"Stewart","2020-11-20","3","1232","1","192","14.8","7.4"
"Stewart","2020-11-21","3","1235","1","193","12.4","9.8"
"Stewart","2020-11-22","1","1236","0","193","12.4","9.8"
"Stewart","2020-11-23","3","1239","0","193","12.4","9.8"
"Stewart","2020-11-24","0","1239","0","193","12.4","9.8"
"Stewart","2020-11-25","5","1244","0","193","9.5","9.8"
"Stewart","2020-11-26","2","1246","1","194","16.7","13.3"
"Stewart","2020-11-27","2","1248","0","194","11.9","13.3"
"Stewart","2020-11-28","0","1248","0","194","7.1","9.8"
"Stewart","2020-11-29","1","1249","0","194","7.1","9.8"
"Stewart","2020-11-30","6","1255","0","194","7.1","9.8"
"Stewart","2020-12-01","1","1256","0","194","7.1","9.8"
"Stewart","2020-12-02","2","1258","0","194","7.1","8.3"
"Stewart","2020-12-03","1","1259","0","194","0","8.3"
"Stewart","2020-12-04","5","1264","0","194","0","6"
"Stewart","2020-12-05","1","1265","0","194","0","3.6"
"Stewart","2020-12-06","3","1268","0","194","0","3.6"
"Stewart","2020-12-07","5","1273","2","196","5.7","6.4"
"Stewart","2020-12-08","3","1276","0","196","5.7","6.4"
"Stewart","2020-12-09","10","1286","1","197","7.1","7.1"
"Stewart","2020-12-10","8","1294","1","198","8.9","4.5"
"Stewart","2020-12-11","5","1299","0","198","8.9","4.5"
"Stewart","2020-12-12","3","1302","0","198","8.9","4.5"
"Stewart","2020-12-13","1","1303","0","198","8.9","4.5"
"Stewart","2020-12-14","4","1307","0","198","3.2","4.5"
"Stewart","2020-12-15","4","1311","0","198","3.2","4.5"
"Stewart","2020-12-16","31","1342","8","206","5.5","6.3"
"Stewart","2020-12-17","2","1344","0","206","3.7","6.3"
"Stewart","2020-12-18","4","1348","0","206","3.7","6.3"
"Stewart","2020-12-19","1","1349","0","206","3.7","6.3"
"Stewart","2020-12-20","2","1351","1","207","10.8","9.9"
"Stewart","2020-12-21","4","1355","1","208","14.4","8.8"
"Stewart","2020-12-22","6","1361","0","208","14.4","8.8"
"Stewart","2020-12-23","5","1366","0","208","10.7","8.1"
"Stewart","2020-12-24","4","1370","0","208","10.7","7.2"
"Stewart","2020-12-25","1","1371","0","208","10.7","7.2"
"Stewart","2020-12-26","3","1374","2","210","20.2","12"
"Stewart","2020-12-27","1","1375","1","211","27.4","19.1"
"Stewart","2020-12-28","4","1379","0","211","23.8","19.1"
"Stewart","2020-12-29","8","1387","2","213","27.4","20.9"
"Stewart","2020-12-30","15","1402","1","214","28.3","19.5"
"Stewart","2020-12-31","3","1405","1","215","33.1","21.9"
"Stewart","2021-01-01","3","1408","1","216","37.9","24.3"
"Stewart","2021-01-02","1","1409","1","217","42.6","31.4"
"Stewart","2021-01-03","5","1414","0","217","28.3","27.9"
"Stewart","2021-01-04","5","1419","1","218","31.2","27.5"
"Stewart","2021-01-05","13","1432","2","220","29.8","28.6"
"Stewart","2021-01-06","19","1451","2","222","30.4","29.4"
"Stewart","2021-01-07","11","1462","1","223","26.9","30"
"Stewart","2021-01-08","2","1464","1","224","29.3","33.6"
"Stewart","2021-01-09","1","1465","0","224","15","28.8"
"Stewart","2021-01-10","2","1467","1","225","22.1","25.2"
"Stewart","2021-01-11","14","1481","1","226","20.3","25.7"
"Stewart","2021-01-12","6","1487","0","226","18.1","24"
"Stewart","2021-01-13","23","1510","1","227","17.2","23.8"
"Stewart","2021-01-14","5","1515","1","228","18.8","22.8"
"Stewart","2021-01-15","3","1518","0","228","11.6","20.5"
"Stewart","2021-01-16","2","1520","2","230","25.9","20.5"
"Stewart","2021-01-17","2","1522","2","232","33.1","27.6"
"Stewart","2021-01-18","7","1529","1","233","34.1","27.2"
"Stewart","2021-01-19","5","1534","1","234","36.9","27.5"
"Stewart","2021-01-20","26","1560","1","235","36.9","27.1"
"Stewart","2021-01-21","4","1564","0","235","34","26.4"
"Stewart","2021-01-22","4","1568","1","236","37.6","24.6"
"Stewart","2021-01-23","6","1574","1","237","25.7","25.8"
"Stewart","2021-01-24","1","1575","1","238","25.7","29.4"
"Stewart","2021-01-25","2","1577","0","238","23.6","28.9"
"Stewart","2021-01-26","1","1578","0","238","20.8","28.9"
"Stewart","2021-01-27","0","1578","0","238","20.2","28.6"
"Sumter","2020-02-01","0","0","0","0",".","."
"Sumter","2020-02-02","0","0","0","0",".","."
"Sumter","2020-02-03","0","0","0","0",".","."
"Sumter","2020-02-04","0","0","0","0",".","."
"Sumter","2020-02-05","0","0","0","0",".","."
"Sumter","2020-02-06","0","0","0","0",".","."
"Sumter","2020-02-07","0","0","0","0","0","."
"Sumter","2020-02-08","0","0","0","0","0","."
"Sumter","2020-02-09","0","0","0","0","0","."
"Sumter","2020-02-10","0","0","0","0","0","."
"Sumter","2020-02-11","0","0","0","0","0","."
"Sumter","2020-02-12","0","0","0","0","0","."
"Sumter","2020-02-13","0","0","0","0","0","."
"Sumter","2020-02-14","0","0","0","0","0","0"
"Sumter","2020-02-15","0","0","0","0","0","0"
"Sumter","2020-02-16","0","0","0","0","0","0"
"Sumter","2020-02-17","0","0","0","0","0","0"
"Sumter","2020-02-18","0","0","0","0","0","0"
"Sumter","2020-02-19","0","0","0","0","0","0"
"Sumter","2020-02-20","0","0","0","0","0","0"
"Sumter","2020-02-21","0","0","0","0","0","0"
"Sumter","2020-02-22","0","0","0","0","0","0"
"Sumter","2020-02-23","0","0","0","0","0","0"
"Sumter","2020-02-24","0","0","0","0","0","0"
"Sumter","2020-02-25","0","0","0","0","0","0"
"Sumter","2020-02-26","0","0","0","0","0","0"
"Sumter","2020-02-27","0","0","0","0","0","0"
"Sumter","2020-02-28","0","0","0","0","0","0"
"Sumter","2020-02-29","0","0","0","0","0","0"
"Sumter","2020-03-01","0","0","0","0","0","0"
"Sumter","2020-03-02","0","0","0","0","0","0"
"Sumter","2020-03-03","0","0","0","0","0","0"
"Sumter","2020-03-04","0","0","0","0","0","0"
"Sumter","2020-03-05","0","0","0","0","0","0"
"Sumter","2020-03-06","0","0","0","0","0","0"
"Sumter","2020-03-07","0","0","0","0","0","0"
"Sumter","2020-03-08","0","0","0","0","0","0"
"Sumter","2020-03-09","0","0","0","0","0","0"
"Sumter","2020-03-10","0","0","0","0","0","0"
"Sumter","2020-03-11","0","0","0","0","0","0"
"Sumter","2020-03-12","2","2","0","0","0","0"
"Sumter","2020-03-13","8","10","1","1","1.8","0.9"
"Sumter","2020-03-14","5","15","1","2","4.6","2.3"
"Sumter","2020-03-15","4","19","1","3","8.2","4.1"
"Sumter","2020-03-16","8","27","2","5","11.8","5.9"
"Sumter","2020-03-17","4","31","2","7","18.9","9.5"
"Sumter","2020-03-18","8","39","5","12","27.9","13.9"
"Sumter","2020-03-19","10","49","4","16","33.6","16.8"
"Sumter","2020-03-20","14","63","4","20","35.9","18.8"
"Sumter","2020-03-21","8","71","4","24","40.2","22.4"
"Sumter","2020-03-22","6","77","3","27","43.7","26"
"Sumter","2020-03-23","21","98","8","35","45.6","28.7"
"Sumter","2020-03-24","44","142","12","47","42.3","30.6"
"Sumter","2020-03-25","24","166","10","57","39.4","33.6"
"Sumter","2020-03-26","32","198","15","72","40.4","37"
"Sumter","2020-03-27","29","227","10","82","41.2","38.5"
"Sumter","2020-03-28","18","245","9","91","41.2","40.7"
"Sumter","2020-03-29","7","252","4","95","42.2","43"
"Sumter","2020-03-30","37","289","15","110","42.6","44.1"
"Sumter","2020-03-31","12","301","10","120","50.6","46.5"
"Sumter","2020-04-01","49","350","17","137","49.6","44.5"
"Sumter","2020-04-02","49","399","22","159","49.3","44.8"
"Sumter","2020-04-03","30","429","15","174","51.5","46.4"
"Sumter","2020-04-04","32","461","16","190","51.5","46.4"
"Sumter","2020-04-05","9","470","4","194","49.7","46"
"Sumter","2020-04-06","61","531","29","223","50.7","46.6"
"Sumter","2020-04-07","54","585","17","240","43.3","46.9"
"Sumter","2020-04-08","22","607","8","248","43.5","46.6"
"Sumter","2020-04-09","60","667","18","266","41.4","45.4"
"Sumter","2020-04-10","40","707","11","277","38.2","44.9"
"Sumter","2020-04-11","13","720","5","282","36.5","44"
"Sumter","2020-04-12","10","730","5","287","37.3","43.5"
"Sumter","2020-04-13","42","772","10","297","33.9","42.3"
"Sumter","2020-04-14","88","860","19","316","32.5","37.9"
"Sumter","2020-04-15","56","916","9","325","29.6","36.6"
"Sumter","2020-04-16","64","980","20","345","29.8","35.6"
"Sumter","2020-04-17","64","1044","7","352","27.4","32.8"
"Sumter","2020-04-18","17","1061","2","354","23.6","30.1"
"Sumter","2020-04-19","17","1078","1","355","17.3","27.3"
"Sumter","2020-04-20","43","1121","10","365","17.3","25.6"
"Sumter","2020-04-21","53","1174","11","376","17.1","24.8"
"Sumter","2020-04-22","45","1219","7","383","17.1","23.3"
"Sumter","2020-04-23","38","1257","6","389","14.8","22.3"
"Sumter","2020-04-24","54","1311","15","404","17.3","22.4"
"Sumter","2020-04-25","21","1332","3","407","17.6","20.6"
"Sumter","2020-04-26","17","1349","3","410","19.3","18.3"
"Sumter","2020-04-27","87","1436","11","421","17.8","17.5"
"Sumter","2020-04-28","40","1476","7","428","17.3","17.2"
"Sumter","2020-04-29","55","1531","9","437","17.4","17.2"
"Sumter","2020-04-30","20","1551","4","441","18","16.4"
"Sumter","2020-05-01","50","1601","2","443","14.6","15.9"
"Sumter","2020-05-02","23","1624","1","444","13.2","15.4"
"Sumter","2020-05-03","14","1638","2","446","12.7","16"
"Sumter","2020-05-04","79","1717","16","462","13.8","15.8"
"Sumter","2020-05-05","75","1792","4","466","12.1","14.7"
"Sumter","2020-05-06","45","1837","2","468","10.4","13.9"
"Sumter","2020-05-07","17","1854","1","469","8.4","13.2"
"Sumter","2020-05-08","23","1877","1","470","8.4","11.5"
"Sumter","2020-05-09","7","1884","2","472","11.9","12.5"
"Sumter","2020-05-10","14","1898","0","472","9.8","11.3"
"Sumter","2020-05-11","38","1936","7","479","9.6","11.7"
"Sumter","2020-05-12","44","1980","6","485","10.8","11.4"
"Sumter","2020-05-13","93","2073","13","498","12.1","11.3"
"Sumter","2020-05-14","90","2163","10","508","12.9","10.6"
"Sumter","2020-05-15","38","2201","12","520","16.8","12.6"
"Sumter","2020-05-16","6","2207","0","520","12.7","12.3"
"Sumter","2020-05-17","27","2234","2","522","13.7","11.8"
"Sumter","2020-05-18","137","2371","9","531","12","10.8"
"Sumter","2020-05-19","157","2528","7","538","10.7","10.7"
"Sumter","2020-05-20","110","2638","5","543","9.4","10.8"
"Sumter","2020-05-21","96","2734","3","546","8.2","10.6"
"Sumter","2020-05-22","57","2791","4","550","4.7","10.7"
"Sumter","2020-05-23","19","2810","0","550","4.7","8.7"
"Sumter","2020-05-24","30","2840","3","553","5.1","9.4"
"Sumter","2020-05-25","32","2872","1","554","4.6","8.3"
"Sumter","2020-05-26","64","2936","8","562","5.8","8.2"
"Sumter","2020-05-27","116","3052","6","568","5.8","7.6"
"Sumter","2020-05-28","112","3164","1","569","5.5","6.9"
"Sumter","2020-05-29","55","3219","2","571","5","4.9"
"Sumter","2020-05-30","33","3252","0","571","5","4.9"
"Sumter","2020-05-31","29","3281","0","571","3.6","4.4"
"Sumter","2020-06-01","45","3326","0","571","3.2","3.9"
"Sumter","2020-06-02","146","3472","4","575","1.8","3.8"
"Sumter","2020-06-03","63","3535","2","577","1.5","3.7"
"Sumter","2020-06-04","121","3656","3","580","1.7","3.6"
"Sumter","2020-06-05","90","3746","1","581","1.4","3.2"
"Sumter","2020-06-06","35","3781","2","583","2.2","3.6"
"Sumter","2020-06-07","22","3803","1","584","2.8","3.2"
"Sumter","2020-06-08","54","3857","1","585","3.1","3.1"
"Sumter","2020-06-09","104","3961","5","590","3.4","2.6"
"Sumter","2020-06-10","62","4023","6","596","4.3","2.9"
"Sumter","2020-06-11","97","4120","17","613","6.5","4.1"
"Sumter","2020-06-12","51","4171","2","615","6.9","4.1"
"Sumter","2020-06-13","22","4193","1","616","6.7","4.4"
"Sumter","2020-06-14","21","4214","0","616","6","4.4"
"Sumter","2020-06-15","77","4291","7","623","7.1","5.1"
"Sumter","2020-06-16","104","4395","3","626","6.8","5.1"
"Sumter","2020-06-17","57","4452","3","629","6.2","5.2"
"Sumter","2020-06-18","119","4571","3","632","4","5.2"
"Sumter","2020-06-19","64","4635","6","638","4.8","5.8"
"Sumter","2020-06-20","12","4647","0","638","4.2","5.4"
"Sumter","2020-06-21","20","4667","0","638","4.2","5.1"
"Sumter","2020-06-22","100","4767","15","653","5","6"
"Sumter","2020-06-23","87","4854","2","655","4.9","5.9"
"Sumter","2020-06-24","68","4922","6","661","5.4","5.8"
"Sumter","2020-06-25","48","4970","4","665","6.3","5.1"
"Sumter","2020-06-26","54","5024","1","666","5.2","5"
"Sumter","2020-06-27","27","5051","2","668","6.2","5.2"
"Sumter","2020-06-28","26","5077","1","669","6.8","5.5"
"Sumter","2020-06-29","65","5142","7","676","6.2","5.6"
"Sumter","2020-06-30","177","5319","13","689","6.9","5.9"
"Sumter","2020-07-01","75","5394","10","699","7.6","6.5"
"Sumter","2020-07-02","60","5454","6","705","7.8","7"
"Sumter","2020-07-03","36","5490","5","710","9.5","7.3"
"Sumter","2020-07-04","23","5513","3","713","10.3","8.3"
"Sumter","2020-07-05","19","5532","3","716","12","9.4"
"Sumter","2020-07-06","139","5671","8","724","11.3","8.7"
"Sumter","2020-07-07","76","5747","1","725","10.4","8.7"
"Sumter","2020-07-08","114","5861","3","728","8.9","8.2"
"Sumter","2020-07-09","56","5917","4","732","8.5","8.2"
"Sumter","2020-07-10","100","6017","8","740","7.7","8.6"
"Sumter","2020-07-11","34","6051","3","743","7.1","8.7"
"Sumter","2020-07-12","29","6080","0","743","4.8","8.4"
"Sumter","2020-07-13","105","6185","10","753","5.3","8.3"
"Sumter","2020-07-14","71","6256","5","758","6.2","8.3"
"Sumter","2020-07-15","98","6354","7","765","6.8","7.9"
"Sumter","2020-07-16","68","6422","0","765","5.8","7.1"
"Sumter","2020-07-17","64","6486","8","773","6.4","7.1"
"Sumter","2020-07-18","21","6507","3","776","7.2","7.1"
"Sumter","2020-07-19","25","6532","2","778","8.4","6.6"
"Sumter","2020-07-20","60","6592","4","782","7.9","6.6"
"Sumter","2020-07-21","82","6674","10","792","8.7","7.4"
"Sumter","2020-07-22","136","6810","6","798","8.3","7.6"
"Sumter","2020-07-23","75","6885","11","809","10.4","8.1"
"Sumter","2020-07-24","57","6942","5","814","9.9","8.1"
"Sumter","2020-07-25","33","6975","1","815","8.2","7.7"
"Sumter","2020-07-26","19","6994","4","819","10.1","9.2"
"Sumter","2020-07-27","113","7107","10","829","10.4","9.2"
"Sumter","2020-07-28","68","7175","6","835","9.9","9.3"
"Sumter","2020-07-29","65","7240","6","841","10.6","9.5"
"Sumter","2020-07-30","62","7302","14","855","11.8","11.1"
"Sumter","2020-07-31","46","7348","3","858","11.4","10.6"
"Sumter","2020-08-01","40","7388","3","861","12.1","10.2"
"Sumter","2020-08-02","14","7402","2","863","11.1","10.6"
"Sumter","2020-08-03","124","7526","5","868","10.4","10.4"
"Sumter","2020-08-04","45","7571","3","871","10.1","10"
"Sumter","2020-08-05","121","7692","7","878","9.6","10.1"
"Sumter","2020-08-06","104","7796","9","887","7.6","9.7"
"Sumter","2020-08-07","121","7917","7","894","7.5","9.5"
"Sumter","2020-08-08","49","7966","1","895","6.7","9.4"
"Sumter","2020-08-09","51","8017","4","899","5.8","8.5"
"Sumter","2020-08-10","180","8197","7","906","5.8","8.1"
"Sumter","2020-08-11","93","8290","3","909","5.3","7.7"
"Sumter","2020-08-12","103","8393","8","917","5.6","7.6"
"Sumter","2020-08-13","94","8487","4","921","5","6.3"
"Sumter","2020-08-14","137","8624","4","925","4.6","6"
"Sumter","2020-08-15","31","8655","1","926","4.7","5.7"
"Sumter","2020-08-16","44","8699","4","930","4.9","5.4"
"Sumter","2020-08-17","65","8764","3","933","5","5.4"
"Sumter","2020-08-18","162","8926","10","943","5.4","5.4"
"Sumter","2020-08-19","184","9110","8","951","4.9","5.3"
"Sumter","2020-08-20","57","9167","2","953","4.8","4.9"
"Sumter","2020-08-21","113","9280","7","960","5.3","4.9"
"Sumter","2020-08-22","22","9302","4","964","7.4","6.1"
"Sumter","2020-08-23","23","9325","2","966","7.4","6.1"
"Sumter","2020-08-24","94","9419","11","977","8.4","6.7"
"Sumter","2020-08-25","38","9457","5","982","9.4","7.4"
"Sumter","2020-08-26","89","9546","2","984","9.1","7"
"Sumter","2020-08-27","53","9599","3","987","9.4","7.1"
"Sumter","2020-08-28","72","9671","8","995","10.1","7.7"
"Sumter","2020-08-29","18","9689","1","996","8.3","7.9"
"Sumter","2020-08-30","17","9706","2","998","8.7","8.1"
"Sumter","2020-08-31","95","9801","8","1006","8.3","8.3"
"Sumter","2020-09-01","40","9841","3","1009","7.5","8.4"
"Sumter","2020-09-02","72","9913","4","1013","7.9","8.5"
"Sumter","2020-09-03","62","9975","3","1016","7.8","8.6"
"Sumter","2020-09-04","108","10083","11","1027","7.7","8.9"
"Sumter","2020-09-05","137","10220","0","1027","6.9","7.6"
"Sumter","2020-09-06","69","10289","3","1030","5.8","7.3"
"Sumter","2020-09-07","16","10305","0","1030","4.6","6.5"
"Sumter","2020-09-08","129","10434","11","1041","4.8","6.1"
"Sumter","2020-09-09","105","10539","5","1046","4.7","6.3"
"Sumter","2020-09-10","70","10609","2","1048","4.4","6.1"
"Sumter","2020-09-11","84","10693","4","1052","3.6","5.6"
"Sumter","2020-09-12","60","10753","0","1052","3.6","5.3"
"Sumter","2020-09-13","32","10785","1","1053","3.4","4.6"
"Sumter","2020-09-14","111","10896","7","1060","4.3","4.5"
"Sumter","2020-09-15","51","10947","0","1060","3.1","3.9"
"Sumter","2020-09-16","91","11038","1","1061","2.6","3.6"
"Sumter","2020-09-17","123","11161","4","1065","2.6","3.5"
"Sumter","2020-09-18","189","11350","4","1069","2.3","2.9"
"Sumter","2020-09-19","49","11399","0","1069","2.3","2.9"
"Sumter","2020-09-20","18","11417","0","1069","1.8","2.6"
"Sumter","2020-09-21","61","11478","2","1071","1.4","2.9"
"Sumter","2020-09-22","38","11516","1","1072","1.8","2.4"
"Sumter","2020-09-23","53","11569","2","1074","2.2","2.4"
"Sumter","2020-09-24","57","11626","2","1076","2.2","2.4"
"Sumter","2020-09-25","99","11725","2","1078","2.2","2.2"
"Sumter","2020-09-26","27","11752","0","1078","2.2","2.2"
"Sumter","2020-09-27","16","11768","2","1080","4","2.9"
"Sumter","2020-09-28","58","11826","3","1083","4.2","2.8"
"Sumter","2020-09-29","37","11863","1","1084","4.2","3"
"Sumter","2020-09-30","66","11929","1","1085","3.9","3"
"Sumter","2020-10-01","48","11977","1","1086","3.7","3"
"Sumter","2020-10-02","50","12027","1","1087","3.7","2.9"
"Sumter","2020-10-03","22","12049","0","1087","3.7","2.9"
"Sumter","2020-10-04","27","12076","1","1088","2.5","3.2"
"Sumter","2020-10-05","66","12142","0","1088","1.7","3"
"Sumter","2020-10-06","28","12170","1","1089","1.8","3"
"Sumter","2020-10-07","279","12449","3","1092","1.8","2.8"
"Sumter","2020-10-08","44","12493","3","1095","2.5","3.1"
"Sumter","2020-10-09","94","12587","2","1097","2.5","3.1"
"Sumter","2020-10-10","51","12638","2","1099","3","3.4"
"Sumter","2020-10-11","45","12683","1","1100","2.8","2.6"
"Sumter","2020-10-12","83","12766","1","1101","3","2.4"
"Sumter","2020-10-13","83","12849","1","1102","2.7","2.2"
"Sumter","2020-10-14","111","12960","0","1102","2.5","2.1"
"Sumter","2020-10-15","99","13059","3","1105","2","2.2"
"Sumter","2020-10-16","148","13207","3","1108","1.9","2.2"
"Sumter","2020-10-17","53","13260","1","1109","1.7","2.3"
"Sumter","2020-10-18","16","13276","3","1112","4","3.4"
"Sumter","2020-10-19","50","13326","0","1112","3.8","3.4"
"Sumter","2020-10-20","42","13368","0","1112","3.7","3.2"
"Sumter","2020-10-21","62","13430","0","1112","3.7","3.1"
"Sumter","2020-10-22","41","13471","1","1113","3.6","2.8"
"Sumter","2020-10-23","40","13511","2","1115","4","3"
"Sumter","2020-10-24","20","13531","0","1115","3.7","2.7"
"Sumter","2020-10-25","16","13547","0","1115","1.1","2.5"
"Sumter","2020-10-26","63","13610","2","1117","1.5","2.7"
"Sumter","2020-10-27","40","13650","2","1119","2.2","3"
"Sumter","2020-10-28","69","13719","3","1122","2.9","3.3"
"Sumter","2020-10-29","36","13755","2","1124","3.3","3.4"
"Sumter","2020-10-30","38","13793","3","1127","3.7","3.9"
"Sumter","2020-10-31","27","13820","0","1127","3.7","3.7"
"Sumter","2020-11-01","20","13840","0","1127","3.7","2.4"
"Sumter","2020-11-02","81","13921","2","1129","3.6","2.6"
"Sumter","2020-11-03","33","13954","2","1131","3.8","3"
"Sumter","2020-11-04","60","14014","0","1131","3.1","3"
"Sumter","2020-11-05","43","14057","0","1131","2.3","2.8"
"Sumter","2020-11-06","44","14101","1","1132","1.5","2.6"
"Sumter","2020-11-07","20","14121","0","1132","1.5","2.6"
"Sumter","2020-11-08","17","14138","1","1133","2.4","3"
"Sumter","2020-11-09","84","14222","4","1137","2.7","3.2"
"Sumter","2020-11-10","53","14275","2","1139","2.4","3.1"
"Sumter","2020-11-11","92","14367","2","1141","2.7","2.9"
"Sumter","2020-11-12","71","14438","4","1145","3.5","2.9"
"Sumter","2020-11-13","122","14560","0","1145","3.2","2.4"
"Sumter","2020-11-14","76","14636","0","1145","3.2","2.4"
"Sumter","2020-11-15","72","14708","5","1150","3.3","2.9"
"Sumter","2020-11-16","88","14796","4","1154","3.3","3"
"Sumter","2020-11-17","98","14894","1","1155","2.9","2.6"
"Sumter","2020-11-18","213","15107","5","1160","2.9","2.8"
"Sumter","2020-11-19","63","15170","5","1165","3.3","3.4"
"Sumter","2020-11-20","31","15201","1","1166","3.7","3.4"
"Sumter","2020-11-21","18","15219","0","1166","3.7","3.4"
"Sumter","2020-11-22","15","15234","4","1170","6.5","4.9"
"Sumter","2020-11-23","120","15354","10","1180","7.1","5.2"
"Sumter","2020-11-24","78","15432","4","1184","7.7","5.3"
"Sumter","2020-11-25","110","15542","11","1195","8.8","5.8"
"Sumter","2020-11-26","127","15669","2","1197","7.8","5.6"
"Sumter","2020-11-27","44","15713","4","1201","8.7","6.2"
"Sumter","2020-11-28","29","15742","1","1202","9.2","6.4"
"Sumter","2020-11-29","20","15762","2","1204","6.8","6.7"
"Sumter","2020-11-30","165","15927","13","1217","6.7","6.9"
"Sumter","2020-12-01","69","15996","6","1223","7.2","7.5"
"Sumter","2020-12-02","195","16191","10","1233","6.5","7.7"
"Sumter","2020-12-03","81","16272","6","1239","7.4","7.6"
"Sumter","2020-12-04","107","16379","11","1250","7.5","8.1"
"Sumter","2020-12-05","118","16497","7","1257","7.9","8.5"
"Sumter","2020-12-06","57","16554","2","1259","7","6.9"
"Sumter","2020-12-07","158","16712","14","1273","7.1","6.9"
"Sumter","2020-12-08","114","16826","11","1284","7.3","7.2"
"Sumter","2020-12-09","177","17003","19","1303","8.1","7.3"
"Sumter","2020-12-10","126","17129","4","1307","7.4","7.4"
"Sumter","2020-12-11","277","17406","14","1321","6.7","7.1"
"Sumter","2020-12-12","28","17434","4","1325","7.9","7.9"
"Sumter","2020-12-13","26","17460","4","1329","9.6","8.3"
"Sumter","2020-12-14","173","17633","28","1357","10.6","8.9"
"Sumter","2020-12-15","83","17716","6","1363","10.3","8.8"
"Sumter","2020-12-16","263","17979","15","1378","9.6","8.8"
"Sumter","2020-12-17","207","18186","13","1391","10","8.7"
"Sumter","2020-12-18","85","18271","5","1396","10.1","8.4"
"Sumter","2020-12-19","74","18345","9","1405","9.8","8.9"
"Sumter","2020-12-20","75","18420","5","1410","8.6","9.1"
"Sumter","2020-12-21","159","18579","18","1428","7.9","9.3"
"Sumter","2020-12-22","116","18695","14","1442","8.6","9.4"
"Sumter","2020-12-23","463","19158","23","1465","8.5","9"
"Sumter","2020-12-24","201","19359","10","1475","8.3","9.2"
"Sumter","2020-12-25","10","19369","0","1475","7.5","8.8"
"Sumter","2020-12-26","29","19398","4","1479","7.7","8.8"
"Sumter","2020-12-27","24","19422","7","1486","10.9","9.7"
"Sumter","2020-12-28","146","19568","18","1504","11","9.5"
"Sumter","2020-12-29","98","19666","13","1517","11.2","9.9"
"Sumter","2020-12-30","466","20132","22","1539","11.2","9.8"
"Sumter","2020-12-31","248","20380","14","1553","11.3","9.8"
"Sumter","2021-01-01","21","20401","2","1555","12.6","10"
"Sumter","2021-01-02","12","20413","4","1559","15.4","11.6"
"Sumter","2021-01-03","39","20452","10","1569","14.9","12.9"
"Sumter","2021-01-04","245","20697","43","1612","15.7","13.4"
"Sumter","2021-01-05","129","20826","14","1626","15.3","13.3"
"Sumter","2021-01-06","482","21308","26","1652","15.4","13.3"
"Sumter","2021-01-07","254","21562","12","1664","15.3","13.3"
"Sumter","2021-01-08","51","21613","10","1674","16.7","14.7"
"Sumter","2021-01-09","40","21653","7","1681","14.5","14.9"
"Sumter","2021-01-10","40","21693","4","1685","12.2","13.6"
"Sumter","2021-01-11","147","21840","31","1716","12.7","14.2"
"Sumter","2021-01-12","118","21958","14","1730","12.9","14.1"
"Sumter","2021-01-13","442","22400","27","1757","13","14.2"
"Sumter","2021-01-14","204","22604","19","1776","13.6","14.5"
"Sumter","2021-01-15","150","22754","18","1794","12.6","14.6"
"Sumter","2021-01-16","62","22816","8","1802","11.9","13.2"
"Sumter","2021-01-17","24","22840","2","1804","11.7","11.9"
"Sumter","2021-01-18","69","22909","10","1814","10.7","11.7"
"Sumter","2021-01-19","92","23001","9","1823","10.4","11.7"
"Sumter","2021-01-20","323","23324","12","1835","10.1","11.5"
"Sumter","2021-01-21","150","23474","12","1847","9.9","11.8"
"Sumter","2021-01-22","259","23733","11","1858","8.8","10.7"
"Sumter","2021-01-23","56","23789","3","1861","7.7","9.8"
"Sumter","2021-01-24","11","23800","1","1862","7.8","9.7"
"Sumter","2021-01-25","39","23839","4","1866","7.2","9"
"Sumter","2021-01-26","18","23857","3","1869","8.2","9.3"
"Sumter","2021-01-27","0","23857","0","1869","7.7","8.9"
"Talbot","2020-02-01","0","0","0","0",".","."
"Talbot","2020-02-02","0","0","0","0",".","."
"Talbot","2020-02-03","0","0","0","0",".","."
"Talbot","2020-02-04","0","0","0","0",".","."
"Talbot","2020-02-05","0","0","0","0",".","."
"Talbot","2020-02-06","0","0","0","0",".","."
"Talbot","2020-02-07","0","0","0","0","0","."
"Talbot","2020-02-08","0","0","0","0","0","."
"Talbot","2020-02-09","0","0","0","0","0","."
"Talbot","2020-02-10","0","0","0","0","0","."
"Talbot","2020-02-11","0","0","0","0","0","."
"Talbot","2020-02-12","0","0","0","0","0","."
"Talbot","2020-02-13","0","0","0","0","0","."
"Talbot","2020-02-14","0","0","0","0","0","0"
"Talbot","2020-02-15","0","0","0","0","0","0"
"Talbot","2020-02-16","0","0","0","0","0","0"
"Talbot","2020-02-17","0","0","0","0","0","0"
"Talbot","2020-02-18","0","0","0","0","0","0"
"Talbot","2020-02-19","0","0","0","0","0","0"
"Talbot","2020-02-20","0","0","0","0","0","0"
"Talbot","2020-02-21","0","0","0","0","0","0"
"Talbot","2020-02-22","0","0","0","0","0","0"
"Talbot","2020-02-23","0","0","0","0","0","0"
"Talbot","2020-02-24","0","0","0","0","0","0"
"Talbot","2020-02-25","0","0","0","0","0","0"
"Talbot","2020-02-26","0","0","0","0","0","0"
"Talbot","2020-02-27","0","0","0","0","0","0"
"Talbot","2020-02-28","0","0","0","0","0","0"
"Talbot","2020-02-29","0","0","0","0","0","0"
"Talbot","2020-03-01","0","0","0","0","0","0"
"Talbot","2020-03-02","0","0","0","0","0","0"
"Talbot","2020-03-03","0","0","0","0","0","0"
"Talbot","2020-03-04","0","0","0","0","0","0"
"Talbot","2020-03-05","0","0","0","0","0","0"
"Talbot","2020-03-06","0","0","0","0","0","0"
"Talbot","2020-03-07","0","0","0","0","0","0"
"Talbot","2020-03-08","0","0","0","0","0","0"
"Talbot","2020-03-09","0","0","0","0","0","0"
"Talbot","2020-03-10","0","0","0","0","0","0"
"Talbot","2020-03-11","0","0","0","0","0","0"
"Talbot","2020-03-12","0","0","0","0","0","0"
"Talbot","2020-03-13","0","0","0","0","0","0"
"Talbot","2020-03-14","0","0","0","0","0","0"
"Talbot","2020-03-15","0","0","0","0","0","0"
"Talbot","2020-03-16","0","0","0","0","0","0"
"Talbot","2020-03-17","1","1","0","0","0","0"
"Talbot","2020-03-18","0","1","0","0","0","0"
"Talbot","2020-03-19","0","1","0","0","0","0"
"Talbot","2020-03-20","1","2","0","0","0","0"
"Talbot","2020-03-21","1","3","0","0","0","0"
"Talbot","2020-03-22","0","3","0","0","0","0"
"Talbot","2020-03-23","1","4","0","0","0","0"
"Talbot","2020-03-24","0","4","0","0","0","0"
"Talbot","2020-03-25","2","6","1","1","7.1","3.6"
"Talbot","2020-03-26","3","9","2","3","16.7","8.3"
"Talbot","2020-03-27","2","11","0","3","16.7","8.3"
"Talbot","2020-03-28","7","18","2","5","20.7","10.4"
"Talbot","2020-03-29","0","18","0","5","20.7","10.4"
"Talbot","2020-03-30","1","19","1","6","35","17.5"
"Talbot","2020-03-31","1","20","1","7","49.3","24.7"
"Talbot","2020-04-01","0","20","0","7","42.2","24.7"
"Talbot","2020-04-02","0","20","0","7","32.7","24.7"
"Talbot","2020-04-03","4","24","2","9","39.8","28.2"
"Talbot","2020-04-04","0","24","0","9","35.7","28.2"
"Talbot","2020-04-05","0","24","0","9","35.7","28.2"
"Talbot","2020-04-06","0","24","0","9","21.4","28.2"
"Talbot","2020-04-07","0","24","0","9","7.1","28.2"
"Talbot","2020-04-08","2","26","2","11","21.4","31.8"
"Talbot","2020-04-09","1","27","0","11","21.4","27"
"Talbot","2020-04-10","1","28","0","11","14.3","27"
"Talbot","2020-04-11","0","28","0","11","14.3","25"
"Talbot","2020-04-12","0","28","0","11","14.3","25"
"Talbot","2020-04-13","2","30","0","11","14.3","17.9"
"Talbot","2020-04-14","2","32","1","12","21.4","14.3"
"Talbot","2020-04-15","4","36","2","14","14.3","17.9"
"Talbot","2020-04-16","5","41","3","17","22.9","22.1"
"Talbot","2020-04-17","3","44","0","17","22.9","18.6"
"Talbot","2020-04-18","1","45","0","17","22.9","18.6"
"Talbot","2020-04-19","0","45","0","17","22.9","18.6"
"Talbot","2020-04-20","7","52","1","18","24.9","19.6"
"Talbot","2020-04-21","5","57","0","18","17.8","19.6"
"Talbot","2020-04-22","1","58","0","18","10.6","12.4"
"Talbot","2020-04-23","4","62","0","18","2","12.4"
"Talbot","2020-04-24","3","65","1","19","6.8","14.8"
"Talbot","2020-04-25","0","65","0","19","6.8","14.8"
"Talbot","2020-04-26","3","68","0","19","6.8","14.8"
"Talbot","2020-04-27","1","69","0","19","4.8","14.8"
"Talbot","2020-04-28","8","77","2","21","8.3","13"
"Talbot","2020-04-29","4","81","0","21","8.3","9.5"
"Talbot","2020-04-30","4","85","0","21","8.3","5.2"
"Talbot","2020-05-01","0","85","0","21","3.6","5.2"
"Talbot","2020-05-02","1","86","0","21","3.6","5.2"
"Talbot","2020-05-03","1","87","0","21","3.6","5.2"
"Talbot","2020-05-04","5","92","0","21","3.6","4.2"
"Talbot","2020-05-05","6","98","0","21","0","4.2"
"Talbot","2020-05-06","6","104","0","21","0","4.2"
"Talbot","2020-05-07","4","108","0","21","0","4.2"
"Talbot","2020-05-08","3","111","1","22","4.8","4.2"
"Talbot","2020-05-09","1","112","0","22","4.8","4.2"
"Talbot","2020-05-10","1","113","0","22","4.8","4.2"
"Talbot","2020-05-11","11","124","0","22","4.8","4.2"
"Talbot","2020-05-12","1","125","0","22","4.8","2.4"
"Talbot","2020-05-13","2","127","1","23","11.9","6"
"Talbot","2020-05-14","7","134","1","24","13.9","7"
"Talbot","2020-05-15","20","154","1","25","9.9","7.3"
"Talbot","2020-05-16","1","155","0","25","9.9","7.3"
"Talbot","2020-05-17","3","158","0","25","9.9","7.3"
"Talbot","2020-05-18","5","163","1","26","12.8","8.8"
"Talbot","2020-05-19","7","170","0","26","12.8","8.8"
"Talbot","2020-05-20","6","176","0","26","5.6","8.8"
"Talbot","2020-05-21","3","179","1","27","8.3","11.1"
"Talbot","2020-05-22","4","183","0","27","7.6","8.8"
"Talbot","2020-05-23","9","192","1","28","9.2","9.6"
"Talbot","2020-05-24","1","193","0","28","9.2","9.6"
"Talbot","2020-05-25","3","196","0","28","6.3","9.6"
"Talbot","2020-05-26","6","202","1","29","8.7","10.7"
"Talbot","2020-05-27","7","209","0","29","8.7","7.2"
"Talbot","2020-05-28","4","213","0","29","4","6.2"
"Talbot","2020-05-29","15","228","0","29","4","5.8"
"Talbot","2020-05-30","3","231","0","29","2.4","5.8"
"Talbot","2020-05-31","0","231","0","29","2.4","5.8"
"Talbot","2020-06-01","13","244","0","29","2.4","4.4"
"Talbot","2020-06-02","7","251","1","30","2","5.4"
"Talbot","2020-06-03","13","264","0","30","2","5.4"
"Talbot","2020-06-04","5","269","0","30","2","3"
"Talbot","2020-06-05","5","274","0","30","2","3"
"Talbot","2020-06-06","1","275","0","30","2","2.2"
"Talbot","2020-06-07","0","275","0","30","2","2.2"
"Talbot","2020-06-08","9","284","1","31","3.6","3"
"Talbot","2020-06-09","1","285","0","31","1.6","1.8"
"Talbot","2020-06-10","17","302","0","31","1.6","1.8"
"Talbot","2020-06-11","6","308","1","32","4","3"
"Talbot","2020-06-12","16","324","1","33","4.9","3.5"
"Talbot","2020-06-13","137","461","5","38","5.4","3.7"
"Talbot","2020-06-14","7","468","3","41","11.5","6.8"
"Talbot","2020-06-15","21","489","1","42","10.6","7.1"
"Talbot","2020-06-16","8","497","0","42","10.6","6.1"
"Talbot","2020-06-17","45","542","3","45","11.6","6.6"
"Talbot","2020-06-18","11","553","2","47","11.8","7.9"
"Talbot","2020-06-19","58","611","2","49","11.4","8.1"
"Talbot","2020-06-20","0","611","0","49","10.8","8.1"
"Talbot","2020-06-21","4","615","0","49","4.7","8.1"
"Talbot","2020-06-22","28","643","2","51","5.1","7.8"
"Talbot","2020-06-23","22","665","3","54","7","8.8"
"Talbot","2020-06-24","45","710","5","59","7.6","9.6"
"Talbot","2020-06-25","6","716","0","59","5","8.4"
"Talbot","2020-06-26","28","744","2","61","5.6","8.5"
"Talbot","2020-06-27","2","746","0","61","5.6","8.2"
"Talbot","2020-06-28","1","747","0","61","5.6","5.1"
"Talbot","2020-06-29","28","775","2","63","5.6","5.3"
"Talbot","2020-06-30","5","780","0","63","3.6","5.3"
"Talbot","2020-07-01","56","836","8","71","4.1","5.9"
"Talbot","2020-07-02","5","841","0","71","4.1","4.6"
"Talbot","2020-07-03","4","845","2","73","10.2","7.9"
"Talbot","2020-07-04","3","848","0","73","10.2","7.9"
"Talbot","2020-07-05","2","850","0","73","10.2","7.9"
"Talbot","2020-07-06","37","887","6","79","11.5","8.5"
"Talbot","2020-07-07","12","899","1","80","12.7","8.2"
"Talbot","2020-07-08","49","948","2","82","11.2","7.7"
"Talbot","2020-07-09","4","952","1","83","14.8","9.4"
"Talbot","2020-07-10","76","1028","0","83","7.7","8.9"
"Talbot","2020-07-11","3","1031","0","83","7.7","8.9"
"Talbot","2020-07-12","1","1032","0","83","7.7","8.9"
"Talbot","2020-07-13","26","1058","3","86","7","9.2"
"Talbot","2020-07-14","3","1061","0","86","5.8","9.2"
"Talbot","2020-07-15","27","1088","1","87","5.7","8.5"
"Talbot","2020-07-16","2","1090","0","87","2.2","8.5"
"Talbot","2020-07-17","81","1171","6","93","3.2","5.4"
"Talbot","2020-07-18","2","1173","1","94","10.4","9"
"Talbot","2020-07-19","3","1176","0","94","10.4","9"
"Talbot","2020-07-20","27","1203","2","96","9.8","8.4"
"Talbot","2020-07-21","5","1208","3","99","18.4","12.1"
"Talbot","2020-07-22","35","1243","1","100","18.2","12"
"Talbot","2020-07-23","5","1248","0","100","18.2","10.2"
"Talbot","2020-07-24","64","1312","3","103","17.9","10.5"
"Talbot","2020-07-25","3","1315","0","103","10.7","10.5"
"Talbot","2020-07-26","0","1315","0","103","10.7","10.5"
"Talbot","2020-07-27","27","1342","2","105","10.7","10.2"
"Talbot","2020-07-28","5","1347","0","105","2.1","10.2"
"Talbot","2020-07-29","32","1379","4","109","3.5","10.9"
"Talbot","2020-07-30","6","1385","1","110","5.9","12.1"
"Talbot","2020-07-31","43","1428","3","113","6.2","12"
"Talbot","2020-08-01","9","1437","1","114","7.8","9.3"
"Talbot","2020-08-02","1","1438","0","114","7.8","9.3"
"Talbot","2020-08-03","27","1465","2","116","7.8","9.3"
"Talbot","2020-08-04","5","1470","2","118","13.5","7.8"
"Talbot","2020-08-05","32","1502","2","120","12.6","8.1"
"Talbot","2020-08-06","6","1508","1","121","12.6","9.3"
"Talbot","2020-08-07","31","1539","3","124","13","9.6"
"Talbot","2020-08-08","4","1543","1","125","15","11.4"
"Talbot","2020-08-09","5","1548","1","126","17.9","12.8"
"Talbot","2020-08-10","21","1569","3","129","18.8","13.3"
"Talbot","2020-08-11","2","1571","0","129","13.1","13.3"
"Talbot","2020-08-12","19","1590","2","131","13.7","13.2"
"Talbot","2020-08-13","5","1595","1","132","14.2","13.4"
"Talbot","2020-08-14","51","1646","5","137","14.2","13.6"
"Talbot","2020-08-15","4","1650","0","137","10.7","12.8"
"Talbot","2020-08-16","1","1651","1","138","22.1","20"
"Talbot","2020-08-17","5","1656","0","138","20","19.4"
"Talbot","2020-08-18","7","1663","1","139","22.1","17.6"
"Talbot","2020-08-19","20","1683","0","139","20.6","17.2"
"Talbot","2020-08-20","4","1687","0","139","17.7","16"
"Talbot","2020-08-21","49","1736","1","140","16.6","15.4"
"Talbot","2020-08-22","46","1782","2","142","17.2","13.9"
"Talbot","2020-08-23","4","1786","1","143","6.5","14.3"
"Talbot","2020-08-24","46","1832","0","143","6.5","13.3"
"Talbot","2020-08-25","22","1854","0","143","4.5","13.3"
"Talbot","2020-08-26","22","1876","1","144","5.1","12.9"
"Talbot","2020-08-27","4","1880","0","144","5.1","11.4"
"Talbot","2020-08-28","41","1921","2","146","5.5","11.1"
"Talbot","2020-08-29","1","1922","0","146","4.9","11.1"
"Talbot","2020-08-30","1","1923","0","146","1.3","3.9"
"Talbot","2020-08-31","12","1935","0","146","1.3","3.9"
"Talbot","2020-09-01","5","1940","0","146","1.3","2.9"
"Talbot","2020-09-02","4","1944","0","146","0.7","2.9"
"Talbot","2020-09-03","13","1957","0","146","0.7","2.9"
"Talbot","2020-09-04","39","1996","3","149","1.1","3.3"
"Talbot","2020-09-05","5","2001","0","149","1.1","3"
"Talbot","2020-09-06","0","2001","0","149","1.1","1.2"
"Talbot","2020-09-07","2","2003","0","149","1.1","1.2"
"Talbot","2020-09-08","4","2007","0","149","1.1","1.2"
"Talbot","2020-09-09","12","2019","0","149","1.1","0.9"
"Talbot","2020-09-10","5","2024","0","149","1.1","0.9"
"Talbot","2020-09-11","25","2049","0","149","0","0.5"
"Talbot","2020-09-12","3","2052","1","150","4.8","2.9"
"Talbot","2020-09-13","1","2053","0","150","4.8","2.9"
"Talbot","2020-09-14","5","2058","0","150","4.8","2.9"
"Talbot","2020-09-15","4","2062","1","151","8.3","4.7"
"Talbot","2020-09-16","16","2078","0","151","8.3","4.7"
"Talbot","2020-09-17","7","2085","1","152","10.4","5.7"
"Talbot","2020-09-18","34","2119","0","152","10.4","5.2"
"Talbot","2020-09-19","5","2124","0","152","5.6","5.2"
"Talbot","2020-09-20","0","2124","0","152","5.6","5.2"
"Talbot","2020-09-21","9","2133","1","153","7.2","6"
"Talbot","2020-09-22","7","2140","1","154","5.7","7"
"Talbot","2020-09-23","6","2146","0","154","5.7","7"
"Talbot","2020-09-24","5","2151","0","154","3.6","7"
"Talbot","2020-09-25","24","2175","1","155","4.2","7.3"
"Talbot","2020-09-26","2","2177","0","155","4.2","4.9"
"Talbot","2020-09-27","1","2178","1","156","18.5","12.1"
"Talbot","2020-09-28","13","2191","0","156","16.9","12.1"
"Talbot","2020-09-29","1","2192","0","156","14.9","10.3"
"Talbot","2020-09-30","3","2195","0","156","14.9","10.3"
"Talbot","2020-10-01","5","2200","0","156","14.9","9.3"
"Talbot","2020-10-02","42","2242","1","157","14.6","9.4"
"Talbot","2020-10-03","2","2244","0","157","14.6","9.4"
"Talbot","2020-10-04","2","2246","0","157","0.3","9.4"
"Talbot","2020-10-05","9","2255","0","157","0.3","8.6"
"Talbot","2020-10-06","4","2259","0","157","0.3","7.6"
"Talbot","2020-10-07","10","2269","0","157","0.3","7.6"
"Talbot","2020-10-08","4","2273","0","157","0.3","7.6"
"Talbot","2020-10-09","36","2309","0","157","0","7.3"
"Talbot","2020-10-10","2","2311","0","157","0","7.3"
"Talbot","2020-10-11","1","2312","0","157","0","0.2"
"Talbot","2020-10-12","2","2314","0","157","0","0.2"
"Talbot","2020-10-13","3","2317","0","157","0","0.2"
"Talbot","2020-10-14","16","2333","0","157","0","0.2"
"Talbot","2020-10-15","4","2337","1","158","3.6","2"
"Talbot","2020-10-16","28","2365","0","158","3.6","1.8"
"Talbot","2020-10-17","1","2366","0","158","3.6","1.8"
"Talbot","2020-10-18","2","2368","0","158","3.6","1.8"
"Talbot","2020-10-19","9","2377","1","159","5.2","2.6"
"Talbot","2020-10-20","4","2381","0","159","5.2","2.6"
"Talbot","2020-10-21","17","2398","4","163","8.5","4.3"
"Talbot","2020-10-22","4","2402","1","164","8.5","6"
"Talbot","2020-10-23","31","2433","1","165","9","6.3"
"Talbot","2020-10-24","1","2434","0","165","9","6.3"
"Talbot","2020-10-25","0","2434","0","165","9","6.3"
"Talbot","2020-10-26","13","2447","1","166","8.5","6.8"
"Talbot","2020-10-27","8","2455","1","167","10.3","7.7"
"Talbot","2020-10-28","9","2464","0","167","6.9","7.7"
"Talbot","2020-10-29","7","2471","1","168","5.4","7"
"Talbot","2020-10-30","30","2501","1","169","5.4","7.2"
"Talbot","2020-10-31","14","2515","0","169","5.4","7.2"
"Talbot","2020-11-01","4","2519","0","169","5.4","7.2"
"Talbot","2020-11-02","31","2550","2","171","5.2","6.9"
"Talbot","2020-11-03","4","2554","0","171","3.4","6.9"
"Talbot","2020-11-04","19","2573","0","171","3.4","5.2"
"Talbot","2020-11-05","7","2580","0","171","1.4","3.4"
"Talbot","2020-11-06","23","2603","3","174","2.8","4.1"
"Talbot","2020-11-07","3","2606","0","174","2.8","4.1"
"Talbot","2020-11-08","3","2609","0","174","2.8","4.1"
"Talbot","2020-11-09","11","2620","0","174","1.9","3.5"
"Talbot","2020-11-10","7","2627","0","174","1.9","2.7"
"Talbot","2020-11-11","10","2637","1","175","3.3","3.4"
"Talbot","2020-11-12","3","2640","0","175","3.3","2.3"
"Talbot","2020-11-13","42","2682","0","175","1.4","2.1"
"Talbot","2020-11-14","5","2687","0","175","1.4","2.1"
"Talbot","2020-11-15","2","2689","0","175","1.4","2.1"
"Talbot","2020-11-16","12","2701","0","175","1.4","1.6"
"Talbot","2020-11-17","8","2709","0","175","1.4","1.6"
"Talbot","2020-11-18","6","2715","0","175","0","1.6"
"Talbot","2020-11-19","5","2720","0","175","0","1.6"
"Talbot","2020-11-20","1","2721","0","175","0","0.7"
"Talbot","2020-11-21","3","2724","0","175","0","0.7"
"Talbot","2020-11-22","0","2724","0","175","0","0.7"
"Talbot","2020-11-23","14","2738","0","175","0","0.7"
"Talbot","2020-11-24","5","2743","0","175","0","0.7"
"Talbot","2020-11-25","14","2757","0","175","0","0"
"Talbot","2020-11-26","1","2758","0","175","0","0"
"Talbot","2020-11-27","0","2758","0","175","0","0"
"Talbot","2020-11-28","1","2759","0","175","0","0"
"Talbot","2020-11-29","4","2763","0","175","0","0"
"Talbot","2020-11-30","13","2776","3","178","3.3","1.6"
"Talbot","2020-12-01","9","2785","2","180","6.5","3.2"
"Talbot","2020-12-02","7","2792","1","181","8.5","4.3"
"Talbot","2020-12-03","7","2799","2","183","12.6","6.3"
"Talbot","2020-12-04","58","2857","2","185","13.1","6.5"
"Talbot","2020-12-05","4","2861","1","186","16.7","8.3"
"Talbot","2020-12-06","1","2862","0","186","16.7","8.3"
"Talbot","2020-12-07","22","2884","1","187","14","8.7"
"Talbot","2020-12-08","8","2892","0","187","10.8","8.7"
"Talbot","2020-12-09","5","2897","0","187","8.8","8.7"
"Talbot","2020-12-10","9","2906","0","187","4.7","8.7"
"Talbot","2020-12-11","2","2908","0","187","4.2","8.7"
"Talbot","2020-12-12","3","2911","0","187","0.6","8.7"
"Talbot","2020-12-13","5","2916","1","188","3.5","10.1"
"Talbot","2020-12-14","18","2934","1","189","3.7","8.8"
"Talbot","2020-12-15","9","2943","3","192","8.4","9.6"
"Talbot","2020-12-16","7","2950","0","192","8.4","8.6"
"Talbot","2020-12-17","4","2954","0","192","8.4","6.6"
"Talbot","2020-12-18","70","3024","11","203","10.7","7.4"
"Talbot","2020-12-19","4","3028","2","205","17.8","9.2"
"Talbot","2020-12-20","5","3033","1","206","17.8","10.7"
"Talbot","2020-12-21","32","3065","4","210","18.8","11.2"
"Talbot","2020-12-22","15","3080","1","211","15","11.7"
"Talbot","2020-12-23","7","3087","1","212","17","12.7"
"Talbot","2020-12-24","3","3090","1","213","21.8","15.1"
"Talbot","2020-12-25","2","3092","0","213","19.5","15.1"
"Talbot","2020-12-26","3","3095","0","213","12.4","15.1"
"Talbot","2020-12-27","6","3101","4","217","19.1","18.4"
"Talbot","2020-12-28","16","3117","3","220","20","19.4"
"Talbot","2020-12-29","12","3129","4","224","23.8","19.4"
"Talbot","2020-12-30","4","3133","1","225","25.3","21.2"
"Talbot","2020-12-31","13","3146","0","225","20.5","21.2"
"Talbot","2021-01-01","3","3149","1","226","25.3","22.4"
"Talbot","2021-01-02","6","3155","4","230","34.8","23.6"
"Talbot","2021-01-03","7","3162","2","232","29.4","24.2"
"Talbot","2021-01-04","44","3206","15","247","31.6","25.8"
"Talbot","2021-01-05","23","3229","1","248","27.4","25.6"
"Talbot","2021-01-06","11","3240","0","248","23.9","24.6"
"Talbot","2021-01-07","18","3258","5","253","27.8","24.2"
"Talbot","2021-01-08","10","3268","0","253","23.1","24.2"
"Talbot","2021-01-09","4","3272","2","255","20.7","27.8"
"Talbot","2021-01-10","3","3275","0","255","16.6","23"
"Talbot","2021-01-11","38","3313","8","263","14.7","23.2"
"Talbot","2021-01-12","10","3323","0","263","14.1","20.8"
"Talbot","2021-01-13","9","3332","3","266","18.9","21.4"
"Talbot","2021-01-14","12","3344","2","268","17.3","22.6"
"Talbot","2021-01-15","81","3425","15","283","19.9","21.5"
"Talbot","2021-01-16","4","3429","2","285","19.9","20.3"
"Talbot","2021-01-17","4","3433","1","286","23.5","20.1"
"Talbot","2021-01-18","7","3440","2","288","24.6","19.7"
"Talbot","2021-01-19","10","3450","3","291","28.9","21.5"
"Talbot","2021-01-20","19","3469","4","295","27.1","23"
"Talbot","2021-01-21","4","3473","1","296","28.3","22.8"
"Talbot","2021-01-22","6","3479","2","298","30.4","25.2"
"Talbot","2021-01-23","3","3482","1","299","28","24"
"Talbot","2021-01-24","2","3484","2","301","38.8","31.1"
"Talbot","2021-01-25","9","3493","2","303","37.8","31.2"
"Talbot","2021-01-26","2","3495","1","304","40.7","34.8"
"Talbot","2021-01-27","0","3495","0","304","37.7","32.4"
"Taliaferro","2020-02-01","0","0","0","0",".","."
"Taliaferro","2020-02-02","0","0","0","0",".","."
"Taliaferro","2020-02-03","0","0","0","0",".","."
"Taliaferro","2020-02-04","0","0","0","0",".","."
"Taliaferro","2020-02-05","0","0","0","0",".","."
"Taliaferro","2020-02-06","0","0","0","0",".","."
"Taliaferro","2020-02-07","0","0","0","0","0","."
"Taliaferro","2020-02-08","0","0","0","0","0","."
"Taliaferro","2020-02-09","0","0","0","0","0","."
"Taliaferro","2020-02-10","0","0","0","0","0","."
"Taliaferro","2020-02-11","0","0","0","0","0","."
"Taliaferro","2020-02-12","0","0","0","0","0","."
"Taliaferro","2020-02-13","0","0","0","0","0","."
"Taliaferro","2020-02-14","0","0","0","0","0","0"
"Taliaferro","2020-02-15","0","0","0","0","0","0"
"Taliaferro","2020-02-16","0","0","0","0","0","0"
"Taliaferro","2020-02-17","0","0","0","0","0","0"
"Taliaferro","2020-02-18","0","0","0","0","0","0"
"Taliaferro","2020-02-19","0","0","0","0","0","0"
"Taliaferro","2020-02-20","0","0","0","0","0","0"
"Taliaferro","2020-02-21","0","0","0","0","0","0"
"Taliaferro","2020-02-22","0","0","0","0","0","0"
"Taliaferro","2020-02-23","0","0","0","0","0","0"
"Taliaferro","2020-02-24","0","0","0","0","0","0"
"Taliaferro","2020-02-25","0","0","0","0","0","0"
"Taliaferro","2020-02-26","0","0","0","0","0","0"
"Taliaferro","2020-02-27","0","0","0","0","0","0"
"Taliaferro","2020-02-28","0","0","0","0","0","0"
"Taliaferro","2020-02-29","0","0","0","0","0","0"
"Taliaferro","2020-03-01","0","0","0","0","0","0"
"Taliaferro","2020-03-02","0","0","0","0","0","0"
"Taliaferro","2020-03-03","0","0","0","0","0","0"
"Taliaferro","2020-03-04","0","0","0","0","0","0"
"Taliaferro","2020-03-05","0","0","0","0","0","0"
"Taliaferro","2020-03-06","0","0","0","0","0","0"
"Taliaferro","2020-03-07","0","0","0","0","0","0"
"Taliaferro","2020-03-08","0","0","0","0","0","0"
"Taliaferro","2020-03-09","0","0","0","0","0","0"
"Taliaferro","2020-03-10","0","0","0","0","0","0"
"Taliaferro","2020-03-11","0","0","0","0","0","0"
"Taliaferro","2020-03-12","0","0","0","0","0","0"
"Taliaferro","2020-03-13","0","0","0","0","0","0"
"Taliaferro","2020-03-14","0","0","0","0","0","0"
"Taliaferro","2020-03-15","0","0","0","0","0","0"
"Taliaferro","2020-03-16","0","0","0","0","0","0"
"Taliaferro","2020-03-17","0","0","0","0","0","0"
"Taliaferro","2020-03-18","0","0","0","0","0","0"
"Taliaferro","2020-03-19","0","0","0","0","0","0"
"Taliaferro","2020-03-20","0","0","0","0","0","0"
"Taliaferro","2020-03-21","0","0","0","0","0","0"
"Taliaferro","2020-03-22","0","0","0","0","0","0"
"Taliaferro","2020-03-23","0","0","0","0","0","0"
"Taliaferro","2020-03-24","0","0","0","0","0","0"
"Taliaferro","2020-03-25","1","1","0","0","0","0"
"Taliaferro","2020-03-26","0","1","0","0","0","0"
"Taliaferro","2020-03-27","2","3","0","0","0","0"
"Taliaferro","2020-03-28","0","3","0","0","0","0"
"Taliaferro","2020-03-29","0","3","0","0","0","0"
"Taliaferro","2020-03-30","1","4","0","0","0","0"
"Taliaferro","2020-03-31","0","4","0","0","0","0"
"Taliaferro","2020-04-01","1","5","0","0","0","0"
"Taliaferro","2020-04-02","1","6","0","0","0","0"
"Taliaferro","2020-04-03","0","6","0","0","0","0"
"Taliaferro","2020-04-04","0","6","0","0","0","0"
"Taliaferro","2020-04-05","0","6","0","0","0","0"
"Taliaferro","2020-04-06","0","6","0","0","0","0"
"Taliaferro","2020-04-07","0","6","0","0","0","0"
"Taliaferro","2020-04-08","0","6","0","0","0","0"
"Taliaferro","2020-04-09","0","6","0","0","0","0"
"Taliaferro","2020-04-10","0","6","0","0","0","0"
"Taliaferro","2020-04-11","0","6","0","0","0","0"
"Taliaferro","2020-04-12","0","6","0","0","0","0"
"Taliaferro","2020-04-13","1","7","0","0","0","0"
"Taliaferro","2020-04-14","0","7","0","0","0","0"
"Taliaferro","2020-04-15","0","7","0","0","0","0"
"Taliaferro","2020-04-16","2","9","0","0","0","0"
"Taliaferro","2020-04-17","0","9","0","0","0","0"
"Taliaferro","2020-04-18","0","9","0","0","0","0"
"Taliaferro","2020-04-19","0","9","0","0","0","0"
"Taliaferro","2020-04-20","0","9","0","0","0","0"
"Taliaferro","2020-04-21","3","12","0","0","0","0"
"Taliaferro","2020-04-22","0","12","0","0","0","0"
"Taliaferro","2020-04-23","1","13","0","0","0","0"
"Taliaferro","2020-04-24","0","13","0","0","0","0"
"Taliaferro","2020-04-25","0","13","0","0","0","0"
"Taliaferro","2020-04-26","1","14","0","0","0","0"
"Taliaferro","2020-04-27","1","15","0","0","0","0"
"Taliaferro","2020-04-28","0","15","0","0","0","0"
"Taliaferro","2020-04-29","2","17","1","1","7.1","3.6"
"Taliaferro","2020-04-30","1","18","0","1","7.1","3.6"
"Taliaferro","2020-05-01","1","19","0","1","7.1","3.6"
"Taliaferro","2020-05-02","0","19","0","1","7.1","3.6"
"Taliaferro","2020-05-03","0","19","0","1","7.1","3.6"
"Taliaferro","2020-05-04","0","19","0","1","7.1","3.6"
"Taliaferro","2020-05-05","0","19","0","1","7.1","3.6"
"Taliaferro","2020-05-06","2","21","0","1","0","3.6"
"Taliaferro","2020-05-07","0","21","0","1","0","3.6"
"Taliaferro","2020-05-08","1","22","0","1","0","3.6"
"Taliaferro","2020-05-09","0","22","0","1","0","3.6"
"Taliaferro","2020-05-10","0","22","0","1","0","3.6"
"Taliaferro","2020-05-11","1","23","0","1","0","3.6"
"Taliaferro","2020-05-12","0","23","0","1","0","3.6"
"Taliaferro","2020-05-13","0","23","0","1","0","0"
"Taliaferro","2020-05-14","0","23","0","1","0","0"
"Taliaferro","2020-05-15","0","23","0","1","0","0"
"Taliaferro","2020-05-16","1","24","0","1","0","0"
"Taliaferro","2020-05-17","0","24","0","1","0","0"
"Taliaferro","2020-05-18","2","26","0","1","0","0"
"Taliaferro","2020-05-19","1","27","1","2","14.3","7.1"
"Taliaferro","2020-05-20","1","28","0","2","14.3","7.1"
"Taliaferro","2020-05-21","0","28","0","2","14.3","7.1"
"Taliaferro","2020-05-22","1","29","0","2","14.3","7.1"
"Taliaferro","2020-05-23","0","29","0","2","14.3","7.1"
"Taliaferro","2020-05-24","0","29","0","2","14.3","7.1"
"Taliaferro","2020-05-25","0","29","0","2","14.3","7.1"
"Taliaferro","2020-05-26","0","29","0","2","0","7.1"
"Taliaferro","2020-05-27","0","29","0","2","0","7.1"
"Taliaferro","2020-05-28","0","29","0","2","0","7.1"
"Taliaferro","2020-05-29","0","29","0","2","0","7.1"
"Taliaferro","2020-05-30","0","29","0","2","0","7.1"
"Taliaferro","2020-05-31","0","29","0","2","0","7.1"
"Taliaferro","2020-06-01","1","30","0","2","0","7.1"
"Taliaferro","2020-06-02","0","30","0","2","0","0"
"Taliaferro","2020-06-03","1","31","0","2","0","0"
"Taliaferro","2020-06-04","0","31","0","2","0","0"
"Taliaferro","2020-06-05","0","31","0","2","0","0"
"Taliaferro","2020-06-06","0","31","0","2","0","0"
"Taliaferro","2020-06-07","0","31","0","2","0","0"
"Taliaferro","2020-06-08","0","31","0","2","0","0"
"Taliaferro","2020-06-09","2","33","0","2","0","0"
"Taliaferro","2020-06-10","1","34","0","2","0","0"
"Taliaferro","2020-06-11","4","38","0","2","0","0"
"Taliaferro","2020-06-12","0","38","0","2","0","0"
"Taliaferro","2020-06-13","0","38","0","2","0","0"
"Taliaferro","2020-06-14","0","38","0","2","0","0"
"Taliaferro","2020-06-15","0","38","0","2","0","0"
"Taliaferro","2020-06-16","0","38","0","2","0","0"
"Taliaferro","2020-06-17","0","38","0","2","0","0"
"Taliaferro","2020-06-18","2","40","0","2","0","0"
"Taliaferro","2020-06-19","0","40","0","2","0","0"
"Taliaferro","2020-06-20","0","40","0","2","0","0"
"Taliaferro","2020-06-21","0","40","0","2","0","0"
"Taliaferro","2020-06-22","0","40","0","2","0","0"
"Taliaferro","2020-06-23","1","41","0","2","0","0"
"Taliaferro","2020-06-24","4","45","0","2","0","0"
"Taliaferro","2020-06-25","5","50","0","2","0","0"
"Taliaferro","2020-06-26","0","50","0","2","0","0"
"Taliaferro","2020-06-27","2","52","0","2","0","0"
"Taliaferro","2020-06-28","0","52","0","2","0","0"
"Taliaferro","2020-06-29","1","53","0","2","0","0"
"Taliaferro","2020-06-30","1","54","0","2","0","0"
"Taliaferro","2020-07-01","1","55","0","2","0","0"
"Taliaferro","2020-07-02","14","69","0","2","0","0"
"Taliaferro","2020-07-03","0","69","0","2","0","0"
"Taliaferro","2020-07-04","0","69","0","2","0","0"
"Taliaferro","2020-07-05","0","69","0","2","0","0"
"Taliaferro","2020-07-06","0","69","0","2","0","0"
"Taliaferro","2020-07-07","1","70","0","2","0","0"
"Taliaferro","2020-07-08","3","73","0","2","0","0"
"Taliaferro","2020-07-09","2","75","0","2","0","0"
"Taliaferro","2020-07-10","2","77","0","2","0","0"
"Taliaferro","2020-07-11","2","79","0","2","0","0"
"Taliaferro","2020-07-12","1","80","0","2","0","0"
"Taliaferro","2020-07-13","2","82","0","2","0","0"
"Taliaferro","2020-07-14","0","82","0","2","0","0"
"Taliaferro","2020-07-15","1","83","0","2","0","0"
"Taliaferro","2020-07-16","0","83","0","2","0","0"
"Taliaferro","2020-07-17","0","83","0","2","0","0"
"Taliaferro","2020-07-18","2","85","0","2","0","0"
"Taliaferro","2020-07-19","3","88","2","4","9.5","4.8"
"Taliaferro","2020-07-20","2","90","1","5","16.7","8.3"
"Taliaferro","2020-07-21","1","91","0","5","16.7","8.3"
"Taliaferro","2020-07-22","1","92","1","6","31","15.5"
"Taliaferro","2020-07-23","30","122","0","6","31","15.5"
"Taliaferro","2020-07-24","2","124","0","6","31","15.5"
"Taliaferro","2020-07-25","2","126","0","6","31","15.5"
"Taliaferro","2020-07-26","0","126","0","6","21.4","15.5"
"Taliaferro","2020-07-27","3","129","0","6","14.3","15.5"
"Taliaferro","2020-07-28","3","132","2","8","23.8","20.2"
"Taliaferro","2020-07-29","1","133","0","8","9.5","20.2"
"Taliaferro","2020-07-30","34","167","1","9","9.9","20.4"
"Taliaferro","2020-07-31","1","168","0","9","9.9","20.4"
"Taliaferro","2020-08-01","0","168","0","9","9.9","20.4"
"Taliaferro","2020-08-02","1","169","0","9","9.9","15.7"
"Taliaferro","2020-08-03","3","172","0","9","9.9","12.1"
"Taliaferro","2020-08-04","2","174","0","9","0.4","12.1"
"Taliaferro","2020-08-05","2","176","0","9","0.4","5"
"Taliaferro","2020-08-06","1","177","0","9","0","5"
"Taliaferro","2020-08-07","0","177","0","9","0","5"
"Taliaferro","2020-08-08","1","178","0","9","0","5"
"Taliaferro","2020-08-09","0","178","0","9","0","5"
"Taliaferro","2020-08-10","1","179","0","9","0","5"
"Taliaferro","2020-08-11","4","183","1","10","3.6","2"
"Taliaferro","2020-08-12","3","186","0","10","3.6","2"
"Taliaferro","2020-08-13","1","187","0","10","3.6","1.8"
"Taliaferro","2020-08-14","2","189","0","10","3.6","1.8"
"Taliaferro","2020-08-15","1","190","0","10","3.6","1.8"
"Taliaferro","2020-08-16","0","190","0","10","3.6","1.8"
"Taliaferro","2020-08-17","1","191","0","10","3.6","1.8"
"Taliaferro","2020-08-18","0","191","0","10","0","1.8"
"Taliaferro","2020-08-19","0","191","0","10","0","1.8"
"Taliaferro","2020-08-20","2","193","0","10","0","1.8"
"Taliaferro","2020-08-21","1","194","0","10","0","1.8"
"Taliaferro","2020-08-22","0","194","0","10","0","1.8"
"Taliaferro","2020-08-23","0","194","0","10","0","1.8"
"Taliaferro","2020-08-24","0","194","0","10","0","1.8"
"Taliaferro","2020-08-25","0","194","0","10","0","0"
"Taliaferro","2020-08-26","1","195","1","11","14.3","7.1"
"Taliaferro","2020-08-27","2","197","0","11","14.3","7.1"
"Taliaferro","2020-08-28","1","198","0","11","14.3","7.1"
"Taliaferro","2020-08-29","0","198","0","11","14.3","7.1"
"Taliaferro","2020-08-30","0","198","0","11","14.3","7.1"
"Taliaferro","2020-08-31","2","200","0","11","14.3","7.1"
"Taliaferro","2020-09-01","2","202","0","11","14.3","7.1"
"Taliaferro","2020-09-02","1","203","0","11","0","7.1"
"Taliaferro","2020-09-03","0","203","0","11","0","7.1"
"Taliaferro","2020-09-04","0","203","0","11","0","7.1"
"Taliaferro","2020-09-05","1","204","0","11","0","7.1"
"Taliaferro","2020-09-06","0","204","0","11","0","7.1"
"Taliaferro","2020-09-07","0","204","0","11","0","7.1"
"Taliaferro","2020-09-08","1","205","0","11","0","7.1"
"Taliaferro","2020-09-09","0","205","0","11","0","0"
"Taliaferro","2020-09-10","1","206","0","11","0","0"
"Taliaferro","2020-09-11","1","207","0","11","0","0"
"Taliaferro","2020-09-12","1","208","0","11","0","0"
"Taliaferro","2020-09-13","0","208","0","11","0","0"
"Taliaferro","2020-09-14","0","208","0","11","0","0"
"Taliaferro","2020-09-15","1","209","0","11","0","0"
"Taliaferro","2020-09-16","2","211","0","11","0","0"
"Taliaferro","2020-09-17","1","212","1","12","14.3","7.1"
"Taliaferro","2020-09-18","1","213","0","12","14.3","7.1"
"Taliaferro","2020-09-19","0","213","0","12","14.3","7.1"
"Taliaferro","2020-09-20","0","213","0","12","14.3","7.1"
"Taliaferro","2020-09-21","4","217","0","12","14.3","7.1"
"Taliaferro","2020-09-22","3","220","0","12","14.3","7.1"
"Taliaferro","2020-09-23","1","221","0","12","14.3","7.1"
"Taliaferro","2020-09-24","0","221","0","12","0","7.1"
"Taliaferro","2020-09-25","1","222","0","12","0","7.1"
"Taliaferro","2020-09-26","3","225","0","12","0","7.1"
"Taliaferro","2020-09-27","1","226","0","12","0","7.1"
"Taliaferro","2020-09-28","0","226","0","12","0","7.1"
"Taliaferro","2020-09-29","0","226","0","12","0","7.1"
"Taliaferro","2020-09-30","2","228","0","12","0","7.1"
"Taliaferro","2020-10-01","0","228","0","12","0","0"
"Taliaferro","2020-10-02","1","229","0","12","0","0"
"Taliaferro","2020-10-03","0","229","0","12","0","0"
"Taliaferro","2020-10-04","0","229","0","12","0","0"
"Taliaferro","2020-10-05","0","229","0","12","0","0"
"Taliaferro","2020-10-06","1","230","1","13","14.3","7.1"
"Taliaferro","2020-10-07","2","232","0","13","14.3","7.1"
"Taliaferro","2020-10-08","1","233","0","13","14.3","7.1"
"Taliaferro","2020-10-09","1","234","0","13","14.3","7.1"
"Taliaferro","2020-10-10","0","234","0","13","14.3","7.1"
"Taliaferro","2020-10-11","0","234","0","13","14.3","7.1"
"Taliaferro","2020-10-12","2","236","0","13","14.3","7.1"
"Taliaferro","2020-10-13","1","237","0","13","0","7.1"
"Taliaferro","2020-10-14","1","238","0","13","0","7.1"
"Taliaferro","2020-10-15","3","241","0","13","0","7.1"
"Taliaferro","2020-10-16","1","242","0","13","0","7.1"
"Taliaferro","2020-10-17","0","242","0","13","0","7.1"
"Taliaferro","2020-10-18","1","243","0","13","0","7.1"
"Taliaferro","2020-10-19","3","246","0","13","0","7.1"
"Taliaferro","2020-10-20","1","247","0","13","0","0"
"Taliaferro","2020-10-21","0","247","0","13","0","0"
"Taliaferro","2020-10-22","1","248","0","13","0","0"
"Taliaferro","2020-10-23","1","249","0","13","0","0"
"Taliaferro","2020-10-24","3","252","2","15","9.5","4.8"
"Taliaferro","2020-10-25","0","252","0","15","9.5","4.8"
"Taliaferro","2020-10-26","0","252","0","15","9.5","4.8"
"Taliaferro","2020-10-27","4","256","2","17","16.7","8.3"
"Taliaferro","2020-10-28","0","256","0","17","16.7","8.3"
"Taliaferro","2020-10-29","0","256","0","17","16.7","8.3"
"Taliaferro","2020-10-30","0","256","0","17","16.7","8.3"
"Taliaferro","2020-10-31","1","257","0","17","7.1","8.3"
"Taliaferro","2020-11-01","0","257","0","17","7.1","8.3"
"Taliaferro","2020-11-02","0","257","0","17","7.1","8.3"
"Taliaferro","2020-11-03","3","260","0","17","0","8.3"
"Taliaferro","2020-11-04","0","260","0","17","0","8.3"
"Taliaferro","2020-11-05","2","262","1","18","7.1","11.9"
"Taliaferro","2020-11-06","1","263","0","18","7.1","11.9"
"Taliaferro","2020-11-07","0","263","0","18","7.1","7.1"
"Taliaferro","2020-11-08","0","263","0","18","7.1","7.1"
"Taliaferro","2020-11-09","0","263","0","18","7.1","7.1"
"Taliaferro","2020-11-10","3","266","0","18","7.1","3.6"
"Taliaferro","2020-11-11","1","267","0","18","7.1","3.6"
"Taliaferro","2020-11-12","2","269","0","18","0","3.6"
"Taliaferro","2020-11-13","1","270","0","18","0","3.6"
"Taliaferro","2020-11-14","1","271","1","19","14.3","10.7"
"Taliaferro","2020-11-15","2","273","0","19","14.3","10.7"
"Taliaferro","2020-11-16","3","276","0","19","14.3","10.7"
"Taliaferro","2020-11-17","2","278","0","19","14.3","10.7"
"Taliaferro","2020-11-18","0","278","0","19","14.3","10.7"
"Taliaferro","2020-11-19","1","279","0","19","14.3","7.1"
"Taliaferro","2020-11-20","5","284","1","20","17.1","8.6"
"Taliaferro","2020-11-21","1","285","0","20","2.9","8.6"
"Taliaferro","2020-11-22","0","285","0","20","2.9","8.6"
"Taliaferro","2020-11-23","1","286","0","20","2.9","8.6"
"Taliaferro","2020-11-24","3","289","0","20","2.9","8.6"
"Taliaferro","2020-11-25","2","291","0","20","2.9","8.6"
"Taliaferro","2020-11-26","0","291","0","20","2.9","8.6"
"Taliaferro","2020-11-27","1","292","0","20","0","8.6"
"Taliaferro","2020-11-28","0","292","0","20","0","1.4"
"Taliaferro","2020-11-29","0","292","0","20","0","1.4"
"Taliaferro","2020-11-30","4","296","0","20","0","1.4"
"Taliaferro","2020-12-01","1","297","0","20","0","1.4"
"Taliaferro","2020-12-02","0","297","0","20","0","1.4"
"Taliaferro","2020-12-03","0","297","0","20","0","1.4"
"Taliaferro","2020-12-04","0","297","0","20","0","0"
"Taliaferro","2020-12-05","0","297","0","20","0","0"
"Taliaferro","2020-12-06","1","298","0","20","0","0"
"Taliaferro","2020-12-07","0","298","0","20","0","0"
"Taliaferro","2020-12-08","3","301","0","20","0","0"
"Taliaferro","2020-12-09","1","302","1","21","14.3","7.1"
"Taliaferro","2020-12-10","4","306","0","21","14.3","7.1"
"Taliaferro","2020-12-11","0","306","0","21","14.3","7.1"
"Taliaferro","2020-12-12","1","307","0","21","14.3","7.1"
"Taliaferro","2020-12-13","0","307","0","21","14.3","7.1"
"Taliaferro","2020-12-14","0","307","0","21","14.3","7.1"
"Taliaferro","2020-12-15","3","310","0","21","14.3","7.1"
"Taliaferro","2020-12-16","10","320","2","23","2.9","8.6"
"Taliaferro","2020-12-17","0","320","0","23","2.9","8.6"
"Taliaferro","2020-12-18","1","321","0","23","2.9","8.6"
"Taliaferro","2020-12-19","2","323","0","23","2.9","8.6"
"Taliaferro","2020-12-20","0","323","0","23","2.9","8.6"
"Taliaferro","2020-12-21","4","327","0","23","2.9","8.6"
"Taliaferro","2020-12-22","4","331","0","23","2.9","8.6"
"Taliaferro","2020-12-23","2","333","0","23","0","1.4"
"Taliaferro","2020-12-24","0","333","0","23","0","1.4"
"Taliaferro","2020-12-25","0","333","0","23","0","1.4"
"Taliaferro","2020-12-26","2","335","0","23","0","1.4"
"Taliaferro","2020-12-27","3","338","3","26","14.3","8.6"
"Taliaferro","2020-12-28","0","338","0","26","14.3","8.6"
"Taliaferro","2020-12-29","3","341","1","27","19","11"
"Taliaferro","2020-12-30","1","342","0","27","19","9.5"
"Taliaferro","2020-12-31","2","344","2","29","33.3","16.7"
"Taliaferro","2021-01-01","1","345","0","29","33.3","16.7"
"Taliaferro","2021-01-02","1","346","0","29","33.3","16.7"
"Taliaferro","2021-01-03","0","346","0","29","19","16.7"
"Taliaferro","2021-01-04","2","348","1","30","26.2","20.2"
"Taliaferro","2021-01-05","8","356","5","35","30.4","24.7"
"Taliaferro","2021-01-06","8","364","1","36","32.1","25.6"
"Taliaferro","2021-01-07","7","371","0","36","17.9","25.6"
"Taliaferro","2021-01-08","2","373","1","37","25","29.2"
"Taliaferro","2021-01-09","5","378","2","39","30.7","32"
"Taliaferro","2021-01-10","2","380","1","40","37.9","28.5"
"Taliaferro","2021-01-11","6","386","1","41","33.1","29.6"
"Taliaferro","2021-01-12","5","391","2","43","29.9","30.1"
"Taliaferro","2021-01-13","2","393","0","43","28.1","30.1"
"Taliaferro","2021-01-14","5","398","3","46","36.7","27.3"
"Taliaferro","2021-01-15","8","406","1","47","31.3","28.2"
"Taliaferro","2021-01-16","5","411","0","47","25.6","28.2"
"Taliaferro","2021-01-17","0","411","0","47","18.5","28.2"
"Taliaferro","2021-01-18","3","414","0","47","16.1","24.6"
"Taliaferro","2021-01-19","3","417","1","48","15.1","22.5"
"Taliaferro","2021-01-20","3","420","2","50","24.6","26.4"
"Taliaferro","2021-01-21","2","422","1","51","23.2","29.9"
"Taliaferro","2021-01-22","1","423","0","51","21.4","26.4"
"Taliaferro","2021-01-23","2","425","0","51","21.4","23.5"
"Taliaferro","2021-01-24","1","426","1","52","35.7","27.1"
"Taliaferro","2021-01-25","1","427","0","52","35.7","25.9"
"Taliaferro","2021-01-26","1","428","0","52","31","23"
"Taliaferro","2021-01-27","0","428","0","52","21.4","23"
"Tattnall","2020-02-01","0","0","0","0",".","."
"Tattnall","2020-02-02","0","0","0","0",".","."
"Tattnall","2020-02-03","0","0","0","0",".","."
"Tattnall","2020-02-04","0","0","0","0",".","."
"Tattnall","2020-02-05","0","0","0","0",".","."
"Tattnall","2020-02-06","0","0","0","0",".","."
"Tattnall","2020-02-07","0","0","0","0","0","."
"Tattnall","2020-02-08","0","0","0","0","0","."
"Tattnall","2020-02-09","0","0","0","0","0","."
"Tattnall","2020-02-10","0","0","0","0","0","."
"Tattnall","2020-02-11","0","0","0","0","0","."
"Tattnall","2020-02-12","0","0","0","0","0","."
"Tattnall","2020-02-13","0","0","0","0","0","."
"Tattnall","2020-02-14","0","0","0","0","0","0"
"Tattnall","2020-02-15","0","0","0","0","0","0"
"Tattnall","2020-02-16","0","0","0","0","0","0"
"Tattnall","2020-02-17","0","0","0","0","0","0"
"Tattnall","2020-02-18","0","0","0","0","0","0"
"Tattnall","2020-02-19","0","0","0","0","0","0"
"Tattnall","2020-02-20","0","0","0","0","0","0"
"Tattnall","2020-02-21","0","0","0","0","0","0"
"Tattnall","2020-02-22","0","0","0","0","0","0"
"Tattnall","2020-02-23","0","0","0","0","0","0"
"Tattnall","2020-02-24","0","0","0","0","0","0"
"Tattnall","2020-02-25","0","0","0","0","0","0"
"Tattnall","2020-02-26","0","0","0","0","0","0"
"Tattnall","2020-02-27","0","0","0","0","0","0"
"Tattnall","2020-02-28","0","0","0","0","0","0"
"Tattnall","2020-02-29","0","0","0","0","0","0"
"Tattnall","2020-03-01","0","0","0","0","0","0"
"Tattnall","2020-03-02","0","0","0","0","0","0"
"Tattnall","2020-03-03","0","0","0","0","0","0"
"Tattnall","2020-03-04","0","0","0","0","0","0"
"Tattnall","2020-03-05","0","0","0","0","0","0"
"Tattnall","2020-03-06","0","0","0","0","0","0"
"Tattnall","2020-03-07","0","0","0","0","0","0"
"Tattnall","2020-03-08","0","0","0","0","0","0"
"Tattnall","2020-03-09","0","0","0","0","0","0"
"Tattnall","2020-03-10","0","0","0","0","0","0"
"Tattnall","2020-03-11","0","0","0","0","0","0"
"Tattnall","2020-03-12","1","1","0","0","0","0"
"Tattnall","2020-03-13","1","2","0","0","0","0"
"Tattnall","2020-03-14","0","2","0","0","0","0"
"Tattnall","2020-03-15","2","4","1","1","7.1","3.6"
"Tattnall","2020-03-16","2","6","0","1","7.1","3.6"
"Tattnall","2020-03-17","2","8","0","1","7.1","3.6"
"Tattnall","2020-03-18","4","12","0","1","7.1","3.6"
"Tattnall","2020-03-19","4","16","0","1","7.1","3.6"
"Tattnall","2020-03-20","3","19","0","1","7.1","3.6"
"Tattnall","2020-03-21","5","24","1","2","10","5"
"Tattnall","2020-03-22","1","25","0","2","2.9","5"
"Tattnall","2020-03-23","2","27","0","2","2.9","5"
"Tattnall","2020-03-24","3","30","0","2","2.9","5"
"Tattnall","2020-03-25","3","33","0","2","2.9","5"
"Tattnall","2020-03-26","2","35","0","2","2.9","5"
"Tattnall","2020-03-27","1","36","0","2","2.9","5"
"Tattnall","2020-03-28","3","39","0","2","0","5"
"Tattnall","2020-03-29","0","39","0","2","0","1.4"
"Tattnall","2020-03-30","1","40","0","2","0","1.4"
"Tattnall","2020-03-31","2","42","0","2","0","1.4"
"Tattnall","2020-04-01","2","44","1","3","7.1","5"
"Tattnall","2020-04-02","2","46","1","4","14.3","8.6"
"Tattnall","2020-04-03","5","51","0","4","14.3","8.6"
"Tattnall","2020-04-04","0","51","0","4","14.3","7.1"
"Tattnall","2020-04-05","0","51","0","4","14.3","7.1"
"Tattnall","2020-04-06","8","59","0","4","14.3","7.1"
"Tattnall","2020-04-07","6","65","0","4","14.3","7.1"
"Tattnall","2020-04-08","4","69","0","4","7.1","7.1"
"Tattnall","2020-04-09","5","74","0","4","0","7.1"
"Tattnall","2020-04-10","5","79","1","5","2.9","8.6"
"Tattnall","2020-04-11","0","79","0","5","2.9","8.6"
"Tattnall","2020-04-12","0","79","0","5","2.9","8.6"
"Tattnall","2020-04-13","1","80","0","5","2.9","8.6"
"Tattnall","2020-04-14","5","85","0","5","2.9","8.6"
"Tattnall","2020-04-15","7","92","0","5","2.9","5"
"Tattnall","2020-04-16","4","96","0","5","2.9","1.4"
"Tattnall","2020-04-17","6","102","0","5","0","1.4"
"Tattnall","2020-04-18","0","102","0","5","0","1.4"
"Tattnall","2020-04-19","6","108","0","5","0","1.4"
"Tattnall","2020-04-20","2","110","1","6","7.1","5"
"Tattnall","2020-04-21","8","118","1","7","8.9","5.9"
"Tattnall","2020-04-22","7","125","0","7","8.9","5.9"
"Tattnall","2020-04-23","5","130","1","8","11.8","7.3"
"Tattnall","2020-04-24","4","134","0","8","11.8","5.9"
"Tattnall","2020-04-25","0","134","0","8","11.8","5.9"
"Tattnall","2020-04-26","3","137","1","9","16.5","8.3"
"Tattnall","2020-04-27","10","147","0","9","9.4","8.3"
"Tattnall","2020-04-28","6","153","0","9","7.6","8.3"
"Tattnall","2020-04-29","5","158","0","9","7.6","8.3"
"Tattnall","2020-04-30","7","165","0","9","4.8","8.3"
"Tattnall","2020-05-01","10","175","0","9","4.8","8.3"
"Tattnall","2020-05-02","2","177","0","9","4.8","8.3"
"Tattnall","2020-05-03","2","179","0","9","0","8.3"
"Tattnall","2020-05-04","7","186","0","9","0","4.7"
"Tattnall","2020-05-05","8","194","0","9","0","3.8"
"Tattnall","2020-05-06","10","204","0","9","0","3.8"
"Tattnall","2020-05-07","3","207","0","9","0","2.4"
"Tattnall","2020-05-08","5","212","0","9","0","2.4"
"Tattnall","2020-05-09","1","213","0","9","0","2.4"
"Tattnall","2020-05-10","1","214","0","9","0","0"
"Tattnall","2020-05-11","6","220","0","9","0","0"
"Tattnall","2020-05-12","93","313","2","11","0.3","0.2"
"Tattnall","2020-05-13","5","318","2","13","6","3"
"Tattnall","2020-05-14","10","328","1","14","7.5","3.7"
"Tattnall","2020-05-15","4","332","0","14","7.5","3.7"
"Tattnall","2020-05-16","5","337","0","14","7.5","3.7"
"Tattnall","2020-05-17","5","342","0","14","7.5","3.7"
"Tattnall","2020-05-18","7","349","0","14","7.5","3.7"
"Tattnall","2020-05-19","9","358","0","14","7.1","3.7"
"Tattnall","2020-05-20","13","371","0","14","1.4","3.7"
"Tattnall","2020-05-21","16","387","1","15","0.9","4.2"
"Tattnall","2020-05-22","5","392","1","16","3.8","5.6"
"Tattnall","2020-05-23","2","394","1","17","10.9","9.2"
"Tattnall","2020-05-24","1","395","0","17","10.9","9.2"
"Tattnall","2020-05-25","3","398","0","17","10.9","9.2"
"Tattnall","2020-05-26","11","409","1","18","12.2","9.7"
"Tattnall","2020-05-27","12","421","3","21","15.8","8.6"
"Tattnall","2020-05-28","13","434","0","21","14.9","7.9"
"Tattnall","2020-05-29","12","446","0","21","12","7.9"
"Tattnall","2020-05-30","3","449","1","22","9.6","10.3"
"Tattnall","2020-05-31","2","451","0","22","9.6","10.3"
"Tattnall","2020-06-01","18","469","0","22","9.6","10.3"
"Tattnall","2020-06-02","9","478","0","22","8.3","10.3"
"Tattnall","2020-06-03","11","489","1","23","6.1","10.9"
"Tattnall","2020-06-04","19","508","0","23","6.1","10.5"
"Tattnall","2020-06-05","10","518","1","24","7.5","9.8"
"Tattnall","2020-06-06","5","523","1","25","5.6","7.6"
"Tattnall","2020-06-07","2","525","0","25","5.6","7.6"
"Tattnall","2020-06-08","25","550","4","29","7.9","8.8"
"Tattnall","2020-06-09","24","574","4","33","10.3","9.3"
"Tattnall","2020-06-10","14","588","5","38","14.1","10.1"
"Tattnall","2020-06-11","14","602","2","40","16.1","11.1"
"Tattnall","2020-06-12","17","619","5","45","18.9","13.2"
"Tattnall","2020-06-13","5","624","1","46","18.9","12.2"
"Tattnall","2020-06-14","9","633","2","48","22","13.8"
"Tattnall","2020-06-15","27","660","6","54","22.9","15.4"
"Tattnall","2020-06-16","73","733","2","56","20.9","15.6"
"Tattnall","2020-06-17","14","747","1","57","16.9","15.5"
"Tattnall","2020-06-18","95","842","10","67","16.3","16.2"
"Tattnall","2020-06-19","24","866","2","69","13.3","16.1"
"Tattnall","2020-06-20","8","874","1","70","12.2","15.6"
"Tattnall","2020-06-21","3","877","1","71","13.8","17.9"
"Tattnall","2020-06-22","42","919","9","80","13.7","18.3"
"Tattnall","2020-06-23","25","944","3","83","15","18"
"Tattnall","2020-06-24","47","991","10","93","17.1","17"
"Tattnall","2020-06-25","27","1018","4","97","17.7","17"
"Tattnall","2020-06-26","34","1052","3","100","17.7","15.5"
"Tattnall","2020-06-27","12","1064","2","102","18.3","15.3"
"Tattnall","2020-06-28","5","1069","1","103","16.4","15.1"
"Tattnall","2020-06-29","26","1095","5","108","16.1","14.9"
"Tattnall","2020-06-30","43","1138","9","117","17.4","16.2"
"Tattnall","2020-07-01","43","1181","12","129","18.3","17.7"
"Tattnall","2020-07-02","34","1215","2","131","17.1","17.4"
"Tattnall","2020-07-03","10","1225","2","133","18.7","18.2"
"Tattnall","2020-07-04","2","1227","0","133","16.3","17.3"
"Tattnall","2020-07-05","3","1230","1","134","18.2","17.3"
"Tattnall","2020-07-06","35","1265","6","140","17.9","17"
"Tattnall","2020-07-07","42","1307","6","146","16.9","17.2"
"Tattnall","2020-07-08","32","1339","7","153","16.1","17.2"
"Tattnall","2020-07-09","37","1376","8","161","18.3","17.7"
"Tattnall","2020-07-10","36","1412","8","169","18.6","18.6"
"Tattnall","2020-07-11","10","1422","3","172","22.9","19.6"
"Tattnall","2020-07-12","3","1425","1","173","22.9","20.6"
"Tattnall","2020-07-13","51","1476","18","191","25.5","21.7"
"Tattnall","2020-07-14","55","1531","19","210","28.4","22.7"
"Tattnall","2020-07-15","35","1566","12","222","30.2","23.1"
"Tattnall","2020-07-16","46","1612","15","237","31.8","25"
"Tattnall","2020-07-17","39","1651","15","252","34.1","26.4"
"Tattnall","2020-07-18","8","1659","3","255","35.1","29"
"Tattnall","2020-07-19","5","1664","1","256","33.2","28.1"
"Tattnall","2020-07-20","47","1711","12","268","31.8","28.7"
"Tattnall","2020-07-21","31","1742","7","275","30.1","29.3"
"Tattnall","2020-07-22","30","1772","7","282","28.6","29.4"
"Tattnall","2020-07-23","35","1807","12","294","28.8","30.3"
"Tattnall","2020-07-24","39","1846","7","301","25.9","30"
"Tattnall","2020-07-25","14","1860","8","309","28.7","31.9"
"Tattnall","2020-07-26","8","1868","1","310","27.6","30.4"
"Tattnall","2020-07-27","51","1919","13","323","27.6","29.7"
"Tattnall","2020-07-28","24","1943","9","332","29.7","29.9"
"Tattnall","2020-07-29","30","1973","7","339","29.7","29.2"
"Tattnall","2020-07-30","40","2013","10","349","28.4","28.6"
"Tattnall","2020-07-31","58","2071","9","358","28.1","27"
"Tattnall","2020-08-01","8","2079","4","362","27","27.9"
"Tattnall","2020-08-02","7","2086","4","366","33.4","30.5"
"Tattnall","2020-08-03","46","2132","13","379","33.8","30.7"
"Tattnall","2020-08-04","36","2168","8","387","31.6","30.7"
"Tattnall","2020-08-05","43","2211","9","396","31.3","30.5"
"Tattnall","2020-08-06","34","2245","5","401","29.8","29.1"
"Tattnall","2020-08-07","36","2281","8","409","30.8","29.4"
"Tattnall","2020-08-08","17","2298","4","413","27","27"
"Tattnall","2020-08-09","7","2305","1","414","20.9","27.2"
"Tattnall","2020-08-10","43","2348","12","426","20.8","27.3"
"Tattnall","2020-08-11","46","2394","12","438","21.4","26.5"
"Tattnall","2020-08-12","33","2427","12","450","23.6","27.4"
"Tattnall","2020-08-13","21","2448","4","454","24.2","27"
"Tattnall","2020-08-14","35","2483","3","457","22.3","26.5"
"Tattnall","2020-08-15","13","2496","4","461","23.3","25.1"
"Tattnall","2020-08-16","11","2507","2","463","23.8","22.4"
"Tattnall","2020-08-17","38","2545","6","469","22.1","21.5"
"Tattnall","2020-08-18","28","2573","3","472","19.9","20.7"
"Tattnall","2020-08-19","30","2603","6","478","17.6","20.6"
"Tattnall","2020-08-20","35","2638","5","483","16.9","20.6"
"Tattnall","2020-08-21","21","2659","4","487","18.4","20.3"
"Tattnall","2020-08-22","15","2674","1","488","15","19.1"
"Tattnall","2020-08-23","15","2689","3","491","15.2","19.5"
"Tattnall","2020-08-24","36","2725","3","494","14.1","18.1"
"Tattnall","2020-08-25","32","2757","3","497","14","16.9"
"Tattnall","2020-08-26","26","2783","3","500","12.7","15.2"
"Tattnall","2020-08-27","21","2804","2","502","12.1","14.5"
"Tattnall","2020-08-28","22","2826","1","503","10","14.2"
"Tattnall","2020-08-29","14","2840","5","508","14.1","14.6"
"Tattnall","2020-08-30","11","2851","2","510","13.9","14.6"
"Tattnall","2020-08-31","34","2885","5","515","14.8","14.5"
"Tattnall","2020-09-01","19","2904","5","520","17.2","15.6"
"Tattnall","2020-09-02","25","2929","4","524","17.9","15.3"
"Tattnall","2020-09-03","24","2953","5","529","19.5","15.8"
"Tattnall","2020-09-04","29","2982","5","534","21.3","15.6"
"Tattnall","2020-09-05","12","2994","1","535","17.4","15.8"
"Tattnall","2020-09-06","7","3001","0","535","14.8","14.3"
"Tattnall","2020-09-07","10","3011","0","535","12.7","13.7"
"Tattnall","2020-09-08","36","3047","14","549","14.5","15.8"
"Tattnall","2020-09-09","27","3074","8","557","16.4","17.1"
"Tattnall","2020-09-10","23","3097","4","561","15.9","17.7"
"Tattnall","2020-09-11","29","3126","5","566","15.9","18.6"
"Tattnall","2020-09-12","11","3137","2","568","17.3","17.4"
"Tattnall","2020-09-13","7","3144","1","569","19.4","17.1"
"Tattnall","2020-09-14","41","3185","5","574","21.1","16.9"
"Tattnall","2020-09-15","45","3230","9","583","18.4","16.4"
"Tattnall","2020-09-16","33","3263","14","597","20.2","18.3"
"Tattnall","2020-09-17","40","3303","5","602","19.5","17.7"
"Tattnall","2020-09-18","32","3335","7","609","20.2","18.1"
"Tattnall","2020-09-19","13","3348","3","612","20.9","19.1"
"Tattnall","2020-09-20","9","3357","1","613","20.5","19.9"
"Tattnall","2020-09-21","52","3409","10","623","21.5","21.3"
"Tattnall","2020-09-22","52","3461","4","627","19.7","19.1"
"Tattnall","2020-09-23","29","3490","4","631","15.6","17.9"
"Tattnall","2020-09-24","29","3519","3","634","15.3","17.4"
"Tattnall","2020-09-25","31","3550","3","637","13.6","16.9"
"Tattnall","2020-09-26","4","3554","0","637","10.3","15.6"
"Tattnall","2020-09-27","6","3560","1","638","11.1","15.8"
"Tattnall","2020-09-28","52","3612","3","641","9.1","15.3"
"Tattnall","2020-09-29","34","3646","2","643","8.9","14.3"
"Tattnall","2020-09-30","22","3668","4","647","9.5","12.6"
"Tattnall","2020-10-01","16","3684","3","650","10.7","13"
"Tattnall","2020-10-02","58","3742","3","653","10.1","11.8"
"Tattnall","2020-10-03","11","3753","3","656","14","12.1"
"Tattnall","2020-10-04","5","3758","2","658","17.3","14.2"
"Tattnall","2020-10-05","58","3816","5","663","17.7","13.4"
"Tattnall","2020-10-06","32","3848","3","666","18.2","13.5"
"Tattnall","2020-10-07","28","3876","3","669","17.1","13.3"
"Tattnall","2020-10-08","16","3892","2","671","16.2","13.5"
"Tattnall","2020-10-09","17","3909","0","671","15.5","12.8"
"Tattnall","2020-10-10","8","3917","2","673","15.2","14.6"
"Tattnall","2020-10-11","3","3920","1","674","14.2","15.8"
"Tattnall","2020-10-12","14","3934","0","674","13","15.3"
"Tattnall","2020-10-13","93","4027","16","690","14.1","16.2"
"Tattnall","2020-10-14","20","4047","5","695","16.1","16.6"
"Tattnall","2020-10-15","63","4110","5","700","15.5","15.9"
"Tattnall","2020-10-16","21","4131","7","707","20.3","17.9"
"Tattnall","2020-10-17","8","4139","0","707","16.7","15.9"
"Tattnall","2020-10-18","3","4142","0","707","11.9","13.1"
"Tattnall","2020-10-19","28","4170","5","712","14.5","13.7"
"Tattnall","2020-10-20","27","4197","3","715","13.6","13.9"
"Tattnall","2020-10-21","18","4215","2","717","11.6","13.9"
"Tattnall","2020-10-22","14","4229","2","719","12.5","14"
"Tattnall","2020-10-23","19","4248","3","722","10","15.1"
"Tattnall","2020-10-24","11","4259","0","722","10","13.4"
"Tattnall","2020-10-25","5","4264","0","722","10","11"
"Tattnall","2020-10-26","39","4303","6","728","9.7","12.1"
"Tattnall","2020-10-27","51","4354","9","737","10.6","12.1"
"Tattnall","2020-10-28","23","4377","1","738","9.6","10.6"
"Tattnall","2020-10-29","19","4396","3","741","9.9","11.2"
"Tattnall","2020-10-30","18","4414","2","743","9.2","9.6"
"Tattnall","2020-10-31","7","4421","0","743","9.2","9.6"
"Tattnall","2020-11-01","5","4426","0","743","9.2","9.6"
"Tattnall","2020-11-02","15","4441","3","746","9.8","9.8"
"Tattnall","2020-11-03","28","4469","5","751","9.9","10.2"
"Tattnall","2020-11-04","14","4483","1","752","10.3","10"
"Tattnall","2020-11-05","9","4492","1","753","9.6","9.7"
"Tattnall","2020-11-06","117","4609","2","755","8.3","8.7"
"Tattnall","2020-11-07","10","4619","1","756","9.7","9.4"
"Tattnall","2020-11-08","6","4625","1","757","12.1","10.6"
"Tattnall","2020-11-09","26","4651","4","761","11.4","10.6"
"Tattnall","2020-11-10","19","4670","2","763","10.4","10.1"
"Tattnall","2020-11-11","20","4690","3","766","11.5","10.9"
"Tattnall","2020-11-12","113","4803","1","767","10","9.8"
"Tattnall","2020-11-13","21","4824","0","767","9.8","9"
"Tattnall","2020-11-14","13","4837","0","767","8.4","9"
"Tattnall","2020-11-15","6","4843","1","768","8.4","10.2"
"Tattnall","2020-11-16","34","4877","4","772","7.8","9.6"
"Tattnall","2020-11-17","70","4947","3","775","6.9","8.7"
"Tattnall","2020-11-18","22","4969","2","777","6.1","8.8"
"Tattnall","2020-11-19","52","5021","1","778","6.2","8.1"
"Tattnall","2020-11-20","25","5046","3","781","8","8.9"
"Tattnall","2020-11-21","5","5051","0","781","8","8.2"
"Tattnall","2020-11-22","7","5058","0","781","5.6","7"
"Tattnall","2020-11-23","36","5094","8","789","7.1","7.5"
"Tattnall","2020-11-24","47","5141","1","790","6.8","6.9"
"Tattnall","2020-11-25","21","5162","1","791","6.1","6.1"
"Tattnall","2020-11-26","4","5166","0","791","5.9","6.1"
"Tattnall","2020-11-27","9","5175","2","793","7.3","7.6"
"Tattnall","2020-11-28","9","5184","3","796","12.1","10"
"Tattnall","2020-11-29","11","5195","3","799","16","10.8"
"Tattnall","2020-11-30","86","5281","9","808","14.3","10.7"
"Tattnall","2020-12-01","53","5334","6","814","15.6","11.2"
"Tattnall","2020-12-02","37","5371","9","823","18.4","12.3"
"Tattnall","2020-12-03","20","5391","6","829","22.7","14.3"
"Tattnall","2020-12-04","74","5465","6","835","20.7","14"
"Tattnall","2020-12-05","14","5479","4","839","20","16.1"
"Tattnall","2020-12-06","8","5487","1","840","17.9","16.9"
"Tattnall","2020-12-07","43","5530","8","848","19.1","16.7"
"Tattnall","2020-12-08","41","5571","6","854","19.5","17.6"
"Tattnall","2020-12-09","32","5603","5","859","18.3","18.4"
"Tattnall","2020-12-10","39","5642","5","864","15.8","19.3"
"Tattnall","2020-12-11","40","5682","11","875","18.6","19.6"
"Tattnall","2020-12-12","10","5692","0","875","14.5","17.3"
"Tattnall","2020-12-13","12","5704","4","879","17.5","17.7"
"Tattnall","2020-12-14","107","5811","20","899","17.5","18.3"
"Tattnall","2020-12-15","72","5883","7","906","16.8","18.2"
"Tattnall","2020-12-16","25","5908","6","912","18","18.2"
"Tattnall","2020-12-17","162","6070","11","923","17.1","16.5"
"Tattnall","2020-12-18","22","6092","5","928","16.5","17.5"
"Tattnall","2020-12-19","27","6119","4","932","18.6","16.6"
"Tattnall","2020-12-20","10","6129","3","935","18.1","17.8"
"Tattnall","2020-12-21","181","6310","17","952","16.8","17.1"
"Tattnall","2020-12-22","67","6377","11","963","17.7","17.3"
"Tattnall","2020-12-23","41","6418","17","980","20.2","19.1"
"Tattnall","2020-12-24","20","6438","3","983","21.4","19.3"
"Tattnall","2020-12-25","1","6439","0","983","18.2","17.3"
"Tattnall","2020-12-26","16","6455","6","989","21.4","20"
"Tattnall","2020-12-27","10","6465","6","995","25.7","21.9"
"Tattnall","2020-12-28","86","6551","25","1020","28.5","22.6"
"Tattnall","2020-12-29","78","6629","20","1040","29.8","23.8"
"Tattnall","2020-12-30","43","6672","11","1051","27.5","23.9"
"Tattnall","2020-12-31","50","6722","14","1065","29.4","25.4"
"Tattnall","2021-01-01","10","6732","1","1066","30.8","24.5"
"Tattnall","2021-01-02","11","6743","4","1070","30.7","26"
"Tattnall","2021-01-03","15","6758","4","1074","25.9","25.8"
"Tattnall","2021-01-04","95","6853","23","1097","25.2","26.9"
"Tattnall","2021-01-05","157","7010","40","1137","25.2","27.5"
"Tattnall","2021-01-06","64","7074","21","1158","26.2","26.9"
"Tattnall","2021-01-07","131","7205","17","1175","24.1","26.7"
"Tattnall","2021-01-08","52","7257","12","1187","25.9","28.4"
"Tattnall","2021-01-09","34","7291","11","1198","25.4","28"
"Tattnall","2021-01-10","30","7321","3","1201","23","24.4"
"Tattnall","2021-01-11","104","7425","26","1227","23.1","24.2"
"Tattnall","2021-01-12","68","7493","8","1235","21.1","23.2"
"Tattnall","2021-01-13","40","7533","8","1243","19.3","22.8"
"Tattnall","2021-01-14","109","7642","18","1261","19.8","21.9"
"Tattnall","2021-01-15","38","7680","3","1264","17.6","21.8"
"Tattnall","2021-01-16","19","7699","6","1270","17.5","21.5"
"Tattnall","2021-01-17","10","7709","3","1273","20.4","21.7"
"Tattnall","2021-01-18","66","7775","13","1286","19.6","21.4"
"Tattnall","2021-01-19","44","7819","10","1296","21.2","21.2"
"Tattnall","2021-01-20","45","7864","14","1310","22.8","21"
"Tattnall","2021-01-21","60","7924","7","1317","22.1","21"
"Tattnall","2021-01-22","106","8030","4","1321","21.5","19.6"
"Tattnall","2021-01-23","13","8043","4","1325","21.4","19.5"
"Tattnall","2021-01-24","8","8051","2","1327","20.7","20.5"
"Tattnall","2021-01-25","13","8064","4","1331","22.3","20.9"
"Tattnall","2021-01-26","6","8070","1","1332","21.4","21.3"
"Tattnall","2021-01-27","0","8070","0","1332","16.9","19.9"
"Taylor","2020-02-01","0","0","0","0",".","."
"Taylor","2020-02-02","0","0","0","0",".","."
"Taylor","2020-02-03","0","0","0","0",".","."
"Taylor","2020-02-04","0","0","0","0",".","."
"Taylor","2020-02-05","0","0","0","0",".","."
"Taylor","2020-02-06","0","0","0","0",".","."
"Taylor","2020-02-07","0","0","0","0","0","."
"Taylor","2020-02-08","0","0","0","0","0","."
"Taylor","2020-02-09","0","0","0","0","0","."
"Taylor","2020-02-10","0","0","0","0","0","."
"Taylor","2020-02-11","0","0","0","0","0","."
"Taylor","2020-02-12","0","0","0","0","0","."
"Taylor","2020-02-13","0","0","0","0","0","."
"Taylor","2020-02-14","0","0","0","0","0","0"
"Taylor","2020-02-15","0","0","0","0","0","0"
"Taylor","2020-02-16","0","0","0","0","0","0"
"Taylor","2020-02-17","0","0","0","0","0","0"
"Taylor","2020-02-18","0","0","0","0","0","0"
"Taylor","2020-02-19","0","0","0","0","0","0"
"Taylor","2020-02-20","0","0","0","0","0","0"
"Taylor","2020-02-21","0","0","0","0","0","0"
"Taylor","2020-02-22","0","0","0","0","0","0"
"Taylor","2020-02-23","0","0","0","0","0","0"
"Taylor","2020-02-24","0","0","0","0","0","0"
"Taylor","2020-02-25","0","0","0","0","0","0"
"Taylor","2020-02-26","0","0","0","0","0","0"
"Taylor","2020-02-27","0","0","0","0","0","0"
"Taylor","2020-02-28","0","0","0","0","0","0"
"Taylor","2020-02-29","0","0","0","0","0","0"
"Taylor","2020-03-01","0","0","0","0","0","0"
"Taylor","2020-03-02","0","0","0","0","0","0"
"Taylor","2020-03-03","0","0","0","0","0","0"
"Taylor","2020-03-04","0","0","0","0","0","0"
"Taylor","2020-03-05","0","0","0","0","0","0"
"Taylor","2020-03-06","0","0","0","0","0","0"
"Taylor","2020-03-07","0","0","0","0","0","0"
"Taylor","2020-03-08","0","0","0","0","0","0"
"Taylor","2020-03-09","0","0","0","0","0","0"
"Taylor","2020-03-10","0","0","0","0","0","0"
"Taylor","2020-03-11","2","2","0","0","0","0"
"Taylor","2020-03-12","0","2","0","0","0","0"
"Taylor","2020-03-13","0","2","0","0","0","0"
"Taylor","2020-03-14","0","2","0","0","0","0"
"Taylor","2020-03-15","0","2","0","0","0","0"
"Taylor","2020-03-16","0","2","0","0","0","0"
"Taylor","2020-03-17","1","3","0","0","0","0"
"Taylor","2020-03-18","2","5","0","0","0","0"
"Taylor","2020-03-19","3","8","0","0","0","0"
"Taylor","2020-03-20","1","9","0","0","0","0"
"Taylor","2020-03-21","0","9","0","0","0","0"
"Taylor","2020-03-22","1","10","1","1","14.3","7.1"
"Taylor","2020-03-23","2","12","0","1","14.3","7.1"
"Taylor","2020-03-24","3","15","0","1","14.3","7.1"
"Taylor","2020-03-25","5","20","1","2","17.1","8.6"
"Taylor","2020-03-26","1","21","1","3","31.4","15.7"
"Taylor","2020-03-27","3","24","0","3","31.4","15.7"
"Taylor","2020-03-28","0","24","0","3","31.4","15.7"
"Taylor","2020-03-29","0","24","0","3","17.1","15.7"
"Taylor","2020-03-30","2","26","0","3","17.1","15.7"
"Taylor","2020-03-31","0","26","0","3","17.1","15.7"
"Taylor","2020-04-01","4","30","2","5","21.4","19.3"
"Taylor","2020-04-02","5","35","3","8","15.7","23.6"
"Taylor","2020-04-03","1","36","0","8","15.7","23.6"
"Taylor","2020-04-04","0","36","0","8","15.7","23.6"
"Taylor","2020-04-05","2","38","2","10","30","23.6"
"Taylor","2020-04-06","3","41","0","10","30","23.6"
"Taylor","2020-04-07","11","52","1","11","31.3","24.2"
"Taylor","2020-04-08","4","56","2","13","31.3","26.4"
"Taylor","2020-04-09","5","61","2","15","28.4","22.1"
"Taylor","2020-04-10","1","62","0","15","28.4","22.1"
"Taylor","2020-04-11","1","63","0","15","28.4","22.1"
"Taylor","2020-04-12","0","63","0","15","14.2","22.1"
"Taylor","2020-04-13","0","63","0","15","14.2","22.1"
"Taylor","2020-04-14","3","66","2","17","22.4","26.8"
"Taylor","2020-04-15","2","68","1","18","22.4","26.8"
"Taylor","2020-04-16","4","72","0","18","16.7","22.6"
"Taylor","2020-04-17","6","78","0","18","16.7","22.6"
"Taylor","2020-04-18","0","78","0","18","16.7","22.6"
"Taylor","2020-04-19","0","78","0","18","16.7","15.4"
"Taylor","2020-04-20","6","84","2","20","21.4","17.8"
"Taylor","2020-04-21","3","87","0","20","11.9","17.1"
"Taylor","2020-04-22","9","96","1","21","6.3","14.4"
"Taylor","2020-04-23","6","102","0","21","6.3","11.5"
"Taylor","2020-04-24","3","105","1","22","11.1","13.9"
"Taylor","2020-04-25","0","105","0","22","11.1","13.9"
"Taylor","2020-04-26","1","106","0","22","11.1","13.9"
"Taylor","2020-04-27","4","110","0","22","6.3","13.9"
"Taylor","2020-04-28","4","114","0","22","6.3","9.1"
"Taylor","2020-04-29","5","119","2","24","10.5","8.4"
"Taylor","2020-04-30","4","123","0","24","10.5","8.4"
"Taylor","2020-05-01","4","127","1","25","9.3","10.2"
"Taylor","2020-05-02","4","131","0","25","9.3","10.2"
"Taylor","2020-05-03","4","135","0","25","9.3","10.2"
"Taylor","2020-05-04","5","140","0","25","9.3","7.8"
"Taylor","2020-05-05","4","144","0","25","9.3","7.8"
"Taylor","2020-05-06","1","145","0","25","3.6","7"
"Taylor","2020-05-07","8","153","2","27","7.1","8.8"
"Taylor","2020-05-08","3","156","0","27","3.6","6.4"
"Taylor","2020-05-09","1","157","0","27","3.6","6.4"
"Taylor","2020-05-10","2","159","0","27","3.6","6.4"
"Taylor","2020-05-11","7","166","0","27","3.6","6.4"
"Taylor","2020-05-12","6","172","0","27","3.6","6.4"
"Taylor","2020-05-13","8","180","0","27","3.6","3.6"
"Taylor","2020-05-14","13","193","1","28","1.1","4.1"
"Taylor","2020-05-15","10","203","0","28","1.1","2.3"
"Taylor","2020-05-16","1","204","0","28","1.1","2.3"
"Taylor","2020-05-17","1","205","0","28","1.1","2.3"
"Taylor","2020-05-18","6","211","1","29","3.5","3.5"
"Taylor","2020-05-19","2","213","0","29","3.5","3.5"
"Taylor","2020-05-20","5","218","0","29","3.5","3.5"
"Taylor","2020-05-21","9","227","2","31","5.6","3.3"
"Taylor","2020-05-22","2","229","0","31","5.6","3.3"
"Taylor","2020-05-23","1","230","0","31","5.6","3.3"
"Taylor","2020-05-24","0","230","0","31","5.6","3.3"
"Taylor","2020-05-25","2","232","0","31","3.2","3.3"
"Taylor","2020-05-26","3","235","0","31","3.2","3.3"
"Taylor","2020-05-27","9","244","0","31","3.2","3.3"
"Taylor","2020-05-28","11","255","0","31","0","2.8"
"Taylor","2020-05-29","6","261","0","31","0","2.8"
"Taylor","2020-05-30","0","261","0","31","0","2.8"
"Taylor","2020-05-31","2","263","0","31","0","2.8"
"Taylor","2020-06-01","5","268","0","31","0","1.6"
"Taylor","2020-06-02","6","274","0","31","0","1.6"
"Taylor","2020-06-03","4","278","0","31","0","1.6"
"Taylor","2020-06-04","5","283","0","31","0","0"
"Taylor","2020-06-05","10","293","1","32","1.4","0.7"
"Taylor","2020-06-06","0","293","0","32","1.4","0.7"
"Taylor","2020-06-07","1","294","0","32","1.4","0.7"
"Taylor","2020-06-08","5","299","0","32","1.4","0.7"
"Taylor","2020-06-09","5","304","1","33","4.3","2.1"
"Taylor","2020-06-10","5","309","0","33","4.3","2.1"
"Taylor","2020-06-11","11","320","1","34","5.6","2.8"
"Taylor","2020-06-12","5","325","1","35","7","4.2"
"Taylor","2020-06-13","1","326","0","35","7","4.2"
"Taylor","2020-06-14","6","332","0","35","7","4.2"
"Taylor","2020-06-15","4","336","0","35","7","4.2"
"Taylor","2020-06-16","15","351","0","35","4.2","4.2"
"Taylor","2020-06-17","10","361","0","35","4.2","4.2"
"Taylor","2020-06-18","11","372","0","35","2.9","4.2"
"Taylor","2020-06-19","9","381","1","36","1.6","4.3"
"Taylor","2020-06-20","2","383","0","36","1.6","4.3"
"Taylor","2020-06-21","17","400","0","36","1.6","4.3"
"Taylor","2020-06-22","9","409","0","36","1.6","4.3"
"Taylor","2020-06-23","10","419","0","36","1.6","2.9"
"Taylor","2020-06-24","6","425","0","36","1.6","2.9"
"Taylor","2020-06-25","23","448","0","36","1.6","2.2"
"Taylor","2020-06-26","8","456","0","36","0","0.8"
"Taylor","2020-06-27","1","457","0","36","0","0.8"
"Taylor","2020-06-28","2","459","0","36","0","0.8"
"Taylor","2020-06-29","7","466","0","36","0","0.8"
"Taylor","2020-06-30","23","489","0","36","0","0.8"
"Taylor","2020-07-01","9","498","0","36","0","0.8"
"Taylor","2020-07-02","9","507","0","36","0","0.8"
"Taylor","2020-07-03","2","509","0","36","0","0"
"Taylor","2020-07-04","1","510","0","36","0","0"
"Taylor","2020-07-05","0","510","0","36","0","0"
"Taylor","2020-07-06","21","531","2","38","1.4","0.7"
"Taylor","2020-07-07","8","539","0","38","1.4","0.7"
"Taylor","2020-07-08","28","567","6","44","4.4","2.2"
"Taylor","2020-07-09","14","581","1","45","5.4","2.7"
"Taylor","2020-07-10","24","605","7","52","9.6","4.8"
"Taylor","2020-07-11","1","606","0","52","9.6","4.8"
"Taylor","2020-07-12","1","607","0","52","9.6","4.8"
"Taylor","2020-07-13","7","614","0","52","8.2","4.8"
"Taylor","2020-07-14","21","635","1","53","8.9","5.1"
"Taylor","2020-07-15","10","645","2","55","8.7","6.6"
"Taylor","2020-07-16","22","667","0","55","7.7","6.6"
"Taylor","2020-07-17","21","688","2","57","4.9","7.3"
"Taylor","2020-07-18","4","692","0","57","4.9","7.3"
"Taylor","2020-07-19","2","694","0","57","4.9","7.3"
"Taylor","2020-07-20","8","702","1","58","6.7","7.5"
"Taylor","2020-07-21","25","727","4","62","8.3","8.6"
"Taylor","2020-07-22","12","739","0","62","5.4","7.1"
"Taylor","2020-07-23","21","760","1","63","6.1","6.9"
"Taylor","2020-07-24","29","789","6","69","7.7","6.3"
"Taylor","2020-07-25","4","793","0","69","7.7","6.3"
"Taylor","2020-07-26","3","796","0","69","7.7","6.3"
"Taylor","2020-07-27","5","801","2","71","11.6","9.2"
"Taylor","2020-07-28","25","826","0","71","9.4","8.8"
"Taylor","2020-07-29","2","828","0","71","9.4","7.4"
"Taylor","2020-07-30","34","862","3","74","9.9","8"
"Taylor","2020-07-31","12","874","3","77","10.5","9.1"
"Taylor","2020-08-01","5","879","2","79","16.3","12"
"Taylor","2020-08-02","2","881","0","79","16.3","12"
"Taylor","2020-08-03","7","888","0","79","10.5","11.1"
"Taylor","2020-08-04","48","936","1","80","10.8","10.1"
"Taylor","2020-08-05","6","942","0","80","10.8","10.1"
"Taylor","2020-08-06","19","961","0","80","9.6","9.8"
"Taylor","2020-08-07","24","985","8","88","10.8","10.7"
"Taylor","2020-08-08","2","987","0","88","5.1","10.7"
"Taylor","2020-08-09","6","993","0","88","5.1","10.7"
"Taylor","2020-08-10","7","1000","1","89","7.1","8.8"
"Taylor","2020-08-11","34","1034","7","96","9.7","10.3"
"Taylor","2020-08-12","2","1036","2","98","24","17.4"
"Taylor","2020-08-13","13","1049","0","98","24","16.8"
"Taylor","2020-08-14","22","1071","3","101","21.2","16"
"Taylor","2020-08-15","5","1076","1","102","24.1","14.6"
"Taylor","2020-08-16","6","1082","1","103","26.5","15.8"
"Taylor","2020-08-17","12","1094","1","104","25.6","16.4"
"Taylor","2020-08-18","16","1110","1","105","23.6","16.6"
"Taylor","2020-08-19","4","1114","0","105","9.3","16.6"
"Taylor","2020-08-20","17","1131","1","106","10.1","17.1"
"Taylor","2020-08-21","10","1141","2","108","11","16.1"
"Taylor","2020-08-22","2","1143","1","109","15.3","19.7"
"Taylor","2020-08-23","10","1153","3","112","17.2","21.8"
"Taylor","2020-08-24","14","1167","2","114","18.1","21.8"
"Taylor","2020-08-25","24","1191","1","115","17.8","20.7"
"Taylor","2020-08-26","18","1209","3","118","20.1","14.7"
"Taylor","2020-08-27","57","1266","13","131","22.6","16.3"
"Taylor","2020-08-28","20","1286","3","134","21.8","16.4"
"Taylor","2020-08-29","2","1288","0","134","14.7","15"
"Taylor","2020-08-30","8","1296","1","135","12.2","14.7"
"Taylor","2020-08-31","14","1310","1","136","11.2","14.6"
"Taylor","2020-09-01","15","1325","2","138","12.5","15.1"
"Taylor","2020-09-02","6","1331","1","139","12.5","16.3"
"Taylor","2020-09-03","14","1345","1","140","10.3","16.4"
"Taylor","2020-09-04","13","1358","4","144","12.5","17.2"
"Taylor","2020-09-05","5","1363","0","144","12.5","13.6"
"Taylor","2020-09-06","6","1369","1","145","13.1","12.7"
"Taylor","2020-09-07","5","1374","0","145","12.1","11.6"
"Taylor","2020-09-08","20","1394","5","150","13.7","13.1"
"Taylor","2020-09-09","7","1401","1","151","13.4","13"
"Taylor","2020-09-10","19","1420","3","154","14.6","12.4"
"Taylor","2020-09-11","11","1431","0","154","10.2","11.4"
"Taylor","2020-09-12","24","1455","3","157","12","12.3"
"Taylor","2020-09-13","5","1460","0","157","9.7","11.4"
"Taylor","2020-09-14","51","1511","13","170","13.3","12.7"
"Taylor","2020-09-15","35","1546","6","176","12.2","13"
"Taylor","2020-09-16","5","1551","2","178","15.8","14.6"
"Taylor","2020-09-17","8","1559","1","179","15.4","15"
"Taylor","2020-09-18","12","1571","0","179","15.4","12.8"
"Taylor","2020-09-19","3","1574","1","180","18.4","15.2"
"Taylor","2020-09-20","3","1577","0","180","18.4","14"
"Taylor","2020-09-21","6","1583","0","180","14.7","14"
"Taylor","2020-09-22","14","1597","3","183","15.3","13.7"
"Taylor","2020-09-23","5","1602","0","183","9.6","12.7"
"Taylor","2020-09-24","10","1612","1","184","9.3","12.3"
"Taylor","2020-09-25","14","1626","1","185","10.3","12.8"
"Taylor","2020-09-26","3","1629","1","186","10.3","14.3"
"Taylor","2020-09-27","4","1633","2","188","17.4","17.9"
"Taylor","2020-09-28","8","1641","0","188","17.4","16.1"
"Taylor","2020-09-29","34","1675","0","188","14.4","14.8"
"Taylor","2020-09-30","3","1678","1","189","19.1","14.4"
"Taylor","2020-10-01","23","1701","1","190","18.3","13.8"
"Taylor","2020-10-02","5","1706","0","190","17.3","13.8"
"Taylor","2020-10-03","7","1713","0","190","12.5","11.4"
"Taylor","2020-10-04","4","1717","0","190","5.4","11.4"
"Taylor","2020-10-05","8","1725","0","190","5.4","11.4"
"Taylor","2020-10-06","23","1748","0","190","5.4","9.9"
"Taylor","2020-10-07","2","1750","0","190","0.6","9.9"
"Taylor","2020-10-08","29","1779","0","190","0","9.2"
"Taylor","2020-10-09","10","1789","1","191","1.4","9.4"
"Taylor","2020-10-10","4","1793","1","192","5","8.8"
"Taylor","2020-10-11","1","1794","0","192","5","5.2"
"Taylor","2020-10-12","6","1800","0","192","5","5.2"
"Taylor","2020-10-13","19","1819","1","193","5.8","5.6"
"Taylor","2020-10-14","3","1822","0","193","5.8","3.2"
"Taylor","2020-10-15","17","1839","0","193","5.8","2.9"
"Taylor","2020-10-16","8","1847","1","194","6.1","3.8"
"Taylor","2020-10-17","1","1848","0","194","2.5","3.8"
"Taylor","2020-10-18","2","1850","0","194","2.5","3.8"
"Taylor","2020-10-19","6","1856","2","196","7.3","6.1"
"Taylor","2020-10-20","17","1873","1","197","7.4","6.6"
"Taylor","2020-10-21","11","1884","0","197","7.4","6.6"
"Taylor","2020-10-22","6","1890","2","199","12.1","9"
"Taylor","2020-10-23","7","1897","2","201","14.4","10.3"
"Taylor","2020-10-24","3","1900","0","201","14.4","8.5"
"Taylor","2020-10-25","2","1902","0","201","14.4","8.5"
"Taylor","2020-10-26","6","1908","0","201","9.7","8.5"
"Taylor","2020-10-27","12","1920","5","206","14.8","11.1"
"Taylor","2020-10-28","4","1924","0","206","14.8","11.1"
"Taylor","2020-10-29","9","1933","3","209","14.8","13.5"
"Taylor","2020-10-30","10","1943","2","211","13.6","14"
"Taylor","2020-10-31","3","1946","0","211","13.6","14"
"Taylor","2020-11-01","2","1948","0","211","13.6","14"
"Taylor","2020-11-02","6","1954","0","211","13.6","11.6"
"Taylor","2020-11-03","17","1971","2","213","9.3","12"
"Taylor","2020-11-04","10","1981","2","215","12.2","13.5"
"Taylor","2020-11-05","9","1990","0","215","7.4","11.1"
"Taylor","2020-11-06","12","2002","1","216","5.7","9.6"
"Taylor","2020-11-07","3","2005","0","216","5.7","9.6"
"Taylor","2020-11-08","4","2009","2","218","12.9","13.2"
"Taylor","2020-11-09","8","2017","0","218","12.9","13.2"
"Taylor","2020-11-10","14","2031","1","219","12.2","10.8"
"Taylor","2020-11-11","7","2038","1","220","11.4","11.8"
"Taylor","2020-11-12","15","2053","1","221","12.3","9.9"
"Taylor","2020-11-13","7","2060","1","222","13.2","9.5"
"Taylor","2020-11-14","1","2061","0","222","13.2","9.5"
"Taylor","2020-11-15","1","2062","0","222","6.1","9.5"
"Taylor","2020-11-16","14","2076","1","223","7.1","10"
"Taylor","2020-11-17","17","2093","0","223","6.1","9.1"
"Taylor","2020-11-18","11","2104","3","226","7.9","9.7"
"Taylor","2020-11-19","27","2131","4","230","9.1","10.7"
"Taylor","2020-11-20","12","2143","2","232","9.4","11.3"
"Taylor","2020-11-21","4","2147","1","233","13","13.1"
"Taylor","2020-11-22","2","2149","0","233","13","9.5"
"Taylor","2020-11-23","8","2157","1","234","13.8","10.4"
"Taylor","2020-11-24","26","2183","5","239","16.5","11.3"
"Taylor","2020-11-25","8","2191","2","241","16.2","12"
"Taylor","2020-11-26","1","2192","0","241","14.1","11.6"
"Taylor","2020-11-27","3","2195","2","243","21.2","15.3"
"Taylor","2020-11-28","1","2196","1","244","31.9","22.4"
"Taylor","2020-11-29","2","2198","1","245","39.1","26"
"Taylor","2020-11-30","5","2203","3","248","45.8","29.8"
"Taylor","2020-12-01","31","2234","2","250","44","30.3"
"Taylor","2020-12-02","6","2240","1","251","42.8","29.5"
"Taylor","2020-12-03","15","2255","3","254","45.7","29.9"
"Taylor","2020-12-04","7","2262","1","255","38.2","29.7"
"Taylor","2020-12-05","4","2266","0","255","23.9","27.9"
"Taylor","2020-12-06","3","2269","0","255","16.8","27.9"
"Taylor","2020-12-07","6","2275","2","257","13","29.4"
"Taylor","2020-12-08","19","2294","3","260","14.3","29.2"
"Taylor","2020-12-09","5","2299","3","263","20.5","31.7"
"Taylor","2020-12-10","19","2318","2","265","19.1","32.4"
"Taylor","2020-12-11","29","2347","6","271","20","29.1"
"Taylor","2020-12-12","6","2353","3","274","27.2","25.6"
"Taylor","2020-12-13","3","2356","1","275","32","24.4"
"Taylor","2020-12-14","8","2364","3","278","32.5","22.8"
"Taylor","2020-12-15","28","2392","3","281","31.8","23.1"
"Taylor","2020-12-16","11","2403","0","281","23.3","21.9"
"Taylor","2020-12-17","26","2429","3","284","23.4","21.3"
"Taylor","2020-12-18","10","2439","0","284","20.4","20.2"
"Taylor","2020-12-19","10","2449","4","288","19","23.1"
"Taylor","2020-12-20","8","2457","2","290","17.8","24.9"
"Taylor","2020-12-21","4","2461","0","290","12.5","22.5"
"Taylor","2020-12-22","34","2495","4","294","12.6","22.2"
"Taylor","2020-12-23","8","2503","2","296","16.2","19.7"
"Taylor","2020-12-24","5","2508","0","296","14.5","19"
"Taylor","2020-12-25","3","2511","1","297","19.3","19.9"
"Taylor","2020-12-26","10","2521","6","303","22.2","20.6"
"Taylor","2020-12-27","10","2531","4","307","24.3","21.1"
"Taylor","2020-12-28","15","2546","6","313","30","21.2"
"Taylor","2020-12-29","31","2577","3","316","29.7","21.2"
"Taylor","2020-12-30","10","2587","5","321","33.3","24.7"
"Taylor","2020-12-31","27","2614","5","326","35.9","25.2"
"Taylor","2021-01-01","3","2617","2","328","40.7","30"
"Taylor","2021-01-02","4","2621","1","329","35.7","28.9"
"Taylor","2021-01-03","5","2626","3","332","38.6","31.4"
"Taylor","2021-01-04","15","2641","3","335","35.7","32.9"
"Taylor","2021-01-05","31","2672","7","342","37.5","33.6"
"Taylor","2021-01-06","17","2689","8","350","37.1","35.2"
"Taylor","2021-01-07","29","2718","7","357","37.9","36.9"
"Taylor","2021-01-08","8","2726","1","358","30.2","35.4"
"Taylor","2021-01-09","6","2732","1","359","29","32.3"
"Taylor","2021-01-10","6","2738","3","362","27.6","33.1"
"Taylor","2021-01-11","11","2749","2","364","27.3","31.5"
"Taylor","2021-01-12","31","2780","10","374","28.7","33.1"
"Taylor","2021-01-13","13","2793","2","376","24.2","30.6"
"Taylor","2021-01-14","31","2824","6","382","23.5","30.7"
"Taylor","2021-01-15","10","2834","3","385","26","28.1"
"Taylor","2021-01-16","9","2843","4","389","29.9","29.5"
"Taylor","2021-01-17","18","2861","2","391","24.4","26"
"Taylor","2021-01-18","11","2872","2","393","24.4","25.8"
"Taylor","2021-01-19","18","2890","3","396","22.2","25.4"
"Taylor","2021-01-20","11","2901","0","396","20","22.1"
"Taylor","2021-01-21","29","2930","2","398","18.2","20.8"
"Taylor","2021-01-22","9","2939","2","400","17.1","21.5"
"Taylor","2021-01-23","4","2943","1","401","14.3","22.1"
"Taylor","2021-01-24","5","2948","2","403","18.4","21.4"
"Taylor","2021-01-25","1","2949","1","404","30.1","27.3"
"Taylor","2021-01-26","0","2949","0","404","27.7","24.9"
"Taylor","2021-01-27","0","2949","0","404","27.7","23.8"
"Telfair","2020-02-01","0","0","0","0",".","."
"Telfair","2020-02-02","0","0","0","0",".","."
"Telfair","2020-02-03","0","0","0","0",".","."
"Telfair","2020-02-04","0","0","0","0",".","."
"Telfair","2020-02-05","0","0","0","0",".","."
"Telfair","2020-02-06","0","0","0","0",".","."
"Telfair","2020-02-07","0","0","0","0","0","."
"Telfair","2020-02-08","0","0","0","0","0","."
"Telfair","2020-02-09","0","0","0","0","0","."
"Telfair","2020-02-10","0","0","0","0","0","."
"Telfair","2020-02-11","0","0","0","0","0","."
"Telfair","2020-02-12","0","0","0","0","0","."
"Telfair","2020-02-13","0","0","0","0","0","."
"Telfair","2020-02-14","0","0","0","0","0","0"
"Telfair","2020-02-15","0","0","0","0","0","0"
"Telfair","2020-02-16","0","0","0","0","0","0"
"Telfair","2020-02-17","0","0","0","0","0","0"
"Telfair","2020-02-18","0","0","0","0","0","0"
"Telfair","2020-02-19","0","0","0","0","0","0"
"Telfair","2020-02-20","0","0","0","0","0","0"
"Telfair","2020-02-21","0","0","0","0","0","0"
"Telfair","2020-02-22","0","0","0","0","0","0"
"Telfair","2020-02-23","0","0","0","0","0","0"
"Telfair","2020-02-24","0","0","0","0","0","0"
"Telfair","2020-02-25","0","0","0","0","0","0"
"Telfair","2020-02-26","0","0","0","0","0","0"
"Telfair","2020-02-27","0","0","0","0","0","0"
"Telfair","2020-02-28","0","0","0","0","0","0"
"Telfair","2020-02-29","0","0","0","0","0","0"
"Telfair","2020-03-01","0","0","0","0","0","0"
"Telfair","2020-03-02","0","0","0","0","0","0"
"Telfair","2020-03-03","0","0","0","0","0","0"
"Telfair","2020-03-04","0","0","0","0","0","0"
"Telfair","2020-03-05","0","0","0","0","0","0"
"Telfair","2020-03-06","0","0","0","0","0","0"
"Telfair","2020-03-07","0","0","0","0","0","0"
"Telfair","2020-03-08","0","0","0","0","0","0"
"Telfair","2020-03-09","0","0","0","0","0","0"
"Telfair","2020-03-10","0","0","0","0","0","0"
"Telfair","2020-03-11","0","0","0","0","0","0"
"Telfair","2020-03-12","0","0","0","0","0","0"
"Telfair","2020-03-13","0","0","0","0","0","0"
"Telfair","2020-03-14","0","0","0","0","0","0"
"Telfair","2020-03-15","1","1","0","0","0","0"
"Telfair","2020-03-16","0","1","0","0","0","0"
"Telfair","2020-03-17","1","2","0","0","0","0"
"Telfair","2020-03-18","1","3","0","0","0","0"
"Telfair","2020-03-19","4","7","0","0","0","0"
"Telfair","2020-03-20","7","14","0","0","0","0"
"Telfair","2020-03-21","0","14","0","0","0","0"
"Telfair","2020-03-22","1","15","0","0","0","0"
"Telfair","2020-03-23","8","23","0","0","0","0"
"Telfair","2020-03-24","11","34","0","0","0","0"
"Telfair","2020-03-25","1","35","0","0","0","0"
"Telfair","2020-03-26","2","37","0","0","0","0"
"Telfair","2020-03-27","1","38","0","0","0","0"
"Telfair","2020-03-28","0","38","0","0","0","0"
"Telfair","2020-03-29","1","39","0","0","0","0"
"Telfair","2020-03-30","0","39","0","0","0","0"
"Telfair","2020-03-31","2","41","1","1","7.1","3.6"
"Telfair","2020-04-01","1","42","1","2","21.4","10.7"
"Telfair","2020-04-02","2","44","0","2","21.4","10.7"
"Telfair","2020-04-03","4","48","0","2","21.4","10.7"
"Telfair","2020-04-04","4","52","1","3","25","12.5"
"Telfair","2020-04-05","2","54","0","3","25","12.5"
"Telfair","2020-04-06","1","55","0","3","25","12.5"
"Telfair","2020-04-07","13","68","2","5","20.1","13.6"
"Telfair","2020-04-08","3","71","0","5","5.8","13.6"
"Telfair","2020-04-09","8","79","0","5","5.8","13.6"
"Telfair","2020-04-10","2","81","0","5","5.8","13.6"
"Telfair","2020-04-11","9","90","1","6","3.8","14.4"
"Telfair","2020-04-12","3","93","0","6","3.8","14.4"
"Telfair","2020-04-13","8","101","2","8","7.4","16.2"
"Telfair","2020-04-14","6","107","0","8","5.2","12.6"
"Telfair","2020-04-15","3","110","0","8","5.2","5.5"
"Telfair","2020-04-16","4","114","0","8","5.2","5.5"
"Telfair","2020-04-17","4","118","0","8","5.2","5.5"
"Telfair","2020-04-18","2","120","1","9","10.7","7.2"
"Telfair","2020-04-19","1","121","1","10","25","14.4"
"Telfair","2020-04-20","38","159","1","11","21.8","14.6"
"Telfair","2020-04-21","10","169","3","14","26.1","15.6"
"Telfair","2020-04-22","6","175","0","14","26.1","15.6"
"Telfair","2020-04-23","2","177","0","14","26.1","15.6"
"Telfair","2020-04-24","7","184","4","18","34.3","19.7"
"Telfair","2020-04-25","0","184","0","18","27.1","18.9"
"Telfair","2020-04-26","1","185","0","18","12.8","18.9"
"Telfair","2020-04-27","4","189","0","18","12.4","17.1"
"Telfair","2020-04-28","8","197","1","19","9.9","18"
"Telfair","2020-04-29","3","200","0","19","9.9","18"
"Telfair","2020-04-30","4","204","0","19","9.9","18"
"Telfair","2020-05-01","6","210","1","20","4.2","19.2"
"Telfair","2020-05-02","1","211","0","20","4.2","15.6"
"Telfair","2020-05-03","2","213","0","20","4.2","8.5"
"Telfair","2020-05-04","5","218","0","20","4.2","8.3"
"Telfair","2020-05-05","7","225","0","20","2.4","6.2"
"Telfair","2020-05-06","4","229","0","20","2.4","6.2"
"Telfair","2020-05-07","1","230","0","20","2.4","6.2"
"Telfair","2020-05-08","3","233","1","21","4.8","4.5"
"Telfair","2020-05-09","4","237","0","21","4.8","4.5"
"Telfair","2020-05-10","0","237","0","21","4.8","4.5"
"Telfair","2020-05-11","2","239","0","21","4.8","4.5"
"Telfair","2020-05-12","1","240","0","21","4.8","3.6"
"Telfair","2020-05-13","6","246","0","21","4.8","3.6"
"Telfair","2020-05-14","5","251","0","21","4.8","3.6"
"Telfair","2020-05-15","3","254","0","21","0","2.4"
"Telfair","2020-05-16","3","257","0","21","0","2.4"
"Telfair","2020-05-17","2","259","0","21","0","2.4"
"Telfair","2020-05-18","8","267","0","21","0","2.4"
"Telfair","2020-05-19","5","272","0","21","0","2.4"
"Telfair","2020-05-20","8","280","0","21","0","2.4"
"Telfair","2020-05-21","4","284","0","21","0","2.4"
"Telfair","2020-05-22","9","293","0","21","0","0"
"Telfair","2020-05-23","2","295","0","21","0","0"
"Telfair","2020-05-24","2","297","0","21","0","0"
"Telfair","2020-05-25","4","301","0","21","0","0"
"Telfair","2020-05-26","7","308","0","21","0","0"
"Telfair","2020-05-27","1","309","0","21","0","0"
"Telfair","2020-05-28","11","320","1","22","1.3","0.6"
"Telfair","2020-05-29","7","327","0","22","1.3","0.6"
"Telfair","2020-05-30","2","329","0","22","1.3","0.6"
"Telfair","2020-05-31","0","329","0","22","1.3","0.6"
"Telfair","2020-06-01","5","334","0","22","1.3","0.6"
"Telfair","2020-06-02","10","344","0","22","1.3","0.6"
"Telfair","2020-06-03","5","349","0","22","1.3","0.6"
"Telfair","2020-06-04","1","350","0","22","0","0.6"
"Telfair","2020-06-05","4","354","0","22","0","0.6"
"Telfair","2020-06-06","2","356","2","24","14.3","7.8"
"Telfair","2020-06-07","0","356","0","24","14.3","7.8"
"Telfair","2020-06-08","9","365","0","24","14.3","7.8"
"Telfair","2020-06-09","9","374","0","24","14.3","7.8"
"Telfair","2020-06-10","2","376","1","25","21.4","11.4"
"Telfair","2020-06-11","7","383","0","25","21.4","10.7"
"Telfair","2020-06-12","7","390","5","30","31.6","15.8"
"Telfair","2020-06-13","4","394","2","32","24.5","19.4"
"Telfair","2020-06-14","0","394","0","32","24.5","19.4"
"Telfair","2020-06-15","4","398","0","32","24.5","19.4"
"Telfair","2020-06-16","11","409","2","34","27.1","20.7"
"Telfair","2020-06-17","3","412","1","35","24.7","23.1"
"Telfair","2020-06-18","6","418","2","37","29.5","25.4"
"Telfair","2020-06-19","6","424","0","37","19.3","25.4"
"Telfair","2020-06-20","0","424","0","37","12.1","18.3"
"Telfair","2020-06-21","2","426","1","38","19.3","21.9"
"Telfair","2020-06-22","8","434","3","41","24.6","24.6"
"Telfair","2020-06-23","7","441","1","42","24.1","25.6"
"Telfair","2020-06-24","10","451","1","43","20.7","22.7"
"Telfair","2020-06-25","16","467","1","44","16.9","23.2"
"Telfair","2020-06-26","7","474","0","44","16.9","18.1"
"Telfair","2020-06-27","2","476","0","44","16.9","14.5"
"Telfair","2020-06-28","1","477","1","45","24","21.6"
"Telfair","2020-06-29","6","483","2","47","23.4","24"
"Telfair","2020-06-30","6","489","0","47","21.4","22.7"
"Telfair","2020-07-01","9","498","1","48","21.5","21.1"
"Telfair","2020-07-02","12","510","3","51","24.2","20.5"
"Telfair","2020-07-03","5","515","1","52","27.1","22"
"Telfair","2020-07-04","1","516","1","53","41.3","29.1"
"Telfair","2020-07-05","2","518","1","54","34.2","29.1"
"Telfair","2020-07-06","6","524","0","54","29.4","26.4"
"Telfair","2020-07-07","6","530","1","55","31.8","26.6"
"Telfair","2020-07-08","6","536","3","58","37.4","29.5"
"Telfair","2020-07-09","4","540","2","60","41","32.6"
"Telfair","2020-07-10","5","545","1","61","41","34"
"Telfair","2020-07-11","1","546","0","61","26.7","34"
"Telfair","2020-07-12","2","548","0","61","19.5","26.9"
"Telfair","2020-07-13","5","553","1","62","22.4","25.9"
"Telfair","2020-07-14","6","559","1","63","22.4","27.1"
"Telfair","2020-07-15","6","565","2","65","20","28.7"
"Telfair","2020-07-16","5","570","0","65","12.9","26.9"
"Telfair","2020-07-17","8","578","1","66","11.8","26.4"
"Telfair","2020-07-18","3","581","1","67","16.5","21.6"
"Telfair","2020-07-19","0","581","0","67","16.5","18"
"Telfair","2020-07-20","6","587","1","68","16.1","19.2"
"Telfair","2020-07-21","2","589","0","68","13.7","18"
"Telfair","2020-07-22","1","590","0","68","8.9","14.5"
"Telfair","2020-07-23","3","593","1","69","13.7","13.3"
"Telfair","2020-07-24","9","602","0","69","11.9","11.8"
"Telfair","2020-07-25","0","602","0","69","7.1","11.8"
"Telfair","2020-07-26","0","602","0","69","7.1","11.8"
"Telfair","2020-07-27","3","605","1","70","9.5","12.8"
"Telfair","2020-07-28","11","616","0","70","9.5","11.6"
"Telfair","2020-07-29","3","619","1","71","14.3","11.6"
"Telfair","2020-07-30","15","634","5","76","14.3","14"
"Telfair","2020-07-31","4","638","1","77","17.9","14.9"
"Telfair","2020-08-01","4","642","0","77","17.9","12.5"
"Telfair","2020-08-02","0","642","0","77","17.9","12.5"
"Telfair","2020-08-03","8","650","0","77","13.1","11.3"
"Telfair","2020-08-04","2","652","0","77","13.1","11.3"
"Telfair","2020-08-05","8","660","2","79","11.9","13.1"
"Telfair","2020-08-06","6","666","2","81","11.9","13.1"
"Telfair","2020-08-07","3","669","1","82","13.1","15.5"
"Telfair","2020-08-08","3","672","0","82","13.1","15.5"
"Telfair","2020-08-09","2","674","2","84","27.4","22.6"
"Telfair","2020-08-10","14","688","1","85","28.4","20.7"
"Telfair","2020-08-11","7","695","0","85","28.4","20.7"
"Telfair","2020-08-12","1","696","0","85","24.8","18.4"
"Telfair","2020-08-13","3","699","0","85","20.1","16"
"Telfair","2020-08-14","2","701","0","85","15.3","14.2"
"Telfair","2020-08-15","18","719","3","88","17.7","15.4"
"Telfair","2020-08-16","0","719","0","88","3.4","15.4"
"Telfair","2020-08-17","6","725","1","89","4.8","16.6"
"Telfair","2020-08-18","5","730","0","89","4.8","16.6"
"Telfair","2020-08-19","11","741","1","90","6.1","15.4"
"Telfair","2020-08-20","4","745","0","90","6.1","13.1"
"Telfair","2020-08-21","3","748","1","91","10.8","13.1"
"Telfair","2020-08-22","5","753","1","92","11.3","14.5"
"Telfair","2020-08-23","0","753","0","92","11.3","7.4"
"Telfair","2020-08-24","4","757","0","92","8.9","6.8"
"Telfair","2020-08-25","10","767","1","93","10.3","7.6"
"Telfair","2020-08-26","5","772","0","93","9","7.6"
"Telfair","2020-08-27","6","778","1","94","11.4","8.7"
"Telfair","2020-08-28","5","783","1","95","9.5","10.2"
"Telfair","2020-08-29","3","786","0","95","6.7","9"
"Telfair","2020-08-30","6","792","0","95","6.7","9"
"Telfair","2020-08-31","9","801","1","96","8.3","8.6"
"Telfair","2020-09-01","9","810","0","96","6.8","8.6"
"Telfair","2020-09-02","6","816","1","97","9.2","9.1"
"Telfair","2020-09-03","7","823","2","99","10.9","11.2"
"Telfair","2020-09-04","3","826","0","99","8","8.8"
"Telfair","2020-09-05","1","827","0","99","8","7.4"
"Telfair","2020-09-06","8","835","0","99","8","7.4"
"Telfair","2020-09-07","5","840","0","99","6.5","7.4"
"Telfair","2020-09-08","7","847","0","99","6.5","6.6"
"Telfair","2020-09-09","6","853","1","100","6.5","7.8"
"Telfair","2020-09-10","8","861","2","102","6","8.4"
"Telfair","2020-09-11","3","864","1","103","10.7","9.4"
"Telfair","2020-09-12","3","867","0","103","10.7","9.4"
"Telfair","2020-09-13","2","869","1","104","17.9","13"
"Telfair","2020-09-14","11","880","1","105","19.2","12.8"
"Telfair","2020-09-15","16","896","0","105","19.2","12.8"
"Telfair","2020-09-16","6","902","1","106","19.2","12.8"
"Telfair","2020-09-17","13","915","1","107","16.7","11.3"
"Telfair","2020-09-18","8","923","1","108","13.7","12.2"
"Telfair","2020-09-19","1","924","1","109","28","19.4"
"Telfair","2020-09-20","5","929","0","109","20.8","19.4"
"Telfair","2020-09-21","8","937","0","109","19.6","19.4"
"Telfair","2020-09-22","10","947","1","110","21","20.1"
"Telfair","2020-09-23","3","950","0","110","18.6","18.9"
"Telfair","2020-09-24","4","954","0","110","17.5","17.1"
"Telfair","2020-09-25","3","957","0","110","15.7","14.7"
"Telfair","2020-09-26","1","958","0","110","1.4","14.7"
"Telfair","2020-09-27","1","959","1","111","15.7","18.3"
"Telfair","2020-09-28","8","967","1","112","17.5","18.5"
"Telfair","2020-09-29","9","976","0","112","16.1","18.5"
"Telfair","2020-09-30","5","981","0","112","16.1","17.3"
"Telfair","2020-10-01","6","987","0","112","16.1","16.8"
"Telfair","2020-10-02","4","991","1","113","19.6","17.7"
"Telfair","2020-10-03","0","991","0","113","19.6","10.5"
"Telfair","2020-10-04","5","996","1","114","8.2","12"
"Telfair","2020-10-05","7","1003","3","117","12.6","15"
"Telfair","2020-10-06","6","1009","1","118","14.9","15.5"
"Telfair","2020-10-07","5","1014","1","119","17.8","16.9"
"Telfair","2020-10-08","8","1022","0","119","17.8","16.9"
"Telfair","2020-10-09","2","1024","0","119","14.2","16.9"
"Telfair","2020-10-10","2","1026","0","119","14.2","16.9"
"Telfair","2020-10-11","8","1034","4","123","18.5","13.4"
"Telfair","2020-10-12","5","1039","0","123","12.4","12.5"
"Telfair","2020-10-13","6","1045","1","124","12.4","13.7"
"Telfair","2020-10-14","5","1050","0","124","9.5","13.7"
"Telfair","2020-10-15","9","1059","2","126","12.7","15.2"
"Telfair","2020-10-16","83","1142","55","181","22.2","18.2"
"Telfair","2020-10-17","1","1143","0","181","22.2","18.2"
"Telfair","2020-10-18","3","1146","0","181","15","16.8"
"Telfair","2020-10-19","9","1155","2","183","18.2","15.3"
"Telfair","2020-10-20","11","1166","3","186","19.7","16"
"Telfair","2020-10-21","8","1174","1","187","21.5","15.5"
"Telfair","2020-10-22","7","1181","0","187","18.3","15.5"
"Telfair","2020-10-23","4","1185","1","188","12.4","17.3"
"Telfair","2020-10-24","5","1190","0","188","12.4","17.3"
"Telfair","2020-10-25","3","1193","0","188","12.4","13.7"
"Telfair","2020-10-26","3","1196","0","188","9.3","13.7"
"Telfair","2020-10-27","10","1206","0","188","5.4","12.5"
"Telfair","2020-10-28","4","1210","1","189","7.1","14.3"
"Telfair","2020-10-29","5","1215","2","191","12.9","15.6"
"Telfair","2020-10-30","3","1218","0","191","9.3","10.9"
"Telfair","2020-10-31","7","1225","1","192","11.3","11.9"
"Telfair","2020-11-01","4","1229","0","192","11.3","11.9"
"Telfair","2020-11-02","48","1277","0","192","11.3","10.3"
"Telfair","2020-11-03","4","1281","1","193","14.9","10.1"
"Telfair","2020-11-04","8","1289","0","193","11.3","9.2"
"Telfair","2020-11-05","11","1300","0","193","5.6","9.2"
"Telfair","2020-11-06","6","1306","0","193","5.6","7.4"
"Telfair","2020-11-07","3","1309","0","193","3.6","7.4"
"Telfair","2020-11-08","6","1315","0","193","3.6","7.4"
"Telfair","2020-11-09","6","1321","2","195","8.3","9.8"
"Telfair","2020-11-10","8","1329","0","195","4.8","9.8"
"Telfair","2020-11-11","2","1331","0","195","4.8","8"
"Telfair","2020-11-12","6","1337","1","196","7.1","6.4"
"Telfair","2020-11-13","4","1341","0","196","7.1","6.4"
"Telfair","2020-11-14","4","1345","1","197","10.7","7.1"
"Telfair","2020-11-15","4","1349","0","197","10.7","7.1"
"Telfair","2020-11-16","5","1354","1","198","8.8","8.6"
"Telfair","2020-11-17","7","1361","1","199","10.9","7.8"
"Telfair","2020-11-18","3","1364","0","199","10.9","7.8"
"Telfair","2020-11-19","12","1376","2","201","10.9","9"
"Telfair","2020-11-20","6","1382","0","201","10.9","9"
"Telfair","2020-11-21","1","1383","0","201","7.3","9"
"Telfair","2020-11-22","2","1385","0","201","7.3","9"
"Telfair","2020-11-23","5","1390","0","201","4.4","6.6"
"Telfair","2020-11-24","14","1404","1","202","3.4","7.1"
"Telfair","2020-11-25","4","1408","0","202","3.4","7.1"
"Telfair","2020-11-26","1","1409","0","202","1","5.9"
"Telfair","2020-11-27","7","1416","1","203","3.1","7"
"Telfair","2020-11-28","3","1419","0","203","3.1","5.2"
"Telfair","2020-11-29","0","1419","0","203","3.1","5.2"
"Telfair","2020-11-30","5","1424","0","203","3.1","3.7"
"Telfair","2020-12-01","6","1430","0","203","2","2.7"
"Telfair","2020-12-02","9","1439","0","203","2","2.7"
"Telfair","2020-12-03","7","1446","0","203","2","1.5"
"Telfair","2020-12-04","4","1450","1","204","3.6","3.3"
"Telfair","2020-12-05","6","1456","0","204","3.6","3.3"
"Telfair","2020-12-06","3","1459","0","204","3.6","3.3"
"Telfair","2020-12-07","10","1469","1","205","5","4"
"Telfair","2020-12-08","7","1476","0","205","5","3.5"
"Telfair","2020-12-09","5","1481","1","206","7.9","4.9"
"Telfair","2020-12-10","10","1491","3","209","12.1","7.1"
"Telfair","2020-12-11","8","1499","2","211","12.1","7.9"
"Telfair","2020-12-12","4","1503","0","211","12.1","7.9"
"Telfair","2020-12-13","0","1503","0","211","12.1","7.9"
"Telfair","2020-12-14","7","1510","2","213","14.8","9.9"
"Telfair","2020-12-15","10","1520","0","213","14.8","9.9"
"Telfair","2020-12-16","11","1531","0","213","11.9","9.9"
"Telfair","2020-12-17","8","1539","2","215","11.2","11.7"
"Telfair","2020-12-18","9","1548","2","217","10.8","11.5"
"Telfair","2020-12-19","8","1556","1","218","12.6","12.4"
"Telfair","2020-12-20","8","1564","3","221","18","15.1"
"Telfair","2020-12-21","13","1577","0","221","13.9","14.3"
"Telfair","2020-12-22","16","1593","0","221","13.9","14.3"
"Telfair","2020-12-23","12","1605","0","221","13.9","12.9"
"Telfair","2020-12-24","4","1609","0","221","10.3","10.8"
"Telfair","2020-12-25","1","1610","0","221","7.1","9"
"Telfair","2020-12-26","6","1616","1","222","7.7","10.2"
"Telfair","2020-12-27","7","1623","3","225","8.5","13.2"
"Telfair","2020-12-28","15","1638","3","228","11.4","12.6"
"Telfair","2020-12-29","9","1647","1","229","12.9","13.4"
"Telfair","2020-12-30","15","1662","4","233","16.8","15.3"
"Telfair","2020-12-31","13","1675","2","235","19","14.6"
"Telfair","2021-01-01","5","1680","1","236","21.8","14.5"
"Telfair","2021-01-02","9","1689","1","237","21","14.4"
"Telfair","2021-01-03","5","1694","2","239","20.6","14.6"
"Telfair","2021-01-04","11","1705","4","243","22.9","17.2"
"Telfair","2021-01-05","18","1723","2","245","22.9","17.9"
"Telfair","2021-01-06","10","1733","3","248","23.4","20.1"
"Telfair","2021-01-07","6","1739","2","250","26","22.5"
"Telfair","2021-01-08","13","1752","1","251","24.2","23"
"Telfair","2021-01-09","3","1755","1","252","27.4","24.2"
"Telfair","2021-01-10","7","1762","0","252","21.7","21.2"
"Telfair","2021-01-11","16","1778","4","256","20.1","21.5"
"Telfair","2021-01-12","12","1790","1","257","19.7","21.3"
"Telfair","2021-01-13","7","1797","0","257","15.4","19.4"
"Telfair","2021-01-14","10","1807","2","259","13.5","19.7"
"Telfair","2021-01-15","6","1813","1","260","14.8","19.5"
"Telfair","2021-01-16","12","1825","1","261","11.2","19.3"
"Telfair","2021-01-17","4","1829","2","263","18.3","20"
"Telfair","2021-01-18","12","1841","1","264","16","18"
"Telfair","2021-01-19","14","1855","1","265","15.8","17.7"
"Telfair","2021-01-20","10","1865","1","266","17.2","16.3"
"Telfair","2021-01-21","7","1872","1","267","16.4","14.9"
"Telfair","2021-01-22","8","1880","2","269","17.6","16.2"
"Telfair","2021-01-23","6","1886","0","269","16.4","13.8"
"Telfair","2021-01-24","1","1887","0","269","9.3","13.8"
"Telfair","2021-01-25","4","1891","1","270","11.6","13.8"
"Telfair","2021-01-26","2","1893","1","271","17.8","16.8"
"Telfair","2021-01-27","0","1893","0","271","16.3","16.8"
"Terrell","2020-02-01","0","0","0","0",".","."
"Terrell","2020-02-02","0","0","0","0",".","."
"Terrell","2020-02-03","0","0","0","0",".","."
"Terrell","2020-02-04","0","0","0","0",".","."
"Terrell","2020-02-05","0","0","0","0",".","."
"Terrell","2020-02-06","0","0","0","0",".","."
"Terrell","2020-02-07","0","0","0","0","0","."
"Terrell","2020-02-08","0","0","0","0","0","."
"Terrell","2020-02-09","0","0","0","0","0","."
"Terrell","2020-02-10","0","0","0","0","0","."
"Terrell","2020-02-11","0","0","0","0","0","."
"Terrell","2020-02-12","0","0","0","0","0","."
"Terrell","2020-02-13","0","0","0","0","0","."
"Terrell","2020-02-14","0","0","0","0","0","0"
"Terrell","2020-02-15","0","0","0","0","0","0"
"Terrell","2020-02-16","0","0","0","0","0","0"
"Terrell","2020-02-17","0","0","0","0","0","0"
"Terrell","2020-02-18","0","0","0","0","0","0"
"Terrell","2020-02-19","0","0","0","0","0","0"
"Terrell","2020-02-20","0","0","0","0","0","0"
"Terrell","2020-02-21","0","0","0","0","0","0"
"Terrell","2020-02-22","0","0","0","0","0","0"
"Terrell","2020-02-23","0","0","0","0","0","0"
"Terrell","2020-02-24","0","0","0","0","0","0"
"Terrell","2020-02-25","0","0","0","0","0","0"
"Terrell","2020-02-26","0","0","0","0","0","0"
"Terrell","2020-02-27","0","0","0","0","0","0"
"Terrell","2020-02-28","0","0","0","0","0","0"
"Terrell","2020-02-29","0","0","0","0","0","0"
"Terrell","2020-03-01","0","0","0","0","0","0"
"Terrell","2020-03-02","0","0","0","0","0","0"
"Terrell","2020-03-03","0","0","0","0","0","0"
"Terrell","2020-03-04","0","0","0","0","0","0"
"Terrell","2020-03-05","0","0","0","0","0","0"
"Terrell","2020-03-06","0","0","0","0","0","0"
"Terrell","2020-03-07","0","0","0","0","0","0"
"Terrell","2020-03-08","0","0","0","0","0","0"
"Terrell","2020-03-09","0","0","0","0","0","0"
"Terrell","2020-03-10","0","0","0","0","0","0"
"Terrell","2020-03-11","0","0","0","0","0","0"
"Terrell","2020-03-12","0","0","0","0","0","0"
"Terrell","2020-03-13","2","2","1","1","7.1","3.6"
"Terrell","2020-03-14","2","4","1","2","14.3","7.1"
"Terrell","2020-03-15","0","4","0","2","14.3","7.1"
"Terrell","2020-03-16","3","7","1","3","19","9.5"
"Terrell","2020-03-17","5","12","0","3","19","9.5"
"Terrell","2020-03-18","4","16","1","4","22.6","11.3"
"Terrell","2020-03-19","7","23","2","6","26.7","13.4"
"Terrell","2020-03-20","8","31","5","11","28.5","17.8"
"Terrell","2020-03-21","13","44","9","20","31.2","22.8"
"Terrell","2020-03-22","2","46","1","21","38.4","26.3"
"Terrell","2020-03-23","19","65","8","29","39.6","29.3"
"Terrell","2020-03-24","25","90","11","40","45.9","32.5"
"Terrell","2020-03-25","13","103","7","47","50","36.3"
"Terrell","2020-03-26","12","115","6","53","53.1","39.9"
"Terrell","2020-03-27","14","129","7","60","51.3","39.9"
"Terrell","2020-03-28","13","142","8","68","50.2","40.7"
"Terrell","2020-03-29","5","147","2","70","48.8","43.6"
"Terrell","2020-03-30","23","170","11","81","49.6","44.6"
"Terrell","2020-03-31","8","178","4","85","50.5","48.2"
"Terrell","2020-04-01","16","194","8","93","49.9","50"
"Terrell","2020-04-02","11","205","3","96","46.7","49.9"
"Terrell","2020-04-03","7","212","6","102","51.8","51.5"
"Terrell","2020-04-04","6","218","3","105","50.1","50.2"
"Terrell","2020-04-05","7","225","2","107","48.5","48.6"
"Terrell","2020-04-06","26","251","12","119","48.2","48.9"
"Terrell","2020-04-07","9","260","5","124","49","49.7"
"Terrell","2020-04-08","12","272","3","127","45.5","47.7"
"Terrell","2020-04-09","11","283","4","131","46.8","46.7"
"Terrell","2020-04-10","9","292","2","133","37.7","44.7"
"Terrell","2020-04-11","16","308","2","135","32.3","41.2"
"Terrell","2020-04-12","2","310","0","135","28.3","38.4"
"Terrell","2020-04-13","12","322","1","136","22.9","35.5"
"Terrell","2020-04-14","27","349","7","143","18.6","33.8"
"Terrell","2020-04-15","20","369","3","146","17.2","31.3"
"Terrell","2020-04-16","21","390","4","150","14.7","30.7"
"Terrell","2020-04-17","6","396","1","151","13.9","25.8"
"Terrell","2020-04-18","11","407","1","152","13.4","22.9"
"Terrell","2020-04-19","7","414","1","153","15.5","21.9"
"Terrell","2020-04-20","23","437","5","158","17.4","20.1"
"Terrell","2020-04-21","10","447","1","159","15.1","16.9"
"Terrell","2020-04-22","16","463","3","162","15.7","16.4"
"Terrell","2020-04-23","11","474","3","165","16.8","15.8"
"Terrell","2020-04-24","17","491","5","170","18.7","16.3"
"Terrell","2020-04-25","4","495","1","171","20.9","17.2"
"Terrell","2020-04-26","4","499","1","172","22.5","19"
"Terrell","2020-04-27","17","516","5","177","23.5","20.5"
"Terrell","2020-04-28","18","534","2","179","23.7","19.4"
"Terrell","2020-04-29","34","568","3","182","22.3","19"
"Terrell","2020-04-30","14","582","1","183","19.4","18.1"
"Terrell","2020-05-01","12","594","1","184","16.4","17.5"
"Terrell","2020-05-02","13","607","2","186","15","18"
"Terrell","2020-05-03","6","613","0","186","11.5","17"
"Terrell","2020-05-04","24","637","1","187","7.9","15.7"
"Terrell","2020-05-05","10","647","0","187","6.3","15"
"Terrell","2020-05-06","18","665","0","187","5","13.6"
"Terrell","2020-05-07","45","710","1","188","4.3","11.9"
"Terrell","2020-05-08","1","711","0","188","3.1","9.8"
"Terrell","2020-05-09","2","713","0","188","0.9","8"
"Terrell","2020-05-10","62","775","1","189","1.1","6.3"
"Terrell","2020-05-11","9","784","2","191","3.7","5.8"
"Terrell","2020-05-12","5","789","1","192","6.6","6.4"
"Terrell","2020-05-13","55","844","1","193","6.8","5.9"
"Terrell","2020-05-14","6","850","0","193","6.5","5.4"
"Terrell","2020-05-15","7","857","1","194","8.6","5.8"
"Terrell","2020-05-16","77","934","6","200","9.7","5.3"
"Terrell","2020-05-17","4","938","0","200","9.4","5.3"
"Terrell","2020-05-18","23","961","1","201","6.9","5.3"
"Terrell","2020-05-19","25","986","3","204","5.7","6.2"
"Terrell","2020-05-20","6","992","0","204","5.5","6.2"
"Terrell","2020-05-21","25","1017","0","204","5.5","6"
"Terrell","2020-05-22","75","1092","5","209","4.4","6.5"
"Terrell","2020-05-23","2","1094","0","209","3.3","6.5"
"Terrell","2020-05-24","17","1111","0","209","3.3","6.4"
"Terrell","2020-05-25","12","1123","0","209","2.7","4.8"
"Terrell","2020-05-26","34","1157","3","212","2.2","4"
"Terrell","2020-05-27","42","1199","0","212","2.2","3.9"
"Terrell","2020-05-28","14","1213","2","214","4.3","4.9"
"Terrell","2020-05-29","10","1223","0","214","3.3","3.9"
"Terrell","2020-05-30","45","1268","2","216","3.9","3.6"
"Terrell","2020-05-31","10","1278","1","217","5.4","4.3"
"Terrell","2020-06-01","31","1309","1","218","5.8","4.2"
"Terrell","2020-06-02","18","1327","0","218","4.6","3.4"
"Terrell","2020-06-03","52","1379","0","218","4.6","3.4"
"Terrell","2020-06-04","11","1390","0","218","2.5","3.4"
"Terrell","2020-06-05","21","1411","1","219","3.2","3.3"
"Terrell","2020-06-06","8","1419","0","219","2.6","3.3"
"Terrell","2020-06-07","27","1446","1","220","1.7","3.5"
"Terrell","2020-06-08","16","1462","0","220","1.2","3.5"
"Terrell","2020-06-09","9","1471","1","221","2.8","3.7"
"Terrell","2020-06-10","11","1482","0","221","2.8","3.7"
"Terrell","2020-06-11","7","1489","2","223","6.9","4.7"
"Terrell","2020-06-12","12","1501","1","224","7.4","5.3"
"Terrell","2020-06-13","1","1502","0","224","7.4","5"
"Terrell","2020-06-14","2","1504","0","224","6.9","4.3"
"Terrell","2020-06-15","15","1519","0","224","6.9","4"
"Terrell","2020-06-16","9","1528","1","225","6.9","4.8"
"Terrell","2020-06-17","8","1536","1","226","8.6","5.7"
"Terrell","2020-06-18","13","1549","0","226","4.6","5.7"
"Terrell","2020-06-19","13","1562","1","227","4.5","5.9"
"Terrell","2020-06-20","2","1564","0","227","4.5","5.9"
"Terrell","2020-06-21","7","1571","0","227","4.5","5.7"
"Terrell","2020-06-22","17","1588","1","228","5.3","6.1"
"Terrell","2020-06-23","18","1606","1","229","4.5","5.7"
"Terrell","2020-06-24","8","1614","1","230","4.5","6.6"
"Terrell","2020-06-25","9","1623","5","235","12.5","8.5"
"Terrell","2020-06-26","7","1630","0","235","11.4","7.9"
"Terrell","2020-06-27","6","1636","0","235","11.4","7.9"
"Terrell","2020-06-28","4","1640","1","236","14.9","9.7"
"Terrell","2020-06-29","14","1654","1","237","15.1","10.2"
"Terrell","2020-06-30","14","1668","2","239","16.4","10.4"
"Terrell","2020-07-01","9","1677","0","239","14.6","9.5"
"Terrell","2020-07-02","13","1690","1","240","7.7","10.1"
"Terrell","2020-07-03","5","1695","0","240","7.7","9.5"
"Terrell","2020-07-04","8","1703","2","242","11.3","11.3"
"Terrell","2020-07-05","8","1711","4","246","14.9","14.9"
"Terrell","2020-07-06","11","1722","0","246","13.9","14.5"
"Terrell","2020-07-07","13","1735","1","247","12.9","14.6"
"Terrell","2020-07-08","9","1744","2","249","16.1","15.3"
"Terrell","2020-07-09","8","1752","2","251","18.6","13.1"
"Terrell","2020-07-10","13","1765","3","254","21.9","14.8"
"Terrell","2020-07-11","3","1768","1","255","23","17.2"
"Terrell","2020-07-12","6","1774","1","256","18.3","16.6"
"Terrell","2020-07-13","10","1784","1","257","19.7","16.8"
"Terrell","2020-07-14","21","1805","2","259","20","16.4"
"Terrell","2020-07-15","15","1820","0","259","16.8","16.4"
"Terrell","2020-07-16","9","1829","1","260","14.8","16.7"
"Terrell","2020-07-17","16","1845","1","261","12.4","17.1"
"Terrell","2020-07-18","6","1851","0","261","7.7","15.3"
"Terrell","2020-07-19","6","1857","0","261","5.3","11.8"
"Terrell","2020-07-20","11","1868","0","261","3.8","11.8"
"Terrell","2020-07-21","19","1887","2","263","4","12"
"Terrell","2020-07-22","8","1895","1","264","5.8","11.3"
"Terrell","2020-07-23","16","1911","2","266","6","10.4"
"Terrell","2020-07-24","10","1921","1","267","6.5","9.5"
"Terrell","2020-07-25","5","1926","0","267","6.5","7.1"
"Terrell","2020-07-26","6","1932","4","271","16","10.6"
"Terrell","2020-07-27","30","1962","4","275","17.9","10.9"
"Terrell","2020-07-28","22","1984","2","277","17.7","10.9"
"Terrell","2020-07-29","22","2006","1","278","16.6","11.2"
"Terrell","2020-07-30","26","2032","2","280","15.9","10.9"
"Terrell","2020-07-31","11","2043","0","280","14.5","10.5"
"Terrell","2020-08-01","6","2049","0","280","14.5","10.5"
"Terrell","2020-08-02","5","2054","0","280","5","10.5"
"Terrell","2020-08-03","17","2071","2","282","4.7","11.3"
"Terrell","2020-08-04","18","2089","2","284","5","11.4"
"Terrell","2020-08-05","29","2118","1","285","4.9","10.7"
"Terrell","2020-08-06","18","2136","2","287","5.3","10.6"
"Terrell","2020-08-07","9","2145","1","288","6.9","10.7"
"Terrell","2020-08-08","10","2155","2","290","9.8","12.1"
"Terrell","2020-08-09","4","2159","1","291","13.4","9.2"
"Terrell","2020-08-10","30","2189","2","293","12.6","8.7"
"Terrell","2020-08-11","20","2209","1","294","11.8","8.4"
"Terrell","2020-08-12","18","2227","1","295","12.1","8.5"
"Terrell","2020-08-13","12","2239","1","296","11.7","8.5"
"Terrell","2020-08-14","14","2253","1","297","11.1","9"
"Terrell","2020-08-15","7","2260","1","298","10.3","10"
"Terrell","2020-08-16","3","2263","1","299","11.5","12.4"
"Terrell","2020-08-17","7","2270","0","299","10.5","11.6"
"Terrell","2020-08-18","16","2286","3","302","12.5","12.1"
"Terrell","2020-08-19","21","2307","3","305","13.7","12.9"
"Terrell","2020-08-20","10","2317","0","305","12.5","12.1"
"Terrell","2020-08-21","13","2330","0","305","11.5","11.3"
"Terrell","2020-08-22","3","2333","0","305","9.5","9.9"
"Terrell","2020-08-23","8","2341","1","306","6.5","9"
"Terrell","2020-08-24","13","2354","1","307","7.6","9.1"
"Terrell","2020-08-25","19","2373","2","309","6.4","9.5"
"Terrell","2020-08-26","9","2382","1","310","6","9.9"
"Terrell","2020-08-27","12","2394","1","311","7.2","9.9"
"Terrell","2020-08-28","12","2406","1","312","8.4","9.9"
"Terrell","2020-08-29","5","2411","1","313","11.2","10.3"
"Terrell","2020-08-30","3","2414","0","313","9.4","8"
"Terrell","2020-08-31","16","2430","1","314","9.2","8.4"
"Terrell","2020-09-01","11","2441","0","314","7.7","7.1"
"Terrell","2020-09-02","13","2454","1","315","7.2","6.6"
"Terrell","2020-09-03","13","2467","0","315","6","6.6"
"Terrell","2020-09-04","19","2486","0","315","4.8","6.6"
"Terrell","2020-09-05","5","2491","1","316","4.8","8"
"Terrell","2020-09-06","4","2495","1","317","8.4","8.9"
"Terrell","2020-09-07","9","2504","0","317","7.5","8.4"
"Terrell","2020-09-08","21","2525","0","317","7.5","7.6"
"Terrell","2020-09-09","21","2546","0","317","6.4","6.8"
"Terrell","2020-09-10","12","2558","1","318","7.6","6.8"
"Terrell","2020-09-11","11","2569","1","319","8.9","6.9"
"Terrell","2020-09-12","3","2572","0","319","6.1","5.5"
"Terrell","2020-09-13","3","2575","1","320","7.3","7.8"
"Terrell","2020-09-14","12","2587","0","320","7.3","7.4"
"Terrell","2020-09-15","15","2602","0","320","7.3","7.4"
"Terrell","2020-09-16","11","2613","0","320","7.3","6.8"
"Terrell","2020-09-17","11","2624","0","320","6.1","6.8"
"Terrell","2020-09-18","16","2640","0","320","4.8","6.8"
"Terrell","2020-09-19","3","2643","0","320","4.8","5.4"
"Terrell","2020-09-20","3","2646","0","320","0","3.6"
"Terrell","2020-09-21","9","2655","0","320","0","3.6"
"Terrell","2020-09-22","18","2673","1","321","0.8","4"
"Terrell","2020-09-23","11","2684","0","321","0.8","4"
"Terrell","2020-09-24","13","2697","0","321","0.8","3.4"
"Terrell","2020-09-25","10","2707","0","321","0.8","2.8"
"Terrell","2020-09-26","5","2712","1","322","3.7","4.2"
"Terrell","2020-09-27","6","2718","0","322","3.7","1.8"
"Terrell","2020-09-28","17","2735","1","323","4.5","2.2"
"Terrell","2020-09-29","10","2745","0","323","3.7","2.2"
"Terrell","2020-09-30","11","2756","0","323","3.7","2.2"
"Terrell","2020-10-01","16","2772","1","324","4.6","2.7"
"Terrell","2020-10-02","17","2789","0","324","4.6","2.7"
"Terrell","2020-10-03","3","2792","0","324","1.7","2.7"
"Terrell","2020-10-04","3","2795","0","324","1.7","2.7"
"Terrell","2020-10-05","5","2800","0","324","0.9","2.7"
"Terrell","2020-10-06","11","2811","0","324","0.9","2.3"
"Terrell","2020-10-07","20","2831","0","324","0.9","2.3"
"Terrell","2020-10-08","11","2842","0","324","0","2.3"
"Terrell","2020-10-09","9","2851","0","324","0","2.3"
"Terrell","2020-10-10","1","2852","0","324","0","0.9"
"Terrell","2020-10-11","5","2857","0","324","0","0.9"
"Terrell","2020-10-12","14","2871","0","324","0","0.4"
"Terrell","2020-10-13","21","2892","1","325","0.7","0.8"
"Terrell","2020-10-14","14","2906","0","325","0.7","0.8"
"Terrell","2020-10-15","9","2915","0","325","0.7","0.3"
"Terrell","2020-10-16","11","2926","2","327","3.3","1.6"
"Terrell","2020-10-17","4","2930","0","327","3.3","1.6"
"Terrell","2020-10-18","5","2935","0","327","3.3","1.6"
"Terrell","2020-10-19","13","2948","0","327","3.3","1.6"
"Terrell","2020-10-20","10","2958","0","327","2.6","1.6"
"Terrell","2020-10-21","12","2970","0","327","2.6","1.6"
"Terrell","2020-10-22","10","2980","1","328","4","2.4"
"Terrell","2020-10-23","10","2990","1","329","2.9","3.1"
"Terrell","2020-10-24","7","2997","0","329","2.9","3.1"
"Terrell","2020-10-25","4","3001","0","329","2.9","3.1"
"Terrell","2020-10-26","15","3016","0","329","2.9","3.1"
"Terrell","2020-10-27","15","3031","0","329","2.9","2.7"
"Terrell","2020-10-28","13","3044","1","330","4","3.3"
"Terrell","2020-10-29","12","3056","0","330","2.5","3.3"
"Terrell","2020-10-30","13","3069","0","330","1.1","2"
"Terrell","2020-10-31","3","3072","0","330","1.1","2"
"Terrell","2020-11-01","3","3075","0","330","1.1","2"
"Terrell","2020-11-02","13","3088","1","331","2.2","2.5"
"Terrell","2020-11-03","14","3102","0","331","2.2","2.5"
"Terrell","2020-11-04","12","3114","1","332","2.3","3.1"
"Terrell","2020-11-05","17","3131","0","332","2.3","2.4"
"Terrell","2020-11-06","15","3146","0","332","2.3","1.7"
"Terrell","2020-11-07","6","3152","2","334","7.1","4.1"
"Terrell","2020-11-08","5","3157","0","334","7.1","4.1"
"Terrell","2020-11-09","15","3172","1","335","6.9","4.6"
"Terrell","2020-11-10","5","3177","0","335","6.9","4.6"
"Terrell","2020-11-11","16","3193","0","335","5.7","4"
"Terrell","2020-11-12","19","3212","0","335","5.7","4"
"Terrell","2020-11-13","11","3223","0","335","5.7","4"
"Terrell","2020-11-14","7","3230","0","335","1","4"
"Terrell","2020-11-15","7","3237","0","335","1","4"
"Terrell","2020-11-16","13","3250","2","337","2.2","4.6"
"Terrell","2020-11-17","14","3264","1","338","3.2","5.1"
"Terrell","2020-11-18","8","3272","1","339","5","5.4"
"Terrell","2020-11-19","13","3285","1","340","6.1","5.9"
"Terrell","2020-11-20","13","3298","0","340","6.1","5.9"
"Terrell","2020-11-21","5","3303","2","342","11.8","6.4"
"Terrell","2020-11-22","3","3306","0","342","11.8","6.4"
"Terrell","2020-11-23","27","3333","2","344","10.7","6.4"
"Terrell","2020-11-24","16","3349","1","345","10.5","6.9"
"Terrell","2020-11-25","18","3367","2","347","10.4","7.7"
"Terrell","2020-11-26","3","3370","0","347","9.3","7.7"
"Terrell","2020-11-27","4","3374","0","347","9.3","7.7"
"Terrell","2020-11-28","3","3377","2","349","13.1","12.4"
"Terrell","2020-11-29","3","3380","0","349","13.1","12.4"
"Terrell","2020-11-30","17","3397","2","351","13.7","12.2"
"Terrell","2020-12-01","23","3420","2","353","14","12.3"
"Terrell","2020-12-02","26","3446","1","354","13","11.7"
"Terrell","2020-12-03","22","3468","2","356","14.3","11.8"
"Terrell","2020-12-04","16","3484","3","359","17","13.1"
"Terrell","2020-12-05","8","3492","3","362","12.8","12.9"
"Terrell","2020-12-06","8","3500","3","365","18.2","15.6"
"Terrell","2020-12-07","27","3527","3","368","18.1","15.9"
"Terrell","2020-12-08","37","3564","8","376","19.9","17"
"Terrell","2020-12-09","31","3595","2","378","20.3","16.6"
"Terrell","2020-12-10","23","3618","5","383","22.1","18.2"
"Terrell","2020-12-11","23","3641","4","387","21.9","19.4"
"Terrell","2020-12-12","11","3652","1","388","17.8","15.3"
"Terrell","2020-12-13","7","3659","2","390","16.6","17.4"
"Terrell","2020-12-14","30","3689","6","396","17.8","18"
"Terrell","2020-12-15","18","3707","5","401","18.7","19.3"
"Terrell","2020-12-16","19","3726","5","406","21.6","20.9"
"Terrell","2020-12-17","21","3747","3","409","20.5","21.3"
"Terrell","2020-12-18","17","3764","2","411","19.7","20.8"
"Terrell","2020-12-19","12","3776","0","411","18.4","18.1"
"Terrell","2020-12-20","8","3784","5","416","23.2","19.9"
"Terrell","2020-12-21","28","3812","6","422","23.4","20.6"
"Terrell","2020-12-22","26","3838","3","425","21.1","19.9"
"Terrell","2020-12-23","17","3855","0","425","17.4","19.5"
"Terrell","2020-12-24","4","3859","0","425","15.3","17.9"
"Terrell","2020-12-25","2","3861","0","425","13.6","16.7"
"Terrell","2020-12-26","13","3874","3","428","16.9","17.7"
"Terrell","2020-12-27","3","3877","0","428","8","15.6"
"Terrell","2020-12-28","15","3892","1","429","5.9","14.7"
"Terrell","2020-12-29","17","3909","0","429","4.2","12.7"
"Terrell","2020-12-30","26","3935","6","435","7.5","12.5"
"Terrell","2020-12-31","20","3955","3","438","9.7","12.5"
"Terrell","2021-01-01","3","3958","0","438","9.7","11.7"
"Terrell","2021-01-02","7","3965","0","438","6.4","11.7"
"Terrell","2021-01-03","7","3972","0","438","6.4","7.2"
"Terrell","2021-01-04","20","3992","3","441","7.6","6.7"
"Terrell","2021-01-05","31","4023","3","444","9","6.6"
"Terrell","2021-01-06","18","4041","2","446","7.3","7.4"
"Terrell","2021-01-07","19","4060","0","446","5.1","7.4"
"Terrell","2021-01-08","13","4073","2","448","7.3","8.5"
"Terrell","2021-01-09","7","4080","0","448","7.3","6.9"
"Terrell","2021-01-10","5","4085","1","449","10.2","8.3"
"Terrell","2021-01-11","25","4110","3","452","9.7","8.7"
"Terrell","2021-01-12","22","4132","3","455","10.3","9.6"
"Terrell","2021-01-13","21","4153","3","458","10.8","9"
"Terrell","2021-01-14","19","4172","7","465","16","10.6"
"Terrell","2021-01-15","15","4187","0","465","13.8","10.6"
"Terrell","2021-01-16","11","4198","1","466","15.1","11.2"
"Terrell","2021-01-17","8","4206","1","467","14.1","12.1"
"Terrell","2021-01-18","17","4223","5","472","16.5","13.1"
"Terrell","2021-01-19","17","4240","2","474","16.3","13.3"
"Terrell","2021-01-20","20","4260","4","478","17.1","13.9"
"Terrell","2021-01-21","12","4272","1","479","13","14.5"
"Terrell","2021-01-22","16","4288","1","480","13.9","13.9"
"Terrell","2021-01-23","7","4295","0","480","12.6","13.9"
"Terrell","2021-01-24","4","4299","1","481","14.4","14.2"
"Terrell","2021-01-25","9","4308","2","483","13.4","15"
"Terrell","2021-01-26","2","4310","0","483","11.7","14"
"Terrell","2021-01-27","0","4310","0","483","8.8","13"
"Thomas","2020-02-01","0","0","0","0",".","."
"Thomas","2020-02-02","0","0","0","0",".","."
"Thomas","2020-02-03","0","0","0","0",".","."
"Thomas","2020-02-04","0","0","0","0",".","."
"Thomas","2020-02-05","0","0","0","0",".","."
"Thomas","2020-02-06","0","0","0","0",".","."
"Thomas","2020-02-07","0","0","0","0","0","."
"Thomas","2020-02-08","0","0","0","0","0","."
"Thomas","2020-02-09","0","0","0","0","0","."
"Thomas","2020-02-10","0","0","0","0","0","."
"Thomas","2020-02-11","0","0","0","0","0","."
"Thomas","2020-02-12","0","0","0","0","0","."
"Thomas","2020-02-13","0","0","0","0","0","."
"Thomas","2020-02-14","0","0","0","0","0","0"
"Thomas","2020-02-15","0","0","0","0","0","0"
"Thomas","2020-02-16","0","0","0","0","0","0"
"Thomas","2020-02-17","0","0","0","0","0","0"
"Thomas","2020-02-18","0","0","0","0","0","0"
"Thomas","2020-02-19","0","0","0","0","0","0"
"Thomas","2020-02-20","0","0","0","0","0","0"
"Thomas","2020-02-21","0","0","0","0","0","0"
"Thomas","2020-02-22","0","0","0","0","0","0"
"Thomas","2020-02-23","0","0","0","0","0","0"
"Thomas","2020-02-24","0","0","0","0","0","0"
"Thomas","2020-02-25","0","0","0","0","0","0"
"Thomas","2020-02-26","0","0","0","0","0","0"
"Thomas","2020-02-27","0","0","0","0","0","0"
"Thomas","2020-02-28","0","0","0","0","0","0"
"Thomas","2020-02-29","0","0","0","0","0","0"
"Thomas","2020-03-01","0","0","0","0","0","0"
"Thomas","2020-03-02","0","0","0","0","0","0"
"Thomas","2020-03-03","0","0","0","0","0","0"
"Thomas","2020-03-04","0","0","0","0","0","0"
"Thomas","2020-03-05","0","0","0","0","0","0"
"Thomas","2020-03-06","0","0","0","0","0","0"
"Thomas","2020-03-07","0","0","0","0","0","0"
"Thomas","2020-03-08","0","0","0","0","0","0"
"Thomas","2020-03-09","0","0","0","0","0","0"
"Thomas","2020-03-10","0","0","0","0","0","0"
"Thomas","2020-03-11","0","0","0","0","0","0"
"Thomas","2020-03-12","1","1","0","0","0","0"
"Thomas","2020-03-13","1","2","1","1","14.3","7.1"
"Thomas","2020-03-14","0","2","0","1","14.3","7.1"
"Thomas","2020-03-15","0","2","0","1","14.3","7.1"
"Thomas","2020-03-16","4","6","2","3","21.4","10.7"
"Thomas","2020-03-17","2","8","0","3","21.4","10.7"
"Thomas","2020-03-18","0","8","0","3","21.4","10.7"
"Thomas","2020-03-19","2","10","0","3","21.4","10.7"
"Thomas","2020-03-20","6","16","1","4","9.5","11.9"
"Thomas","2020-03-21","2","18","0","4","9.5","11.9"
"Thomas","2020-03-22","1","19","0","4","9.5","11.9"
"Thomas","2020-03-23","4","23","1","5","6","13.7"
"Thomas","2020-03-24","5","28","1","6","8.8","15.1"
"Thomas","2020-03-25","4","32","0","6","8.8","15.1"
"Thomas","2020-03-26","11","43","3","9","12.7","17.1"
"Thomas","2020-03-27","3","46","3","12","24.6","17.1"
"Thomas","2020-03-28","7","53","5","17","34.8","22.2"
"Thomas","2020-03-29","9","62","9","26","49.1","29.3"
"Thomas","2020-03-30","13","75","7","33","53.2","29.6"
"Thomas","2020-03-31","11","86","6","39","58.2","33.5"
"Thomas","2020-04-01","13","99","11","50","70.2","39.5"
"Thomas","2020-04-02","2","101","2","52","80.6","46.7"
"Thomas","2020-04-03","11","112","8","60","76.7","50.7"
"Thomas","2020-04-04","5","117","4","64","78","56.4"
"Thomas","2020-04-05","1","118","1","65","78","63.5"
"Thomas","2020-04-06","10","128","6","71","78.8","66"
"Thomas","2020-04-07","30","158","8","79","74.9","66.5"
"Thomas","2020-04-08","14","172","12","91","75","72.6"
"Thomas","2020-04-09","55","227","10","101","63.3","72"
"Thomas","2020-04-10","10","237","6","107","61.5","69.1"
"Thomas","2020-04-11","6","243","5","112","62","70"
"Thomas","2020-04-12","6","249","5","117","59.6","68.8"
"Thomas","2020-04-13","13","262","8","125","59.8","69.3"
"Thomas","2020-04-14","80","342","14","139","58.5","66.7"
"Thomas","2020-04-15","8","350","4","143","53.4","64.2"
"Thomas","2020-04-16","6","356","4","147","60.3","61.8"
"Thomas","2020-04-17","11","367","10","157","64.8","63.1"
"Thomas","2020-04-18","2","369","2","159","67.1","64.6"
"Thomas","2020-04-19","4","373","2","161","62.4","61"
"Thomas","2020-04-20","4","377","4","165","67.9","63.8"
"Thomas","2020-04-21","39","416","4","169","66.8","62.7"
"Thomas","2020-04-22","79","495","6","175","60.8","57.1"
"Thomas","2020-04-23","20","515","0","175","51.3","55.8"
"Thomas","2020-04-24","88","603","5","180","39.1","51.9"
"Thomas","2020-04-25","47","650","4","184","26","46.6"
"Thomas","2020-04-26","2","652","1","185","26","44.2"
"Thomas","2020-04-27","61","713","9","194","13.8","40.8"
"Thomas","2020-04-28","108","821","13","207","14.1","40.5"
"Thomas","2020-04-29","19","840","3","210","15.3","38"
"Thomas","2020-04-30","35","875","6","216","17.7","34.5"
"Thomas","2020-05-01","28","903","3","219","18.4","28.7"
"Thomas","2020-05-02","14","917","0","219","17.2","21.6"
"Thomas","2020-05-03","8","925","2","221","13.6","19.8"
"Thomas","2020-05-04","55","980","1","222","11.8","12.8"
"Thomas","2020-05-05","67","1047","6","228","11.3","12.7"
"Thomas","2020-05-06","67","1114","3","231","9.7","12.5"
"Thomas","2020-05-07","52","1166","2","233","7.8","12.8"
"Thomas","2020-05-08","57","1223","15","248","10.1","14.2"
"Thomas","2020-05-09","33","1256","7","255","13.1","15.1"
"Thomas","2020-05-10","0","1256","0","255","9.5","11.6"
"Thomas","2020-05-11","54","1310","7","262","11.1","11.4"
"Thomas","2020-05-12","35","1345","3","265","11.1","11.2"
"Thomas","2020-05-13","64","1409","9","274","12.4","11.1"
"Thomas","2020-05-14","37","1446","4","278","13.4","10.6"
"Thomas","2020-05-15","44","1490","8","286","12.3","11.2"
"Thomas","2020-05-16","29","1519","3","289","10.7","11.9"
"Thomas","2020-05-17","4","1523","2","291","17.8","13.7"
"Thomas","2020-05-18","20","1543","8","299","21.7","16.4"
"Thomas","2020-05-19","89","1632","14","313","22.7","16.9"
"Thomas","2020-05-20","10","1642","0","313","20.7","16.6"
"Thomas","2020-05-21","56","1698","0","313","19.2","16.3"
"Thomas","2020-05-22","47","1745","1","314","16.9","14.6"
"Thomas","2020-05-23","9","1754","0","314","15.4","13.1"
"Thomas","2020-05-24","2","1756","1","315","15.4","16.6"
"Thomas","2020-05-25","44","1800","1","316","10","15.9"
"Thomas","2020-05-26","19","1819","1","317","8.5","15.6"
"Thomas","2020-05-27","100","1919","6","323","9.4","15.1"
"Thomas","2020-05-28","28","1947","2","325","10.4","14.8"
"Thomas","2020-05-29","55","2002","5","330","11.4","14.1"
"Thomas","2020-05-30","53","2055","14","344","15.2","15.3"
"Thomas","2020-05-31","3","2058","0","344","8","11.7"
"Thomas","2020-06-01","26","2084","4","348","9.9","10"
"Thomas","2020-06-02","136","2220","3","351","9.5","9"
"Thomas","2020-06-03","95","2315","2","353","8.9","9.1"
"Thomas","2020-06-04","72","2387","3","356","8.5","9.4"
"Thomas","2020-06-05","81","2468","4","360","7.9","9.6"
"Thomas","2020-06-06","31","2499","2","362","5","10.1"
"Thomas","2020-06-07","5","2504","0","362","5","6.5"
"Thomas","2020-06-08","110","2614","0","362","2.8","6.4"
"Thomas","2020-06-09","63","2677","4","366","3.4","6.4"
"Thomas","2020-06-10","102","2779","3","369","3.5","6.2"
"Thomas","2020-06-11","28","2807","0","369","3","5.7"
"Thomas","2020-06-12","85","2892","1","370","2.4","5.2"
"Thomas","2020-06-13","59","2951","2","372","2","3.5"
"Thomas","2020-06-14","9","2960","0","372","2","3.5"
"Thomas","2020-06-15","114","3074","1","373","2.1","2.5"
"Thomas","2020-06-16","98","3172","12","385","2.9","3.2"
"Thomas","2020-06-17","83","3255","6","391","3.6","3.6"
"Thomas","2020-06-18","38","3293","1","392","3.9","3.4"
"Thomas","2020-06-19","166","3459","13","405","4.9","3.7"
"Thomas","2020-06-20","68","3527","11","416","6.7","4.3"
"Thomas","2020-06-21","11","3538","1","417","8","5"
"Thomas","2020-06-22","79","3617","4","421","8.6","5.4"
"Thomas","2020-06-23","128","3745","19","440","9","6"
"Thomas","2020-06-24","45","3790","2","442","8.6","6.1"
"Thomas","2020-06-25","266","4056","32","474","9.9","6.9"
"Thomas","2020-06-26","72","4128","4","478","9.6","7.2"
"Thomas","2020-06-27","133","4261","10","488","8.4","7.5"
"Thomas","2020-06-28","22","4283","3","491","9","8.5"
"Thomas","2020-06-29","276","4559","23","514","9.5","9"
"Thomas","2020-06-30","263","4822","23","537","8.6","8.8"
"Thomas","2020-07-01","87","4909","4","541","8.6","8.6"
"Thomas","2020-07-02","277","5186","25","566","8.2","9.1"
"Thomas","2020-07-03","15","5201","4","570","11.2","10.4"
"Thomas","2020-07-04","9","5210","1","571","11.7","10"
"Thomas","2020-07-05","9","5219","2","573","13","11"
"Thomas","2020-07-06","245","5464","34","607","13.7","11.6"
"Thomas","2020-07-07","332","5796","23","630","13.5","11"
"Thomas","2020-07-08","109","5905","11","641","14.3","11.5"
"Thomas","2020-07-09","314","6219","33","674","14.5","11.3"
"Thomas","2020-07-10","74","6293","8","682","12.2","11.7"
"Thomas","2020-07-11","19","6312","4","686","13.6","12.7"
"Thomas","2020-07-12","25","6337","3","689","12.2","12.6"
"Thomas","2020-07-13","76","6413","13","702","12.6","13.2"
"Thomas","2020-07-14","337","6750","39","741","13.3","13.4"
"Thomas","2020-07-15","186","6936","18","759","13.2","13.8"
"Thomas","2020-07-16","290","7226","13","772","12.4","13.4"
"Thomas","2020-07-17","90","7316","10","782","12.4","12.3"
"Thomas","2020-07-18","18","7334","1","783","10.2","11.9"
"Thomas","2020-07-19","25","7359","9","792","13.6","12.9"
"Thomas","2020-07-20","264","7623","26","818","12.6","12.6"
"Thomas","2020-07-21","302","7925","40","858","12.8","13.1"
"Thomas","2020-07-22","166","8091","21","879","13.3","13.3"
"Thomas","2020-07-23","245","8336","19","898","13.7","13.1"
"Thomas","2020-07-24","94","8430","10","908","13.7","13"
"Thomas","2020-07-25","53","8483","1","909","13.1","11.7"
"Thomas","2020-07-26","26","8509","9","918","12.9","13.3"
"Thomas","2020-07-27","260","8769","41","959","13.8","13.2"
"Thomas","2020-07-28","261","9030","36","995","13.9","13.4"
"Thomas","2020-07-29","68","9098","7","1002","13.5","13.4"
"Thomas","2020-07-30","219","9317","34","1036","14.6","14.2"
"Thomas","2020-07-31","171","9488","10","1046","14","13.8"
"Thomas","2020-08-01","35","9523","10","1056","17.8","15.5"
"Thomas","2020-08-02","23","9546","5","1061","15.9","14.4"
"Thomas","2020-08-03","268","9814","45","1106","16.1","14.9"
"Thomas","2020-08-04","74","9888","14","1120","16.8","15.3"
"Thomas","2020-08-05","256","10144","17","1137","16.3","14.9"
"Thomas","2020-08-06","154","10298","13","1150","15.3","15"
"Thomas","2020-08-07","71","10369","6","1156","15.7","14.8"
"Thomas","2020-08-08","62","10431","7","1163","13.2","15.5"
"Thomas","2020-08-09","56","10487","0","1163","10.1","13"
"Thomas","2020-08-10","224","10711","20","1183","9","12.5"
"Thomas","2020-08-11","72","10783","15","1198","9.2","13"
"Thomas","2020-08-12","224","11007","22","1220","9.7","13"
"Thomas","2020-08-13","203","11210","42","1262","11.4","13.4"
"Thomas","2020-08-14","57","11267","9","1271","12.5","14.1"
"Thomas","2020-08-15","86","11353","7","1278","12","12.6"
"Thomas","2020-08-16","13","11366","1","1279","13.1","11.6"
"Thomas","2020-08-17","56","11422","10","1289","14.4","11.7"
"Thomas","2020-08-18","59","11481","8","1297","13.4","11.3"
"Thomas","2020-08-19","224","11705","19","1316","13.2","11.4"
"Thomas","2020-08-20","131","11836","13","1329","11.6","11.5"
"Thomas","2020-08-21","57","11893","14","1343","12.9","12.7"
"Thomas","2020-08-22","75","11968","1","1344","11.9","12"
"Thomas","2020-08-23","19","11987","4","1348","13.8","13.5"
"Thomas","2020-08-24","135","12122","14","1362","12.8","13.6"
"Thomas","2020-08-25","57","12179","10","1372","13.3","13.3"
"Thomas","2020-08-26","165","12344","18","1390","13.7","13.4"
"Thomas","2020-08-27","133","12477","11","1401","13.4","12.5"
"Thomas","2020-08-28","43","12520","4","1405","11.3","12.1"
"Thomas","2020-08-29","71","12591","8","1413","12.7","12.3"
"Thomas","2020-08-30","11","12602","2","1415","12.3","13"
"Thomas","2020-08-31","178","12780","25","1440","12.8","12.8"
"Thomas","2020-09-01","43","12823","5","1445","11.9","12.6"
"Thomas","2020-09-02","125","12948","15","1460","12.1","12.9"
"Thomas","2020-09-03","110","13058","8","1468","12","12.7"
"Thomas","2020-09-04","49","13107","6","1474","12.4","11.8"
"Thomas","2020-09-05","52","13159","2","1476","11.3","12"
"Thomas","2020-09-06","8","13167","1","1477","10.5","11.4"
"Thomas","2020-09-07","22","13189","4","1481","11.1","11.9"
"Thomas","2020-09-08","48","13237","11","1492","12.7","12.3"
"Thomas","2020-09-09","144","13381","8","1500","11.8","11.9"
"Thomas","2020-09-10","54","13435","7","1507","12.6","12.3"
"Thomas","2020-09-11","147","13582","5","1512","11.3","11.9"
"Thomas","2020-09-12","14","13596","2","1514","12.8","12.1"
"Thomas","2020-09-13","20","13616","1","1515","11.8","11.1"
"Thomas","2020-09-14","143","13759","16","1531","10.8","10.9"
"Thomas","2020-09-15","102","13861","10","1541","8.9","10.8"
"Thomas","2020-09-16","169","14030","11","1552","9","10.4"
"Thomas","2020-09-17","72","14102","12","1564","9.6","11.1"
"Thomas","2020-09-18","56","14158","5","1569","10.3","10.8"
"Thomas","2020-09-19","103","14261","1","1570","8.4","10.6"
"Thomas","2020-09-20","35","14296","1","1571","8.1","9.9"
"Thomas","2020-09-21","151","14447","10","1581","7.5","9.1"
"Thomas","2020-09-22","45","14492","3","1584","7","8"
"Thomas","2020-09-23","184","14676","7","1591","6.6","7.8"
"Thomas","2020-09-24","75","14751","7","1598","5.6","7.6"
"Thomas","2020-09-25","100","14851","6","1604","5.2","7.8"
"Thomas","2020-09-26","13","14864","1","1605","6.1","7.3"
"Thomas","2020-09-27","15","14879","1","1606","6.7","7.4"
"Thomas","2020-09-28","101","14980","2","1608","6","6.8"
"Thomas","2020-09-29","58","15038","0","1608","5.1","6"
"Thomas","2020-09-30","55","15093","5","1613","5.8","6.2"
"Thomas","2020-10-01","89","15182","5","1618","5.3","5.4"
"Thomas","2020-10-02","132","15314","5","1623","5","5.1"
"Thomas","2020-10-03","38","15352","3","1626","5","5.6"
"Thomas","2020-10-04","25","15377","2","1628","5.2","5.9"
"Thomas","2020-10-05","124","15501","11","1639","6.2","6.1"
"Thomas","2020-10-06","116","15617","4","1643","6.7","5.9"
"Thomas","2020-10-07","177","15794","10","1653","6.2","6"
"Thomas","2020-10-08","78","15872","3","1656","5.9","5.6"
"Thomas","2020-10-09","59","15931","4","1660","6.4","5.7"
"Thomas","2020-10-10","112","16043","6","1666","6","5.5"
"Thomas","2020-10-11","12","16055","1","1667","6","5.6"
"Thomas","2020-10-12","74","16129","9","1676","6.5","6.3"
"Thomas","2020-10-13","40","16169","4","1680","7.4","7.1"
"Thomas","2020-10-14","158","16327","9","1689","7.5","6.8"
"Thomas","2020-10-15","71","16398","4","1693","7.7","6.8"
"Thomas","2020-10-16","66","16464","2","1695","7.2","6.8"
"Thomas","2020-10-17","29","16493","1","1696","6.9","6.4"
"Thomas","2020-10-18","5","16498","0","1696","5.7","5.9"
"Thomas","2020-10-19","96","16594","5","1701","4.7","5.6"
"Thomas","2020-10-20","29","16623","1","1702","3.8","5.6"
"Thomas","2020-10-21","105","16728","8","1710","4.1","5.8"
"Thomas","2020-10-22","50","16778","2","1712","3.8","5.8"
"Thomas","2020-10-23","120","16898","6","1718","4.1","5.6"
"Thomas","2020-10-24","22","16920","3","1721","5.6","6.2"
"Thomas","2020-10-25","20","16940","3","1724","7.7","6.7"
"Thomas","2020-10-26","144","17084","11","1735","8","6.4"
"Thomas","2020-10-27","41","17125","2","1737","8.3","6"
"Thomas","2020-10-28","120","17245","5","1742","7.8","5.9"
"Thomas","2020-10-29","42","17287","6","1748","9.2","6.5"
"Thomas","2020-10-30","106","17393","4","1752","9.1","6.6"
"Thomas","2020-10-31","22","17415","1","1753","7.8","6.7"
"Thomas","2020-11-01","10","17425","2","1755","8.5","8.1"
"Thomas","2020-11-02","102","17527","9","1764","8.6","8.3"
"Thomas","2020-11-03","103","17630","3","1767","8.4","8.3"
"Thomas","2020-11-04","92","17722","2","1769","8.1","7.9"
"Thomas","2020-11-05","58","17780","2","1771","6.5","7.9"
"Thomas","2020-11-06","67","17847","6","1777","7.3","8.2"
"Thomas","2020-11-07","27","17874","1","1778","7.1","7.5"
"Thomas","2020-11-08","16","17890","3","1781","7","7.7"
"Thomas","2020-11-09","89","17979","14","1795","8","8.3"
"Thomas","2020-11-10","64","18043","6","1801","8.9","8.6"
"Thomas","2020-11-11","134","18177","9","1810","9.5","8.8"
"Thomas","2020-11-12","63","18240","7","1817","10.6","8.6"
"Thomas","2020-11-13","108","18348","7","1824","10.3","8.8"
"Thomas","2020-11-14","20","18368","1","1825","10.5","8.8"
"Thomas","2020-11-15","9","18377","0","1825","7.8","7.4"
"Thomas","2020-11-16","117","18494","11","1836","6.9","7.4"
"Thomas","2020-11-17","116","18610","3","1839","5.9","7.4"
"Thomas","2020-11-18","63","18673","3","1842","5.6","7.6"
"Thomas","2020-11-19","68","18741","6","1848","5.3","8"
"Thomas","2020-11-20","95","18836","9","1857","5.7","8"
"Thomas","2020-11-21","128","18964","7","1864","5.8","8.1"
"Thomas","2020-11-22","25","18989","5","1869","8.6","8.2"
"Thomas","2020-11-23","146","19135","15","1884","8.8","7.8"
"Thomas","2020-11-24","77","19212","4","1888","9.1","7.5"
"Thomas","2020-11-25","99","19311","11","1899","10","7.8"
"Thomas","2020-11-26","31","19342","3","1902","10.2","7.7"
"Thomas","2020-11-27","51","19393","6","1908","10.5","8.1"
"Thomas","2020-11-28","26","19419","5","1913","12.5","9.1"
"Thomas","2020-11-29","25","19444","5","1918","12.5","10.6"
"Thomas","2020-11-30","215","19659","19","1937","12.3","10.5"
"Thomas","2020-12-01","123","19782","14","1951","13.1","11.1"
"Thomas","2020-12-02","142","19924","9","1960","12.5","11.3"
"Thomas","2020-12-03","188","20112","22","1982","12.8","11.5"
"Thomas","2020-12-04","85","20197","16","1998","13.8","12.1"
"Thomas","2020-12-05","52","20249","13","2011","14.6","13.5"
"Thomas","2020-12-06","28","20277","4","2015","13.8","13.1"
"Thomas","2020-12-07","197","20474","34","2049","15","13.6"
"Thomas","2020-12-08","170","20644","21","2070","15.1","14.1"
"Thomas","2020-12-09","79","20723","15","2085","16.9","14.7"
"Thomas","2020-12-10","282","21005","25","2110","16.5","14.6"
"Thomas","2020-12-11","195","21200","20","2130","15.3","14.5"
"Thomas","2020-12-12","33","21233","11","2141","16.5","15.5"
"Thomas","2020-12-13","21","21254","6","2147","18.5","16.1"
"Thomas","2020-12-14","365","21619","52","2199","18.1","16.5"
"Thomas","2020-12-15","167","21786","12","2211","17.3","16.2"
"Thomas","2020-12-16","316","22102","52","2263","17","17"
"Thomas","2020-12-17","360","22462","44","2307","17.5","17"
"Thomas","2020-12-18","107","22569","15","2322","18","16.6"
"Thomas","2020-12-19","95","22664","5","2327","14","15.2"
"Thomas","2020-12-20","27","22691","5","2332","12.6","15.5"
"Thomas","2020-12-21","364","23055","59","2391","12.8","15.5"
"Thomas","2020-12-22","287","23342","47","2438","14.2","15.8"
"Thomas","2020-12-23","117","23459","12","2450","13.3","15.1"
"Thomas","2020-12-24","125","23584","9","2459","12.5","15"
"Thomas","2020-12-25","16","23600","6","2465","15.9","17"
"Thomas","2020-12-26","220","23820","28","2493","17","15.5"
"Thomas","2020-12-27","43","23863","13","2506","18.6","15.6"
"Thomas","2020-12-28","272","24135","50","2556","19","15.9"
"Thomas","2020-12-29","109","24244","23","2579","19.6","16.9"
"Thomas","2020-12-30","477","24721","46","2625","19.5","16.4"
"Thomas","2020-12-31","427","25148","55","2680","20.4","16.5"
"Thomas","2021-01-01","198","25346","13","2693","15.9","15.9"
"Thomas","2021-01-02","31","25377","11","2704","19.2","18.1"
"Thomas","2021-01-03","40","25417","13","2717","19.5","19.1"
"Thomas","2021-01-04","393","25810","74","2791","19.6","19.3"
"Thomas","2021-01-05","181","25991","61","2852","21.4","20.5"
"Thomas","2021-01-06","263","26254","64","2916","23.5","21.5"
"Thomas","2021-01-07","338","26592","78","2994","24.9","22.6"
"Thomas","2021-01-08","313","26905","47","3041","26.1","21"
"Thomas","2021-01-09","83","26988","16","3057","23.8","21.5"
"Thomas","2021-01-10","41","27029","6","3063","21.3","20.4"
"Thomas","2021-01-11","371","27400","71","3134","21.3","20.4"
"Thomas","2021-01-12","185","27585","32","3166","19","20.2"
"Thomas","2021-01-13","157","27742","23","3189","17.6","20.5"
"Thomas","2021-01-14","382","28124","46","3235","16","20.5"
"Thomas","2021-01-15","174","28298","33","3268","16.6","21.4"
"Thomas","2021-01-16","62","28360","13","3281","16.8","20.3"
"Thomas","2021-01-17","39","28399","12","3293","19.1","20.2"
"Thomas","2021-01-18","298","28697","48","3341","18.7","20"
"Thomas","2021-01-19","147","28844","21","3362","18.3","18.6"
"Thomas","2021-01-20","189","29033","21","3383","17.7","17.7"
"Thomas","2021-01-21","335","29368","34","3417","17.5","16.7"
"Thomas","2021-01-22","322","29690","38","3455","16.5","16.5"
"Thomas","2021-01-23","29","29719","5","3460","15.9","16.4"
"Thomas","2021-01-24","17","29736","8","3468","18.3","18.7"
"Thomas","2021-01-25","79","29815","23","3491","20.1","19.4"
"Thomas","2021-01-26","27","29842","8","3499","22.3","20.3"
"Thomas","2021-01-27","0","29842","0","3499","20.7","19.2"
"Tift","2020-02-01","0","0","0","0",".","."
"Tift","2020-02-02","0","0","0","0",".","."
"Tift","2020-02-03","0","0","0","0",".","."
"Tift","2020-02-04","0","0","0","0",".","."
"Tift","2020-02-05","0","0","0","0",".","."
"Tift","2020-02-06","0","0","0","0",".","."
"Tift","2020-02-07","0","0","0","0","0","."
"Tift","2020-02-08","0","0","0","0","0","."
"Tift","2020-02-09","0","0","0","0","0","."
"Tift","2020-02-10","0","0","0","0","0","."
"Tift","2020-02-11","0","0","0","0","0","."
"Tift","2020-02-12","0","0","0","0","0","."
"Tift","2020-02-13","0","0","0","0","0","."
"Tift","2020-02-14","0","0","0","0","0","0"
"Tift","2020-02-15","0","0","0","0","0","0"
"Tift","2020-02-16","0","0","0","0","0","0"
"Tift","2020-02-17","0","0","0","0","0","0"
"Tift","2020-02-18","0","0","0","0","0","0"
"Tift","2020-02-19","0","0","0","0","0","0"
"Tift","2020-02-20","0","0","0","0","0","0"
"Tift","2020-02-21","0","0","0","0","0","0"
"Tift","2020-02-22","0","0","0","0","0","0"
"Tift","2020-02-23","0","0","0","0","0","0"
"Tift","2020-02-24","0","0","0","0","0","0"
"Tift","2020-02-25","0","0","0","0","0","0"
"Tift","2020-02-26","0","0","0","0","0","0"
"Tift","2020-02-27","0","0","0","0","0","0"
"Tift","2020-02-28","0","0","0","0","0","0"
"Tift","2020-02-29","0","0","0","0","0","0"
"Tift","2020-03-01","0","0","0","0","0","0"
"Tift","2020-03-02","0","0","0","0","0","0"
"Tift","2020-03-03","0","0","0","0","0","0"
"Tift","2020-03-04","0","0","0","0","0","0"
"Tift","2020-03-05","0","0","0","0","0","0"
"Tift","2020-03-06","0","0","0","0","0","0"
"Tift","2020-03-07","0","0","0","0","0","0"
"Tift","2020-03-08","0","0","0","0","0","0"
"Tift","2020-03-09","0","0","0","0","0","0"
"Tift","2020-03-10","0","0","0","0","0","0"
"Tift","2020-03-11","0","0","0","0","0","0"
"Tift","2020-03-12","4","4","0","0","0","0"
"Tift","2020-03-13","2","6","0","0","0","0"
"Tift","2020-03-14","1","7","0","0","0","0"
"Tift","2020-03-15","0","7","0","0","0","0"
"Tift","2020-03-16","3","10","0","0","0","0"
"Tift","2020-03-17","2","12","0","0","0","0"
"Tift","2020-03-18","2","14","0","0","0","0"
"Tift","2020-03-19","2","16","0","0","0","0"
"Tift","2020-03-20","0","16","0","0","0","0"
"Tift","2020-03-21","0","16","0","0","0","0"
"Tift","2020-03-22","0","16","0","0","0","0"
"Tift","2020-03-23","6","22","1","1","2.4","1.2"
"Tift","2020-03-24","6","28","1","2","4.8","2.4"
"Tift","2020-03-25","2","30","2","4","19","9.5"
"Tift","2020-03-26","3","33","0","4","19","9.5"
"Tift","2020-03-27","6","39","0","4","19","9.5"
"Tift","2020-03-28","0","39","0","4","19","9.5"
"Tift","2020-03-29","0","39","0","4","19","9.5"
"Tift","2020-03-30","5","44","1","5","19.5","11"
"Tift","2020-03-31","1","45","1","6","31.4","18.1"
"Tift","2020-04-01","1","46","0","6","17.1","18.1"
"Tift","2020-04-02","43","89","8","14","19.8","19.4"
"Tift","2020-04-03","32","121","6","20","22.5","20.8"
"Tift","2020-04-04","2","123","1","21","29.6","24.3"
"Tift","2020-04-05","0","123","0","21","29.6","24.3"
"Tift","2020-04-06","4","127","0","21","26.8","23.1"
"Tift","2020-04-07","9","136","3","24","17.2","24.3"
"Tift","2020-04-08","76","212","18","42","20.6","18.9"
"Tift","2020-04-09","49","261","8","50","20.3","20"
"Tift","2020-04-10","83","344","20","70","21.1","21.8"
"Tift","2020-04-11","54","398","11","81","16.8","23.2"
"Tift","2020-04-12","0","398","0","81","16.8","23.2"
"Tift","2020-04-13","6","404","0","81","16.8","21.8"
"Tift","2020-04-14","126","530","25","106","14.9","16.1"
"Tift","2020-04-15","51","581","8","114","13.8","17.2"
"Tift","2020-04-16","57","638","8","122","13.4","16.9"
"Tift","2020-04-17","53","691","15","137","14","17.5"
"Tift","2020-04-18","75","766","18","155","14.6","15.7"
"Tift","2020-04-19","4","770","1","156","18.1","17.5"
"Tift","2020-04-20","29","799","6","162","21.1","19"
"Tift","2020-04-21","97","896","14","176","20.3","17.6"
"Tift","2020-04-22","56","952","13","189","21.4","17.6"
"Tift","2020-04-23","77","1029","21","210","23.3","18.4"
"Tift","2020-04-24","47","1076","13","223","23.2","18.6"
"Tift","2020-04-25","40","1116","8","231","22.6","18.6"
"Tift","2020-04-26","4","1120","3","234","29.8","23.9"
"Tift","2020-04-27","15","1135","6","240","32.5","26.8"
"Tift","2020-04-28","132","1267","4","244","30.9","25.6"
"Tift","2020-04-29","92","1359","12","256","29.4","25.4"
"Tift","2020-04-30","56","1415","12","268","28.6","25.9"
"Tift","2020-05-01","82","1497","20","288","28.1","25.7"
"Tift","2020-05-02","75","1572","10","298","27.2","24.9"
"Tift","2020-05-03","5","1577","2","300","22.2","26"
"Tift","2020-05-04","59","1636","11","311","19.1","25.8"
"Tift","2020-05-05","78","1714","7","318","20","25.4"
"Tift","2020-05-06","85","1799","13","331","20.3","24.9"
"Tift","2020-05-07","91","1890","22","353","20.7","24.6"
"Tift","2020-05-08","88","1978","13","366","19.3","23.7"
"Tift","2020-05-09","80","2058","14","380","19.9","23.5"
"Tift","2020-05-10","3","2061","1","381","19","20.6"
"Tift","2020-05-11","77","2138","8","389","17.8","18.5"
"Tift","2020-05-12","121","2259","12","401","17.9","18.9"
"Tift","2020-05-13","99","2358","14","415","17.7","19"
"Tift","2020-05-14","77","2435","12","427","16.5","18.6"
"Tift","2020-05-15","100","2535","13","440","16.3","17.8"
"Tift","2020-05-16","122","2657","7","447","14.6","17.2"
"Tift","2020-05-17","4","2661","3","450","20.5","19.7"
"Tift","2020-05-18","75","2736","7","457","20.4","19.1"
"Tift","2020-05-19","112","2848","17","474","21.1","19.5"
"Tift","2020-05-20","122","2970","19","493","21.3","19.5"
"Tift","2020-05-21","158","3128","14","507","20.4","18.5"
"Tift","2020-05-22","80","3208","9","516","20.1","18.2"
"Tift","2020-05-23","10","3218","2","518","22.2","18.4"
"Tift","2020-05-24","1","3219","1","519","25.7","23.1"
"Tift","2020-05-25","9","3228","3","522","29.2","24.8"
"Tift","2020-05-26","82","3310","8","530","28.4","24.8"
"Tift","2020-05-27","143","3453","20","550","28.2","24.8"
"Tift","2020-05-28","151","3604","17","567","28.5","24.4"
"Tift","2020-05-29","102","3706","12","579","28.6","24.4"
"Tift","2020-05-30","90","3796","8","587","27","24.6"
"Tift","2020-05-31","2","3798","1","588","19.9","22.8"
"Tift","2020-06-01","99","3897","19","607","17.8","23.5"
"Tift","2020-06-02","61","3958","6","613","17.8","23.1"
"Tift","2020-06-03","98","4056","10","623","17.3","22.7"
"Tift","2020-06-04","192","4248","38","661","18.5","23.5"
"Tift","2020-06-05","154","4402","17","678","18.4","23.5"
"Tift","2020-06-06","113","4515","12","690","18.7","22.8"
"Tift","2020-06-07","15","4530","4","694","15.3","17.6"
"Tift","2020-06-08","192","4722","40","734","15.6","16.7"
"Tift","2020-06-09","94","4816","17","751","16.7","17.3"
"Tift","2020-06-10","288","5104","49","800","17.7","17.5"
"Tift","2020-06-11","218","5322","42","842","17.6","18.1"
"Tift","2020-06-12","182","5504","13","855","17.1","17.8"
"Tift","2020-06-13","7","5511","1","856","17.6","18.1"
"Tift","2020-06-14","7","5518","3","859","19.9","17.6"
"Tift","2020-06-15","138","5656","12","871","18.2","16.9"
"Tift","2020-06-16","324","5980","58","929","18.2","17.5"
"Tift","2020-06-17","257","6237","60","989","19.1","18.4"
"Tift","2020-06-18","261","6498","44","1033","18.7","18.2"
"Tift","2020-06-19","260","6758","44","1077","20.1","18.6"
"Tift","2020-06-20","221","6979","27","1104","19.8","18.7"
"Tift","2020-06-21","14","6993","3","1107","16.8","18.3"
"Tift","2020-06-22","378","7371","69","1176","18.1","18.2"
"Tift","2020-06-23","362","7733","82","1258","18.8","18.5"
"Tift","2020-06-24","344","8077","64","1322","18.1","18.6"
"Tift","2020-06-25","413","8490","46","1368","17.3","18"
"Tift","2020-06-26","374","8864","33","1401","16.2","18.1"
"Tift","2020-06-27","79","8943","14","1415","16.9","18.4"
"Tift","2020-06-28","30","8973","9","1424","18.2","17.5"
"Tift","2020-06-29","311","9284","32","1456","17","17.6"
"Tift","2020-06-30","115","9399","20","1476","16.3","17.5"
"Tift","2020-07-01","253","9652","34","1510","15.5","16.8"
"Tift","2020-07-02","273","9925","38","1548","15.9","16.6"
"Tift","2020-07-03","92","10017","19","1567","17.6","16.9"
"Tift","2020-07-04","98","10115","19","1586","17.9","17.4"
"Tift","2020-07-05","23","10138","6","1592","17.3","17.7"
"Tift","2020-07-06","230","10368","34","1626","18","17.5"
"Tift","2020-07-07","134","10502","13","1639","16.9","16.6"
"Tift","2020-07-08","306","10808","63","1702","17.9","16.7"
"Tift","2020-07-09","149","10957","15","1717","17.3","16.6"
"Tift","2020-07-10","307","11264","32","1749","15.9","16.7"
"Tift","2020-07-11","118","11382","14","1763","14.8","16.3"
"Tift","2020-07-12","19","11401","2","1765","12.6","14.9"
"Tift","2020-07-13","126","11527","5","1770","11","14.5"
"Tift","2020-07-14","281","11808","43","1813","11.8","14.3"
"Tift","2020-07-15","214","12022","24","1837","10.5","14.2"
"Tift","2020-07-16","215","12237","16","1853","10.1","13.7"
"Tift","2020-07-17","237","12474","35","1888","10.7","13.3"
"Tift","2020-07-18","135","12609","11","1899","10.2","12.5"
"Tift","2020-07-19","14","12623","3","1902","11.8","12.2"
"Tift","2020-07-20","143","12766","8","1910","12","11.5"
"Tift","2020-07-21","266","13032","48","1958","12.4","12.1"
"Tift","2020-07-22","234","13266","33","1991","12.8","11.6"
"Tift","2020-07-23","187","13453","33","2024","14.2","12.2"
"Tift","2020-07-24","182","13635","20","2044","13.7","12.2"
"Tift","2020-07-25","117","13752","23","2067","15.4","12.8"
"Tift","2020-07-26","20","13772","4","2071","15.1","13.5"
"Tift","2020-07-27","170","13942","25","2096","16.4","14.2"
"Tift","2020-07-28","220","14162","43","2139","16.7","14.5"
"Tift","2020-07-29","152","14314","18","2157","16.3","14.6"
"Tift","2020-07-30","178","14492","24","2181","15.7","15"
"Tift","2020-07-31","149","14641","14","2195","15.5","14.6"
"Tift","2020-08-01","106","14747","15","2210","14.7","15"
"Tift","2020-08-02","11","14758","3","2213","15.8","15.5"
"Tift","2020-08-03","153","14911","15","2228","15.1","15.8"
"Tift","2020-08-04","132","15043","24","2252","14.9","15.8"
"Tift","2020-08-05","126","15169","6","2258","13.9","15.1"
"Tift","2020-08-06","75","15244","9","2267","13.7","14.7"
"Tift","2020-08-07","137","15381","5","2272","12.8","14.2"
"Tift","2020-08-08","39","15420","6","2278","13","13.9"
"Tift","2020-08-09","24","15444","4","2282","11.5","13.6"
"Tift","2020-08-10","116","15560","6","2288","10.8","13"
"Tift","2020-08-11","98","15658","7","2295","9.3","12.1"
"Tift","2020-08-12","120","15778","11","2306","9.9","11.9"
"Tift","2020-08-13","134","15912","7","2313","8.9","11.3"
"Tift","2020-08-14","99","16011","7","2320","9.4","11.1"
"Tift","2020-08-15","42","16053","4","2324","8.6","10.8"
"Tift","2020-08-16","36","16089","1","2325","6.6","9"
"Tift","2020-08-17","72","16161","7","2332","7.2","9"
"Tift","2020-08-18","108","16269","10","2342","7.5","8.4"
"Tift","2020-08-19","105","16374","8","2350","7.3","8.6"
"Tift","2020-08-20","84","16458","9","2359","8.1","8.5"
"Tift","2020-08-21","74","16532","5","2364","8.1","8.7"
"Tift","2020-08-22","14","16546","2","2366","8.7","8.7"
"Tift","2020-08-23","12","16558","3","2369","11.9","9.2"
"Tift","2020-08-24","99","16657","9","2378","11.8","9.5"
"Tift","2020-08-25","98","16755","15","2393","12.7","10.1"
"Tift","2020-08-26","128","16883","12","2405","12.9","10.1"
"Tift","2020-08-27","129","17012","6","2411","12.1","10.1"
"Tift","2020-08-28","94","17106","9","2420","12.5","10.3"
"Tift","2020-08-29","21","17127","1","2421","11.1","9.9"
"Tift","2020-08-30","14","17141","7","2428","14.7","13.3"
"Tift","2020-08-31","117","17258","17","2445","15.5","13.6"
"Tift","2020-09-01","98","17356","19","2464","16","14.4"
"Tift","2020-09-02","89","17445","8","2472","16","14.5"
"Tift","2020-09-03","95","17540","14","2486","17.4","14.7"
"Tift","2020-09-04","73","17613","10","2496","18","15.2"
"Tift","2020-09-05","17","17630","1","2497","18.2","14.6"
"Tift","2020-09-06","15","17645","5","2502","15.8","15.2"
"Tift","2020-09-07","41","17686","9","2511","16.9","16.2"
"Tift","2020-09-08","93","17779","9","2520","15.5","15.8"
"Tift","2020-09-09","117","17896","14","2534","15.9","15.9"
"Tift","2020-09-10","73","17969","4","2538","14.6","16"
"Tift","2020-09-11","81","18050","11","2549","14.6","16.3"
"Tift","2020-09-12","28","18078","6","2555","16.8","17.5"
"Tift","2020-09-13","63","18141","6","2561","13.4","14.6"
"Tift","2020-09-14","110","18251","10","2571","11.5","14.2"
"Tift","2020-09-15","74","18325","12","2583","12.5","14"
"Tift","2020-09-16","106","18431","15","2598","12.8","14.3"
"Tift","2020-09-17","80","18511","16","2614","14.9","14.7"
"Tift","2020-09-18","160","18671","11","2625","13.9","14.2"
"Tift","2020-09-19","31","18702","7","2632","14.1","15.4"
"Tift","2020-09-20","33","18735","10","2642","17","15.2"
"Tift","2020-09-21","117","18852","18","2660","17.9","14.7"
"Tift","2020-09-22","76","18928","5","2665","16.6","14.5"
"Tift","2020-09-23","89","19017","7","2672","15.7","14.2"
"Tift","2020-09-24","78","19095","11","2683","14.8","14.8"
"Tift","2020-09-25","78","19173","11","2694","15.8","14.9"
"Tift","2020-09-26","16","19189","1","2695","13.5","13.8"
"Tift","2020-09-27","13","19202","2","2697","11.4","14.2"
"Tift","2020-09-28","112","19314","25","2722","12.4","15.2"
"Tift","2020-09-29","89","19403","3","2725","11.9","14.2"
"Tift","2020-09-30","66","19469","7","2732","12.3","14"
"Tift","2020-10-01","87","19556","11","2743","12.1","13.5"
"Tift","2020-10-02","131","19687","7","2750","10.8","13.3"
"Tift","2020-10-03","70","19757","1","2751","10.2","11.8"
"Tift","2020-10-04","43","19800","3","2754","9","10.2"
"Tift","2020-10-05","116","19916","8","2762","6.8","9.6"
"Tift","2020-10-06","74","19990","6","2768","7.4","9.7"
"Tift","2020-10-07","104","20094","7","2775","6.9","9.6"
"Tift","2020-10-08","74","20168","7","2782","6.4","9.3"
"Tift","2020-10-09","148","20316","7","2789","6.3","8.6"
"Tift","2020-10-10","53","20369","5","2794","7.5","8.8"
"Tift","2020-10-11","62","20431","3","2797","7.2","8.1"
"Tift","2020-10-12","60","20491","5","2802","7.4","7.1"
"Tift","2020-10-13","71","20562","4","2806","7","7.2"
"Tift","2020-10-14","81","20643","5","2811","6.9","6.9"
"Tift","2020-10-15","101","20744","7","2818","6.6","6.5"
"Tift","2020-10-16","73","20817","6","2824","7.1","6.7"
"Tift","2020-10-17","54","20871","0","2824","5.7","6.6"
"Tift","2020-10-18","24","20895","6","2830","8.6","7.9"
"Tift","2020-10-19","70","20965","6","2836","8.6","8"
"Tift","2020-10-20","64","21029","3","2839","8.5","7.8"
"Tift","2020-10-21","71","21100","6","2845","8.8","7.9"
"Tift","2020-10-22","80","21180","6","2851","8.9","7.8"
"Tift","2020-10-23","116","21296","12","2863","9.2","8.2"
"Tift","2020-10-24","53","21349","6","2869","10.8","8.3"
"Tift","2020-10-25","17","21366","4","2873","10.6","9.6"
"Tift","2020-10-26","96","21462","12","2885","11.2","9.9"
"Tift","2020-10-27","83","21545","2","2887","10.9","9.7"
"Tift","2020-10-28","79","21624","6","2893","10.7","9.8"
"Tift","2020-10-29","67","21691","6","2899","11","9.9"
"Tift","2020-10-30","108","21799","5","2904","10.1","9.7"
"Tift","2020-10-31","43","21842","6","2910","10.5","10.7"
"Tift","2020-11-01","53","21895","5","2915","8.5","9.6"
"Tift","2020-11-02","85","21980","9","2924","8.2","9.7"
"Tift","2020-11-03","78","22058","1","2925","8.1","9.5"
"Tift","2020-11-04","159","22217","5","2930","7.4","9.1"
"Tift","2020-11-05","85","22302","4","2934","6.8","8.9"
"Tift","2020-11-06","70","22372","4","2938","7","8.6"
"Tift","2020-11-07","53","22425","1","2939","5.3","7.9"
"Tift","2020-11-08","16","22441","4","2943","7.5","8"
"Tift","2020-11-09","95","22536","7","2950","7","7.6"
"Tift","2020-11-10","111","22647","15","2965","8.8","8.4"
"Tift","2020-11-11","56","22703","13","2978","11.6","9.5"
"Tift","2020-11-12","181","22884","13","2991","12","9.4"
"Tift","2020-11-13","130","23014","12","3003","12.5","9.7"
"Tift","2020-11-14","90","23104","6","3009","13.2","9.2"
"Tift","2020-11-15","42","23146","10","3019","13","10.2"
"Tift","2020-11-16","131","23277","16","3035","13.7","10.4"
"Tift","2020-11-17","133","23410","22","3057","14.1","11.4"
"Tift","2020-11-18","128","23538","13","3070","12.3","11.9"
"Tift","2020-11-19","173","23711","15","3085","12.5","12.2"
"Tift","2020-11-20","159","23870","13","3098","12.3","12.4"
"Tift","2020-11-21","44","23914","10","3108","14.6","13.9"
"Tift","2020-11-22","31","23945","8","3116","14.9","13.9"
"Tift","2020-11-23","154","24099","23","3139","15.3","14.5"
"Tift","2020-11-24","132","24231","24","3163","15.5","14.8"
"Tift","2020-11-25","150","24381","31","3194","17","14.6"
"Tift","2020-11-26","96","24477","6","3200","16.7","14.6"
"Tift","2020-11-27","77","24554","16","3216","18.5","15.4"
"Tift","2020-11-28","41","24595","7","3223","17.7","16.1"
"Tift","2020-11-29","28","24623","8","3231","18.1","16.5"
"Tift","2020-11-30","174","24797","34","3265","18.7","17"
"Tift","2020-12-01","123","24920","24","3289","18.9","17.2"
"Tift","2020-12-02","167","25087","20","3309","17.7","17.3"
"Tift","2020-12-03","144","25231","25","3334","19.3","18"
"Tift","2020-12-04","176","25407","20","3354","17.9","18.2"
"Tift","2020-12-05","83","25490","5","3359","16.3","17"
"Tift","2020-12-06","53","25543","10","3369","14.9","16.5"
"Tift","2020-12-07","160","25703","28","3397","14.7","16.7"
"Tift","2020-12-08","174","25877","23","3420","13.8","16.3"
"Tift","2020-12-09","132","26009","21","3441","14.3","16"
"Tift","2020-12-10","206","26215","16","3457","13","16.1"
"Tift","2020-12-11","155","26370","19","3476","13.1","15.5"
"Tift","2020-12-12","50","26420","9","3485","14.8","15.6"
"Tift","2020-12-13","25","26445","9","3494","17.2","16.1"
"Tift","2020-12-14","178","26623","36","3530","17.6","16.1"
"Tift","2020-12-15","143","26766","22","3552","17.9","15.8"
"Tift","2020-12-16","147","26913","18","3570","17.4","15.9"
"Tift","2020-12-17","191","27104","19","3589","17.7","15.3"
"Tift","2020-12-18","131","27235","16","3605","17.7","15.4"
"Tift","2020-12-19","92","27327","4","3609","15.8","15.3"
"Tift","2020-12-20","47","27374","13","3622","14.6","15.9"
"Tift","2020-12-21","142","27516","24","3646","14.1","15.9"
"Tift","2020-12-22","135","27651","26","3672","14.7","16.3"
"Tift","2020-12-23","158","27809","34","3706","16","16.7"
"Tift","2020-12-24","117","27926","17","3723","16.6","17.2"
"Tift","2020-12-25","13","27939","4","3727","19.3","18.5"
"Tift","2020-12-26","68","28007","16","3743","22","18.9"
"Tift","2020-12-27","51","28058","15","3758","22.3","18.4"
"Tift","2020-12-28","94","28152","22","3780","23.2","18.7"
"Tift","2020-12-29","101","28253","23","3803","23.7","19.2"
"Tift","2020-12-30","232","28485","27","3830","22.3","19.1"
"Tift","2020-12-31","117","28602","15","3845","22","19.3"
"Tift","2021-01-01","21","28623","5","3850","21.1","20.2"
"Tift","2021-01-02","33","28656","8","3858","21.2","21.6"
"Tift","2021-01-03","77","28733","8","3866","18.4","20.4"
"Tift","2021-01-04","106","28839","27","3893","18.7","21"
"Tift","2021-01-05","113","28952","23","3916","18.4","21"
"Tift","2021-01-06","179","29131","29","3945","19","20.7"
"Tift","2021-01-07","195","29326","17","3962","18.5","20.3"
"Tift","2021-01-08","117","29443","16","3978","17","19"
"Tift","2021-01-09","59","29502","6","3984","15","18.1"
"Tift","2021-01-10","29","29531","8","3992","17.5","17.9"
"Tift","2021-01-11","85","29616","18","4010","16.8","17.8"
"Tift","2021-01-12","95","29711","8","4018","15.1","16.8"
"Tift","2021-01-13","153","29864","17","4035","14.4","16.7"
"Tift","2021-01-14","92","29956","15","4050","15.5","17"
"Tift","2021-01-15","89","30045","14","4064","15.8","16.4"
"Tift","2021-01-16","78","30123","6","4070","15.4","15.2"
"Tift","2021-01-17","24","30147","3","4073","13.3","15.4"
"Tift","2021-01-18","72","30219","14","4087","13","14.9"
"Tift","2021-01-19","73","30292","10","4097","13.8","14.5"
"Tift","2021-01-20","77","30369","15","4112","15","14.7"
"Tift","2021-01-21","175","30544","14","4126","13.8","14.6"
"Tift","2021-01-22","100","30644","12","4138","13.3","14.5"
"Tift","2021-01-23","56","30700","5","4143","13.4","14.4"
"Tift","2021-01-24","19","30719","4","4147","14.7","14"
"Tift","2021-01-25","24","30743","0","4147","11.9","12.5"
"Tift","2021-01-26","4","30747","1","4148","13.5","13.6"
"Tift","2021-01-27","0","30747","0","4148","10.7","12.8"
"Toombs","2020-02-01","0","0","0","0",".","."
"Toombs","2020-02-02","0","0","0","0",".","."
"Toombs","2020-02-03","0","0","0","0",".","."
"Toombs","2020-02-04","0","0","0","0",".","."
"Toombs","2020-02-05","0","0","0","0",".","."
"Toombs","2020-02-06","0","0","0","0",".","."
"Toombs","2020-02-07","0","0","0","0","0","."
"Toombs","2020-02-08","0","0","0","0","0","."
"Toombs","2020-02-09","0","0","0","0","0","."
"Toombs","2020-02-10","0","0","0","0","0","."
"Toombs","2020-02-11","0","0","0","0","0","."
"Toombs","2020-02-12","0","0","0","0","0","."
"Toombs","2020-02-13","0","0","0","0","0","."
"Toombs","2020-02-14","0","0","0","0","0","0"
"Toombs","2020-02-15","0","0","0","0","0","0"
"Toombs","2020-02-16","0","0","0","0","0","0"
"Toombs","2020-02-17","0","0","0","0","0","0"
"Toombs","2020-02-18","0","0","0","0","0","0"
"Toombs","2020-02-19","0","0","0","0","0","0"
"Toombs","2020-02-20","0","0","0","0","0","0"
"Toombs","2020-02-21","0","0","0","0","0","0"
"Toombs","2020-02-22","0","0","0","0","0","0"
"Toombs","2020-02-23","0","0","0","0","0","0"
"Toombs","2020-02-24","0","0","0","0","0","0"
"Toombs","2020-02-25","0","0","0","0","0","0"
"Toombs","2020-02-26","0","0","0","0","0","0"
"Toombs","2020-02-27","0","0","0","0","0","0"
"Toombs","2020-02-28","0","0","0","0","0","0"
"Toombs","2020-02-29","0","0","0","0","0","0"
"Toombs","2020-03-01","0","0","0","0","0","0"
"Toombs","2020-03-02","0","0","0","0","0","0"
"Toombs","2020-03-03","0","0","0","0","0","0"
"Toombs","2020-03-04","0","0","0","0","0","0"
"Toombs","2020-03-05","0","0","0","0","0","0"
"Toombs","2020-03-06","0","0","0","0","0","0"
"Toombs","2020-03-07","0","0","0","0","0","0"
"Toombs","2020-03-08","0","0","0","0","0","0"
"Toombs","2020-03-09","0","0","0","0","0","0"
"Toombs","2020-03-10","0","0","0","0","0","0"
"Toombs","2020-03-11","0","0","0","0","0","0"
"Toombs","2020-03-12","0","0","0","0","0","0"
"Toombs","2020-03-13","1","1","0","0","0","0"
"Toombs","2020-03-14","0","1","0","0","0","0"
"Toombs","2020-03-15","0","1","0","0","0","0"
"Toombs","2020-03-16","1","2","0","0","0","0"
"Toombs","2020-03-17","1","3","0","0","0","0"
"Toombs","2020-03-18","3","6","0","0","0","0"
"Toombs","2020-03-19","7","13","0","0","0","0"
"Toombs","2020-03-20","5","18","0","0","0","0"
"Toombs","2020-03-21","3","21","1","1","4.8","2.4"
"Toombs","2020-03-22","4","25","0","1","4.8","2.4"
"Toombs","2020-03-23","7","32","1","2","6.8","3.4"
"Toombs","2020-03-24","8","40","2","4","10.4","5.2"
"Toombs","2020-03-25","2","42","0","4","10.4","5.2"
"Toombs","2020-03-26","3","45","0","4","10.4","5.2"
"Toombs","2020-03-27","4","49","0","4","10.4","5.2"
"Toombs","2020-03-28","0","49","0","4","5.6","5.2"
"Toombs","2020-03-29","0","49","0","4","5.6","5.2"
"Toombs","2020-03-30","1","50","0","4","3.6","5.2"
"Toombs","2020-03-31","6","56","1","5","2.4","6.4"
"Toombs","2020-04-01","3","59","1","6","7.1","8.8"
"Toombs","2020-04-02","3","62","0","6","7.1","8.8"
"Toombs","2020-04-03","1","63","0","6","7.1","8.8"
"Toombs","2020-04-04","1","64","0","6","7.1","6.4"
"Toombs","2020-04-05","1","65","0","6","7.1","6.4"
"Toombs","2020-04-06","9","74","2","8","10.3","6.9"
"Toombs","2020-04-07","4","78","0","8","7.9","5.2"
"Toombs","2020-04-08","8","86","1","9","5","6.1"
"Toombs","2020-04-09","2","88","0","9","5","6.1"
"Toombs","2020-04-10","1","89","1","10","19.2","13.2"
"Toombs","2020-04-11","1","90","0","10","19.2","13.2"
"Toombs","2020-04-12","0","90","0","10","19.2","13.2"
"Toombs","2020-04-13","4","94","1","11","19.6","15"
"Toombs","2020-04-14","4","98","2","13","26.8","17.4"
"Toombs","2020-04-15","2","100","1","14","32.1","18.6"
"Toombs","2020-04-16","2","102","1","15","39.3","22.1"
"Toombs","2020-04-17","7","109","1","16","27","23.1"
"Toombs","2020-04-18","4","113","0","16","27","23.1"
"Toombs","2020-04-19","1","114","0","16","27","23.1"
"Toombs","2020-04-20","47","161","1","17","23.8","21.7"
"Toombs","2020-04-21","19","180","3","20","18.9","22.8"
"Toombs","2020-04-22","9","189","0","20","11.7","21.9"
"Toombs","2020-04-23","9","198","2","22","7.8","23.5"
"Toombs","2020-04-24","7","205","0","22","5.7","16.4"
"Toombs","2020-04-25","3","208","1","23","10.5","18.8"
"Toombs","2020-04-26","4","212","0","23","10.5","18.8"
"Toombs","2020-04-27","8","220","1","24","12","17.9"
"Toombs","2020-04-28","5","225","1","25","12.6","15.7"
"Toombs","2020-04-29","11","236","1","26","13.9","12.8"
"Toombs","2020-04-30","8","244","1","27","12.5","10.1"
"Toombs","2020-05-01","3","247","0","27","12.5","9.1"
"Toombs","2020-05-02","5","252","1","28","10.6","10.5"
"Toombs","2020-05-03","3","255","1","29","15.3","12.9"
"Toombs","2020-05-04","7","262","1","30","15.6","13.8"
"Toombs","2020-05-05","9","271","0","30","12.7","12.7"
"Toombs","2020-05-06","6","277","2","32","16.2","15"
"Toombs","2020-05-07","7","284","1","33","16.5","14.5"
"Toombs","2020-05-08","5","289","1","34","19.3","15.9"
"Toombs","2020-05-09","0","289","0","34","16.5","13.5"
"Toombs","2020-05-10","1","290","0","34","11.7","13.5"
"Toombs","2020-05-11","9","299","1","35","11.2","13.4"
"Toombs","2020-05-12","4","303","0","35","11.2","12"
"Toombs","2020-05-13","6","309","0","35","6.5","11.3"
"Toombs","2020-05-14","11","320","0","35","4.4","10.5"
"Toombs","2020-05-15","5","325","1","36","4.4","11.9"
"Toombs","2020-05-16","2","327","0","36","4.4","10.5"
"Toombs","2020-05-17","2","329","0","36","4.4","8.1"
"Toombs","2020-05-18","10","339","1","37","4.3","7.8"
"Toombs","2020-05-19","18","357","1","38","5.1","8.2"
"Toombs","2020-05-20","11","368","1","39","6.4","6.4"
"Toombs","2020-05-21","17","385","0","39","6.4","5.4"
"Toombs","2020-05-22","10","395","0","39","3.5","4"
"Toombs","2020-05-23","0","395","0","39","3.5","4"
"Toombs","2020-05-24","2","397","0","39","3.5","4"
"Toombs","2020-05-25","0","397","0","39","2.1","3.2"
"Toombs","2020-05-26","12","409","0","39","1.3","3.2"
"Toombs","2020-05-27","13","422","2","41","2.2","4.3"
"Toombs","2020-05-28","7","429","0","41","2.2","4.3"
"Toombs","2020-05-29","19","448","2","43","3.7","3.6"
"Toombs","2020-05-30","6","454","0","43","3.7","3.6"
"Toombs","2020-05-31","1","455","0","43","3.7","3.6"
"Toombs","2020-06-01","36","491","2","45","4.5","3.3"
"Toombs","2020-06-02","11","502","0","45","4.5","2.9"
"Toombs","2020-06-03","23","525","3","48","4.2","3.2"
"Toombs","2020-06-04","19","544","9","57","10.9","6.6"
"Toombs","2020-06-05","18","562","6","63","14.2","8.9"
"Toombs","2020-06-06","9","571","2","65","17.4","10.5"
"Toombs","2020-06-07","1","572","0","65","17.4","10.5"
"Toombs","2020-06-08","36","608","6","71","18.9","11.7"
"Toombs","2020-06-09","18","626","1","72","19.7","12.1"
"Toombs","2020-06-10","34","660","9","81","21.7","12.9"
"Toombs","2020-06-11","23","683","0","81","14.9","12.9"
"Toombs","2020-06-12","25","708","4","85","12.4","13.3"
"Toombs","2020-06-13","9","717","2","87","12.4","14.9"
"Toombs","2020-06-14","6","723","2","89","17.2","17.3"
"Toombs","2020-06-15","25","748","3","92","16.5","17.7"
"Toombs","2020-06-16","44","792","5","97","17.3","18.5"
"Toombs","2020-06-17","26","818","4","101","15.8","18.7"
"Toombs","2020-06-18","54","872","4","105","16.8","15.9"
"Toombs","2020-06-19","20","892","2","107","16","14.2"
"Toombs","2020-06-20","10","902","0","107","12.8","12.6"
"Toombs","2020-06-21","14","916","5","112","13.1","15.2"
"Toombs","2020-06-22","38","954","11","123","15.5","16"
"Toombs","2020-06-23","35","989","11","134","18.4","17.9"
"Toombs","2020-06-24","34","1023","11","145","20.8","18.3"
"Toombs","2020-06-25","34","1057","7","152","22.7","19.8"
"Toombs","2020-06-26","34","1091","5","157","23.4","19.7"
"Toombs","2020-06-27","7","1098","4","161","31.6","22.2"
"Toombs","2020-06-28","8","1106","0","161","26.5","19.8"
"Toombs","2020-06-29","43","1149","4","165","23.6","19.6"
"Toombs","2020-06-30","42","1191","5","170","20.9","19.6"
"Toombs","2020-07-01","36","1227","5","175","18.2","19.5"
"Toombs","2020-07-02","19","1246","2","177","16.8","19.8"
"Toombs","2020-07-03","18","1264","3","180","17.1","20.2"
"Toombs","2020-07-04","3","1267","2","182","18.4","25"
"Toombs","2020-07-05","21","1288","8","190","23.9","25.2"
"Toombs","2020-07-06","50","1338","16","206","27.1","25.4"
"Toombs","2020-07-07","48","1386","8","214","27.8","24.3"
"Toombs","2020-07-08","52","1438","6","220","27.5","22.8"
"Toombs","2020-07-09","40","1478","7","227","28.4","22.6"
"Toombs","2020-07-10","61","1539","8","235","27.9","22.5"
"Toombs","2020-07-11","26","1565","3","238","20.1","19.2"
"Toombs","2020-07-12","20","1585","4","242","17.5","20.7"
"Toombs","2020-07-13","59","1644","13","255","16.1","21.6"
"Toombs","2020-07-14","68","1712","14","269","16.6","22.2"
"Toombs","2020-07-15","64","1776","21","290","19.7","23.6"
"Toombs","2020-07-16","63","1839","10","300","19.4","23.9"
"Toombs","2020-07-17","44","1883","12","312","21.4","24.7"
"Toombs","2020-07-18","17","1900","2","314","21.5","20.8"
"Toombs","2020-07-19","12","1912","2","316","21","19.2"
"Toombs","2020-07-20","49","1961","12","328","21.4","18.7"
"Toombs","2020-07-21","46","2007","14","342","22.8","19.7"
"Toombs","2020-07-22","63","2070","14","356","21.2","20.5"
"Toombs","2020-07-23","68","2138","12","368","21.5","20.5"
"Toombs","2020-07-24","48","2186","5","373","19.1","20.3"
"Toombs","2020-07-25","30","2216","13","386","23.6","22.5"
"Toombs","2020-07-26","15","2231","4","390","25","23"
"Toombs","2020-07-27","58","2289","15","405","25.2","23.3"
"Toombs","2020-07-28","74","2363","16","421","24","23.4"
"Toombs","2020-07-29","74","2437","12","433","23.1","22.2"
"Toombs","2020-07-30","66","2503","24","457","25.8","23.6"
"Toombs","2020-07-31","98","2601","33","490","29.1","24.1"
"Toombs","2020-08-01","25","2626","9","499","28.1","25.8"
"Toombs","2020-08-02","23","2649","6","505","28","26.5"
"Toombs","2020-08-03","49","2698","16","521","28.9","27.1"
"Toombs","2020-08-04","44","2742","10","531","29.1","26.5"
"Toombs","2020-08-05","106","2848","24","555","30","26.6"
"Toombs","2020-08-06","47","2895","16","571","29.7","27.7"
"Toombs","2020-08-07","67","2962","9","580","26.8","28"
"Toombs","2020-08-08","21","2983","5","585","25.1","26.6"
"Toombs","2020-08-09","37","3020","11","596","25.6","26.8"
"Toombs","2020-08-10","56","3076","5","601","22.2","25.6"
"Toombs","2020-08-11","75","3151","20","621","22.8","25.9"
"Toombs","2020-08-12","89","3240","31","652","24.5","27.3"
"Toombs","2020-08-13","70","3310","17","669","23.1","26.4"
"Toombs","2020-08-14","42","3352","11","680","24.9","25.9"
"Toombs","2020-08-15","25","3377","10","690","27.2","26.1"
"Toombs","2020-08-16","24","3401","3","693","24.8","25.2"
"Toombs","2020-08-17","45","3446","9","702","26.4","24.3"
"Toombs","2020-08-18","59","3505","17","719","26.7","24.7"
"Toombs","2020-08-19","111","3616","28","747","25.3","24.9"
"Toombs","2020-08-20","37","3653","9","756","25.3","24.2"
"Toombs","2020-08-21","40","3693","4","760","23","24"
"Toombs","2020-08-22","56","3749","10","770","19.8","23.5"
"Toombs","2020-08-23","13","3762","4","774","22.4","23.6"
"Toombs","2020-08-24","74","3836","9","783","21.3","23.8"
"Toombs","2020-08-25","57","3893","14","797","20.7","23.7"
"Toombs","2020-08-26","34","3927","4","801","18.8","22"
"Toombs","2020-08-27","61","3988","14","815","18.6","21.9"
"Toombs","2020-08-28","33","4021","5","820","19.3","21.1"
"Toombs","2020-08-29","48","4069","14","834","20.9","20.4"
"Toombs","2020-08-30","18","4087","5","839","20.5","21.5"
"Toombs","2020-08-31","79","4166","9","848","20.4","20.9"
"Toombs","2020-09-01","51","4217","9","857","19.4","20.1"
"Toombs","2020-09-02","66","4283","16","873","21.2","20"
"Toombs","2020-09-03","47","4330","4","877","19.1","18.9"
"Toombs","2020-09-04","54","4384","11","888","19.9","19.6"
"Toombs","2020-09-05","24","4408","10","898","21.7","21.3"
"Toombs","2020-09-06","16","4424","4","902","21.3","20.9"
"Toombs","2020-09-07","17","4441","3","905","22.2","21.3"
"Toombs","2020-09-08","39","4480","15","920","25.1","22.3"
"Toombs","2020-09-09","47","4527","11","931","25","23.1"
"Toombs","2020-09-10","50","4577","8","939","26.1","22.6"
"Toombs","2020-09-11","27","4604","4","943","25.3","22.6"
"Toombs","2020-09-12","23","4627","9","952","24.9","23.3"
"Toombs","2020-09-13","16","4643","5","957","25.8","23.5"
"Toombs","2020-09-14","42","4685","5","962","25","23.6"
"Toombs","2020-09-15","54","4739","15","977","23.5","24.3"
"Toombs","2020-09-16","53","4792","8","985","22.3","23.6"
"Toombs","2020-09-17","44","4836","6","991","21.9","24"
"Toombs","2020-09-18","43","4879","8","999","22.5","23.9"
"Toombs","2020-09-19","24","4903","5","1004","19.9","22.4"
"Toombs","2020-09-20","5","4908","1","1005","18.3","22"
"Toombs","2020-09-21","38","4946","9","1014","19.9","22.5"
"Toombs","2020-09-22","28","4974","6","1020","19","21.3"
"Toombs","2020-09-23","18","4992","2","1022","18.5","20.4"
"Toombs","2020-09-24","36","5028","7","1029","19.3","20.6"
"Toombs","2020-09-25","36","5064","2","1031","17.4","20"
"Toombs","2020-09-26","7","5071","3","1034","20.6","20.2"
"Toombs","2020-09-27","6","5077","1","1035","20.1","19.2"
"Toombs","2020-09-28","36","5113","6","1041","19.1","19.5"
"Toombs","2020-09-29","22","5135","1","1042","16.7","17.9"
"Toombs","2020-09-30","34","5169","9","1051","18.9","18.7"
"Toombs","2020-10-01","35","5204","6","1057","18.6","18.9"
"Toombs","2020-10-02","72","5276","3","1060","18.4","17.9"
"Toombs","2020-10-03","36","5312","4","1064","13.8","17.2"
"Toombs","2020-10-04","18","5330","8","1072","17.8","18.9"
"Toombs","2020-10-05","34","5364","7","1079","18.4","18.7"
"Toombs","2020-10-06","31","5395","3","1082","19.1","17.9"
"Toombs","2020-10-07","60","5455","10","1092","17.7","18.3"
"Toombs","2020-10-08","39","5494","4","1096","16.7","17.6"
"Toombs","2020-10-09","35","5529","2","1098","16.9","17.6"
"Toombs","2020-10-10","17","5546","4","1102","18.7","16.3"
"Toombs","2020-10-11","8","5554","0","1102","12.3","15.1"
"Toombs","2020-10-12","34","5588","4","1106","11.1","14.7"
"Toombs","2020-10-13","48","5636","5","1111","11.2","15.1"
"Toombs","2020-10-14","32","5668","3","1114","10.2","13.9"
"Toombs","2020-10-15","31","5699","5","1119","11","13.8"
"Toombs","2020-10-16","31","5730","6","1125","12.9","14.9"
"Toombs","2020-10-17","62","5792","7","1132","11.2","14.9"
"Toombs","2020-10-18","9","5801","1","1133","12.8","12.6"
"Toombs","2020-10-19","30","5831","6","1139","14","12.5"
"Toombs","2020-10-20","30","5861","8","1147","16.3","13.7"
"Toombs","2020-10-21","59","5920","7","1154","16.6","13.4"
"Toombs","2020-10-22","21","5941","3","1157","16.4","13.7"
"Toombs","2020-10-23","14","5955","3","1160","16.7","14.8"
"Toombs","2020-10-24","55","6010","2","1162","15.6","13.4"
"Toombs","2020-10-25","13","6023","1","1163","15.1","13.9"
"Toombs","2020-10-26","21","6044","3","1166","14.3","14.1"
"Toombs","2020-10-27","32","6076","7","1173","13.6","14.9"
"Toombs","2020-10-28","14","6090","1","1174","12.9","14.8"
"Toombs","2020-10-29","38","6128","8","1182","13.9","15.1"
"Toombs","2020-10-30","15","6143","1","1183","11.8","14.2"
"Toombs","2020-10-31","23","6166","1","1184","11.9","13.7"
"Toombs","2020-11-01","12","6178","2","1186","13.1","14.1"
"Toombs","2020-11-02","30","6208","6","1192","14","14.1"
"Toombs","2020-11-03","37","6245","2","1194","11.6","12.6"
"Toombs","2020-11-04","36","6281","3","1197","11.8","12.3"
"Toombs","2020-11-05","32","6313","2","1199","9.7","11.8"
"Toombs","2020-11-06","32","6345","4","1203","10.5","11.1"
"Toombs","2020-11-07","18","6363","3","1206","12.3","12.1"
"Toombs","2020-11-08","21","6384","3","1209","11.9","12.5"
"Toombs","2020-11-09","41","6425","3","1212","10.1","12"
"Toombs","2020-11-10","47","6472","5","1217","10.9","11.2"
"Toombs","2020-11-11","34","6506","3","1220","10.9","11.4"
"Toombs","2020-11-12","35","6541","6","1226","12.5","11.1"
"Toombs","2020-11-13","48","6589","6","1232","12.5","11.5"
"Toombs","2020-11-14","20","6609","0","1232","10.1","11.2"
"Toombs","2020-11-15","25","6634","4","1236","10.3","11.1"
"Toombs","2020-11-16","51","6685","6","1242","11","10.5"
"Toombs","2020-11-17","51","6736","8","1250","11.7","11.3"
"Toombs","2020-11-18","44","6780","7","1257","12.7","11.8"
"Toombs","2020-11-19","67","6847","5","1262","11.3","11.9"
"Toombs","2020-11-20","58","6905","7","1269","11.3","11.9"
"Toombs","2020-11-21","18","6923","4","1273","14.4","12.3"
"Toombs","2020-11-22","26","6949","4","1277","14.4","12.4"
"Toombs","2020-11-23","37","6986","7","1284","15.4","13.2"
"Toombs","2020-11-24","28","7014","4","1288","15.2","13.4"
"Toombs","2020-11-25","25","7039","4","1292","15.2","14"
"Toombs","2020-11-26","6","7045","0","1292","14.1","12.7"
"Toombs","2020-11-27","40","7085","8","1300","15.3","13.3"
"Toombs","2020-11-28","34","7119","3","1303","13.3","13.9"
"Toombs","2020-11-29","20","7139","3","1306","13.3","13.8"
"Toombs","2020-11-30","63","7202","8","1314","12.4","13.9"
"Toombs","2020-12-01","56","7258","6","1320","11.9","13.5"
"Toombs","2020-12-02","56","7314","11","1331","12.4","13.8"
"Toombs","2020-12-03","40","7354","4","1335","13.8","14"
"Toombs","2020-12-04","47","7401","8","1343","13.4","14.3"
"Toombs","2020-12-05","29","7430","2","1345","13.1","13.2"
"Toombs","2020-12-06","23","7453","9","1354","16.6","14.9"
"Toombs","2020-12-07","42","7495","6","1360","16.8","14.6"
"Toombs","2020-12-08","47","7542","12","1372","18.9","15.4"
"Toombs","2020-12-09","57","7599","9","1381","18.4","15.4"
"Toombs","2020-12-10","67","7666","6","1387","18.2","16"
"Toombs","2020-12-11","47","7713","10","1397","18.8","16.1"
"Toombs","2020-12-12","39","7752","6","1403","20.1","16.6"
"Toombs","2020-12-13","21","7773","5","1408","17.9","17.2"
"Toombs","2020-12-14","111","7884","14","1422","17.6","17.2"
"Toombs","2020-12-15","65","7949","20","1442","18.4","18.7"
"Toombs","2020-12-16","56","8005","16","1458","20.2","19.3"
"Toombs","2020-12-17","67","8072","21","1479","23.4","20.8"
"Toombs","2020-12-18","57","8129","13","1492","23.6","21.2"
"Toombs","2020-12-19","68","8197","10","1502","23.5","21.8"
"Toombs","2020-12-20","37","8234","12","1514","24.7","21.3"
"Toombs","2020-12-21","88","8322","32","1546","28.1","22.9"
"Toombs","2020-12-22","73","8395","22","1568","28.1","23.2"
"Toombs","2020-12-23","73","8468","20","1588","27.9","24"
"Toombs","2020-12-24","60","8528","11","1599","26","24.7"
"Toombs","2020-12-25","9","8537","4","1603","29.1","26.4"
"Toombs","2020-12-26","26","8563","14","1617","34.7","29.1"
"Toombs","2020-12-27","26","8589","12","1629","36.7","30.7"
"Toombs","2020-12-28","63","8652","26","1655","37.4","32.8"
"Toombs","2020-12-29","76","8728","29","1684","38.5","33.3"
"Toombs","2020-12-30","84","8812","25","1709","38.9","33.4"
"Toombs","2020-12-31","86","8898","28","1737","40.9","33.5"
"Toombs","2021-01-01","11","8909","6","1743","42.3","35.7"
"Toombs","2021-01-02","35","8944","13","1756","39.9","37.3"
"Toombs","2021-01-03","39","8983","22","1778","41.4","39"
"Toombs","2021-01-04","82","9065","32","1810","41.1","39.2"
"Toombs","2021-01-05","104","9169","38","1848","40.9","39.7"
"Toombs","2021-01-06","70","9239","19","1867","40.5","39.7"
"Toombs","2021-01-07","119","9358","40","1907","40.6","40.8"
"Toombs","2021-01-08","42","9400","9","1916","35.9","39.1"
"Toombs","2021-01-09","44","9444","13","1929","34.8","37.4"
"Toombs","2021-01-10","33","9477","8","1937","30.2","35.8"
"Toombs","2021-01-11","63","9540","20","1957","29.2","35.1"
"Toombs","2021-01-12","81","9621","18","1975","27.1","34"
"Toombs","2021-01-13","47","9668","9","1984","26","33.2"
"Toombs","2021-01-14","51","9719","16","2000","25.7","33.2"
"Toombs","2021-01-15","50","9769","12","2012","26","31"
"Toombs","2021-01-16","24","9793","3","2015","23.6","29.2"
"Toombs","2021-01-17","17","9810","4","2019","23.5","26.9"
"Toombs","2021-01-18","52","9862","13","2032","22.5","25.9"
"Toombs","2021-01-19","58","9920","9","2041","21.6","24.4"
"Toombs","2021-01-20","37","9957","7","2048","21.5","23.8"
"Toombs","2021-01-21","51","10008","9","2057","19.6","22.6"
"Toombs","2021-01-22","62","10070","13","2070","19.2","22.6"
"Toombs","2021-01-23","36","10106","8","2078","20.5","22.1"
"Toombs","2021-01-24","9","10115","3","2081","21.9","22.7"
"Toombs","2021-01-25","10","10125","3","2084","22.7","22.6"
"Toombs","2021-01-26","10","10135","2","2086","23.3","22.4"
"Toombs","2021-01-27","0","10135","0","2086","20.6","21.1"
"Towns","2020-02-01","0","0","0","0",".","."
"Towns","2020-02-02","0","0","0","0",".","."
"Towns","2020-02-03","0","0","0","0",".","."
"Towns","2020-02-04","0","0","0","0",".","."
"Towns","2020-02-05","0","0","0","0",".","."
"Towns","2020-02-06","0","0","0","0",".","."
"Towns","2020-02-07","0","0","0","0","0","."
"Towns","2020-02-08","0","0","0","0","0","."
"Towns","2020-02-09","0","0","0","0","0","."
"Towns","2020-02-10","0","0","0","0","0","."
"Towns","2020-02-11","0","0","0","0","0","."
"Towns","2020-02-12","0","0","0","0","0","."
"Towns","2020-02-13","0","0","0","0","0","."
"Towns","2020-02-14","0","0","0","0","0","0"
"Towns","2020-02-15","0","0","0","0","0","0"
"Towns","2020-02-16","0","0","0","0","0","0"
"Towns","2020-02-17","0","0","0","0","0","0"
"Towns","2020-02-18","0","0","0","0","0","0"
"Towns","2020-02-19","0","0","0","0","0","0"
"Towns","2020-02-20","0","0","0","0","0","0"
"Towns","2020-02-21","0","0","0","0","0","0"
"Towns","2020-02-22","0","0","0","0","0","0"
"Towns","2020-02-23","0","0","0","0","0","0"
"Towns","2020-02-24","0","0","0","0","0","0"
"Towns","2020-02-25","0","0","0","0","0","0"
"Towns","2020-02-26","0","0","0","0","0","0"
"Towns","2020-02-27","0","0","0","0","0","0"
"Towns","2020-02-28","0","0","0","0","0","0"
"Towns","2020-02-29","0","0","0","0","0","0"
"Towns","2020-03-01","0","0","0","0","0","0"
"Towns","2020-03-02","0","0","0","0","0","0"
"Towns","2020-03-03","0","0","0","0","0","0"
"Towns","2020-03-04","0","0","0","0","0","0"
"Towns","2020-03-05","0","0","0","0","0","0"
"Towns","2020-03-06","0","0","0","0","0","0"
"Towns","2020-03-07","0","0","0","0","0","0"
"Towns","2020-03-08","0","0","0","0","0","0"
"Towns","2020-03-09","0","0","0","0","0","0"
"Towns","2020-03-10","0","0","0","0","0","0"
"Towns","2020-03-11","2","2","0","0","0","0"
"Towns","2020-03-12","0","2","0","0","0","0"
"Towns","2020-03-13","0","2","0","0","0","0"
"Towns","2020-03-14","0","2","0","0","0","0"
"Towns","2020-03-15","0","2","0","0","0","0"
"Towns","2020-03-16","0","2","0","0","0","0"
"Towns","2020-03-17","1","3","0","0","0","0"
"Towns","2020-03-18","1","4","0","0","0","0"
"Towns","2020-03-19","2","6","0","0","0","0"
"Towns","2020-03-20","2","8","0","0","0","0"
"Towns","2020-03-21","2","10","0","0","0","0"
"Towns","2020-03-22","4","14","0","0","0","0"
"Towns","2020-03-23","0","14","0","0","0","0"
"Towns","2020-03-24","3","17","0","0","0","0"
"Towns","2020-03-25","2","19","0","0","0","0"
"Towns","2020-03-26","0","19","0","0","0","0"
"Towns","2020-03-27","1","20","0","0","0","0"
"Towns","2020-03-28","0","20","0","0","0","0"
"Towns","2020-03-29","0","20","0","0","0","0"
"Towns","2020-03-30","2","22","2","2","14.3","7.1"
"Towns","2020-03-31","1","23","0","2","14.3","7.1"
"Towns","2020-04-01","0","23","0","2","14.3","7.1"
"Towns","2020-04-02","7","30","0","2","14.3","7.1"
"Towns","2020-04-03","4","34","0","2","14.3","7.1"
"Towns","2020-04-04","0","34","0","2","14.3","7.1"
"Towns","2020-04-05","0","34","0","2","14.3","7.1"
"Towns","2020-04-06","0","34","0","2","0","7.1"
"Towns","2020-04-07","1","35","0","2","0","7.1"
"Towns","2020-04-08","0","35","0","2","0","7.1"
"Towns","2020-04-09","3","38","0","2","0","7.1"
"Towns","2020-04-10","0","38","0","2","0","7.1"
"Towns","2020-04-11","0","38","0","2","0","7.1"
"Towns","2020-04-12","0","38","0","2","0","7.1"
"Towns","2020-04-13","2","40","0","2","0","0"
"Towns","2020-04-14","3","43","0","2","0","0"
"Towns","2020-04-15","0","43","0","2","0","0"
"Towns","2020-04-16","1","44","0","2","0","0"
"Towns","2020-04-17","15","59","0","2","0","0"
"Towns","2020-04-18","2","61","0","2","0","0"
"Towns","2020-04-19","0","61","0","2","0","0"
"Towns","2020-04-20","1","62","0","2","0","0"
"Towns","2020-04-21","2","64","0","2","0","0"
"Towns","2020-04-22","2","66","0","2","0","0"
"Towns","2020-04-23","3","69","0","2","0","0"
"Towns","2020-04-24","20","89","0","2","0","0"
"Towns","2020-04-25","0","89","0","2","0","0"
"Towns","2020-04-26","0","89","0","2","0","0"
"Towns","2020-04-27","2","91","0","2","0","0"
"Towns","2020-04-28","25","116","0","2","0","0"
"Towns","2020-04-29","4","120","0","2","0","0"
"Towns","2020-04-30","2","122","0","2","0","0"
"Towns","2020-05-01","20","142","1","3","0.7","0.4"
"Towns","2020-05-02","0","142","0","3","0.7","0.4"
"Towns","2020-05-03","0","142","0","3","0.7","0.4"
"Towns","2020-05-04","1","143","0","3","0.7","0.4"
"Towns","2020-05-05","10","153","0","3","0.7","0.4"
"Towns","2020-05-06","4","157","0","3","0.7","0.4"
"Towns","2020-05-07","2","159","0","3","0.7","0.4"
"Towns","2020-05-08","47","206","0","3","0","0.4"
"Towns","2020-05-09","0","206","0","3","0","0.4"
"Towns","2020-05-10","0","206","0","3","0","0.4"
"Towns","2020-05-11","3","209","0","3","0","0.4"
"Towns","2020-05-12","56","265","0","3","0","0.4"
"Towns","2020-05-13","2","267","0","3","0","0.4"
"Towns","2020-05-14","1","268","0","3","0","0.4"
"Towns","2020-05-15","61","329","5","8","1.2","0.6"
"Towns","2020-05-16","4","333","1","9","4.7","2.4"
"Towns","2020-05-17","0","333","0","9","4.7","2.4"
"Towns","2020-05-18","5","338","1","10","7.6","3.8"
"Towns","2020-05-19","15","353","0","10","7.6","3.8"
"Towns","2020-05-20","2","355","1","11","14.7","7.4"
"Towns","2020-05-21","3","358","0","11","14.7","7.4"
"Towns","2020-05-22","40","398","1","12","13.9","7.5"
"Towns","2020-05-23","1","399","0","12","10.4","7.5"
"Towns","2020-05-24","1","400","0","12","10.4","7.5"
"Towns","2020-05-25","1","401","0","12","7.5","7.5"
"Towns","2020-05-26","26","427","0","12","7.5","7.5"
"Towns","2020-05-27","6","433","0","12","0.4","7.5"
"Towns","2020-05-28","31","464","1","13","0.8","7.8"
"Towns","2020-05-29","5","469","0","13","0.5","7.2"
"Towns","2020-05-30","0","469","0","13","0.5","5.4"
"Towns","2020-05-31","1","470","0","13","0.5","5.4"
"Towns","2020-06-01","7","477","0","13","0.5","4"
"Towns","2020-06-02","35","512","2","15","1.3","4.4"
"Towns","2020-06-03","3","515","0","15","1.3","0.8"
"Towns","2020-06-04","5","520","0","15","0.8","0.8"
"Towns","2020-06-05","47","567","1","16","1.1","0.8"
"Towns","2020-06-06","0","567","0","16","1.1","0.8"
"Towns","2020-06-07","1","568","0","16","1.1","0.8"
"Towns","2020-06-08","8","576","1","17","2.9","1.7"
"Towns","2020-06-09","34","610","1","18","2.5","1.9"
"Towns","2020-06-10","2","612","0","18","2.5","1.9"
"Towns","2020-06-11","5","617","0","18","2.5","1.7"
"Towns","2020-06-12","43","660","0","18","2.2","1.7"
"Towns","2020-06-13","0","660","0","18","2.2","1.7"
"Towns","2020-06-14","0","660","0","18","2.2","1.7"
"Towns","2020-06-15","11","671","0","18","0.4","1.7"
"Towns","2020-06-16","1","672","0","18","0","1.3"
"Towns","2020-06-17","2","674","1","19","7.1","4.8"
"Towns","2020-06-18","4","678","0","19","7.1","4.8"
"Towns","2020-06-19","64","742","0","19","7.1","4.7"
"Towns","2020-06-20","0","742","0","19","7.1","4.7"
"Towns","2020-06-21","0","742","0","19","7.1","4.7"
"Towns","2020-06-22","5","747","0","19","7.1","3.8"
"Towns","2020-06-23","4","751","0","19","7.1","3.6"
"Towns","2020-06-24","5","756","0","19","0","3.6"
"Towns","2020-06-25","9","765","0","19","0","3.6"
"Towns","2020-06-26","112","877","9","28","1.1","4.1"
"Towns","2020-06-27","1","878","0","28","1.1","4.1"
"Towns","2020-06-28","0","878","0","28","1.1","4.1"
"Towns","2020-06-29","109","987","7","35","2.1","4.6"
"Towns","2020-06-30","9","996","1","36","3.7","5.4"
"Towns","2020-07-01","4","1000","1","37","7.2","3.6"
"Towns","2020-07-02","111","1111","9","46","8.4","4.2"
"Towns","2020-07-03","11","1122","0","46","7.2","4.2"
"Towns","2020-07-04","0","1122","0","46","7.2","4.2"
"Towns","2020-07-05","1","1123","0","46","7.2","4.2"
"Towns","2020-07-06","113","1236","14","60","8.1","5.1"
"Towns","2020-07-07","9","1245","0","60","6.5","5.1"
"Towns","2020-07-08","10","1255","4","64","8.6","7.9"
"Towns","2020-07-09","21","1276","1","65","8.2","8.3"
"Towns","2020-07-10","139","1415","4","69","8.6","7.9"
"Towns","2020-07-11","2","1417","0","69","8.6","7.9"
"Towns","2020-07-12","13","1430","1","70","9.7","8.5"
"Towns","2020-07-13","60","1490","3","73","8.6","8.4"
"Towns","2020-07-14","8","1498","3","76","14","10.2"
"Towns","2020-07-15","17","1515","1","77","9.1","8.9"
"Towns","2020-07-16","14","1529","1","78","9.4","8.8"
"Towns","2020-07-17","154","1683","2","80","9.2","8.9"
"Towns","2020-07-18","1","1684","0","80","9.2","8.9"
"Towns","2020-07-19","14","1698","3","83","11.2","10.4"
"Towns","2020-07-20","12","1710","2","85","12.8","10.7"
"Towns","2020-07-21","11","1721","6","91","15.3","14.6"
"Towns","2020-07-22","21","1742","5","96","17.8","13.5"
"Towns","2020-07-23","19","1761","3","99","19.1","14.3"
"Towns","2020-07-24","23","1784","5","104","22","15.6"
"Towns","2020-07-25","11","1795","2","106","24.6","16.9"
"Towns","2020-07-26","8","1803","3","109","26.9","19"
"Towns","2020-07-27","13","1816","4","113","28.9","20.9"
"Towns","2020-07-28","8","1824","3","116","26.5","20.9"
"Towns","2020-07-29","19","1843","1","117","23.8","20.8"
"Towns","2020-07-30","13","1856","1","118","22.7","20.9"
"Towns","2020-07-31","151","2007","9","127","20.4","21.2"
"Towns","2020-08-01","7","2014","3","130","23.9","24.3"
"Towns","2020-08-02","5","2019","1","131","21.4","24.2"
"Towns","2020-08-03","5","2024","1","132","19.9","24.4"
"Towns","2020-08-04","154","2178","3","135","14.8","20.6"
"Towns","2020-08-05","23","2201","8","143","19","21.4"
"Towns","2020-08-06","4","2205","1","144","21.5","22.1"
"Towns","2020-08-07","130","2335","11","155","21.9","21.1"
"Towns","2020-08-08","0","2335","0","155","15.7","19.8"
"Towns","2020-08-09","6","2341","2","157","17.6","19.5"
"Towns","2020-08-10","26","2367","6","163","18.1","19"
"Towns","2020-08-11","141","2508","2","165","18","16.4"
"Towns","2020-08-12","31","2539","5","170","15.3","17.2"
"Towns","2020-08-13","9","2548","2","172","14.9","18.2"
"Towns","2020-08-14","132","2680","15","187","15.4","18.6"
"Towns","2020-08-15","2","2682","0","187","15.4","15.6"
"Towns","2020-08-16","24","2706","3","190","12.4","15"
"Towns","2020-08-17","13","2719","0","190","9.1","13.6"
"Towns","2020-08-18","134","2853","4","194","9.3","13.7"
"Towns","2020-08-19","10","2863","0","194","7","11.2"
"Towns","2020-08-20","89","2952","14","208","6.1","10.5"
"Towns","2020-08-21","17","2969","2","210","6.1","10.8"
"Towns","2020-08-22","13","2982","2","212","8.3","11.9"
"Towns","2020-08-23","5","2987","1","213","9.4","10.9"
"Towns","2020-08-24","6","2993","3","216","16.6","12.8"
"Towns","2020-08-25","71","3064","4","220","16.9","13.1"
"Towns","2020-08-26","14","3078","3","223","20","13.5"
"Towns","2020-08-27","7","3085","1","224","19.8","12.9"
"Towns","2020-08-28","97","3182","9","233","19.4","12.8"
"Towns","2020-08-29","1","3183","0","233","17.2","12.8"
"Towns","2020-08-30","17","3200","4","237","17.7","13.6"
"Towns","2020-08-31","6","3206","2","239","15.4","16"
"Towns","2020-09-01","5","3211","0","239","14.6","15.7"
"Towns","2020-09-02","17","3228","0","239","11.5","15.7"
"Towns","2020-09-03","11","3239","1","240","10.7","15.3"
"Towns","2020-09-04","116","3355","22","262","12.1","15.8"
"Towns","2020-09-05","8","3363","4","266","19.3","18.3"
"Towns","2020-09-06","9","3372","3","269","20.7","19.2"
"Towns","2020-09-07","1","3373","0","269","15.9","15.6"
"Towns","2020-09-08","46","3419","1","270","16.2","15.4"
"Towns","2020-09-09","9","3428","1","271","17.8","14.7"
"Towns","2020-09-10","10","3438","0","271","16.5","13.6"
"Towns","2020-09-11","23","3461","5","276","16.9","14.5"
"Towns","2020-09-12","12","3473","0","276","9.8","14.5"
"Towns","2020-09-13","12","3485","0","276","5","12.8"
"Towns","2020-09-14","12","3497","2","278","7.4","11.6"
"Towns","2020-09-15","3","3500","0","278","7.1","11.6"
"Towns","2020-09-16","7","3507","1","279","7.5","12.7"
"Towns","2020-09-17","13","3520","3","282","10.8","13.7"
"Towns","2020-09-18","122","3642","3","285","8.1","12.5"
"Towns","2020-09-19","4","3646","0","285","8.1","8.9"
"Towns","2020-09-20","1","3647","0","285","8.1","6.5"
"Towns","2020-09-21","9","3656","2","287","8.9","8.1"
"Towns","2020-09-22","39","3695","1","288","9.2","8.2"
"Towns","2020-09-23","16","3711","3","291","9.9","8.7"
"Towns","2020-09-24","9","3720","0","291","6.6","8.7"
"Towns","2020-09-25","12","3732","5","296","12.2","10.1"
"Towns","2020-09-26","14","3746","3","299","15.2","11.7"
"Towns","2020-09-27","0","3746","0","299","15.2","11.7"
"Towns","2020-09-28","12","3758","0","299","12.1","10.5"
"Towns","2020-09-29","6","3764","0","299","11.7","10.5"
"Towns","2020-09-30","17","3781","1","300","9.9","9.9"
"Towns","2020-10-01","6","3787","0","300","9.9","8.2"
"Towns","2020-10-02","92","3879","0","300","3.9","8"
"Towns","2020-10-03","8","3887","1","301","2.6","8.9"
"Towns","2020-10-04","4","3891","2","303","9.8","12.5"
"Towns","2020-10-05","18","3909","5","308","13.7","12.9"
"Towns","2020-10-06","9","3918","1","309","15.3","13.5"
"Towns","2020-10-07","6","3924","0","309","14.5","12.2"
"Towns","2020-10-08","7","3931","0","309","14.5","12.2"
"Towns","2020-10-09","3","3934","0","309","14.5","9.2"
"Towns","2020-10-10","1","3935","0","309","12.7","7.7"
"Towns","2020-10-11","3","3938","1","310","10.3","10"
"Towns","2020-10-12","11","3949","1","311","7.6","10.7"
"Towns","2020-10-13","6","3955","0","311","6.1","10.7"
"Towns","2020-10-14","8","3963","0","311","6.1","10.3"
"Towns","2020-10-15","5","3968","0","311","6.1","10.3"
"Towns","2020-10-16","88","4056","5","316","6.9","10.7"
"Towns","2020-10-17","2","4058","0","316","6.9","9.8"
"Towns","2020-10-18","1","4059","0","316","2.1","6.2"
"Towns","2020-10-19","8","4067","1","317","2.6","5.1"
"Towns","2020-10-20","4","4071","0","317","2.6","4.3"
"Towns","2020-10-21","5","4076","1","318","5.5","5.8"
"Towns","2020-10-22","22","4098","7","325","10","8"
"Towns","2020-10-23","4","4102","0","325","9.2","8"
"Towns","2020-10-24","4","4106","0","325","9.2","8"
"Towns","2020-10-25","1","4107","1","326","23.5","12.8"
"Towns","2020-10-26","9","4116","3","329","26.5","14.5"
"Towns","2020-10-27","8","4124","1","330","28.2","15.4"
"Towns","2020-10-28","7","4131","0","330","25.4","15.4"
"Towns","2020-10-29","4","4135","0","330","20.8","15.4"
"Towns","2020-10-30","79","4214","7","337","22.1","15.6"
"Towns","2020-10-31","1","4215","0","337","22.1","15.6"
"Towns","2020-11-01","2","4217","2","339","22.1","22.8"
"Towns","2020-11-02","6","4223","0","339","17.3","21.9"
"Towns","2020-11-03","3","4226","0","339","15.6","21.9"
"Towns","2020-11-04","6","4232","1","340","17.9","21.7"
"Towns","2020-11-05","10","4242","1","341","19.4","20.1"
"Towns","2020-11-06","6","4248","1","342","20.5","21.3"
"Towns","2020-11-07","2","4250","0","342","20.5","21.3"
"Towns","2020-11-08","4","4254","1","343","9.8","15.9"
"Towns","2020-11-09","8","4262","0","343","9.8","13.5"
"Towns","2020-11-10","7","4269","1","344","11.8","13.7"
"Towns","2020-11-11","8","4277","0","344","9.4","13.7"
"Towns","2020-11-12","12","4289","2","346","10.4","14.9"
"Towns","2020-11-13","82","4371","9","355","9.6","15"
"Towns","2020-11-14","1","4372","0","355","9.6","15"
"Towns","2020-11-15","4","4376","0","355","6","7.9"
"Towns","2020-11-16","8","4384","0","355","6","7.9"
"Towns","2020-11-17","9","4393","1","356","5.5","8.7"
"Towns","2020-11-18","11","4404","1","357","6.8","8.1"
"Towns","2020-11-19","19","4423","1","358","5.2","7.8"
"Towns","2020-11-20","85","4508","13","371","5.8","7.7"
"Towns","2020-11-21","5","4513","0","371","5.8","7.7"
"Towns","2020-11-22","1","4514","0","371","5.8","5.9"
"Towns","2020-11-23","14","4528","3","374","8.9","7.4"
"Towns","2020-11-24","8","4536","0","374","7.3","6.4"
"Towns","2020-11-25","18","4554","7","381","11.6","9.2"
"Towns","2020-11-26","1","4555","0","381","10.8","8"
"Towns","2020-11-27","11","4566","3","384","12.5","9.2"
"Towns","2020-11-28","24","4590","5","389","15.5","10.7"
"Towns","2020-11-29","9","4599","3","392","20.3","13"
"Towns","2020-11-30","15","4614","6","398","22.9","15.9"
"Towns","2020-12-01","23","4637","3","401","24.8","16"
"Towns","2020-12-02","18","4655","5","406","23.2","17.4"
"Towns","2020-12-03","28","4683","5","411","25.7","18.3"
"Towns","2020-12-04","28","4711","5","416","24.4","18.4"
"Towns","2020-12-05","21","4732","4","420","24.1","19.8"
"Towns","2020-12-06","1","4733","0","420","19.4","19.8"
"Towns","2020-12-07","29","4762","2","422","14.6","18.8"
"Towns","2020-12-08","18","4780","5","427","16.7","20.8"
"Towns","2020-12-09","23","4803","0","427","12.8","18"
"Towns","2020-12-10","31","4834","6","433","13","19.4"
"Towns","2020-12-11","24","4858","2","435","11.6","18"
"Towns","2020-12-12","22","4880","3","438","10.9","17.5"
"Towns","2020-12-13","7","4887","2","440","14.9","17.2"
"Towns","2020-12-14","30","4917","1","441","14.4","14.5"
"Towns","2020-12-15","34","4951","2","443","11.3","14"
"Towns","2020-12-16","59","5010","11","454","14","13.4"
"Towns","2020-12-17","34","5044","5","459","13.3","13.1"
"Towns","2020-12-18","24","5068","3","462","13.9","12.8"
"Towns","2020-12-19","14","5082","4","466","16","13.4"
"Towns","2020-12-20","10","5092","2","468","14.8","14.9"
"Towns","2020-12-21","27","5119","4","472","16.4","15.4"
"Towns","2020-12-22","27","5146","5","477","18.3","14.8"
"Towns","2020-12-23","35","5181","6","483","18","16"
"Towns","2020-12-24","26","5207","5","488","18.7","16"
"Towns","2020-12-25","2","5209","0","488","16.9","15.4"
"Towns","2020-12-26","6","5215","3","491","20","18"
"Towns","2020-12-27","15","5230","8","499","24.7","19.8"
"Towns","2020-12-28","19","5249","5","504","26.4","21.4"
"Towns","2020-12-29","43","5292","11","515","27.4","22.8"
"Towns","2020-12-30","51","5343","15","530","29.1","23.6"
"Towns","2020-12-31","47","5390","10","540","29.4","24"
"Towns","2021-01-01","18","5408","8","548","35.8","26.3"
"Towns","2021-01-02","19","5427","4","552","31.6","25.8"
"Towns","2021-01-03","5","5432","1","553","26.9","25.8"
"Towns","2021-01-04","33","5465","8","561","26.6","26.5"
"Towns","2021-01-05","54","5519","9","570","25.3","26.3"
"Towns","2021-01-06","42","5561","12","582","25.2","27.2"
"Towns","2021-01-07","46","5607","7","589","24.3","26.9"
"Towns","2021-01-08","50","5657","15","604","22.3","29"
"Towns","2021-01-09","13","5670","3","607","22.5","27.1"
"Towns","2021-01-10","16","5686","3","610","22.4","24.6"
"Towns","2021-01-11","13","5699","2","612","21.1","23.8"
"Towns","2021-01-12","20","5719","1","613","19.4","22.4"
"Towns","2021-01-13","21","5740","4","617","18.1","21.6"
"Towns","2021-01-14","12","5752","1","618","17.1","20.7"
"Towns","2021-01-15","27","5779","10","628","18.1","20.2"
"Towns","2021-01-16","22","5801","7","635","19.3","20.9"
"Towns","2021-01-17","4","5805","0","635","16.7","19.5"
"Towns","2021-01-18","5","5810","1","636","17.3","19.2"
"Towns","2021-01-19","10","5820","2","638","19.5","19.4"
"Towns","2021-01-20","12","5832","0","638","16.7","17.4"
"Towns","2021-01-21","11","5843","1","639","16.8","17"
"Towns","2021-01-22","12","5855","3","642","15.1","16.6"
"Towns","2021-01-23","8","5863","0","642","10.6","15"
"Towns","2021-01-24","3","5866","0","642","10.6","13.6"
"Towns","2021-01-25","1","5867","1","643","22","19.7"
"Towns","2021-01-26","0","5867","0","643","19.2","19.3"
"Towns","2021-01-27","0","5867","0","643","19.2","17.9"
"Treutlen","2020-02-01","0","0","0","0",".","."
"Treutlen","2020-02-02","0","0","0","0",".","."
"Treutlen","2020-02-03","0","0","0","0",".","."
"Treutlen","2020-02-04","0","0","0","0",".","."
"Treutlen","2020-02-05","0","0","0","0",".","."
"Treutlen","2020-02-06","0","0","0","0",".","."
"Treutlen","2020-02-07","0","0","0","0","0","."
"Treutlen","2020-02-08","0","0","0","0","0","."
"Treutlen","2020-02-09","0","0","0","0","0","."
"Treutlen","2020-02-10","0","0","0","0","0","."
"Treutlen","2020-02-11","0","0","0","0","0","."
"Treutlen","2020-02-12","0","0","0","0","0","."
"Treutlen","2020-02-13","0","0","0","0","0","."
"Treutlen","2020-02-14","0","0","0","0","0","0"
"Treutlen","2020-02-15","0","0","0","0","0","0"
"Treutlen","2020-02-16","0","0","0","0","0","0"
"Treutlen","2020-02-17","0","0","0","0","0","0"
"Treutlen","2020-02-18","0","0","0","0","0","0"
"Treutlen","2020-02-19","0","0","0","0","0","0"
"Treutlen","2020-02-20","0","0","0","0","0","0"
"Treutlen","2020-02-21","0","0","0","0","0","0"
"Treutlen","2020-02-22","0","0","0","0","0","0"
"Treutlen","2020-02-23","0","0","0","0","0","0"
"Treutlen","2020-02-24","0","0","0","0","0","0"
"Treutlen","2020-02-25","0","0","0","0","0","0"
"Treutlen","2020-02-26","0","0","0","0","0","0"
"Treutlen","2020-02-27","0","0","0","0","0","0"
"Treutlen","2020-02-28","0","0","0","0","0","0"
"Treutlen","2020-02-29","0","0","0","0","0","0"
"Treutlen","2020-03-01","0","0","0","0","0","0"
"Treutlen","2020-03-02","0","0","0","0","0","0"
"Treutlen","2020-03-03","0","0","0","0","0","0"
"Treutlen","2020-03-04","0","0","0","0","0","0"
"Treutlen","2020-03-05","0","0","0","0","0","0"
"Treutlen","2020-03-06","0","0","0","0","0","0"
"Treutlen","2020-03-07","0","0","0","0","0","0"
"Treutlen","2020-03-08","0","0","0","0","0","0"
"Treutlen","2020-03-09","0","0","0","0","0","0"
"Treutlen","2020-03-10","0","0","0","0","0","0"
"Treutlen","2020-03-11","1","1","0","0","0","0"
"Treutlen","2020-03-12","1","2","0","0","0","0"
"Treutlen","2020-03-13","0","2","0","0","0","0"
"Treutlen","2020-03-14","0","2","0","0","0","0"
"Treutlen","2020-03-15","0","2","0","0","0","0"
"Treutlen","2020-03-16","0","2","0","0","0","0"
"Treutlen","2020-03-17","0","2","0","0","0","0"
"Treutlen","2020-03-18","0","2","0","0","0","0"
"Treutlen","2020-03-19","1","3","0","0","0","0"
"Treutlen","2020-03-20","0","3","0","0","0","0"
"Treutlen","2020-03-21","3","6","0","0","0","0"
"Treutlen","2020-03-22","3","9","0","0","0","0"
"Treutlen","2020-03-23","2","11","0","0","0","0"
"Treutlen","2020-03-24","1","12","0","0","0","0"
"Treutlen","2020-03-25","2","14","0","0","0","0"
"Treutlen","2020-03-26","1","15","0","0","0","0"
"Treutlen","2020-03-27","0","15","0","0","0","0"
"Treutlen","2020-03-28","0","15","0","0","0","0"
"Treutlen","2020-03-29","0","15","0","0","0","0"
"Treutlen","2020-03-30","1","16","0","0","0","0"
"Treutlen","2020-03-31","0","16","0","0","0","0"
"Treutlen","2020-04-01","2","18","0","0","0","0"
"Treutlen","2020-04-02","0","18","0","0","0","0"
"Treutlen","2020-04-03","4","22","0","0","0","0"
"Treutlen","2020-04-04","2","24","0","0","0","0"
"Treutlen","2020-04-05","0","24","0","0","0","0"
"Treutlen","2020-04-06","2","26","0","0","0","0"
"Treutlen","2020-04-07","0","26","0","0","0","0"
"Treutlen","2020-04-08","1","27","0","0","0","0"
"Treutlen","2020-04-09","0","27","0","0","0","0"
"Treutlen","2020-04-10","0","27","0","0","0","0"
"Treutlen","2020-04-11","0","27","0","0","0","0"
"Treutlen","2020-04-12","1","28","0","0","0","0"
"Treutlen","2020-04-13","2","30","0","0","0","0"
"Treutlen","2020-04-14","1","31","0","0","0","0"
"Treutlen","2020-04-15","2","33","0","0","0","0"
"Treutlen","2020-04-16","3","36","2","2","9.5","4.8"
"Treutlen","2020-04-17","0","36","0","2","9.5","4.8"
"Treutlen","2020-04-18","0","36","0","2","9.5","4.8"
"Treutlen","2020-04-19","0","36","0","2","9.5","4.8"
"Treutlen","2020-04-20","3","39","0","2","9.5","4.8"
"Treutlen","2020-04-21","7","46","0","2","9.5","4.8"
"Treutlen","2020-04-22","0","46","0","2","9.5","4.8"
"Treutlen","2020-04-23","2","48","0","2","0","4.8"
"Treutlen","2020-04-24","2","50","1","3","7.1","8.3"
"Treutlen","2020-04-25","2","52","0","3","7.1","8.3"
"Treutlen","2020-04-26","0","52","0","3","7.1","8.3"
"Treutlen","2020-04-27","0","52","0","3","7.1","8.3"
"Treutlen","2020-04-28","4","56","0","3","7.1","8.3"
"Treutlen","2020-04-29","4","60","0","3","7.1","8.3"
"Treutlen","2020-04-30","3","63","0","3","7.1","3.6"
"Treutlen","2020-05-01","2","65","0","3","0","3.6"
"Treutlen","2020-05-02","0","65","0","3","0","3.6"
"Treutlen","2020-05-03","4","69","1","4","3.6","5.4"
"Treutlen","2020-05-04","1","70","0","4","3.6","5.4"
"Treutlen","2020-05-05","1","71","0","4","3.6","5.4"
"Treutlen","2020-05-06","0","71","0","4","3.6","5.4"
"Treutlen","2020-05-07","0","71","0","4","3.6","5.4"
"Treutlen","2020-05-08","0","71","0","4","3.6","1.8"
"Treutlen","2020-05-09","0","71","0","4","3.6","1.8"
"Treutlen","2020-05-10","1","72","0","4","0","1.8"
"Treutlen","2020-05-11","0","72","0","4","0","1.8"
"Treutlen","2020-05-12","1","73","0","4","0","1.8"
"Treutlen","2020-05-13","2","75","0","4","0","1.8"
"Treutlen","2020-05-14","1","76","0","4","0","1.8"
"Treutlen","2020-05-15","0","76","0","4","0","1.8"
"Treutlen","2020-05-16","1","77","0","4","0","1.8"
"Treutlen","2020-05-17","0","77","0","4","0","0"
"Treutlen","2020-05-18","2","79","0","4","0","0"
"Treutlen","2020-05-19","3","82","0","4","0","0"
"Treutlen","2020-05-20","2","84","0","4","0","0"
"Treutlen","2020-05-21","7","91","0","4","0","0"
"Treutlen","2020-05-22","1","92","0","4","0","0"
"Treutlen","2020-05-23","0","92","0","4","0","0"
"Treutlen","2020-05-24","0","92","0","4","0","0"
"Treutlen","2020-05-25","1","93","0","4","0","0"
"Treutlen","2020-05-26","1","94","0","4","0","0"
"Treutlen","2020-05-27","65","159","1","5","0.2","0.1"
"Treutlen","2020-05-28","5","164","0","5","0.2","0.1"
"Treutlen","2020-05-29","8","172","2","7","3.8","1.9"
"Treutlen","2020-05-30","5","177","2","9","9.5","4.8"
"Treutlen","2020-05-31","2","179","0","9","9.5","4.8"
"Treutlen","2020-06-01","4","183","0","9","9.5","4.8"
"Treutlen","2020-06-02","5","188","0","9","9.5","4.8"
"Treutlen","2020-06-03","6","194","0","9","9.3","4.8"
"Treutlen","2020-06-04","2","196","0","9","9.3","4.8"
"Treutlen","2020-06-05","4","200","0","9","5.7","4.8"
"Treutlen","2020-06-06","2","202","0","9","0","4.8"
"Treutlen","2020-06-07","1","203","0","9","0","4.8"
"Treutlen","2020-06-08","4","207","0","9","0","4.8"
"Treutlen","2020-06-09","4","211","0","9","0","4.8"
"Treutlen","2020-06-10","12","223","0","9","0","4.6"
"Treutlen","2020-06-11","8","231","0","9","0","4.6"
"Treutlen","2020-06-12","4","235","0","9","0","2.9"
"Treutlen","2020-06-13","6","241","0","9","0","0"
"Treutlen","2020-06-14","0","241","0","9","0","0"
"Treutlen","2020-06-15","2","243","0","9","0","0"
"Treutlen","2020-06-16","2","245","0","9","0","0"
"Treutlen","2020-06-17","3","248","0","9","0","0"
"Treutlen","2020-06-18","2","250","0","9","0","0"
"Treutlen","2020-06-19","3","253","0","9","0","0"
"Treutlen","2020-06-20","0","253","0","9","0","0"
"Treutlen","2020-06-21","1","254","1","10","14.3","7.1"
"Treutlen","2020-06-22","3","257","1","11","19","9.5"
"Treutlen","2020-06-23","1","258","0","11","19","9.5"
"Treutlen","2020-06-24","3","261","1","12","23.8","11.9"
"Treutlen","2020-06-25","1","262","0","12","23.8","11.9"
"Treutlen","2020-06-26","2","264","0","12","23.8","11.9"
"Treutlen","2020-06-27","1","265","0","12","23.8","11.9"
"Treutlen","2020-06-28","2","267","0","12","9.5","11.9"
"Treutlen","2020-06-29","8","275","0","12","4.8","11.9"
"Treutlen","2020-06-30","6","281","1","13","7.1","13.1"
"Treutlen","2020-07-01","3","284","0","13","2.4","13.1"
"Treutlen","2020-07-02","8","292","1","14","4.2","14"
"Treutlen","2020-07-03","3","295","1","15","8.9","16.4"
"Treutlen","2020-07-04","2","297","1","16","16.1","19.9"
"Treutlen","2020-07-05","4","301","0","16","16.1","12.8"
"Treutlen","2020-07-06","11","312","2","18","18.7","11.7"
"Treutlen","2020-07-07","15","327","3","21","19.1","13.1"
"Treutlen","2020-07-08","3","330","0","21","19.1","10.8"
"Treutlen","2020-07-09","6","336","2","23","22.1","13.1"
"Treutlen","2020-07-10","3","339","0","23","17.4","13.1"
"Treutlen","2020-07-11","3","342","1","24","15","15.5"
"Treutlen","2020-07-12","3","345","0","24","15","15.5"
"Treutlen","2020-07-13","5","350","0","24","12.4","15.5"
"Treutlen","2020-07-14","9","359","2","26","12.7","15.9"
"Treutlen","2020-07-15","12","371","1","27","13.9","16.5"
"Treutlen","2020-07-16","6","377","3","30","16.3","19.2"
"Treutlen","2020-07-17","8","385","1","31","18.1","17.7"
"Treutlen","2020-07-18","2","387","0","31","13.3","14.1"
"Treutlen","2020-07-19","3","390","0","31","13.3","14.1"
"Treutlen","2020-07-20","3","393","0","31","13.3","12.8"
"Treutlen","2020-07-21","4","397","0","31","10.1","11.4"
"Treutlen","2020-07-22","8","405","0","31","8.9","11.4"
"Treutlen","2020-07-23","10","415","1","32","3.2","9.7"
"Treutlen","2020-07-24","3","418","0","32","1.4","9.7"
"Treutlen","2020-07-25","3","421","1","33","6.2","9.7"
"Treutlen","2020-07-26","0","421","0","33","6.2","9.7"
"Treutlen","2020-07-27","7","428","2","35","10.3","11.8"
"Treutlen","2020-07-28","4","432","1","36","13.8","12"
"Treutlen","2020-07-29","14","446","6","42","20","14.4"
"Treutlen","2020-07-30","6","452","1","43","20.9","12.1"
"Treutlen","2020-07-31","8","460","3","46","26.3","13.9"
"Treutlen","2020-08-01","2","462","0","46","21.5","13.9"
"Treutlen","2020-08-02","6","468","1","47","23.9","15"
"Treutlen","2020-08-03","11","479","6","53","27.6","18.9"
"Treutlen","2020-08-04","3","482","2","55","33.6","23.7"
"Treutlen","2020-08-05","5","487","2","57","33.1","26.6"
"Treutlen","2020-08-06","4","491","1","58","34.3","27.6"
"Treutlen","2020-08-07","4","495","1","59","32.6","29.4"
"Treutlen","2020-08-08","6","501","2","61","37.3","29.4"
"Treutlen","2020-08-09","2","503","0","61","34.9","29.4"
"Treutlen","2020-08-10","4","507","0","61","27.1","27.4"
"Treutlen","2020-08-11","13","520","7","68","25.3","29.4"
"Treutlen","2020-08-12","4","524","1","69","23.2","28.2"
"Treutlen","2020-08-13","2","526","0","69","19.6","27"
"Treutlen","2020-08-14","4","530","0","69","16","24.3"
"Treutlen","2020-08-15","7","537","0","69","11.3","24.3"
"Treutlen","2020-08-16","2","539","2","71","25.5","30.2"
"Treutlen","2020-08-17","9","548","0","71","25.5","26.3"
"Treutlen","2020-08-18","8","556","6","77","28.6","26.9"
"Treutlen","2020-08-19","10","566","1","78","26.4","24.8"
"Treutlen","2020-08-20","5","571","1","79","29.3","24.4"
"Treutlen","2020-08-21","7","578","1","80","31.3","23.7"
"Treutlen","2020-08-22","5","583","2","82","37","24.2"
"Treutlen","2020-08-23","5","588","2","84","28.5","27"
"Treutlen","2020-08-24","7","595","1","85","30.5","28"
"Treutlen","2020-08-25","8","603","1","86","21.6","25.1"
"Treutlen","2020-08-26","15","618","5","91","24.9","25.7"
"Treutlen","2020-08-27","12","630","3","94","25.6","27.5"
"Treutlen","2020-08-28","6","636","3","97","30.7","31"
"Treutlen","2020-08-29","27","663","3","100","26.6","31.8"
"Treutlen","2020-08-30","3","666","1","101","25.7","27.1"
"Treutlen","2020-08-31","6","672","0","101","23.6","27.1"
"Treutlen","2020-09-01","7","679","3","104","27.9","24.8"
"Treutlen","2020-09-02","7","686","0","104","23.2","24.1"
"Treutlen","2020-09-03","5","691","3","107","28.2","26.9"
"Treutlen","2020-09-04","4","695","0","107","21","25.9"
"Treutlen","2020-09-05","15","710","0","107","19.5","23"
"Treutlen","2020-09-06","16","726","0","107","14.7","20.2"
"Treutlen","2020-09-07","2","728","2","109","29","26.3"
"Treutlen","2020-09-08","32","760","3","112","24.2","26.1"
"Treutlen","2020-09-09","3","763","0","112","24.2","23.7"
"Treutlen","2020-09-10","11","774","1","113","16.9","22.6"
"Treutlen","2020-09-11","3","777","0","113","16.9","19"
"Treutlen","2020-09-12","4","781","1","114","20.5","20"
"Treutlen","2020-09-13","1","782","0","114","20.5","17.6"
"Treutlen","2020-09-14","29","811","5","119","8.7","18.8"
"Treutlen","2020-09-15","6","817","0","119","7.3","15.8"
"Treutlen","2020-09-16","3","820","0","119","7.3","15.8"
"Treutlen","2020-09-17","40","860","0","119","6","11.5"
"Treutlen","2020-09-18","3","863","0","119","6","11.5"
"Treutlen","2020-09-19","2","865","0","119","2.5","11.5"
"Treutlen","2020-09-20","2","867","1","120","9.6","15.1"
"Treutlen","2020-09-21","31","898","4","124","9","8.8"
"Treutlen","2020-09-22","3","901","0","124","9","8.2"
"Treutlen","2020-09-23","16","917","0","124","9","8.2"
"Treutlen","2020-09-24","4","921","0","124","9","7.5"
"Treutlen","2020-09-25","4","925","0","124","9","7.5"
"Treutlen","2020-09-26","1","926","0","124","9","5.7"
"Treutlen","2020-09-27","3","929","0","124","1.8","5.7"
"Treutlen","2020-09-28","33","962","6","130","2.6","5.8"
"Treutlen","2020-09-29","6","968","1","131","5","7"
"Treutlen","2020-09-30","10","978","1","132","6.4","7.7"
"Treutlen","2020-10-01","7","985","1","133","8.4","8.7"
"Treutlen","2020-10-02","5","990","0","133","8.4","8.7"
"Treutlen","2020-10-03","2","992","0","133","8.4","8.7"
"Treutlen","2020-10-04","3","995","1","134","13.2","7.5"
"Treutlen","2020-10-05","49","1044","5","139","12.1","7.3"
"Treutlen","2020-10-06","23","1067","1","140","10.3","7.6"
"Treutlen","2020-10-07","11","1078","0","140","8.9","7.6"
"Treutlen","2020-10-08","9","1087","2","142","10","9.2"
"Treutlen","2020-10-09","3","1090","2","144","19.5","14"
"Treutlen","2020-10-10","21","1111","0","144","19.5","14"
"Treutlen","2020-10-11","3","1114","0","144","14.8","14"
"Treutlen","2020-10-12","2","1116","0","144","13.3","12.7"
"Treutlen","2020-10-13","1","1117","0","144","12.7","11.5"
"Treutlen","2020-10-14","5","1122","2","146","18.4","13.6"
"Treutlen","2020-10-15","2","1124","1","147","22.4","16.2"
"Treutlen","2020-10-16","21","1145","2","149","14.2","16.9"
"Treutlen","2020-10-17","3","1148","1","150","19","19.3"
"Treutlen","2020-10-18","3","1151","1","151","23.7","19.3"
"Treutlen","2020-10-19","34","1185","7","158","26.7","20"
"Treutlen","2020-10-20","8","1193","0","158","26.7","19.7"
"Treutlen","2020-10-21","5","1198","1","159","23.8","21.1"
"Treutlen","2020-10-22","3","1201","0","159","16.7","19.5"
"Treutlen","2020-10-23","3","1204","1","160","20.1","17.2"
"Treutlen","2020-10-24","21","1225","0","160","15.3","17.2"
"Treutlen","2020-10-25","1","1226","0","160","10.6","17.2"
"Treutlen","2020-10-26","36","1262","3","163","8.8","17.7"
"Treutlen","2020-10-27","4","1266","1","164","12.4","19.5"
"Treutlen","2020-10-28","10","1276","3","167","13.8","18.8"
"Treutlen","2020-10-29","6","1282","0","167","13.8","15.2"
"Treutlen","2020-10-30","2","1284","0","167","9","14.6"
"Treutlen","2020-10-31","1","1285","1","168","23.3","19.3"
"Treutlen","2020-11-01","0","1285","0","168","23.3","16.9"
"Treutlen","2020-11-02","16","1301","5","173","26.6","17.7"
"Treutlen","2020-11-03","2","1303","0","173","23","17.7"
"Treutlen","2020-11-04","3","1306","2","175","28.3","21"
"Treutlen","2020-11-05","2","1308","0","175","28.3","21"
"Treutlen","2020-11-06","61","1369","0","175","28.3","18.7"
"Treutlen","2020-11-07","4","1373","0","175","14","18.7"
"Treutlen","2020-11-08","1","1374","0","175","14","18.7"
"Treutlen","2020-11-09","25","1399","1","176","10.1","18.4"
"Treutlen","2020-11-10","4","1403","0","176","10.1","16.6"
"Treutlen","2020-11-11","5","1408","0","176","0.6","14.4"
"Treutlen","2020-11-12","3","1411","1","177","5.3","16.8"
"Treutlen","2020-11-13","7","1418","3","180","11.5","19.9"
"Treutlen","2020-11-14","1","1419","0","180","11.5","12.7"
"Treutlen","2020-11-15","1","1420","0","180","11.5","12.7"
"Treutlen","2020-11-16","5","1425","1","181","13.7","11.9"
"Treutlen","2020-11-17","3","1428","1","182","18.5","14.3"
"Treutlen","2020-11-18","6","1434","0","182","18.5","9.5"
"Treutlen","2020-11-19","3","1437","1","183","18.5","11.9"
"Treutlen","2020-11-20","5","1442","1","184","15.2","13.3"
"Treutlen","2020-11-21","2","1444","0","184","15.2","13.3"
"Treutlen","2020-11-22","1","1445","0","184","15.2","13.3"
"Treutlen","2020-11-23","17","1462","1","185","13.2","13.5"
"Treutlen","2020-11-24","4","1466","0","185","8.5","13.5"
"Treutlen","2020-11-25","5","1471","0","185","8.5","13.5"
"Treutlen","2020-11-26","1","1472","0","185","3.7","11.1"
"Treutlen","2020-11-27","1","1473","1","186","15.1","15.2"
"Treutlen","2020-11-28","4","1477","1","187","18.7","17"
"Treutlen","2020-11-29","10","1487","1","188","20.1","17.7"
"Treutlen","2020-11-30","16","1503","1","189","20.2","16.7"
"Treutlen","2020-12-01","13","1516","1","190","21.3","14.9"
"Treutlen","2020-12-02","6","1522","0","190","21.3","14.9"
"Treutlen","2020-12-03","6","1528","0","190","21.3","12.5"
"Treutlen","2020-12-04","2","1530","1","191","14.1","14.6"
"Treutlen","2020-12-05","3","1533","0","191","10.6","14.6"
"Treutlen","2020-12-06","0","1533","0","191","9.1","14.6"
"Treutlen","2020-12-07","32","1565","2","193","9.1","14.7"
"Treutlen","2020-12-08","6","1571","1","194","10.4","15.8"
"Treutlen","2020-12-09","7","1578","1","195","12.5","16.9"
"Treutlen","2020-12-10","5","1583","1","196","15.3","18.3"
"Treutlen","2020-12-11","4","1587","2","198","15.3","14.7"
"Treutlen","2020-12-12","1","1588","0","198","15.3","12.9"
"Treutlen","2020-12-13","1","1589","0","198","15.3","12.2"
"Treutlen","2020-12-14","24","1613","9","207","19.8","14.5"
"Treutlen","2020-12-15","7","1620","3","210","23.5","17"
"Treutlen","2020-12-16","14","1634","2","212","23.5","18"
"Treutlen","2020-12-17","3","1637","0","212","20.7","18"
"Treutlen","2020-12-18","9","1646","1","213","15.1","15.2"
"Treutlen","2020-12-19","1","1647","0","213","15.1","15.2"
"Treutlen","2020-12-20","3","1650","1","214","19.9","17.6"
"Treutlen","2020-12-21","72","1722","13","227","17.1","18.4"
"Treutlen","2020-12-22","6","1728","1","228","13.4","18.4"
"Treutlen","2020-12-23","5","1733","2","230","17","20.3"
"Treutlen","2020-12-24","0","1733","0","230","17","18.8"
"Treutlen","2020-12-25","2","1735","0","230","15.4","15.3"
"Treutlen","2020-12-26","5","1740","1","231","18.3","16.7"
"Treutlen","2020-12-27","7","1747","1","232","15.6","17.7"
"Treutlen","2020-12-28","69","1816","19","251","16.9","17"
"Treutlen","2020-12-29","11","1827","3","254","18.4","15.9"
"Treutlen","2020-12-30","16","1843","3","257","15.4","16.2"
"Treutlen","2020-12-31","8","1851","4","261","22.5","19.8"
"Treutlen","2021-01-01","4","1855","2","263","29.7","22.6"
"Treutlen","2021-01-02","7","1862","6","269","39.1","28.7"
"Treutlen","2021-01-03","3","1865","2","271","46.6","31.1"
"Treutlen","2021-01-04","170","2035","48","319","46.7","31.8"
"Treutlen","2021-01-05","16","2051","7","326","49","33.7"
"Treutlen","2021-01-06","16","2067","3","329","49","32.2"
"Treutlen","2021-01-07","5","2072","2","331","47.6","35.1"
"Treutlen","2021-01-08","9","2081","4","335","46.8","38.2"
"Treutlen","2021-01-09","8","2089","4","339","41.7","40.4"
"Treutlen","2021-01-10","4","2093","2","341","39.3","42.9"
"Treutlen","2021-01-11","86","2179","22","363","38.9","42.8"
"Treutlen","2021-01-12","50","2229","17","380","37.5","43.3"
"Treutlen","2021-01-13","11","2240","4","384","40.1","44.5"
"Treutlen","2021-01-14","33","2273","13","397","40","43.8"
"Treutlen","2021-01-15","9","2282","1","398","35.2","41"
"Treutlen","2021-01-16","2","2284","0","398","28.1","34.9"
"Treutlen","2021-01-17","4","2288","1","399","24.5","31.9"
"Treutlen","2021-01-18","5","2293","1","400","23.7","31.3"
"Treutlen","2021-01-19","12","2305","1","401","20","28.8"
"Treutlen","2021-01-20","11","2316","1","402","16.1","28.1"
"Treutlen","2021-01-21","44","2360","13","415","14.7","27.3"
"Treutlen","2021-01-22","9","2369","3","418","17.9","26.6"
"Treutlen","2021-01-23","2","2371","1","419","25","26.6"
"Treutlen","2021-01-24","2","2373","2","421","35.8","30.1"
"Treutlen","2021-01-25","5","2378","4","425","44.3","34"
"Treutlen","2021-01-26","0","2378","0","425","43.1","31.6"
"Treutlen","2021-01-27","0","2378","0","425","41.8","29"
"Troup","2020-02-01","0","0","0","0",".","."
"Troup","2020-02-02","0","0","0","0",".","."
"Troup","2020-02-03","0","0","0","0",".","."
"Troup","2020-02-04","0","0","0","0",".","."
"Troup","2020-02-05","0","0","0","0",".","."
"Troup","2020-02-06","0","0","0","0",".","."
"Troup","2020-02-07","0","0","0","0","0","."
"Troup","2020-02-08","0","0","0","0","0","."
"Troup","2020-02-09","0","0","0","0","0","."
"Troup","2020-02-10","0","0","0","0","0","."
"Troup","2020-02-11","0","0","0","0","0","."
"Troup","2020-02-12","0","0","0","0","0","."
"Troup","2020-02-13","0","0","0","0","0","."
"Troup","2020-02-14","0","0","0","0","0","0"
"Troup","2020-02-15","0","0","0","0","0","0"
"Troup","2020-02-16","0","0","0","0","0","0"
"Troup","2020-02-17","0","0","0","0","0","0"
"Troup","2020-02-18","0","0","0","0","0","0"
"Troup","2020-02-19","0","0","0","0","0","0"
"Troup","2020-02-20","0","0","0","0","0","0"
"Troup","2020-02-21","0","0","0","0","0","0"
"Troup","2020-02-22","0","0","0","0","0","0"
"Troup","2020-02-23","0","0","0","0","0","0"
"Troup","2020-02-24","0","0","0","0","0","0"
"Troup","2020-02-25","0","0","0","0","0","0"
"Troup","2020-02-26","0","0","0","0","0","0"
"Troup","2020-02-27","0","0","0","0","0","0"
"Troup","2020-02-28","0","0","0","0","0","0"
"Troup","2020-02-29","0","0","0","0","0","0"
"Troup","2020-03-01","0","0","0","0","0","0"
"Troup","2020-03-02","0","0","0","0","0","0"
"Troup","2020-03-03","0","0","0","0","0","0"
"Troup","2020-03-04","0","0","0","0","0","0"
"Troup","2020-03-05","0","0","0","0","0","0"
"Troup","2020-03-06","0","0","0","0","0","0"
"Troup","2020-03-07","0","0","0","0","0","0"
"Troup","2020-03-08","0","0","0","0","0","0"
"Troup","2020-03-09","0","0","0","0","0","0"
"Troup","2020-03-10","2","2","0","0","0","0"
"Troup","2020-03-11","0","2","0","0","0","0"
"Troup","2020-03-12","0","2","0","0","0","0"
"Troup","2020-03-13","3","5","1","1","4.8","2.4"
"Troup","2020-03-14","2","7","2","3","19","9.5"
"Troup","2020-03-15","3","10","1","4","23.8","11.9"
"Troup","2020-03-16","8","18","0","4","23.8","11.9"
"Troup","2020-03-17","11","29","1","5","25.1","12.6"
"Troup","2020-03-18","16","45","2","7","26.9","13.4"
"Troup","2020-03-19","10","55","3","10","31.2","15.6"
"Troup","2020-03-20","24","79","1","11","27","15.9"
"Troup","2020-03-21","2","81","0","11","12.7","15.9"
"Troup","2020-03-22","4","85","3","14","18.7","21.2"
"Troup","2020-03-23","34","119","3","17","19.9","21.9"
"Troup","2020-03-24","47","166","5","22","20.2","22.6"
"Troup","2020-03-25","40","206","9","31","21.6","24.2"
"Troup","2020-03-26","42","248","6","37","19.3","25.3"
"Troup","2020-03-27","35","283","8","45","22","24.5"
"Troup","2020-03-28","12","295","3","48","25.6","19.2"
"Troup","2020-03-29","10","305","2","50","17.7","18.2"
"Troup","2020-03-30","44","349","11","61","20","20"
"Troup","2020-03-31","38","387","9","70","21.9","21"
"Troup","2020-04-01","64","451","11","81","21.1","21.4"
"Troup","2020-04-02","25","476","0","81","19.1","19.2"
"Troup","2020-04-03","37","513","5","86","17.8","19.9"
"Troup","2020-04-04","18","531","3","89","16.6","21.1"
"Troup","2020-04-05","5","536","1","90","16.6","17.2"
"Troup","2020-04-06","33","569","4","94","14.7","17.4"
"Troup","2020-04-07","141","710","8","102","12.2","17"
"Troup","2020-04-08","26","736","3","105","11.4","16.3"
"Troup","2020-04-09","33","769","8","113","14.8","17"
"Troup","2020-04-10","394","1163","145","258","18.1","18"
"Troup","2020-04-11","7","1170","0","258","15.8","16.2"
"Troup","2020-04-12","1","1171","0","258","12.9","14.7"
"Troup","2020-04-13","37","1208","14","272","16.6","15.7"
"Troup","2020-04-14","51","1259","31","303","24.5","18.3"
"Troup","2020-04-15","14","1273","1","304","23.8","17.6"
"Troup","2020-04-16","12","1285","0","304","20.4","17.6"
"Troup","2020-04-17","21","1306","7","311","19.9","19"
"Troup","2020-04-18","10","1316","0","311","19.9","17.8"
"Troup","2020-04-19","6","1322","2","313","24.6","18.8"
"Troup","2020-04-20","19","1341","1","314","20","18.3"
"Troup","2020-04-21","30","1371","2","316","12.2","18.4"
"Troup","2020-04-22","28","1399","2","318","12.2","18"
"Troup","2020-04-23","18","1417","1","319","13","16.7"
"Troup","2020-04-24","30","1447","1","320","8.8","14.3"
"Troup","2020-04-25","12","1459","1","321","9.9","14.9"
"Troup","2020-04-26","8","1467","0","321","5.2","14.9"
"Troup","2020-04-27","22","1489","0","321","4.4","12.2"
"Troup","2020-04-28","28","1517","1","322","4","8.1"
"Troup","2020-04-29","30","1547","0","322","3","7.6"
"Troup","2020-04-30","33","1580","2","324","3","8"
"Troup","2020-05-01","24","1604","3","327","4.4","6.6"
"Troup","2020-05-02","10","1614","0","327","3.2","6.6"
"Troup","2020-05-03","6","1620","2","329","7.9","6.6"
"Troup","2020-05-04","21","1641","0","329","7.9","6.2"
"Troup","2020-05-05","32","1673","1","330","7.9","5.9"
"Troup","2020-05-06","83","1756","1","331","8","5.5"
"Troup","2020-05-07","19","1775","1","332","7.9","5.5"
"Troup","2020-05-08","16","1791","1","333","7","5.7"
"Troup","2020-05-09","9","1800","0","333","7","5.1"
"Troup","2020-05-10","5","1805","2","335","8","8"
"Troup","2020-05-11","228","2033","1","336","8","8"
"Troup","2020-05-12","24","2057","2","338","8.8","8.3"
"Troup","2020-05-13","36","2093","2","340","9.4","8.7"
"Troup","2020-05-14","42","2135","7","347","11","9.5"
"Troup","2020-05-15","64","2199","5","352","11.3","9.1"
"Troup","2020-05-16","35","2234","2","354","12.1","9.5"
"Troup","2020-05-17","34","2268","3","357","7.6","7.8"
"Troup","2020-05-18","58","2326","5","362","8.8","8.4"
"Troup","2020-05-19","61","2387","7","369","9.2","9"
"Troup","2020-05-20","67","2454","10","379","10.6","10"
"Troup","2020-05-21","45","2499","4","383","9.5","10.3"
"Troup","2020-05-22","21","2520","3","386","10.4","10.8"
"Troup","2020-05-23","74","2594","7","393","10.9","11.5"
"Troup","2020-05-24","7","2601","0","393","9.7","8.6"
"Troup","2020-05-25","16","2617","1","394","9.3","9.1"
"Troup","2020-05-26","176","2793","45","439","11.3","10.3"
"Troup","2020-05-27","52","2845","4","443","10.3","10.4"
"Troup","2020-05-28","46","2891","5","448","10.6","10"
"Troup","2020-05-29","38","2929","0","448","8.5","9.5"
"Troup","2020-05-30","19","2948","3","451","9.5","10.2"
"Troup","2020-05-31","58","3006","6","457","10.9","10.3"
"Troup","2020-06-01","51","3057","7","464","12","10.7"
"Troup","2020-06-02","99","3156","18","482","10.9","11.1"
"Troup","2020-06-03","92","3248","16","498","12.3","11.3"
"Troup","2020-06-04","85","3333","21","519","14.3","12.4"
"Troup","2020-06-05","164","3497","48","567","18.5","13.5"
"Troup","2020-06-06","47","3544","12","579","19.9","14.7"
"Troup","2020-06-07","27","3571","7","586","22.1","16.5"
"Troup","2020-06-08","242","3813","40","626","22.5","17.3"
"Troup","2020-06-09","172","3985","21","647","21.7","16.3"
"Troup","2020-06-10","171","4156","26","673","21.3","16.8"
"Troup","2020-06-11","128","4284","23","696","20.4","17.3"
"Troup","2020-06-12","198","4482","22","718","17.8","18.1"
"Troup","2020-06-13","59","4541","18","736","18.5","19.2"
"Troup","2020-06-14","33","4574","12","748","20","21"
"Troup","2020-06-15","176","4750","38","786","20.7","21.6"
"Troup","2020-06-16","150","4900","33","819","22.1","21.9"
"Troup","2020-06-17","218","5118","40","859","22.6","21.9"
"Troup","2020-06-18","185","5303","37","896","22.8","21.6"
"Troup","2020-06-19","228","5531","35","931","23.5","20.6"
"Troup","2020-06-20","419","5950","73","1004","21.6","20"
"Troup","2020-06-21","38","5988","6","1010","18.6","19.3"
"Troup","2020-06-22","392","6380","53","1063","17.5","19.1"
"Troup","2020-06-23","263","6643","25","1088","15.7","18.9"
"Troup","2020-06-24","274","6917","27","1115","14.5","18.5"
"Troup","2020-06-25","170","7087","28","1143","14","18.4"
"Troup","2020-06-26","207","7294","34","1177","14.1","18.8"
"Troup","2020-06-27","74","7368","11","1188","13.8","17.7"
"Troup","2020-06-28","43","7411","10","1198","14.8","16.7"
"Troup","2020-06-29","209","7620","27","1225","14.8","16.1"
"Troup","2020-06-30","335","7955","37","1262","15","15.3"
"Troup","2020-07-01","305","8260","36","1298","15.3","14.9"
"Troup","2020-07-02","425","8685","41","1339","14.3","14.1"
"Troup","2020-07-03","183","8868","25","1364","13.9","14"
"Troup","2020-07-04","44","8912","5","1369","13.4","13.6"
"Troup","2020-07-05","61","8973","7","1376","11.7","13.3"
"Troup","2020-07-06","358","9331","60","1436","12.3","13.5"
"Troup","2020-07-07","412","9743","56","1492","12.6","13.8"
"Troup","2020-07-08","502","10245","54","1546","12.5","13.9"
"Troup","2020-07-09","455","10700","52","1598","12.7","13.5"
"Troup","2020-07-10","455","11155","40","1638","12","13"
"Troup","2020-07-11","59","11214","8","1646","12.3","12.9"
"Troup","2020-07-12","27","11241","4","1650","12.8","12.3"
"Troup","2020-07-13","391","11632","58","1708","12.5","12.4"
"Troup","2020-07-14","383","12015","52","1760","12.5","12.6"
"Troup","2020-07-15","375","12390","49","1809","12.9","12.7"
"Troup","2020-07-16","452","12842","56","1865","13","12.9"
"Troup","2020-07-17","400","13242","61","1926","13.9","13"
"Troup","2020-07-18","63","13305","13","1939","14.9","13.6"
"Troup","2020-07-19","34","13339","2","1941","13.7","13.2"
"Troup","2020-07-20","461","13800","52","1993","13.2","12.8"
"Troup","2020-07-21","271","14071","45","2038","13.6","13.1"
"Troup","2020-07-22","322","14393","50","2088","13.9","13.4"
"Troup","2020-07-23","298","14691","56","2144","14.9","13.9"
"Troup","2020-07-24","321","15012","57","2201","15.2","14.6"
"Troup","2020-07-25","47","15059","6","2207","14.1","14.5"
"Troup","2020-07-26","29","15088","0","2207","13.2","13.5"
"Troup","2020-07-27","842","15930","69","2276","12.8","13"
"Troup","2020-07-28","205","16135","33","2309","12.7","13.2"
"Troup","2020-07-29","323","16458","50","2359","12.7","13.3"
"Troup","2020-07-30","353","16811","68","2427","12.8","13.8"
"Troup","2020-07-31","492","17303","66","2493","12.2","13.7"
"Troup","2020-08-01","100","17403","5","2498","11.1","12.6"
"Troup","2020-08-02","23","17426","4","2502","13.5","13.4"
"Troup","2020-08-03","426","17852","31","2533","13.4","13.1"
"Troup","2020-08-04","311","18163","69","2602","14.3","13.5"
"Troup","2020-08-05","489","18652","72","2674","14.2","13.5"
"Troup","2020-08-06","470","19122","75","2749","13.7","13.3"
"Troup","2020-08-07","370","19492","51","2800","13.8","13"
"Troup","2020-08-08","155","19647","21","2821","15","13"
"Troup","2020-08-09","24","19671","2","2823","13.7","13.6"
"Troup","2020-08-10","494","20165","77","2900","14.9","14.1"
"Troup","2020-08-11","108","20273","18","2918","14.1","14.2"
"Troup","2020-08-12","101","20374","13","2931","13.8","14"
"Troup","2020-08-13","106","20480","16","2947","13.7","13.7"
"Troup","2020-08-14","95","20575","4","2951","12.3","13"
"Troup","2020-08-15","44","20619","7","2958","12.7","13.8"
"Troup","2020-08-16","36","20655","0","2958","11.5","12.6"
"Troup","2020-08-17","126","20781","13","2971","10.7","12.8"
"Troup","2020-08-18","131","20912","11","2982","9.5","11.8"
"Troup","2020-08-19","91","21003","10","2992","9.3","11.5"
"Troup","2020-08-20","92","21095","11","3003","8.8","11.3"
"Troup","2020-08-21","110","21205","9","3012","9.4","10.9"
"Troup","2020-08-22","58","21263","2","3014","7.6","10.1"
"Troup","2020-08-23","44","21307","1","3015","7.9","9.7"
"Troup","2020-08-24","192","21499","12","3027","7.4","9"
"Troup","2020-08-25","113","21612","7","3034","7","8.3"
"Troup","2020-08-26","172","21784","4","3038","5.8","7.5"
"Troup","2020-08-27","125","21909","8","3046","5","6.9"
"Troup","2020-08-28","181","22090","6","3052","4.3","6.9"
"Troup","2020-08-29","63","22153","10","3062","6.1","6.9"
"Troup","2020-08-30","34","22187","1","3063","6.2","7.1"
"Troup","2020-08-31","153","22340","15","3078","6.7","7"
"Troup","2020-09-01","108","22448","6","3084","6.6","6.8"
"Troup","2020-09-02","106","22554","5","3089","6.9","6.4"
"Troup","2020-09-03","92","22646","7","3096","7.1","6.1"
"Troup","2020-09-04","89","22735","10","3106","8.2","6.3"
"Troup","2020-09-05","47","22782","7","3113","8.1","7.1"
"Troup","2020-09-06","40","22822","1","3114","8","7.1"
"Troup","2020-09-07","63","22885","3","3117","7.3","7"
"Troup","2020-09-08","87","22972","9","3126","8","7.3"
"Troup","2020-09-09","161","23133","6","3132","7.9","7.4"
"Troup","2020-09-10","199","23332","11","3143","7.6","7.3"
"Troup","2020-09-11","89","23421","6","3149","6.9","7.6"
"Troup","2020-09-12","50","23471","3","3152","5.7","6.9"
"Troup","2020-09-13","26","23497","1","3153","5.8","6.9"
"Troup","2020-09-14","156","23653","14","3167","6.5","6.9"
"Troup","2020-09-15","120","23773","6","3173","5.7","6.8"
"Troup","2020-09-16","110","23883","9","3182","6.3","7.1"
"Troup","2020-09-17","65","23948","3","3185","6.2","6.9"
"Troup","2020-09-18","71","24019","4","3189","6","6.5"
"Troup","2020-09-19","60","24079","2","3191","5.7","5.7"
"Troup","2020-09-20","40","24119","1","3192","5.5","5.7"
"Troup","2020-09-21","130","24249","8","3200","5.1","5.8"
"Troup","2020-09-22","89","24338","9","3209","5.8","5.7"
"Troup","2020-09-23","66","24404","10","3219","6.8","6.6"
"Troup","2020-09-24","90","24494","3","3222","6.6","6.4"
"Troup","2020-09-25","68","24562","6","3228","7.1","6.5"
"Troup","2020-09-26","32","24594","4","3232","8.4","7"
"Troup","2020-09-27","28","24622","3","3235","9.5","7.5"
"Troup","2020-09-28","130","24752","5","3240","9.2","7.1"
"Troup","2020-09-29","83","24835","8","3248","9.1","7.5"
"Troup","2020-09-30","54","24889","1","3249","7.2","7"
"Troup","2020-10-01","69","24958","4","3253","7.6","7.1"
"Troup","2020-10-02","68","25026","9","3262","8.2","7.6"
"Troup","2020-10-03","40","25066","4","3266","7.9","8.1"
"Troup","2020-10-04","30","25096","1","3267","6.8","8.2"
"Troup","2020-10-05","116","25212","5","3272","6.9","8"
"Troup","2020-10-06","97","25309","8","3280","6.7","7.9"
"Troup","2020-10-07","74","25383","4","3284","7.2","7.2"
"Troup","2020-10-08","84","25467","4","3288","7","7.3"
"Troup","2020-10-09","87","25554","7","3295","6.3","7.3"
"Troup","2020-10-10","36","25590","4","3299","6.5","7.2"
"Troup","2020-10-11","45","25635","4","3303","7.3","7"
"Troup","2020-10-12","82","25717","10","3313","8.4","7.6"
"Troup","2020-10-13","73","25790","5","3318","8.2","7.4"
"Troup","2020-10-14","77","25867","6","3324","8.5","7.9"
"Troup","2020-10-15","69","25936","4","3328","8.7","7.9"
"Troup","2020-10-16","85","26021","7","3335","8.7","7.5"
"Troup","2020-10-17","62","26083","6","3341","8.5","7.5"
"Troup","2020-10-18","35","26118","2","3343","8","7.6"
"Troup","2020-10-19","121","26239","3","3346","6.6","7.5"
"Troup","2020-10-20","120","26359","14","3360","7.3","7.8"
"Troup","2020-10-21","116","26475","7","3367","7.1","7.8"
"Troup","2020-10-22","87","26562","7","3374","7.4","8"
"Troup","2020-10-23","123","26685","26","3400","9.3","9"
"Troup","2020-10-24","47","26732","4","3404","9.1","8.8"
"Troup","2020-10-25","42","26774","8","3412","11","9.5"
"Troup","2020-10-26","151","26925","15","3427","12.1","9.4"
"Troup","2020-10-27","91","27016","11","3438","12.1","9.7"
"Troup","2020-10-28","100","27116","4","3442","11.8","9.5"
"Troup","2020-10-29","91","27207","7","3449","11.8","9.6"
"Troup","2020-10-30","64","27271","2","3451","9.2","9.2"
"Troup","2020-10-31","45","27316","5","3456","9.6","9.3"
"Troup","2020-11-01","22","27338","3","3459","8.8","9.9"
"Troup","2020-11-02","135","27473","9","3468","8.3","10.2"
"Troup","2020-11-03","78","27551","3","3471","7.2","9.6"
"Troup","2020-11-04","80","27631","10","3481","8.4","10.1"
"Troup","2020-11-05","84","27715","6","3487","8.3","10"
"Troup","2020-11-06","99","27814","6","3493","8.7","9"
"Troup","2020-11-07","44","27858","0","3493","7.1","8.3"
"Troup","2020-11-08","33","27891","1","3494","5.6","7.2"
"Troup","2020-11-09","126","28017","10","3504","5.8","7.1"
"Troup","2020-11-10","84","28101","9","3513","6.8","7"
"Troup","2020-11-11","115","28216","15","3528","6.8","7.6"
"Troup","2020-11-12","284","28500","73","3601","9.5","8.9"
"Troup","2020-11-13","104","28604","16","3617","10.8","9.8"
"Troup","2020-11-14","66","28670","11","3628","13.2","10.2"
"Troup","2020-11-15","26","28696","2","3630","13.9","9.7"
"Troup","2020-11-16","113","28809","18","3648","15","10.4"
"Troup","2020-11-17","106","28915","9","3657","14.7","10.7"
"Troup","2020-11-18","77","28992","4","3661","13.6","10.2"
"Troup","2020-11-19","80","29072","1","3662","10.1","9.8"
"Troup","2020-11-20","147","29219","10","3672","8.9","9.8"
"Troup","2020-11-21","41","29260","3","3675","7.5","10.4"
"Troup","2020-11-22","31","29291","4","3679","8.3","11.1"
"Troup","2020-11-23","175","29466","13","3692","7.1","11"
"Troup","2020-11-24","70","29536","7","3699","7.3","11"
"Troup","2020-11-25","84","29620","10","3709","8.2","10.9"
"Troup","2020-11-26","16","29636","1","3710","8.9","9.5"
"Troup","2020-11-27","73","29709","9","3719","9.7","9.3"
"Troup","2020-11-28","29","29738","5","3724","11.2","9.3"
"Troup","2020-11-29","42","29780","5","3729","11","9.6"
"Troup","2020-11-30","184","29964","20","3749","11.5","9.3"
"Troup","2020-12-01","89","30053","9","3758","11.5","9.4"
"Troup","2020-12-02","98","30151","18","3776","12.4","10.3"
"Troup","2020-12-03","105","30256","19","3795","14.1","11.5"
"Troup","2020-12-04","110","30366","21","3816","15.1","12.4"
"Troup","2020-12-05","48","30414","10","3826","15.6","13.4"
"Troup","2020-12-06","24","30438","6","3832","17.5","14.2"
"Troup","2020-12-07","216","30654","27","3859","17.7","14.6"
"Troup","2020-12-08","140","30794","12","3871","17.5","14.5"
"Troup","2020-12-09","128","30922","19","3890","17","14.7"
"Troup","2020-12-10","137","31059","22","3912","16.7","15.4"
"Troup","2020-12-11","145","31204","26","3938","16.5","15.8"
"Troup","2020-12-12","108","31312","13","3951","15.3","15.4"
"Troup","2020-12-13","67","31379","11","3962","14.1","15.8"
"Troup","2020-12-14","301","31680","44","4006","14.4","16"
"Troup","2020-12-15","202","31882","35","4041","15.6","16.5"
"Troup","2020-12-16","172","32054","26","4067","15.6","16.3"
"Troup","2020-12-17","198","32252","47","4114","16.7","16.7"
"Troup","2020-12-18","138","32390","30","4144","17.3","16.9"
"Troup","2020-12-19","89","32479","18","4162","18.5","16.9"
"Troup","2020-12-20","53","32532","10","4172","18.8","16.4"
"Troup","2020-12-21","278","32810","47","4219","19.1","16.7"
"Troup","2020-12-22","120","32930","21","4240","19.2","17.4"
"Troup","2020-12-23","123","33053","25","4265","19.9","17.8"
"Troup","2020-12-24","72","33125","16","4281","19.7","18.2"
"Troup","2020-12-25","16","33141","4","4285","20.1","18.7"
"Troup","2020-12-26","74","33215","25","4310","22.1","20.3"
"Troup","2020-12-27","63","33278","10","4320","21.7","20.2"
"Troup","2020-12-28","264","33542","36","4356","21.2","20.2"
"Troup","2020-12-29","169","33711","43","4399","22.3","20.7"
"Troup","2020-12-30","164","33875","37","4436","22.6","21.3"
"Troup","2020-12-31","138","34013","33","4469","22.9","21.3"
"Troup","2021-01-01","34","34047","9","4478","23.1","21.6"
"Troup","2021-01-02","51","34098","13","4491","21.9","22"
"Troup","2021-01-03","47","34145","8","4499","22.1","21.9"
"Troup","2021-01-04","467","34612","120","4619","23.8","22.5"
"Troup","2021-01-05","180","34792","43","4662","23.6","23"
"Troup","2021-01-06","187","34979","43","4705","23.6","23.1"
"Troup","2021-01-07","181","35160","46","4751","23.9","23.4"
"Troup","2021-01-08","200","35360","53","4804","23.9","23.5"
"Troup","2021-01-09","124","35484","31","4835","23.8","22.9"
"Troup","2021-01-10","70","35554","15","4850","24.4","23.2"
"Troup","2021-01-11","288","35842","37","4887","22.6","23.2"
"Troup","2021-01-12","212","36054","48","4935","22.4","23"
"Troup","2021-01-13","192","36246","35","4970","21.7","22.7"
"Troup","2021-01-14","153","36399","25","4995","20.4","22.1"
"Troup","2021-01-15","205","36604","48","5043","20","21.9"
"Troup","2021-01-16","144","36748","46","5089","21","22.4"
"Troup","2021-01-17","82","36830","24","5113","22.1","23.3"
"Troup","2021-01-18","188","37018","46","5159","23.8","23.2"
"Troup","2021-01-19","235","37253","39","5198","22.9","22.6"
"Troup","2021-01-20","214","37467","35","5233","22.6","22.2"
"Troup","2021-01-21","212","37679","27","5260","22.1","21.3"
"Troup","2021-01-22","205","37884","29","5289","20.8","20.4"
"Troup","2021-01-23","79","37963","13","5302","18.6","19.8"
"Troup","2021-01-24","39","38002","10","5312","18.1","20.1"
"Troup","2021-01-25","64","38066","5","5317","15.7","19.7"
"Troup","2021-01-26","19","38085","6","5323","17.8","20.4"
"Troup","2021-01-27","0","38085","0","5323","15.5","19.1"
"Turner","2020-02-01","0","0","0","0",".","."
"Turner","2020-02-02","0","0","0","0",".","."
"Turner","2020-02-03","0","0","0","0",".","."
"Turner","2020-02-04","0","0","0","0",".","."
"Turner","2020-02-05","0","0","0","0",".","."
"Turner","2020-02-06","0","0","0","0",".","."
"Turner","2020-02-07","0","0","0","0","0","."
"Turner","2020-02-08","0","0","0","0","0","."
"Turner","2020-02-09","0","0","0","0","0","."
"Turner","2020-02-10","0","0","0","0","0","."
"Turner","2020-02-11","0","0","0","0","0","."
"Turner","2020-02-12","0","0","0","0","0","."
"Turner","2020-02-13","0","0","0","0","0","."
"Turner","2020-02-14","0","0","0","0","0","0"
"Turner","2020-02-15","0","0","0","0","0","0"
"Turner","2020-02-16","0","0","0","0","0","0"
"Turner","2020-02-17","0","0","0","0","0","0"
"Turner","2020-02-18","0","0","0","0","0","0"
"Turner","2020-02-19","0","0","0","0","0","0"
"Turner","2020-02-20","0","0","0","0","0","0"
"Turner","2020-02-21","0","0","0","0","0","0"
"Turner","2020-02-22","0","0","0","0","0","0"
"Turner","2020-02-23","0","0","0","0","0","0"
"Turner","2020-02-24","0","0","0","0","0","0"
"Turner","2020-02-25","0","0","0","0","0","0"
"Turner","2020-02-26","0","0","0","0","0","0"
"Turner","2020-02-27","0","0","0","0","0","0"
"Turner","2020-02-28","0","0","0","0","0","0"
"Turner","2020-02-29","0","0","0","0","0","0"
"Turner","2020-03-01","0","0","0","0","0","0"
"Turner","2020-03-02","0","0","0","0","0","0"
"Turner","2020-03-03","0","0","0","0","0","0"
"Turner","2020-03-04","0","0","0","0","0","0"
"Turner","2020-03-05","0","0","0","0","0","0"
"Turner","2020-03-06","0","0","0","0","0","0"
"Turner","2020-03-07","0","0","0","0","0","0"
"Turner","2020-03-08","0","0","0","0","0","0"
"Turner","2020-03-09","0","0","0","0","0","0"
"Turner","2020-03-10","0","0","0","0","0","0"
"Turner","2020-03-11","1","1","1","1","14.3","7.1"
"Turner","2020-03-12","1","2","0","1","14.3","7.1"
"Turner","2020-03-13","0","2","0","1","14.3","7.1"
"Turner","2020-03-14","0","2","0","1","14.3","7.1"
"Turner","2020-03-15","0","2","0","1","14.3","7.1"
"Turner","2020-03-16","1","3","0","1","14.3","7.1"
"Turner","2020-03-17","1","4","1","2","28.6","14.3"
"Turner","2020-03-18","0","4","0","2","14.3","14.3"
"Turner","2020-03-19","1","5","0","2","14.3","14.3"
"Turner","2020-03-20","0","5","0","2","14.3","14.3"
"Turner","2020-03-21","2","7","1","3","21.4","17.9"
"Turner","2020-03-22","1","8","0","3","21.4","17.9"
"Turner","2020-03-23","5","13","0","3","21.4","17.9"
"Turner","2020-03-24","1","14","0","3","7.1","17.9"
"Turner","2020-03-25","3","17","1","4","11.9","13.1"
"Turner","2020-03-26","1","18","0","4","11.9","13.1"
"Turner","2020-03-27","1","19","0","4","11.9","13.1"
"Turner","2020-03-28","1","20","0","4","4.8","13.1"
"Turner","2020-03-29","1","21","1","5","19","20.2"
"Turner","2020-03-30","4","25","0","5","19","20.2"
"Turner","2020-03-31","2","27","0","5","19","13.1"
"Turner","2020-04-01","3","30","3","8","28.6","20.2"
"Turner","2020-04-02","5","35","1","9","31.4","21.7"
"Turner","2020-04-03","2","37","0","9","31.4","21.7"
"Turner","2020-04-04","1","38","1","10","45.7","25.2"
"Turner","2020-04-05","1","39","0","10","31.4","25.2"
"Turner","2020-04-06","2","41","2","12","45.7","32.4"
"Turner","2020-04-07","1","42","0","12","45.7","32.4"
"Turner","2020-04-08","1","43","0","12","31.4","30"
"Turner","2020-04-09","2","45","1","13","35.7","33.6"
"Turner","2020-04-10","0","45","0","13","35.7","33.6"
"Turner","2020-04-11","0","45","0","13","21.4","33.6"
"Turner","2020-04-12","1","46","1","14","35.7","33.6"
"Turner","2020-04-13","1","47","1","15","35.7","40.7"
"Turner","2020-04-14","1","48","0","15","35.7","40.7"
"Turner","2020-04-15","2","50","0","15","35.7","33.6"
"Turner","2020-04-16","3","53","1","16","33.3","34.5"
"Turner","2020-04-17","4","57","0","16","33.3","34.5"
"Turner","2020-04-18","0","57","0","16","33.3","27.4"
"Turner","2020-04-19","0","57","0","16","19","27.4"
"Turner","2020-04-20","9","66","1","17","6.3","21"
"Turner","2020-04-21","15","81","6","23","12.1","23.9"
"Turner","2020-04-22","17","98","9","32","19.6","27.7"
"Turner","2020-04-23","6","104","1","33","17.2","25.3"
"Turner","2020-04-24","18","122","2","35","18.8","26.1"
"Turner","2020-04-25","6","128","1","36","21.2","27.3"
"Turner","2020-04-26","1","129","1","37","35.5","27.3"
"Turner","2020-04-27","14","143","1","38","34.9","20.6"
"Turner","2020-04-28","28","171","0","38","29.2","20.6"
"Turner","2020-04-29","19","190","0","38","21.7","20.6"
"Turner","2020-04-30","4","194","1","39","22.8","20"
"Turner","2020-05-01","13","207","4","43","25.7","22.2"
"Turner","2020-05-02","1","208","1","44","37.6","29.4"
"Turner","2020-05-03","1","209","1","45","37.6","36.5"
"Turner","2020-05-04","2","211","0","45","36.5","35.7"
"Turner","2020-05-05","3","214","1","46","41.3","35.3"
"Turner","2020-05-06","13","227","5","51","46.8","34.2"
"Turner","2020-05-07","12","239","1","52","44.4","33.6"
"Turner","2020-05-08","11","250","1","53","41.3","33.5"
"Turner","2020-05-09","0","250","0","53","27","32.3"
"Turner","2020-05-10","0","250","0","53","12.7","25.2"
"Turner","2020-05-11","18","268","3","56","15.1","25.8"
"Turner","2020-05-12","5","273","1","57","13.2","27.3"
"Turner","2020-05-13","14","287","0","57","7.7","27.3"
"Turner","2020-05-14","9","296","3","60","11.3","27.9"
"Turner","2020-05-15","10","306","1","61","11.4","26.4"
"Turner","2020-05-16","5","311","1","62","14.3","20.7"
"Turner","2020-05-17","0","311","0","62","14.3","13.5"
"Turner","2020-05-18","18","329","5","67","15.9","15.5"
"Turner","2020-05-19","10","339","3","70","17.3","15.3"
"Turner","2020-05-20","21","360","6","76","21.4","14.6"
"Turner","2020-05-21","26","386","7","83","20.5","15.9"
"Turner","2020-05-22","11","397","1","84","20.3","15.9"
"Turner","2020-05-23","2","399","0","84","17.5","15.9"
"Turner","2020-05-24","0","399","0","84","17.5","15.9"
"Turner","2020-05-25","4","403","1","85","17.1","16.5"
"Turner","2020-05-26","24","427","6","91","16.4","16.8"
"Turner","2020-05-27","26","453","3","94","13.9","17.7"
"Turner","2020-05-28","18","471","6","100","14.9","17.7"
"Turner","2020-05-29","9","480","4","104","19.9","20.1"
"Turner","2020-05-30","4","484","4","108","34.2","25.8"
"Turner","2020-05-31","0","484","0","108","34.2","25.8"
"Turner","2020-06-01","33","517","5","113","32.8","24.9"
"Turner","2020-06-02","42","559","2","115","29.9","23.1"
"Turner","2020-06-03","25","584","2","117","29.4","21.7"
"Turner","2020-06-04","13","597","1","118","25.7","20.3"
"Turner","2020-06-05","23","620","2","120","20.6","20.3"
"Turner","2020-06-06","2","622","1","121","13.5","23.8"
"Turner","2020-06-07","2","624","1","122","20.6","27.4"
"Turner","2020-06-08","40","664","4","126","19.9","26.3"
"Turner","2020-06-09","19","683","3","129","21.5","25.7"
"Turner","2020-06-10","20","703","2","131","21.7","25.6"
"Turner","2020-06-11","28","731","2","133","21.7","23.7"
"Turner","2020-06-12","23","754","0","133","20.4","20.5"
"Turner","2020-06-13","3","757","1","134","18","15.8"
"Turner","2020-06-14","3","760","0","134","10.9","15.8"
"Turner","2020-06-15","43","803","1","135","9.8","14.8"
"Turner","2020-06-16","10","813","0","135","7.5","14.5"
"Turner","2020-06-17","26","839","5","140","8.9","15.3"
"Turner","2020-06-18","41","880","1","141","8.2","14.9"
"Turner","2020-06-19","23","903","2","143","9.4","14.9"
"Turner","2020-06-20","2","905","1","144","11.8","14.9"
"Turner","2020-06-21","5","910","0","144","11.8","11.4"
"Turner","2020-06-22","38","948","1","145","11.9","10.8"
"Turner","2020-06-23","23","971","1","146","12.5","10"
"Turner","2020-06-24","40","1011","4","150","11.2","10"
"Turner","2020-06-25","24","1035","3","153","12.6","10.4"
"Turner","2020-06-26","21","1056","1","154","12","10.7"
"Turner","2020-06-27","5","1061","0","154","4.9","8.4"
"Turner","2020-06-28","1","1062","0","154","4.9","8.4"
"Turner","2020-06-29","39","1101","1","155","4.9","8.4"
"Turner","2020-06-30","37","1138","0","155","4.3","8.4"
"Turner","2020-07-01","32","1170","4","159","4.6","7.9"
"Turner","2020-07-02","18","1188","1","160","3.6","8.1"
"Turner","2020-07-03","3","1191","0","160","2.9","7.5"
"Turner","2020-07-04","1","1192","0","160","2.9","3.9"
"Turner","2020-07-05","1","1193","1","161","17.2","11.1"
"Turner","2020-07-06","19","1212","1","162","17.6","11.2"
"Turner","2020-07-07","12","1224","0","162","17.6","10.9"
"Turner","2020-07-08","34","1258","0","162","15.8","10.2"
"Turner","2020-07-09","47","1305","2","164","15.6","9.6"
"Turner","2020-07-10","10","1315","0","164","15.6","9.3"
"Turner","2020-07-11","5","1320","0","164","15.6","9.3"
"Turner","2020-07-12","4","1324","0","164","1.4","9.3"
"Turner","2020-07-13","30","1354","2","166","1.6","9.6"
"Turner","2020-07-14","11","1365","0","166","1.6","9.6"
"Turner","2020-07-15","35","1400","4","170","3.2","9.5"
"Turner","2020-07-16","33","1433","0","170","2.6","9.1"
"Turner","2020-07-17","9","1442","0","170","2.6","9.1"
"Turner","2020-07-18","1","1443","0","170","2.6","9.1"
"Turner","2020-07-19","3","1446","0","170","2.6","2"
"Turner","2020-07-20","33","1479","3","173","2.9","2.2"
"Turner","2020-07-21","15","1494","10","183","12.5","7"
"Turner","2020-07-22","27","1521","3","186","12.4","7.8"
"Turner","2020-07-23","13","1534","2","188","14.6","8.6"
"Turner","2020-07-24","4","1538","0","188","14.6","8.6"
"Turner","2020-07-25","4","1542","0","188","14.6","8.6"
"Turner","2020-07-26","6","1548","1","189","17","9.8"
"Turner","2020-07-27","36","1584","4","193","17.3","10.1"
"Turner","2020-07-28","34","1618","20","213","16.2","14.3"
"Turner","2020-07-29","34","1652","3","216","15.8","14.1"
"Turner","2020-07-30","17","1669","3","219","16.2","15.4"
"Turner","2020-07-31","8","1677","3","222","21.5","18.1"
"Turner","2020-08-01","1","1678","0","222","21.5","18.1"
"Turner","2020-08-02","1","1679","0","222","19.1","18.1"
"Turner","2020-08-03","23","1702","3","225","19.4","18.3"
"Turner","2020-08-04","30","1732","3","228","12.4","14.3"
"Turner","2020-08-05","38","1770","6","234","13.4","14.6"
"Turner","2020-08-06","12","1782","0","234","10.9","13.5"
"Turner","2020-08-07","8","1790","0","234","5.5","13.5"
"Turner","2020-08-08","9","1799","0","234","5.5","13.5"
"Turner","2020-08-09","2","1801","1","235","12.7","15.9"
"Turner","2020-08-10","46","1847","3","238","11.8","15.6"
"Turner","2020-08-11","9","1856","4","242","16.7","14.6"
"Turner","2020-08-12","32","1888","2","244","15.3","14.4"
"Turner","2020-08-13","6","1894","1","245","17.7","14.3"
"Turner","2020-08-14","33","1927","0","245","17.7","11.6"
"Turner","2020-08-15","27","1954","1","246","18.2","11.9"
"Turner","2020-08-16","37","1991","1","247","11.5","12.1"
"Turner","2020-08-17","11","2002","2","249","13.1","12.4"
"Turner","2020-08-18","14","2016","1","250","7.8","12.2"
"Turner","2020-08-19","39","2055","3","253","8","11.7"
"Turner","2020-08-20","26","2081","0","253","5.6","11.7"
"Turner","2020-08-21","89","2170","0","253","5.6","11.7"
"Turner","2020-08-22","6","2176","0","253","5.1","11.7"
"Turner","2020-08-23","2","2178","1","254","11.9","11.7"
"Turner","2020-08-24","6","2184","0","254","9.3","11.2"
"Turner","2020-08-25","5","2189","0","254","8.2","8"
"Turner","2020-08-26","42","2231","1","255","7.5","7.7"
"Turner","2020-08-27","24","2255","0","255","7.5","6.6"
"Turner","2020-08-28","56","2311","1","256","7.7","6.7"
"Turner","2020-08-29","23","2334","0","256","7.7","6.4"
"Turner","2020-08-30","3","2337","0","256","0.6","6.2"
"Turner","2020-08-31","13","2350","3","259","3.9","6.6"
"Turner","2020-09-01","12","2362","0","259","3.9","6.1"
"Turner","2020-09-02","25","2387","0","259","3.6","5.5"
"Turner","2020-09-03","22","2409","4","263","6.1","6.8"
"Turner","2020-09-04","12","2421","0","263","5.9","6.8"
"Turner","2020-09-05","5","2426","4","267","17.3","12.5"
"Turner","2020-09-06","0","2426","0","267","17.3","9"
"Turner","2020-09-07","2","2428","1","268","21.2","12.5"
"Turner","2020-09-08","12","2440","1","269","22.4","13.1"
"Turner","2020-09-09","37","2477","0","269","22.4","13"
"Turner","2020-09-10","17","2494","0","269","19.8","13"
"Turner","2020-09-11","10","2504","0","269","19.8","12.8"
"Turner","2020-09-12","5","2509","0","269","8.3","12.8"
"Turner","2020-09-13","4","2513","1","270","11.9","14.6"
"Turner","2020-09-14","8","2521","1","271","6.5","13.9"
"Turner","2020-09-15","7","2528","0","271","5.4","13.9"
"Turner","2020-09-16","21","2549","1","272","6","14.2"
"Turner","2020-09-17","19","2568","1","273","6.8","13.3"
"Turner","2020-09-18","8","2576","1","274","8.6","14.2"
"Turner","2020-09-19","3","2579","0","274","8.6","8.5"
"Turner","2020-09-20","4","2583","0","274","5","8.5"
"Turner","2020-09-21","11","2594","0","274","3.2","4.9"
"Turner","2020-09-22","8","2602","1","275","5","5.2"
"Turner","2020-09-23","30","2632","1","276","4.8","5.4"
"Turner","2020-09-24","31","2663","6","282","6.8","6.8"
"Turner","2020-09-25","5","2668","0","282","5","6.8"
"Turner","2020-09-26","7","2675","0","282","5","6.8"
"Turner","2020-09-27","3","2678","1","283","9.8","7.4"
"Turner","2020-09-28","20","2698","1","284","10.5","6.9"
"Turner","2020-09-29","10","2708","0","284","8.7","6.9"
"Turner","2020-09-30","12","2720","3","287","11.8","8.3"
"Turner","2020-10-01","12","2732","2","289","11.4","9.1"
"Turner","2020-10-02","54","2786","3","292","12.2","8.6"
"Turner","2020-10-03","19","2805","1","293","13","9"
"Turner","2020-10-04","4","2809","0","293","8.2","9"
"Turner","2020-10-05","25","2834","3","296","9.2","9.9"
"Turner","2020-10-06","10","2844","1","297","10.6","9.7"
"Turner","2020-10-07","71","2915","1","298","7.3","9.5"
"Turner","2020-10-08","32","2947","2","300","5.8","8.6"
"Turner","2020-10-09","36","2983","1","301","5.4","8.8"
"Turner","2020-10-10","5","2988","0","301","4.6","8.8"
"Turner","2020-10-11","11","2999","0","301","4.6","6.4"
"Turner","2020-10-12","16","3015","2","303","4.7","7"
"Turner","2020-10-13","24","3039","3","306","5.1","7.9"
"Turner","2020-10-14","41","3080","1","307","5.2","6.2"
"Turner","2020-10-15","22","3102","0","307","4.3","5"
"Turner","2020-10-16","19","3121","1","308","4.7","5"
"Turner","2020-10-17","4","3125","1","309","8.2","6.4"
"Turner","2020-10-18","1","3126","0","309","8.2","6.4"
"Turner","2020-10-19","31","3157","1","310","6.9","5.8"
"Turner","2020-10-20","32","3189","1","311","5.6","5.3"
"Turner","2020-10-21","40","3229","0","311","5.2","5.2"
"Turner","2020-10-22","12","3241","1","312","6.4","5.4"
"Turner","2020-10-23","6","3247","0","312","5.7","5.2"
"Turner","2020-10-24","4","3251","0","312","2.1","5.2"
"Turner","2020-10-25","4","3255","0","312","2.1","5.2"
"Turner","2020-10-26","11","3266","1","313","2.9","4.9"
"Turner","2020-10-27","7","3273","0","313","2.5","4"
"Turner","2020-10-28","35","3308","1","314","2.9","4.1"
"Turner","2020-10-29","31","3339","1","315","2.2","4.3"
"Turner","2020-10-30","7","3346","0","315","2.2","3.9"
"Turner","2020-10-31","2","3348","1","316","9.3","5.7"
"Turner","2020-11-01","0","3348","0","316","9.3","5.7"
"Turner","2020-11-02","10","3358","0","316","8","5.5"
"Turner","2020-11-03","14","3372","1","317","9","5.8"
"Turner","2020-11-04","15","3387","1","318","9.6","6.2"
"Turner","2020-11-05","26","3413","10","328","14.6","8.4"
"Turner","2020-11-06","17","3430","1","329","15.5","8.8"
"Turner","2020-11-07","1","3431","0","329","8.3","8.8"
"Turner","2020-11-08","0","3431","0","329","8.3","8.8"
"Turner","2020-11-09","22","3453","1","330","9","8.5"
"Turner","2020-11-10","18","3471","0","330","7.9","8.5"
"Turner","2020-11-11","4","3475","1","331","10.6","10.1"
"Turner","2020-11-12","19","3494","0","331","5.1","9.8"
"Turner","2020-11-13","11","3505","1","332","5.5","10.5"
"Turner","2020-11-14","4","3509","0","332","5.5","6.9"
"Turner","2020-11-15","2","3511","0","332","5.5","6.9"
"Turner","2020-11-16","25","3536","2","334","6","7.5"
"Turner","2020-11-17","19","3555","1","335","6.8","7.4"
"Turner","2020-11-18","15","3570","2","337","5.1","7.8"
"Turner","2020-11-19","28","3598","4","341","7.1","6.1"
"Turner","2020-11-20","26","3624","1","342","6.4","6"
"Turner","2020-11-21","7","3631","1","343","8.4","7"
"Turner","2020-11-22","7","3638","1","344","10.5","8"
"Turner","2020-11-23","26","3664","3","347","11","8.5"
"Turner","2020-11-24","14","3678","0","347","10.2","8.5"
"Turner","2020-11-25","10","3688","0","347","8.3","6.7"
"Turner","2020-11-26","4","3692","1","348","9.9","8.5"
"Turner","2020-11-27","11","3703","4","352","14.5","10.4"
"Turner","2020-11-28","3","3706","0","352","12.5","10.4"
"Turner","2020-11-29","8","3714","0","352","10.4","10.4"
"Turner","2020-11-30","21","3735","3","355","10.8","10.9"
"Turner","2020-12-01","16","3751","2","357","12.6","11.4"
"Turner","2020-12-02","16","3767","0","357","12.6","10.5"
"Turner","2020-12-03","13","3780","1","358","10.1","10"
"Turner","2020-12-04","12","3792","0","358","4.9","9.7"
"Turner","2020-12-05","7","3799","4","362","13.1","12.8"
"Turner","2020-12-06","2","3801","1","363","20.2","15.3"
"Turner","2020-12-07","18","3819","3","366","20.6","15.7"
"Turner","2020-12-08","55","3874","8","374","20.9","16.7"
"Turner","2020-12-09","16","3890","0","374","20.9","16.7"
"Turner","2020-12-10","19","3909","2","376","21.3","15.7"
"Turner","2020-12-11","11","3920","1","377","22.6","13.7"
"Turner","2020-12-12","12","3932","1","378","15.6","14.3"
"Turner","2020-12-13","8","3940","3","381","13.8","17"
"Turner","2020-12-14","51","3991","14","395","15.3","18"
"Turner","2020-12-15","19","4010","1","396","14","17.4"
"Turner","2020-12-16","23","4033","4","400","16.5","18.7"
"Turner","2020-12-17","24","4057","1","401","15.6","18.4"
"Turner","2020-12-18","14","4071","4","405","18.4","20.5"
"Turner","2020-12-19","10","4081","1","406","18.6","17.1"
"Turner","2020-12-20","5","4086","0","406","13.3","13.5"
"Turner","2020-12-21","108","4194","3","409","9.7","12.5"
"Turner","2020-12-22","65","4259","7","416","10.5","12.3"
"Turner","2020-12-23","10","4269","0","416","8","12.3"
"Turner","2020-12-24","9","4278","1","417","9","12.3"
"Turner","2020-12-25","3","4281","1","418","9.7","14"
"Turner","2020-12-26","3","4284","3","421","22.6","20.6"
"Turner","2020-12-27","6","4290","2","423","27.3","20.3"
"Turner","2020-12-28","13","4303","0","423","26.9","18.3"
"Turner","2020-12-29","73","4376","7","430","26.8","18.6"
"Turner","2020-12-30","12","4388","5","435","32.7","20.4"
"Turner","2020-12-31","18","4406","5","440","35.1","22.1"
"Turner","2021-01-01","3","4409","0","440","30.3","20"
"Turner","2021-01-02","0","4409","0","440","16.1","19.3"
"Turner","2021-01-03","8","4417","5","445","20.2","23.8"
"Turner","2021-01-04","22","4439","7","452","24.8","25.8"
"Turner","2021-01-05","145","4584","9","461","24.3","25.5"
"Turner","2021-01-06","67","4651","8","469","20","26.4"
"Turner","2021-01-07","34","4685","4","473","17.7","26.4"
"Turner","2021-01-08","33","4718","4","477","19.5","24.9"
"Turner","2021-01-09","9","4727","2","479","22.7","19.4"
"Turner","2021-01-10","2","4729","0","479","13.7","17"
"Turner","2021-01-11","17","4746","3","482","11.7","18.2"
"Turner","2021-01-12","31","4777","5","487","13.1","18.7"
"Turner","2021-01-13","44","4821","2","489","12.1","16"
"Turner","2021-01-14","50","4871","1","490","10.7","14.2"
"Turner","2021-01-15","11","4882","4","494","14.1","16.8"
"Turner","2021-01-16","9","4891","5","499","18.9","20.8"
"Turner","2021-01-17","4","4895","2","501","26","19.9"
"Turner","2021-01-18","19","4914","9","510","30.3","21"
"Turner","2021-01-19","20","4934","6","516","32.3","22.7"
"Turner","2021-01-20","9","4943","3","519","36.4","24.2"
"Turner","2021-01-21","21","4964","4","523","38.8","24.7"
"Turner","2021-01-22","14","4978","5","528","38.7","26.4"
"Turner","2021-01-23","0","4978","0","528","30.8","24.8"
"Turner","2021-01-24","5","4983","0","528","23.6","24.8"
"Turner","2021-01-25","9","4992","3","531","21.6","26"
"Turner","2021-01-26","0","4992","0","531","17.3","24.8"
"Turner","2021-01-27","0","4992","0","531","12.6","24.5"
"Twiggs","2020-02-01","0","0","0","0",".","."
"Twiggs","2020-02-02","0","0","0","0",".","."
"Twiggs","2020-02-03","0","0","0","0",".","."
"Twiggs","2020-02-04","0","0","0","0",".","."
"Twiggs","2020-02-05","0","0","0","0",".","."
"Twiggs","2020-02-06","0","0","0","0",".","."
"Twiggs","2020-02-07","0","0","0","0","0","."
"Twiggs","2020-02-08","0","0","0","0","0","."
"Twiggs","2020-02-09","0","0","0","0","0","."
"Twiggs","2020-02-10","0","0","0","0","0","."
"Twiggs","2020-02-11","0","0","0","0","0","."
"Twiggs","2020-02-12","0","0","0","0","0","."
"Twiggs","2020-02-13","0","0","0","0","0","."
"Twiggs","2020-02-14","0","0","0","0","0","0"
"Twiggs","2020-02-15","0","0","0","0","0","0"
"Twiggs","2020-02-16","0","0","0","0","0","0"
"Twiggs","2020-02-17","0","0","0","0","0","0"
"Twiggs","2020-02-18","0","0","0","0","0","0"
"Twiggs","2020-02-19","0","0","0","0","0","0"
"Twiggs","2020-02-20","0","0","0","0","0","0"
"Twiggs","2020-02-21","0","0","0","0","0","0"
"Twiggs","2020-02-22","0","0","0","0","0","0"
"Twiggs","2020-02-23","0","0","0","0","0","0"
"Twiggs","2020-02-24","0","0","0","0","0","0"
"Twiggs","2020-02-25","0","0","0","0","0","0"
"Twiggs","2020-02-26","0","0","0","0","0","0"
"Twiggs","2020-02-27","0","0","0","0","0","0"
"Twiggs","2020-02-28","0","0","0","0","0","0"
"Twiggs","2020-02-29","0","0","0","0","0","0"
"Twiggs","2020-03-01","0","0","0","0","0","0"
"Twiggs","2020-03-02","0","0","0","0","0","0"
"Twiggs","2020-03-03","0","0","0","0","0","0"
"Twiggs","2020-03-04","0","0","0","0","0","0"
"Twiggs","2020-03-05","0","0","0","0","0","0"
"Twiggs","2020-03-06","0","0","0","0","0","0"
"Twiggs","2020-03-07","0","0","0","0","0","0"
"Twiggs","2020-03-08","0","0","0","0","0","0"
"Twiggs","2020-03-09","0","0","0","0","0","0"
"Twiggs","2020-03-10","0","0","0","0","0","0"
"Twiggs","2020-03-11","0","0","0","0","0","0"
"Twiggs","2020-03-12","0","0","0","0","0","0"
"Twiggs","2020-03-13","3","3","0","0","0","0"
"Twiggs","2020-03-14","2","5","0","0","0","0"
"Twiggs","2020-03-15","0","5","0","0","0","0"
"Twiggs","2020-03-16","0","5","0","0","0","0"
"Twiggs","2020-03-17","0","5","0","0","0","0"
"Twiggs","2020-03-18","1","6","0","0","0","0"
"Twiggs","2020-03-19","2","8","0","0","0","0"
"Twiggs","2020-03-20","4","12","1","1","3.6","1.8"
"Twiggs","2020-03-21","2","14","0","1","3.6","1.8"
"Twiggs","2020-03-22","4","18","3","4","14.3","7.1"
"Twiggs","2020-03-23","2","20","0","4","14.3","7.1"
"Twiggs","2020-03-24","3","23","0","4","14.3","7.1"
"Twiggs","2020-03-25","6","29","0","4","14.3","7.1"
"Twiggs","2020-03-26","0","29","0","4","14.3","7.1"
"Twiggs","2020-03-27","5","34","0","4","10.7","7.1"
"Twiggs","2020-03-28","1","35","0","4","10.7","7.1"
"Twiggs","2020-03-29","0","35","0","4","0","7.1"
"Twiggs","2020-03-30","1","36","0","4","0","7.1"
"Twiggs","2020-03-31","0","36","0","4","0","7.1"
"Twiggs","2020-04-01","2","38","0","4","0","7.1"
"Twiggs","2020-04-02","1","39","0","4","0","7.1"
"Twiggs","2020-04-03","1","40","0","4","0","5.4"
"Twiggs","2020-04-04","0","40","0","4","0","5.4"
"Twiggs","2020-04-05","0","40","0","4","0","0"
"Twiggs","2020-04-06","1","41","0","4","0","0"
"Twiggs","2020-04-07","3","44","1","5","4.8","2.4"
"Twiggs","2020-04-08","2","46","0","5","4.8","2.4"
"Twiggs","2020-04-09","6","52","4","9","14.3","7.1"
"Twiggs","2020-04-10","6","58","2","11","19","9.5"
"Twiggs","2020-04-11","6","64","0","11","19","9.5"
"Twiggs","2020-04-12","1","65","1","12","33.3","16.7"
"Twiggs","2020-04-13","6","71","1","13","35.7","17.9"
"Twiggs","2020-04-14","13","84","3","16","34.2","19.5"
"Twiggs","2020-04-15","4","88","1","17","37.8","21.3"
"Twiggs","2020-04-16","5","93","0","17","28.3","21.3"
"Twiggs","2020-04-17","0","93","0","17","23.5","21.3"
"Twiggs","2020-04-18","0","93","0","17","23.5","21.3"
"Twiggs","2020-04-19","0","93","0","17","9.2","21.3"
"Twiggs","2020-04-20","2","95","0","17","6.9","21.3"
"Twiggs","2020-04-21","4","99","3","20","14.3","24.3"
"Twiggs","2020-04-22","2","101","0","20","10.7","24.3"
"Twiggs","2020-04-23","1","102","1","21","25","26.6"
"Twiggs","2020-04-24","5","107","4","25","36.4","30"
"Twiggs","2020-04-25","1","108","1","26","50.7","37.1"
"Twiggs","2020-04-26","0","108","0","26","50.7","30"
"Twiggs","2020-04-27","6","114","0","26","50.7","28.8"
"Twiggs","2020-04-28","1","115","0","26","40","27.1"
"Twiggs","2020-04-29","0","115","0","26","40","25.4"
"Twiggs","2020-04-30","5","120","0","26","25.7","25.4"
"Twiggs","2020-05-01","6","126","1","27","16.7","26.5"
"Twiggs","2020-05-02","4","130","0","27","2.4","26.5"
"Twiggs","2020-05-03","6","136","0","27","2.4","26.5"
"Twiggs","2020-05-04","9","145","2","29","5.6","28.1"
"Twiggs","2020-05-05","4","149","0","29","5.6","22.8"
"Twiggs","2020-05-06","5","154","1","30","8.4","24.2"
"Twiggs","2020-05-07","4","158","0","30","8.4","17.1"
"Twiggs","2020-05-08","0","158","0","30","6","11.3"
"Twiggs","2020-05-09","6","164","0","30","6","4.2"
"Twiggs","2020-05-10","2","166","0","30","6","4.2"
"Twiggs","2020-05-11","8","174","1","31","4.6","5.1"
"Twiggs","2020-05-12","3","177","0","31","4.6","5.1"
"Twiggs","2020-05-13","8","185","0","31","1.8","5.1"
"Twiggs","2020-05-14","8","193","0","31","1.8","5.1"
"Twiggs","2020-05-15","4","197","1","32","5.4","5.7"
"Twiggs","2020-05-16","4","201","0","32","5.4","5.7"
"Twiggs","2020-05-17","5","206","2","34","11.1","8.6"
"Twiggs","2020-05-18","3","209","0","34","9.3","7"
"Twiggs","2020-05-19","5","214","2","36","15","9.8"
"Twiggs","2020-05-20","4","218","0","36","15","8.4"
"Twiggs","2020-05-21","6","224","0","36","15","8.4"
"Twiggs","2020-05-22","9","233","2","38","14.6","10"
"Twiggs","2020-05-23","0","233","0","38","14.6","10"
"Twiggs","2020-05-24","3","236","0","38","8.9","10"
"Twiggs","2020-05-25","5","241","0","38","8.9","9.1"
"Twiggs","2020-05-26","13","254","3","41","6.5","10.7"
"Twiggs","2020-05-27","2","256","0","41","6.5","10.7"
"Twiggs","2020-05-28","5","261","1","42","9.3","12.2"
"Twiggs","2020-05-29","4","265","1","43","9.7","12.2"
"Twiggs","2020-05-30","0","265","0","43","9.7","12.2"
"Twiggs","2020-05-31","1","266","0","43","9.7","9.3"
"Twiggs","2020-06-01","7","273","0","43","9.7","9.3"
"Twiggs","2020-06-02","6","279","1","44","8.8","7.6"
"Twiggs","2020-06-03","4","283","2","46","16","11.2"
"Twiggs","2020-06-04","8","291","1","47","14.9","12.1"
"Twiggs","2020-06-05","6","297","0","47","11.3","10.5"
"Twiggs","2020-06-06","3","300","0","47","11.3","10.5"
"Twiggs","2020-06-07","1","301","0","47","11.3","10.5"
"Twiggs","2020-06-08","4","305","1","48","14.9","12.3"
"Twiggs","2020-06-09","3","308","0","48","12.5","10.7"
"Twiggs","2020-06-10","6","314","2","50","10.1","13"
"Twiggs","2020-06-11","15","329","0","50","8.3","11.6"
"Twiggs","2020-06-12","7","336","0","50","8.3","9.8"
"Twiggs","2020-06-13","3","339","1","51","13.1","12.2"
"Twiggs","2020-06-14","1","340","0","51","13.1","12.2"
"Twiggs","2020-06-15","3","343","0","51","9.5","12.2"
"Twiggs","2020-06-16","5","348","0","51","9.5","11"
"Twiggs","2020-06-17","4","352","1","52","8.3","9.2"
"Twiggs","2020-06-18","5","357","0","52","8.3","8.3"
"Twiggs","2020-06-19","2","359","0","52","8.3","8.3"
"Twiggs","2020-06-20","1","360","0","52","3.6","8.3"
"Twiggs","2020-06-21","1","361","0","52","3.6","8.3"
"Twiggs","2020-06-22","14","375","1","53","4.6","7.1"
"Twiggs","2020-06-23","7","382","0","53","4.6","7.1"
"Twiggs","2020-06-24","6","388","0","53","1","4.7"
"Twiggs","2020-06-25","14","402","2","55","3.1","5.7"
"Twiggs","2020-06-26","7","409","1","56","5.1","6.7"
"Twiggs","2020-06-27","7","416","3","59","11.2","7.4"
"Twiggs","2020-06-28","6","422","1","60","13.6","8.6"
"Twiggs","2020-06-29","12","434","8","68","22.1","13.4"
"Twiggs","2020-06-30","10","444","0","68","22.1","13.4"
"Twiggs","2020-07-01","22","466","1","69","22.8","11.9"
"Twiggs","2020-07-02","26","492","3","72","22.4","12.7"
"Twiggs","2020-07-03","10","502","3","75","24.6","14.9"
"Twiggs","2020-07-04","1","503","0","75","18.5","14.9"
"Twiggs","2020-07-05","11","514","5","80","22.6","18.1"
"Twiggs","2020-07-06","17","531","1","81","13.9","18"
"Twiggs","2020-07-07","16","547","1","82","14.8","18.5"
"Twiggs","2020-07-08","23","570","2","84","15.4","19.1"
"Twiggs","2020-07-09","32","602","7","91","16.9","19.6"
"Twiggs","2020-07-10","9","611","0","91","12.6","18.6"
"Twiggs","2020-07-11","6","617","0","91","12.6","15.5"
"Twiggs","2020-07-12","13","630","2","93","8.3","15.4"
"Twiggs","2020-07-13","20","650","1","94","8.2","11"
"Twiggs","2020-07-14","19","669","0","94","7.3","11"
"Twiggs","2020-07-15","11","680","4","98","11.2","13.3"
"Twiggs","2020-07-16","33","713","10","108","12.4","14.7"
"Twiggs","2020-07-17","14","727","2","110","14.5","13.5"
"Twiggs","2020-07-18","12","739","7","117","22.8","17.7"
"Twiggs","2020-07-19","14","753","1","118","21.6","15"
"Twiggs","2020-07-20","29","782","7","125","24.4","16.3"
"Twiggs","2020-07-21","10","792","3","128","28.7","18"
"Twiggs","2020-07-22","10","802","4","132","29.2","20.2"
"Twiggs","2020-07-23","35","837","6","138","27.3","19.9"
"Twiggs","2020-07-24","11","848","2","140","27.8","21.2"
"Twiggs","2020-07-25","7","855","2","142","23.6","23.2"
"Twiggs","2020-07-26","6","861","3","145","29.7","25.7"
"Twiggs","2020-07-27","19","880","4","149","29.3","26.8"
"Twiggs","2020-07-28","14","894","3","152","28.1","28.4"
"Twiggs","2020-07-29","19","913","2","154","23.8","26.5"
"Twiggs","2020-07-30","53","966","8","162","23.6","25.4"
"Twiggs","2020-07-31","18","984","2","164","22.5","25.2"
"Twiggs","2020-08-01","4","988","1","165","22","22.8"
"Twiggs","2020-08-02","5","993","1","166","17.7","23.7"
"Twiggs","2020-08-03","16","1009","4","170","18.3","23.8"
"Twiggs","2020-08-04","9","1018","3","173","20","24"
"Twiggs","2020-08-05","16","1034","6","179","23.9","23.9"
"Twiggs","2020-08-06","41","1075","4","183","23.1","23.3"
"Twiggs","2020-08-07","21","1096","4","187","24.2","23.4"
"Twiggs","2020-08-08","11","1107","4","191","25.9","23.9"
"Twiggs","2020-08-09","3","1110","0","191","23","20.4"
"Twiggs","2020-08-10","17","1127","6","197","24.5","21.4"
"Twiggs","2020-08-11","10","1137","3","200","24","22"
"Twiggs","2020-08-12","5","1142","1","201","21.5","22.7"
"Twiggs","2020-08-13","23","1165","8","209","25.1","24.1"
"Twiggs","2020-08-14","7","1172","0","209","22.3","23.3"
"Twiggs","2020-08-15","6","1178","3","212","24.3","25.1"
"Twiggs","2020-08-16","4","1182","1","213","27.9","25.4"
"Twiggs","2020-08-17","11","1193","3","216","26.7","25.6"
"Twiggs","2020-08-18","21","1214","3","219","24.5","24.2"
"Twiggs","2020-08-19","10","1224","2","221","24.5","23"
"Twiggs","2020-08-20","25","1249","3","224","21.2","23.1"
"Twiggs","2020-08-21","4","1253","1","225","24.8","23.6"
"Twiggs","2020-08-22","13","1266","1","226","18.8","21.5"
"Twiggs","2020-08-23","4","1270","0","226","15.2","21.5"
"Twiggs","2020-08-24","19","1289","3","229","13.5","20.1"
"Twiggs","2020-08-25","12","1301","1","230","12.7","18.6"
"Twiggs","2020-08-26","5","1306","0","230","9.8","17.2"
"Twiggs","2020-08-27","27","1333","3","233","9.7","15.5"
"Twiggs","2020-08-28","9","1342","0","233","6.1","15.5"
"Twiggs","2020-08-29","4","1346","1","234","8.6","13.7"
"Twiggs","2020-08-30","9","1355","1","235","10.2","12.7"
"Twiggs","2020-08-31","4","1359","0","235","7.9","10.7"
"Twiggs","2020-09-01","6","1365","2","237","11.5","12.1"
"Twiggs","2020-09-02","10","1375","1","238","12.9","11.4"
"Twiggs","2020-09-03","15","1390","3","241","14.2","12"
"Twiggs","2020-09-04","6","1396","1","242","16.6","11.4"
"Twiggs","2020-09-05","6","1402","0","242","13","10.8"
"Twiggs","2020-09-06","2","1404","0","242","11.4","10.8"
"Twiggs","2020-09-07","3","1407","2","244","21","14.4"
"Twiggs","2020-09-08","6","1413","1","245","18.6","15"
"Twiggs","2020-09-09","10","1423","1","246","18.6","15.8"
"Twiggs","2020-09-10","14","1437","0","246","15.7","15"
"Twiggs","2020-09-11","7","1444","2","248","17.4","17"
"Twiggs","2020-09-12","0","1444","0","248","17.4","15.2"
"Twiggs","2020-09-13","3","1447","0","248","17.4","14.4"
"Twiggs","2020-09-14","10","1457","1","249","9.3","15.1"
"Twiggs","2020-09-15","4","1461","1","250","10.5","14.5"
"Twiggs","2020-09-16","6","1467","1","251","11.5","15"
"Twiggs","2020-09-17","12","1479","2","253","13.8","14.8"
"Twiggs","2020-09-18","7","1486","0","253","9.8","13.6"
"Twiggs","2020-09-19","4","1490","0","253","9.8","13.6"
"Twiggs","2020-09-20","7","1497","1","254","11.8","14.6"
"Twiggs","2020-09-21","13","1510","2","256","12.6","10.9"
"Twiggs","2020-09-22","8","1518","1","257","10.8","10.6"
"Twiggs","2020-09-23","6","1524","1","258","10.8","11.1"
"Twiggs","2020-09-24","9","1533","2","260","11.6","12.7"
"Twiggs","2020-09-25","12","1545","3","263","15.2","12.5"
"Twiggs","2020-09-26","6","1551","2","265","19.9","14.8"
"Twiggs","2020-09-27","5","1556","4","269","29.3","20.6"
"Twiggs","2020-09-28","14","1570","3","272","30.2","21.4"
"Twiggs","2020-09-29","6","1576","0","272","28.4","19.6"
"Twiggs","2020-09-30","7","1583","1","273","28","19.4"
"Twiggs","2020-10-01","23","1606","1","274","25.5","18.5"
"Twiggs","2020-10-02","9","1615","1","275","23.5","19.3"
"Twiggs","2020-10-03","6","1621","1","276","21.1","20.5"
"Twiggs","2020-10-04","3","1624","0","276","9.7","19.5"
"Twiggs","2020-10-05","4","1628","1","277","10.2","20.2"
"Twiggs","2020-10-06","8","1636","2","279","13.8","21.1"
"Twiggs","2020-10-07","13","1649","3","282","15","21.5"
"Twiggs","2020-10-08","8","1657","2","284","18","21.7"
"Twiggs","2020-10-09","12","1669","3","287","20","21.7"
"Twiggs","2020-10-10","6","1675","0","287","17.6","19.4"
"Twiggs","2020-10-11","3","1678","1","288","22.3","16"
"Twiggs","2020-10-12","12","1690","1","289","20","15.1"
"Twiggs","2020-10-13","11","1701","2","291","19","16.4"
"Twiggs","2020-10-14","8","1709","3","294","21","18"
"Twiggs","2020-10-15","13","1722","1","295","18.6","18.3"
"Twiggs","2020-10-16","12","1734","1","296","16.2","18.1"
"Twiggs","2020-10-17","4","1738","1","297","19.8","18.7"
"Twiggs","2020-10-18","5","1743","2","299","20.7","21.5"
"Twiggs","2020-10-19","10","1753","2","301","22.4","21.2"
"Twiggs","2020-10-20","11","1764","1","302","21.1","20"
"Twiggs","2020-10-21","11","1775","1","303","17","19"
"Twiggs","2020-10-22","20","1795","2","305","17.4","18"
"Twiggs","2020-10-23","11","1806","1","306","17.5","16.8"
"Twiggs","2020-10-24","7","1813","0","306","13.9","16.8"
"Twiggs","2020-10-25","3","1816","1","307","12.9","16.8"
"Twiggs","2020-10-26","16","1832","3","310","12.8","17.6"
"Twiggs","2020-10-27","14","1846","1","311","12.5","16.8"
"Twiggs","2020-10-28","11","1857","1","312","12.5","14.8"
"Twiggs","2020-10-29","12","1869","3","315","14.6","16"
"Twiggs","2020-10-30","13","1882","1","316","14.4","15.9"
"Twiggs","2020-10-31","4","1886","3","319","25.1","19.5"
"Twiggs","2020-11-01","2","1888","1","320","27.5","20.2"
"Twiggs","2020-11-02","18","1906","2","322","26.4","19.6"
"Twiggs","2020-11-03","6","1912","3","325","32.6","22.5"
"Twiggs","2020-11-04","9","1921","0","325","31.3","21.9"
"Twiggs","2020-11-05","11","1932","2","327","30.3","22.5"
"Twiggs","2020-11-06","6","1938","0","327","29.2","21.8"
"Twiggs","2020-11-07","4","1942","0","327","18.5","21.8"
"Twiggs","2020-11-08","2","1944","0","327","11.3","19.4"
"Twiggs","2020-11-09","10","1954","0","327","9.7","18.1"
"Twiggs","2020-11-10","6","1960","1","328","5","18.8"
"Twiggs","2020-11-11","3","1963","0","328","5","18.1"
"Twiggs","2020-11-12","15","1978","0","328","2.4","16.3"
"Twiggs","2020-11-13","16","1994","0","328","2.4","15.8"
"Twiggs","2020-11-14","4","1998","0","328","2.4","10.4"
"Twiggs","2020-11-15","6","2004","0","328","2.4","6.9"
"Twiggs","2020-11-16","14","2018","1","329","3.4","6.6"
"Twiggs","2020-11-17","12","2030","2","331","3.4","4.2"
"Twiggs","2020-11-18","10","2040","1","332","4.8","4.9"
"Twiggs","2020-11-19","28","2068","2","334","5.9","4.1"
"Twiggs","2020-11-20","12","2080","4","338","10.6","6.5"
"Twiggs","2020-11-21","7","2087","2","340","14.7","8.5"
"Twiggs","2020-11-22","1","2088","0","340","14.7","8.5"
"Twiggs","2020-11-23","11","2099","0","340","13.7","8.5"
"Twiggs","2020-11-24","5","2104","0","340","11.3","7.3"
"Twiggs","2020-11-25","10","2114","1","341","11.3","8.1"
"Twiggs","2020-11-26","2","2116","0","341","10.3","8.1"
"Twiggs","2020-11-27","10","2126","4","345","11.2","10.9"
"Twiggs","2020-11-28","3","2129","0","345","7.1","10.9"
"Twiggs","2020-11-29","7","2136","2","347","11.2","13"
"Twiggs","2020-11-30","17","2153","2","349","12.9","13.3"
"Twiggs","2020-12-01","9","2162","1","350","14.5","12.9"
"Twiggs","2020-12-02","12","2174","1","351","14.3","12.8"
"Twiggs","2020-12-03","17","2191","3","354","16.8","13.5"
"Twiggs","2020-12-04","18","2209","2","356","12.6","11.9"
"Twiggs","2020-12-05","13","2222","1","357","13.7","10.4"
"Twiggs","2020-12-06","4","2226","0","357","9.7","10.4"
"Twiggs","2020-12-07","18","2244","1","358","8.8","10.8"
"Twiggs","2020-12-08","9","2253","2","360","10.4","12.4"
"Twiggs","2020-12-09","20","2273","5","365","12.7","13.5"
"Twiggs","2020-12-10","12","2285","2","367","12.6","14.7"
"Twiggs","2020-12-11","14","2299","5","372","16.1","14.4"
"Twiggs","2020-12-12","8","2307","3","375","20.4","17.1"
"Twiggs","2020-12-13","4","2311","3","378","31.1","20.4"
"Twiggs","2020-12-14","16","2327","5","383","34.8","21.8"
"Twiggs","2020-12-15","15","2342","2","385","33.5","21.9"
"Twiggs","2020-12-16","12","2354","8","393","39.4","26.1"
"Twiggs","2020-12-17","25","2379","6","399","40.5","26.6"
"Twiggs","2020-12-18","21","2400","2","401","36.8","26.4"
"Twiggs","2020-12-19","11","2411","7","408","40.5","30.4"
"Twiggs","2020-12-20","9","2420","2","410","32.9","32"
"Twiggs","2020-12-21","18","2438","2","412","30.1","32.4"
"Twiggs","2020-12-22","13","2451","6","418","34.8","34.1"
"Twiggs","2020-12-23","20","2471","8","426","30.9","35.2"
"Twiggs","2020-12-24","7","2478","4","430","35.7","38.1"
"Twiggs","2020-12-25","5","2483","1","431","37.2","37"
"Twiggs","2020-12-26","9","2492","5","436","36","38.3"
"Twiggs","2020-12-27","16","2508","8","444","40","36.5"
"Twiggs","2020-12-28","18","2526","7","451","44","37"
"Twiggs","2020-12-29","24","2550","11","462","43.9","39.3"
"Twiggs","2020-12-30","50","2600","21","483","44.2","37.6"
"Twiggs","2020-12-31","34","2634","9","492","39.8","37.8"
"Twiggs","2021-01-01","7","2641","3","495","43.1","40.1"
"Twiggs","2021-01-02","11","2652","2","497","37.7","36.9"
"Twiggs","2021-01-03","20","2672","7","504","35.6","37.8"
"Twiggs","2021-01-04","40","2712","11","515","34","39"
"Twiggs","2021-01-05","26","2738","10","525","32.9","38.4"
"Twiggs","2021-01-06","30","2768","2","527","27.9","36"
"Twiggs","2021-01-07","43","2811","8","535","26.8","33.3"
"Twiggs","2021-01-08","19","2830","6","541","25.1","34.1"
"Twiggs","2021-01-09","13","2843","6","547","29.1","33.4"
"Twiggs","2021-01-10","19","2862","4","551","27.1","31.4"
"Twiggs","2021-01-11","29","2891","1","552","23.7","28.8"
"Twiggs","2021-01-12","28","2919","8","560","22.3","27.6"
"Twiggs","2021-01-13","16","2935","0","560","21.3","24.6"
"Twiggs","2021-01-14","38","2973","6","566","20.9","23.8"
"Twiggs","2021-01-15","13","2986","3","569","19.7","22.4"
"Twiggs","2021-01-16","9","2995","3","572","17.9","23.5"
"Twiggs","2021-01-17","6","3001","3","575","22","24.6"
"Twiggs","2021-01-18","18","3019","1","576","22.3","23"
"Twiggs","2021-01-19","15","3034","5","581","23","22.7"
"Twiggs","2021-01-20","8","3042","1","582","24.8","23.1"
"Twiggs","2021-01-21","20","3062","2","584","24","22.5"
"Twiggs","2021-01-22","14","3076","1","585","21.7","20.7"
"Twiggs","2021-01-23","8","3084","2","587","20.5","19.2"
"Twiggs","2021-01-24","3","3087","1","588","18.1","20.1"
"Twiggs","2021-01-25","8","3095","0","588","17.3","19.8"
"Twiggs","2021-01-26","0","3095","0","588","12.6","17.8"
"Twiggs","2021-01-27","0","3095","0","588","10.8","17.8"
"Union","2020-02-01","0","0","0","0",".","."
"Union","2020-02-02","0","0","0","0",".","."
"Union","2020-02-03","0","0","0","0",".","."
"Union","2020-02-04","0","0","0","0",".","."
"Union","2020-02-05","0","0","0","0",".","."
"Union","2020-02-06","0","0","0","0",".","."
"Union","2020-02-07","0","0","0","0","0","."
"Union","2020-02-08","0","0","0","0","0","."
"Union","2020-02-09","0","0","0","0","0","."
"Union","2020-02-10","0","0","0","0","0","."
"Union","2020-02-11","0","0","0","0","0","."
"Union","2020-02-12","0","0","0","0","0","."
"Union","2020-02-13","0","0","0","0","0","."
"Union","2020-02-14","0","0","0","0","0","0"
"Union","2020-02-15","0","0","0","0","0","0"
"Union","2020-02-16","0","0","0","0","0","0"
"Union","2020-02-17","0","0","0","0","0","0"
"Union","2020-02-18","0","0","0","0","0","0"
"Union","2020-02-19","0","0","0","0","0","0"
"Union","2020-02-20","0","0","0","0","0","0"
"Union","2020-02-21","0","0","0","0","0","0"
"Union","2020-02-22","0","0","0","0","0","0"
"Union","2020-02-23","0","0","0","0","0","0"
"Union","2020-02-24","0","0","0","0","0","0"
"Union","2020-02-25","0","0","0","0","0","0"
"Union","2020-02-26","0","0","0","0","0","0"
"Union","2020-02-27","0","0","0","0","0","0"
"Union","2020-02-28","0","0","0","0","0","0"
"Union","2020-02-29","0","0","0","0","0","0"
"Union","2020-03-01","0","0","0","0","0","0"
"Union","2020-03-02","0","0","0","0","0","0"
"Union","2020-03-03","0","0","0","0","0","0"
"Union","2020-03-04","0","0","0","0","0","0"
"Union","2020-03-05","0","0","0","0","0","0"
"Union","2020-03-06","0","0","0","0","0","0"
"Union","2020-03-07","0","0","0","0","0","0"
"Union","2020-03-08","0","0","0","0","0","0"
"Union","2020-03-09","0","0","0","0","0","0"
"Union","2020-03-10","0","0","0","0","0","0"
"Union","2020-03-11","0","0","0","0","0","0"
"Union","2020-03-12","1","1","0","0","0","0"
"Union","2020-03-13","0","1","0","0","0","0"
"Union","2020-03-14","1","2","0","0","0","0"
"Union","2020-03-15","1","3","1","1","14.3","7.1"
"Union","2020-03-16","0","3","0","1","14.3","7.1"
"Union","2020-03-17","5","8","0","1","14.3","7.1"
"Union","2020-03-18","1","9","0","1","14.3","7.1"
"Union","2020-03-19","1","10","0","1","14.3","7.1"
"Union","2020-03-20","2","12","0","1","14.3","7.1"
"Union","2020-03-21","3","15","0","1","14.3","7.1"
"Union","2020-03-22","5","20","0","1","0","7.1"
"Union","2020-03-23","3","23","0","1","0","7.1"
"Union","2020-03-24","3","26","0","1","0","7.1"
"Union","2020-03-25","1","27","0","1","0","7.1"
"Union","2020-03-26","10","37","0","1","0","7.1"
"Union","2020-03-27","6","43","0","1","0","7.1"
"Union","2020-03-28","2","45","0","1","0","7.1"
"Union","2020-03-29","2","47","0","1","0","0"
"Union","2020-03-30","7","54","1","2","2","1"
"Union","2020-03-31","0","54","0","2","2","1"
"Union","2020-04-01","1","55","0","2","2","1"
"Union","2020-04-02","7","62","0","2","2","1"
"Union","2020-04-03","5","67","0","2","2","1"
"Union","2020-04-04","6","73","0","2","2","1"
"Union","2020-04-05","2","75","0","2","2","1"
"Union","2020-04-06","4","79","0","2","0","1"
"Union","2020-04-07","5","84","0","2","0","1"
"Union","2020-04-08","3","87","0","2","0","1"
"Union","2020-04-09","3","90","0","2","0","1"
"Union","2020-04-10","4","94","0","2","0","1"
"Union","2020-04-11","1","95","0","2","0","1"
"Union","2020-04-12","0","95","0","2","0","1"
"Union","2020-04-13","0","95","0","2","0","0"
"Union","2020-04-14","3","98","1","3","4.8","2.4"
"Union","2020-04-15","0","98","0","3","4.8","2.4"
"Union","2020-04-16","4","102","0","3","4.8","2.4"
"Union","2020-04-17","9","111","0","3","4.8","2.4"
"Union","2020-04-18","3","114","0","3","4.8","2.4"
"Union","2020-04-19","1","115","0","3","4.8","2.4"
"Union","2020-04-20","2","117","0","3","4.8","2.4"
"Union","2020-04-21","2","119","0","3","0","2.4"
"Union","2020-04-22","6","125","0","3","0","2.4"
"Union","2020-04-23","8","133","0","3","0","2.4"
"Union","2020-04-24","4","137","0","3","0","2.4"
"Union","2020-04-25","2","139","0","3","0","2.4"
"Union","2020-04-26","2","141","1","4","7.1","6"
"Union","2020-04-27","6","147","0","4","7.1","6"
"Union","2020-04-28","5","152","0","4","7.1","3.6"
"Union","2020-04-29","4","156","0","4","7.1","3.6"
"Union","2020-04-30","5","161","0","4","7.1","3.6"
"Union","2020-05-01","6","167","0","4","7.1","3.6"
"Union","2020-05-02","1","168","0","4","7.1","3.6"
"Union","2020-05-03","2","170","0","4","0","3.6"
"Union","2020-05-04","4","174","0","4","0","3.6"
"Union","2020-05-05","3","177","0","4","0","3.6"
"Union","2020-05-06","7","184","0","4","0","3.6"
"Union","2020-05-07","4","188","0","4","0","3.6"
"Union","2020-05-08","10","198","0","4","0","3.6"
"Union","2020-05-09","3","201","0","4","0","3.6"
"Union","2020-05-10","0","201","0","4","0","0"
"Union","2020-05-11","10","211","0","4","0","0"
"Union","2020-05-12","10","221","0","4","0","0"
"Union","2020-05-13","13","234","0","4","0","0"
"Union","2020-05-14","10","244","0","4","0","0"
"Union","2020-05-15","8","252","0","4","0","0"
"Union","2020-05-16","17","269","1","5","0.8","0.4"
"Union","2020-05-17","13","282","2","7","3","1.5"
"Union","2020-05-18","6","288","0","7","3","1.5"
"Union","2020-05-19","9","297","0","7","3","1.5"
"Union","2020-05-20","13","310","0","7","3","1.5"
"Union","2020-05-21","6","316","0","7","3","1.5"
"Union","2020-05-22","8","324","0","7","3","1.5"
"Union","2020-05-23","41","365","4","11","3.6","2.2"
"Union","2020-05-24","1","366","1","12","15.7","9.4"
"Union","2020-05-25","1","367","0","12","15.7","9.4"
"Union","2020-05-26","13","380","0","12","15.7","9.4"
"Union","2020-05-27","48","428","0","12","15.7","9.4"
"Union","2020-05-28","13","441","1","13","16.8","9.9"
"Union","2020-05-29","8","449","0","13","16.8","9.9"
"Union","2020-05-30","28","477","3","16","16.9","10.3"
"Union","2020-05-31","4","481","0","16","2.6","9.2"
"Union","2020-06-01","7","488","0","16","2.6","9.2"
"Union","2020-06-02","9","497","1","17","4.2","9.9"
"Union","2020-06-03","41","538","6","23","6.3","11"
"Union","2020-06-04","15","553","0","23","5.2","11"
"Union","2020-06-05","10","563","1","24","6.6","11.7"
"Union","2020-06-06","19","582","1","25","5.9","11.4"
"Union","2020-06-07","4","586","2","27","13","7.8"
"Union","2020-06-08","13","599","1","28","14.1","8.4"
"Union","2020-06-09","10","609","1","29","13.9","9.1"
"Union","2020-06-10","51","660","3","32","12.7","9.5"
"Union","2020-06-11","9","669","0","32","12.7","8.9"
"Union","2020-06-12","16","685","5","37","15.7","11.2"
"Union","2020-06-13","49","734","2","39","15.6","10.7"
"Union","2020-06-14","2","736","0","39","8.4","10.7"
"Union","2020-06-15","27","763","0","39","7.3","10.7"
"Union","2020-06-16","6","769","1","40","8.3","11.1"
"Union","2020-06-17","44","813","2","42","8.1","10.4"
"Union","2020-06-18","12","825","0","42","8.1","10.4"
"Union","2020-06-19","9","834","2","44","6.8","11.3"
"Union","2020-06-20","34","868","1","45","6.6","11.1"
"Union","2020-06-21","1","869","0","45","6.6","7.5"
"Union","2020-06-22","15","884","4","49","10.4","8.9"
"Union","2020-06-23","8","892","0","49","8.1","8.2"
"Union","2020-06-24","64","956","7","56","9","8.5"
"Union","2020-06-25","14","970","5","61","14.1","11.1"
"Union","2020-06-26","17","987","7","68","16.8","11.8"
"Union","2020-06-27","36","1023","5","73","18.3","12.5"
"Union","2020-06-28","8","1031","4","77","25.5","16.1"
"Union","2020-06-29","18","1049","4","81","24.8","17.6"
"Union","2020-06-30","16","1065","4","85","28.4","18.2"
"Union","2020-07-01","137","1202","9","94","27.8","18.4"
"Union","2020-07-02","8","1210","0","94","22.7","18.4"
"Union","2020-07-03","73","1283","13","107","19.4","18.1"
"Union","2020-07-04","4","1287","1","108","20.9","19.6"
"Union","2020-07-05","2","1289","0","108","13.8","19.6"
"Union","2020-07-06","35","1324","15","123","16.7","20.8"
"Union","2020-07-07","35","1359","4","127","14.8","21.6"
"Union","2020-07-08","162","1521","25","152","16.1","21.9"
"Union","2020-07-09","46","1567","4","156","17.3","20"
"Union","2020-07-10","66","1633","29","185","21.1","20.2"
"Union","2020-07-11","92","1725","7","192","18.6","19.8"
"Union","2020-07-12","62","1787","12","204","21.3","17.6"
"Union","2020-07-13","28","1815","9","213","19.8","18.3"
"Union","2020-07-14","65","1880","25","238","23.7","19.2"
"Union","2020-07-15","45","1925","12","250","25.3","20.7"
"Union","2020-07-16","42","1967","5","255","25.7","21.5"
"Union","2020-07-17","65","2032","7","262","21","21"
"Union","2020-07-18","73","2105","4","266","20.7","19.6"
"Union","2020-07-19","3","2108","0","266","17.9","19.6"
"Union","2020-07-20","72","2180","13","279","15.9","17.9"
"Union","2020-07-21","77","2257","17","296","13.6","18.6"
"Union","2020-07-22","142","2399","21","317","11.9","18.6"
"Union","2020-07-23","55","2454","18","335","14.8","20.3"
"Union","2020-07-24","75","2529","17","352","16.5","18.8"
"Union","2020-07-25","115","2644","13","365","17.4","19"
"Union","2020-07-26","28","2672","6","371","20.4","19.2"
"Union","2020-07-27","34","2706","8","379","21.2","18.6"
"Union","2020-07-28","62","2768","13","392","21.1","17.3"
"Union","2020-07-29","171","2939","14","406","20.1","16"
"Union","2020-07-30","60","2999","15","421","19","16.9"
"Union","2020-07-31","86","3085","25","446","19.9","18.2"
"Union","2020-08-01","116","3201","21","467","20.9","19.1"
"Union","2020-08-02","30","3231","11","478","23.1","21.8"
"Union","2020-08-03","19","3250","0","478","19.7","20.5"
"Union","2020-08-04","23","3273","4","482","19.2","20.1"
"Union","2020-08-05","213","3486","38","520","20.6","20.3"
"Union","2020-08-06","76","3562","30","550","22.6","20.8"
"Union","2020-08-07","21","3583","4","554","21.2","20.6"
"Union","2020-08-08","79","3662","4","558","19.4","20.1"
"Union","2020-08-09","61","3723","20","578","18.8","20.9"
"Union","2020-08-10","88","3811","29","607","23.5","21.6"
"Union","2020-08-11","62","3873","16","623","24.7","22"
"Union","2020-08-12","261","4134","37","660","24.2","22.4"
"Union","2020-08-13","49","4183","3","663","19.4","21"
"Union","2020-08-14","69","4252","10","673","18.8","20"
"Union","2020-08-15","104","4356","12","685","19.7","19.5"
"Union","2020-08-16","122","4478","23","708","17.7","18.3"
"Union","2020-08-17","20","4498","8","716","18.7","21.1"
"Union","2020-08-18","61","4559","13","729","18.1","21.4"
"Union","2020-08-19","62","4621","11","740","18.6","21.4"
"Union","2020-08-20","74","4695","18","758","21.2","20.3"
"Union","2020-08-21","21","4716","6","764","23.2","21"
"Union","2020-08-22","83","4799","9","773","23.1","21.4"
"Union","2020-08-23","75","4874","30","803","26.1","21.9"
"Union","2020-08-24","27","4901","9","812","25.2","21.9"
"Union","2020-08-25","13","4914","2","814","24.3","21.2"
"Union","2020-08-26","144","5058","32","846","25","21.8"
"Union","2020-08-27","50","5108","4","850","22.6","21.9"
"Union","2020-08-28","68","5176","19","869","22.5","22.9"
"Union","2020-08-29","21","5197","0","869","21","22"
"Union","2020-08-30","65","5262","13","882","18.1","22.1"
"Union","2020-08-31","23","5285","6","888","17.1","21.1"
"Union","2020-09-01","44","5329","13","901","19.1","21.7"
"Union","2020-09-02","70","5399","10","911","18","21.5"
"Union","2020-09-03","33","5432","8","919","20.3","21.5"
"Union","2020-09-04","10","5442","0","919","16.3","19.4"
"Union","2020-09-05","7","5449","0","919","16.3","18.6"
"Union","2020-09-06","38","5487","17","936","19.8","19"
"Union","2020-09-07","2","5489","0","936","16.1","16.6"
"Union","2020-09-08","30","5519","8","944","15.7","17.4"
"Union","2020-09-09","112","5631","48","992","19.8","18.9"
"Union","2020-09-10","86","5717","9","1001","17.8","19.1"
"Union","2020-09-11","76","5793","18","1019","21.2","18.8"
"Union","2020-09-12","63","5856","2","1021","21.7","19"
"Union","2020-09-13","37","5893","6","1027","17.6","18.7"
"Union","2020-09-14","36","5929","15","1042","23.5","19.8"
"Union","2020-09-15","40","5969","18","1060","26.2","20.9"
"Union","2020-09-16","148","6117","12","1072","21.2","20.5"
"Union","2020-09-17","50","6167","5","1077","21.1","19.5"
"Union","2020-09-18","57","6224","9","1086","20","20.6"
"Union","2020-09-19","96","6320","17","1103","22.1","21.9"
"Union","2020-09-20","22","6342","6","1109","23.6","20.6"
"Union","2020-09-21","41","6383","13","1122","22.2","22.9"
"Union","2020-09-22","31","6414","9","1131","19.9","23"
"Union","2020-09-23","133","6547","38","1169","22.9","22"
"Union","2020-09-24","6","6553","0","1169","21.4","21.3"
"Union","2020-09-25","132","6685","28","1197","22.2","21.1"
"Union","2020-09-26","83","6768","19","1216","23","22.5"
"Union","2020-09-27","0","6768","0","1216","19.1","21.4"
"Union","2020-09-28","59","6827","11","1227","17.2","19.7"
"Union","2020-09-29","31","6858","10","1237","17.7","18.8"
"Union","2020-09-30","103","6961","7","1244","14.5","18.7"
"Union","2020-10-01","89","7050","31","1275","19.5","20.5"
"Union","2020-10-02","52","7102","19","1294","21.7","22"
"Union","2020-10-03","36","7138","11","1305","22.8","22.9"
"Union","2020-10-04","3","7141","0","1305","22.8","20.9"
"Union","2020-10-05","89","7230","25","1330","24.2","20.7"
"Union","2020-10-06","36","7266","15","1345","25.5","21.6"
"Union","2020-10-07","14","7280","2","1347","26.6","20.6"
"Union","2020-10-08","13","7293","0","1347","21.6","20.6"
"Union","2020-10-09","10","7303","1","1348","17.8","19.8"
"Union","2020-10-10","5","7308","1","1349","16.3","19.5"
"Union","2020-10-11","5","7313","0","1349","16.3","19.5"
"Union","2020-10-12","24","7337","0","1349","12.3","18.2"
"Union","2020-10-13","14","7351","0","1349","6.3","15.9"
"Union","2020-10-14","15","7366","0","1349","4.3","15.4"
"Union","2020-10-15","10","7376","2","1351","7.1","14.4"
"Union","2020-10-16","12","7388","0","1351","5.7","11.8"
"Union","2020-10-17","3","7391","1","1352","7.6","12"
"Union","2020-10-18","3","7394","0","1352","7.6","12"
"Union","2020-10-19","16","7410","0","1352","7.6","9.9"
"Union","2020-10-20","9","7419","2","1354","10.8","8.6"
"Union","2020-10-21","25","7444","1","1355","11.4","7.8"
"Union","2020-10-22","18","7462","1","1356","9.3","8.2"
"Union","2020-10-23","15","7477","3","1359","12.2","8.9"
"Union","2020-10-24","1","7478","0","1359","7.4","7.5"
"Union","2020-10-25","3","7481","0","1359","7.4","7.5"
"Union","2020-10-26","18","7499","1","1360","8.2","7.9"
"Union","2020-10-27","17","7516","0","1360","5","7.9"
"Union","2020-10-28","10","7526","0","1360","4.4","7.9"
"Union","2020-10-29","13","7539","3","1363","6.9","8.1"
"Union","2020-10-30","17","7556","2","1365","5.8","9"
"Union","2020-10-31","7","7563","2","1367","9.9","8.6"
"Union","2020-11-01","5","7568","1","1368","12.7","10.1"
"Union","2020-11-02","26","7594","2","1370","13","10.6"
"Union","2020-11-03","15","7609","0","1370","13","9"
"Union","2020-11-04","19","7628","2","1372","14.5","9.5"
"Union","2020-11-05","20","7648","0","1372","11.2","9.1"
"Union","2020-11-06","15","7663","1","1373","10.5","8.1"
"Union","2020-11-07","71","7734","11","1384","8.6","9.2"
"Union","2020-11-08","6","7740","2","1386","10.5","11.6"
"Union","2020-11-09","15","7755","2","1388","11.3","12.2"
"Union","2020-11-10","28","7783","5","1393","13.9","13.5"
"Union","2020-11-11","17","7800","5","1398","16.6","15.6"
"Union","2020-11-12","24","7824","1","1399","17.2","14.2"
"Union","2020-11-13","26","7850","1","1400","16.8","13.6"
"Union","2020-11-14","74","7924","11","1411","16.7","12.7"
"Union","2020-11-15","3","7927","1","1412","16.7","13.6"
"Union","2020-11-16","19","7946","0","1412","14.8","13.1"
"Union","2020-11-17","38","7984","5","1417","14.1","14"
"Union","2020-11-18","32","8016","5","1422","12.1","14.4"
"Union","2020-11-19","33","8049","3","1425","12.8","15"
"Union","2020-11-20","24","8073","5","1430","15.3","16"
"Union","2020-11-21","156","8229","15","1445","14.5","15.6"
"Union","2020-11-22","8","8237","0","1445","9.8","13.2"
"Union","2020-11-23","32","8269","3","1448","11.1","12.9"
"Union","2020-11-24","36","8305","12","1460","14","14"
"Union","2020-11-25","48","8353","8","1468","14.1","13.1"
"Union","2020-11-26","5","8358","4","1472","24.3","18.6"
"Union","2020-11-27","61","8419","8","1480","23.2","19.2"
"Union","2020-11-28","56","8475","10","1490","24.3","19.4"
"Union","2020-11-29","13","8488","3","1493","27.6","18.7"
"Union","2020-11-30","27","8515","6","1499","29.5","20.3"
"Union","2020-12-01","75","8590","11","1510","26.8","20.4"
"Union","2020-12-02","62","8652","13","1523","27.4","20.8"
"Union","2020-12-03","95","8747","13","1536","17.9","21.1"
"Union","2020-12-04","78","8825","12","1548","18.3","20.7"
"Union","2020-12-05","156","8981","33","1581","18.7","21.5"
"Union","2020-12-06","22","9003","5","1586","18.7","23.2"
"Union","2020-12-07","53","9056","8","1594","17.7","23.6"
"Union","2020-12-08","69","9125","15","1609","18.7","22.7"
"Union","2020-12-09","53","9178","6","1615","17.3","22.4"
"Union","2020-12-10","125","9303","22","1637","17.9","17.9"
"Union","2020-12-11","48","9351","5","1642","17.2","17.7"
"Union","2020-12-12","202","9553","23","1665","15.8","17.2"
"Union","2020-12-13","36","9589","7","1672","15.3","17"
"Union","2020-12-14","42","9631","10","1682","16.5","17.1"
"Union","2020-12-15","104","9735","15","1697","15.5","17.1"
"Union","2020-12-16","128","9863","13","1710","15.3","16.3"
"Union","2020-12-17","89","9952","17","1727","15.5","16.7"
"Union","2020-12-18","101","10053","14","1741","16","16.6"
"Union","2020-12-19","203","10256","48","1789","17.8","16.8"
"Union","2020-12-20","33","10289","8","1797","18.5","16.9"
"Union","2020-12-21","60","10349","15","1812","18.6","17.6"
"Union","2020-12-22","90","10439","18","1830","19.4","17.5"
"Union","2020-12-23","105","10544","22","1852","21","18.1"
"Union","2020-12-24","101","10645","16","1868","20.5","18"
"Union","2020-12-25","1","10646","1","1869","32.8","24.4"
"Union","2020-12-26","15","10661","3","1872","32.3","25"
"Union","2020-12-27","35","10696","11","1883","33.3","25.9"
"Union","2020-12-28","80","10776","20","1903","33.3","26"
"Union","2020-12-29","105","10881","37","1940","35.5","27.5"
"Union","2020-12-30","126","11007","33","1973","36.2","28.6"
"Union","2020-12-31","141","11148","34","2007","37.4","29"
"Union","2021-01-01","33","11181","10","2017","27.5","30.1"
"Union","2021-01-02","76","11257","27","2044","29.7","31"
"Union","2021-01-03","44","11301","27","2071","34","33.6"
"Union","2021-01-04","54","11355","18","2089","35.2","34.2"
"Union","2021-01-05","92","11447","19","2108","33.1","34.3"
"Union","2021-01-06","221","11668","71","2179","33.9","35.1"
"Union","2021-01-07","119","11787","31","2210","34.2","35.8"
"Union","2021-01-08","95","11882","20","2230","32.9","30.2"
"Union","2021-01-09","60","11942","26","2256","34","31.8"
"Union","2021-01-10","50","11992","18","2274","30.4","32.2"
"Union","2021-01-11","67","12059","6","2280","26.9","31"
"Union","2021-01-12","77","12136","19","2299","27.5","30.3"
"Union","2021-01-13","75","12211","13","2312","25.3","29.6"
"Union","2021-01-14","37","12248","9","2321","25.1","29.6"
"Union","2021-01-15","117","12365","27","2348","25.4","29.1"
"Union","2021-01-16","78","12443","22","2370","23.2","28.6"
"Union","2021-01-17","17","12460","6","2376","23.1","26.7"
"Union","2021-01-18","24","12484","6","2382","25.4","26.1"
"Union","2021-01-19","57","12541","8","2390","23.9","25.7"
"Union","2021-01-20","36","12577","5","2395","23.4","24.4"
"Union","2021-01-21","20","12597","4","2399","22.8","23.9"
"Union","2021-01-22","26","12623","4","2403","21.7","23.5"
"Union","2021-01-23","8","12631","3","2406","23","23.1"
"Union","2021-01-24","4","12635","1","2407","21.5","22.3"
"Union","2021-01-25","6","12641","0","2407","18","21.7"
"Union","2021-01-26","1","12642","0","2407","16","19.9"
"Union","2021-01-27","0","12642","0","2407","14","18.7"
"Unknown","2020-02-01","0","0","0","0",".","."
"Unknown","2020-02-02","0","0","0","0",".","."
"Unknown","2020-02-03","0","0","0","0",".","."
"Unknown","2020-02-04","0","0","0","0",".","."
"Unknown","2020-02-05","0","0","0","0",".","."
"Unknown","2020-02-06","0","0","0","0",".","."
"Unknown","2020-02-07","0","0","0","0","0","."
"Unknown","2020-02-08","0","0","0","0","0","."
"Unknown","2020-02-09","0","0","0","0","0","."
"Unknown","2020-02-10","0","0","0","0","0","."
"Unknown","2020-02-11","0","0","0","0","0","."
"Unknown","2020-02-12","0","0","0","0","0","."
"Unknown","2020-02-13","0","0","0","0","0","."
"Unknown","2020-02-14","0","0","0","0","0","0"
"Unknown","2020-02-15","0","0","0","0","0","0"
"Unknown","2020-02-16","0","0","0","0","0","0"
"Unknown","2020-02-17","0","0","0","0","0","0"
"Unknown","2020-02-18","0","0","0","0","0","0"
"Unknown","2020-02-19","0","0","0","0","0","0"
"Unknown","2020-02-20","0","0","0","0","0","0"
"Unknown","2020-02-21","0","0","0","0","0","0"
"Unknown","2020-02-22","0","0","0","0","0","0"
"Unknown","2020-02-23","0","0","0","0","0","0"
"Unknown","2020-02-24","0","0","0","0","0","0"
"Unknown","2020-02-25","0","0","0","0","0","0"
"Unknown","2020-02-26","0","0","0","0","0","0"
"Unknown","2020-02-27","0","0","0","0","0","0"
"Unknown","2020-02-28","0","0","0","0","0","0"
"Unknown","2020-02-29","0","0","0","0","0","0"
"Unknown","2020-03-01","0","0","0","0","0","0"
"Unknown","2020-03-02","0","0","0","0","0","0"
"Unknown","2020-03-03","0","0","0","0","0","0"
"Unknown","2020-03-04","0","0","0","0","0","0"
"Unknown","2020-03-05","0","0","0","0","0","0"
"Unknown","2020-03-06","0","0","0","0","0","0"
"Unknown","2020-03-07","0","0","0","0","0","0"
"Unknown","2020-03-08","0","0","0","0","0","0"
"Unknown","2020-03-09","0","0","0","0","0","0"
"Unknown","2020-03-10","0","0","0","0","0","0"
"Unknown","2020-03-11","0","0","0","0","0","0"
"Unknown","2020-03-12","2","2","0","0","0","0"
"Unknown","2020-03-13","4","6","0","0","0","0"
"Unknown","2020-03-14","3","9","1","1","4.8","2.4"
"Unknown","2020-03-15","0","9","0","1","4.8","2.4"
"Unknown","2020-03-16","7","16","0","1","4.8","2.4"
"Unknown","2020-03-17","9","25","0","1","4.8","2.4"
"Unknown","2020-03-18","1","26","0","1","4.8","2.4"
"Unknown","2020-03-19","3","29","1","2","9.5","4.8"
"Unknown","2020-03-20","11","40","1","3","10.8","5.4"
"Unknown","2020-03-21","3","43","0","3","6.1","5.4"
"Unknown","2020-03-22","2","45","0","3","6.1","5.4"
"Unknown","2020-03-23","11","56","4","7","11.3","8"
"Unknown","2020-03-24","6","62","2","9","16","10.4"
"Unknown","2020-03-25","8","70","2","11","19.6","12.2"
"Unknown","2020-03-26","5","75","1","12","17.7","13.6"
"Unknown","2020-03-27","7","82","2","14","20.5","15.6"
"Unknown","2020-03-28","3","85","0","14","20.5","13.3"
"Unknown","2020-03-29","1","86","0","14","20.5","13.3"
"Unknown","2020-03-30","8","94","2","16","18.8","15"
"Unknown","2020-03-31","20","114","4","20","16.9","16.5"
"Unknown","2020-04-01","17","131","2","22","15","17.3"
"Unknown","2020-04-02","12","143","1","23","13.4","15.5"
"Unknown","2020-04-03","18","161","3","26","11.7","16.1"
"Unknown","2020-04-04","10","171","2","28","14.5","17.5"
"Unknown","2020-04-05","3","174","0","28","14.5","17.5"
"Unknown","2020-04-06","22","196","0","28","11","14.9"
"Unknown","2020-04-07","31","227","3","31","9.5","13.2"
"Unknown","2020-04-08","39","266","10","41","11.5","13.3"
"Unknown","2020-04-09","25","291","2","43","11.4","12.4"
"Unknown","2020-04-10","13","304","0","43","9","10.4"
"Unknown","2020-04-11","7","311","0","43","6.2","10.4"
"Unknown","2020-04-12","12","323","4","47","11","12.7"
"Unknown","2020-04-13","27","350","7","54","14.7","12.8"
"Unknown","2020-04-14","29","379","5","59","15.7","12.6"
"Unknown","2020-04-15","35","414","6","65","14.5","13"
"Unknown","2020-04-16","43","457","12","77","17.4","14.4"
"Unknown","2020-04-17","22","479","6","83","21.3","15.2"
"Unknown","2020-04-18","30","509","3","86","22.7","14.4"
"Unknown","2020-04-19","33","542","7","93","21","16"
"Unknown","2020-04-20","40","582","3","96","18.3","16.5"
"Unknown","2020-04-21","50","632","17","113","20.7","18.2"
"Unknown","2020-04-22","60","692","14","127","21.6","18.1"
"Unknown","2020-04-23","60","752","14","141","21","19.2"
"Unknown","2020-04-24","66","818","5","146","18.1","19.7"
"Unknown","2020-04-25","66","884","11","157","19.1","20.9"
"Unknown","2020-04-26","45","929","19","176","22.1","21.5"
"Unknown","2020-04-27","64","993","14","190","24.1","21.2"
"Unknown","2020-04-28","152","1145","106","296","29.2","25"
"Unknown","2020-04-29","94","1239","54","350","34.1","27.9"
"Unknown","2020-04-30","74","1313","33","383","37.2","29.1"
"Unknown","2020-05-01","75","1388","48","431","45.2","31.7"
"Unknown","2020-05-02","65","1453","48","479","53.4","36.2"
"Unknown","2020-05-03","53","1506","29","508","55.2","38.6"
"Unknown","2020-05-04","124","1630","81","589","61.4","42.8"
"Unknown","2020-05-05","41","1671","2","591","52.1","40.7"
"Unknown","2020-05-06","52","1723","9","600","46.4","40.3"
"Unknown","2020-05-07","66","1789","29","629","46.3","41.7"
"Unknown","2020-05-08","181","1970","154","783","49.3","47.3"
"Unknown","2020-05-09","66","2036","45","828","48.5","50.9"
"Unknown","2020-05-10","43","2079","28","856","50","52.6"
"Unknown","2020-05-11","60","2139","18","874","44.9","53.2"
"Unknown","2020-05-12","47","2186","16","890","49.1","50.6"
"Unknown","2020-05-13","44","2230","14","904","51.2","48.8"
"Unknown","2020-05-14","65","2295","2","906","45.3","45.8"
"Unknown","2020-05-15","56","2351","6","912","34.7","42"
"Unknown","2020-05-16","44","2395","5","917","26.6","37.5"
"Unknown","2020-05-17","34","2429","5","922","19.4","34.7"
"Unknown","2020-05-18","96","2525","15","937","17.3","31.1"
"Unknown","2020-05-19","62","2587","9","946","14.5","31.8"
"Unknown","2020-05-20","57","2644","6","952","11.5","31.3"
"Unknown","2020-05-21","42","2686","3","955","12.1","28.7"
"Unknown","2020-05-22","59","2745","1","956","10.8","22.8"
"Unknown","2020-05-23","13","2758","0","956","9.2","17.9"
"Unknown","2020-05-24","13","2771","3","959","10.4","14.9"
"Unknown","2020-05-25","14","2785","0","959","8.1","12.7"
"Unknown","2020-05-26","50","2835","3","962","6.9","10.7"
"Unknown","2020-05-27","23","2858","1","963","6","8.8"
"Unknown","2020-05-28","46","2904","0","963","5","8.6"
"Unknown","2020-05-29","52","2956","9","972","7.2","9"
"Unknown","2020-05-30","26","2982","1","973","7.8","8.5"
"Unknown","2020-05-31","17","2999","0","973","4.5","7.4"
"Unknown","2020-06-01","63","3062","5","978","5.6","6.9"
"Unknown","2020-06-02","67","3129","7","985","6.3","6.6"
"Unknown","2020-06-03","90","3219","5","990","6.4","6.2"
"Unknown","2020-06-04","40","3259","2","992","7.2","6.1"
"Unknown","2020-06-05","58","3317","5","997","5.9","6.6"
"Unknown","2020-06-06","29","3346","0","997","5.4","6.6"
"Unknown","2020-06-07","19","3365","3","1000","7.6","6.1"
"Unknown","2020-06-08","43","3408","4","1004","7.8","6.7"
"Unknown","2020-06-09","52","3460","7","1011","8.2","7.3"
"Unknown","2020-06-10","38","3498","2","1013","8.2","7.3"
"Unknown","2020-06-11","38","3536","3","1016","8.6","7.9"
"Unknown","2020-06-12","39","3575","4","1020","8.9","7.4"
"Unknown","2020-06-13","24","3599","0","1020","8.9","7.1"
"Unknown","2020-06-14","9","3608","1","1021","8.2","7.9"
"Unknown","2020-06-15","47","3655","6","1027","8.7","8.2"
"Unknown","2020-06-16","52","3707","3","1030","7.6","7.9"
"Unknown","2020-06-17","32","3739","4","1034","8.6","8.4"
"Unknown","2020-06-18","48","3787","2","1036","8.1","8.4"
"Unknown","2020-06-19","51","3838","6","1042","8.3","8.6"
"Unknown","2020-06-20","9","3847","0","1042","8.3","8.6"
"Unknown","2020-06-21","4","3851","0","1042","6.7","7.4"
"Unknown","2020-06-22","118","3969","11","1053","6.2","7.4"
"Unknown","2020-06-23","79","4048","6","1059","6.5","7"
"Unknown","2020-06-24","128","4176","24","1083","7.4","8"
"Unknown","2020-06-25","75","4251","1","1084","7","7.5"
"Unknown","2020-06-26","62","4313","10","1094","7.6","7.9"
"Unknown","2020-06-27","36","4349","13","1107","12.7","10.5"
"Unknown","2020-06-28","19","4368","4","1111","15.8","11.2"
"Unknown","2020-06-29","84","4452","10","1121","16.1","11.2"
"Unknown","2020-06-30","130","4582","13","1134","16.5","11.5"
"Unknown","2020-07-01","126","4708","7","1141","14.6","11"
"Unknown","2020-07-02","115","4823","13","1154","16","11.5"
"Unknown","2020-07-03","155","4978","17","1171","15.3","11.4"
"Unknown","2020-07-04","40","5018","2","1173","10.8","11.8"
"Unknown","2020-07-05","32","5050","4","1177","9.6","12.7"
"Unknown","2020-07-06","100","5150","14","1191","9.9","13"
"Unknown","2020-07-07","79","5229","18","1209","11.7","14.1"
"Unknown","2020-07-08","93","5322","19","1228","13.9","14.2"
"Unknown","2020-07-09","91","5413","17","1245","14.9","15.5"
"Unknown","2020-07-10","65","5478","7","1252","14.9","15.1"
"Unknown","2020-07-11","39","5517","5","1257","16","13.4"
"Unknown","2020-07-12","46","5563","21","1278","20.7","15.2"
"Unknown","2020-07-13","91","5654","12","1290","20.6","15.3"
"Unknown","2020-07-14","292","5946","23","1313","18.5","15.1"
"Unknown","2020-07-15","196","6142","16","1329","16.7","15.3"
"Unknown","2020-07-16","344","6486","22","1351","15","14.9"
"Unknown","2020-07-17","377","6863","29","1380","14.5","14.7"
"Unknown","2020-07-18","325","7188","29","1409","14","15"
"Unknown","2020-07-19","28","7216","8","1417","11.5","16.1"
"Unknown","2020-07-20","167","7383","25","1442","11.8","16.2"
"Unknown","2020-07-21","86","7469","10","1452","12.3","15.4"
"Unknown","2020-07-22","77","7546","16","1468","14.1","15.4"
"Unknown","2020-07-23","227","7773","14","1482","14.1","14.5"
"Unknown","2020-07-24","196","7969","30","1512","15.2","14.9"
"Unknown","2020-07-25","150","8119","13","1525","15.2","14.6"
"Unknown","2020-07-26","52","8171","11","1536","14.1","12.8"
"Unknown","2020-07-27","99","8270","14","1550","14","12.9"
"Unknown","2020-07-28","324","8594","25","1575","13.4","12.9"
"Unknown","2020-07-29","408","9002","19","1594","11.1","12.6"
"Unknown","2020-07-30","348","9350","29","1623","11.4","12.8"
"Unknown","2020-07-31","795","10145","22","1645","9.6","12.4"
"Unknown","2020-08-01","165","10310","6","1651","8.9","12"
"Unknown","2020-08-02","195","10505","3","1654","6.1","10.1"
"Unknown","2020-08-03","290","10795","17","1671","4.9","9.5"
"Unknown","2020-08-04","302","11097","15","1686","4.5","9"
"Unknown","2020-08-05","796","11893","27","1713","4.4","7.7"
"Unknown","2020-08-06","368","12261","21","1734","4","7.7"
"Unknown","2020-08-07","399","12660","18","1752","4.2","6.9"
"Unknown","2020-08-08","441","13101","7","1759","3.9","6.4"
"Unknown","2020-08-09","26","13127","6","1765","7","6.6"
"Unknown","2020-08-10","480","13607","16","1781","6.7","5.8"
"Unknown","2020-08-11","317","13924","12","1793","6.5","5.5"
"Unknown","2020-08-12","214","14138","12","1805","6.8","5.6"
"Unknown","2020-08-13","264","14402","6","1811","6.3","5.1"
"Unknown","2020-08-14","231","14633","11","1822","6.3","5.3"
"Unknown","2020-08-15","131","14764","10","1832","7.2","5.6"
"Unknown","2020-08-16","36","14800","2","1834","4.7","5.9"
"Unknown","2020-08-17","224","15024","7","1841","4.7","5.7"
"Unknown","2020-08-18","382","15406","14","1855","4.7","5.6"
"Unknown","2020-08-19","397","15803","7","1862","4.1","5.5"
"Unknown","2020-08-20","232","16035","13","1875","4.6","5.4"
"Unknown","2020-08-21","472","16507","15","1890","4.4","5.4"
"Unknown","2020-08-22","752","17259","13","1903","3.5","5.4"
"Unknown","2020-08-23","55","17314","7","1910","4.5","4.6"
"Unknown","2020-08-24","228","17542","18","1928","5.2","5"
"Unknown","2020-08-25","256","17798","12","1940","5.4","5"
"Unknown","2020-08-26","2152","19950","59","1999","5.5","4.8"
"Unknown","2020-08-27","729","20679","26","2025","5.2","4.9"
"Unknown","2020-08-28","1219","21898","11","2036","4.9","4.6"
"Unknown","2020-08-29","448","22346","5","2041","4.8","4.2"
"Unknown","2020-08-30","17","22363","2","2043","4.7","4.6"
"Unknown","2020-08-31","95","22458","1","2044","3.7","4.5"
"Unknown","2020-09-01","272","22730","6","2050","3.3","4.4"
"Unknown","2020-09-02","256","22986","5","2055","3.2","4.4"
"Unknown","2020-09-03","389","23375","19","2074","3.4","4.3"
"Unknown","2020-09-04","179","23554","4","2078","3.6","4.2"
"Unknown","2020-09-05","67","23621","6","2084","4.7","4.8"
"Unknown","2020-09-06","4","23625","2","2086","10.2","7.4"
"Unknown","2020-09-07","61","23686","2","2088","10.5","7.1"
"Unknown","2020-09-08","168","23854","7","2095","10.8","7.1"
"Unknown","2020-09-09","222","24076","6","2101","10.9","7.1"
"Unknown","2020-09-10","336","24412","11","2112","10.7","7"
"Unknown","2020-09-11","174","24586","7","2119","10.9","7.3"
"Unknown","2020-09-12","95","24681","5","2124","10.4","7.6"
"Unknown","2020-09-13","184","24865","23","2147","5","7.6"
"Unknown","2020-09-14","209","25074","6","2153","5","7.7"
"Unknown","2020-09-15","216","25290","8","2161","4.9","7.8"
"Unknown","2020-09-16","355","25645","15","2176","5.1","8"
"Unknown","2020-09-17","290","25935","9","2185","5.1","7.9"
"Unknown","2020-09-18","193","26128","2","2187","4.7","7.8"
"Unknown","2020-09-19","54","26182","1","2188","4.2","7.3"
"Unknown","2020-09-20","59","26241","14","2202","5.8","5.4"
"Unknown","2020-09-21","260","26501","23","2225","6.6","5.8"
"Unknown","2020-09-22","44","26545","2","2227","6.8","5.8"
"Unknown","2020-09-23","44","26589","4","2231","7.5","6.3"
"Unknown","2020-09-24","132","26721","5","2236","7.6","6.3"
"Unknown","2020-09-25","110","26831","5","2241","8.1","6.4"
"Unknown","2020-09-26","8","26839","0","2241","7.8","6"
"Unknown","2020-09-27","16","26855","2","2243","6.2","6"
"Unknown","2020-09-28","97","26952","2","2245","5.2","5.9"
"Unknown","2020-09-29","30","26982","0","2245","4.6","5.7"
"Unknown","2020-09-30","561","27543","37","2282","4.2","5.8"
"Unknown","2020-10-01","798","28341","11","2293","3.9","5.7"
"Unknown","2020-10-02","270","28611","4","2297","3.4","5.7"
"Unknown","2020-10-03","82","28693","6","2303","4.5","6.1"
"Unknown","2020-10-04","12","28705","0","2303","2.7","4.4"
"Unknown","2020-10-05","902","29607","2","2305","2.4","3.8"
"Unknown","2020-10-06","631","30238","4","2309","2.5","3.5"
"Unknown","2020-10-07","235","30473","6","2315","1.9","3.1"
"Unknown","2020-10-08","314","30787","10","2325","2.2","3"
"Unknown","2020-10-09","153","30940","6","2331","2.5","3"
"Unknown","2020-10-10","61","31001","4","2335","2.4","3.5"
"Unknown","2020-10-11","8","31009","2","2337","6","4.4"
"Unknown","2020-10-12","115","31124","3","2340","6.4","4.4"
"Unknown","2020-10-13","184","31308","4","2344","6.6","4.5"
"Unknown","2020-10-14","149","31457","10","2354","7.2","4.6"
"Unknown","2020-10-15","220","31677","2","2356","6.8","4.5"
"Unknown","2020-10-16","107","31784","3","2359","6.7","4.6"
"Unknown","2020-10-17","240","32024","4","2363","6","4.2"
"Unknown","2020-10-18","7","32031","1","2364","4.5","5.2"
"Unknown","2020-10-19","141","32172","4","2368","4.5","5.4"
"Unknown","2020-10-20","184","32356","5","2373","4.6","5.6"
"Unknown","2020-10-21","184","32540","6","2379","4.1","5.6"
"Unknown","2020-10-22","37","32577","4","2383","5.5","6.2"
"Unknown","2020-10-23","26","32603","3","2386","6.7","6.7"
"Unknown","2020-10-24","91","32694","4","2390","7.1","6.6"
"Unknown","2020-10-25","9","32703","1","2391","6.7","5.6"
"Unknown","2020-10-26","50","32753","6","2397","8","6.2"
"Unknown","2020-10-27","262","33015","4","2401","7.8","6.2"
"Unknown","2020-10-28","341","33356","12","2413","7.8","6"
"Unknown","2020-10-29","65","33421","6","2419","7.6","6.6"
"Unknown","2020-10-30","213","33634","3","2422","6.2","6.5"
"Unknown","2020-10-31","401","34035","36","2458","6.8","7"
"Unknown","2020-11-01","14","34049","3","2461","8.3","7.5"
"Unknown","2020-11-02","163","34212","8","2469","7.3","7.6"
"Unknown","2020-11-03","221","34433","2","2471","7.2","7.5"
"Unknown","2020-11-04","181","34614","2","2473","6.9","7.3"
"Unknown","2020-11-05","146","34760","6","2479","6.1","6.9"
"Unknown","2020-11-06","207","34967","12","2491","6.7","6.5"
"Unknown","2020-11-07","78","35045","2","2493","5.8","6.3"
"Unknown","2020-11-08","33","35078","3","2496","4.1","6.2"
"Unknown","2020-11-09","137","35215","7","2503","4.1","5.7"
"Unknown","2020-11-10","276","35491","7","2510","4.3","5.8"
"Unknown","2020-11-11","155","35646","16","2526","5.6","6.2"
"Unknown","2020-11-12","202","35848","11","2537","5.8","6"
"Unknown","2020-11-13","178","36026","9","2546","5.7","6.2"
"Unknown","2020-11-14","91","36117","6","2552","6.3","6.1"
"Unknown","2020-11-15","4","36121","1","2553","8.6","6.3"
"Unknown","2020-11-16","111","36232","8","2561","8.9","6.5"
"Unknown","2020-11-17","282","36514","25","2586","9.8","7.1"
"Unknown","2020-11-18","155","36669","13","2599","9.5","7.6"
"Unknown","2020-11-19","220","36889","10","2609","9.4","7.6"
"Unknown","2020-11-20","113","37002","9","2618","9.8","7.8"
"Unknown","2020-11-21","79","37081","7","2625","10.1","8.2"
"Unknown","2020-11-22","11","37092","2","2627","9.1","8.9"
"Unknown","2020-11-23","176","37268","10","2637","8.9","8.9"
"Unknown","2020-11-24","307","37575","8","2645","8","8.9"
"Unknown","2020-11-25","185","37760","15","2660","8","8.8"
"Unknown","2020-11-26","19","37779","1","2661","8.1","8.7"
"Unknown","2020-11-27","71","37850","11","2672","9.2","9.5"
"Unknown","2020-11-28","98","37948","13","2685","9.8","10"
"Unknown","2020-11-29","7","37955","1","2686","9.2","9.2"
"Unknown","2020-11-30","219","38174","17","2703","9.5","9.2"
"Unknown","2020-12-01","205","38379","30","2733","11.3","9.6"
"Unknown","2020-12-02","261","38640","12","2745","10.8","9.4"
"Unknown","2020-12-03","207","38847","21","2766","11.5","9.8"
"Unknown","2020-12-04","158","39005","12","2778","10.3","9.7"
"Unknown","2020-12-05","404","39409","28","2806","9.4","9.6"
"Unknown","2020-12-06","5","39414","1","2807","10.2","9.7"
"Unknown","2020-12-07","95","39509","4","2811","9.7","9.6"
"Unknown","2020-12-08","259","39768","18","2829","8.6","9.9"
"Unknown","2020-12-09","419","40187","20","2849","8.7","9.7"
"Unknown","2020-12-10","277","40464","11","2860","7.8","9.6"
"Unknown","2020-12-11","110","40574","14","2874","8.5","9.4"
"Unknown","2020-12-12","402","40976","21","2895","8.3","8.8"
"Unknown","2020-12-13","16","40992","7","2902","11.7","10.9"
"Unknown","2020-12-14","282","41274","24","2926","12.3","11"
"Unknown","2020-12-15","399","41673","36","2962","12.6","10.6"
"Unknown","2020-12-16","319","41992","27","2989","13.1","10.9"
"Unknown","2020-12-17","686","42678","50","3039","13.6","10.7"
"Unknown","2020-12-18","674","43352","65","3104","13.1","10.8"
"Unknown","2020-12-19","410","43762","23","3127","13.2","10.7"
"Unknown","2020-12-20","102","43864","8","3135","8.1","9.9"
"Unknown","2020-12-21","167","44031","17","3152","8.3","10.3"
"Unknown","2020-12-22","412","44443","33","3185","8.1","10.4"
"Unknown","2020-12-23","649","45092","65","3250","8.4","10.7"
"Unknown","2020-12-24","769","45861","53","3303","8.3","10.9"
"Unknown","2020-12-25","48","45909","9","3312","9.6","11.4"
"Unknown","2020-12-26","308","46217","28","3340","10.1","11.6"
"Unknown","2020-12-27","37","46254","5","3345","10.9","9.5"
"Unknown","2020-12-28","265","46519","50","3395","12.2","10.2"
"Unknown","2020-12-29","234","46753","34","3429","13.1","10.6"
"Unknown","2020-12-30","658","47411","45","3474","12.6","10.5"
"Unknown","2020-12-31","664","48075","64","3538","13","10.7"
"Unknown","2021-01-01","8","48083","2","3540","13.9","11.8"
"Unknown","2021-01-02","121","48204","23","3563","15.3","12.7"
"Unknown","2021-01-03","73","48277","4","3567","14.2","12.6"
"Unknown","2021-01-04","210","48487","19","3586","12.8","12.5"
"Unknown","2021-01-05","390","48877","55","3641","12.7","12.9"
"Unknown","2021-01-06","700","49577","74","3715","13.3","13"
"Unknown","2021-01-07","840","50417","54","3769","12.8","12.9"
"Unknown","2021-01-08","376","50793","59","3828","11.5","12.7"
"Unknown","2021-01-09","245","51038","14","3842","9.6","12.5"
"Unknown","2021-01-10","32","51070","10","3852","13.3","13.7"
"Unknown","2021-01-11","157","51227","16","3868","13.4","13.1"
"Unknown","2021-01-12","488","51715","45","3913","12.7","12.7"
"Unknown","2021-01-13","532","52247","46","3959","12.4","12.9"
"Unknown","2021-01-14","443","52690","47","4006","13","12.9"
"Unknown","2021-01-15","370","53060","41","4047","12.4","11.9"
"Unknown","2021-01-16","214","53274","20","4067","12.9","11.2"
"Unknown","2021-01-17","25","53299","9","4076","13.6","13.4"
"Unknown","2021-01-18","313","53612","14","4090","12.8","13.1"
"Unknown","2021-01-19","275","53887","17","4107","12.3","12.5"
"Unknown","2021-01-20","463","54350","49","4156","12.6","12.5"
"Unknown","2021-01-21","525","54875","30","4186","11.9","12.5"
"Unknown","2021-01-22","352","55227","16","4202","11","11.7"
"Unknown","2021-01-23","482","55709","30","4232","10.5","11.7"
"Unknown","2021-01-24","28","55737","12","4244","11.5","12.5"
"Unknown","2021-01-25","175","55912","14","4258","12","12.4"
"Unknown","2021-01-26","5","55917","1","4259","14","13.2"
"Unknown","2021-01-27","0","55917","0","4259","12.5","12.5"
"Upson","2020-02-01","0","0","0","0",".","."
"Upson","2020-02-02","0","0","0","0",".","."
"Upson","2020-02-03","0","0","0","0",".","."
"Upson","2020-02-04","0","0","0","0",".","."
"Upson","2020-02-05","0","0","0","0",".","."
"Upson","2020-02-06","0","0","0","0",".","."
"Upson","2020-02-07","0","0","0","0","0","."
"Upson","2020-02-08","0","0","0","0","0","."
"Upson","2020-02-09","0","0","0","0","0","."
"Upson","2020-02-10","0","0","0","0","0","."
"Upson","2020-02-11","0","0","0","0","0","."
"Upson","2020-02-12","0","0","0","0","0","."
"Upson","2020-02-13","0","0","0","0","0","."
"Upson","2020-02-14","0","0","0","0","0","0"
"Upson","2020-02-15","0","0","0","0","0","0"
"Upson","2020-02-16","0","0","0","0","0","0"
"Upson","2020-02-17","0","0","0","0","0","0"
"Upson","2020-02-18","0","0","0","0","0","0"
"Upson","2020-02-19","0","0","0","0","0","0"
"Upson","2020-02-20","0","0","0","0","0","0"
"Upson","2020-02-21","0","0","0","0","0","0"
"Upson","2020-02-22","0","0","0","0","0","0"
"Upson","2020-02-23","0","0","0","0","0","0"
"Upson","2020-02-24","0","0","0","0","0","0"
"Upson","2020-02-25","0","0","0","0","0","0"
"Upson","2020-02-26","0","0","0","0","0","0"
"Upson","2020-02-27","0","0","0","0","0","0"
"Upson","2020-02-28","0","0","0","0","0","0"
"Upson","2020-02-29","0","0","0","0","0","0"
"Upson","2020-03-01","0","0","0","0","0","0"
"Upson","2020-03-02","0","0","0","0","0","0"
"Upson","2020-03-03","0","0","0","0","0","0"
"Upson","2020-03-04","0","0","0","0","0","0"
"Upson","2020-03-05","0","0","0","0","0","0"
"Upson","2020-03-06","0","0","0","0","0","0"
"Upson","2020-03-07","0","0","0","0","0","0"
"Upson","2020-03-08","0","0","0","0","0","0"
"Upson","2020-03-09","0","0","0","0","0","0"
"Upson","2020-03-10","4","4","0","0","0","0"
"Upson","2020-03-11","12","16","0","0","0","0"
"Upson","2020-03-12","14","30","0","0","0","0"
"Upson","2020-03-13","8","38","0","0","0","0"
"Upson","2020-03-14","0","38","0","0","0","0"
"Upson","2020-03-15","0","38","0","0","0","0"
"Upson","2020-03-16","12","50","2","2","2.4","1.2"
"Upson","2020-03-17","7","57","0","2","2.4","1.2"
"Upson","2020-03-18","11","68","2","4","5","2.5"
"Upson","2020-03-19","11","79","0","4","5","2.5"
"Upson","2020-03-20","5","84","0","4","5","2.5"
"Upson","2020-03-21","4","88","0","4","5","2.5"
"Upson","2020-03-22","3","91","0","4","5","2.5"
"Upson","2020-03-23","14","105","2","6","4.6","3.5"
"Upson","2020-03-24","8","113","2","8","8.2","5.3"
"Upson","2020-03-25","12","125","3","11","9.2","7.1"
"Upson","2020-03-26","11","136","5","16","15.7","10.3"
"Upson","2020-03-27","6","142","1","17","18.1","11.5"
"Upson","2020-03-28","14","156","3","20","21.1","13"
"Upson","2020-03-29","3","159","0","20","21.1","13"
"Upson","2020-03-30","7","166","2","22","23.2","13.9"
"Upson","2020-03-31","16","182","3","25","22.3","15.2"
"Upson","2020-04-01","14","196","3","28","21.8","15.5"
"Upson","2020-04-02","31","227","9","37","19.4","17.5"
"Upson","2020-04-03","37","264","8","45","20.1","19.1"
"Upson","2020-04-04","49","313","19","64","22.6","21.9"
"Upson","2020-04-05","4","317","0","64","22.6","21.9"
"Upson","2020-04-06","19","336","4","68","21.5","22.3"
"Upson","2020-04-07","69","405","16","84","22.2","22.2"
"Upson","2020-04-08","48","453","11","95","22.4","22.1"
"Upson","2020-04-09","49","502","13","108","22","20.7"
"Upson","2020-04-10","40","542","9","117","22.1","21.1"
"Upson","2020-04-11","25","567","5","122","19.5","21"
"Upson","2020-04-12","8","575","3","125","24.8","23.7"
"Upson","2020-04-13","36","611","10","135","25.8","23.6"
"Upson","2020-04-14","48","659","18","153","27.8","25"
"Upson","2020-04-15","99","758","37","190","29.9","26.1"
"Upson","2020-04-16","51","809","14","204","30","26"
"Upson","2020-04-17","39","848","9","213","30.1","26.1"
"Upson","2020-04-18","30","878","7","220","30.6","25"
"Upson","2020-04-19","6","884","1","221","27.6","26.2"
"Upson","2020-04-20","110","994","15","236","25.6","25.7"
"Upson","2020-04-21","143","1137","16","252","21.8","24.8"
"Upson","2020-04-22","122","1259","11","263","17.8","23.8"
"Upson","2020-04-23","69","1328","6","269","15.1","22.6"
"Upson","2020-04-24","113","1441","11","280","13.2","21.6"
"Upson","2020-04-25","30","1471","4","284","11.8","21.2"
"Upson","2020-04-26","22","1493","6","290","13.3","20.4"
"Upson","2020-04-27","73","1566","8","298","12.9","19.2"
"Upson","2020-04-28","60","1626","1","299","11.5","16.7"
"Upson","2020-04-29","111","1737","19","318","12.7","15.2"
"Upson","2020-04-30","77","1814","10","328","13.3","14.2"
"Upson","2020-05-01","45","1859","8","336","14.4","13.8"
"Upson","2020-05-02","27","1886","7","343","16.2","14"
"Upson","2020-05-03","7","1893","0","343","12.3","12.8"
"Upson","2020-05-04","57","1950","9","352","13","13"
"Upson","2020-05-05","92","2042","10","362","14.4","12.9"
"Upson","2020-05-06","30","2072","2","364","12.9","12.8"
"Upson","2020-05-07","108","2180","2","366","11.3","12.3"
"Upson","2020-05-08","27","2207","2","368","9.8","12.1"
"Upson","2020-05-09","62","2269","2","370","6.5","11.4"
"Upson","2020-05-10","5","2274","1","371","9.4","10.9"
"Upson","2020-05-11","39","2313","2","373","7.9","10.5"
"Upson","2020-05-12","220","2533","10","383","7","10.7"
"Upson","2020-05-13","63","2596","4","387","6.9","9.9"
"Upson","2020-05-14","207","2803","9","396","7.3","9.3"
"Upson","2020-05-15","110","2913","13","409","7.9","8.9"
"Upson","2020-05-16","77","2990","3","412","8","7.3"
"Upson","2020-05-17","4","2994","1","413","8.7","9.1"
"Upson","2020-05-18","25","3019","2","415","9.1","8.5"
"Upson","2020-05-19","125","3144","6","421","9.2","8.1"
"Upson","2020-05-20","38","3182","2","423","9","8"
"Upson","2020-05-21","155","3337","11","434","9.4","8.3"
"Upson","2020-05-22","39","3376","4","438","9.2","8.6"
"Upson","2020-05-23","12","3388","0","438","8.6","8.3"
"Upson","2020-05-24","7","3395","0","438","5.1","6.9"
"Upson","2020-05-25","4","3399","1","439","7.5","8.3"
"Upson","2020-05-26","101","3500","1","440","6.9","8.1"
"Upson","2020-05-27","51","3551","2","442","6.8","7.9"
"Upson","2020-05-28","115","3666","4","446","6.2","7.8"
"Upson","2020-05-29","85","3751","5","451","5.6","7.4"
"Upson","2020-05-30","31","3782","4","455","7.5","8"
"Upson","2020-05-31","4","3786","0","455","7.5","6.3"
"Upson","2020-06-01","24","3810","1","456","4.5","6"
"Upson","2020-06-02","116","3926","3","459","4.7","5.8"
"Upson","2020-06-03","61","3987","3","462","4.8","5.8"
"Upson","2020-06-04","92","4079","1","463","4.5","5.4"
"Upson","2020-06-05","30","4109","2","465","4.6","5.1"
"Upson","2020-06-06","21","4130","2","467","4.1","5.8"
"Upson","2020-06-07","6","4136","0","467","4.1","5.8"
"Upson","2020-06-08","27","4163","4","471","5.7","5.1"
"Upson","2020-06-09","72","4235","5","476","6.3","5.5"
"Upson","2020-06-10","34","4269","1","477","6","5.4"
"Upson","2020-06-11","93","4362","6","483","6.8","5.6"
"Upson","2020-06-12","30","4392","2","485","6.8","5.7"
"Upson","2020-06-13","8","4400","2","487","9","6.6"
"Upson","2020-06-14","4","4404","0","487","9","6.6"
"Upson","2020-06-15","41","4445","3","490","7.9","6.8"
"Upson","2020-06-16","97","4542","13","503","8.8","7.6"
"Upson","2020-06-17","48","4590","7","510","10.5","8.2"
"Upson","2020-06-18","114","4704","11","521","10.9","8.9"
"Upson","2020-06-19","25","4729","2","523","11.1","8.9"
"Upson","2020-06-20","26","4755","2","525","8.7","8.8"
"Upson","2020-06-21","9","4764","1","526","10.3","9.6"
"Upson","2020-06-22","41","4805","5","531","10.9","9.4"
"Upson","2020-06-23","108","4913","5","536","9.7","9.3"
"Upson","2020-06-24","40","4953","5","541","9.4","9.9"
"Upson","2020-06-25","35","4988","2","543","8.8","9.9"
"Upson","2020-06-26","157","5145","9","552","8.5","9.8"
"Upson","2020-06-27","45","5190","6","558","9.3","9"
"Upson","2020-06-28","5","5195","0","558","7.7","9"
"Upson","2020-06-29","41","5236","2","560","6.7","8.8"
"Upson","2020-06-30","53","5289","5","565","7.4","8.5"
"Upson","2020-07-01","129","5418","7","572","6.4","7.9"
"Upson","2020-07-02","35","5453","1","573","6","7.4"
"Upson","2020-07-03","22","5475","0","573","5.1","6.8"
"Upson","2020-07-04","10","5485","0","573","3.2","6.3"
"Upson","2020-07-05","12","5497","2","575","5.6","6.7"
"Upson","2020-07-06","27","5524","1","576","5.4","6.1"
"Upson","2020-07-07","46","5570","0","576","4.1","5.7"
"Upson","2020-07-08","95","5665","4","580","3.9","5.1"
"Upson","2020-07-09","50","5715","1","581","3.8","4.9"
"Upson","2020-07-10","21","5736","1","582","4.5","4.8"
"Upson","2020-07-11","23","5759","3","585","6.3","4.8"
"Upson","2020-07-12","18","5777","4","589","7.1","6.4"
"Upson","2020-07-13","47","5824","2","591","7.2","6.3"
"Upson","2020-07-14","40","5864","3","594","8.3","6.2"
"Upson","2020-07-15","158","6022","5","599","8.1","6"
"Upson","2020-07-16","34","6056","4","603","9.5","6.7"
"Upson","2020-07-17","34","6090","8","611","12.2","8.3"
"Upson","2020-07-18","24","6114","4","615","12.7","9.5"
"Upson","2020-07-19","15","6129","6","621","15.3","11.2"
"Upson","2020-07-20","138","6267","5","626","15.2","11.2"
"Upson","2020-07-21","23","6290","0","626","14.1","11.2"
"Upson","2020-07-22","156","6446","6","632","14.2","11.2"
"Upson","2020-07-23","43","6489","4","636","13.9","11.7"
"Upson","2020-07-24","38","6527","7","643","13.1","12.7"
"Upson","2020-07-25","136","6663","11","654","11.9","12.3"
"Upson","2020-07-26","19","6682","2","656","7.7","11.5"
"Upson","2020-07-27","53","6735","3","659","8","11.6"
"Upson","2020-07-28","41","6776","2","661","8.7","11.4"
"Upson","2020-07-29","151","6927","6","667","8.7","11.4"
"Upson","2020-07-30","41","6968","5","672","9.1","11.5"
"Upson","2020-07-31","42","7010","9","681","9.5","11.3"
"Upson","2020-08-01","40","7050","2","683","9.1","10.5"
"Upson","2020-08-02","23","7073","3","686","9.5","8.6"
"Upson","2020-08-03","70","7143","4","690","9.5","8.7"
"Upson","2020-08-04","71","7214","6","696","10","9.3"
"Upson","2020-08-05","163","7377","14","710","10.6","9.7"
"Upson","2020-08-06","41","7418","5","715","10.6","9.9"
"Upson","2020-08-07","60","7478","3","718","8.3","8.9"
"Upson","2020-08-08","30","7508","4","722","9.5","9.3"
"Upson","2020-08-09","36","7544","18","740","14.8","12.1"
"Upson","2020-08-10","38","7582","8","748","16.9","13.2"
"Upson","2020-08-11","33","7615","2","750","16.6","13.3"
"Upson","2020-08-12","139","7754","13","763","16.7","13.7"
"Upson","2020-08-13","32","7786","3","766","16.3","13.5"
"Upson","2020-08-14","30","7816","1","767","16.1","12.2"
"Upson","2020-08-15","36","7852","4","771","15.8","12.6"
"Upson","2020-08-16","28","7880","8","779","12.7","13.7"
"Upson","2020-08-17","29","7909","5","784","12.1","14.5"
"Upson","2020-08-18","42","7951","3","787","12.3","14.5"
"Upson","2020-08-19","102","8053","10","797","12.4","14.5"
"Upson","2020-08-20","38","8091","0","797","11","13.7"
"Upson","2020-08-21","34","8125","4","801","12.2","14.2"
"Upson","2020-08-22","38","8163","8","809","13.7","14.7"
"Upson","2020-08-23","19","8182","6","815","14.1","13.4"
"Upson","2020-08-24","41","8223","5","820","13.4","12.8"
"Upson","2020-08-25","30","8253","2","822","13.3","12.8"
"Upson","2020-08-26","98","8351","6","828","12.8","12.6"
"Upson","2020-08-27","31","8382","5","833","15.1","13.1"
"Upson","2020-08-28","48","8430","10","843","16.4","14.3"
"Upson","2020-08-29","22","8452","5","848","16.6","15.1"
"Upson","2020-08-30","16","8468","2","850","13.9","14"
"Upson","2020-08-31","34","8502","3","853","13.4","13.4"
"Upson","2020-09-01","54","8556","4","857","13.5","13.4"
"Upson","2020-09-02","104","8660","8","865","13.7","13.2"
"Upson","2020-09-03","44","8704","3","868","12.4","13.7"
"Upson","2020-09-04","31","8735","8","876","13.1","14.7"
"Upson","2020-09-05","34","8769","4","880","11.5","14.1"
"Upson","2020-09-06","10","8779","0","880","9.8","11.8"
"Upson","2020-09-07","36","8815","2","882","9.3","11.3"
"Upson","2020-09-08","29","8844","5","887","10.7","12.1"
"Upson","2020-09-09","80","8924","3","890","10.1","11.9"
"Upson","2020-09-10","53","8977","5","895","10.5","11.5"
"Upson","2020-09-11","37","9014","2","897","7.6","10.4"
"Upson","2020-09-12","16","9030","2","899","7.7","9.6"
"Upson","2020-09-13","16","9046","5","904","12.2","11"
"Upson","2020-09-14","37","9083","2","906","12.1","10.7"
"Upson","2020-09-15","51","9134","1","907","10","10.3"
"Upson","2020-09-16","80","9214","3","910","10","10"
"Upson","2020-09-17","25","9239","2","912","9.8","10.1"
"Upson","2020-09-18","27","9266","2","914","10","8.8"
"Upson","2020-09-19","22","9288","6","920","12.1","9.9"
"Upson","2020-09-20","5","9293","1","921","10.5","11.4"
"Upson","2020-09-21","28","9321","2","923","10.8","11.5"
"Upson","2020-09-22","29","9350","4","927","12.5","11.2"
"Upson","2020-09-23","92","9442","4","931","12.6","11.3"
"Upson","2020-09-24","19","9461","1","932","12.2","11"
"Upson","2020-09-25","20","9481","3","935","13.3","11.6"
"Upson","2020-09-26","30","9511","5","940","11.7","11.9"
"Upson","2020-09-27","11","9522","5","945","15.4","13"
"Upson","2020-09-28","25","9547","3","948","16.1","13.4"
"Upson","2020-09-29","27","9574","4","952","16.2","14.4"
"Upson","2020-09-30","71","9645","2","954","16","14.3"
"Upson","2020-10-01","23","9668","1","955","15.9","14"
"Upson","2020-10-02","70","9738","3","958","14.3","13.8"
"Upson","2020-10-03","57","9795","0","958","12","11.9"
"Upson","2020-10-04","67","9862","1","959","5.7","10.5"
"Upson","2020-10-05","23","9885","1","960","4.6","10.3"
"Upson","2020-10-06","51","9936","1","961","2.8","9.5"
"Upson","2020-10-07","62","9998","1","962","2.6","9.3"
"Upson","2020-10-08","50","10048","1","963","2.2","9.1"
"Upson","2020-10-09","33","10081","0","963","1.6","8"
"Upson","2020-10-10","31","10112","1","964","2.1","7"
"Upson","2020-10-11","30","10142","4","968","3.8","4.7"
"Upson","2020-10-12","20","10162","4","972","6","5.3"
"Upson","2020-10-13","20","10182","0","972","5.7","4.2"
"Upson","2020-10-14","52","10234","4","976","6.6","4.6"
"Upson","2020-10-15","26","10260","0","976","6.3","4.3"
"Upson","2020-10-16","17","10277","1","977","7.2","4.4"
"Upson","2020-10-17","79","10356","0","977","6.7","4.4"
"Upson","2020-10-18","12","10368","3","980","8.4","6.1"
"Upson","2020-10-19","48","10416","1","981","5.8","5.9"
"Upson","2020-10-20","56","10472","2","983","6.3","6"
"Upson","2020-10-21","62","10534","1","984","5.5","6"
"Upson","2020-10-22","35","10569","1","985","5.9","6.1"
"Upson","2020-10-23","27","10596","0","985","5","6.1"
"Upson","2020-10-24","48","10644","0","985","5","5.9"
"Upson","2020-10-25","18","10662","0","985","1.4","4.9"
"Upson","2020-10-26","32","10694","2","987","2","3.9"
"Upson","2020-10-27","36","10730","4","991","3.1","4.7"
"Upson","2020-10-28","79","10809","4","995","3.6","4.5"
"Upson","2020-10-29","34","10843","3","998","4.5","5.2"
"Upson","2020-10-30","40","10883","0","998","4.5","4.7"
"Upson","2020-10-31","50","10933","1","999","4.7","4.9"
"Upson","2020-11-01","13","10946","2","1001","6.9","4.2"
"Upson","2020-11-02","28","10974","2","1003","7.1","4.6"
"Upson","2020-11-03","20","10994","1","1004","6.2","4.7"
"Upson","2020-11-04","90","11084","6","1010","6.4","5"
"Upson","2020-11-05","38","11122","1","1011","5.5","5"
"Upson","2020-11-06","43","11165","0","1011","5.5","5"
"Upson","2020-11-07","38","11203","7","1018","7.9","6.3"
"Upson","2020-11-08","22","11225","6","1024","9.6","8.3"
"Upson","2020-11-09","39","11264","2","1026","9.3","8.2"
"Upson","2020-11-10","45","11309","6","1032","10.5","8.3"
"Upson","2020-11-11","38","11347","1","1033","9.9","8.2"
"Upson","2020-11-12","38","11385","5","1038","11.4","8.5"
"Upson","2020-11-13","36","11421","2","1040","12.2","8.9"
"Upson","2020-11-14","28","11449","9","1049","14.2","11"
"Upson","2020-11-15","24","11473","4","1053","12.7","11.1"
"Upson","2020-11-16","36","11509","3","1056","13.1","11.2"
"Upson","2020-11-17","35","11544","1","1057","11.6","11.1"
"Upson","2020-11-18","79","11623","6","1063","12.3","11.1"
"Upson","2020-11-19","45","11668","0","1063","10.5","10.9"
"Upson","2020-11-20","28","11696","4","1067","11.7","12"
"Upson","2020-11-21","34","11730","7","1074","10","12.1"
"Upson","2020-11-22","22","11752","6","1080","11.6","12.1"
"Upson","2020-11-23","25","11777","2","1082","11.5","12.3"
"Upson","2020-11-24","25","11802","5","1087","14","12.8"
"Upson","2020-11-25","85","11887","13","1100","15.1","13.7"
"Upson","2020-11-26","7","11894","1","1101","17.1","13.8"
"Upson","2020-11-27","20","11914","5","1106","18.6","15.2"
"Upson","2020-11-28","26","11940","5","1111","18.4","14.2"
"Upson","2020-11-29","7","11947","0","1111","14.5","13.1"
"Upson","2020-11-30","31","11978","4","1115","15.2","13.4"
"Upson","2020-12-01","28","12006","4","1119","14.4","14.2"
"Upson","2020-12-02","103","12109","4","1123","12.8","13.9"
"Upson","2020-12-03","27","12136","3","1126","12.3","14.7"
"Upson","2020-12-04","38","12174","3","1129","9.9","14.3"
"Upson","2020-12-05","18","12192","1","1130","7.9","13.2"
"Upson","2020-12-06","15","12207","1","1131","8.9","11.7"
"Upson","2020-12-07","29","12236","3","1134","8.5","11.9"
"Upson","2020-12-08","33","12269","5","1139","8.7","11.5"
"Upson","2020-12-09","132","12401","15","1154","9.7","11.3"
"Upson","2020-12-10","31","12432","1","1155","8.6","10.5"
"Upson","2020-12-11","38","12470","3","1158","8.6","9.3"
"Upson","2020-12-12","36","12506","5","1163","9.8","8.9"
"Upson","2020-12-13","24","12530","3","1166","10.6","9.8"
"Upson","2020-12-14","37","12567","3","1169","10.3","9.4"
"Upson","2020-12-15","76","12643","15","1184","11","9.8"
"Upson","2020-12-16","159","12802","26","1210","11.7","10.7"
"Upson","2020-12-17","43","12845","5","1215","12.9","10.7"
"Upson","2020-12-18","37","12882","7","1222","14.4","11.5"
"Upson","2020-12-19","28","12910","5","1227","15","12.4"
"Upson","2020-12-20","17","12927","2","1229","14.9","12.8"
"Upson","2020-12-21","51","12978","15","1244","18","14.1"
"Upson","2020-12-22","58","13036","7","1251","16.9","13.9"
"Upson","2020-12-23","194","13230","28","1279","16.6","14.1"
"Upson","2020-12-24","47","13277","14","1293","19.2","16"
"Upson","2020-12-25","22","13299","9","1302","22.3","18.4"
"Upson","2020-12-26","50","13349","17","1319","24.6","19.8"
"Upson","2020-12-27","32","13381","14","1333","29.2","22.1"
"Upson","2020-12-28","62","13443","13","1346","28","23"
"Upson","2020-12-29","104","13547","27","1373","30","23.4"
"Upson","2020-12-30","315","13862","66","1439","30.9","23.7"
"Upson","2020-12-31","98","13960","24","1463","30.1","24.7"
"Upson","2021-01-01","32","13992","16","1479","31.4","26.9"
"Upson","2021-01-02","36","14028","12","1491","31.4","28"
"Upson","2021-01-03","19","14047","9","1500","31.9","30.5"
"Upson","2021-01-04","25","14072","3","1503","30.6","29.3"
"Upson","2021-01-05","83","14155","13","1516","29.1","29.5"
"Upson","2021-01-06","275","14430","49","1565","28.7","29.8"
"Upson","2021-01-07","56","14486","18","1583","29.8","30"
"Upson","2021-01-08","41","14527","10","1593","26.1","28.8"
"Upson","2021-01-09","33","14560","13","1606","27","29.2"
"Upson","2021-01-10","27","14587","5","1611","22.8","27.4"
"Upson","2021-01-11","54","14641","8","1619","23.2","26.9"
"Upson","2021-01-12","72","14713","14","1633","23.8","26.5"
"Upson","2021-01-13","212","14925","44","1677","24.2","26.4"
"Upson","2021-01-14","87","15012","21","1698","23.1","26.4"
"Upson","2021-01-15","69","15081","13","1711","22.3","24.2"
"Upson","2021-01-16","29","15110","6","1717","19.6","23.3"
"Upson","2021-01-17","27","15137","3","1720","18.5","20.7"
"Upson","2021-01-18","59","15196","11","1731","19.1","21.2"
"Upson","2021-01-19","56","15252","10","1741","18.9","21.3"
"Upson","2021-01-20","175","15427","22","1763","17.7","21"
"Upson","2021-01-21","66","15493","10","1773","16.4","19.7"
"Upson","2021-01-22","52","15545","11","1784","16.7","19.5"
"Upson","2021-01-23","52","15597","12","1796","17.1","18.3"
"Upson","2021-01-24","26","15623","6","1802","18.8","18.7"
"Upson","2021-01-25","8","15631","1","1803","17.9","18.5"
"Upson","2021-01-26","2","15633","0","1803","15.4","17.1"
"Upson","2021-01-27","0","15633","0","1803","13.6","15.6"
"Walker","2020-02-01","0","0","0","0",".","."
"Walker","2020-02-02","0","0","0","0",".","."
"Walker","2020-02-03","0","0","0","0",".","."
"Walker","2020-02-04","0","0","0","0",".","."
"Walker","2020-02-05","0","0","0","0",".","."
"Walker","2020-02-06","0","0","0","0",".","."
"Walker","2020-02-07","0","0","0","0","0","."
"Walker","2020-02-08","0","0","0","0","0","."
"Walker","2020-02-09","0","0","0","0","0","."
"Walker","2020-02-10","0","0","0","0","0","."
"Walker","2020-02-11","0","0","0","0","0","."
"Walker","2020-02-12","0","0","0","0","0","."
"Walker","2020-02-13","0","0","0","0","0","."
"Walker","2020-02-14","0","0","0","0","0","0"
"Walker","2020-02-15","0","0","0","0","0","0"
"Walker","2020-02-16","0","0","0","0","0","0"
"Walker","2020-02-17","0","0","0","0","0","0"
"Walker","2020-02-18","0","0","0","0","0","0"
"Walker","2020-02-19","0","0","0","0","0","0"
"Walker","2020-02-20","0","0","0","0","0","0"
"Walker","2020-02-21","0","0","0","0","0","0"
"Walker","2020-02-22","0","0","0","0","0","0"
"Walker","2020-02-23","0","0","0","0","0","0"
"Walker","2020-02-24","0","0","0","0","0","0"
"Walker","2020-02-25","0","0","0","0","0","0"
"Walker","2020-02-26","0","0","0","0","0","0"
"Walker","2020-02-27","0","0","0","0","0","0"
"Walker","2020-02-28","0","0","0","0","0","0"
"Walker","2020-02-29","0","0","0","0","0","0"
"Walker","2020-03-01","0","0","0","0","0","0"
"Walker","2020-03-02","0","0","0","0","0","0"
"Walker","2020-03-03","0","0","0","0","0","0"
"Walker","2020-03-04","0","0","0","0","0","0"
"Walker","2020-03-05","0","0","0","0","0","0"
"Walker","2020-03-06","0","0","0","0","0","0"
"Walker","2020-03-07","0","0","0","0","0","0"
"Walker","2020-03-08","0","0","0","0","0","0"
"Walker","2020-03-09","0","0","0","0","0","0"
"Walker","2020-03-10","1","1","0","0","0","0"
"Walker","2020-03-11","1","2","0","0","0","0"
"Walker","2020-03-12","2","4","0","0","0","0"
"Walker","2020-03-13","12","16","0","0","0","0"
"Walker","2020-03-14","2","18","0","0","0","0"
"Walker","2020-03-15","3","21","0","0","0","0"
"Walker","2020-03-16","16","37","0","0","0","0"
"Walker","2020-03-17","23","60","0","0","0","0"
"Walker","2020-03-18","24","84","0","0","0","0"
"Walker","2020-03-19","20","104","0","0","0","0"
"Walker","2020-03-20","14","118","1","1","1","0.5"
"Walker","2020-03-21","6","124","0","1","1","0.5"
"Walker","2020-03-22","0","124","0","1","1","0.5"
"Walker","2020-03-23","14","138","0","1","1","0.5"
"Walker","2020-03-24","12","150","0","1","1","0.5"
"Walker","2020-03-25","15","165","0","1","1","0.5"
"Walker","2020-03-26","15","180","2","3","2.9","1.5"
"Walker","2020-03-27","20","200","0","3","1.9","1.5"
"Walker","2020-03-28","0","200","0","3","1.9","1.5"
"Walker","2020-03-29","1","201","0","3","1.9","1.5"
"Walker","2020-03-30","6","207","1","4","4.3","2.7"
"Walker","2020-03-31","7","214","0","4","4.3","2.7"
"Walker","2020-04-01","11","225","0","4","4.3","2.7"
"Walker","2020-04-02","3","228","0","4","2.4","2.7"
"Walker","2020-04-03","8","236","0","4","2.4","2.1"
"Walker","2020-04-04","0","236","0","4","2.4","2.1"
"Walker","2020-04-05","0","236","0","4","2.4","2.1"
"Walker","2020-04-06","11","247","1","5","1.3","2.8"
"Walker","2020-04-07","16","263","1","6","2.2","3.2"
"Walker","2020-04-08","14","277","0","6","2.2","3.2"
"Walker","2020-04-09","13","290","0","6","2.2","2.3"
"Walker","2020-04-10","22","312","0","6","2.2","2.3"
"Walker","2020-04-11","1","313","0","6","2.2","2.3"
"Walker","2020-04-12","0","313","0","6","2.2","2.3"
"Walker","2020-04-13","0","313","0","6","0.9","1.1"
"Walker","2020-04-14","16","329","0","6","0","1.1"
"Walker","2020-04-15","15","344","1","7","1","1.6"
"Walker","2020-04-16","11","355","0","7","1","1.6"
"Walker","2020-04-17","11","366","0","7","1","1.6"
"Walker","2020-04-18","2","368","0","7","1","1.6"
"Walker","2020-04-19","3","371","0","7","1","1.6"
"Walker","2020-04-20","45","416","0","7","1","0.9"
"Walker","2020-04-21","61","477","0","7","1","0.5"
"Walker","2020-04-22","36","513","0","7","0","0.5"
"Walker","2020-04-23","14","527","0","7","0","0.5"
"Walker","2020-04-24","73","600","1","8","0.2","0.6"
"Walker","2020-04-25","24","624","0","8","0.2","0.6"
"Walker","2020-04-26","1","625","0","8","0.2","0.6"
"Walker","2020-04-27","32","657","0","8","0.2","0.6"
"Walker","2020-04-28","39","696","0","8","0.2","0.6"
"Walker","2020-04-29","13","709","0","8","0.2","0.1"
"Walker","2020-04-30","65","774","0","8","0.2","0.1"
"Walker","2020-05-01","33","807","2","10","0.9","0.5"
"Walker","2020-05-02","25","832","0","10","0.9","0.5"
"Walker","2020-05-03","0","832","0","10","0.9","0.5"
"Walker","2020-05-04","9","841","0","10","0.9","0.5"
"Walker","2020-05-05","25","866","0","10","0.9","0.5"
"Walker","2020-05-06","59","925","4","14","1.8","1"
"Walker","2020-05-07","62","987","1","15","2.1","1.1"
"Walker","2020-05-08","230","1217","3","18","1.4","1.1"
"Walker","2020-05-09","80","1297","0","18","1.4","1.1"
"Walker","2020-05-10","2","1299","0","18","1.4","1.1"
"Walker","2020-05-11","43","1342","1","19","1.7","1.3"
"Walker","2020-05-12","223","1565","5","24","2","1.5"
"Walker","2020-05-13","119","1684","10","34","2.3","2.1"
"Walker","2020-05-14","69","1753","1","35","2.2","2.2"
"Walker","2020-05-15","311","2064","20","55","3","2.2"
"Walker","2020-05-16","102","2166","6","61","3.8","2.6"
"Walker","2020-05-17","1","2167","0","61","3.8","2.6"
"Walker","2020-05-18","19","2186","0","61","3.5","2.6"
"Walker","2020-05-19","25","2211","0","61","3.2","2.6"
"Walker","2020-05-20","28","2239","0","61","2","2.1"
"Walker","2020-05-21","9","2248","0","61","1.8","2"
"Walker","2020-05-22","18","2266","0","61","0.8","1.9"
"Walker","2020-05-23","1","2267","0","61","0","1.9"
"Walker","2020-05-24","0","2267","0","61","0","1.9"
"Walker","2020-05-25","1","2268","0","61","0","1.7"
"Walker","2020-05-26","75","2343","3","64","0.6","1.9"
"Walker","2020-05-27","61","2404","3","67","1.3","1.6"
"Walker","2020-05-28","83","2487","4","71","2","1.9"
"Walker","2020-05-29","55","2542","4","75","3","1.9"
"Walker","2020-05-30","29","2571","0","75","3","1.5"
"Walker","2020-05-31","5","2576","0","75","3","1.5"
"Walker","2020-06-01","54","2630","6","81","4.6","2.3"
"Walker","2020-06-02","45","2675","3","84","5","2.8"
"Walker","2020-06-03","35","2710","2","86","5.1","3.2"
"Walker","2020-06-04","48","2758","0","86","4.4","3.2"
"Walker","2020-06-05","33","2791","0","86","3.4","3.2"
"Walker","2020-06-06","18","2809","0","86","3.4","3.2"
"Walker","2020-06-07","2","2811","0","86","3.4","3.2"
"Walker","2020-06-08","53","2864","3","89","2.6","3.6"
"Walker","2020-06-09","50","2914","3","92","2.5","3.7"
"Walker","2020-06-10","84","2998","4","96","2.3","3.7"
"Walker","2020-06-11","69","3067","8","104","4","4.2"
"Walker","2020-06-12","56","3123","2","106","4.5","3.9"
"Walker","2020-06-13","41","3164","3","109","5.6","4.5"
"Walker","2020-06-14","2","3166","0","109","5.6","4.5"
"Walker","2020-06-15","66","3232","7","116","6.3","4.4"
"Walker","2020-06-16","68","3300","8","124","7.1","4.8"
"Walker","2020-06-17","57","3357","4","128","7.4","4.9"
"Walker","2020-06-18","62","3419","4","132","6.7","5.3"
"Walker","2020-06-19","54","3473","2","134","6.7","5.6"
"Walker","2020-06-20","24","3497","1","135","6.2","5.9"
"Walker","2020-06-21","4","3501","0","135","6.2","5.9"
"Walker","2020-06-22","68","3569","2","137","5.1","5.7"
"Walker","2020-06-23","71","3640","2","139","3.9","5.5"
"Walker","2020-06-24","90","3730","3","142","3.3","5.4"
"Walker","2020-06-25","74","3804","7","149","3.8","5.2"
"Walker","2020-06-26","54","3858","4","153","4.3","5.5"
"Walker","2020-06-27","40","3898","3","156","4.8","5.5"
"Walker","2020-06-28","2","3900","0","156","4.8","5.5"
"Walker","2020-06-29","88","3988","7","163","5.5","5.3"
"Walker","2020-06-30","82","4070","4","167","5.8","4.8"
"Walker","2020-07-01","113","4183","5","172","5.9","4.6"
"Walker","2020-07-02","91","4274","3","175","5.1","4.4"
"Walker","2020-07-03","12","4286","1","176","5.2","4.8"
"Walker","2020-07-04","1","4287","0","176","4.1","4.5"
"Walker","2020-07-05","7","4294","1","177","6.2","5.5"
"Walker","2020-07-06","128","4422","3","180","5.4","5.4"
"Walker","2020-07-07","145","4567","8","188","5.5","5.6"
"Walker","2020-07-08","120","4687","8","196","5.8","5.9"
"Walker","2020-07-09","130","4817","7","203","6.1","5.6"
"Walker","2020-07-10","84","4901","4","207","5.6","5.4"
"Walker","2020-07-11","32","4933","4","211","7.4","5.7"
"Walker","2020-07-12","7","4940","0","211","5.3","5.7"
"Walker","2020-07-13","83","5023","6","217","6","5.7"
"Walker","2020-07-14","80","5103","4","221","5.9","5.7"
"Walker","2020-07-15","80","5183","7","228","6.2","6"
"Walker","2020-07-16","112","5295","12","240","7","6.5"
"Walker","2020-07-17","67","5362","6","246","7.6","6.6"
"Walker","2020-07-18","7","5369","0","246","5.8","6.6"
"Walker","2020-07-19","3","5372","0","246","5.8","5.6"
"Walker","2020-07-20","96","5468","5","251","5.5","5.8"
"Walker","2020-07-21","102","5570","9","260","6.1","6"
"Walker","2020-07-22","73","5643","8","268","6.4","6.3"
"Walker","2020-07-23","73","5716","9","277","6.6","6.8"
"Walker","2020-07-24","85","5801","8","285","6.7","7.1"
"Walker","2020-07-25","70","5871","2","287","7.1","6.4"
"Walker","2020-07-26","2","5873","1","288","14.2","10"
"Walker","2020-07-27","114","5987","11","299","14.9","10.2"
"Walker","2020-07-28","107","6094","9","308","14.8","10.4"
"Walker","2020-07-29","88","6182","10","318","14.9","10.6"
"Walker","2020-07-30","99","6281","4","322","13.7","10.1"
"Walker","2020-07-31","98","6379","5","327","13.1","9.9"
"Walker","2020-08-01","39","6418","3","330","13.8","10.4"
"Walker","2020-08-02","5","6423","0","330","6.6","10.4"
"Walker","2020-08-03","115","6538","11","341","6.6","10.7"
"Walker","2020-08-04","113","6651","4","345","5.9","10.4"
"Walker","2020-08-05","87","6738","10","355","5.9","10.4"
"Walker","2020-08-06","92","6830","7","362","6.4","10.1"
"Walker","2020-08-07","97","6927","5","367","6.4","9.7"
"Walker","2020-08-08","59","6986","3","370","6.1","9.9"
"Walker","2020-08-09","8","6994","0","370","6.1","6.3"
"Walker","2020-08-10","121","7115","11","381","6","6.3"
"Walker","2020-08-11","96","7211","9","390","6.8","6.4"
"Walker","2020-08-12","125","7336","6","396","5.9","5.9"
"Walker","2020-08-13","140","7476","4","400","5.2","5.8"
"Walker","2020-08-14","134","7610","8","408","5.3","5.9"
"Walker","2020-08-15","7","7617","1","409","6.6","6.3"
"Walker","2020-08-16","41","7658","1","410","7","6.5"
"Walker","2020-08-17","20","7678","1","411","6.4","6.2"
"Walker","2020-08-18","108","7786","8","419","6.1","6.5"
"Walker","2020-08-19","162","7948","6","425","6","5.9"
"Walker","2020-08-20","73","8021","7","432","6.9","6.1"
"Walker","2020-08-21","115","8136","4","436","6.6","5.9"
"Walker","2020-08-22","53","8189","3","439","5.3","6"
"Walker","2020-08-23","10","8199","0","439","5","6"
"Walker","2020-08-24","140","8339","14","453","5.7","6"
"Walker","2020-08-25","249","8588","33","486","6.5","6.3"
"Walker","2020-08-26","162","8750","22","508","7.9","6.9"
"Walker","2020-08-27","195","8945","13","521","7.5","7.2"
"Walker","2020-08-28","132","9077","7","528","7.8","7.2"
"Walker","2020-08-29","17","9094","1","529","7.8","6.6"
"Walker","2020-08-30","66","9160","3","532","8.5","6.7"
"Walker","2020-08-31","159","9319","11","543","8","6.9"
"Walker","2020-09-01","65","9384","0","543","6.1","6.3"
"Walker","2020-09-02","140","9524","4","547","4.6","6.3"
"Walker","2020-09-03","341","9865","20","567","4.5","6"
"Walker","2020-09-04","189","10054","10","577","4.5","6.1"
"Walker","2020-09-05","71","10125","1","578","3.8","5.8"
"Walker","2020-09-06","12","10137","2","580","5.6","7"
"Walker","2020-09-07","9","10146","2","582","7.8","7.9"
"Walker","2020-09-08","31","10177","5","587","10.1","8.1"
"Walker","2020-09-09","48","10225","9","596","12.3","8.5"
"Walker","2020-09-10","263","10488","46","642","14","9.2"
"Walker","2020-09-11","232","10720","21","663","14.5","9.5"
"Walker","2020-09-12","50","10770","4","667","15.5","9.7"
"Walker","2020-09-13","9","10779","1","668","14.7","10.1"
"Walker","2020-09-14","23","10802","1","669","12.1","9.9"
"Walker","2020-09-15","89","10891","2","671","10.1","10.1"
"Walker","2020-09-16","34","10925","0","671","7.5","9.9"
"Walker","2020-09-17","42","10967","2","673","5.6","9.8"
"Walker","2020-09-18","320","11287","43","716","6.3","10.4"
"Walker","2020-09-19","12","11299","2","718","7.5","11.5"
"Walker","2020-09-20","1","11300","0","718","5.9","10.3"
"Walker","2020-09-21","18","11318","0","718","5.3","8.7"
"Walker","2020-09-22","28","11346","1","719","5.5","7.8"
"Walker","2020-09-23","13","11359","1","720","6.6","7"
"Walker","2020-09-24","79","11438","7","727","7.2","6.4"
"Walker","2020-09-25","69","11507","2","729","5.7","6"
"Walker","2020-09-26","27","11534","2","731","4.3","5.9"
"Walker","2020-09-27","26","11560","2","733","5.4","5.7"
"Walker","2020-09-28","15","11575","1","734","6.4","5.9"
"Walker","2020-09-29","30","11605","3","737","7.3","6.4"
"Walker","2020-09-30","6","11611","0","737","6.2","6.4"
"Walker","2020-10-01","199","11810","8","745","5.5","6.4"
"Walker","2020-10-02","106","11916","3","748","5.5","5.6"
"Walker","2020-10-03","63","11979","1","749","4.7","4.5"
"Walker","2020-10-04","48","12027","0","749","3.6","4.5"
"Walker","2020-10-05","16","12043","1","750","3.5","5"
"Walker","2020-10-06","47","12090","2","752","2.7","5"
"Walker","2020-10-07","146","12236","6","758","3.3","4.8"
"Walker","2020-10-08","105","12341","2","760","3","4.3"
"Walker","2020-10-09","215","12556","11","771","3.3","4.4"
"Walker","2020-10-10","80","12636","2","773","3.4","4.1"
"Walker","2020-10-11","33","12669","0","773","3.4","3.5"
"Walker","2020-10-12","48","12717","10","783","5.5","4.5"
"Walker","2020-10-13","42","12759","1","784","5.3","4"
"Walker","2020-10-14","54","12813","2","786","5.2","4.2"
"Walker","2020-10-15","211","13024","20","806","6.3","4.6"
"Walker","2020-10-16","123","13147","19","825","7.8","5.5"
"Walker","2020-10-17","82","13229","5","830","8.3","5.9"
"Walker","2020-10-18","1","13230","0","830","8.3","5.9"
"Walker","2020-10-19","65","13295","1","831","5.5","5.5"
"Walker","2020-10-20","78","13373","17","848","8.3","6.8"
"Walker","2020-10-21","58","13431","6","854","9.2","7.2"
"Walker","2020-10-22","107","13538","14","868","9.8","8"
"Walker","2020-10-23","100","13638","3","871","8","7.9"
"Walker","2020-10-24","33","13671","2","873","8","8.1"
"Walker","2020-10-25","9","13680","0","873","8","8.1"
"Walker","2020-10-26","48","13728","5","878","9.2","7.4"
"Walker","2020-10-27","31","13759","5","883","8.4","8.4"
"Walker","2020-10-28","37","13796","3","886","8.1","8.7"
"Walker","2020-10-29","42","13838","7","893","8.6","9.2"
"Walker","2020-10-30","170","14008","11","904","9.1","8.6"
"Walker","2020-10-31","19","14027","3","907","10.5","9.2"
"Walker","2020-11-01","9","14036","1","908","12.1","10"
"Walker","2020-11-02","47","14083","5","913","12.1","10.7"
"Walker","2020-11-03","29","14112","5","918","12.3","10.4"
"Walker","2020-11-04","41","14153","11","929","15","11.5"
"Walker","2020-11-05","177","14330","8","937","13.2","10.9"
"Walker","2020-11-06","159","14489","17","954","13.8","11.5"
"Walker","2020-11-07","32","14521","1","955","12","11.3"
"Walker","2020-11-08","4","14525","2","957","17.6","14.8"
"Walker","2020-11-09","83","14608","6","963","17.1","14.6"
"Walker","2020-11-10","65","14673","8","971","16.4","14.3"
"Walker","2020-11-11","122","14795","7","978","13.4","14.2"
"Walker","2020-11-12","329","15124","39","1017","14.4","13.8"
"Walker","2020-11-13","272","15396","29","1046","14.4","14.1"
"Walker","2020-11-14","32","15428","8","1054","17.5","14.8"
"Walker","2020-11-15","32","15460","2","1056","11.3","14.4"
"Walker","2020-11-16","70","15530","12","1068","12.7","14.9"
"Walker","2020-11-17","112","15642","4","1072","11.5","13.9"
"Walker","2020-11-18","68","15710","9","1081","12.5","13"
"Walker","2020-11-19","279","15989","36","1117","12.7","13.6"
"Walker","2020-11-20","214","16203","29","1146","13.1","13.8"
"Walker","2020-11-21","17","16220","0","1146","9.5","13.5"
"Walker","2020-11-22","10","16230","2","1148","11.5","11.4"
"Walker","2020-11-23","72","16302","9","1157","10.8","11.8"
"Walker","2020-11-24","60","16362","14","1171","13.6","12.6"
"Walker","2020-11-25","34","16396","5","1176","13.9","13.2"
"Walker","2020-11-26","9","16405","0","1176","12","12.3"
"Walker","2020-11-27","25","16430","4","1180","12.4","12.7"
"Walker","2020-11-28","33","16463","13","1193","18","13.8"
"Walker","2020-11-29","13","16476","4","1197","19.5","15.5"
"Walker","2020-11-30","99","16575","9","1206","19","14.9"
"Walker","2020-12-01","53","16628","6","1212","17.3","15.5"
"Walker","2020-12-02","141","16769","15","1227","16.7","15.3"
"Walker","2020-12-03","209","16978","37","1264","19.3","15.6"
"Walker","2020-12-04","176","17154","30","1294","19.4","15.9"
"Walker","2020-12-05","40","17194","8","1302","16.7","17.3"
"Walker","2020-12-06","15","17209","4","1306","16.1","17.8"
"Walker","2020-12-07","84","17293","6","1312","15.8","17.4"
"Walker","2020-12-08","53","17346","9","1321","16.6","17"
"Walker","2020-12-09","110","17456","21","1342","17.8","17.3"
"Walker","2020-12-10","181","17637","23","1365","17.1","18.2"
"Walker","2020-12-11","147","17784","30","1395","17.6","18.5"
"Walker","2020-12-12","28","17812","8","1403","18.8","17.7"
"Walker","2020-12-13","19","17831","5","1408","18.7","17.4"
"Walker","2020-12-14","75","17906","8","1416","19.2","17.5"
"Walker","2020-12-15","74","17980","11","1427","18.9","17.8"
"Walker","2020-12-16","151","18131","26","1453","18.7","18.2"
"Walker","2020-12-17","238","18369","35","1488","19","18"
"Walker","2020-12-18","232","18601","36","1524","18.3","17.9"
"Walker","2020-12-19","35","18636","3","1527","15.4","17.1"
"Walker","2020-12-20","17","18653","5","1532","15.9","17.3"
"Walker","2020-12-21","67","18720","9","1541","16.2","17.7"
"Walker","2020-12-22","91","18811","13","1554","16.2","17.6"
"Walker","2020-12-23","194","19005","32","1586","16.1","17.4"
"Walker","2020-12-24","42","19047","17","1603","19.7","19.4"
"Walker","2020-12-25","0","19047","0","1603","17.5","17.9"
"Walker","2020-12-26","31","19078","11","1614","21.4","18.4"
"Walker","2020-12-27","27","19105","6","1620","20.3","18.1"
"Walker","2020-12-28","73","19178","9","1629","20.2","18.2"
"Walker","2020-12-29","96","19274","23","1652","21.6","18.9"
"Walker","2020-12-30","314","19588","39","1691","21","18.5"
"Walker","2020-12-31","259","19847","60","1751","18.5","19.1"
"Walker","2021-01-01","3","19850","0","1751","18.5","18"
"Walker","2021-01-02","12","19862","4","1755","18.2","19.8"
"Walker","2021-01-03","28","19890","8","1763","19.1","19.7"
"Walker","2021-01-04","74","19964","13","1776","19.9","20"
"Walker","2021-01-05","94","20058","18","1794","19.2","20.4"
"Walker","2021-01-06","176","20234","32","1826","20","20.5"
"Walker","2021-01-07","266","20500","36","1862","18.6","18.6"
"Walker","2021-01-08","225","20725","44","1906","21.4","20"
"Walker","2021-01-09","31","20756","3","1909","18","18.1"
"Walker","2021-01-10","25","20781","5","1914","16.8","18"
"Walker","2021-01-11","93","20874","21","1935","17.5","18.7"
"Walker","2021-01-12","88","20962","10","1945","16.4","17.8"
"Walker","2021-01-13","217","21179","26","1971","15.5","17.8"
"Walker","2021-01-14","202","21381","27","1998","15.5","17.1"
"Walker","2021-01-15","148","21529","13","2011","14","17.7"
"Walker","2021-01-16","29","21558","3","2014","14.1","16"
"Walker","2021-01-17","11","21569","0","2014","11.2","14"
"Walker","2021-01-18","75","21644","15","2029","10.8","14.2"
"Walker","2021-01-19","66","21710","5","2034","10.3","13.4"
"Walker","2021-01-20","69","21779","4","2038","9.4","12.5"
"Walker","2021-01-21","66","21845","8","2046","9.2","12.4"
"Walker","2021-01-22","198","22043","9","2055","8.6","11.3"
"Walker","2021-01-23","29","22072","2","2057","8.1","11.1"
"Walker","2021-01-24","7","22079","0","2057","8.1","9.7"
"Walker","2021-01-25","8","22087","0","2057","5.3","8.1"
"Walker","2021-01-26","0","22087","0","2057","4.2","7.2"
"Walker","2021-01-27","0","22087","0","2057","3.4","6.4"
"Walton","2020-02-01","0","0","0","0",".","."
"Walton","2020-02-02","0","0","0","0",".","."
"Walton","2020-02-03","0","0","0","0",".","."
"Walton","2020-02-04","0","0","0","0",".","."
"Walton","2020-02-05","0","0","0","0",".","."
"Walton","2020-02-06","0","0","0","0",".","."
"Walton","2020-02-07","0","0","0","0","0","."
"Walton","2020-02-08","0","0","0","0","0","."
"Walton","2020-02-09","0","0","0","0","0","."
"Walton","2020-02-10","0","0","0","0","0","."
"Walton","2020-02-11","0","0","0","0","0","."
"Walton","2020-02-12","0","0","0","0","0","."
"Walton","2020-02-13","0","0","0","0","0","."
"Walton","2020-02-14","0","0","0","0","0","0"
"Walton","2020-02-15","0","0","0","0","0","0"
"Walton","2020-02-16","0","0","0","0","0","0"
"Walton","2020-02-17","0","0","0","0","0","0"
"Walton","2020-02-18","0","0","0","0","0","0"
"Walton","2020-02-19","0","0","0","0","0","0"
"Walton","2020-02-20","0","0","0","0","0","0"
"Walton","2020-02-21","0","0","0","0","0","0"
"Walton","2020-02-22","0","0","0","0","0","0"
"Walton","2020-02-23","0","0","0","0","0","0"
"Walton","2020-02-24","0","0","0","0","0","0"
"Walton","2020-02-25","0","0","0","0","0","0"
"Walton","2020-02-26","0","0","0","0","0","0"
"Walton","2020-02-27","0","0","0","0","0","0"
"Walton","2020-02-28","0","0","0","0","0","0"
"Walton","2020-02-29","0","0","0","0","0","0"
"Walton","2020-03-01","0","0","0","0","0","0"
"Walton","2020-03-02","0","0","0","0","0","0"
"Walton","2020-03-03","0","0","0","0","0","0"
"Walton","2020-03-04","0","0","0","0","0","0"
"Walton","2020-03-05","0","0","0","0","0","0"
"Walton","2020-03-06","2","2","0","0","0","0"
"Walton","2020-03-07","0","2","0","0","0","0"
"Walton","2020-03-08","0","2","0","0","0","0"
"Walton","2020-03-09","0","2","0","0","0","0"
"Walton","2020-03-10","0","2","0","0","0","0"
"Walton","2020-03-11","2","4","0","0","0","0"
"Walton","2020-03-12","0","4","0","0","0","0"
"Walton","2020-03-13","7","11","0","0","0","0"
"Walton","2020-03-14","0","11","0","0","0","0"
"Walton","2020-03-15","3","14","0","0","0","0"
"Walton","2020-03-16","12","26","0","0","0","0"
"Walton","2020-03-17","24","50","0","0","0","0"
"Walton","2020-03-18","21","71","0","0","0","0"
"Walton","2020-03-19","17","88","3","3","2.5","1.3"
"Walton","2020-03-20","19","107","1","4","3.3","1.6"
"Walton","2020-03-21","8","115","0","4","3.3","1.6"
"Walton","2020-03-22","1","116","0","4","3.3","1.6"
"Walton","2020-03-23","24","140","7","11","7.4","3.7"
"Walton","2020-03-24","39","179","5","16","9.3","4.6"
"Walton","2020-03-25","29","208","4","20","11.2","5.6"
"Walton","2020-03-26","35","243","4","24","10.4","6.4"
"Walton","2020-03-27","18","261","3","27","12","7.6"
"Walton","2020-03-28","0","261","0","27","12","7.6"
"Walton","2020-03-29","2","263","0","27","12","7.6"
"Walton","2020-03-30","38","301","3","30","8.9","8.2"
"Walton","2020-03-31","13","314","1","31","8.2","8.7"
"Walton","2020-04-01","17","331","1","32","7.1","9.2"
"Walton","2020-04-02","35","366","1","33","5.9","8.1"
"Walton","2020-04-03","18","384","0","33","3.5","7.7"
"Walton","2020-04-04","4","388","2","35","10.6","11.3"
"Walton","2020-04-05","8","396","0","35","10.6","11.3"
"Walton","2020-04-06","29","425","5","40","12","10.4"
"Walton","2020-04-07","23","448","2","42","12.1","10.2"
"Walton","2020-04-08","35","483","3","45","12.5","9.8"
"Walton","2020-04-09","31","514","3","48","13.5","9.7"
"Walton","2020-04-10","28","542","3","51","15","9.2"
"Walton","2020-04-11","17","559","1","52","8.7","9.7"
"Walton","2020-04-12","3","562","0","52","8.7","9.7"
"Walton","2020-04-13","34","596","2","54","7.1","9.5"
"Walton","2020-04-14","55","651","8","62","7.9","10"
"Walton","2020-04-15","38","689","2","64","7.4","10"
"Walton","2020-04-16","61","750","2","66","6.5","10"
"Walton","2020-04-17","41","791","2","68","5.7","10.3"
"Walton","2020-04-18","34","825","0","68","4.8","6.8"
"Walton","2020-04-19","5","830","0","68","4.8","6.8"
"Walton","2020-04-20","65","895","3","71","4.7","5.9"
"Walton","2020-04-21","64","959","5","76","3.7","5.8"
"Walton","2020-04-22","78","1037","6","82","4","5.7"
"Walton","2020-04-23","72","1109","6","88","4.8","5.6"
"Walton","2020-04-24","82","1191","3","91","4.6","5.1"
"Walton","2020-04-25","21","1212","2","93","5.9","5.4"
"Walton","2020-04-26","13","1225","3","96","9.2","7"
"Walton","2020-04-27","90","1315","5","101","9.4","7"
"Walton","2020-04-28","76","1391","0","101","8.3","6"
"Walton","2020-04-29","64","1455","1","102","7.4","5.7"
"Walton","2020-04-30","68","1523","3","105","6.8","5.8"
"Walton","2020-05-01","87","1610","1","106","6.5","5.5"
"Walton","2020-05-02","42","1652","0","106","5.1","5.5"
"Walton","2020-05-03","24","1676","2","108","3","6.1"
"Walton","2020-05-04","63","1739","4","112","3.1","6.2"
"Walton","2020-05-05","72","1811","3","115","3.7","6"
"Walton","2020-05-06","68","1879","3","118","4.1","5.8"
"Walton","2020-05-07","60","1939","2","120","4","5.4"
"Walton","2020-05-08","64","2003","3","123","4.5","5.5"
"Walton","2020-05-09","31","2034","5","128","6.8","5.9"
"Walton","2020-05-10","22","2056","3","131","7.5","5.3"
"Walton","2020-05-11","75","2131","7","138","8","5.5"
"Walton","2020-05-12","84","2215","7","145","8.6","6.1"
"Walton","2020-05-13","68","2283","2","147","8.3","6.2"
"Walton","2020-05-14","118","2401","7","154","8.7","6.3"
"Walton","2020-05-15","83","2484","4","158","8.7","6.6"
"Walton","2020-05-16","48","2532","8","166","8.8","7.8"
"Walton","2020-05-17","26","2558","5","171","9.6","8.6"
"Walton","2020-05-18","86","2644","7","178","9.4","8.7"
"Walton","2020-05-19","99","2743","13","191","10.1","9.3"
"Walton","2020-05-20","85","2828","4","195","10.4","9.4"
"Walton","2020-05-21","60","2888","3","198","10.2","9.5"
"Walton","2020-05-22","119","3007","15","213","11.4","10"
"Walton","2020-05-23","33","3040","1","214","9.4","9.1"
"Walton","2020-05-24","34","3074","0","214","6.7","8.1"
"Walton","2020-05-25","23","3097","3","217","7.4","8.4"
"Walton","2020-05-26","81","3178","7","224","6.7","8.4"
"Walton","2020-05-27","102","3280","7","231","7","8.7"
"Walton","2020-05-28","101","3381","9","240","7.6","8.9"
"Walton","2020-05-29","54","3435","5","245","7.1","9.2"
"Walton","2020-05-30","37","3472","7","252","9.4","9.4"
"Walton","2020-05-31","26","3498","2","254","10.5","8.6"
"Walton","2020-06-01","88","3586","2","256","8.9","8.1"
"Walton","2020-06-02","85","3671","3","259","8.2","7.5"
"Walton","2020-06-03","101","3772","4","263","7.8","7.4"
"Walton","2020-06-04","79","3851","6","269","7.6","7.6"
"Walton","2020-06-05","71","3922","2","271","6.7","6.9"
"Walton","2020-06-06","50","3972","3","274","4.8","7.1"
"Walton","2020-06-07","28","4000","1","275","4.2","7.4"
"Walton","2020-06-08","98","4098","5","280","4.7","6.8"
"Walton","2020-06-09","79","4177","3","283","4.7","6.4"
"Walton","2020-06-10","92","4269","4","287","4.7","6.3"
"Walton","2020-06-11","88","4357","1","288","3.8","5.7"
"Walton","2020-06-12","74","4431","4","292","4.2","5.4"
"Walton","2020-06-13","27","4458","3","295","4.9","4.9"
"Walton","2020-06-14","35","4493","3","298","5.6","4.9"
"Walton","2020-06-15","116","4609","4","302","5.4","5"
"Walton","2020-06-16","109","4718","3","305","5.3","5"
"Walton","2020-06-17","121","4839","3","308","5","4.9"
"Walton","2020-06-18","88","4927","4","312","5.5","4.6"
"Walton","2020-06-19","108","5035","3","315","5.1","4.6"
"Walton","2020-06-20","69","5104","11","326","5.8","5.4"
"Walton","2020-06-21","32","5136","6","332","7.2","6.4"
"Walton","2020-06-22","179","5315","22","354","8.5","7"
"Walton","2020-06-23","136","5451","20","374","10.2","7.7"
"Walton","2020-06-24","148","5599","12","386","11","8"
"Walton","2020-06-25","181","5780","21","407","12","8.7"
"Walton","2020-06-26","157","5937","16","423","13.1","9.1"
"Walton","2020-06-27","95","6032","13","436","12.8","9.3"
"Walton","2020-06-28","58","6090","11","447","12.8","10"
"Walton","2020-06-29","211","6301","27","474","12.9","10.7"
"Walton","2020-06-30","236","6537","30","504","12.6","11.4"
"Walton","2020-07-01","209","6746","30","534","13.5","12.2"
"Walton","2020-07-02","188","6934","18","552","13.2","12.6"
"Walton","2020-07-03","117","7051","21","573","14.3","13.7"
"Walton","2020-07-04","35","7086","7","580","15.2","14"
"Walton","2020-07-05","51","7137","7","587","14.4","13.6"
"Walton","2020-07-06","249","7386","36","623","14.7","13.8"
"Walton","2020-07-07","179","7565","14","637","14","13.3"
"Walton","2020-07-08","199","7764","23","660","13.6","13.5"
"Walton","2020-07-09","337","8101","38","698","13.8","13.5"
"Walton","2020-07-10","214","8315","23","721","12.8","13.5"
"Walton","2020-07-11","127","8442","13","734","11.4","13.3"
"Walton","2020-07-12","81","8523","12","746","11.6","13"
"Walton","2020-07-13","150","8673","26","772","12","13.3"
"Walton","2020-07-14","142","8815","21","793","13","13.5"
"Walton","2020-07-15","145","8960","19","812","13.2","13.4"
"Walton","2020-07-16","125","9085","19","831","13.7","13.8"
"Walton","2020-07-17","156","9241","19","850","14","13.4"
"Walton","2020-07-18","110","9351","18","868","14.8","13.1"
"Walton","2020-07-19","71","9422","14","882","15.5","13.5"
"Walton","2020-07-20","257","9679","41","923","15.3","13.6"
"Walton","2020-07-21","192","9871","32","955","15.6","14.3"
"Walton","2020-07-22","138","10009","19","974","15.7","14.4"
"Walton","2020-07-23","189","10198","23","997","15.3","14.5"
"Walton","2020-07-24","239","10437","32","1029","15.4","14.7"
"Walton","2020-07-25","119","10556","23","1052","15.9","15.3"
"Walton","2020-07-26","42","10598","15","1067","18.1","16.8"
"Walton","2020-07-27","197","10795","36","1103","18.5","16.9"
"Walton","2020-07-28","166","10961","24","1127","18.2","16.9"
"Walton","2020-07-29","144","11105","22","1149","18.4","17"
"Walton","2020-07-30","133","11238","21","1170","18.9","17.1"
"Walton","2020-07-31","163","11401","19","1189","18.6","17"
"Walton","2020-08-01","84","11485","8","1197","17.2","16.5"
"Walton","2020-08-02","43","11528","8","1205","14.8","16.5"
"Walton","2020-08-03","157","11685","17","1222","13.7","16.1"
"Walton","2020-08-04","194","11879","25","1247","13.5","15.8"
"Walton","2020-08-05","134","12013","21","1268","13.6","16"
"Walton","2020-08-06","159","12172","24","1292","13.5","16.2"
"Walton","2020-08-07","171","12343","22","1314","13.6","16.1"
"Walton","2020-08-08","64","12407","9","1323","14.3","15.8"
"Walton","2020-08-09","45","12452","6","1329","13.5","14.2"
"Walton","2020-08-10","191","12643","19","1348","13.4","13.6"
"Walton","2020-08-11","195","12838","18","1366","12.9","13.2"
"Walton","2020-08-12","155","12993","18","1384","12.3","12.9"
"Walton","2020-08-13","199","13192","20","1404","11.6","12.5"
"Walton","2020-08-14","214","13406","24","1428","11.4","12.5"
"Walton","2020-08-15","92","13498","7","1435","10.4","12.4"
"Walton","2020-08-16","32","13530","8","1443","12.1","12.8"
"Walton","2020-08-17","163","13693","12","1455","11.7","12.6"
"Walton","2020-08-18","154","13847","19","1474","12.2","12.5"
"Walton","2020-08-19","143","13990","15","1489","12","12.2"
"Walton","2020-08-20","163","14153","12","1501","11.6","11.6"
"Walton","2020-08-21","212","14365","16","1517","11.1","11.2"
"Walton","2020-08-22","96","14461","11","1528","11.7","11"
"Walton","2020-08-23","32","14493","5","1533","10.3","11.2"
"Walton","2020-08-24","219","14712","19","1552","10.5","11.1"
"Walton","2020-08-25","153","14865","15","1567","10.1","11.2"
"Walton","2020-08-26","158","15023","15","1582","10","11"
"Walton","2020-08-27","141","15164","12","1594","10.2","10.9"
"Walton","2020-08-28","205","15369","22","1616","10.6","10.9"
"Walton","2020-08-29","98","15467","12","1628","10.7","11.2"
"Walton","2020-08-30","47","15514","4","1632","9.7","10"
"Walton","2020-08-31","187","15701","16","1648","9.7","10.1"
"Walton","2020-09-01","134","15835","14","1662","9.8","10"
"Walton","2020-09-02","142","15977","17","1679","10.1","10.1"
"Walton","2020-09-03","127","16104","12","1691","10.3","10.2"
"Walton","2020-09-04","146","16250","14","1705","10.1","10.4"
"Walton","2020-09-05","75","16325","5","1710","9.3","10"
"Walton","2020-09-06","27","16352","3","1713","9.7","9.7"
"Walton","2020-09-07","46","16398","5","1718","10","9.9"
"Walton","2020-09-08","121","16519","10","1728","9.7","9.7"
"Walton","2020-09-09","139","16658","10","1738","9","9.6"
"Walton","2020-09-10","113","16771","9","1747","8.8","9.5"
"Walton","2020-09-11","148","16919","14","1761","8.8","9.4"
"Walton","2020-09-12","39","16958","7","1768","10.4","9.9"
"Walton","2020-09-13","36","16994","3","1771","10","9.8"
"Walton","2020-09-14","145","17139","5","1776","8.9","9.5"
"Walton","2020-09-15","153","17292","12","1788","8.9","9.3"
"Walton","2020-09-16","98","17390","8","1796","9","9"
"Walton","2020-09-17","122","17512","10","1806","9.1","8.9"
"Walton","2020-09-18","148","17660","10","1816","8.7","8.7"
"Walton","2020-09-19","60","17720","6","1822","7.5","9"
"Walton","2020-09-20","34","17754","8","1830","9.7","9.9"
"Walton","2020-09-21","166","17920","9","1839","10","9.5"
"Walton","2020-09-22","105","18025","9","1848","10.1","9.5"
"Walton","2020-09-23","111","18136","7","1855","9.8","9.4"
"Walton","2020-09-24","101","18237","9","1864","9.9","9.5"
"Walton","2020-09-25","166","18403","16","1880","10.3","9.5"
"Walton","2020-09-26","46","18449","3","1883","9.8","8.7"
"Walton","2020-09-27","36","18485","4","1887","8.1","8.9"
"Walton","2020-09-28","131","18616","9","1896","8.3","9.1"
"Walton","2020-09-29","111","18727","3","1899","7.4","8.8"
"Walton","2020-09-30","136","18863","7","1906","7.3","8.5"
"Walton","2020-10-01","94","18957","5","1911","6.8","8.3"
"Walton","2020-10-02","140","19097","10","1921","6.4","8.4"
"Walton","2020-10-03","91","19188","5","1926","6.3","8"
"Walton","2020-10-04","43","19231","6","1932","6.7","7.4"
"Walton","2020-10-05","195","19426","20","1952","7.1","7.7"
"Walton","2020-10-06","152","19578","16","1968","8.3","7.9"
"Walton","2020-10-07","169","19747","8","1976","8.2","7.7"
"Walton","2020-10-08","161","19908","15","1991","8.8","7.8"
"Walton","2020-10-09","177","20085","13","2004","8.8","7.6"
"Walton","2020-10-10","85","20170","9","2013","9.5","7.9"
"Walton","2020-10-11","46","20216","4","2017","8.8","7.7"
"Walton","2020-10-12","116","20332","4","2021","7.8","7.5"
"Walton","2020-10-13","177","20509","19","2040","7.8","8.1"
"Walton","2020-10-14","141","20650","12","2052","8.4","8.3"
"Walton","2020-10-15","143","20793","13","2065","8.3","8.6"
"Walton","2020-10-16","148","20941","14","2079","8.6","8.7"
"Walton","2020-10-17","97","21038","8","2087","8.3","8.9"
"Walton","2020-10-18","29","21067","3","2090","8.5","8.7"
"Walton","2020-10-19","176","21243","11","2101","8.9","8.4"
"Walton","2020-10-20","119","21362","10","2111","8.6","8.2"
"Walton","2020-10-21","177","21539","13","2124","8.4","8.4"
"Walton","2020-10-22","146","21685","8","2132","7.9","8.1"
"Walton","2020-10-23","175","21860","15","2147","7.8","8.2"
"Walton","2020-10-24","58","21918","11","2158","9.3","8.8"
"Walton","2020-10-25","38","21956","5","2163","9.7","9.1"
"Walton","2020-10-26","192","22148","15","2178","10","9.5"
"Walton","2020-10-27","146","22294","10","2188","9.7","9.2"
"Walton","2020-10-28","133","22427","11","2199","9.9","9.2"
"Walton","2020-10-29","108","22535","11","2210","10.5","9.2"
"Walton","2020-10-30","156","22691","11","2221","10.3","9.1"
"Walton","2020-10-31","99","22790","7","2228","8.6","9"
"Walton","2020-11-01","61","22851","9","2237","8.9","9.3"
"Walton","2020-11-02","203","23054","18","2255","9","9.5"
"Walton","2020-11-03","122","23176","10","2265","9.2","9.5"
"Walton","2020-11-04","136","23312","16","2281","9.7","9.8"
"Walton","2020-11-05","145","23457","6","2287","8.8","9.7"
"Walton","2020-11-06","215","23672","15","2302","8.8","9.6"
"Walton","2020-11-07","78","23750","13","2315","10.2","9.4"
"Walton","2020-11-08","97","23847","8","2323","9.3","9.1"
"Walton","2020-11-09","191","24038","17","2340","9.3","9.1"
"Walton","2020-11-10","242","24280","17","2357","9.1","9.2"
"Walton","2020-11-11","158","24438","15","2372","8.8","9.2"
"Walton","2020-11-12","168","24606","14","2386","9.4","9.1"
"Walton","2020-11-13","213","24819","21","2407","9.8","9.3"
"Walton","2020-11-14","137","24956","19","2426","9.4","9.8"
"Walton","2020-11-15","110","25066","7","2433","9.1","9.2"
"Walton","2020-11-16","230","25296","22","2455","9.2","9.2"
"Walton","2020-11-17","199","25495","24","2479","9.9","9.5"
"Walton","2020-11-18","265","25760","28","2507","10.1","9.4"
"Walton","2020-11-19","250","26010","22","2529","10.2","9.8"
"Walton","2020-11-20","257","26267","31","2560","10.5","10.1"
"Walton","2020-11-21","163","26430","19","2579","10.2","9.8"
"Walton","2020-11-22","93","26523","12","2591","11.1","10.1"
"Walton","2020-11-23","247","26770","34","2625","11.7","10.5"
"Walton","2020-11-24","196","26966","39","2664","12.8","11.4"
"Walton","2020-11-25","267","27233","53","2717","14.1","12.1"
"Walton","2020-11-26","46","27279","7","2724","15.1","12.6"
"Walton","2020-11-27","222","27501","35","2759","15.6","13"
"Walton","2020-11-28","126","27627","35","2794","17.9","14"
"Walton","2020-11-29","108","27735","26","2820","19.5","15.3"
"Walton","2020-11-30","319","28054","41","2861","19.3","15.5"
"Walton","2020-12-01","245","28299","54","2915","19.7","16.2"
"Walton","2020-12-02","364","28663","69","2984","19.5","16.8"
"Walton","2020-12-03","317","28980","62","3046","20.1","17.6"
"Walton","2020-12-04","355","29335","47","3093","19.8","17.7"
"Walton","2020-12-05","144","29479","29","3122","18.7","18.3"
"Walton","2020-12-06","144","29623","28","3150","18","18.8"
"Walton","2020-12-07","306","29929","47","3197","18.4","18.9"
"Walton","2020-12-08","308","30237","56","3253","17.8","18.7"
"Walton","2020-12-09","297","30534","48","3301","17.4","18.5"
"Walton","2020-12-10","341","30875","63","3364","17.3","18.7"
"Walton","2020-12-11","454","31329","63","3427","17.4","18.6"
"Walton","2020-12-12","271","31600","51","3478","17.2","17.9"
"Walton","2020-12-13","103","31703","30","3508","18.6","18.3"
"Walton","2020-12-14","411","32114","74","3582","18.9","18.7"
"Walton","2020-12-15","307","32421","45","3627","18.4","18.1"
"Walton","2020-12-16","344","32765","84","3711","19.6","18.5"
"Walton","2020-12-17","338","33103","91","3802","20.8","19.1"
"Walton","2020-12-18","375","33478","73","3875","21.6","19.5"
"Walton","2020-12-19","203","33681","44","3919","22","19.6"
"Walton","2020-12-20","134","33815","33","3952","21.4","20"
"Walton","2020-12-21","411","34226","127","4079","23.2","21.1"
"Walton","2020-12-22","411","34637","137","4216","25.9","22.2"
"Walton","2020-12-23","433","35070","126","4342","26.6","23.1"
"Walton","2020-12-24","408","35478","80","4422","25.5","23.2"
"Walton","2020-12-25","34","35512","15","4437","29.1","25.3"
"Walton","2020-12-26","161","35673","50","4487","30.4","26.2"
"Walton","2020-12-27","155","35828","63","4550","32.7","27"
"Walton","2020-12-28","450","36278","142","4692","32.8","28"
"Walton","2020-12-29","369","36647","142","4834","33.5","29.7"
"Walton","2020-12-30","419","37066","151","4985","34.5","30.5"
"Walton","2020-12-31","398","37464","126","5111","36.2","30.9"
"Walton","2021-01-01","97","37561","36","5147","35.2","32.1"
"Walton","2021-01-02","136","37697","41","5188","35.1","32.7"
"Walton","2021-01-03","200","37897","31","5219","31.5","32.1"
"Walton","2021-01-04","409","38306","113","5332","30.9","31.9"
"Walton","2021-01-05","447","38753","138","5470","29.9","31.7"
"Walton","2021-01-06","415","39168","126","5596","29","31.8"
"Walton","2021-01-07","516","39684","130","5726","28.1","32.2"
"Walton","2021-01-08","410","40094","95","5821","26.1","30.7"
"Walton","2021-01-09","235","40329","61","5882","25.5","30.3"
"Walton","2021-01-10","124","40453","41","5923","28","29.8"
"Walton","2021-01-11","386","40839","84","6007","27.2","29.1"
"Walton","2021-01-12","410","41249","105","6112","26.4","28.1"
"Walton","2021-01-13","422","41671","111","6223","25.9","27.5"
"Walton","2021-01-14","341","42012","86","6309","25.9","27"
"Walton","2021-01-15","431","42443","100","6409","25.9","26"
"Walton","2021-01-16","227","42670","37","6446","24.5","25"
"Walton","2021-01-17","130","42800","40","6486","24.2","26.1"
"Walton","2021-01-18","300","43100","81","6567","24.9","26.1"
"Walton","2021-01-19","318","43418","64","6631","24.1","25.3"
"Walton","2021-01-20","270","43688","56","6687","23.3","24.6"
"Walton","2021-01-21","320","44008","59","6746","22.4","24.1"
"Walton","2021-01-22","312","44320","42","6788","21","23.4"
"Walton","2021-01-23","190","44510","36","6824","21.4","22.9"
"Walton","2021-01-24","87","44597","22","6846","20.6","22.4"
"Walton","2021-01-25","104","44701","22","6868","19.7","22.3"
"Walton","2021-01-26","8","44709","1","6869","18.6","21.4"
"Walton","2021-01-27","0","44709","0","6869","15.7","19.5"
"Ware","2020-02-01","0","0","0","0",".","."
"Ware","2020-02-02","0","0","0","0",".","."
"Ware","2020-02-03","0","0","0","0",".","."
"Ware","2020-02-04","0","0","0","0",".","."
"Ware","2020-02-05","0","0","0","0",".","."
"Ware","2020-02-06","0","0","0","0",".","."
"Ware","2020-02-07","0","0","0","0","0","."
"Ware","2020-02-08","0","0","0","0","0","."
"Ware","2020-02-09","0","0","0","0","0","."
"Ware","2020-02-10","0","0","0","0","0","."
"Ware","2020-02-11","0","0","0","0","0","."
"Ware","2020-02-12","0","0","0","0","0","."
"Ware","2020-02-13","0","0","0","0","0","."
"Ware","2020-02-14","0","0","0","0","0","0"
"Ware","2020-02-15","0","0","0","0","0","0"
"Ware","2020-02-16","0","0","0","0","0","0"
"Ware","2020-02-17","0","0","0","0","0","0"
"Ware","2020-02-18","0","0","0","0","0","0"
"Ware","2020-02-19","0","0","0","0","0","0"
"Ware","2020-02-20","0","0","0","0","0","0"
"Ware","2020-02-21","0","0","0","0","0","0"
"Ware","2020-02-22","0","0","0","0","0","0"
"Ware","2020-02-23","0","0","0","0","0","0"
"Ware","2020-02-24","0","0","0","0","0","0"
"Ware","2020-02-25","0","0","0","0","0","0"
"Ware","2020-02-26","0","0","0","0","0","0"
"Ware","2020-02-27","0","0","0","0","0","0"
"Ware","2020-02-28","0","0","0","0","0","0"
"Ware","2020-02-29","0","0","0","0","0","0"
"Ware","2020-03-01","0","0","0","0","0","0"
"Ware","2020-03-02","0","0","0","0","0","0"
"Ware","2020-03-03","0","0","0","0","0","0"
"Ware","2020-03-04","0","0","0","0","0","0"
"Ware","2020-03-05","0","0","0","0","0","0"
"Ware","2020-03-06","0","0","0","0","0","0"
"Ware","2020-03-07","0","0","0","0","0","0"
"Ware","2020-03-08","0","0","0","0","0","0"
"Ware","2020-03-09","0","0","0","0","0","0"
"Ware","2020-03-10","0","0","0","0","0","0"
"Ware","2020-03-11","1","1","0","0","0","0"
"Ware","2020-03-12","0","1","0","0","0","0"
"Ware","2020-03-13","19","20","0","0","0","0"
"Ware","2020-03-14","1","21","0","0","0","0"
"Ware","2020-03-15","1","22","0","0","0","0"
"Ware","2020-03-16","1","23","0","0","0","0"
"Ware","2020-03-17","7","30","0","0","0","0"
"Ware","2020-03-18","10","40","2","2","2.9","1.4"
"Ware","2020-03-19","8","48","0","2","2.9","1.4"
"Ware","2020-03-20","24","72","0","2","2.9","1.4"
"Ware","2020-03-21","5","77","0","2","2.9","1.4"
"Ware","2020-03-22","3","80","0","2","2.9","1.4"
"Ware","2020-03-23","39","119","1","3","3.2","1.6"
"Ware","2020-03-24","40","159","4","7","4.7","2.3"
"Ware","2020-03-25","43","202","0","7","1.8","2.3"
"Ware","2020-03-26","38","240","3","10","2.9","2.9"
"Ware","2020-03-27","27","267","4","14","5","3.9"
"Ware","2020-03-28","2","269","0","14","5","3.9"
"Ware","2020-03-29","0","269","0","14","5","3.9"
"Ware","2020-03-30","43","312","8","22","7.3","5.3"
"Ware","2020-03-31","39","351","8","30","8.8","6.7"
"Ware","2020-04-01","33","384","7","37","11.9","6.8"
"Ware","2020-04-02","49","433","7","44","12.8","7.8"
"Ware","2020-04-03","50","483","7","51","12.7","8.8"
"Ware","2020-04-04","14","497","1","52","13.7","9.4"
"Ware","2020-04-05","0","497","0","52","13.7","9.4"
"Ware","2020-04-06","53","550","9","61","13.4","10.4"
"Ware","2020-04-07","79","629","9","70","12.1","10.5"
"Ware","2020-04-08","60","689","15","85","12.7","12.3"
"Ware","2020-04-09","51","740","10","95","13.4","13.1"
"Ware","2020-04-10","51","791","9","104","14","13.3"
"Ware","2020-04-11","18","809","4","108","16.1","14.9"
"Ware","2020-04-12","4","813","2","110","23.3","18.5"
"Ware","2020-04-13","22","835","2","112","22.1","17.8"
"Ware","2020-04-14","27","862","1","113","21","16.6"
"Ware","2020-04-15","28","890","7","120","21","16.9"
"Ware","2020-04-16","56","946","7","127","20","16.7"
"Ware","2020-04-17","41","987","4","131","18.9","16.4"
"Ware","2020-04-18","17","1004","3","134","18.2","17.2"
"Ware","2020-04-19","14","1018","4","138","15.2","19.2"
"Ware","2020-04-20","42","1060","11","149","17.6","19.9"
"Ware","2020-04-21","36","1096","1","150","17.5","19.3"
"Ware","2020-04-22","23","1119","2","152","15.2","18.1"
"Ware","2020-04-23","19","1138","3","155","15.6","17.8"
"Ware","2020-04-24","26","1164","2","157","15.3","17.1"
"Ware","2020-04-25","15","1179","2","159","14.7","16.5"
"Ware","2020-04-26","7","1186","0","159","10.6","12.9"
"Ware","2020-04-27","22","1208","1","160","7.5","12.6"
"Ware","2020-04-28","44","1252","9","169","10.1","13.8"
"Ware","2020-04-29","30","1282","2","171","9.8","12.5"
"Ware","2020-04-30","36","1318","6","177","9.9","12.8"
"Ware","2020-05-01","18","1336","0","177","8.8","12.1"
"Ware","2020-05-02","12","1348","1","178","8.1","11.4"
"Ware","2020-05-03","9","1357","2","180","11.3","11"
"Ware","2020-05-04","143","1500","6","186","11.2","9.4"
"Ware","2020-05-05","125","1625","9","195","9.3","9.7"
"Ware","2020-05-06","112","1737","2","197","8.6","9.2"
"Ware","2020-05-07","90","1827","9","206","7.7","8.8"
"Ware","2020-05-08","19","1846","2","208","9.2","9"
"Ware","2020-05-09","6","1852","1","209","10.4","9.2"
"Ware","2020-05-10","2","1854","0","209","7.2","9.2"
"Ware","2020-05-11","122","1976","14","223","8.2","9.7"
"Ware","2020-05-12","117","2093","4","227","7.7","8.5"
"Ware","2020-05-13","49","2142","2","229","8","8.3"
"Ware","2020-05-14","13","2155","1","230","7.7","7.7"
"Ware","2020-05-15","27","2182","5","235","8.8","9"
"Ware","2020-05-16","15","2197","1","236","7.4","8.9"
"Ware","2020-05-17","10","2207","0","236","7.4","7.3"
"Ware","2020-05-18","60","2267","6","242","7.2","7.7"
"Ware","2020-05-19","86","2353","5","247","7.5","7.6"
"Ware","2020-05-20","45","2398","3","250","7.9","8"
"Ware","2020-05-21","128","2526","9","259","7.8","7.8"
"Ware","2020-05-22","96","2622","1","260","5.3","7.1"
"Ware","2020-05-23","11","2633","0","260","4.4","5.9"
"Ware","2020-05-24","54","2687","3","263","5.2","6.3"
"Ware","2020-05-25","19","2706","2","265","5.2","6.2"
"Ware","2020-05-26","203","2909","12","277","5.2","6.4"
"Ware","2020-05-27","129","3038","5","282","4.8","6.4"
"Ware","2020-05-28","227","3265","4","286","4.1","6"
"Ware","2020-05-29","53","3318","2","288","4.5","4.9"
"Ware","2020-05-30","2","3320","1","289","11.6","8"
"Ware","2020-05-31","1","3321","0","289","10.8","8"
"Ware","2020-06-01","71","3392","2","291","9.7","7.5"
"Ware","2020-06-02","57","3449","5","296","10.1","7.7"
"Ware","2020-06-03","153","3602","4","300","10","7.4"
"Ware","2020-06-04","45","3647","0","300","9.7","6.9"
"Ware","2020-06-05","120","3767","4","304","9.6","7.1"
"Ware","2020-06-06","13","3780","2","306","4.7","8.2"
"Ware","2020-06-07","10","3790","0","306","4.7","7.8"
"Ware","2020-06-08","196","3986","19","325","5.7","7.7"
"Ware","2020-06-09","211","4197","6","331","4.8","7.5"
"Ware","2020-06-10","157","4354","0","331","4.5","7.2"
"Ware","2020-06-11","146","4500","7","338","5.1","7.4"
"Ware","2020-06-12","101","4601","6","344","5.5","7.6"
"Ware","2020-06-13","9","4610","2","346","6.5","5.6"
"Ware","2020-06-14","5","4615","1","347","9.4","7"
"Ware","2020-06-15","134","4749","17","364","9.8","7.7"
"Ware","2020-06-16","149","4898","14","378","10.7","7.8"
"Ware","2020-06-17","139","5037","19","397","12.7","8.6"
"Ware","2020-06-18","178","5215","12","409","13","9.1"
"Ware","2020-06-19","155","5370","16","425","13.6","9.5"
"Ware","2020-06-20","60","5430","3","428","11.1","8.8"
"Ware","2020-06-21","9","5439","2","430","11.4","10.4"
"Ware","2020-06-22","129","5568","27","457","12.6","11.2"
"Ware","2020-06-23","248","5816","36","493","13.3","12"
"Ware","2020-06-24","90","5906","10","503","13","12.8"
"Ware","2020-06-25","333","6239","24","527","13","13"
"Ware","2020-06-26","197","6436","6","533","12","12.8"
"Ware","2020-06-27","22","6458","4","537","13.9","12.5"
"Ware","2020-06-28","18","6476","4","541","13.9","12.7"
"Ware","2020-06-29","220","6696","22","563","12.3","12.5"
"Ware","2020-06-30","227","6923","23","586","11.7","12.5"
"Ware","2020-07-01","140","7063","10","596","11.1","12.1"
"Ware","2020-07-02","307","7370","24","620","11.2","12.1"
"Ware","2020-07-03","112","7482","11","631","12.2","12.1"
"Ware","2020-07-04","35","7517","7","638","12.4","13.2"
"Ware","2020-07-05","14","7531","6","644","15.4","14.6"
"Ware","2020-07-06","111","7642","17","661","16.2","14.2"
"Ware","2020-07-07","178","7820","39","700","17.8","14.8"
"Ware","2020-07-08","80","7900","10","710","18.6","14.9"
"Ware","2020-07-09","244","8144","23","733","18.8","15"
"Ware","2020-07-10","60","8204","12","745","20.3","16.2"
"Ware","2020-07-11","40","8244","10","755","21","16.7"
"Ware","2020-07-12","18","8262","3","758","17.3","16.3"
"Ware","2020-07-13","181","8443","18","776","16.5","16.3"
"Ware","2020-07-14","46","8489","9","785","16.2","17"
"Ware","2020-07-15","153","8642","23","808","16.5","17.6"
"Ware","2020-07-16","215","8857","26","834","16.9","17.9"
"Ware","2020-07-17","71","8928","8","842","15.7","18"
"Ware","2020-07-18","30","8958","5","847","14.5","17.7"
"Ware","2020-07-19","10","8968","2","849","14.9","16.1"
"Ware","2020-07-20","134","9102","14","863","15","15.8"
"Ware","2020-07-21","80","9182","17","880","15.3","15.7"
"Ware","2020-07-22","167","9349","14","894","14.3","15.4"
"Ware","2020-07-23","132","9481","15","909","14.2","15.5"
"Ware","2020-07-24","50","9531","5","914","14","14.8"
"Ware","2020-07-25","19","9550","1","915","12.4","13.4"
"Ware","2020-07-26","22","9572","2","917","10.8","12.9"
"Ware","2020-07-27","280","9852","11","928","9.9","12.5"
"Ware","2020-07-28","178","10030","13","941","7.9","11.6"
"Ware","2020-07-29","110","10140","6","947","7.5","10.9"
"Ware","2020-07-30","155","10295","5","952","6.3","10.3"
"Ware","2020-07-31","44","10339","1","953","5.2","9.6"
"Ware","2020-08-01","62","10401","16","969","8.2","10.3"
"Ware","2020-08-02","24","10425","4","973","9.2","10"
"Ware","2020-08-03","279","10704","11","984","9.2","9.6"
"Ware","2020-08-04","109","10813","12","996","9.8","8.8"
"Ware","2020-08-05","151","10964","9","1005","9.8","8.7"
"Ware","2020-08-06","185","11149","16","1021","10.6","8.5"
"Ware","2020-08-07","101","11250","14","1035","12.3","8.7"
"Ware","2020-08-08","12","11262","5","1040","14.5","11.3"
"Ware","2020-08-09","24","11286","14","1054","20.5","14.9"
"Ware","2020-08-10","283","11569","5","1059","20.2","14.7"
"Ware","2020-08-11","114","11683","10","1069","19.9","14.8"
"Ware","2020-08-12","127","11810","9","1078","20","14.9"
"Ware","2020-08-13","81","11891","5","1083","19.7","15.1"
"Ware","2020-08-14","46","11937","16","1099","22.7","17.5"
"Ware","2020-08-15","20","11957","5","1104","20.3","17.4"
"Ware","2020-08-16","8","11965","1","1105","13.7","17.1"
"Ware","2020-08-17","259","12224","12","1117","14.1","17.2"
"Ware","2020-08-18","137","12361","11","1128","14","16.9"
"Ware","2020-08-19","130","12491","7","1135","13.8","16.9"
"Ware","2020-08-20","73","12564","5","1140","13.9","16.8"
"Ware","2020-08-21","40","12604","7","1147","11.4","17"
"Ware","2020-08-22","19","12623","1","1148","8.6","14.4"
"Ware","2020-08-23","11","12634","0","1148","6.8","10.3"
"Ware","2020-08-24","274","12908","5","1153","6.4","10.3"
"Ware","2020-08-25","131","13039","5","1158","5.8","9.9"
"Ware","2020-08-26","115","13154","9","1167","6.2","10"
"Ware","2020-08-27","84","13238","4","1171","5.9","9.9"
"Ware","2020-08-28","42","13280","4","1175","4.7","8.1"
"Ware","2020-08-29","30","13310","2","1177","4.9","6.8"
"Ware","2020-08-30","81","13391","5","1182","5.8","6.3"
"Ware","2020-08-31","302","13693","8","1190","5.9","6.2"
"Ware","2020-09-01","274","13967","19","1209","6.4","6.1"
"Ware","2020-09-02","168","14135","17","1226","6.7","6.4"
"Ware","2020-09-03","69","14204","2","1228","6.4","6.1"
"Ware","2020-09-04","135","14339","5","1233","5.6","5.2"
"Ware","2020-09-05","22","14361","2","1235","5.9","5.4"
"Ware","2020-09-06","20","14381","2","1237","6.5","6.1"
"Ware","2020-09-07","200","14581","6","1243","6.5","6.2"
"Ware","2020-09-08","155","14736","8","1251","6.3","6.3"
"Ware","2020-09-09","210","14946","13","1264","5.7","6.2"
"Ware","2020-09-10","208","15154","12","1276","6.1","6.3"
"Ware","2020-09-11","71","15225","4","1280","6.4","6"
"Ware","2020-09-12","12","15237","1","1281","6.3","6.1"
"Ware","2020-09-13","49","15286","27","1308","12.7","9.6"
"Ware","2020-09-14","282","15568","9","1317","12.8","9.7"
"Ware","2020-09-15","129","15697","6","1323","12.7","9.5"
"Ware","2020-09-16","229","15926","5","1328","12.1","8.9"
"Ware","2020-09-17","138","16064","4","1332","11.7","8.9"
"Ware","2020-09-18","41","16105","1","1333","11.3","8.8"
"Ware","2020-09-19","15","16120","0","1333","10.1","8.2"
"Ware","2020-09-20","21","16141","0","1333","2.2","7.5"
"Ware","2020-09-21","268","16409","3","1336","1.9","7.3"
"Ware","2020-09-22","148","16557","3","1339","1.5","7.1"
"Ware","2020-09-23","117","16674","8","1347","2.2","7.2"
"Ware","2020-09-24","48","16722","3","1350","2.7","7.2"
"Ware","2020-09-25","33","16755","2","1352","3.2","7.2"
"Ware","2020-09-26","27","16782","1","1353","3.7","6.9"
"Ware","2020-09-27","20","16802","0","1353","3.7","3"
"Ware","2020-09-28","274","17076","6","1359","3.9","2.9"
"Ware","2020-09-29","176","17252","5","1364","4","2.8"
"Ware","2020-09-30","87","17339","2","1366","3.3","2.8"
"Ware","2020-10-01","79","17418","1","1367","2.6","2.6"
"Ware","2020-10-02","52","17470","2","1369","2.3","2.7"
"Ware","2020-10-03","35","17505","0","1369","1.8","2.7"
"Ware","2020-10-04","16","17521","0","1369","1.8","2.7"
"Ware","2020-10-05","280","17801","37","1406","3.4","3.6"
"Ware","2020-10-06","178","17979","34","1440","5.7","4.8"
"Ware","2020-10-07","115","18094","0","1440","5.3","4.3"
"Ware","2020-10-08","153","18247","8","1448","5.9","4.3"
"Ware","2020-10-09","57","18304","1","1449","5.6","4"
"Ware","2020-10-10","21","18325","0","1449","5.6","3.7"
"Ware","2020-10-11","82","18407","7","1456","6.8","4.3"
"Ware","2020-10-12","385","18792","62","1518","7.2","5.3"
"Ware","2020-10-13","193","18985","10","1528","5.3","5.5"
"Ware","2020-10-14","170","19155","13","1541","6.4","5.8"
"Ware","2020-10-15","97","19252","2","1543","5.9","5.9"
"Ware","2020-10-16","58","19310","15","1558","9.3","7.5"
"Ware","2020-10-17","13","19323","1","1559","10.4","8"
"Ware","2020-10-18","12","19335","0","1559","9.2","8"
"Ware","2020-10-19","339","19674","12","1571","7.4","7.3"
"Ware","2020-10-20","178","19852","16","1587","8","6.6"
"Ware","2020-10-21","117","19969","2","1589","7.1","6.7"
"Ware","2020-10-22","90","20059","4","1593","7.5","6.7"
"Ware","2020-10-23","83","20142","4","1597","4.5","6.9"
"Ware","2020-10-24","29","20171","2","1599","4.3","7.4"
"Ware","2020-10-25","15","20186","4","1603","8.2","8.7"
"Ware","2020-10-26","358","20544","10","1613","8","7.7"
"Ware","2020-10-27","117","20661","9","1622","7.9","7.9"
"Ware","2020-10-28","182","20843","8","1630","8.2","7.7"
"Ware","2020-10-29","84","20927","7","1637","8.8","8.1"
"Ware","2020-10-30","55","20982","2","1639","8.6","6.5"
"Ware","2020-10-31","30","21012","5","1644","10","7.2"
"Ware","2020-11-01","20","21032","2","1646","7.6","7.9"
"Ware","2020-11-02","305","21337","5","1651","7.5","7.8"
"Ware","2020-11-03","137","21474","8","1659","7.2","7.5"
"Ware","2020-11-04","100","21574","7","1666","7.6","7.9"
"Ware","2020-11-05","86","21660","6","1672","7.4","8.1"
"Ware","2020-11-06","81","21741","10","1682","8.6","8.6"
"Ware","2020-11-07","37","21778","8","1690","9.3","9.7"
"Ware","2020-11-08","10","21788","1","1691","9.3","8.5"
"Ware","2020-11-09","320","22108","8","1699","9.5","8.5"
"Ware","2020-11-10","91","22199","2","1701","8.9","8.1"
"Ware","2020-11-11","134","22333","8","1709","8.8","8.2"
"Ware","2020-11-12","233","22566","8","1717","8.3","7.8"
"Ware","2020-11-13","84","22650","11","1728","8.4","8.5"
"Ware","2020-11-14","31","22681","5","1733","7.6","8.5"
"Ware","2020-11-15","15","22696","0","1733","6.2","7.8"
"Ware","2020-11-16","340","23036","11","1744","6.3","7.9"
"Ware","2020-11-17","98","23134","3","1747","6.4","7.7"
"Ware","2020-11-18","220","23354","16","1763","6.6","7.7"
"Ware","2020-11-19","235","23589","4","1767","6.4","7.3"
"Ware","2020-11-20","64","23653","5","1772","5.6","7"
"Ware","2020-11-21","24","23677","0","1772","3.3","5.5"
"Ware","2020-11-22","14","23691","2","1774","5.3","5.8"
"Ware","2020-11-23","375","24066","7","1781","5.1","5.7"
"Ware","2020-11-24","87","24153","3","1784","5.2","5.8"
"Ware","2020-11-25","92","24245","2","1786","4.5","5.5"
"Ware","2020-11-26","55","24300","2","1788","4.7","5.6"
"Ware","2020-11-27","38","24338","3","1791","4.8","5.2"
"Ware","2020-11-28","45","24383","2","1793","5.4","4.3"
"Ware","2020-11-29","20","24403","0","1793","3.4","4.3"
"Ware","2020-11-30","341","24744","6","1799","3.3","4.2"
"Ware","2020-12-01","102","24846","3","1802","3.3","4.2"
"Ware","2020-12-02","151","24997","4","1806","3.3","3.9"
"Ware","2020-12-03","33","25030","0","1806","2.8","3.8"
"Ware","2020-12-04","117","25147","3","1809","2.1","3.4"
"Ware","2020-12-05","52","25199","0","1809","1.4","3.4"
"Ware","2020-12-06","21","25220","5","1814","4.8","4.1"
"Ware","2020-12-07","356","25576","11","1825","5","4.2"
"Ware","2020-12-08","157","25733","2","1827","4.8","4"
"Ware","2020-12-09","83","25816","9","1836","5.9","4.6"
"Ware","2020-12-10","75","25891","8","1844","7.5","5.1"
"Ware","2020-12-11","156","26047","10","1854","8","5"
"Ware","2020-12-12","38","26085","5","1859","9.9","5.7"
"Ware","2020-12-13","30","26115","6","1865","9.3","7.1"
"Ware","2020-12-14","370","26485","17","1882","9.6","7.3"
"Ware","2020-12-15","126","26611","15","1897","11.1","7.9"
"Ware","2020-12-16","188","26799","18","1915","10.9","8.4"
"Ware","2020-12-17","102","26901","8","1923","10.5","9"
"Ware","2020-12-18","138","27039","10","1933","10.6","9.3"
"Ware","2020-12-19","40","27079","8","1941","11.6","10.7"
"Ware","2020-12-20","35","27114","6","1947","11.2","10.3"
"Ware","2020-12-21","387","27501","18","1965","11.2","10.4"
"Ware","2020-12-22","190","27691","15","1980","10.6","10.9"
"Ware","2020-12-23","150","27841","20","2000","11.2","11"
"Ware","2020-12-24","40","27881","14","2014","15","12.8"
"Ware","2020-12-25","18","27899","8","2022","20.4","15.5"
"Ware","2020-12-26","71","27970","12","2034","19.9","15.8"
"Ware","2020-12-27","48","28018","8","2042","19.8","15.5"
"Ware","2020-12-28","407","28425","31","2073","20.3","15.7"
"Ware","2020-12-29","153","28578","22","2095","21.2","15.9"
"Ware","2020-12-30","225","28803","46","2141","22.2","16.7"
"Ware","2020-12-31","77","28880","29","2170","22.6","18.8"
"Ware","2021-01-01","28","28908","11","2181","21.9","21.1"
"Ware","2021-01-02","56","28964","13","2194","22.8","21.3"
"Ware","2021-01-03","69","29033","25","2219","25.5","22.7"
"Ware","2021-01-04","410","29443","39","2258","25.8","23"
"Ware","2021-01-05","240","29683","29","2287","25.5","23.3"
"Ware","2021-01-06","199","29882","19","2306","23.9","23.1"
"Ware","2021-01-07","210","30092","26","2332","20.3","21.5"
"Ware","2021-01-08","147","30239","24","2356","17","19.4"
"Ware","2021-01-09","55","30294","9","2365","16.1","19.4"
"Ware","2021-01-10","25","30319","7","2372","14.9","20.2"
"Ware","2021-01-11","459","30778","59","2431","15.4","20.6"
"Ware","2021-01-12","247","31025","47","2478","16.4","20.9"
"Ware","2021-01-13","132","31157","23","2501","17.5","20.7"
"Ware","2021-01-14","185","31342","27","2528","17.8","19.1"
"Ware","2021-01-15","165","31507","21","2549","17.3","17.2"
"Ware","2021-01-16","38","31545","8","2557","18","17"
"Ware","2021-01-17","36","31581","6","2563","16.3","15.6"
"Ware","2021-01-18","392","31973","52","2615","16.4","15.9"
"Ware","2021-01-19","203","32176","14","2629","14.7","15.5"
"Ware","2021-01-20","169","32345","27","2656","14.5","16"
"Ware","2021-01-21","163","32508","19","2675","14","15.9"
"Ware","2021-01-22","202","32710","11","2686","13","15.1"
"Ware","2021-01-23","130","32840","5","2691","10.5","14.2"
"Ware","2021-01-24","16","32856","1","2692","9","12.7"
"Ware","2021-01-25","251","33107","34","2726","9.1","12.7"
"Ware","2021-01-26","9","33116","1","2727","9.7","12.2"
"Ware","2021-01-27","0","33116","0","2727","7.4","10.9"
"Warren","2020-02-01","0","0","0","0",".","."
"Warren","2020-02-02","0","0","0","0",".","."
"Warren","2020-02-03","0","0","0","0",".","."
"Warren","2020-02-04","0","0","0","0",".","."
"Warren","2020-02-05","0","0","0","0",".","."
"Warren","2020-02-06","0","0","0","0",".","."
"Warren","2020-02-07","0","0","0","0","0","."
"Warren","2020-02-08","0","0","0","0","0","."
"Warren","2020-02-09","0","0","0","0","0","."
"Warren","2020-02-10","0","0","0","0","0","."
"Warren","2020-02-11","0","0","0","0","0","."
"Warren","2020-02-12","0","0","0","0","0","."
"Warren","2020-02-13","0","0","0","0","0","."
"Warren","2020-02-14","0","0","0","0","0","0"
"Warren","2020-02-15","0","0","0","0","0","0"
"Warren","2020-02-16","0","0","0","0","0","0"
"Warren","2020-02-17","0","0","0","0","0","0"
"Warren","2020-02-18","0","0","0","0","0","0"
"Warren","2020-02-19","0","0","0","0","0","0"
"Warren","2020-02-20","0","0","0","0","0","0"
"Warren","2020-02-21","0","0","0","0","0","0"
"Warren","2020-02-22","0","0","0","0","0","0"
"Warren","2020-02-23","0","0","0","0","0","0"
"Warren","2020-02-24","0","0","0","0","0","0"
"Warren","2020-02-25","0","0","0","0","0","0"
"Warren","2020-02-26","0","0","0","0","0","0"
"Warren","2020-02-27","0","0","0","0","0","0"
"Warren","2020-02-28","0","0","0","0","0","0"
"Warren","2020-02-29","0","0","0","0","0","0"
"Warren","2020-03-01","0","0","0","0","0","0"
"Warren","2020-03-02","0","0","0","0","0","0"
"Warren","2020-03-03","0","0","0","0","0","0"
"Warren","2020-03-04","0","0","0","0","0","0"
"Warren","2020-03-05","0","0","0","0","0","0"
"Warren","2020-03-06","0","0","0","0","0","0"
"Warren","2020-03-07","0","0","0","0","0","0"
"Warren","2020-03-08","0","0","0","0","0","0"
"Warren","2020-03-09","0","0","0","0","0","0"
"Warren","2020-03-10","0","0","0","0","0","0"
"Warren","2020-03-11","0","0","0","0","0","0"
"Warren","2020-03-12","0","0","0","0","0","0"
"Warren","2020-03-13","0","0","0","0","0","0"
"Warren","2020-03-14","0","0","0","0","0","0"
"Warren","2020-03-15","0","0","0","0","0","0"
"Warren","2020-03-16","0","0","0","0","0","0"
"Warren","2020-03-17","1","1","0","0","0","0"
"Warren","2020-03-18","0","1","0","0","0","0"
"Warren","2020-03-19","1","2","1","1","14.3","7.1"
"Warren","2020-03-20","0","2","0","1","14.3","7.1"
"Warren","2020-03-21","0","2","0","1","14.3","7.1"
"Warren","2020-03-22","0","2","0","1","14.3","7.1"
"Warren","2020-03-23","0","2","0","1","14.3","7.1"
"Warren","2020-03-24","0","2","0","1","14.3","7.1"
"Warren","2020-03-25","0","2","0","1","14.3","7.1"
"Warren","2020-03-26","0","2","0","1","0","7.1"
"Warren","2020-03-27","0","2","0","1","0","7.1"
"Warren","2020-03-28","0","2","0","1","0","7.1"
"Warren","2020-03-29","0","2","0","1","0","7.1"
"Warren","2020-03-30","0","2","0","1","0","7.1"
"Warren","2020-03-31","0","2","0","1","0","7.1"
"Warren","2020-04-01","0","2","0","1","0","7.1"
"Warren","2020-04-02","2","4","0","1","0","0"
"Warren","2020-04-03","0","4","0","1","0","0"
"Warren","2020-04-04","1","5","0","1","0","0"
"Warren","2020-04-05","1","6","0","1","0","0"
"Warren","2020-04-06","0","6","0","1","0","0"
"Warren","2020-04-07","3","9","1","2","4.8","2.4"
"Warren","2020-04-08","1","10","0","2","4.8","2.4"
"Warren","2020-04-09","1","11","0","2","4.8","2.4"
"Warren","2020-04-10","4","15","0","2","4.8","2.4"
"Warren","2020-04-11","4","19","1","3","8.3","4.2"
"Warren","2020-04-12","0","19","0","3","8.3","4.2"
"Warren","2020-04-13","2","21","2","5","22.6","11.3"
"Warren","2020-04-14","0","21","0","5","17.9","11.3"
"Warren","2020-04-15","2","23","1","6","25","14.9"
"Warren","2020-04-16","2","25","0","6","25","14.9"
"Warren","2020-04-17","2","27","0","6","25","14.9"
"Warren","2020-04-18","0","27","0","6","21.4","14.9"
"Warren","2020-04-19","0","27","0","6","21.4","14.9"
"Warren","2020-04-20","2","29","0","6","7.1","14.9"
"Warren","2020-04-21","4","33","0","6","7.1","12.5"
"Warren","2020-04-22","5","38","2","8","5.7","15.4"
"Warren","2020-04-23","3","41","0","8","5.7","15.4"
"Warren","2020-04-24","1","42","0","8","5.7","15.4"
"Warren","2020-04-25","2","44","1","9","12.9","17.1"
"Warren","2020-04-26","0","44","0","9","12.9","17.1"
"Warren","2020-04-27","3","47","1","10","17.6","12.4"
"Warren","2020-04-28","1","48","0","10","17.6","12.4"
"Warren","2020-04-29","2","50","2","12","26.2","16"
"Warren","2020-04-30","4","54","1","13","29.8","17.7"
"Warren","2020-05-01","3","57","1","14","34.5","20.1"
"Warren","2020-05-02","0","57","0","14","27.4","20.1"
"Warren","2020-05-03","2","59","0","14","27.4","20.1"
"Warren","2020-05-04","4","63","0","14","22.6","20.1"
"Warren","2020-05-05","9","72","0","14","22.6","20.1"
"Warren","2020-05-06","7","79","0","14","8.3","17.3"
"Warren","2020-05-07","9","88","3","17","9.5","19.6"
"Warren","2020-05-08","3","91","0","17","4.8","19.6"
"Warren","2020-05-09","0","91","0","17","4.8","16.1"
"Warren","2020-05-10","0","91","0","17","4.8","16.1"
"Warren","2020-05-11","0","91","0","17","4.8","13.7"
"Warren","2020-05-12","2","93","0","17","4.8","13.7"
"Warren","2020-05-13","2","95","0","17","4.8","6.5"
"Warren","2020-05-14","2","97","0","17","0","4.8"
"Warren","2020-05-15","0","97","0","17","0","2.4"
"Warren","2020-05-16","1","98","0","17","0","2.4"
"Warren","2020-05-17","2","100","0","17","0","2.4"
"Warren","2020-05-18","2","102","0","17","0","2.4"
"Warren","2020-05-19","4","106","0","17","0","2.4"
"Warren","2020-05-20","7","113","1","18","2","3.4"
"Warren","2020-05-21","1","114","0","18","2","1"
"Warren","2020-05-22","1","115","0","18","2","1"
"Warren","2020-05-23","0","115","0","18","2","1"
"Warren","2020-05-24","0","115","0","18","2","1"
"Warren","2020-05-25","0","115","0","18","2","1"
"Warren","2020-05-26","4","119","0","18","2","1"
"Warren","2020-05-27","1","120","0","18","0","1"
"Warren","2020-05-28","1","121","0","18","0","1"
"Warren","2020-05-29","1","122","0","18","0","1"
"Warren","2020-05-30","0","122","0","18","0","1"
"Warren","2020-05-31","4","126","0","18","0","1"
"Warren","2020-06-01","4","130","0","18","0","1"
"Warren","2020-06-02","4","134","0","18","0","1"
"Warren","2020-06-03","1","135","0","18","0","0"
"Warren","2020-06-04","1","136","0","18","0","0"
"Warren","2020-06-05","0","136","0","18","0","0"
"Warren","2020-06-06","0","136","0","18","0","0"
"Warren","2020-06-07","0","136","0","18","0","0"
"Warren","2020-06-08","0","136","0","18","0","0"
"Warren","2020-06-09","1","137","0","18","0","0"
"Warren","2020-06-10","3","140","0","18","0","0"
"Warren","2020-06-11","5","145","0","18","0","0"
"Warren","2020-06-12","1","146","0","18","0","0"
"Warren","2020-06-13","3","149","0","18","0","0"
"Warren","2020-06-14","1","150","0","18","0","0"
"Warren","2020-06-15","4","154","0","18","0","0"
"Warren","2020-06-16","1","155","0","18","0","0"
"Warren","2020-06-17","1","156","0","18","0","0"
"Warren","2020-06-18","1","157","0","18","0","0"
"Warren","2020-06-19","1","158","0","18","0","0"
"Warren","2020-06-20","0","158","0","18","0","0"
"Warren","2020-06-21","0","158","0","18","0","0"
"Warren","2020-06-22","5","163","0","18","0","0"
"Warren","2020-06-23","2","165","0","18","0","0"
"Warren","2020-06-24","6","171","1","19","2.4","1.2"
"Warren","2020-06-25","6","177","0","19","2.4","1.2"
"Warren","2020-06-26","1","178","0","19","2.4","1.2"
"Warren","2020-06-27","1","179","0","19","2.4","1.2"
"Warren","2020-06-28","2","181","0","19","2.4","1.2"
"Warren","2020-06-29","3","184","0","19","2.4","1.2"
"Warren","2020-06-30","8","192","0","19","2.4","1.2"
"Warren","2020-07-01","10","202","1","20","1.4","1.9"
"Warren","2020-07-02","14","216","0","20","1.4","1.9"
"Warren","2020-07-03","4","220","0","20","1.4","1.9"
"Warren","2020-07-04","4","224","1","21","5","3.7"
"Warren","2020-07-05","5","229","0","21","5","3.7"
"Warren","2020-07-06","6","235","1","22","7.4","4.9"
"Warren","2020-07-07","14","249","1","23","8.4","5.4"
"Warren","2020-07-08","9","258","0","23","7","4.2"
"Warren","2020-07-09","3","261","1","24","11.7","6.6"
"Warren","2020-07-10","9","270","2","26","14.9","8.2"
"Warren","2020-07-11","3","273","0","26","11.3","8.2"
"Warren","2020-07-12","3","276","0","26","11.3","8.2"
"Warren","2020-07-13","11","287","2","28","11.6","9.5"
"Warren","2020-07-14","11","298","2","30","13.1","10.8"
"Warren","2020-07-15","10","308","0","30","13.1","10.1"
"Warren","2020-07-16","11","319","1","31","9.7","10.7"
"Warren","2020-07-17","4","323","0","31","6.5","10.7"
"Warren","2020-07-18","3","326","1","32","11.3","11.3"
"Warren","2020-07-19","6","332","2","34","16","13.7"
"Warren","2020-07-20","5","337","0","34","13.4","12.5"
"Warren","2020-07-21","5","342","1","35","13.7","13.4"
"Warren","2020-07-22","5","347","0","35","13.7","13.4"
"Warren","2020-07-23","4","351","2","37","19.5","14.6"
"Warren","2020-07-24","10","361","3","40","23.8","15.2"
"Warren","2020-07-25","4","365","0","40","19","15.2"
"Warren","2020-07-26","2","367","0","40","14.3","15.2"
"Warren","2020-07-27","16","383","4","44","17.9","15.6"
"Warren","2020-07-28","15","398","3","47","17.9","15.8"
"Warren","2020-07-29","4","402","2","49","25","19.3"
"Warren","2020-07-30","4","406","1","50","21.4","20.5"
"Warren","2020-07-31","9","415","3","53","21.9","22.9"
"Warren","2020-08-01","4","419","2","55","29","24"
"Warren","2020-08-02","4","423","0","55","29","21.7"
"Warren","2020-08-03","11","434","4","59","30.7","24.3"
"Warren","2020-08-04","5","439","3","62","36.4","27.1"
"Warren","2020-08-05","12","451","5","67","35.2","30.1"
"Warren","2020-08-06","5","456","2","69","37.3","29.4"
"Warren","2020-08-07","5","461","3","72","41.1","31.5"
"Warren","2020-08-08","5","466","0","72","34","31.5"
"Warren","2020-08-09","4","470","0","72","34","31.5"
"Warren","2020-08-10","4","474","1","73","32.4","31.5"
"Warren","2020-08-11","7","481","0","73","23.8","30.1"
"Warren","2020-08-12","8","489","1","74","19.6","27.4"
"Warren","2020-08-13","8","497","0","74","13.9","25.6"
"Warren","2020-08-14","4","501","1","75","8.9","25"
"Warren","2020-08-15","5","506","1","76","11.8","22.9"
"Warren","2020-08-16","1","507","0","76","11.8","22.9"
"Warren","2020-08-17","6","513","0","76","8.2","20.3"
"Warren","2020-08-18","5","518","0","76","8.2","16"
"Warren","2020-08-19","4","522","0","76","6.4","13"
"Warren","2020-08-20","2","524","0","76","6.4","10.2"
"Warren","2020-08-21","5","529","0","76","2.9","5.9"
"Warren","2020-08-22","1","530","1","77","14.3","13"
"Warren","2020-08-23","3","533","0","77","14.3","13"
"Warren","2020-08-24","7","540","0","77","14.3","11.3"
"Warren","2020-08-25","4","544","1","78","17.9","13"
"Warren","2020-08-26","5","549","2","80","23.6","15"
"Warren","2020-08-27","6","555","0","80","23.6","15"
"Warren","2020-08-28","3","558","0","80","23.6","13.2"
"Warren","2020-08-29","1","559","0","80","9.3","11.8"
"Warren","2020-08-30","3","562","0","80","9.3","11.8"
"Warren","2020-08-31","5","567","2","82","15","14.6"
"Warren","2020-09-01","3","570","0","82","11.4","14.6"
"Warren","2020-09-02","5","575","0","82","5.7","14.6"
"Warren","2020-09-03","3","578","0","82","5.7","14.6"
"Warren","2020-09-04","4","582","0","82","5.7","14.6"
"Warren","2020-09-05","2","584","0","82","5.7","7.5"
"Warren","2020-09-06","1","585","0","82","5.7","7.5"
"Warren","2020-09-07","3","588","0","82","0","7.5"
"Warren","2020-09-08","6","594","0","82","0","5.7"
"Warren","2020-09-09","5","599","0","82","0","2.9"
"Warren","2020-09-10","1","600","0","82","0","2.9"
"Warren","2020-09-11","3","603","1","83","4.8","5.2"
"Warren","2020-09-12","4","607","1","84","8.3","7"
"Warren","2020-09-13","3","610","0","84","8.3","7"
"Warren","2020-09-14","8","618","0","84","8.3","4.2"
"Warren","2020-09-15","31","649","0","84","8.3","4.2"
"Warren","2020-09-16","4","653","1","85","11.9","6"
"Warren","2020-09-17","9","662","0","85","11.9","6"
"Warren","2020-09-18","8","670","2","87","10.7","7.7"
"Warren","2020-09-19","19","689","1","88","7.9","8.1"
"Warren","2020-09-20","3","692","1","89","12.7","10.5"
"Warren","2020-09-21","6","698","0","89","12.7","10.5"
"Warren","2020-09-22","5","703","0","89","12.7","10.5"
"Warren","2020-09-23","4","707","0","89","9.1","10.5"
"Warren","2020-09-24","13","720","8","97","17.9","14.9"
"Warren","2020-09-25","4","724","1","98","17.9","14.3"
"Warren","2020-09-26","1","725","0","98","17.1","12.5"
"Warren","2020-09-27","1","726","0","98","12.4","12.5"
"Warren","2020-09-28","8","734","0","98","12.4","12.5"
"Warren","2020-09-29","13","747","1","99","13.5","13.1"
"Warren","2020-09-30","7","754","1","100","15.5","12.3"
"Warren","2020-10-01","2","756","2","102","21","19.4"
"Warren","2020-10-02","7","763","0","102","17.4","17.7"
"Warren","2020-10-03","3","766","0","102","17.4","17.3"
"Warren","2020-10-04","6","772","1","103","19.8","16.1"
"Warren","2020-10-05","5","777","0","103","19.8","16.1"
"Warren","2020-10-06","8","785","0","103","18.7","16.1"
"Warren","2020-10-07","8","793","1","104","18.5","17"
"Warren","2020-10-08","2","795","0","104","4.2","12.6"
"Warren","2020-10-09","12","807","0","104","4.2","10.8"
"Warren","2020-10-10","5","812","0","104","4.2","10.8"
"Warren","2020-10-11","2","814","0","104","1.8","10.8"
"Warren","2020-10-12","7","821","2","106","5.9","12.8"
"Warren","2020-10-13","12","833","0","106","5.9","12.3"
"Warren","2020-10-14","6","839","0","106","4.1","11.3"
"Warren","2020-10-15","5","844","0","106","4.1","4.1"
"Warren","2020-10-16","5","849","0","106","4.1","4.1"
"Warren","2020-10-17","6","855","0","106","4.1","4.1"
"Warren","2020-10-18","1","856","0","106","4.1","2.9"
"Warren","2020-10-19","5","861","0","106","0","2.9"
"Warren","2020-10-20","5","866","1","107","2.9","4.4"
"Warren","2020-10-21","5","871","0","107","2.9","3.5"
"Warren","2020-10-22","6","877","0","107","2.9","3.5"
"Warren","2020-10-23","5","882","0","107","2.9","3.5"
"Warren","2020-10-24","5","887","0","107","2.9","3.5"
"Warren","2020-10-25","3","890","0","107","2.9","3.5"
"Warren","2020-10-26","4","894","0","107","2.9","1.4"
"Warren","2020-10-27","16","910","1","108","0.9","1.9"
"Warren","2020-10-28","3","913","1","109","5.7","4.3"
"Warren","2020-10-29","6","919","1","110","8","5.4"
"Warren","2020-10-30","3","922","0","110","8","5.4"
"Warren","2020-10-31","3","925","1","111","12.8","7.8"
"Warren","2020-11-01","5","930","0","111","12.8","7.8"
"Warren","2020-11-02","6","936","0","111","12.8","7.8"
"Warren","2020-11-03","6","942","0","111","11.9","6.4"
"Warren","2020-11-04","8","950","2","113","10.7","8.2"
"Warren","2020-11-05","4","954","0","113","8.3","8.2"
"Warren","2020-11-06","4","958","0","113","8.3","8.2"
"Warren","2020-11-07","6","964","0","113","3.6","8.2"
"Warren","2020-11-08","4","968","1","114","7.1","10"
"Warren","2020-11-09","8","976","0","114","7.1","10"
"Warren","2020-11-10","24","1000","3","117","8.9","10.4"
"Warren","2020-11-11","5","1005","0","117","5.4","8"
"Warren","2020-11-12","5","1010","0","117","5.4","6.8"
"Warren","2020-11-13","11","1021","2","119","8","8.1"
"Warren","2020-11-14","8","1029","0","119","8","5.8"
"Warren","2020-11-15","2","1031","0","119","4.4","5.8"
"Warren","2020-11-16","9","1040","3","122","9.1","8.1"
"Warren","2020-11-17","14","1054","1","123","8.4","8.7"
"Warren","2020-11-18","8","1062","0","123","8.4","6.9"
"Warren","2020-11-19","5","1067","0","123","8.4","6.9"
"Warren","2020-11-20","4","1071","0","123","5.8","6.9"
"Warren","2020-11-21","0","1071","0","123","5.8","6.9"
"Warren","2020-11-22","3","1074","1","124","10.5","7.5"
"Warren","2020-11-23","2","1076","0","124","5.8","7.5"
"Warren","2020-11-24","9","1085","3","127","9.5","9"
"Warren","2020-11-25","6","1091","0","127","9.5","9"
"Warren","2020-11-26","2","1093","0","127","9.5","9"
"Warren","2020-11-27","8","1101","0","127","9.5","7.7"
"Warren","2020-11-28","2","1103","0","127","9.5","7.7"
"Warren","2020-11-29","2","1105","0","127","4.8","7.7"
"Warren","2020-11-30","9","1114","0","127","4.8","5.3"
"Warren","2020-12-01","3","1117","0","127","0","4.8"
"Warren","2020-12-02","14","1131","5","132","5.1","7.3"
"Warren","2020-12-03","13","1144","1","133","6.2","7.9"
"Warren","2020-12-04","14","1158","0","133","6.2","7.9"
"Warren","2020-12-05","11","1169","0","133","6.2","7.9"
"Warren","2020-12-06","3","1172","0","133","6.2","5.5"
"Warren","2020-12-07","12","1184","1","134","7.4","6.1"
"Warren","2020-12-08","5","1189","2","136","13.1","6.6"
"Warren","2020-12-09","16","1205","5","141","12.5","8.8"
"Warren","2020-12-10","4","1209","0","141","11.4","8.8"
"Warren","2020-12-11","11","1220","0","141","11.4","8.8"
"Warren","2020-12-12","2","1222","0","141","11.4","8.8"
"Warren","2020-12-13","1","1223","0","141","11.4","8.8"
"Warren","2020-12-14","8","1231","2","143","13.8","10.6"
"Warren","2020-12-15","4","1235","2","145","15.2","14.1"
"Warren","2020-12-16","3","1238","0","145","10.7","11.6"
"Warren","2020-12-17","7","1245","2","147","14.8","13.1"
"Warren","2020-12-18","10","1255","0","147","14.8","13.1"
"Warren","2020-12-19","3","1258","1","148","19.6","15.5"
"Warren","2020-12-20","10","1268","2","150","22.4","16.9"
"Warren","2020-12-21","7","1275","1","151","20.9","17.3"
"Warren","2020-12-22","5","1280","1","152","16.6","15.9"
"Warren","2020-12-23","2","1282","0","152","16.6","13.7"
"Warren","2020-12-24","3","1285","1","153","17.3","16"
"Warren","2020-12-25","1","1286","0","153","17.3","16"
"Warren","2020-12-26","8","1294","5","158","21.4","20.5"
"Warren","2020-12-27","7","1301","4","162","26.8","24.6"
"Warren","2020-12-28","7","1308","0","162","24.7","22.8"
"Warren","2020-12-29","7","1315","1","163","23.9","20.2"
"Warren","2020-12-30","10","1325","1","164","25.3","21"
"Warren","2020-12-31","4","1329","0","164","20.6","18.9"
"Warren","2021-01-01","0","1329","0","164","20.6","18.9"
"Warren","2021-01-02","8","1337","0","164","11.6","16.5"
"Warren","2021-01-03","2","1339","1","165","10.6","18.7"
"Warren","2021-01-04","5","1344","2","167","16.3","20.5"
"Warren","2021-01-05","10","1354","2","169","17.1","20.5"
"Warren","2021-01-06","23","1377","8","177","20.7","23"
"Warren","2021-01-07","17","1394","8","185","27.4","24"
"Warren","2021-01-08","15","1409","4","189","31.2","25.9"
"Warren","2021-01-09","19","1428","6","195","35.7","23.7"
"Warren","2021-01-10","10","1438","2","197","31.4","21"
"Warren","2021-01-11","18","1456","8","205","32.1","24.2"
"Warren","2021-01-12","4","1460","1","206","32.8","25"
"Warren","2021-01-13","24","1484","10","216","33.8","27.2"
"Warren","2021-01-14","14","1498","6","222","33.2","30.3"
"Warren","2021-01-15","9","1507","4","226","35.7","33.5"
"Warren","2021-01-16","13","1520","4","230","35.6","35.7"
"Warren","2021-01-17","9","1529","3","233","37.5","34.5"
"Warren","2021-01-18","11","1540","2","235","33.8","32.9"
"Warren","2021-01-19","13","1553","3","238","33.5","33.1"
"Warren","2021-01-20","14","1567","4","242","31.6","32.7"
"Warren","2021-01-21","13","1580","1","243","26.6","29.9"
"Warren","2021-01-22","12","1592","2","245","22.6","29.2"
"Warren","2021-01-23","11","1603","5","250","24.7","30.2"
"Warren","2021-01-24","9","1612","4","254","26.3","31.9"
"Warren","2021-01-25","12","1624","1","255","24.9","29.3"
"Warren","2021-01-26","0","1624","0","255","21.6","27.5"
"Warren","2021-01-27","0","1624","0","255","17.5","24.6"
"Washington","2020-02-01","0","0","0","0",".","."
"Washington","2020-02-02","0","0","0","0",".","."
"Washington","2020-02-03","0","0","0","0",".","."
"Washington","2020-02-04","0","0","0","0",".","."
"Washington","2020-02-05","0","0","0","0",".","."
"Washington","2020-02-06","0","0","0","0",".","."
"Washington","2020-02-07","0","0","0","0","0","."
"Washington","2020-02-08","0","0","0","0","0","."
"Washington","2020-02-09","0","0","0","0","0","."
"Washington","2020-02-10","0","0","0","0","0","."
"Washington","2020-02-11","0","0","0","0","0","."
"Washington","2020-02-12","0","0","0","0","0","."
"Washington","2020-02-13","0","0","0","0","0","."
"Washington","2020-02-14","0","0","0","0","0","0"
"Washington","2020-02-15","0","0","0","0","0","0"
"Washington","2020-02-16","0","0","0","0","0","0"
"Washington","2020-02-17","0","0","0","0","0","0"
"Washington","2020-02-18","0","0","0","0","0","0"
"Washington","2020-02-19","0","0","0","0","0","0"
"Washington","2020-02-20","0","0","0","0","0","0"
"Washington","2020-02-21","0","0","0","0","0","0"
"Washington","2020-02-22","0","0","0","0","0","0"
"Washington","2020-02-23","0","0","0","0","0","0"
"Washington","2020-02-24","0","0","0","0","0","0"
"Washington","2020-02-25","0","0","0","0","0","0"
"Washington","2020-02-26","0","0","0","0","0","0"
"Washington","2020-02-27","0","0","0","0","0","0"
"Washington","2020-02-28","0","0","0","0","0","0"
"Washington","2020-02-29","0","0","0","0","0","0"
"Washington","2020-03-01","0","0","0","0","0","0"
"Washington","2020-03-02","0","0","0","0","0","0"
"Washington","2020-03-03","0","0","0","0","0","0"
"Washington","2020-03-04","0","0","0","0","0","0"
"Washington","2020-03-05","0","0","0","0","0","0"
"Washington","2020-03-06","1","1","0","0","0","0"
"Washington","2020-03-07","0","1","0","0","0","0"
"Washington","2020-03-08","0","1","0","0","0","0"
"Washington","2020-03-09","0","1","0","0","0","0"
"Washington","2020-03-10","0","1","0","0","0","0"
"Washington","2020-03-11","0","1","0","0","0","0"
"Washington","2020-03-12","0","1","0","0","0","0"
"Washington","2020-03-13","0","1","0","0","0","0"
"Washington","2020-03-14","0","1","0","0","0","0"
"Washington","2020-03-15","0","1","0","0","0","0"
"Washington","2020-03-16","0","1","0","0","0","0"
"Washington","2020-03-17","0","1","0","0","0","0"
"Washington","2020-03-18","0","1","0","0","0","0"
"Washington","2020-03-19","2","3","0","0","0","0"
"Washington","2020-03-20","8","11","1","1","1.8","0.9"
"Washington","2020-03-21","2","13","0","1","1.8","0.9"
"Washington","2020-03-22","1","14","0","1","1.8","0.9"
"Washington","2020-03-23","4","18","0","1","1.8","0.9"
"Washington","2020-03-24","7","25","0","1","1.8","0.9"
"Washington","2020-03-25","7","32","0","1","1.8","0.9"
"Washington","2020-03-26","7","39","0","1","1.8","0.9"
"Washington","2020-03-27","5","44","0","1","0","0.9"
"Washington","2020-03-28","1","45","0","1","0","0.9"
"Washington","2020-03-29","3","48","2","3","9.5","5.7"
"Washington","2020-03-30","2","50","0","3","9.5","5.7"
"Washington","2020-03-31","1","51","0","3","9.5","5.7"
"Washington","2020-04-01","1","52","0","3","9.5","5.7"
"Washington","2020-04-02","3","55","0","3","9.5","5.7"
"Washington","2020-04-03","2","57","0","3","9.5","4.8"
"Washington","2020-04-04","2","59","0","3","9.5","4.8"
"Washington","2020-04-05","3","62","0","3","0","4.8"
"Washington","2020-04-06","1","63","0","3","0","4.8"
"Washington","2020-04-07","3","66","0","3","0","4.8"
"Washington","2020-04-08","5","71","0","3","0","4.8"
"Washington","2020-04-09","3","74","0","3","0","4.8"
"Washington","2020-04-10","7","81","3","6","6.1","7.8"
"Washington","2020-04-11","1","82","0","6","6.1","7.8"
"Washington","2020-04-12","0","82","0","6","6.1","3.1"
"Washington","2020-04-13","7","89","0","6","6.1","3.1"
"Washington","2020-04-14","5","94","0","6","6.1","3.1"
"Washington","2020-04-15","8","102","0","6","6.1","3.1"
"Washington","2020-04-16","10","112","0","6","6.1","3.1"
"Washington","2020-04-17","1","113","0","6","0","3.1"
"Washington","2020-04-18","4","117","0","6","0","3.1"
"Washington","2020-04-19","1","118","0","6","0","3.1"
"Washington","2020-04-20","6","124","3","9","7.1","6.6"
"Washington","2020-04-21","3","127","0","9","7.1","6.6"
"Washington","2020-04-22","6","133","0","9","7.1","6.6"
"Washington","2020-04-23","8","141","1","10","8.9","7.5"
"Washington","2020-04-24","9","150","0","10","8.9","4.5"
"Washington","2020-04-25","5","155","0","10","8.9","4.5"
"Washington","2020-04-26","4","159","0","10","8.9","4.5"
"Washington","2020-04-27","8","167","0","10","1.8","4.5"
"Washington","2020-04-28","20","187","2","12","3.2","5.2"
"Washington","2020-04-29","9","196","0","12","3.2","5.2"
"Washington","2020-04-30","15","211","2","14","3.3","6.1"
"Washington","2020-05-01","5","216","1","15","6.2","7.6"
"Washington","2020-05-02","3","219","2","17","15.7","12.3"
"Washington","2020-05-03","5","224","0","17","15.7","12.3"
"Washington","2020-05-04","5","229","1","18","18.6","10.2"
"Washington","2020-05-05","19","248","3","21","19.4","11.3"
"Washington","2020-05-06","11","259","0","21","19.4","11.3"
"Washington","2020-05-07","14","273","1","22","18.5","10.9"
"Washington","2020-05-08","10","283","1","23","17.1","11.6"
"Washington","2020-05-09","3","286","0","23","7.6","11.6"
"Washington","2020-05-10","2","288","1","24","14.7","15.2"
"Washington","2020-05-11","12","300","3","27","15.4","17"
"Washington","2020-05-12","13","313","1","28","14.3","16.8"
"Washington","2020-05-13","9","322","1","29","15.8","17.6"
"Washington","2020-05-14","8","330","0","29","14.8","16.7"
"Washington","2020-05-15","5","335","1","30","16.3","16.7"
"Washington","2020-05-16","2","337","1","31","23.4","15.5"
"Washington","2020-05-17","5","342","0","31","16.3","15.5"
"Washington","2020-05-18","14","356","0","31","12.7","14.1"
"Washington","2020-05-19","13","369","0","31","11.6","12.9"
"Washington","2020-05-20","10","379","0","31","10","12.9"
"Washington","2020-05-21","17","396","0","31","10","12.4"
"Washington","2020-05-22","14","410","1","32","8.2","12.2"
"Washington","2020-05-23","4","414","1","33","4.6","14"
"Washington","2020-05-24","2","416","0","33","4.6","10.4"
"Washington","2020-05-25","3","419","0","33","4.6","8.6"
"Washington","2020-05-26","13","432","1","34","5.7","8.6"
"Washington","2020-05-27","5","437","0","34","5.7","7.8"
"Washington","2020-05-28","7","444","0","34","5.7","7.8"
"Washington","2020-05-29","4","448","0","34","4.7","6.4"
"Washington","2020-05-30","0","448","0","34","1.1","2.8"
"Washington","2020-05-31","1","449","0","34","1.1","2.8"
"Washington","2020-06-01","8","457","1","35","2.9","3.7"
"Washington","2020-06-02","10","467","0","35","1.8","3.7"
"Washington","2020-06-03","8","475","0","35","1.8","3.7"
"Washington","2020-06-04","51","526","0","35","1.8","3.7"
"Washington","2020-06-05","5","531","0","35","1.8","3.2"
"Washington","2020-06-06","0","531","0","35","1.8","1.4"
"Washington","2020-06-07","2","533","0","35","1.8","1.4"
"Washington","2020-06-08","6","539","0","35","0","1.4"
"Washington","2020-06-09","2","541","0","35","0","0.9"
"Washington","2020-06-10","6","547","0","35","0","0.9"
"Washington","2020-06-11","10","557","0","35","0","0.9"
"Washington","2020-06-12","10","567","0","35","0","0.9"
"Washington","2020-06-13","8","575","0","35","0","0.9"
"Washington","2020-06-14","3","578","0","35","0","0.9"
"Washington","2020-06-15","12","590","1","36","1.2","0.6"
"Washington","2020-06-16","4","594","1","37","4.8","2.4"
"Washington","2020-06-17","7","601","2","39","8.8","4.4"
"Washington","2020-06-18","7","608","4","43","17","8.5"
"Washington","2020-06-19","15","623","2","45","18.9","9.5"
"Washington","2020-06-20","4","627","0","45","18.9","9.5"
"Washington","2020-06-21","5","632","0","45","18.9","9.5"
"Washington","2020-06-22","19","651","6","51","22.2","11.7"
"Washington","2020-06-23","9","660","1","52","20.2","12.5"
"Washington","2020-06-24","8","668","1","53","18","13.4"
"Washington","2020-06-25","15","683","1","54","10.7","13.9"
"Washington","2020-06-26","22","705","3","57","10.8","14.8"
"Washington","2020-06-27","4","709","1","58","14.4","16.6"
"Washington","2020-06-28","5","714","3","61","22.9","20.9"
"Washington","2020-06-29","24","738","7","68","22.6","22.4"
"Washington","2020-06-30","20","758","6","74","25.3","22.8"
"Washington","2020-07-01","11","769","3","77","27.4","22.7"
"Washington","2020-07-02","22","791","5","82","29.7","20.2"
"Washington","2020-07-03","8","799","2","84","31.3","21"
"Washington","2020-07-04","2","801","0","84","27.7","21"
"Washington","2020-07-05","9","810","2","86","22.3","22.6"
"Washington","2020-07-06","23","833","3","89","20","21.3"
"Washington","2020-07-07","18","851","3","92","18.1","21.7"
"Washington","2020-07-08","25","876","3","95","16","21.7"
"Washington","2020-07-09","11","887","2","97","15.3","22.5"
"Washington","2020-07-10","22","909","12","109","19.5","25.4"
"Washington","2020-07-11","5","914","1","110","22.4","25.1"
"Washington","2020-07-12","2","916","0","110","19.2","20.8"
"Washington","2020-07-13","19","935","4","114","20.3","20.2"
"Washington","2020-07-14","14","949","3","117","21","19.6"
"Washington","2020-07-15","22","971","5","122","22.6","19.3"
"Washington","2020-07-16","16","987","6","128","25.3","20.3"
"Washington","2020-07-17","17","1004","4","132","20.9","20.2"
"Washington","2020-07-18","10","1014","1","133","19.5","20.9"
"Washington","2020-07-19","7","1021","0","133","19.5","19.3"
"Washington","2020-07-20","17","1038","5","138","20.7","20.5"
"Washington","2020-07-21","13","1051","5","143","23.1","22.1"
"Washington","2020-07-22","13","1064","4","147","24.2","23.4"
"Washington","2020-07-23","11","1075","2","149","21.5","23.4"
"Washington","2020-07-24","26","1101","7","156","22","21.4"
"Washington","2020-07-25","20","1121","4","160","23.4","21.4"
"Washington","2020-07-26","5","1126","1","161","26.2","22.9"
"Washington","2020-07-27","11","1137","1","162","23.3","22"
"Washington","2020-07-28","24","1161","7","169","22","22.6"
"Washington","2020-07-29","14","1175","7","176","24.8","24.5"
"Washington","2020-07-30","12","1187","4","180","26.9","24.2"
"Washington","2020-07-31","25","1212","4","184","25.4","23.7"
"Washington","2020-08-01","14","1226","4","188","26.6","25"
"Washington","2020-08-02","8","1234","2","190","27.3","26.8"
"Washington","2020-08-03","8","1242","0","190","26","24.7"
"Washington","2020-08-04","15","1257","5","195","26.6","24.3"
"Washington","2020-08-05","9","1266","5","200","27.4","26.1"
"Washington","2020-08-06","10","1276","3","203","26.9","26.9"
"Washington","2020-08-07","18","1294","2","205","26.2","25.8"
"Washington","2020-08-08","14","1308","2","207","24.2","25.4"
"Washington","2020-08-09","11","1319","3","210","24.5","25.9"
"Washington","2020-08-10","17","1336","3","213","27","26.5"
"Washington","2020-08-11","5","1341","1","214","25.1","25.9"
"Washington","2020-08-12","11","1352","2","216","19.8","23.6"
"Washington","2020-08-13","12","1364","0","216","15.5","21.2"
"Washington","2020-08-14","14","1378","1","217","14.9","20.6"
"Washington","2020-08-15","18","1396","6","223","17.7","20.9"
"Washington","2020-08-16","13","1409","2","225","16","20.2"
"Washington","2020-08-17","18","1427","2","227","15","21"
"Washington","2020-08-18","17","1444","4","231","15.5","20.3"
"Washington","2020-08-19","18","1462","4","235","16.1","17.9"
"Washington","2020-08-20","9","1471","0","235","16.1","15.8"
"Washington","2020-08-21","17","1488","1","236","15.9","15.4"
"Washington","2020-08-22","6","1494","0","236","11.2","14.4"
"Washington","2020-08-23","5","1499","2","238","14.7","15.3"
"Washington","2020-08-24","21","1520","2","240","14.5","14.7"
"Washington","2020-08-25","11","1531","2","242","13.7","14.6"
"Washington","2020-08-26","8","1539","0","242","10.5","13.3"
"Washington","2020-08-27","13","1552","3","245","13.8","15"
"Washington","2020-08-28","18","1570","6","251","17.7","16.8"
"Washington","2020-08-29","3","1573","1","252","22.5","16.8"
"Washington","2020-08-30","8","1581","0","252","16.8","15.7"
"Washington","2020-08-31","27","1608","1","253","15.9","15.2"
"Washington","2020-09-01","12","1620","1","254","14.5","14.1"
"Washington","2020-09-02","13","1633","1","255","15.6","13.1"
"Washington","2020-09-03","13","1646","0","255","12.3","13.1"
"Washington","2020-09-04","8","1654","0","255","7.6","12.7"
"Washington","2020-09-05","14","1668","1","256","3.8","13.2"
"Washington","2020-09-06","7","1675","0","256","3.8","10.3"
"Washington","2020-09-07","7","1682","2","258","7.4","11.7"
"Washington","2020-09-08","17","1699","3","261","8.7","11.6"
"Washington","2020-09-09","9","1708","0","261","7.6","11.6"
"Washington","2020-09-10","12","1720","0","261","7.6","10"
"Washington","2020-09-11","16","1736","0","261","7.6","7.6"
"Washington","2020-09-12","13","1749","0","261","6.6","5.2"
"Washington","2020-09-13","5","1754","1","262","9.5","6.6"
"Washington","2020-09-14","11","1765","0","262","5.4","6.4"
"Washington","2020-09-15","11","1776","0","262","2.9","5.8"
"Washington","2020-09-16","14","1790","0","262","2.9","5.2"
"Washington","2020-09-17","8","1798","0","262","2.9","5.2"
"Washington","2020-09-18","22","1820","2","264","4.2","5.9"
"Washington","2020-09-19","12","1832","0","264","4.2","5.4"
"Washington","2020-09-20","3","1835","1","265","6.1","7.8"
"Washington","2020-09-21","15","1850","2","267","8","6.7"
"Washington","2020-09-22","12","1862","2","269","10.3","6.6"
"Washington","2020-09-23","12","1874","2","271","12.7","7.8"
"Washington","2020-09-24","13","1887","0","271","12.7","7.8"
"Washington","2020-09-25","24","1911","0","271","11.4","7.8"
"Washington","2020-09-26","6","1917","0","271","11.4","7.8"
"Washington","2020-09-27","6","1923","0","271","6.7","6.4"
"Washington","2020-09-28","17","1940","1","272","5.6","6.8"
"Washington","2020-09-29","10","1950","0","272","3.2","6.8"
"Washington","2020-09-30","10","1960","1","273","2.3","7.5"
"Washington","2020-10-01","12","1972","2","275","4.6","8.7"
"Washington","2020-10-02","16","1988","2","277","6.4","8.9"
"Washington","2020-10-03","23","2011","1","278","7.1","9.2"
"Washington","2020-10-04","4","2015","0","278","7.1","6.9"
"Washington","2020-10-05","19","2034","0","278","6.2","5.9"
"Washington","2020-10-06","14","2048","0","278","6.2","4.7"
"Washington","2020-10-07","11","2059","0","278","4.8","3.5"
"Washington","2020-10-08","13","2072","3","281","5.7","5.2"
"Washington","2020-10-09","23","2095","1","282","4.5","5.5"
"Washington","2020-10-10","7","2102","1","283","6","6.5"
"Washington","2020-10-11","2","2104","1","284","13.1","10.1"
"Washington","2020-10-12","13","2117","1","285","14.2","10.2"
"Washington","2020-10-13","18","2135","4","289","17.4","11.8"
"Washington","2020-10-14","20","2155","0","289","17.4","11.1"
"Washington","2020-10-15","21","2176","2","291","15.4","10.6"
"Washington","2020-10-16","15","2191","0","291","14.8","9.7"
"Washington","2020-10-17","13","2204","0","291","12.8","9.4"
"Washington","2020-10-18","5","2209","0","291","5.6","9.4"
"Washington","2020-10-19","22","2231","3","294","6.5","10.3"
"Washington","2020-10-20","45","2276","5","299","4.9","11.1"
"Washington","2020-10-21","27","2303","4","303","7","12.2"
"Washington","2020-10-22","17","2320","3","306","8.2","11.8"
"Washington","2020-10-23","25","2345","1","307","8.7","11.8"
"Washington","2020-10-24","65","2410","3","310","9.4","11.1"
"Washington","2020-10-25","11","2421","3","313","13.3","9.5"
"Washington","2020-10-26","20","2441","5","318","14.9","10.7"
"Washington","2020-10-27","31","2472","3","321","14.7","9.8"
"Washington","2020-10-28","73","2545","6","327","13.8","10.4"
"Washington","2020-10-29","22","2567","9","336","17.1","12.6"
"Washington","2020-10-30","25","2592","1","337","17.1","12.9"
"Washington","2020-10-31","18","2610","2","339","18","13.7"
"Washington","2020-11-01","15","2625","1","340","15.1","14.2"
"Washington","2020-11-02","163","2788","4","344","11.9","13.4"
"Washington","2020-11-03","14","2802","2","346","12.5","13.6"
"Washington","2020-11-04","17","2819","3","349","13.9","13.8"
"Washington","2020-11-05","136","2955","2","351","8.2","12.7"
"Washington","2020-11-06","30","2985","1","352","8.1","12.6"
"Washington","2020-11-07","10","2995","0","352","6.6","12.3"
"Washington","2020-11-08","7","3002","1","353","7.6","11.4"
"Washington","2020-11-09","27","3029","2","355","8.3","10.1"
"Washington","2020-11-10","22","3051","0","355","6.3","9.4"
"Washington","2020-11-11","21","3072","7","362","8.5","11.2"
"Washington","2020-11-12","14","3086","0","362","8.3","8.3"
"Washington","2020-11-13","23","3109","1","363","8.5","8.3"
"Washington","2020-11-14","11","3120","4","367","13.7","10.1"
"Washington","2020-11-15","7","3127","1","368","13.7","10.7"
"Washington","2020-11-16","27","3154","3","371","14.2","11.3"
"Washington","2020-11-17","32","3186","3","374","15.5","10.9"
"Washington","2020-11-18","29","3215","4","378","12.8","10.7"
"Washington","2020-11-19","27","3242","4","382","14.9","11.6"
"Washington","2020-11-20","24","3266","4","386","16.6","12.6"
"Washington","2020-11-21","19","3285","4","390","14.4","14.1"
"Washington","2020-11-22","11","3296","1","391","13.7","13.7"
"Washington","2020-11-23","31","3327","6","397","14.9","14.5"
"Washington","2020-11-24","19","3346","4","401","16.5","16"
"Washington","2020-11-25","28","3374","3","404","16.1","14.4"
"Washington","2020-11-26","5","3379","0","404","14","14.4"
"Washington","2020-11-27","31","3410","7","411","14.8","15.7"
"Washington","2020-11-28","15","3425","4","415","15.6","15"
"Washington","2020-11-29","11","3436","1","416","15.6","14.7"
"Washington","2020-11-30","138","3574","4","420","13.3","14.1"
"Washington","2020-12-01","31","3605","2","422","11.2","13.9"
"Washington","2020-12-02","25","3630","4","426","12","14"
"Washington","2020-12-03","109","3739","5","431","12.6","13.3"
"Washington","2020-12-04","27","3766","6","437","12.6","13.7"
"Washington","2020-12-05","20","3786","6","443","13","14.3"
"Washington","2020-12-06","15","3801","5","448","16.5","16.1"
"Washington","2020-12-07","38","3839","6","454","18.3","15.8"
"Washington","2020-12-08","36","3875","8","462","20.6","15.9"
"Washington","2020-12-09","14","3889","2","464","20.3","16.2"
"Washington","2020-12-10","31","3920","3","467","21.1","16.8"
"Washington","2020-12-11","34","3954","5","472","20","16.3"
"Washington","2020-12-12","21","3975","5","477","19.1","16.1"
"Washington","2020-12-13","10","3985","0","477","14.4","15.4"
"Washington","2020-12-14","25","4010","3","480","13.8","16.1"
"Washington","2020-12-15","31","4041","7","487","13.9","17.2"
"Washington","2020-12-16","34","4075","6","493","14.3","17.3"
"Washington","2020-12-17","32","4107","5","498","15.2","18.1"
"Washington","2020-12-18","37","4144","5","503","15","17.5"
"Washington","2020-12-19","17","4161","2","505","13.3","16.2"
"Washington","2020-12-20","20","4181","5","510","16.9","15.6"
"Washington","2020-12-21","37","4218","2","512","15.9","14.9"
"Washington","2020-12-22","30","4248","1","513","13.2","13.5"
"Washington","2020-12-23","28","4276","3","516","12.2","13.3"
"Washington","2020-12-24","27","4303","10","526","15.3","15.2"
"Washington","2020-12-25","2","4305","0","526","13.3","14.2"
"Washington","2020-12-26","30","4335","12","538","17.4","15.3"
"Washington","2020-12-27","25","4360","7","545","17.8","17.3"
"Washington","2020-12-28","30","4390","6","551","19.9","17.9"
"Washington","2020-12-29","37","4427","6","557","21.7","17.4"
"Washington","2020-12-30","44","4471","14","571","24.7","18.5"
"Washington","2020-12-31","54","4525","12","583","22.6","18.9"
"Washington","2021-01-01","5","4530","1","584","25.5","19.4"
"Washington","2021-01-02","24","4554","10","594","25.7","21.5"
"Washington","2021-01-03","3","4557","2","596","31.2","24.5"
"Washington","2021-01-04","42","4599","10","606","31.8","25.8"
"Washington","2021-01-05","65","4664","19","625","33.6","27.7"
"Washington","2021-01-06","48","4712","15","640","33.5","29.1"
"Washington","2021-01-07","41","4753","13","653","34.9","28.8"
"Washington","2021-01-08","47","4800","12","665","35.7","30.6"
"Washington","2021-01-09","46","4846","14","679","34.1","29.9"
"Washington","2021-01-10","25","4871","7","686","28.6","29.9"
"Washington","2021-01-11","35","4906","12","698","30.1","30.9"
"Washington","2021-01-12","68","4974","7","705","27.4","30.5"
"Washington","2021-01-13","39","5013","6","711","25.1","29.3"
"Washington","2021-01-14","47","5060","10","721","23.6","29.3"
"Washington","2021-01-15","51","5111","9","730","22.5","29.1"
"Washington","2021-01-16","29","5140","8","738","22.1","28.1"
"Washington","2021-01-17","14","5154","1","739","19.1","23.8"
"Washington","2021-01-18","36","5190","9","748","17.8","23.9"
"Washington","2021-01-19","50","5240","13","761","20","23.7"
"Washington","2021-01-20","42","5282","5","766","19.5","22.3"
"Washington","2021-01-21","45","5327","7","773","18.7","21.1"
"Washington","2021-01-22","43","5370","6","779","18.2","20.3"
"Washington","2021-01-23","34","5404","8","787","17.6","19.8"
"Washington","2021-01-24","16","5420","4","791","20.1","19.6"
"Washington","2021-01-25","8","5428","0","791","16.6","17.2"
"Washington","2021-01-26","6","5434","0","791","12.8","16.4"
"Washington","2021-01-27","0","5434","0","791","11.1","15.3"
"Wayne","2020-02-01","0","0","0","0",".","."
"Wayne","2020-02-02","0","0","0","0",".","."
"Wayne","2020-02-03","0","0","0","0",".","."
"Wayne","2020-02-04","0","0","0","0",".","."
"Wayne","2020-02-05","0","0","0","0",".","."
"Wayne","2020-02-06","0","0","0","0",".","."
"Wayne","2020-02-07","0","0","0","0","0","."
"Wayne","2020-02-08","0","0","0","0","0","."
"Wayne","2020-02-09","0","0","0","0","0","."
"Wayne","2020-02-10","0","0","0","0","0","."
"Wayne","2020-02-11","0","0","0","0","0","."
"Wayne","2020-02-12","0","0","0","0","0","."
"Wayne","2020-02-13","0","0","0","0","0","."
"Wayne","2020-02-14","0","0","0","0","0","0"
"Wayne","2020-02-15","0","0","0","0","0","0"
"Wayne","2020-02-16","0","0","0","0","0","0"
"Wayne","2020-02-17","0","0","0","0","0","0"
"Wayne","2020-02-18","0","0","0","0","0","0"
"Wayne","2020-02-19","0","0","0","0","0","0"
"Wayne","2020-02-20","0","0","0","0","0","0"
"Wayne","2020-02-21","0","0","0","0","0","0"
"Wayne","2020-02-22","0","0","0","0","0","0"
"Wayne","2020-02-23","0","0","0","0","0","0"
"Wayne","2020-02-24","0","0","0","0","0","0"
"Wayne","2020-02-25","0","0","0","0","0","0"
"Wayne","2020-02-26","0","0","0","0","0","0"
"Wayne","2020-02-27","0","0","0","0","0","0"
"Wayne","2020-02-28","0","0","0","0","0","0"
"Wayne","2020-02-29","0","0","0","0","0","0"
"Wayne","2020-03-01","0","0","0","0","0","0"
"Wayne","2020-03-02","0","0","0","0","0","0"
"Wayne","2020-03-03","0","0","0","0","0","0"
"Wayne","2020-03-04","0","0","0","0","0","0"
"Wayne","2020-03-05","0","0","0","0","0","0"
"Wayne","2020-03-06","0","0","0","0","0","0"
"Wayne","2020-03-07","0","0","0","0","0","0"
"Wayne","2020-03-08","0","0","0","0","0","0"
"Wayne","2020-03-09","0","0","0","0","0","0"
"Wayne","2020-03-10","0","0","0","0","0","0"
"Wayne","2020-03-11","0","0","0","0","0","0"
"Wayne","2020-03-12","1","1","0","0","0","0"
"Wayne","2020-03-13","0","1","0","0","0","0"
"Wayne","2020-03-14","0","1","0","0","0","0"
"Wayne","2020-03-15","4","5","0","0","0","0"
"Wayne","2020-03-16","0","5","0","0","0","0"
"Wayne","2020-03-17","6","11","0","0","0","0"
"Wayne","2020-03-18","4","15","0","0","0","0"
"Wayne","2020-03-19","8","23","0","0","0","0"
"Wayne","2020-03-20","12","35","0","0","0","0"
"Wayne","2020-03-21","2","37","0","0","0","0"
"Wayne","2020-03-22","0","37","0","0","0","0"
"Wayne","2020-03-23","17","54","0","0","0","0"
"Wayne","2020-03-24","15","69","1","1","1","0.5"
"Wayne","2020-03-25","6","75","0","1","1","0.5"
"Wayne","2020-03-26","9","84","0","1","1","0.5"
"Wayne","2020-03-27","9","93","0","1","1","0.5"
"Wayne","2020-03-28","2","95","0","1","1","0.5"
"Wayne","2020-03-29","5","100","1","2","3.8","1.9"
"Wayne","2020-03-30","13","113","1","3","4.9","2.5"
"Wayne","2020-03-31","13","126","1","4","5.1","3"
"Wayne","2020-04-01","7","133","0","4","5.1","3"
"Wayne","2020-04-02","16","149","0","4","5.1","3"
"Wayne","2020-04-03","9","158","0","4","5.1","3"
"Wayne","2020-04-04","13","171","0","4","5.1","3"
"Wayne","2020-04-05","4","175","1","5","5.8","4.8"
"Wayne","2020-04-06","18","193","0","5","4.7","4.8"
"Wayne","2020-04-07","18","211","0","5","3.6","4.3"
"Wayne","2020-04-08","18","229","0","5","3.6","4.3"
"Wayne","2020-04-09","20","249","0","5","3.6","4.3"
"Wayne","2020-04-10","10","259","2","7","6.4","5.7"
"Wayne","2020-04-11","4","263","0","7","6.4","5.7"
"Wayne","2020-04-12","2","265","0","7","2.9","4.3"
"Wayne","2020-04-13","7","272","0","7","2.9","3.8"
"Wayne","2020-04-14","11","283","2","9","5.5","4.5"
"Wayne","2020-04-15","15","298","1","10","6.4","5"
"Wayne","2020-04-16","21","319","0","10","6.4","5"
"Wayne","2020-04-17","17","336","1","11","4.4","5.4"
"Wayne","2020-04-18","14","350","0","11","4.4","5.4"
"Wayne","2020-04-19","9","359","1","12","6","4.4"
"Wayne","2020-04-20","5","364","0","12","6","4.4"
"Wayne","2020-04-21","10","374","0","12","3.4","4.4"
"Wayne","2020-04-22","10","384","0","12","2.4","4.4"
"Wayne","2020-04-23","15","399","0","12","2.4","4.4"
"Wayne","2020-04-24","7","406","1","13","3.6","4"
"Wayne","2020-04-25","4","410","0","13","3.6","4"
"Wayne","2020-04-26","4","414","0","13","2","4"
"Wayne","2020-04-27","19","433","1","14","2.8","4.4"
"Wayne","2020-04-28","10","443","0","14","2.8","3.1"
"Wayne","2020-04-29","20","463","0","14","2.8","2.6"
"Wayne","2020-04-30","20","483","0","14","2.8","2.6"
"Wayne","2020-05-01","17","500","0","14","0.8","2.2"
"Wayne","2020-05-02","10","510","0","14","0.8","2.2"
"Wayne","2020-05-03","5","515","0","14","0.8","1.4"
"Wayne","2020-05-04","19","534","0","14","0","1.4"
"Wayne","2020-05-05","17","551","0","14","0","1.4"
"Wayne","2020-05-06","18","569","0","14","0","1.4"
"Wayne","2020-05-07","20","589","0","14","0","1.4"
"Wayne","2020-05-08","11","600","0","14","0","0.4"
"Wayne","2020-05-09","3","603","0","14","0","0.4"
"Wayne","2020-05-10","6","609","0","14","0","0.4"
"Wayne","2020-05-11","91","700","0","14","0","0"
"Wayne","2020-05-12","10","710","0","14","0","0"
"Wayne","2020-05-13","9","719","0","14","0","0"
"Wayne","2020-05-14","23","742","1","15","0.6","0.3"
"Wayne","2020-05-15","13","755","0","15","0.6","0.3"
"Wayne","2020-05-16","7","762","1","16","2.7","1.3"
"Wayne","2020-05-17","4","766","0","16","2.7","1.3"
"Wayne","2020-05-18","24","790","0","16","2.7","1.3"
"Wayne","2020-05-19","13","803","0","16","2.7","1.3"
"Wayne","2020-05-20","20","823","0","16","2.7","1.3"
"Wayne","2020-05-21","16","839","0","16","2","1.3"
"Wayne","2020-05-22","7","846","0","16","2","1.3"
"Wayne","2020-05-23","4","850","0","16","0","1.3"
"Wayne","2020-05-24","5","855","0","16","0","1.3"
"Wayne","2020-05-25","7","862","0","16","0","1.3"
"Wayne","2020-05-26","13","875","1","17","1.1","1.9"
"Wayne","2020-05-27","8","883","0","17","1.1","1.9"
"Wayne","2020-05-28","20","903","0","17","1.1","1.6"
"Wayne","2020-05-29","13","916","0","17","1.1","1.6"
"Wayne","2020-05-30","3","919","0","17","1.1","0.5"
"Wayne","2020-05-31","2","921","0","17","1.1","0.5"
"Wayne","2020-06-01","25","946","1","18","1.7","0.8"
"Wayne","2020-06-02","21","967","0","18","0.6","0.8"
"Wayne","2020-06-03","17","984","0","18","0.6","0.8"
"Wayne","2020-06-04","23","1007","0","18","0.6","0.8"
"Wayne","2020-06-05","10","1017","0","18","0.6","0.8"
"Wayne","2020-06-06","2","1019","0","18","0.6","0.8"
"Wayne","2020-06-07","3","1022","1","19","5.3","3.2"
"Wayne","2020-06-08","21","1043","0","19","4.8","3.2"
"Wayne","2020-06-09","21","1064","3","22","6.8","3.7"
"Wayne","2020-06-10","22","1086","0","22","6.8","3.7"
"Wayne","2020-06-11","29","1115","0","22","6.8","3.7"
"Wayne","2020-06-12","11","1126","1","23","8.1","4.3"
"Wayne","2020-06-13","11","1137","0","23","8.1","4.3"
"Wayne","2020-06-14","1","1138","0","23","3.3","4.3"
"Wayne","2020-06-15","111","1249","3","26","3.7","4.2"
"Wayne","2020-06-16","113","1362","2","28","1.9","4.4"
"Wayne","2020-06-17","108","1470","1","29","2.1","4.4"
"Wayne","2020-06-18","37","1507","1","30","2.5","4.6"
"Wayne","2020-06-19","36","1543","4","34","2.7","5.4"
"Wayne","2020-06-20","8","1551","2","36","6.3","7.2"
"Wayne","2020-06-21","16","1567","4","40","9.9","6.6"
"Wayne","2020-06-22","118","1685","14","54","11.2","7.5"
"Wayne","2020-06-23","53","1738","7","61","12.8","7.4"
"Wayne","2020-06-24","49","1787","3","64","13.6","7.8"
"Wayne","2020-06-25","48","1835","9","73","15.9","9.2"
"Wayne","2020-06-26","70","1905","5","78","15.3","9"
"Wayne","2020-06-27","71","1976","6","84","12.9","9.6"
"Wayne","2020-06-28","15","1991","1","85","10.3","10.1"
"Wayne","2020-06-29","63","2054","8","93","10.4","10.8"
"Wayne","2020-06-30","49","2103","4","97","9.7","11.3"
"Wayne","2020-07-01","113","2216","8","105","9.9","11.7"
"Wayne","2020-07-02","50","2266","6","111","8.9","12.4"
"Wayne","2020-07-03","60","2326","10","121","10.2","12.8"
"Wayne","2020-07-04","41","2367","9","130","12.2","12.6"
"Wayne","2020-07-05","21","2388","5","135","14.6","12.5"
"Wayne","2020-07-06","83","2471","18","153","15.9","13.2"
"Wayne","2020-07-07","106","2577","19","172","17.3","13.5"
"Wayne","2020-07-08","84","2661","15","187","18.8","14.3"
"Wayne","2020-07-09","123","2784","11","198","18.4","13.6"
"Wayne","2020-07-10","77","2861","19","217","19.5","14.9"
"Wayne","2020-07-11","37","2898","9","226","19.9","16"
"Wayne","2020-07-12","29","2927","8","234","20.4","17.5"
"Wayne","2020-07-13","97","3024","27","261","21.3","18.6"
"Wayne","2020-07-14","123","3147","40","301","23.4","20.3"
"Wayne","2020-07-15","159","3306","76","377","27.7","23.3"
"Wayne","2020-07-16","210","3516","76","453","31.6","25"
"Wayne","2020-07-17","127","3643","49","502","33.5","26.5"
"Wayne","2020-07-18","42","3685","9","511","33.1","26.5"
"Wayne","2020-07-19","27","3712","2","513","30.3","25.3"
"Wayne","2020-07-20","81","3793","16","529","29.1","25.2"
"Wayne","2020-07-21","60","3853","13","542","27.5","25.5"
"Wayne","2020-07-22","74","3927","10","552","22.6","25.2"
"Wayne","2020-07-23","79","4006","22","574","21.5","26.5"
"Wayne","2020-07-24","48","4054","7","581","18","25.8"
"Wayne","2020-07-25","31","4085","3","584","16.3","24.7"
"Wayne","2020-07-26","13","4098","4","588","19.7","25"
"Wayne","2020-07-27","78","4176","15","603","19.6","24.4"
"Wayne","2020-07-28","99","4275","31","634","21","24.3"
"Wayne","2020-07-29","62","4337","10","644","21.4","22"
"Wayne","2020-07-30","93","4430","57","701","26.1","23.8"
"Wayne","2020-07-31","113","4543","42","743","29.4","23.7"
"Wayne","2020-08-01","105","4648","23","766","31.1","23.7"
"Wayne","2020-08-02","18","4666","2","768","28.3","24"
"Wayne","2020-08-03","48","4714","11","779","28.8","24.2"
"Wayne","2020-08-04","90","4804","14","793","26.6","23.8"
"Wayne","2020-08-05","64","4868","14","807","27.4","24.4"
"Wayne","2020-08-06","91","4959","24","831","22.4","24.3"
"Wayne","2020-08-07","146","5105","68","899","23.8","26.6"
"Wayne","2020-08-08","44","5149","11","910","24.2","27.7"
"Wayne","2020-08-09","21","5170","5","915","26","27.2"
"Wayne","2020-08-10","182","5352","72","987","28.4","28.6"
"Wayne","2020-08-11","88","5440","21","1008","29.6","28.1"
"Wayne","2020-08-12","56","5496","13","1021","29.8","28.6"
"Wayne","2020-08-13","59","5555","5","1026","27.2","24.8"
"Wayne","2020-08-14","53","5608","11","1037","23.5","23.6"
"Wayne","2020-08-15","34","5642","8","1045","23.3","23.8"
"Wayne","2020-08-16","16","5658","1","1046","20.8","23.4"
"Wayne","2020-08-17","111","5769","12","1058","16.7","22.5"
"Wayne","2020-08-18","86","5855","17","1075","16.1","22.8"
"Wayne","2020-08-19","71","5926","24","1099","17.6","23.7"
"Wayne","2020-08-20","89","6015","30","1129","21.2","24.2"
"Wayne","2020-08-21","51","6066","9","1138","20.8","22.2"
"Wayne","2020-08-22","38","6104","4","1142","18.9","21.1"
"Wayne","2020-08-23","36","6140","4","1146","19.6","20.2"
"Wayne","2020-08-24","56","6196","9","1155","20.4","18.5"
"Wayne","2020-08-25","53","6249","4","1159","18.6","17.4"
"Wayne","2020-08-26","55","6304","9","1168","16.1","16.9"
"Wayne","2020-08-27","49","6353","5","1173","12.8","17"
"Wayne","2020-08-28","70","6423","15","1188","13.3","17.1"
"Wayne","2020-08-29","42","6465","3","1191","12.8","15.9"
"Wayne","2020-08-30","32","6497","7","1198","14.4","17"
"Wayne","2020-08-31","67","6564","12","1210","14.6","17.5"
"Wayne","2020-09-01","82","6646","15","1225","16.2","17.4"
"Wayne","2020-09-02","89","6735","8","1233","15.1","15.6"
"Wayne","2020-09-03","57","6792","10","1243","16.2","14.5"
"Wayne","2020-09-04","109","6901","15","1258","15.1","14.2"
"Wayne","2020-09-05","27","6928","4","1262","16.2","14.5"
"Wayne","2020-09-06","24","6952","6","1268","16.6","15.5"
"Wayne","2020-09-07","35","6987","4","1272","15.7","15.2"
"Wayne","2020-09-08","95","7082","17","1289","15.6","15.9"
"Wayne","2020-09-09","72","7154","8","1297","15.9","15.5"
"Wayne","2020-09-10","76","7230","7","1304","14.7","15.5"
"Wayne","2020-09-11","36","7266","6","1310","15.2","15.1"
"Wayne","2020-09-12","43","7309","0","1310","13","14.6"
"Wayne","2020-09-13","33","7342","7","1317","12.5","14.6"
"Wayne","2020-09-14","95","7437","3","1320","11.3","13.5"
"Wayne","2020-09-15","75","7512","15","1335","11.6","13.6"
"Wayne","2020-09-16","44","7556","7","1342","12.3","14.1"
"Wayne","2020-09-17","79","7635","6","1348","12.1","13.4"
"Wayne","2020-09-18","58","7693","4","1352","10.7","12.9"
"Wayne","2020-09-19","24","7717","4","1356","13.1","13.1"
"Wayne","2020-09-20","20","7737","2","1358","11.5","12"
"Wayne","2020-09-21","54","7791","8","1366","13.1","12.2"
"Wayne","2020-09-22","60","7851","10","1376","12.6","12.1"
"Wayne","2020-09-23","61","7912","5","1381","11.5","11.9"
"Wayne","2020-09-24","87","7999","7","1388","11.6","11.8"
"Wayne","2020-09-25","26","8025","3","1391","12.3","11.5"
"Wayne","2020-09-26","24","8049","1","1392","10.5","11.8"
"Wayne","2020-09-27","25","8074","6","1398","12.5","12"
"Wayne","2020-09-28","51","8125","7","1405","12.3","12.7"
"Wayne","2020-09-29","52","8177","3","1408","10.8","11.7"
"Wayne","2020-09-30","61","8238","4","1412","10.5","11"
"Wayne","2020-10-01","87","8325","4","1416","10.1","10.8"
"Wayne","2020-10-02","31","8356","3","1419","9.8","11"
"Wayne","2020-10-03","20","8376","4","1423","12","11.3"
"Wayne","2020-10-04","18","8394","2","1425","10.2","11.3"
"Wayne","2020-10-05","48","8442","2","1427","8.8","10.6"
"Wayne","2020-10-06","90","8532","5","1432","8.8","9.8"
"Wayne","2020-10-07","44","8576","3","1435","8.8","9.7"
"Wayne","2020-10-08","94","8670","3","1438","8.6","9.3"
"Wayne","2020-10-09","44","8714","6","1444","9.2","9.5"
"Wayne","2020-10-10","20","8734","2","1446","7.8","9.9"
"Wayne","2020-10-11","12","8746","0","1446","6.2","8.2"
"Wayne","2020-10-12","54","8800","2","1448","6.1","7.5"
"Wayne","2020-10-13","57","8857","2","1450","5.8","7.3"
"Wayne","2020-10-14","36","8893","4","1454","6.5","7.6"
"Wayne","2020-10-15","105","8998","4","1458","6.5","7.6"
"Wayne","2020-10-16","38","9036","2","1460","5.3","7.3"
"Wayne","2020-10-17","18","9054","1","1461","4.7","6.2"
"Wayne","2020-10-18","18","9072","3","1464","7.1","6.6"
"Wayne","2020-10-19","88","9160","5","1469","7.4","6.8"
"Wayne","2020-10-20","73","9233","7","1476","8.2","7"
"Wayne","2020-10-21","39","9272","6","1482","8.9","7.7"
"Wayne","2020-10-22","75","9347","5","1487","9.3","7.9"
"Wayne","2020-10-23","138","9485","8","1495","9.3","7.3"
"Wayne","2020-10-24","23","9508","4","1499","11","7.9"
"Wayne","2020-10-25","19","9527","3","1502","10.9","9"
"Wayne","2020-10-26","50","9577","12","1514","13.5","10.4"
"Wayne","2020-10-27","66","9643","9","1523","14.1","11.2"
"Wayne","2020-10-28","51","9694","2","1525","12.5","10.7"
"Wayne","2020-10-29","67","9761","10","1535","13.6","11.4"
"Wayne","2020-10-30","159","9920","2","1537","13","11.2"
"Wayne","2020-10-31","31","9951","1","1538","11","11"
"Wayne","2020-11-01","15","9966","1","1539","9.7","10.3"
"Wayne","2020-11-02","46","10012","4","1543","7.5","10.5"
"Wayne","2020-11-03","36","10048","4","1547","7.1","10.6"
"Wayne","2020-11-04","50","10098","6","1553","8.3","10.4"
"Wayne","2020-11-05","47","10145","5","1558","7.7","10.6"
"Wayne","2020-11-06","84","10229","4","1562","8.2","10.6"
"Wayne","2020-11-07","21","10250","1","1563","8.4","9.7"
"Wayne","2020-11-08","22","10272","6","1569","11.3","10.5"
"Wayne","2020-11-09","40","10312","4","1573","11.5","9.5"
"Wayne","2020-11-10","53","10365","5","1578","11.3","9.2"
"Wayne","2020-11-11","48","10413","8","1586","11.9","10.1"
"Wayne","2020-11-12","61","10474","6","1592","11.8","9.7"
"Wayne","2020-11-13","32","10506","4","1596","12.9","10.5"
"Wayne","2020-11-14","21","10527","0","1596","12.2","10.3"
"Wayne","2020-11-15","17","10544","4","1600","11.7","11.5"
"Wayne","2020-11-16","61","10605","6","1606","11.7","11.6"
"Wayne","2020-11-17","147","10752","66","1672","16.8","14"
"Wayne","2020-11-18","54","10806","2","1674","14.9","13.4"
"Wayne","2020-11-19","155","10961","15","1689","14.9","13.3"
"Wayne","2020-11-20","33","10994","3","1692","14.4","13.7"
"Wayne","2020-11-21","17","11011","2","1694","16.1","14.2"
"Wayne","2020-11-22","17","11028","2","1696","14.4","13.1"
"Wayne","2020-11-23","84","11112","23","1719","16.9","14.3"
"Wayne","2020-11-24","59","11171","6","1725","11.9","14.3"
"Wayne","2020-11-25","43","11214","5","1730","13.1","14"
"Wayne","2020-11-26","24","11238","2","1732","12.9","13.9"
"Wayne","2020-11-27","59","11297","7","1739","13.3","13.8"
"Wayne","2020-11-28","41","11338","7","1746","14","15.1"
"Wayne","2020-11-29","24","11362","0","1746","12.3","13.4"
"Wayne","2020-11-30","44","11406","6","1752","10.4","13.6"
"Wayne","2020-12-01","161","11567","36","1788","12.1","12"
"Wayne","2020-12-02","66","11633","11","1799","12.8","13"
"Wayne","2020-12-03","60","11693","12","1811","14.5","13.7"
"Wayne","2020-12-04","52","11745","10","1821","15.6","14.4"
"Wayne","2020-12-05","19","11764","3","1824","15.4","14.7"
"Wayne","2020-12-06","14","11778","3","1827","18.4","15.4"
"Wayne","2020-12-07","53","11831","5","1832","17.8","14.1"
"Wayne","2020-12-08","83","11914","5","1837","15.5","13.8"
"Wayne","2020-12-09","63","11977","16","1853","16.8","14.8"
"Wayne","2020-12-10","41","12018","6","1859","16","15.3"
"Wayne","2020-12-11","54","12072","8","1867","15.4","15.5"
"Wayne","2020-12-12","44","12116","6","1873","15.1","15.2"
"Wayne","2020-12-13","32","12148","9","1882","16","17.2"
"Wayne","2020-12-14","91","12239","25","1907","18.6","18.2"
"Wayne","2020-12-15","96","12335","22","1929","21","18.3"
"Wayne","2020-12-16","68","12403","21","1950","21.8","19.3"
"Wayne","2020-12-17","74","12477","11","1961","21.8","18.9"
"Wayne","2020-12-18","79","12556","13","1974","22.1","18.7"
"Wayne","2020-12-19","55","12611","24","1998","26.3","20.7"
"Wayne","2020-12-20","25","12636","9","2007","27.5","21.7"
"Wayne","2020-12-21","66","12702","17","2024","27.2","22.9"
"Wayne","2020-12-22","59","12761","15","2039","27.6","24.3"
"Wayne","2020-12-23","119","12880","23","2062","25.9","23.9"
"Wayne","2020-12-24","34","12914","15","2077","30.1","26"
"Wayne","2020-12-25","14","12928","4","2081","31.8","26.9"
"Wayne","2020-12-26","31","12959","11","2092","30.7","28.5"
"Wayne","2020-12-27","28","12987","11","2103","31.1","29.3"
"Wayne","2020-12-28","85","13072","26","2129","31.8","29.5"
"Wayne","2020-12-29","101","13173","35","2164","33.1","30.4"
"Wayne","2020-12-30","80","13253","21","2185","34.1","30"
"Wayne","2020-12-31","100","13353","26","2211","31.5","30.8"
"Wayne","2021-01-01","16","13369","10","2221","36.4","34.1"
"Wayne","2021-01-02","40","13409","16","2237","37","33.9"
"Wayne","2021-01-03","25","13434","12","2249","38.3","34.7"
"Wayne","2021-01-04","151","13585","68","2317","40.3","36.1"
"Wayne","2021-01-05","163","13748","38","2355","38.7","35.9"
"Wayne","2021-01-06","137","13885","48","2403","40","37.1"
"Wayne","2021-01-07","78","13963","13","2416","38.6","35.1"
"Wayne","2021-01-08","69","14032","14","2430","32.6","34.5"
"Wayne","2021-01-09","61","14093","10","2440","29.2","33.1"
"Wayne","2021-01-10","27","14120","4","2444","24.5","31.4"
"Wayne","2021-01-11","101","14221","34","2478","22.9","31.6"
"Wayne","2021-01-12","115","14336","25","2503","22.7","30.7"
"Wayne","2021-01-13","81","14417","17","2520","20.7","30.3"
"Wayne","2021-01-14","94","14511","19","2539","21.2","29.9"
"Wayne","2021-01-15","54","14565","18","2557","23","27.8"
"Wayne","2021-01-16","41","14606","8","2565","23.5","26.4"
"Wayne","2021-01-17","25","14631","7","2572","25.3","24.9"
"Wayne","2021-01-18","59","14690","18","2590","24.9","23.9"
"Wayne","2021-01-19","79","14769","17","2607","24.9","23.8"
"Wayne","2021-01-20","85","14854","20","2627","25.2","22.9"
"Wayne","2021-01-21","81","14935","17","2644","25.3","23.2"
"Wayne","2021-01-22","61","14996","12","2656","23.4","23.2"
"Wayne","2021-01-23","28","15024","5","2661","23.2","23.3"
"Wayne","2021-01-24","14","15038","3","2664","22.2","23.8"
"Wayne","2021-01-25","19","15057","4","2668","20.9","22.9"
"Wayne","2021-01-26","1","15058","1","2669","32.1","28.5"
"Wayne","2021-01-27","0","15058","0","2669","28.7","27"
"Webster","2020-02-01","0","0","0","0",".","."
"Webster","2020-02-02","0","0","0","0",".","."
"Webster","2020-02-03","0","0","0","0",".","."
"Webster","2020-02-04","0","0","0","0",".","."
"Webster","2020-02-05","0","0","0","0",".","."
"Webster","2020-02-06","0","0","0","0",".","."
"Webster","2020-02-07","0","0","0","0","0","."
"Webster","2020-02-08","0","0","0","0","0","."
"Webster","2020-02-09","0","0","0","0","0","."
"Webster","2020-02-10","0","0","0","0","0","."
"Webster","2020-02-11","0","0","0","0","0","."
"Webster","2020-02-12","0","0","0","0","0","."
"Webster","2020-02-13","0","0","0","0","0","."
"Webster","2020-02-14","0","0","0","0","0","0"
"Webster","2020-02-15","0","0","0","0","0","0"
"Webster","2020-02-16","0","0","0","0","0","0"
"Webster","2020-02-17","0","0","0","0","0","0"
"Webster","2020-02-18","0","0","0","0","0","0"
"Webster","2020-02-19","0","0","0","0","0","0"
"Webster","2020-02-20","0","0","0","0","0","0"
"Webster","2020-02-21","0","0","0","0","0","0"
"Webster","2020-02-22","0","0","0","0","0","0"
"Webster","2020-02-23","0","0","0","0","0","0"
"Webster","2020-02-24","0","0","0","0","0","0"
"Webster","2020-02-25","0","0","0","0","0","0"
"Webster","2020-02-26","0","0","0","0","0","0"
"Webster","2020-02-27","0","0","0","0","0","0"
"Webster","2020-02-28","0","0","0","0","0","0"
"Webster","2020-02-29","0","0","0","0","0","0"
"Webster","2020-03-01","0","0","0","0","0","0"
"Webster","2020-03-02","0","0","0","0","0","0"
"Webster","2020-03-03","0","0","0","0","0","0"
"Webster","2020-03-04","0","0","0","0","0","0"
"Webster","2020-03-05","0","0","0","0","0","0"
"Webster","2020-03-06","0","0","0","0","0","0"
"Webster","2020-03-07","0","0","0","0","0","0"
"Webster","2020-03-08","0","0","0","0","0","0"
"Webster","2020-03-09","0","0","0","0","0","0"
"Webster","2020-03-10","0","0","0","0","0","0"
"Webster","2020-03-11","0","0","0","0","0","0"
"Webster","2020-03-12","0","0","0","0","0","0"
"Webster","2020-03-13","1","1","0","0","0","0"
"Webster","2020-03-14","2","3","0","0","0","0"
"Webster","2020-03-15","0","3","0","0","0","0"
"Webster","2020-03-16","0","3","0","0","0","0"
"Webster","2020-03-17","1","4","0","0","0","0"
"Webster","2020-03-18","1","5","1","1","14.3","7.1"
"Webster","2020-03-19","0","5","0","1","14.3","7.1"
"Webster","2020-03-20","0","5","0","1","14.3","7.1"
"Webster","2020-03-21","0","5","0","1","14.3","7.1"
"Webster","2020-03-22","0","5","0","1","14.3","7.1"
"Webster","2020-03-23","0","5","0","1","14.3","7.1"
"Webster","2020-03-24","1","6","0","1","14.3","7.1"
"Webster","2020-03-25","0","6","0","1","0","7.1"
"Webster","2020-03-26","0","6","0","1","0","7.1"
"Webster","2020-03-27","2","8","0","1","0","7.1"
"Webster","2020-03-28","1","9","1","2","14.3","14.3"
"Webster","2020-03-29","0","9","0","2","14.3","14.3"
"Webster","2020-03-30","1","10","0","2","14.3","14.3"
"Webster","2020-03-31","2","12","0","2","14.3","14.3"
"Webster","2020-04-01","1","13","0","2","14.3","7.1"
"Webster","2020-04-02","2","15","1","3","21.4","10.7"
"Webster","2020-04-03","0","15","0","3","21.4","10.7"
"Webster","2020-04-04","0","15","0","3","7.1","10.7"
"Webster","2020-04-05","0","15","0","3","7.1","10.7"
"Webster","2020-04-06","2","17","0","3","7.1","10.7"
"Webster","2020-04-07","3","20","0","3","7.1","10.7"
"Webster","2020-04-08","1","21","1","4","21.4","17.9"
"Webster","2020-04-09","1","22","0","4","14.3","17.9"
"Webster","2020-04-10","1","23","0","4","14.3","17.9"
"Webster","2020-04-11","2","25","0","4","14.3","10.7"
"Webster","2020-04-12","0","25","0","4","14.3","10.7"
"Webster","2020-04-13","0","25","0","4","14.3","10.7"
"Webster","2020-04-14","4","29","1","5","17.9","12.5"
"Webster","2020-04-15","4","33","1","6","7.1","14.3"
"Webster","2020-04-16","0","33","0","6","7.1","10.7"
"Webster","2020-04-17","1","34","1","7","21.4","17.9"
"Webster","2020-04-18","0","34","0","7","21.4","17.9"
"Webster","2020-04-19","0","34","0","7","21.4","17.9"
"Webster","2020-04-20","5","39","1","8","24.3","19.3"
"Webster","2020-04-21","0","39","0","8","20.7","19.3"
"Webster","2020-04-22","0","39","0","8","17.1","12.1"
"Webster","2020-04-23","0","39","0","8","17.1","12.1"
"Webster","2020-04-24","0","39","0","8","2.9","12.1"
"Webster","2020-04-25","4","43","1","9","6.4","13.9"
"Webster","2020-04-26","3","46","0","9","6.4","13.9"
"Webster","2020-04-27","0","46","0","9","3.6","13.9"
"Webster","2020-04-28","1","47","0","9","3.6","12.1"
"Webster","2020-04-29","4","51","0","9","3.6","10.4"
"Webster","2020-04-30","3","54","0","9","3.6","10.4"
"Webster","2020-05-01","1","55","0","9","3.6","3.2"
"Webster","2020-05-02","1","56","0","9","0","3.2"
"Webster","2020-05-03","0","56","0","9","0","3.2"
"Webster","2020-05-04","2","58","0","9","0","1.8"
"Webster","2020-05-05","5","63","1","10","2.9","3.2"
"Webster","2020-05-06","2","65","0","10","2.9","3.2"
"Webster","2020-05-07","0","65","0","10","2.9","3.2"
"Webster","2020-05-08","3","68","1","11","7.6","5.6"
"Webster","2020-05-09","2","70","0","11","7.6","3.8"
"Webster","2020-05-10","0","70","0","11","7.6","3.8"
"Webster","2020-05-11","4","74","0","11","7.6","3.8"
"Webster","2020-05-12","1","75","0","11","4.8","3.8"
"Webster","2020-05-13","6","81","0","11","4.8","3.8"
"Webster","2020-05-14","2","83","0","11","4.8","3.8"
"Webster","2020-05-15","2","85","0","11","0","3.8"
"Webster","2020-05-16","0","85","0","11","0","3.8"
"Webster","2020-05-17","1","86","0","11","0","3.8"
"Webster","2020-05-18","5","91","1","12","2.9","5.2"
"Webster","2020-05-19","4","95","0","12","2.9","3.8"
"Webster","2020-05-20","0","95","0","12","2.9","3.8"
"Webster","2020-05-21","3","98","0","12","2.9","3.8"
"Webster","2020-05-22","5","103","0","12","2.9","1.4"
"Webster","2020-05-23","0","103","0","12","2.9","1.4"
"Webster","2020-05-24","0","103","0","12","2.9","1.4"
"Webster","2020-05-25","0","103","0","12","0","1.4"
"Webster","2020-05-26","4","107","0","12","0","1.4"
"Webster","2020-05-27","0","107","0","12","0","1.4"
"Webster","2020-05-28","2","109","1","13","7.1","5"
"Webster","2020-05-29","9","118","0","13","7.1","5"
"Webster","2020-05-30","1","119","0","13","7.1","5"
"Webster","2020-05-31","0","119","0","13","7.1","5"
"Webster","2020-06-01","3","122","0","13","7.1","3.6"
"Webster","2020-06-02","0","122","0","13","7.1","3.6"
"Webster","2020-06-03","4","126","1","14","10.7","5.4"
"Webster","2020-06-04","5","131","0","14","3.6","5.4"
"Webster","2020-06-05","5","136","0","14","3.6","5.4"
"Webster","2020-06-06","4","140","0","14","3.6","5.4"
"Webster","2020-06-07","2","142","0","14","3.6","5.4"
"Webster","2020-06-08","2","144","0","14","3.6","5.4"
"Webster","2020-06-09","2","146","0","14","3.6","5.4"
"Webster","2020-06-10","1","147","0","14","0","5.4"
"Webster","2020-06-11","10","157","3","17","4.3","3.9"
"Webster","2020-06-12","11","168","3","20","8.2","5.9"
"Webster","2020-06-13","2","170","0","20","8.2","5.9"
"Webster","2020-06-14","0","170","0","20","8.2","5.9"
"Webster","2020-06-15","3","173","0","20","8.2","5.9"
"Webster","2020-06-16","2","175","0","20","8.2","5.9"
"Webster","2020-06-17","7","182","1","21","10.2","5.1"
"Webster","2020-06-18","4","186","0","21","5.9","5.1"
"Webster","2020-06-19","1","187","1","22","16.3","12.3"
"Webster","2020-06-20","3","190","2","24","25.9","17"
"Webster","2020-06-21","0","190","0","24","25.9","17"
"Webster","2020-06-22","9","199","3","27","30.6","19.4"
"Webster","2020-06-23","2","201","0","27","30.6","19.4"
"Webster","2020-06-24","1","202","0","27","28.6","19.4"
"Webster","2020-06-25","11","213","1","28","29.9","17.9"
"Webster","2020-06-26","6","219","0","28","15.6","16"
"Webster","2020-06-27","2","221","0","28","6.1","16"
"Webster","2020-06-28","2","223","0","28","6.1","16"
"Webster","2020-06-29","6","229","0","28","1.3","16"
"Webster","2020-06-30","0","229","0","28","1.3","16"
"Webster","2020-07-01","2","231","1","29","8.4","18.5"
"Webster","2020-07-02","17","248","4","33","10.5","20.2"
"Webster","2020-07-03","6","254","0","33","10.5","13"
"Webster","2020-07-04","1","255","0","33","10.5","8.3"
"Webster","2020-07-05","1","256","0","33","10.5","8.3"
"Webster","2020-07-06","5","261","0","33","10.5","5.9"
"Webster","2020-07-07","0","261","0","33","10.5","5.9"
"Webster","2020-07-08","3","264","0","33","3.4","5.9"
"Webster","2020-07-09","2","266","0","33","0","5.3"
"Webster","2020-07-10","6","272","0","33","0","5.3"
"Webster","2020-07-11","1","273","1","34","14.3","12.4"
"Webster","2020-07-12","1","274","0","34","14.3","12.4"
"Webster","2020-07-13","1","275","0","34","14.3","12.4"
"Webster","2020-07-14","3","278","0","34","14.3","12.4"
"Webster","2020-07-15","0","278","0","34","14.3","8.8"
"Webster","2020-07-16","3","281","0","34","14.3","7.1"
"Webster","2020-07-17","0","281","0","34","14.3","7.1"
"Webster","2020-07-18","1","282","0","34","0","7.1"
"Webster","2020-07-19","0","282","0","34","0","7.1"
"Webster","2020-07-20","8","290","1","35","1.8","8"
"Webster","2020-07-21","0","290","0","35","1.8","8"
"Webster","2020-07-22","3","293","0","35","1.8","8"
"Webster","2020-07-23","3","296","2","37","11.3","12.8"
"Webster","2020-07-24","3","299","0","37","11.3","12.8"
"Webster","2020-07-25","4","303","0","37","11.3","5.7"
"Webster","2020-07-26","1","304","0","37","11.3","5.7"
"Webster","2020-07-27","26","330","0","37","9.5","5.7"
"Webster","2020-07-28","6","336","1","38","11.9","6.8"
"Webster","2020-07-29","0","336","0","38","11.9","6.8"
"Webster","2020-07-30","2","338","0","38","2.4","6.8"
"Webster","2020-07-31","1","339","1","39","16.7","14"
"Webster","2020-08-01","3","342","1","40","21.4","16.4"
"Webster","2020-08-02","0","342","0","40","21.4","16.4"
"Webster","2020-08-03","7","349","0","40","21.4","15.5"
"Webster","2020-08-04","3","352","0","40","19","15.5"
"Webster","2020-08-05","2","354","0","40","19","15.5"
"Webster","2020-08-06","3","357","0","40","19","10.7"
"Webster","2020-08-07","5","362","1","41","7.6","12.1"
"Webster","2020-08-08","1","363","0","41","2.9","12.1"
"Webster","2020-08-09","0","363","0","41","2.9","12.1"
"Webster","2020-08-10","2","365","1","42","10","15.7"
"Webster","2020-08-11","0","365","0","42","10","14.5"
"Webster","2020-08-12","1","366","0","42","10","14.5"
"Webster","2020-08-13","2","368","0","42","10","14.5"
"Webster","2020-08-14","4","372","0","42","7.1","7.4"
"Webster","2020-08-15","0","372","0","42","7.1","5"
"Webster","2020-08-16","1","373","0","42","7.1","5"
"Webster","2020-08-17","2","375","0","42","0","5"
"Webster","2020-08-18","1","376","0","42","0","5"
"Webster","2020-08-19","1","377","0","42","0","5"
"Webster","2020-08-20","1","378","0","42","0","5"
"Webster","2020-08-21","4","382","0","42","0","3.6"
"Webster","2020-08-22","2","384","1","43","7.1","7.1"
"Webster","2020-08-23","0","384","0","43","7.1","7.1"
"Webster","2020-08-24","9","393","0","43","7.1","3.6"
"Webster","2020-08-25","0","393","0","43","7.1","3.6"
"Webster","2020-08-26","1","394","0","43","7.1","3.6"
"Webster","2020-08-27","4","398","0","43","7.1","3.6"
"Webster","2020-08-28","0","398","0","43","7.1","3.6"
"Webster","2020-08-29","0","398","0","43","0","3.6"
"Webster","2020-08-30","0","398","0","43","0","3.6"
"Webster","2020-08-31","11","409","1","44","1.3","4.2"
"Webster","2020-09-01","0","409","0","44","1.3","4.2"
"Webster","2020-09-02","0","409","0","44","1.3","4.2"
"Webster","2020-09-03","5","414","0","44","1.3","4.2"
"Webster","2020-09-04","5","419","0","44","1.3","4.2"
"Webster","2020-09-05","2","421","1","45","8.4","4.2"
"Webster","2020-09-06","0","421","0","45","8.4","4.2"
"Webster","2020-09-07","0","421","0","45","7.1","4.2"
"Webster","2020-09-08","1","422","0","45","7.1","4.2"
"Webster","2020-09-09","3","425","0","45","7.1","4.2"
"Webster","2020-09-10","2","427","0","45","7.1","4.2"
"Webster","2020-09-11","1","428","1","46","21.4","11.4"
"Webster","2020-09-12","1","429","0","46","14.3","11.4"
"Webster","2020-09-13","1","430","0","46","14.3","11.4"
"Webster","2020-09-14","3","433","0","46","14.3","10.7"
"Webster","2020-09-15","0","433","0","46","14.3","10.7"
"Webster","2020-09-16","1","434","0","46","14.3","10.7"
"Webster","2020-09-17","3","437","0","46","14.3","10.7"
"Webster","2020-09-18","5","442","0","46","0","10.7"
"Webster","2020-09-19","0","442","0","46","0","7.1"
"Webster","2020-09-20","0","442","0","46","0","7.1"
"Webster","2020-09-21","6","448","1","47","2.4","8.3"
"Webster","2020-09-22","1","449","0","47","2.4","8.3"
"Webster","2020-09-23","1","450","0","47","2.4","8.3"
"Webster","2020-09-24","0","450","0","47","2.4","8.3"
"Webster","2020-09-25","2","452","0","47","2.4","1.2"
"Webster","2020-09-26","1","453","0","47","2.4","1.2"
"Webster","2020-09-27","0","453","0","47","2.4","1.2"
"Webster","2020-09-28","9","462","1","48","1.6","2"
"Webster","2020-09-29","1","463","0","48","1.6","2"
"Webster","2020-09-30","2","465","0","48","1.6","2"
"Webster","2020-10-01","0","465","0","48","1.6","2"
"Webster","2020-10-02","2","467","0","48","1.6","2"
"Webster","2020-10-03","2","469","0","48","1.6","2"
"Webster","2020-10-04","0","469","0","48","1.6","2"
"Webster","2020-10-05","1","470","0","48","0","0.8"
"Webster","2020-10-06","0","470","0","48","0","0.8"
"Webster","2020-10-07","7","477","0","48","0","0.8"
"Webster","2020-10-08","0","477","0","48","0","0.8"
"Webster","2020-10-09","1","478","0","48","0","0.8"
"Webster","2020-10-10","1","479","0","48","0","0.8"
"Webster","2020-10-11","1","480","0","48","0","0.8"
"Webster","2020-10-12","1","481","0","48","0","0"
"Webster","2020-10-13","0","481","0","48","0","0"
"Webster","2020-10-14","3","484","0","48","0","0"
"Webster","2020-10-15","4","488","0","48","0","0"
"Webster","2020-10-16","3","491","0","48","0","0"
"Webster","2020-10-17","0","491","0","48","0","0"
"Webster","2020-10-18","1","492","0","48","0","0"
"Webster","2020-10-19","4","496","0","48","0","0"
"Webster","2020-10-20","2","498","0","48","0","0"
"Webster","2020-10-21","2","500","1","49","7.1","3.6"
"Webster","2020-10-22","1","501","0","49","7.1","3.6"
"Webster","2020-10-23","0","501","0","49","7.1","3.6"
"Webster","2020-10-24","0","501","0","49","7.1","3.6"
"Webster","2020-10-25","2","503","0","49","7.1","3.6"
"Webster","2020-10-26","0","503","0","49","7.1","3.6"
"Webster","2020-10-27","4","507","0","49","7.1","3.6"
"Webster","2020-10-28","2","509","0","49","0","3.6"
"Webster","2020-10-29","1","510","0","49","0","3.6"
"Webster","2020-10-30","1","511","0","49","0","3.6"
"Webster","2020-10-31","2","513","0","49","0","3.6"
"Webster","2020-11-01","1","514","0","49","0","3.6"
"Webster","2020-11-02","2","516","0","49","0","3.6"
"Webster","2020-11-03","3","519","0","49","0","3.6"
"Webster","2020-11-04","1","520","0","49","0","0"
"Webster","2020-11-05","1","521","0","49","0","0"
"Webster","2020-11-06","3","524","0","49","0","0"
"Webster","2020-11-07","0","524","0","49","0","0"
"Webster","2020-11-08","1","525","0","49","0","0"
"Webster","2020-11-09","7","532","0","49","0","0"
"Webster","2020-11-10","1","533","0","49","0","0"
"Webster","2020-11-11","5","538","0","49","0","0"
"Webster","2020-11-12","2","540","0","49","0","0"
"Webster","2020-11-13","2","542","0","49","0","0"
"Webster","2020-11-14","1","543","0","49","0","0"
"Webster","2020-11-15","1","544","0","49","0","0"
"Webster","2020-11-16","11","555","0","49","0","0"
"Webster","2020-11-17","1","556","0","49","0","0"
"Webster","2020-11-18","3","559","0","49","0","0"
"Webster","2020-11-19","0","559","0","49","0","0"
"Webster","2020-11-20","4","563","0","49","0","0"
"Webster","2020-11-21","0","563","0","49","0","0"
"Webster","2020-11-22","0","563","0","49","0","0"
"Webster","2020-11-23","5","568","1","50","2.9","1.4"
"Webster","2020-11-24","1","569","0","50","2.9","1.4"
"Webster","2020-11-25","1","570","0","50","2.9","1.4"
"Webster","2020-11-26","2","572","0","50","2.9","1.4"
"Webster","2020-11-27","0","572","0","50","2.9","1.4"
"Webster","2020-11-28","0","572","0","50","2.9","1.4"
"Webster","2020-11-29","1","573","0","50","2.9","1.4"
"Webster","2020-11-30","5","578","0","50","0","1.4"
"Webster","2020-12-01","1","579","0","50","0","1.4"
"Webster","2020-12-02","3","582","0","50","0","1.4"
"Webster","2020-12-03","3","585","0","50","0","1.4"
"Webster","2020-12-04","3","588","0","50","0","1.4"
"Webster","2020-12-05","0","588","0","50","0","1.4"
"Webster","2020-12-06","2","590","0","50","0","1.4"
"Webster","2020-12-07","13","603","1","51","1.1","0.5"
"Webster","2020-12-08","2","605","0","51","1.1","0.5"
"Webster","2020-12-09","3","608","0","51","1.1","0.5"
"Webster","2020-12-10","1","609","0","51","1.1","0.5"
"Webster","2020-12-11","4","613","0","51","1.1","0.5"
"Webster","2020-12-12","1","614","0","51","1.1","0.5"
"Webster","2020-12-13","2","616","0","51","1.1","0.5"
"Webster","2020-12-14","14","630","0","51","0","0.5"
"Webster","2020-12-15","1","631","0","51","0","0.5"
"Webster","2020-12-16","3","634","0","51","0","0.5"
"Webster","2020-12-17","5","639","1","52","2.9","2"
"Webster","2020-12-18","3","642","0","52","2.9","2"
"Webster","2020-12-19","1","643","1","53","17.1","9.1"
"Webster","2020-12-20","1","644","0","53","17.1","9.1"
"Webster","2020-12-21","19","663","2","55","18.6","9.3"
"Webster","2020-12-22","3","666","1","56","23.4","11.7"
"Webster","2020-12-23","4","670","0","56","23.4","11.7"
"Webster","2020-12-24","0","670","0","56","20.6","11.7"
"Webster","2020-12-25","0","670","0","56","20.6","11.7"
"Webster","2020-12-26","1","671","1","57","20.6","18.8"
"Webster","2020-12-27","2","673","0","57","20.6","18.8"
"Webster","2020-12-28","3","676","2","59","28.6","23.6"
"Webster","2020-12-29","2","678","0","59","23.8","23.6"
"Webster","2020-12-30","2","680","0","59","23.8","23.6"
"Webster","2020-12-31","2","682","1","60","31","25.8"
"Webster","2021-01-01","0","682","0","60","31","25.8"
"Webster","2021-01-02","0","682","0","60","16.7","18.6"
"Webster","2021-01-03","1","683","0","60","16.7","18.6"
"Webster","2021-01-04","20","703","4","64","10","19.3"
"Webster","2021-01-05","0","703","0","64","10","16.9"
"Webster","2021-01-06","2","705","0","64","10","16.9"
"Webster","2021-01-07","5","710","0","64","2.9","16.9"
"Webster","2021-01-08","0","710","0","64","2.9","16.9"
"Webster","2021-01-09","1","711","0","64","2.9","9.8"
"Webster","2021-01-10","0","711","0","64","2.9","9.8"
"Webster","2021-01-11","17","728","2","66","1.7","5.8"
"Webster","2021-01-12","2","730","0","66","1.7","5.8"
"Webster","2021-01-13","2","732","0","66","1.7","5.8"
"Webster","2021-01-14","4","736","1","67","5.3","4.1"
"Webster","2021-01-15","2","738","0","67","5.3","4.1"
"Webster","2021-01-16","1","739","1","68","19.5","11.2"
"Webster","2021-01-17","1","740","1","69","33.8","18.3"
"Webster","2021-01-18","2","742","0","69","32.1","16.9"
"Webster","2021-01-19","2","744","2","71","46.4","24.1"
"Webster","2021-01-20","1","745","0","71","46.4","24.1"
"Webster","2021-01-21","1","746","1","72","57.1","31.2"
"Webster","2021-01-22","5","751","1","73","60","32.6"
"Webster","2021-01-23","1","752","1","74","60","39.8"
"Webster","2021-01-24","1","753","0","74","45.7","39.8"
"Webster","2021-01-25","2","755","0","74","45.7","38.9"
"Webster","2021-01-26","2","757","2","76","45.7","46.1"
"Webster","2021-01-27","0","757","0","76","45.7","46.1"
"Wheeler","2020-02-01","0","0","0","0",".","."
"Wheeler","2020-02-02","0","0","0","0",".","."
"Wheeler","2020-02-03","0","0","0","0",".","."
"Wheeler","2020-02-04","0","0","0","0",".","."
"Wheeler","2020-02-05","0","0","0","0",".","."
"Wheeler","2020-02-06","0","0","0","0",".","."
"Wheeler","2020-02-07","0","0","0","0","0","."
"Wheeler","2020-02-08","0","0","0","0","0","."
"Wheeler","2020-02-09","0","0","0","0","0","."
"Wheeler","2020-02-10","0","0","0","0","0","."
"Wheeler","2020-02-11","0","0","0","0","0","."
"Wheeler","2020-02-12","0","0","0","0","0","."
"Wheeler","2020-02-13","0","0","0","0","0","."
"Wheeler","2020-02-14","0","0","0","0","0","0"
"Wheeler","2020-02-15","0","0","0","0","0","0"
"Wheeler","2020-02-16","0","0","0","0","0","0"
"Wheeler","2020-02-17","0","0","0","0","0","0"
"Wheeler","2020-02-18","0","0","0","0","0","0"
"Wheeler","2020-02-19","0","0","0","0","0","0"
"Wheeler","2020-02-20","0","0","0","0","0","0"
"Wheeler","2020-02-21","0","0","0","0","0","0"
"Wheeler","2020-02-22","0","0","0","0","0","0"
"Wheeler","2020-02-23","0","0","0","0","0","0"
"Wheeler","2020-02-24","0","0","0","0","0","0"
"Wheeler","2020-02-25","0","0","0","0","0","0"
"Wheeler","2020-02-26","0","0","0","0","0","0"
"Wheeler","2020-02-27","0","0","0","0","0","0"
"Wheeler","2020-02-28","0","0","0","0","0","0"
"Wheeler","2020-02-29","0","0","0","0","0","0"
"Wheeler","2020-03-01","0","0","0","0","0","0"
"Wheeler","2020-03-02","0","0","0","0","0","0"
"Wheeler","2020-03-03","0","0","0","0","0","0"
"Wheeler","2020-03-04","0","0","0","0","0","0"
"Wheeler","2020-03-05","0","0","0","0","0","0"
"Wheeler","2020-03-06","0","0","0","0","0","0"
"Wheeler","2020-03-07","0","0","0","0","0","0"
"Wheeler","2020-03-08","0","0","0","0","0","0"
"Wheeler","2020-03-09","0","0","0","0","0","0"
"Wheeler","2020-03-10","0","0","0","0","0","0"
"Wheeler","2020-03-11","0","0","0","0","0","0"
"Wheeler","2020-03-12","0","0","0","0","0","0"
"Wheeler","2020-03-13","0","0","0","0","0","0"
"Wheeler","2020-03-14","0","0","0","0","0","0"
"Wheeler","2020-03-15","0","0","0","0","0","0"
"Wheeler","2020-03-16","0","0","0","0","0","0"
"Wheeler","2020-03-17","0","0","0","0","0","0"
"Wheeler","2020-03-18","1","1","0","0","0","0"
"Wheeler","2020-03-19","1","2","0","0","0","0"
"Wheeler","2020-03-20","1","3","0","0","0","0"
"Wheeler","2020-03-21","0","3","0","0","0","0"
"Wheeler","2020-03-22","1","4","0","0","0","0"
"Wheeler","2020-03-23","1","5","0","0","0","0"
"Wheeler","2020-03-24","1","6","0","0","0","0"
"Wheeler","2020-03-25","1","7","0","0","0","0"
"Wheeler","2020-03-26","0","7","0","0","0","0"
"Wheeler","2020-03-27","2","9","1","1","7.1","3.6"
"Wheeler","2020-03-28","0","9","0","1","7.1","3.6"
"Wheeler","2020-03-29","0","9","0","1","7.1","3.6"
"Wheeler","2020-03-30","0","9","0","1","7.1","3.6"
"Wheeler","2020-03-31","2","11","0","1","7.1","3.6"
"Wheeler","2020-04-01","0","11","0","1","7.1","3.6"
"Wheeler","2020-04-02","0","11","0","1","7.1","3.6"
"Wheeler","2020-04-03","0","11","0","1","0","3.6"
"Wheeler","2020-04-04","2","13","0","1","0","3.6"
"Wheeler","2020-04-05","0","13","0","1","0","3.6"
"Wheeler","2020-04-06","0","13","0","1","0","3.6"
"Wheeler","2020-04-07","1","14","0","1","0","3.6"
"Wheeler","2020-04-08","1","15","1","2","14.3","10.7"
"Wheeler","2020-04-09","1","16","0","2","14.3","10.7"
"Wheeler","2020-04-10","0","16","0","2","14.3","7.1"
"Wheeler","2020-04-11","1","17","1","3","28.6","14.3"
"Wheeler","2020-04-12","0","17","0","3","28.6","14.3"
"Wheeler","2020-04-13","2","19","0","3","28.6","14.3"
"Wheeler","2020-04-14","1","20","0","3","28.6","14.3"
"Wheeler","2020-04-15","3","23","0","3","14.3","14.3"
"Wheeler","2020-04-16","0","23","0","3","14.3","14.3"
"Wheeler","2020-04-17","0","23","0","3","14.3","14.3"
"Wheeler","2020-04-18","0","23","0","3","0","14.3"
"Wheeler","2020-04-19","0","23","0","3","0","14.3"
"Wheeler","2020-04-20","0","23","0","3","0","14.3"
"Wheeler","2020-04-21","2","25","0","3","0","14.3"
"Wheeler","2020-04-22","1","26","0","3","0","7.1"
"Wheeler","2020-04-23","1","27","1","4","14.3","14.3"
"Wheeler","2020-04-24","0","27","0","4","14.3","14.3"
"Wheeler","2020-04-25","3","30","1","5","19","9.5"
"Wheeler","2020-04-26","1","31","0","5","19","9.5"
"Wheeler","2020-04-27","2","33","0","5","19","9.5"
"Wheeler","2020-04-28","1","34","0","5","19","9.5"
"Wheeler","2020-04-29","3","37","0","5","19","9.5"
"Wheeler","2020-04-30","1","38","0","5","4.8","9.5"
"Wheeler","2020-05-01","1","39","0","5","4.8","9.5"
"Wheeler","2020-05-02","0","39","0","5","0","9.5"
"Wheeler","2020-05-03","0","39","0","5","0","9.5"
"Wheeler","2020-05-04","0","39","0","5","0","9.5"
"Wheeler","2020-05-05","1","40","0","5","0","9.5"
"Wheeler","2020-05-06","0","40","0","5","0","9.5"
"Wheeler","2020-05-07","0","40","0","5","0","2.4"
"Wheeler","2020-05-08","0","40","0","5","0","2.4"
"Wheeler","2020-05-09","2","42","0","5","0","0"
"Wheeler","2020-05-10","0","42","0","5","0","0"
"Wheeler","2020-05-11","1","43","0","5","0","0"
"Wheeler","2020-05-12","1","44","0","5","0","0"
"Wheeler","2020-05-13","3","47","0","5","0","0"
"Wheeler","2020-05-14","2","49","0","5","0","0"
"Wheeler","2020-05-15","2","51","0","5","0","0"
"Wheeler","2020-05-16","2","53","1","6","7.1","3.6"
"Wheeler","2020-05-17","1","54","0","6","7.1","3.6"
"Wheeler","2020-05-18","0","54","0","6","7.1","3.6"
"Wheeler","2020-05-19","1","55","0","6","7.1","3.6"
"Wheeler","2020-05-20","2","57","0","6","7.1","3.6"
"Wheeler","2020-05-21","2","59","0","6","7.1","3.6"
"Wheeler","2020-05-22","1","60","0","6","7.1","3.6"
"Wheeler","2020-05-23","0","60","0","6","0","3.6"
"Wheeler","2020-05-24","0","60","0","6","0","3.6"
"Wheeler","2020-05-25","1","61","0","6","0","3.6"
"Wheeler","2020-05-26","1","62","0","6","0","3.6"
"Wheeler","2020-05-27","1","63","0","6","0","3.6"
"Wheeler","2020-05-28","1","64","0","6","0","3.6"
"Wheeler","2020-05-29","4","68","0","6","0","3.6"
"Wheeler","2020-05-30","0","68","0","6","0","0"
"Wheeler","2020-05-31","1","69","0","6","0","0"
"Wheeler","2020-06-01","26","95","0","6","0","0"
"Wheeler","2020-06-02","3","98","0","6","0","0"
"Wheeler","2020-06-03","0","98","0","6","0","0"
"Wheeler","2020-06-04","1","99","0","6","0","0"
"Wheeler","2020-06-05","2","101","0","6","0","0"
"Wheeler","2020-06-06","1","102","0","6","0","0"
"Wheeler","2020-06-07","0","102","0","6","0","0"
"Wheeler","2020-06-08","1","103","0","6","0","0"
"Wheeler","2020-06-09","5","108","0","6","0","0"
"Wheeler","2020-06-10","4","112","3","9","10.7","5.4"
"Wheeler","2020-06-11","0","112","0","9","10.7","5.4"
"Wheeler","2020-06-12","5","117","1","10","13.6","6.8"
"Wheeler","2020-06-13","7","124","6","16","25.8","12.9"
"Wheeler","2020-06-14","0","124","0","16","25.8","12.9"
"Wheeler","2020-06-15","1","125","0","16","25.8","12.9"
"Wheeler","2020-06-16","0","125","0","16","25.8","12.9"
"Wheeler","2020-06-17","1","126","1","17","29.4","20.1"
"Wheeler","2020-06-18","1","127","0","17","29.4","20.1"
"Wheeler","2020-06-19","2","129","0","17","26.5","20.1"
"Wheeler","2020-06-20","1","130","0","17","14.3","20.1"
"Wheeler","2020-06-21","1","131","0","17","14.3","20.1"
"Wheeler","2020-06-22","3","134","1","18","19","22.4"
"Wheeler","2020-06-23","3","137","0","18","19","22.4"
"Wheeler","2020-06-24","3","140","0","18","4.8","17.1"
"Wheeler","2020-06-25","6","146","2","20","9.5","19.5"
"Wheeler","2020-06-26","3","149","0","20","9.5","18"
"Wheeler","2020-06-27","1","150","0","20","9.5","11.9"
"Wheeler","2020-06-28","0","150","0","20","9.5","11.9"
"Wheeler","2020-06-29","5","155","0","20","4.8","11.9"
"Wheeler","2020-06-30","1","156","0","20","4.8","11.9"
"Wheeler","2020-07-01","4","160","1","21","8.3","6.5"
"Wheeler","2020-07-02","2","162","1","22","10.7","10.1"
"Wheeler","2020-07-03","33","195","1","23","11.1","10.3"
"Wheeler","2020-07-04","1","196","0","23","11.1","10.3"
"Wheeler","2020-07-05","0","196","0","23","11.1","10.3"
"Wheeler","2020-07-06","4","200","1","24","14.7","9.7"
"Wheeler","2020-07-07","1","201","0","24","14.7","9.7"
"Wheeler","2020-07-08","19","220","3","27","13.4","10.9"
"Wheeler","2020-07-09","1","221","0","27","6.3","8.5"
"Wheeler","2020-07-10","0","221","0","27","5.8","8.5"
"Wheeler","2020-07-11","1","222","1","28","20.1","15.6"
"Wheeler","2020-07-12","2","224","1","29","27.3","19.2"
"Wheeler","2020-07-13","5","229","0","29","23.7","19.2"
"Wheeler","2020-07-14","3","232","0","29","23.7","19.2"
"Wheeler","2020-07-15","2","234","0","29","21.4","17.4"
"Wheeler","2020-07-16","2","236","0","29","21.4","13.8"
"Wheeler","2020-07-17","3","239","1","30","26.2","16"
"Wheeler","2020-07-18","3","242","0","30","11.9","16"
"Wheeler","2020-07-19","0","242","0","30","4.8","16"
"Wheeler","2020-07-20","3","245","0","30","4.8","14.2"
"Wheeler","2020-07-21","2","247","0","30","4.8","14.2"
"Wheeler","2020-07-22","3","250","0","30","4.8","13.1"
"Wheeler","2020-07-23","1","251","0","30","4.8","13.1"
"Wheeler","2020-07-24","2","253","1","31","7.1","16.7"
"Wheeler","2020-07-25","3","256","0","31","7.1","9.5"
"Wheeler","2020-07-26","0","256","0","31","7.1","6"
"Wheeler","2020-07-27","3","259","1","32","11.9","8.3"
"Wheeler","2020-07-28","1","260","0","32","11.9","8.3"
"Wheeler","2020-07-29","3","263","1","33","16.7","10.7"
"Wheeler","2020-07-30","0","263","0","33","16.7","10.7"
"Wheeler","2020-07-31","9","272","2","35","12.7","9.9"
"Wheeler","2020-08-01","1","273","0","35","12.7","9.9"
"Wheeler","2020-08-02","3","276","1","36","17.5","12.3"
"Wheeler","2020-08-03","0","276","0","36","12.7","12.3"
"Wheeler","2020-08-04","2","278","2","38","27","19.4"
"Wheeler","2020-08-05","7","285","2","40","26.3","21.5"
"Wheeler","2020-08-06","2","287","1","41","33.4","25.1"
"Wheeler","2020-08-07","2","289","0","41","30.3","21.5"
"Wheeler","2020-08-08","2","291","0","41","30.3","21.5"
"Wheeler","2020-08-09","4","295","3","44","36.2","26.8"
"Wheeler","2020-08-10","5","300","1","45","39.1","25.9"
"Wheeler","2020-08-11","3","303","1","46","29.6","28.3"
"Wheeler","2020-08-12","2","305","0","46","25.5","25.9"
"Wheeler","2020-08-13","4","309","1","47","21.9","27.7"
"Wheeler","2020-08-14","1","310","1","48","36.2","33.2"
"Wheeler","2020-08-15","1","311","1","49","50.5","40.4"
"Wheeler","2020-08-16","2","313","1","50","46.9","41.6"
"Wheeler","2020-08-17","4","317","1","51","47.6","43.4"
"Wheeler","2020-08-18","6","323","0","51","42.9","36.2"
"Wheeler","2020-08-19","11","334","4","55","48.1","36.8"
"Wheeler","2020-08-20","4","338","1","56","48.1","35"
"Wheeler","2020-08-21","2","340","1","57","40.9","38.5"
"Wheeler","2020-08-22","2","342","2","59","40.9","45.7"
"Wheeler","2020-08-23","3","345","1","60","38.5","42.7"
"Wheeler","2020-08-24","5","350","4","64","46.4","47"
"Wheeler","2020-08-25","6","356","0","64","46.4","44.6"
"Wheeler","2020-08-26","2","358","2","66","55.5","51.8"
"Wheeler","2020-08-27","3","361","2","68","61.4","54.7"
"Wheeler","2020-08-28","2","363","0","68","54.3","47.6"
"Wheeler","2020-08-29","4","367","2","70","47.1","44"
"Wheeler","2020-08-30","1","368","1","71","56.7","47.6"
"Wheeler","2020-08-31","4","372","0","71","45.2","45.8"
"Wheeler","2020-09-01","54","426","5","76","46.6","46.5"
"Wheeler","2020-09-02","0","426","0","76","32.3","43.9"
"Wheeler","2020-09-03","3","429","0","76","22.8","42.1"
"Wheeler","2020-09-04","5","434","1","77","25.6","39.9"
"Wheeler","2020-09-05","1","435","0","77","18.5","32.8"
"Wheeler","2020-09-06","7","442","3","80","10.3","33.5"
"Wheeler","2020-09-07","0","442","0","80","10.3","27.8"
"Wheeler","2020-09-08","22","464","7","87","13.5","30"
"Wheeler","2020-09-09","2","466","1","88","20.7","26.5"
"Wheeler","2020-09-10","1","467","0","88","20.7","21.7"
"Wheeler","2020-09-11","2","469","0","88","17.8","21.7"
"Wheeler","2020-09-12","6","475","1","89","20.2","19.3"
"Wheeler","2020-09-13","0","475","0","89","14.1","12.2"
"Wheeler","2020-09-14","2","477","1","90","21.2","15.8"
"Wheeler","2020-09-15","33","510","3","93","18","15.7"
"Wheeler","2020-09-16","6","516","0","93","10.8","15.7"
"Wheeler","2020-09-17","6","522","1","94","13.2","16.9"
"Wheeler","2020-09-18","12","534","3","97","16.8","17.3"
"Wheeler","2020-09-19","2","536","0","97","14.4","17.3"
"Wheeler","2020-09-20","2","538","0","97","14.4","14.2"
"Wheeler","2020-09-21","6","544","0","97","7.3","14.2"
"Wheeler","2020-09-22","23","567","2","99","7.2","12.6"
"Wheeler","2020-09-23","6","573","0","99","7.2","9"
"Wheeler","2020-09-24","6","579","4","103","14.3","13.8"
"Wheeler","2020-09-25","0","579","0","103","10.8","13.8"
"Wheeler","2020-09-26","2","581","1","104","17.9","16.2"
"Wheeler","2020-09-27","2","583","0","104","17.9","16.2"
"Wheeler","2020-09-28","3","586","1","105","22.7","15"
"Wheeler","2020-09-29","51","637","5","110","22.8","15"
"Wheeler","2020-09-30","1","638","0","110","22.8","15"
"Wheeler","2020-10-01","5","643","0","110","13.3","13.8"
"Wheeler","2020-10-02","2","645","0","110","13.3","12"
"Wheeler","2020-10-03","2","647","0","110","6.2","12"
"Wheeler","2020-10-04","3","650","0","110","6.2","12"
"Wheeler","2020-10-05","6","656","1","111","3.8","13.2"
"Wheeler","2020-10-06","35","691","5","116","4.4","13.6"
"Wheeler","2020-10-07","3","694","0","116","4.4","13.6"
"Wheeler","2020-10-08","5","699","1","117","7.3","10.3"
"Wheeler","2020-10-09","7","706","0","117","7.3","10.3"
"Wheeler","2020-10-10","3","709","0","117","7.3","6.7"
"Wheeler","2020-10-11","3","712","0","117","7.3","6.7"
"Wheeler","2020-10-12","3","715","0","117","4.9","4.3"
"Wheeler","2020-10-13","27","742","5","122","5.5","5"
"Wheeler","2020-10-14","7","749","1","123","7.5","6"
"Wheeler","2020-10-15","2","751","0","123","4.7","6"
"Wheeler","2020-10-16","2","753","1","124","11.8","9.6"
"Wheeler","2020-10-17","3","756","0","124","11.8","9.6"
"Wheeler","2020-10-18","0","756","0","124","11.8","9.6"
"Wheeler","2020-10-19","2","758","1","125","19","11.9"
"Wheeler","2020-10-20","13","771","2","127","18.5","12"
"Wheeler","2020-10-21","5","776","1","128","19.3","13.4"
"Wheeler","2020-10-22","1","777","0","128","19.3","12"
"Wheeler","2020-10-23","0","777","0","128","12.2","12"
"Wheeler","2020-10-24","3","780","1","129","17","14.4"
"Wheeler","2020-10-25","3","783","0","129","17","14.4"
"Wheeler","2020-10-26","2","785","0","129","9.8","14.4"
"Wheeler","2020-10-27","18","803","0","129","7.6","13.1"
"Wheeler","2020-10-28","0","803","0","129","4.8","12.1"
"Wheeler","2020-10-29","3","806","0","129","4.8","12.1"
"Wheeler","2020-10-30","3","809","0","129","4.8","8.5"
"Wheeler","2020-10-31","1","810","0","129","0","8.5"
"Wheeler","2020-11-01","1","811","0","129","0","8.5"
"Wheeler","2020-11-02","0","811","0","129","0","4.9"
"Wheeler","2020-11-03","23","834","3","132","1.9","4.7"
"Wheeler","2020-11-04","1","835","0","132","1.9","3.3"
"Wheeler","2020-11-05","1","836","0","132","1.9","3.3"
"Wheeler","2020-11-06","0","836","0","132","1.9","3.3"
"Wheeler","2020-11-07","3","839","0","132","1.9","0.9"
"Wheeler","2020-11-08","0","839","0","132","1.9","0.9"
"Wheeler","2020-11-09","4","843","0","132","1.9","0.9"
"Wheeler","2020-11-10","17","860","0","132","0","0.9"
"Wheeler","2020-11-11","4","864","0","132","0","0.9"
"Wheeler","2020-11-12","3","867","0","132","0","0.9"
"Wheeler","2020-11-13","2","869","0","132","0","0.9"
"Wheeler","2020-11-14","0","869","0","132","0","0.9"
"Wheeler","2020-11-15","1","870","0","132","0","0.9"
"Wheeler","2020-11-16","4","874","0","132","0","0.9"
"Wheeler","2020-11-17","17","891","0","132","0","0"
"Wheeler","2020-11-18","0","891","0","132","0","0"
"Wheeler","2020-11-19","1","892","0","132","0","0"
"Wheeler","2020-11-20","3","895","0","132","0","0"
"Wheeler","2020-11-21","0","895","0","132","0","0"
"Wheeler","2020-11-22","2","897","0","132","0","0"
"Wheeler","2020-11-23","1","898","0","132","0","0"
"Wheeler","2020-11-24","13","911","2","134","2.2","1.1"
"Wheeler","2020-11-25","4","915","0","134","2.2","1.1"
"Wheeler","2020-11-26","1","916","0","134","2.2","1.1"
"Wheeler","2020-11-27","2","918","0","134","2.2","1.1"
"Wheeler","2020-11-28","1","919","0","134","2.2","1.1"
"Wheeler","2020-11-29","3","922","0","134","2.2","1.1"
"Wheeler","2020-11-30","3","925","0","134","2.2","1.1"
"Wheeler","2020-12-01","16","941","1","135","0.9","1.5"
"Wheeler","2020-12-02","5","946","1","136","3.8","3"
"Wheeler","2020-12-03","1","947","0","136","3.8","3"
"Wheeler","2020-12-04","5","952","0","136","3.8","3"
"Wheeler","2020-12-05","3","955","0","136","3.8","3"
"Wheeler","2020-12-06","1","956","0","136","3.8","3"
"Wheeler","2020-12-07","1","957","0","136","3.8","3"
"Wheeler","2020-12-08","15","972","4","140","6.7","3.8"
"Wheeler","2020-12-09","3","975","2","142","13.3","8.5"
"Wheeler","2020-12-10","2","977","0","142","13.3","8.5"
"Wheeler","2020-12-11","3","980","2","144","22.9","13.3"
"Wheeler","2020-12-12","1","981","0","144","22.9","13.3"
"Wheeler","2020-12-13","3","984","0","144","22.9","13.3"
"Wheeler","2020-12-14","9","993","0","144","22.9","13.3"
"Wheeler","2020-12-15","26","1019","2","146","20.1","13.4"
"Wheeler","2020-12-16","1","1020","0","146","10.6","12"
"Wheeler","2020-12-17","3","1023","1","147","15.4","14.4"
"Wheeler","2020-12-18","3","1026","0","147","5.9","14.4"
"Wheeler","2020-12-19","4","1030","0","147","5.9","14.4"
"Wheeler","2020-12-20","4","1034","0","147","5.9","14.4"
"Wheeler","2020-12-21","6","1040","0","147","5.9","14.4"
"Wheeler","2020-12-22","34","1074","7","154","7.7","13.9"
"Wheeler","2020-12-23","3","1077","1","155","12.5","11.5"
"Wheeler","2020-12-24","1","1078","1","156","22","18.7"
"Wheeler","2020-12-25","0","1078","0","156","22","13.9"
"Wheeler","2020-12-26","5","1083","2","158","27.7","16.8"
"Wheeler","2020-12-27","2","1085","1","159","34.8","20.4"
"Wheeler","2020-12-28","6","1091","1","160","37.2","21.5"
"Wheeler","2020-12-29","54","1145","13","173","37.7","22.7"
"Wheeler","2020-12-30","5","1150","2","175","38.7","25.6"
"Wheeler","2020-12-31","4","1154","1","176","28","25"
"Wheeler","2021-01-01","0","1154","0","176","28","25"
"Wheeler","2021-01-02","4","1158","0","176","22.2","25"
"Wheeler","2021-01-03","1","1159","0","176","15.1","25"
"Wheeler","2021-01-04","6","1165","3","179","19.9","28.5"
"Wheeler","2021-01-05","48","1213","11","190","19.7","28.7"
"Wheeler","2021-01-06","9","1222","4","194","20.3","29.5"
"Wheeler","2021-01-07","3","1225","1","195","21.5","24.7"
"Wheeler","2021-01-08","1","1226","0","195","21.5","24.7"
"Wheeler","2021-01-09","5","1231","0","195","21.5","21.9"
"Wheeler","2021-01-10","3","1234","1","196","26.3","20.7"
"Wheeler","2021-01-11","5","1239","0","196","19.1","19.5"
"Wheeler","2021-01-12","3","1242","0","196","15.9","17.8"
"Wheeler","2021-01-13","7","1249","1","197","11.6","16"
"Wheeler","2021-01-14","6","1255","2","199","11.6","16.5"
"Wheeler","2021-01-15","6","1261","1","200","13.9","17.7"
"Wheeler","2021-01-16","2","1263","0","200","13.9","17.7"
"Wheeler","2021-01-17","1","1264","1","201","23.5","24.9"
"Wheeler","2021-01-18","3","1267","0","201","23.5","21.3"
"Wheeler","2021-01-19","40","1307","8","209","26.3","21.1"
"Wheeler","2021-01-20","4","1311","0","209","24.3","17.9"
"Wheeler","2021-01-21","2","1313","0","209","19.5","15.5"
"Wheeler","2021-01-22","3","1316","0","209","17.1","15.5"
"Wheeler","2021-01-23","2","1318","0","209","17.1","15.5"
"Wheeler","2021-01-24","6","1324","4","213","12.4","17.9"
"Wheeler","2021-01-25","1","1325","0","213","12.4","17.9"
"Wheeler","2021-01-26","2","1327","0","213","9.5","17.9"
"Wheeler","2021-01-27","0","1327","0","213","9.5","16.9"
"White","2020-02-01","0","0","0","0",".","."
"White","2020-02-02","0","0","0","0",".","."
"White","2020-02-03","0","0","0","0",".","."
"White","2020-02-04","0","0","0","0",".","."
"White","2020-02-05","0","0","0","0",".","."
"White","2020-02-06","0","0","0","0",".","."
"White","2020-02-07","0","0","0","0","0","."
"White","2020-02-08","0","0","0","0","0","."
"White","2020-02-09","0","0","0","0","0","."
"White","2020-02-10","0","0","0","0","0","."
"White","2020-02-11","0","0","0","0","0","."
"White","2020-02-12","0","0","0","0","0","."
"White","2020-02-13","0","0","0","0","0","."
"White","2020-02-14","0","0","0","0","0","0"
"White","2020-02-15","0","0","0","0","0","0"
"White","2020-02-16","0","0","0","0","0","0"
"White","2020-02-17","0","0","0","0","0","0"
"White","2020-02-18","0","0","0","0","0","0"
"White","2020-02-19","0","0","0","0","0","0"
"White","2020-02-20","0","0","0","0","0","0"
"White","2020-02-21","0","0","0","0","0","0"
"White","2020-02-22","0","0","0","0","0","0"
"White","2020-02-23","0","0","0","0","0","0"
"White","2020-02-24","0","0","0","0","0","0"
"White","2020-02-25","0","0","0","0","0","0"
"White","2020-02-26","0","0","0","0","0","0"
"White","2020-02-27","0","0","0","0","0","0"
"White","2020-02-28","0","0","0","0","0","0"
"White","2020-02-29","0","0","0","0","0","0"
"White","2020-03-01","0","0","0","0","0","0"
"White","2020-03-02","0","0","0","0","0","0"
"White","2020-03-03","0","0","0","0","0","0"
"White","2020-03-04","0","0","0","0","0","0"
"White","2020-03-05","0","0","0","0","0","0"
"White","2020-03-06","0","0","0","0","0","0"
"White","2020-03-07","0","0","0","0","0","0"
"White","2020-03-08","0","0","0","0","0","0"
"White","2020-03-09","0","0","0","0","0","0"
"White","2020-03-10","0","0","0","0","0","0"
"White","2020-03-11","1","1","0","0","0","0"
"White","2020-03-12","0","1","0","0","0","0"
"White","2020-03-13","0","1","0","0","0","0"
"White","2020-03-14","0","1","0","0","0","0"
"White","2020-03-15","3","4","0","0","0","0"
"White","2020-03-16","7","11","0","0","0","0"
"White","2020-03-17","7","18","0","0","0","0"
"White","2020-03-18","6","24","0","0","0","0"
"White","2020-03-19","14","38","0","0","0","0"
"White","2020-03-20","5","43","0","0","0","0"
"White","2020-03-21","8","51","0","0","0","0"
"White","2020-03-22","7","58","1","1","2","1"
"White","2020-03-23","6","64","0","1","2","1"
"White","2020-03-24","9","73","0","1","2","1"
"White","2020-03-25","7","80","0","1","2","1"
"White","2020-03-26","0","80","0","1","2","1"
"White","2020-03-27","1","81","0","1","2","1"
"White","2020-03-28","0","81","0","1","2","1"
"White","2020-03-29","1","82","0","1","0","1"
"White","2020-03-30","1","83","0","1","0","1"
"White","2020-03-31","5","88","0","1","0","1"
"White","2020-04-01","1","89","0","1","0","1"
"White","2020-04-02","1","90","0","1","0","1"
"White","2020-04-03","1","91","0","1","0","1"
"White","2020-04-04","1","92","0","1","0","1"
"White","2020-04-05","0","92","0","1","0","0"
"White","2020-04-06","2","94","0","1","0","0"
"White","2020-04-07","3","97","0","1","0","0"
"White","2020-04-08","1","98","0","1","0","0"
"White","2020-04-09","2","100","1","2","7.1","3.6"
"White","2020-04-10","4","104","0","2","7.1","3.6"
"White","2020-04-11","0","104","0","2","7.1","3.6"
"White","2020-04-12","0","104","0","2","7.1","3.6"
"White","2020-04-13","3","107","0","2","7.1","3.6"
"White","2020-04-14","1","108","0","2","7.1","3.6"
"White","2020-04-15","7","115","0","2","7.1","3.6"
"White","2020-04-16","1","116","0","2","0","3.6"
"White","2020-04-17","5","121","0","2","0","3.6"
"White","2020-04-18","1","122","0","2","0","3.6"
"White","2020-04-19","0","122","0","2","0","3.6"
"White","2020-04-20","12","134","0","2","0","3.6"
"White","2020-04-21","7","141","1","3","2","4.6"
"White","2020-04-22","5","146","0","3","2","4.6"
"White","2020-04-23","5","151","0","3","2","1"
"White","2020-04-24","4","155","0","3","2","1"
"White","2020-04-25","4","159","0","3","2","1"
"White","2020-04-26","0","159","0","3","2","1"
"White","2020-04-27","5","164","0","3","2","1"
"White","2020-04-28","11","175","0","3","0","1"
"White","2020-04-29","26","201","0","3","0","1"
"White","2020-04-30","24","225","0","3","0","1"
"White","2020-05-01","17","242","1","4","0.8","1.4"
"White","2020-05-02","4","246","0","4","0.8","1.4"
"White","2020-05-03","2","248","0","4","0.8","1.4"
"White","2020-05-04","7","255","0","4","0.8","1.4"
"White","2020-05-05","10","265","1","5","2.3","1.1"
"White","2020-05-06","8","273","0","5","2.3","1.1"
"White","2020-05-07","2","275","0","5","2.3","1.1"
"White","2020-05-08","7","282","0","5","1.4","1.1"
"White","2020-05-09","2","284","0","5","1.4","1.1"
"White","2020-05-10","0","284","0","5","1.4","1.1"
"White","2020-05-11","6","290","0","5","1.4","1.1"
"White","2020-05-12","12","302","0","5","0","1.1"
"White","2020-05-13","8","310","0","5","0","1.1"
"White","2020-05-14","8","318","0","5","0","1.1"
"White","2020-05-15","11","329","1","6","1.3","1.4"
"White","2020-05-16","2","331","0","6","1.3","1.4"
"White","2020-05-17","4","335","0","6","1.3","1.4"
"White","2020-05-18","20","355","2","8","2.7","2.1"
"White","2020-05-19","12","367","0","8","2.7","1.4"
"White","2020-05-20","27","394","1","9","3.3","1.6"
"White","2020-05-21","3","397","0","9","3.3","1.6"
"White","2020-05-22","10","407","0","9","2","1.6"
"White","2020-05-23","4","411","0","9","2","1.6"
"White","2020-05-24","0","411","0","9","2","1.6"
"White","2020-05-25","0","411","0","9","0.5","1.6"
"White","2020-05-26","6","417","1","10","2.9","2.8"
"White","2020-05-27","10","427","0","10","2.4","2.8"
"White","2020-05-28","7","434","0","10","2.4","2.8"
"White","2020-05-29","11","445","0","10","2.4","2.2"
"White","2020-05-30","3","448","0","10","2.4","2.2"
"White","2020-05-31","3","451","0","10","2.4","2.2"
"White","2020-06-01","9","460","0","10","2.4","1.5"
"White","2020-06-02","6","466","0","10","0","1.5"
"White","2020-06-03","9","475","0","10","0","1.2"
"White","2020-06-04","9","484","1","11","1.6","2"
"White","2020-06-05","6","490","0","11","1.6","2"
"White","2020-06-06","6","496","0","11","1.6","2"
"White","2020-06-07","1","497","0","11","1.6","2"
"White","2020-06-08","9","506","0","11","1.6","2"
"White","2020-06-09","7","513","0","11","1.6","0.8"
"White","2020-06-10","4","517","0","11","1.6","0.8"
"White","2020-06-11","11","528","0","11","0","0.8"
"White","2020-06-12","9","537","0","11","0","0.8"
"White","2020-06-13","11","548","0","11","0","0.8"
"White","2020-06-14","0","548","0","11","0","0.8"
"White","2020-06-15","7","555","0","11","0","0.8"
"White","2020-06-16","11","566","0","11","0","0.8"
"White","2020-06-17","13","579","0","11","0","0.8"
"White","2020-06-18","10","589","0","11","0","0"
"White","2020-06-19","7","596","2","13","4.1","2"
"White","2020-06-20","5","601","0","13","4.1","2"
"White","2020-06-21","0","601","0","13","4.1","2"
"White","2020-06-22","7","608","0","13","4.1","2"
"White","2020-06-23","13","621","0","13","4.1","2"
"White","2020-06-24","16","637","0","13","4.1","2"
"White","2020-06-25","58","695","3","16","4.8","2.4"
"White","2020-06-26","22","717","0","16","0.7","2.4"
"White","2020-06-27","19","736","2","18","2.2","3.2"
"White","2020-06-28","3","739","0","18","2.2","3.2"
"White","2020-06-29","42","781","0","18","2.2","3.2"
"White","2020-06-30","34","815","2","20","3.1","3.6"
"White","2020-07-01","24","839","0","20","3.1","3.6"
"White","2020-07-02","48","887","2","22","2.9","3.9"
"White","2020-07-03","6","893","0","22","2.9","1.8"
"White","2020-07-04","22","915","0","22","1.4","1.8"
"White","2020-07-05","21","936","1","23","2.1","2.2"
"White","2020-07-06","19","955","2","25","3.6","2.9"
"White","2020-07-07","43","998","4","29","4.1","3.6"
"White","2020-07-08","32","1030","4","33","5.9","4.5"
"White","2020-07-09","49","1079","4","37","6.5","4.7"
"White","2020-07-10","25","1104","1","38","7","5"
"White","2020-07-11","13","1117","2","40","9.2","5.3"
"White","2020-07-12","48","1165","3","43","9.4","5.8"
"White","2020-07-13","22","1187","2","45","9.2","6.4"
"White","2020-07-14","24","1211","2","47","9.1","6.6"
"White","2020-07-15","77","1288","8","55","8.8","7.3"
"White","2020-07-16","45","1333","4","59","8.9","7.7"
"White","2020-07-17","57","1390","8","67","10.3","8.7"
"White","2020-07-18","12","1402","2","69","10.5","9.9"
"White","2020-07-19","34","1436","4","73","11.3","10.4"
"White","2020-07-20","31","1467","4","77","11.9","10.5"
"White","2020-07-21","31","1498","3","80","12","10.6"
"White","2020-07-22","31","1529","0","80","10.6","9.7"
"White","2020-07-23","44","1573","4","84","10.6","9.7"
"White","2020-07-24","26","1599","1","85","9.1","9.7"
"White","2020-07-25","28","1627","6","91","9.8","10.2"
"White","2020-07-26","28","1655","11","102","13.7","12.5"
"White","2020-07-27","21","1676","3","105","13.9","12.9"
"White","2020-07-28","26","1702","2","107","13.7","12.9"
"White","2020-07-29","58","1760","6","113","15.1","12.9"
"White","2020-07-30","46","1806","6","119","15.7","13.1"
"White","2020-07-31","43","1849","4","123","16.5","12.8"
"White","2020-08-01","16","1865","6","129","18.8","14.3"
"White","2020-08-02","23","1888","3","132","15","14.4"
"White","2020-08-03","24","1912","3","135","14.8","14.4"
"White","2020-08-04","15","1927","6","141","19.4","16.5"
"White","2020-08-05","28","1955","3","144","19.4","17.3"
"White","2020-08-06","18","1973","0","144","17.6","16.6"
"White","2020-08-07","9","1982","3","147","21","18.7"
"White","2020-08-08","10","1992","2","149","18.5","18.6"
"White","2020-08-09","5","1997","0","149","16.6","15.8"
"White","2020-08-10","13","2010","2","151","17.1","15.9"
"White","2020-08-11","9","2019","1","152","12.9","16.2"
"White","2020-08-12","11","2030","2","154","14","16.7"
"White","2020-08-13","21","2051","1","155","14.7","16.1"
"White","2020-08-14","12","2063","3","158","13.5","17.3"
"White","2020-08-15","6","2069","0","158","10.6","14.6"
"White","2020-08-16","4","2073","0","158","10.6","13.6"
"White","2020-08-17","12","2085","1","159","9.6","13.3"
"White","2020-08-18","11","2096","2","161","10.6","11.8"
"White","2020-08-19","15","2111","1","162","9","11.5"
"White","2020-08-20","5","2116","0","162","8.3","11.5"
"White","2020-08-21","24","2140","0","162","4.7","9.1"
"White","2020-08-22","12","2152","0","162","4.7","7.7"
"White","2020-08-23","3","2155","0","162","4.7","7.7"
"White","2020-08-24","6","2161","1","163","5.9","7.8"
"White","2020-08-25","8","2169","0","163","3.3","7"
"White","2020-08-26","23","2192","1","164","3","6"
"White","2020-08-27","22","2214","2","166","4.3","6.3"
"White","2020-08-28","11","2225","0","166","4.3","4.5"
"White","2020-08-29","9","2234","1","167","5.9","5.3"
"White","2020-08-30","13","2247","2","169","8.1","6.4"
"White","2020-08-31","22","2269","3","172","7.7","6.8"
"White","2020-09-01","14","2283","3","175","10.7","7"
"White","2020-09-02","26","2309","2","177","11.2","7.1"
"White","2020-09-03","18","2327","1","178","10.7","7.5"
"White","2020-09-04","29","2356","1","179","11.2","7.7"
"White","2020-09-05","20","2376","3","182","11.7","8.8"
"White","2020-09-06","4","2380","1","183","13.1","10.6"
"White","2020-09-07","3","2383","0","183","11.2","9.4"
"White","2020-09-08","14","2397","2","185","10.1","10.4"
"White","2020-09-09","13","2410","4","189","13.4","12.3"
"White","2020-09-10","26","2436","3","192","14.3","12.5"
"White","2020-09-11","14","2450","0","192","13.8","12.5"
"White","2020-09-12","10","2460","3","195","15.9","13.8"
"White","2020-09-13","3","2463","0","195","12.4","12.7"
"White","2020-09-14","19","2482","2","197","13.9","12.5"
"White","2020-09-15","18","2500","3","200","14.2","12.2"
"White","2020-09-16","14","2514","0","200","9.8","11.6"
"White","2020-09-17","23","2537","1","201","8.8","11.5"
"White","2020-09-18","14","2551","0","201","8.8","11.3"
"White","2020-09-19","9","2560","0","201","4.5","10.2"
"White","2020-09-20","0","2560","0","201","4.5","8.4"
"White","2020-09-21","17","2577","2","203","4.7","9.3"
"White","2020-09-22","24","2601","3","206","4.1","9.2"
"White","2020-09-23","14","2615","1","207","5.1","7.5"
"White","2020-09-24","17","2632","0","207","4.5","6.6"
"White","2020-09-25","9","2641","1","208","6.1","7.4"
"White","2020-09-26","3","2644","0","208","6.1","5.3"
"White","2020-09-27","3","2647","1","209","10.8","7.7"
"White","2020-09-28","18","2665","2","211","10.7","7.7"
"White","2020-09-29","22","2687","1","212","9.6","6.8"
"White","2020-09-30","19","2706","2","214","10.1","7.6"
"White","2020-10-01","18","2724","1","215","10.9","7.7"
"White","2020-10-02","16","2740","0","215","9.3","7.7"
"White","2020-10-03","8","2748","2","217","12.9","9.5"
"White","2020-10-04","3","2751","2","219","17.6","14.2"
"White","2020-10-05","11","2762","1","220","17.3","14"
"White","2020-10-06","16","2778","1","221","17.6","13.6"
"White","2020-10-07","25","2803","2","223","17.2","13.7"
"White","2020-10-08","21","2824","4","227","19.2","15"
"White","2020-10-09","24","2848","1","228","19.7","14.5"
"White","2020-10-10","14","2862","1","229","17.2","15"
"White","2020-10-11","4","2866","0","229","7.7","12.7"
"White","2020-10-12","17","2883","0","229","6.4","11.9"
"White","2020-10-13","20","2903","2","231","6.9","12.2"
"White","2020-10-14","23","2926","0","231","5.8","11.5"
"White","2020-10-15","26","2952","0","231","3","11.1"
"White","2020-10-16","21","2973","0","231","2.4","11.1"
"White","2020-10-17","10","2983","3","234","5.7","11.5"
"White","2020-10-18","2","2985","1","235","12.9","10.3"
"White","2020-10-19","23","3008","0","235","12.9","9.6"
"White","2020-10-20","15","3023","0","235","11.4","9.2"
"White","2020-10-21","25","3048","1","236","12","8.9"
"White","2020-10-22","14","3062","0","236","12","7.5"
"White","2020-10-23","14","3076","0","236","12","7.2"
"White","2020-10-24","18","3094","0","236","7.7","6.7"
"White","2020-10-25","6","3100","1","237","3","7.9"
"White","2020-10-26","14","3114","0","237","3","7.9"
"White","2020-10-27","18","3132","3","240","5.3","8.4"
"White","2020-10-28","22","3154","0","240","4.8","8.4"
"White","2020-10-29","11","3165","0","240","4.8","8.4"
"White","2020-10-30","18","3183","1","241","5.6","8.8"
"White","2020-10-31","14","3197","9","250","14.7","11.2"
"White","2020-11-01","7","3204","1","251","14.4","8.7"
"White","2020-11-02","11","3215","1","252","15.7","9.3"
"White","2020-11-03","19","3234","0","252","13.3","9.3"
"White","2020-11-04","17","3251","0","252","13.3","9"
"White","2020-11-05","25","3276","5","257","16.2","10.5"
"White","2020-11-06","28","3304","5","262","17.9","11.7"
"White","2020-11-07","11","3315","4","266","13.9","14.3"
"White","2020-11-08","4","3319","3","269","22.6","18.5"
"White","2020-11-09","15","3334","1","270","22.3","19"
"White","2020-11-10","23","3357","3","273","24.1","18.7"
"White","2020-11-11","25","3382","6","279","27.6","20.4"
"White","2020-11-12","26","3408","6","285","28","22.1"
"White","2020-11-13","37","3445","8","293","28.5","23.2"
"White","2020-11-14","7","3452","0","293","23.3","18.6"
"White","2020-11-15","6","3458","1","294","15","18.8"
"White","2020-11-16","28","3486","5","299","16.6","19.4"
"White","2020-11-17","58","3544","7","306","16.5","20.3"
"White","2020-11-18","45","3589","3","309","14","20.8"
"White","2020-11-19","60","3649","11","320","13.3","20.7"
"White","2020-11-20","36","3685","4","324","11.8","20.2"
"White","2020-11-21","12","3697","4","328","16.6","20"
"White","2020-11-22","9","3706","3","331","19","17"
"White","2020-11-23","43","3749","11","342","20.1","18.3"
"White","2020-11-24","34","3783","5","347","20.4","18.5"
"White","2020-11-25","39","3822","7","354","22","18"
"White","2020-11-26","3","3825","1","355","24.2","18.8"
"White","2020-11-27","44","3869","6","361","24.6","18.2"
"White","2020-11-28","24","3893","8","369","24.6","20.6"
"White","2020-11-29","19","3912","5","374","23.6","21.3"
"White","2020-11-30","49","3961","9","383","22.5","21.3"
"White","2020-12-01","35","3996","5","388","22.5","21.4"
"White","2020-12-02","42","4038","5","393","21.6","21.8"
"White","2020-12-03","46","4084","9","402","19.6","21.9"
"White","2020-12-04","46","4130","10","412","20.8","22.7"
"White","2020-12-05","22","4152","5","417","19.3","21.9"
"White","2020-12-06","17","4169","5","422","19.7","21.6"
"White","2020-12-07","66","4235","15","437","20.3","21.4"
"White","2020-12-08","63","4298","11","448","20.8","21.6"
"White","2020-12-09","46","4344","10","458","22.2","21.9"
"White","2020-12-10","57","4401","12","470","22.4","21"
"White","2020-12-11","54","4455","7","477","21.2","21"
"White","2020-12-12","39","4494","15","492","23.4","21.3"
"White","2020-12-13","18","4512","5","497","23.2","21.4"
"White","2020-12-14","66","4578","13","510","22.7","21.5"
"White","2020-12-15","73","4651","14","524","23","21.9"
"White","2020-12-16","69","4720","13","537","22.6","22.4"
"White","2020-12-17","57","4777","10","547","22.1","22.2"
"White","2020-12-18","63","4840","17","564","24.1","22.6"
"White","2020-12-19","23","4863","11","575","25.4","24.4"
"White","2020-12-20","27","4890","10","585","26.7","24.9"
"White","2020-12-21","63","4953","12","597","26.6","24.7"
"White","2020-12-22","64","5017","15","612","27.2","25.1"
"White","2020-12-23","50","5067","12","624","28","25.3"
"White","2020-12-24","26","5093","7","631","29.3","25.7"
"White","2020-12-25","6","5099","2","633","30.2","27.1"
"White","2020-12-26","40","5139","14","647","28.4","26.9"
"White","2020-12-27","24","5163","4","651","25.5","26.1"
"White","2020-12-28","88","5251","21","672","26.2","26.4"
"White","2020-12-29","50","5301","15","687","27.1","27.2"
"White","2020-12-30","52","5353","17","704","28.4","28.2"
"White","2020-12-31","51","5404","19","723","29.8","29.6"
"White","2021-01-01","9","5413","2","725","28.2","29.2"
"White","2021-01-02","17","5430","6","731","28.3","28.3"
"White","2021-01-03","23","5453","9","740","31.5","28.5"
"White","2021-01-04","77","5530","23","763","32.4","29.3"
"White","2021-01-05","89","5619","24","787","31.9","29.5"
"White","2021-01-06","63","5682","15","802","30.6","29.5"
"White","2021-01-07","59","5741","15","817","29","29.4"
"White","2021-01-08","44","5785","10","827","29","28.6"
"White","2021-01-09","25","5810","7","834","28","28.1"
"White","2021-01-10","25","5835","8","842","27","29.2"
"White","2021-01-11","46","5881","11","853","26.1","29.2"
"White","2021-01-12","43","5924","10","863","25.6","28.8"
"White","2021-01-13","46","5970","11","874","25.6","28.1"
"White","2021-01-14","50","6020","11","885","25.1","27"
"White","2021-01-15","47","6067","16","901","26.7","27.9"
"White","2021-01-16","16","6083","5","906","27.2","27.6"
"White","2021-01-17","13","6096","2","908","24.8","25.9"
"White","2021-01-18","45","6141","7","915","23.6","24.9"
"White","2021-01-19","59","6200","12","927","23.2","24.4"
"White","2021-01-20","44","6244","10","937","23","24.3"
"White","2021-01-21","38","6282","8","945","22.9","24"
"White","2021-01-22","41","6323","12","957","22.2","24.5"
"White","2021-01-23","18","6341","6","963","22.5","24.9"
"White","2021-01-24","4","6345","0","963","20.3","22.6"
"White","2021-01-25","14","6359","2","965","20.1","21.9"
"White","2021-01-26","0","6359","0","965","17.2","20.2"
"White","2021-01-27","0","6359","0","965","14","18.5"
"Whitfield","2020-02-01","0","0","0","0",".","."
"Whitfield","2020-02-02","0","0","0","0",".","."
"Whitfield","2020-02-03","0","0","0","0",".","."
"Whitfield","2020-02-04","0","0","0","0",".","."
"Whitfield","2020-02-05","0","0","0","0",".","."
"Whitfield","2020-02-06","0","0","0","0",".","."
"Whitfield","2020-02-07","0","0","0","0","0","."
"Whitfield","2020-02-08","0","0","0","0","0","."
"Whitfield","2020-02-09","0","0","0","0","0","."
"Whitfield","2020-02-10","0","0","0","0","0","."
"Whitfield","2020-02-11","0","0","0","0","0","."
"Whitfield","2020-02-12","0","0","0","0","0","."
"Whitfield","2020-02-13","0","0","0","0","0","."
"Whitfield","2020-02-14","0","0","0","0","0","0"
"Whitfield","2020-02-15","0","0","0","0","0","0"
"Whitfield","2020-02-16","0","0","0","0","0","0"
"Whitfield","2020-02-17","0","0","0","0","0","0"
"Whitfield","2020-02-18","0","0","0","0","0","0"
"Whitfield","2020-02-19","0","0","0","0","0","0"
"Whitfield","2020-02-20","0","0","0","0","0","0"
"Whitfield","2020-02-21","0","0","0","0","0","0"
"Whitfield","2020-02-22","0","0","0","0","0","0"
"Whitfield","2020-02-23","0","0","0","0","0","0"
"Whitfield","2020-02-24","0","0","0","0","0","0"
"Whitfield","2020-02-25","0","0","0","0","0","0"
"Whitfield","2020-02-26","0","0","0","0","0","0"
"Whitfield","2020-02-27","0","0","0","0","0","0"
"Whitfield","2020-02-28","0","0","0","0","0","0"
"Whitfield","2020-02-29","0","0","0","0","0","0"
"Whitfield","2020-03-01","0","0","0","0","0","0"
"Whitfield","2020-03-02","0","0","0","0","0","0"
"Whitfield","2020-03-03","0","0","0","0","0","0"
"Whitfield","2020-03-04","0","0","0","0","0","0"
"Whitfield","2020-03-05","0","0","0","0","0","0"
"Whitfield","2020-03-06","0","0","0","0","0","0"
"Whitfield","2020-03-07","0","0","0","0","0","0"
"Whitfield","2020-03-08","0","0","0","0","0","0"
"Whitfield","2020-03-09","0","0","0","0","0","0"
"Whitfield","2020-03-10","1","1","0","0","0","0"
"Whitfield","2020-03-11","1","2","0","0","0","0"
"Whitfield","2020-03-12","9","11","0","0","0","0"
"Whitfield","2020-03-13","24","35","0","0","0","0"
"Whitfield","2020-03-14","8","43","4","4","7.1","3.6"
"Whitfield","2020-03-15","5","48","1","5","10","5"
"Whitfield","2020-03-16","20","68","0","5","10","5"
"Whitfield","2020-03-17","10","78","1","6","11.4","5.7"
"Whitfield","2020-03-18","15","93","0","6","11.4","5.7"
"Whitfield","2020-03-19","24","117","5","11","14.4","7.2"
"Whitfield","2020-03-20","19","136","4","15","17.4","8.7"
"Whitfield","2020-03-21","8","144","1","16","12.1","9.6"
"Whitfield","2020-03-22","9","153","0","16","9.2","9.6"
"Whitfield","2020-03-23","14","167","0","16","9.2","9.6"
"Whitfield","2020-03-24","15","182","5","21","12.5","12"
"Whitfield","2020-03-25","58","240","0","21","12.5","12"
"Whitfield","2020-03-26","12","252","1","22","10.7","12.6"
"Whitfield","2020-03-27","25","277","1","23","8.3","12.9"
"Whitfield","2020-03-28","5","282","4","27","18","15"
"Whitfield","2020-03-29","4","286","0","27","18","13.6"
"Whitfield","2020-03-30","26","312","2","29","19.1","14.1"
"Whitfield","2020-03-31","11","323","0","29","14.3","13.4"
"Whitfield","2020-04-01","43","366","5","34","16","14.2"
"Whitfield","2020-04-02","9","375","0","34","14.8","12.8"
"Whitfield","2020-04-03","49","424","8","42","16.5","12.4"
"Whitfield","2020-04-04","14","438","1","43","6.1","12"
"Whitfield","2020-04-05","6","444","0","43","6.1","12"
"Whitfield","2020-04-06","91","535","10","53","6.6","12.8"
"Whitfield","2020-04-07","73","608","14","67","9.3","11.8"
"Whitfield","2020-04-08","67","675","2","69","8.1","12"
"Whitfield","2020-04-09","20","695","3","72","10.2","12.5"
"Whitfield","2020-04-10","26","721","5","77","10.6","13.6"
"Whitfield","2020-04-11","9","730","2","79","12.8","9.5"
"Whitfield","2020-04-12","5","735","1","80","15.7","10.9"
"Whitfield","2020-04-13","29","764","6","86","17","11.8"
"Whitfield","2020-04-14","19","783","1","87","15.1","12.2"
"Whitfield","2020-04-15","79","862","11","98","16.6","12.4"
"Whitfield","2020-04-16","55","917","4","102","15.5","12.9"
"Whitfield","2020-04-17","80","997","1","103","12.9","11.8"
"Whitfield","2020-04-18","17","1014","0","103","9.8","11.3"
"Whitfield","2020-04-19","14","1028","4","107","11","13.3"
"Whitfield","2020-04-20","126","1154","13","120","9.5","13.3"
"Whitfield","2020-04-21","68","1222","8","128","10.4","12.7"
"Whitfield","2020-04-22","55","1277","6","134","10","13.3"
"Whitfield","2020-04-23","62","1339","9","143","11","13.3"
"Whitfield","2020-04-24","98","1437","5","148","11.6","12.3"
"Whitfield","2020-04-25","22","1459","2","150","12.9","11.3"
"Whitfield","2020-04-26","17","1476","1","151","9.7","10.3"
"Whitfield","2020-04-27","110","1586","11","162","9.6","9.6"
"Whitfield","2020-04-28","109","1695","10","172","9.2","9.8"
"Whitfield","2020-04-29","81","1776","7","179","8.9","9.5"
"Whitfield","2020-04-30","179","1955","6","185","7.3","9.2"
"Whitfield","2020-05-01","48","2003","10","195","9.6","10.6"
"Whitfield","2020-05-02","12","2015","0","195","8.3","10.6"
"Whitfield","2020-05-03","6","2021","1","196","9.8","9.7"
"Whitfield","2020-05-04","71","2092","4","200","9.2","9.4"
"Whitfield","2020-05-05","78","2170","2","202","8.2","8.7"
"Whitfield","2020-05-06","188","2358","14","216","8.1","8.5"
"Whitfield","2020-05-07","182","2540","24","240","9.5","8.4"
"Whitfield","2020-05-08","231","2771","9","249","7.1","8.3"
"Whitfield","2020-05-09","87","2858","1","250","7.2","7.7"
"Whitfield","2020-05-10","48","2906","0","250","4.8","7.3"
"Whitfield","2020-05-11","262","3168","10","260","4.6","6.9"
"Whitfield","2020-05-12","141","3309","5","265","4.7","6.5"
"Whitfield","2020-05-13","126","3435","4","269","4.1","6.1"
"Whitfield","2020-05-14","157","3592","4","273","2.6","6"
"Whitfield","2020-05-15","125","3717","11","284","3.3","5.2"
"Whitfield","2020-05-16","103","3820","12","296","4.8","6"
"Whitfield","2020-05-17","63","3883","12","308","7.5","6.2"
"Whitfield","2020-05-18","148","4031","20","328","8.9","6.7"
"Whitfield","2020-05-19","127","4158","23","351","11","7.8"
"Whitfield","2020-05-20","108","4266","7","358","11.5","7.8"
"Whitfield","2020-05-21","150","4416","6","364","11.7","7.1"
"Whitfield","2020-05-22","85","4501","6","370","11.4","7.3"
"Whitfield","2020-05-23","95","4596","20","390","12.8","8.8"
"Whitfield","2020-05-24","17","4613","8","398","16.8","12.1"
"Whitfield","2020-05-25","34","4647","1","399","15.2","12.1"
"Whitfield","2020-05-26","271","4918","31","430","14.3","12.6"
"Whitfield","2020-05-27","244","5162","18","448","14.4","12.9"
"Whitfield","2020-05-28","228","5390","23","471","15.3","13.5"
"Whitfield","2020-05-29","254","5644","26","497","15.7","13.6"
"Whitfield","2020-05-30","33","5677","4","501","14.5","13.6"
"Whitfield","2020-05-31","11","5688","1","502","9","12.9"
"Whitfield","2020-06-01","367","6055","28","530","9.7","12.5"
"Whitfield","2020-06-02","250","6305","35","565","10.1","12.2"
"Whitfield","2020-06-03","243","6548","27","592","10.6","12.5"
"Whitfield","2020-06-04","244","6792","17","609","10.2","12.7"
"Whitfield","2020-06-05","184","6976","30","639","11","13.4"
"Whitfield","2020-06-06","42","7018","4","643","10.7","12.6"
"Whitfield","2020-06-07","25","7043","3","646","11.1","10.1"
"Whitfield","2020-06-08","411","7454","30","676","11","10.4"
"Whitfield","2020-06-09","314","7768","35","711","10.6","10.3"
"Whitfield","2020-06-10","198","7966","34","745","11.5","11"
"Whitfield","2020-06-11","380","8346","25","770","11.4","10.8"
"Whitfield","2020-06-12","243","8589","29","799","10.8","10.9"
"Whitfield","2020-06-13","105","8694","31","830","13.7","12.2"
"Whitfield","2020-06-14","74","8768","12","842","14.3","12.7"
"Whitfield","2020-06-15","232","9000","38","880","15.6","13.3"
"Whitfield","2020-06-16","207","9207","19","899","15.3","13"
"Whitfield","2020-06-17","204","9411","34","933","15.2","13.3"
"Whitfield","2020-06-18","255","9666","43","976","16.7","14.1"
"Whitfield","2020-06-19","368","10034","33","1009","16.3","13.5"
"Whitfield","2020-06-20","153","10187","27","1036","14.6","14.1"
"Whitfield","2020-06-21","31","10218","8","1044","15.9","15.1"
"Whitfield","2020-06-22","290","10508","74","1118","17.2","16.4"
"Whitfield","2020-06-23","391","10899","55","1173","17.9","16.6"
"Whitfield","2020-06-24","335","11234","54","1227","17.9","16.5"
"Whitfield","2020-06-25","434","11668","77","1304","18","17.3"
"Whitfield","2020-06-26","412","12080","70","1374","19.1","17.7"
"Whitfield","2020-06-27","500","12580","98","1472","19.4","17"
"Whitfield","2020-06-28","60","12640","12","1484","18.6","17.3"
"Whitfield","2020-06-29","363","13003","65","1549","17.5","17.4"
"Whitfield","2020-06-30","426","13429","101","1650","18.9","18.4"
"Whitfield","2020-07-01","529","13958","116","1766","19.7","18.8"
"Whitfield","2020-07-02","756","14714","124","1890","19.5","18.7"
"Whitfield","2020-07-03","267","14981","86","1976","21.7","20.4"
"Whitfield","2020-07-04","46","15027","15","1991","23.5","21.5"
"Whitfield","2020-07-05","96","15123","46","2037","27.5","23.1"
"Whitfield","2020-07-06","810","15933","180","2217","28.1","22.8"
"Whitfield","2020-07-07","544","16477","105","2322","27.5","23.2"
"Whitfield","2020-07-08","605","17082","123","2445","27.3","23.5"
"Whitfield","2020-07-09","863","17945","128","2573","27.1","23.3"
"Whitfield","2020-07-10","693","18638","108","2681","24.7","23.2"
"Whitfield","2020-07-11","741","19379","126","2807","22.5","23"
"Whitfield","2020-07-12","69","19448","21","2828","20","23.7"
"Whitfield","2020-07-13","717","20165","161","2989","20","24.1"
"Whitfield","2020-07-14","482","20647","100","3089","20.2","23.9"
"Whitfield","2020-07-15","662","21309","94","3183","19.3","23.3"
"Whitfield","2020-07-16","827","22136","150","3333","19.8","23.4"
"Whitfield","2020-07-17","224","22360","45","3378","20.4","22.6"
"Whitfield","2020-07-18","246","22606","53","3431","21.1","21.8"
"Whitfield","2020-07-19","294","22900","44","3475","18.9","19.4"
"Whitfield","2020-07-20","534","23434","98","3573","18.3","19.1"
"Whitfield","2020-07-21","554","23988","82","3655","17.4","18.8"
"Whitfield","2020-07-22","751","24739","90","3745","17.1","18.2"
"Whitfield","2020-07-23","705","25444","92","3837","16.4","18.1"
"Whitfield","2020-07-24","577","26021","102","3939","16.1","18.2"
"Whitfield","2020-07-25","533","26554","95","4034","15.5","18.3"
"Whitfield","2020-07-26","125","26679","30","4064","16.8","17.8"
"Whitfield","2020-07-27","548","27227","99","4163","16.8","17.5"
"Whitfield","2020-07-28","488","27715","74","4237","16.8","17.1"
"Whitfield","2020-07-29","516","28231","65","4302","16.9","17"
"Whitfield","2020-07-30","406","28637","52","4354","16.9","16.6"
"Whitfield","2020-07-31","431","29068","48","4402","15.9","16"
"Whitfield","2020-08-01","278","29346","40","4442","15.5","15.5"
"Whitfield","2020-08-02","62","29408","16","4458","15.7","16.3"
"Whitfield","2020-08-03","329","29737","32","4490","14.5","15.6"
"Whitfield","2020-08-04","459","30196","48","4538","13.8","15.3"
"Whitfield","2020-08-05","445","30641","50","4588","13.7","15.3"
"Whitfield","2020-08-06","310","30951","49","4637","14.1","15.5"
"Whitfield","2020-08-07","534","31485","37","4674","13.5","14.7"
"Whitfield","2020-08-08","207","31692","27","4701","13.3","14.4"
"Whitfield","2020-08-09","64","31756","17","4718","13.4","14.6"
"Whitfield","2020-08-10","290","32046","43","4761","14.1","14.3"
"Whitfield","2020-08-11","555","32601","34","4795","13.5","13.7"
"Whitfield","2020-08-12","337","32938","31","4826","13.2","13.4"
"Whitfield","2020-08-13","248","33186","27","4853","12.5","13.3"
"Whitfield","2020-08-14","496","33682","18","4871","12","12.8"
"Whitfield","2020-08-15","76","33758","11","4882","12.2","12.8"
"Whitfield","2020-08-16","60","33818","5","4887","9.6","11.5"
"Whitfield","2020-08-17","108","33926","18","4905","9.9","12"
"Whitfield","2020-08-18","425","34351","26","4931","9.9","11.7"
"Whitfield","2020-08-19","269","34620","17","4948","9.5","11.4"
"Whitfield","2020-08-20","227","34847","15","4963","8.9","10.7"
"Whitfield","2020-08-21","273","35120","29","4992","9.9","11"
"Whitfield","2020-08-22","84","35204","15","5007","10.4","11.3"
"Whitfield","2020-08-23","55","35259","5","5012","10.5","10.1"
"Whitfield","2020-08-24","378","35637","35","5047","9.4","9.7"
"Whitfield","2020-08-25","387","36024","24","5071","9.4","9.7"
"Whitfield","2020-08-26","225","36249","26","5097","10.2","9.8"
"Whitfield","2020-08-27","251","36500","33","5130","11.1","10"
"Whitfield","2020-08-28","330","36830","28","5158","10.8","10.3"
"Whitfield","2020-08-29","69","36899","9","5167","10.1","10.2"
"Whitfield","2020-08-30","55","36954","6","5173","10.4","10.4"
"Whitfield","2020-08-31","373","37327","38","5211","10.5","10"
"Whitfield","2020-09-01","371","37698","25","5236","10.6","10"
"Whitfield","2020-09-02","377","38075","22","5258","9.8","10"
"Whitfield","2020-09-03","226","38301","25","5283","9.5","10.3"
"Whitfield","2020-09-04","280","38581","34","5317","10","10.4"
"Whitfield","2020-09-05","113","38694","14","5331","9.9","10"
"Whitfield","2020-09-06","90","38784","9","5340","9.8","10.1"
"Whitfield","2020-09-07","48","38832","8","5348","10.7","10.6"
"Whitfield","2020-09-08","336","39168","37","5385","11.3","10.9"
"Whitfield","2020-09-09","355","39523","43","5428","12.2","11"
"Whitfield","2020-09-10","281","39804","21","5449","11.7","10.6"
"Whitfield","2020-09-11","378","40182","17","5466","10.6","10.3"
"Whitfield","2020-09-12","78","40260","12","5478","11","10.5"
"Whitfield","2020-09-13","93","40353","14","5492","11.7","10.8"
"Whitfield","2020-09-14","371","40724","46","5538","11.1","10.9"
"Whitfield","2020-09-15","240","40964","22","5560","10.9","11.1"
"Whitfield","2020-09-16","311","41275","25","5585","10.3","11.2"
"Whitfield","2020-09-17","359","41634","29","5614","10.4","11"
"Whitfield","2020-09-18","329","41963","16","5630","10.4","10.5"
"Whitfield","2020-09-19","68","42031","8","5638","9.9","10.5"
"Whitfield","2020-09-20","96","42127","12","5650","9.5","10.6"
"Whitfield","2020-09-21","333","42460","33","5683","9.2","10.2"
"Whitfield","2020-09-22","384","42844","19","5702","8.6","9.7"
"Whitfield","2020-09-23","298","43142","27","5729","8.7","9.5"
"Whitfield","2020-09-24","418","43560","22","5751","8.3","9.4"
"Whitfield","2020-09-25","341","43901","28","5779","8.8","9.6"
"Whitfield","2020-09-26","73","43974","7","5786","8.5","9.2"
"Whitfield","2020-09-27","81","44055","12","5798","8.8","9.2"
"Whitfield","2020-09-28","298","44353","32","5830","8.9","9.1"
"Whitfield","2020-09-29","314","44667","22","5852","9.2","8.9"
"Whitfield","2020-09-30","331","44998","20","5872","8.8","8.8"
"Whitfield","2020-10-01","320","45318","12","5884","8.6","8.5"
"Whitfield","2020-10-02","377","45695","20","5904","8.2","8.5"
"Whitfield","2020-10-03","30","45725","5","5909","9.2","8.8"
"Whitfield","2020-10-04","37","45762","7","5916","9.8","9.3"
"Whitfield","2020-10-05","293","46055","29","5945","9.7","9.3"
"Whitfield","2020-10-06","393","46448","26","5971","9.6","9.4"
"Whitfield","2020-10-07","223","46671","15","5986","9.7","9.3"
"Whitfield","2020-10-08","315","46986","18","6004","10","9.3"
"Whitfield","2020-10-09","320","47306","25","6029","10.3","9.3"
"Whitfield","2020-10-10","64","47370","4","6033","8.8","9"
"Whitfield","2020-10-11","30","47400","4","6037","8","8.9"
"Whitfield","2020-10-12","82","47482","18","6055","9.8","9.7"
"Whitfield","2020-10-13","310","47792","39","6094","10.6","10.1"
"Whitfield","2020-10-14","238","48030","21","6115","10.9","10.3"
"Whitfield","2020-10-15","244","48274","28","6143","11.7","10.9"
"Whitfield","2020-10-16","320","48594","27","6170","11.8","11.1"
"Whitfield","2020-10-17","25","48619","2","6172","12.1","10.5"
"Whitfield","2020-10-18","43","48662","7","6179","12.5","10.3"
"Whitfield","2020-10-19","331","48993","45","6224","11.3","10.5"
"Whitfield","2020-10-20","248","49241","41","6265","11.9","11.3"
"Whitfield","2020-10-21","292","49533","47","6312","12.9","11.9"
"Whitfield","2020-10-22","299","49832","28","6340","12.6","12.2"
"Whitfield","2020-10-23","468","50300","33","6373","12.4","12.1"
"Whitfield","2020-10-24","146","50446","36","6409","14.8","13.4"
"Whitfield","2020-10-25","78","50524","21","6430","16.3","14.4"
"Whitfield","2020-10-26","490","51014","58","6488","16.1","13.7"
"Whitfield","2020-10-27","415","51429","48","6536","15.4","13.6"
"Whitfield","2020-10-28","394","51823","57","6593","15.1","14"
"Whitfield","2020-10-29","137","51960","24","6617","16.3","14.5"
"Whitfield","2020-10-30","682","52642","61","6678","16.6","14.5"
"Whitfield","2020-10-31","133","52775","22","6700","15.4","15.1"
"Whitfield","2020-11-01","136","52911","18","6718","13.4","14.9"
"Whitfield","2020-11-02","474","53385","100","6818","14.8","15.4"
"Whitfield","2020-11-03","413","53798","45","6863","14.7","15"
"Whitfield","2020-11-04","455","54253","61","6924","14.5","14.8"
"Whitfield","2020-11-05","563","54816","52","6976","13.3","14.8"
"Whitfield","2020-11-06","521","55337","44","7020","13.3","14.9"
"Whitfield","2020-11-07","199","55536","38","7058","13.6","14.5"
"Whitfield","2020-11-08","132","55668","26","7084","14.6","14"
"Whitfield","2020-11-09","689","56357","109","7193","13.8","14.3"
"Whitfield","2020-11-10","447","56804","50","7243","13.8","14.3"
"Whitfield","2020-11-11","375","57179","63","7306","14.3","14.4"
"Whitfield","2020-11-12","883","58062","87","7393","14.4","13.9"
"Whitfield","2020-11-13","703","58765","73","7466","14.7","14"
"Whitfield","2020-11-14","188","58953","22","7488","13.6","13.6"
"Whitfield","2020-11-15","135","59088","23","7511","13.3","13.9"
"Whitfield","2020-11-16","554","59642","79","7590","13","13.4"
"Whitfield","2020-11-17","540","60182","82","7672","13.6","13.7"
"Whitfield","2020-11-18","764","60946","79","7751","12.7","13.5"
"Whitfield","2020-11-19","798","61744","108","7859","13.2","13.8"
"Whitfield","2020-11-20","734","62478","61","7920","12.9","13.8"
"Whitfield","2020-11-21","290","62768","30","7950","12.7","13.2"
"Whitfield","2020-11-22","131","62899","19","7969","12.4","12.8"
"Whitfield","2020-11-23","516","63415","89","8058","12.8","12.9"
"Whitfield","2020-11-24","547","63962","68","8126","12.4","13"
"Whitfield","2020-11-25","687","64649","67","8193","12.3","12.5"
"Whitfield","2020-11-26","48","64697","8","8201","12.8","13"
"Whitfield","2020-11-27","137","64834","38","8239","15.5","14.2"
"Whitfield","2020-11-28","92","64926","23","8262","17.6","15.2"
"Whitfield","2020-11-29","111","65037","33","8295","19.8","16.1"
"Whitfield","2020-11-30","714","65751","130","8425","19.9","16.4"
"Whitfield","2020-12-01","657","66408","127","8552","20.9","16.7"
"Whitfield","2020-12-02","770","67178","130","8682","21.9","17.1"
"Whitfield","2020-12-03","665","67843","113","8795","22","17.4"
"Whitfield","2020-12-04","460","68303","47","8842","19.5","17.5"
"Whitfield","2020-12-05","269","68572","49","8891","18.5","18.1"
"Whitfield","2020-12-06","182","68754","51","8942","18.3","19"
"Whitfield","2020-12-07","623","69377","112","9054","18.2","19.1"
"Whitfield","2020-12-08","644","70021","107","9161","17.8","19.4"
"Whitfield","2020-12-09","691","70712","113","9274","17.8","19.9"
"Whitfield","2020-12-10","757","71469","132","9406","17.8","19.9"
"Whitfield","2020-12-11","488","71957","99","9505","19.3","19.4"
"Whitfield","2020-12-12","179","72136","47","9552","20.4","19.5"
"Whitfield","2020-12-13","167","72303","46","9598","20.4","19.3"
"Whitfield","2020-12-14","669","72972","114","9712","20.2","19.2"
"Whitfield","2020-12-15","604","73576","131","9843","20.9","19.4"
"Whitfield","2020-12-16","844","74420","143","9986","21","19.4"
"Whitfield","2020-12-17","815","75235","148","10134","21.1","19.5"
"Whitfield","2020-12-18","433","75668","57","10191","20.1","19.7"
"Whitfield","2020-12-19","249","75917","40","10231","18.7","19.5"
"Whitfield","2020-12-20","199","76116","50","10281","18.3","19.3"
"Whitfield","2020-12-21","631","76747","102","10383","18.2","19.2"
"Whitfield","2020-12-22","788","77535","117","10500","17.2","19.1"
"Whitfield","2020-12-23","685","78220","117","10617","17.2","19.1"
"Whitfield","2020-12-24","143","78363","42","10659","18.8","20"
"Whitfield","2020-12-25","46","78409","7","10666","19.1","19.6"
"Whitfield","2020-12-26","112","78521","36","10702","21.4","20"
"Whitfield","2020-12-27","223","78744","60","10762","21.7","20"
"Whitfield","2020-12-28","724","79468","160","10922","22.5","20.4"
"Whitfield","2020-12-29","788","80256","184","11106","23.7","20.5"
"Whitfield","2020-12-30","786","81042","122","11228","23.5","20.4"
"Whitfield","2020-12-31","421","81463","77","11305","21.9","20.4"
"Whitfield","2021-01-01","65","81528","19","11324","23.9","21.5"
"Whitfield","2021-01-02","88","81616","28","11352","23.9","22.7"
"Whitfield","2021-01-03","85","81701","29","11381","24.9","23.3"
"Whitfield","2021-01-04","417","82118","97","11478","25.1","23.8"
"Whitfield","2021-01-05","886","83004","212","11690","25.2","24.5"
"Whitfield","2021-01-06","844","83848","124","11814","25","24.3"
"Whitfield","2021-01-07","498","84346","108","11922","25.5","23.7"
"Whitfield","2021-01-08","459","84805","92","12014","24.2","24.1"
"Whitfield","2021-01-09","254","85059","66","12080","23.4","23.6"
"Whitfield","2021-01-10","250","85309","78","12158","23","23.9"
"Whitfield","2021-01-11","530","85839","97","12255","22.3","23.7"
"Whitfield","2021-01-12","411","86250","75","12330","21.5","23.3"
"Whitfield","2021-01-13","646","86896","73","12403","21","23"
"Whitfield","2021-01-14","383","87279","58","12461","20","22.8"
"Whitfield","2021-01-15","278","87557","56","12517","20","22.1"
"Whitfield","2021-01-16","122","87679","34","12551","20.3","21.9"
"Whitfield","2021-01-17","108","87787","39","12590","21","22"
"Whitfield","2021-01-18","396","88183","85","12675","21.5","21.9"
"Whitfield","2021-01-19","433","88616","61","12736","20.9","21.2"
"Whitfield","2021-01-20","592","89208","73","12809","21","21"
"Whitfield","2021-01-21","271","89479","39","12848","20.9","20.5"
"Whitfield","2021-01-22","238","89717","51","12899","21.1","20.6"
"Whitfield","2021-01-23","101","89818","14","12913","19.1","19.7"
"Whitfield","2021-01-24","52","89870","14","12927","17.8","19.4"
"Whitfield","2021-01-25","96","89966","8","12935","15.9","18.7"
"Whitfield","2021-01-26","3","89969","1","12936","18.7","19.8"
"Whitfield","2021-01-27","0","89969","0","12936","16.9","19"
"Wilcox","2020-02-01","0","0","0","0",".","."
"Wilcox","2020-02-02","0","0","0","0",".","."
"Wilcox","2020-02-03","0","0","0","0",".","."
"Wilcox","2020-02-04","0","0","0","0",".","."
"Wilcox","2020-02-05","0","0","0","0",".","."
"Wilcox","2020-02-06","0","0","0","0",".","."
"Wilcox","2020-02-07","0","0","0","0","0","."
"Wilcox","2020-02-08","0","0","0","0","0","."
"Wilcox","2020-02-09","0","0","0","0","0","."
"Wilcox","2020-02-10","0","0","0","0","0","."
"Wilcox","2020-02-11","0","0","0","0","0","."
"Wilcox","2020-02-12","0","0","0","0","0","."
"Wilcox","2020-02-13","0","0","0","0","0","."
"Wilcox","2020-02-14","0","0","0","0","0","0"
"Wilcox","2020-02-15","0","0","0","0","0","0"
"Wilcox","2020-02-16","0","0","0","0","0","0"
"Wilcox","2020-02-17","0","0","0","0","0","0"
"Wilcox","2020-02-18","0","0","0","0","0","0"
"Wilcox","2020-02-19","0","0","0","0","0","0"
"Wilcox","2020-02-20","0","0","0","0","0","0"
"Wilcox","2020-02-21","0","0","0","0","0","0"
"Wilcox","2020-02-22","0","0","0","0","0","0"
"Wilcox","2020-02-23","0","0","0","0","0","0"
"Wilcox","2020-02-24","0","0","0","0","0","0"
"Wilcox","2020-02-25","0","0","0","0","0","0"
"Wilcox","2020-02-26","0","0","0","0","0","0"
"Wilcox","2020-02-27","0","0","0","0","0","0"
"Wilcox","2020-02-28","0","0","0","0","0","0"
"Wilcox","2020-02-29","0","0","0","0","0","0"
"Wilcox","2020-03-01","0","0","0","0","0","0"
"Wilcox","2020-03-02","0","0","0","0","0","0"
"Wilcox","2020-03-03","0","0","0","0","0","0"
"Wilcox","2020-03-04","0","0","0","0","0","0"
"Wilcox","2020-03-05","0","0","0","0","0","0"
"Wilcox","2020-03-06","0","0","0","0","0","0"
"Wilcox","2020-03-07","0","0","0","0","0","0"
"Wilcox","2020-03-08","0","0","0","0","0","0"
"Wilcox","2020-03-09","0","0","0","0","0","0"
"Wilcox","2020-03-10","0","0","0","0","0","0"
"Wilcox","2020-03-11","0","0","0","0","0","0"
"Wilcox","2020-03-12","0","0","0","0","0","0"
"Wilcox","2020-03-13","0","0","0","0","0","0"
"Wilcox","2020-03-14","0","0","0","0","0","0"
"Wilcox","2020-03-15","0","0","0","0","0","0"
"Wilcox","2020-03-16","0","0","0","0","0","0"
"Wilcox","2020-03-17","1","1","0","0","0","0"
"Wilcox","2020-03-18","0","1","0","0","0","0"
"Wilcox","2020-03-19","2","3","0","0","0","0"
"Wilcox","2020-03-20","0","3","0","0","0","0"
"Wilcox","2020-03-21","0","3","0","0","0","0"
"Wilcox","2020-03-22","0","3","0","0","0","0"
"Wilcox","2020-03-23","3","6","0","0","0","0"
"Wilcox","2020-03-24","2","8","0","0","0","0"
"Wilcox","2020-03-25","1","9","0","0","0","0"
"Wilcox","2020-03-26","1","10","1","1","14.3","7.1"
"Wilcox","2020-03-27","1","11","0","1","14.3","7.1"
"Wilcox","2020-03-28","0","11","0","1","14.3","7.1"
"Wilcox","2020-03-29","1","12","0","1","14.3","7.1"
"Wilcox","2020-03-30","2","14","0","1","14.3","7.1"
"Wilcox","2020-03-31","1","15","0","1","14.3","7.1"
"Wilcox","2020-04-01","2","17","2","3","28.6","14.3"
"Wilcox","2020-04-02","1","18","0","3","14.3","14.3"
"Wilcox","2020-04-03","2","20","0","3","14.3","14.3"
"Wilcox","2020-04-04","0","20","0","3","14.3","14.3"
"Wilcox","2020-04-05","0","20","0","3","14.3","14.3"
"Wilcox","2020-04-06","4","24","3","6","25","19.6"
"Wilcox","2020-04-07","1","25","0","6","25","19.6"
"Wilcox","2020-04-08","3","28","1","7","15.5","22"
"Wilcox","2020-04-09","20","48","9","16","21.9","18.1"
"Wilcox","2020-04-10","4","52","4","20","36.2","25.2"
"Wilcox","2020-04-11","3","55","2","22","45.7","30"
"Wilcox","2020-04-12","11","66","11","33","60","37.1"
"Wilcox","2020-04-13","16","82","11","44","59.1","42.1"
"Wilcox","2020-04-14","6","88","2","46","63.9","44.4"
"Wilcox","2020-04-15","6","94","3","49","66.3","40.9"
"Wilcox","2020-04-16","2","96","0","49","59.8","40.9"
"Wilcox","2020-04-17","10","106","6","55","54.1","45.1"
"Wilcox","2020-04-18","6","112","3","58","51.7","48.7"
"Wilcox","2020-04-19","0","112","0","58","37.4","48.7"
"Wilcox","2020-04-20","5","117","1","59","30.5","44.8"
"Wilcox","2020-04-21","6","123","2","61","30.5","47.2"
"Wilcox","2020-04-22","23","146","14","75","32","49.1"
"Wilcox","2020-04-23","15","161","13","88","44.4","52.1"
"Wilcox","2020-04-24","1","162","0","88","35.8","45"
"Wilcox","2020-04-25","2","164","0","88","28.7","40.2"
"Wilcox","2020-04-26","65","229","1","89","28.9","33.2"
"Wilcox","2020-04-27","66","295","1","90","26.3","28.4"
"Wilcox","2020-04-28","6","301","1","91","23.9","27.2"
"Wilcox","2020-04-29","3","304","0","91","15.2","23.6"
"Wilcox","2020-04-30","0","304","0","91","2.8","23.6"
"Wilcox","2020-05-01","6","310","0","91","2.8","19.3"
"Wilcox","2020-05-02","0","310","0","91","2.8","15.8"
"Wilcox","2020-05-03","1","311","0","91","2.6","15.8"
"Wilcox","2020-05-04","6","317","0","91","2.4","14.3"
"Wilcox","2020-05-05","5","322","0","91","0","11.9"
"Wilcox","2020-05-06","5","327","0","91","0","7.6"
"Wilcox","2020-05-07","3","330","0","91","0","1.4"
"Wilcox","2020-05-08","5","335","0","91","0","1.4"
"Wilcox","2020-05-09","1","336","0","91","0","1.4"
"Wilcox","2020-05-10","0","336","0","91","0","1.3"
"Wilcox","2020-05-11","91","427","5","96","0.8","1.6"
"Wilcox","2020-05-12","1","428","0","96","0.8","0.4"
"Wilcox","2020-05-13","2","430","0","96","0.8","0.4"
"Wilcox","2020-05-14","3","433","0","96","0.8","0.4"
"Wilcox","2020-05-15","5","438","0","96","0.8","0.4"
"Wilcox","2020-05-16","34","472","2","98","1.6","0.8"
"Wilcox","2020-05-17","2","474","0","98","1.6","0.8"
"Wilcox","2020-05-18","88","562","4","102","1.5","1.1"
"Wilcox","2020-05-19","7","569","2","104","5.6","3.2"
"Wilcox","2020-05-20","8","577","0","104","5.6","3.2"
"Wilcox","2020-05-21","6","583","2","106","10.3","5.6"
"Wilcox","2020-05-22","4","587","1","107","13.9","7.3"
"Wilcox","2020-05-23","1","588","1","108","27.4","14.5"
"Wilcox","2020-05-24","2","590","1","109","34.5","18.1"
"Wilcox","2020-05-25","1","591","0","109","33.8","17.7"
"Wilcox","2020-05-26","12","603","2","111","32.1","18.9"
"Wilcox","2020-05-27","4","607","0","111","32.1","18.9"
"Wilcox","2020-05-28","8","615","1","112","29.2","19.7"
"Wilcox","2020-05-29","15","630","1","113","26.5","20.2"
"Wilcox","2020-05-30","0","630","0","113","12.3","19.8"
"Wilcox","2020-05-31","2","632","0","113","5.1","19.8"
"Wilcox","2020-06-01","3","635","0","113","5.1","19.5"
"Wilcox","2020-06-02","2","637","1","114","9.9","21"
"Wilcox","2020-06-03","4","641","0","114","9.9","21"
"Wilcox","2020-06-04","2","643","0","114","8.1","18.6"
"Wilcox","2020-06-05","2","645","0","114","7.1","16.8"
"Wilcox","2020-06-06","4","649","1","115","10.7","11.5"
"Wilcox","2020-06-07","1","650","0","115","10.7","7.9"
"Wilcox","2020-06-08","5","655","0","115","10.7","7.9"
"Wilcox","2020-06-09","4","659","2","117","10.7","10.3"
"Wilcox","2020-06-10","7","666","1","118","12.8","11.3"
"Wilcox","2020-06-11","8","674","1","119","14.5","11.3"
"Wilcox","2020-06-12","7","681","1","120","16.6","11.9"
"Wilcox","2020-06-13","2","683","0","120","13","11.9"
"Wilcox","2020-06-14","2","685","2","122","27.3","19"
"Wilcox","2020-06-15","3","688","0","122","27.3","19"
"Wilcox","2020-06-16","10","698","0","122","20.2","15.4"
"Wilcox","2020-06-17","18","716","0","122","18.1","15.4"
"Wilcox","2020-06-18","6","722","3","125","23.5","19"
"Wilcox","2020-06-19","4","726","0","125","21.4","19"
"Wilcox","2020-06-20","5","731","1","126","24.3","18.6"
"Wilcox","2020-06-21","7","738","0","126","10","18.6"
"Wilcox","2020-06-22","6","744","0","126","10","18.6"
"Wilcox","2020-06-23","3","747","1","127","14.8","17.5"
"Wilcox","2020-06-24","35","782","0","127","14.8","16.4"
"Wilcox","2020-06-25","8","790","0","127","7.6","15.5"
"Wilcox","2020-06-26","2","792","0","127","7.6","14.5"
"Wilcox","2020-06-27","2","794","0","127","4.8","14.5"
"Wilcox","2020-06-28","0","794","0","127","4.8","7.4"
"Wilcox","2020-06-29","6","800","0","127","4.8","7.4"
"Wilcox","2020-06-30","5","805","0","127","0","7.4"
"Wilcox","2020-07-01","39","844","0","127","0","7.4"
"Wilcox","2020-07-02","8","852","2","129","3.6","5.6"
"Wilcox","2020-07-03","0","852","0","129","3.6","5.6"
"Wilcox","2020-07-04","1","853","0","129","3.6","4.2"
"Wilcox","2020-07-05","4","857","1","130","7.1","6"
"Wilcox","2020-07-06","7","864","0","130","7.1","6"
"Wilcox","2020-07-07","5","869","0","130","7.1","3.6"
"Wilcox","2020-07-08","37","906","0","130","7.1","3.6"
"Wilcox","2020-07-09","3","909","2","132","13.1","8.3"
"Wilcox","2020-07-10","8","917","0","132","13.1","8.3"
"Wilcox","2020-07-11","3","920","0","132","13.1","8.3"
"Wilcox","2020-07-12","0","920","0","132","9.5","8.3"
"Wilcox","2020-07-13","7","927","1","133","11.6","9.4"
"Wilcox","2020-07-14","4","931","1","134","15.1","11.1"
"Wilcox","2020-07-15","33","964","0","134","15.1","11.1"
"Wilcox","2020-07-16","5","969","3","137","14.2","13.6"
"Wilcox","2020-07-17","7","976","1","138","16.2","14.7"
"Wilcox","2020-07-18","3","979","0","138","16.2","14.7"
"Wilcox","2020-07-19","5","984","1","139","19.1","14.3"
"Wilcox","2020-07-20","3","987","2","141","26.6","19.1"
"Wilcox","2020-07-21","7","994","1","142","25","20.1"
"Wilcox","2020-07-22","18","1012","0","142","25","20.1"
"Wilcox","2020-07-23","10","1022","5","147","23.6","18.9"
"Wilcox","2020-07-24","10","1032","1","148","23","19.6"
"Wilcox","2020-07-25","1","1033","0","148","23","19.6"
"Wilcox","2020-07-26","1","1034","0","148","20.1","19.6"
"Wilcox","2020-07-27","3","1037","2","150","20.1","23.4"
"Wilcox","2020-07-28","10","1047","2","152","21","23"
"Wilcox","2020-07-29","43","1090","4","156","22.3","23.7"
"Wilcox","2020-07-30","9","1099","2","158","18.3","21"
"Wilcox","2020-07-31","3","1102","3","161","31.2","27.1"
"Wilcox","2020-08-01","2","1104","0","161","31.2","27.1"
"Wilcox","2020-08-02","6","1110","2","163","35.9","28"
"Wilcox","2020-08-03","5","1115","1","164","29.3","24.7"
"Wilcox","2020-08-04","7","1122","3","167","32.5","26.7"
"Wilcox","2020-08-05","39","1161","2","169","31.9","27.1"
"Wilcox","2020-08-06","7","1168","0","169","28.8","23.5"
"Wilcox","2020-08-07","5","1173","0","169","14.5","22.8"
"Wilcox","2020-08-08","2","1175","0","169","14.5","22.8"
"Wilcox","2020-08-09","4","1179","2","171","16.9","26.4"
"Wilcox","2020-08-10","8","1187","2","173","17.6","23.4"
"Wilcox","2020-08-11","8","1195","2","175","15","23.8"
"Wilcox","2020-08-12","37","1232","3","178","15.4","23.7"
"Wilcox","2020-08-13","6","1238","1","179","17.8","23.3"
"Wilcox","2020-08-14","3","1241","1","180","22.6","18.5"
"Wilcox","2020-08-15","5","1246","0","180","22.6","18.5"
"Wilcox","2020-08-16","2","1248","2","182","29.7","23.3"
"Wilcox","2020-08-17","9","1257","0","182","26.2","21.9"
"Wilcox","2020-08-18","6","1263","1","183","25","20"
"Wilcox","2020-08-19","37","1300","6","189","26.1","20.8"
"Wilcox","2020-08-20","6","1306","1","190","26.1","22"
"Wilcox","2020-08-21","6","1312","1","191","23.7","23.2"
"Wilcox","2020-08-22","2","1314","0","191","23.7","23.2"
"Wilcox","2020-08-23","1","1315","0","191","9.5","19.6"
"Wilcox","2020-08-24","7","1322","0","191","9.5","17.8"
"Wilcox","2020-08-25","5","1327","2","193","12.8","18.9"
"Wilcox","2020-08-26","37","1364","4","197","12","19.1"
"Wilcox","2020-08-27","2","1366","0","197","9.6","17.9"
"Wilcox","2020-08-28","4","1370","1","198","10.8","17.3"
"Wilcox","2020-08-29","2","1372","0","198","10.8","17.3"
"Wilcox","2020-08-30","1","1373","0","198","10.8","10.1"
"Wilcox","2020-08-31","9","1382","1","199","12.4","10.9"
"Wilcox","2020-09-01","11","1393","1","200","8","10.4"
"Wilcox","2020-09-02","21","1414","1","201","7.1","9.6"
"Wilcox","2020-09-03","4","1418","1","202","10.7","10.2"
"Wilcox","2020-09-04","4","1422","0","202","7.1","9"
"Wilcox","2020-09-05","2","1424","0","202","7.1","9"
"Wilcox","2020-09-06","4","1428","1","203","10.7","10.8"
"Wilcox","2020-09-07","4","1432","0","203","9.1","10.8"
"Wilcox","2020-09-08","9","1441","1","204","9.4","8.7"
"Wilcox","2020-09-09","19","1460","1","205","9.5","8.3"
"Wilcox","2020-09-10","15","1475","1","206","6.9","8.8"
"Wilcox","2020-09-11","7","1482","2","208","10.9","9"
"Wilcox","2020-09-12","2","1484","1","209","18.1","12.6"
"Wilcox","2020-09-13","2","1486","0","209","14.5","12.6"
"Wilcox","2020-09-14","4","1490","0","209","14.5","11.8"
"Wilcox","2020-09-15","4","1494","2","211","20.1","14.7"
"Wilcox","2020-09-16","5","1499","0","211","19.3","14.4"
"Wilcox","2020-09-17","5","1504","0","211","18.4","12.6"
"Wilcox","2020-09-18","4","1508","0","211","14.3","12.6"
"Wilcox","2020-09-19","3","1511","1","212","11.9","15"
"Wilcox","2020-09-20","0","1511","0","212","11.9","13.2"
"Wilcox","2020-09-21","1","1512","0","212","11.9","13.2"
"Wilcox","2020-09-22","7","1519","1","213","6.8","13.4"
"Wilcox","2020-09-23","30","1549","1","214","7.3","13.3"
"Wilcox","2020-09-24","4","1553","0","214","7.3","12.8"
"Wilcox","2020-09-25","3","1556","0","214","7.3","10.8"
"Wilcox","2020-09-26","1","1557","0","214","2.5","7.2"
"Wilcox","2020-09-27","2","1559","0","214","2.5","7.2"
"Wilcox","2020-09-28","5","1564","0","214","2.5","7.2"
"Wilcox","2020-09-29","5","1569","1","215","3.3","5.1"
"Wilcox","2020-09-30","2","1571","0","215","2.9","5.1"
"Wilcox","2020-10-01","1","1572","0","215","2.9","5.1"
"Wilcox","2020-10-02","7","1579","0","215","2.9","5.1"
"Wilcox","2020-10-03","2","1581","0","215","2.9","2.7"
"Wilcox","2020-10-04","4","1585","0","215","2.9","2.7"
"Wilcox","2020-10-05","4","1589","0","215","2.9","2.7"
"Wilcox","2020-10-06","1","1590","0","215","0","1.7"
"Wilcox","2020-10-07","28","1618","0","215","0","1.4"
"Wilcox","2020-10-08","5","1623","1","216","2.9","2.9"
"Wilcox","2020-10-09","6","1629","0","216","2.9","2.9"
"Wilcox","2020-10-10","4","1633","0","216","2.9","2.9"
"Wilcox","2020-10-11","4","1637","0","216","2.9","2.9"
"Wilcox","2020-10-12","1","1638","0","216","2.9","2.9"
"Wilcox","2020-10-13","2","1640","0","216","2.9","1.4"
"Wilcox","2020-10-14","25","1665","1","217","3.4","1.7"
"Wilcox","2020-10-15","4","1669","0","217","0.6","1.7"
"Wilcox","2020-10-16","1","1670","0","217","0.6","1.7"
"Wilcox","2020-10-17","3","1673","0","217","0.6","1.7"
"Wilcox","2020-10-18","1","1674","0","217","0.6","1.7"
"Wilcox","2020-10-19","7","1681","0","217","0.6","1.7"
"Wilcox","2020-10-20","6","1687","0","217","0.6","1.7"
"Wilcox","2020-10-21","31","1718","3","220","1.4","2.4"
"Wilcox","2020-10-22","3","1721","0","220","1.4","1"
"Wilcox","2020-10-23","3","1724","0","220","1.4","1"
"Wilcox","2020-10-24","0","1724","0","220","1.4","1"
"Wilcox","2020-10-25","0","1724","0","220","1.4","1"
"Wilcox","2020-10-26","4","1728","0","220","1.4","1"
"Wilcox","2020-10-27","4","1732","0","220","1.4","1"
"Wilcox","2020-10-28","30","1762","0","220","0","0.7"
"Wilcox","2020-10-29","6","1768","1","221","2.4","1.9"
"Wilcox","2020-10-30","2","1770","0","221","2.4","1.9"
"Wilcox","2020-10-31","2","1772","0","221","2.4","1.9"
"Wilcox","2020-11-01","1","1773","0","221","2.4","1.9"
"Wilcox","2020-11-02","20","1793","0","221","2.4","1.9"
"Wilcox","2020-11-03","6","1799","0","221","2.4","1.9"
"Wilcox","2020-11-04","10","1809","1","222","3.8","1.9"
"Wilcox","2020-11-05","72","1881","0","222","1.4","1.9"
"Wilcox","2020-11-06","47","1928","0","222","1.4","1.9"
"Wilcox","2020-11-07","1","1929","0","222","1.4","1.9"
"Wilcox","2020-11-08","0","1929","0","222","1.4","1.9"
"Wilcox","2020-11-09","7","1936","0","222","1.4","1.9"
"Wilcox","2020-11-10","316","2252","3","225","1.6","2"
"Wilcox","2020-11-11","4","2256","0","225","0.1","2"
"Wilcox","2020-11-12","2","2258","0","225","0.1","0.8"
"Wilcox","2020-11-13","4","2262","1","226","3.7","2.6"
"Wilcox","2020-11-14","2","2264","0","226","3.7","2.6"
"Wilcox","2020-11-15","3","2267","0","226","3.7","2.6"
"Wilcox","2020-11-16","2","2269","0","226","3.7","2.6"
"Wilcox","2020-11-17","112","2381","2","228","3.8","2.7"
"Wilcox","2020-11-18","118","2499","4","232","4.3","2.2"
"Wilcox","2020-11-19","123","2622","2","234","4.5","2.3"
"Wilcox","2020-11-20","8","2630","0","234","1","2.3"
"Wilcox","2020-11-21","6","2636","3","237","8.1","5.9"
"Wilcox","2020-11-22","3","2639","1","238","12.9","8.3"
"Wilcox","2020-11-23","6","2645","0","238","12.9","8.3"
"Wilcox","2020-11-24","6","2651","1","239","15","9.4"
"Wilcox","2020-11-25","10","2661","1","240","15.9","10.1"
"Wilcox","2020-11-26","1","2662","0","240","15.7","10.1"
"Wilcox","2020-11-27","6","2668","3","243","22.9","11.9"
"Wilcox","2020-11-28","2","2670","2","245","30","19.1"
"Wilcox","2020-11-29","0","2670","0","245","25.2","19.1"
"Wilcox","2020-11-30","8","2678","0","245","25.2","19.1"
"Wilcox","2020-12-01","12","2690","2","247","25.2","20.1"
"Wilcox","2020-12-02","30","2720","2","249","24.8","20.4"
"Wilcox","2020-12-03","6","2726","0","249","24.8","20.2"
"Wilcox","2020-12-04","2","2728","0","249","17.6","20.2"
"Wilcox","2020-12-05","6","2734","5","254","15.2","22.6"
"Wilcox","2020-12-06","0","2734","0","254","15.2","20.2"
"Wilcox","2020-12-07","9","2743","0","254","15.2","20.2"
"Wilcox","2020-12-08","23","2766","0","254","12.9","19"
"Wilcox","2020-12-09","65","2831","4","258","12.8","18.8"
"Wilcox","2020-12-10","85","2916","3","261","13.3","19"
"Wilcox","2020-12-11","10","2926","0","261","13.3","15.5"
"Wilcox","2020-12-12","3","2929","0","261","1.4","8.3"
"Wilcox","2020-12-13","1","2930","0","261","1.4","8.3"
"Wilcox","2020-12-14","123","3053","22","283","3.9","9.6"
"Wilcox","2020-12-15","8","3061","1","284","5.7","9.3"
"Wilcox","2020-12-16","76","3137","0","284","4.8","8.8"
"Wilcox","2020-12-17","119","3256","0","284","4.3","8.8"
"Wilcox","2020-12-18","27","3283","1","285","4.9","9.1"
"Wilcox","2020-12-19","5","3288","0","285","4.9","3.1"
"Wilcox","2020-12-20","1","3289","0","285","4.9","3.1"
"Wilcox","2020-12-21","121","3410","0","285","2.3","3.1"
"Wilcox","2020-12-22","13","3423","1","286","1.6","3.7"
"Wilcox","2020-12-23","57","3480","4","290","2.6","3.7"
"Wilcox","2020-12-24","6","3486","2","292","7.4","5.9"
"Wilcox","2020-12-25","1","3487","1","293","21.1","13"
"Wilcox","2020-12-26","4","3491","2","295","28.3","16.6"
"Wilcox","2020-12-27","1","3492","1","296","42.6","23.7"
"Wilcox","2020-12-28","8","3500","2","298","46.1","24.2"
"Wilcox","2020-12-29","4","3504","0","298","45.1","23.3"
"Wilcox","2020-12-30","45","3549","5","303","45.6","24.1"
"Wilcox","2020-12-31","2","3551","0","303","40.9","24.1"
"Wilcox","2021-01-01","0","3551","0","303","26.6","23.9"
"Wilcox","2021-01-02","4","3555","0","303","19.4","23.9"
"Wilcox","2021-01-03","4","3559","0","303","5.2","23.9"
"Wilcox","2021-01-04","9","3568","0","303","1.6","23.9"
"Wilcox","2021-01-05","10","3578","0","303","1.6","23.3"
"Wilcox","2021-01-06","70","3648","12","315","2.4","24"
"Wilcox","2021-01-07","10","3658","4","319","8.2","24.5"
"Wilcox","2021-01-08","4","3662","0","319","8.2","17.4"
"Wilcox","2021-01-09","0","3662","0","319","8.2","13.8"
"Wilcox","2021-01-10","2","3664","1","320","15.3","10.2"
"Wilcox","2021-01-11","15","3679","1","321","16.3","8.9"
"Wilcox","2021-01-12","6","3685","0","321","16.3","8.9"
"Wilcox","2021-01-13","51","3736","7","328","15.8","9.1"
"Wilcox","2021-01-14","9","3745","0","328","10.1","9.1"
"Wilcox","2021-01-15","10","3755","3","331","14.3","11.3"
"Wilcox","2021-01-16","3","3758","0","331","14.3","11.3"
"Wilcox","2021-01-17","2","3760","1","332","14.3","14.8"
"Wilcox","2021-01-18","9","3769","1","333","15","15.6"
"Wilcox","2021-01-19","4","3773","0","333","15","15.6"
"Wilcox","2021-01-20","8","3781","1","334","14.8","15.3"
"Wilcox","2021-01-21","5","3786","1","335","17.7","13.9"
"Wilcox","2021-01-22","5","3791","0","335","13.4","13.9"
"Wilcox","2021-01-23","2","3793","2","337","27.7","21"
"Wilcox","2021-01-24","3","3796","0","337","20.5","17.4"
"Wilcox","2021-01-25","3","3799","0","337","18.9","17"
"Wilcox","2021-01-26","0","3799","0","337","18.9","17"
"Wilcox","2021-01-27","0","3799","0","337","17.1","16"
"Wilkes","2020-02-01","0","0","0","0",".","."
"Wilkes","2020-02-02","0","0","0","0",".","."
"Wilkes","2020-02-03","0","0","0","0",".","."
"Wilkes","2020-02-04","0","0","0","0",".","."
"Wilkes","2020-02-05","0","0","0","0",".","."
"Wilkes","2020-02-06","0","0","0","0",".","."
"Wilkes","2020-02-07","0","0","0","0","0","."
"Wilkes","2020-02-08","0","0","0","0","0","."
"Wilkes","2020-02-09","0","0","0","0","0","."
"Wilkes","2020-02-10","0","0","0","0","0","."
"Wilkes","2020-02-11","0","0","0","0","0","."
"Wilkes","2020-02-12","0","0","0","0","0","."
"Wilkes","2020-02-13","0","0","0","0","0","."
"Wilkes","2020-02-14","0","0","0","0","0","0"
"Wilkes","2020-02-15","0","0","0","0","0","0"
"Wilkes","2020-02-16","0","0","0","0","0","0"
"Wilkes","2020-02-17","0","0","0","0","0","0"
"Wilkes","2020-02-18","0","0","0","0","0","0"
"Wilkes","2020-02-19","0","0","0","0","0","0"
"Wilkes","2020-02-20","0","0","0","0","0","0"
"Wilkes","2020-02-21","0","0","0","0","0","0"
"Wilkes","2020-02-22","0","0","0","0","0","0"
"Wilkes","2020-02-23","0","0","0","0","0","0"
"Wilkes","2020-02-24","0","0","0","0","0","0"
"Wilkes","2020-02-25","0","0","0","0","0","0"
"Wilkes","2020-02-26","0","0","0","0","0","0"
"Wilkes","2020-02-27","0","0","0","0","0","0"
"Wilkes","2020-02-28","0","0","0","0","0","0"
"Wilkes","2020-02-29","0","0","0","0","0","0"
"Wilkes","2020-03-01","0","0","0","0","0","0"
"Wilkes","2020-03-02","0","0","0","0","0","0"
"Wilkes","2020-03-03","0","0","0","0","0","0"
"Wilkes","2020-03-04","0","0","0","0","0","0"
"Wilkes","2020-03-05","0","0","0","0","0","0"
"Wilkes","2020-03-06","0","0","0","0","0","0"
"Wilkes","2020-03-07","0","0","0","0","0","0"
"Wilkes","2020-03-08","0","0","0","0","0","0"
"Wilkes","2020-03-09","0","0","0","0","0","0"
"Wilkes","2020-03-10","0","0","0","0","0","0"
"Wilkes","2020-03-11","0","0","0","0","0","0"
"Wilkes","2020-03-12","0","0","0","0","0","0"
"Wilkes","2020-03-13","0","0","0","0","0","0"
"Wilkes","2020-03-14","0","0","0","0","0","0"
"Wilkes","2020-03-15","0","0","0","0","0","0"
"Wilkes","2020-03-16","1","1","0","0","0","0"
"Wilkes","2020-03-17","0","1","0","0","0","0"
"Wilkes","2020-03-18","2","3","0","0","0","0"
"Wilkes","2020-03-19","0","3","0","0","0","0"
"Wilkes","2020-03-20","1","4","1","1","14.3","7.1"
"Wilkes","2020-03-21","0","4","0","1","14.3","7.1"
"Wilkes","2020-03-22","1","5","1","2","28.6","14.3"
"Wilkes","2020-03-23","0","5","0","2","28.6","14.3"
"Wilkes","2020-03-24","0","5","0","2","28.6","14.3"
"Wilkes","2020-03-25","4","9","1","3","32.1","16.1"
"Wilkes","2020-03-26","0","9","0","3","32.1","16.1"
"Wilkes","2020-03-27","3","12","0","3","17.9","16.1"
"Wilkes","2020-03-28","0","12","0","3","17.9","16.1"
"Wilkes","2020-03-29","1","13","0","3","3.6","16.1"
"Wilkes","2020-03-30","3","16","0","3","3.6","16.1"
"Wilkes","2020-03-31","1","17","0","3","3.6","16.1"
"Wilkes","2020-04-01","2","19","0","3","0","16.1"
"Wilkes","2020-04-02","1","20","0","3","0","16.1"
"Wilkes","2020-04-03","5","25","3","6","8.6","13.2"
"Wilkes","2020-04-04","3","28","0","6","8.6","13.2"
"Wilkes","2020-04-05","1","29","0","6","8.6","6.1"
"Wilkes","2020-04-06","0","29","0","6","8.6","6.1"
"Wilkes","2020-04-07","5","34","0","6","8.6","6.1"
"Wilkes","2020-04-08","2","36","0","6","8.6","4.3"
"Wilkes","2020-04-09","2","38","0","6","8.6","4.3"
"Wilkes","2020-04-10","0","38","0","6","0","4.3"
"Wilkes","2020-04-11","3","41","0","6","0","4.3"
"Wilkes","2020-04-12","1","42","0","6","0","4.3"
"Wilkes","2020-04-13","3","45","2","8","9.5","9"
"Wilkes","2020-04-14","1","46","0","8","9.5","9"
"Wilkes","2020-04-15","0","46","0","8","9.5","9"
"Wilkes","2020-04-16","48","94","10","18","12.5","10.5"
"Wilkes","2020-04-17","24","118","1","19","13.1","6.5"
"Wilkes","2020-04-18","8","126","2","21","16.7","8.3"
"Wilkes","2020-04-19","0","126","0","21","16.7","8.3"
"Wilkes","2020-04-20","2","128","0","21","7.1","8.3"
"Wilkes","2020-04-21","12","140","2","23","9.5","9.5"
"Wilkes","2020-04-22","24","164","0","23","9.5","9.5"
"Wilkes","2020-04-23","9","173","0","23","6.5","9.5"
"Wilkes","2020-04-24","18","191","0","23","6","9.5"
"Wilkes","2020-04-25","3","194","0","23","2.4","9.5"
"Wilkes","2020-04-26","4","198","0","23","2.4","9.5"
"Wilkes","2020-04-27","2","200","1","24","9.5","8.3"
"Wilkes","2020-04-28","8","208","0","24","7.1","8.3"
"Wilkes","2020-04-29","12","220","3","27","10.7","10.1"
"Wilkes","2020-04-30","1","221","0","27","10.7","8.6"
"Wilkes","2020-05-01","5","226","0","27","10.7","8.3"
"Wilkes","2020-05-02","6","232","0","27","10.7","6.5"
"Wilkes","2020-05-03","0","232","0","27","10.7","6.5"
"Wilkes","2020-05-04","6","238","0","27","3.6","6.5"
"Wilkes","2020-05-05","7","245","0","27","3.6","5.4"
"Wilkes","2020-05-06","6","251","0","27","0","5.4"
"Wilkes","2020-05-07","4","255","0","27","0","5.4"
"Wilkes","2020-05-08","3","258","0","27","0","5.4"
"Wilkes","2020-05-09","7","265","0","27","0","5.4"
"Wilkes","2020-05-10","1","266","0","27","0","5.4"
"Wilkes","2020-05-11","3","269","0","27","0","1.8"
"Wilkes","2020-05-12","9","278","1","28","1.6","2.6"
"Wilkes","2020-05-13","4","282","0","28","1.6","0.8"
"Wilkes","2020-05-14","3","285","0","28","1.6","0.8"
"Wilkes","2020-05-15","8","293","1","29","3.4","1.7"
"Wilkes","2020-05-16","5","298","0","29","3.4","1.7"
"Wilkes","2020-05-17","0","298","0","29","3.4","1.7"
"Wilkes","2020-05-18","5","303","1","30","6.2","3.1"
"Wilkes","2020-05-19","7","310","0","30","4.6","3.1"
"Wilkes","2020-05-20","6","316","1","31","7","4.3"
"Wilkes","2020-05-21","8","324","0","31","7","4.3"
"Wilkes","2020-05-22","10","334","0","31","5.2","4.3"
"Wilkes","2020-05-23","4","338","0","31","5.2","4.3"
"Wilkes","2020-05-24","8","346","0","31","5.2","4.3"
"Wilkes","2020-05-25","0","346","0","31","2.4","4.3"
"Wilkes","2020-05-26","4","350","0","31","2.4","3.5"
"Wilkes","2020-05-27","6","356","0","31","0","3.5"
"Wilkes","2020-05-28","3","359","0","31","0","3.5"
"Wilkes","2020-05-29","5","364","0","31","0","2.6"
"Wilkes","2020-05-30","7","371","0","31","0","2.6"
"Wilkes","2020-05-31","1","372","0","31","0","2.6"
"Wilkes","2020-06-01","5","377","0","31","0","1.2"
"Wilkes","2020-06-02","10","387","0","31","0","1.2"
"Wilkes","2020-06-03","7","394","0","31","0","0"
"Wilkes","2020-06-04","7","401","0","31","0","0"
"Wilkes","2020-06-05","6","407","0","31","0","0"
"Wilkes","2020-06-06","1","408","0","31","0","0"
"Wilkes","2020-06-07","2","410","0","31","0","0"
"Wilkes","2020-06-08","2","412","0","31","0","0"
"Wilkes","2020-06-09","22","434","1","32","0.6","0.3"
"Wilkes","2020-06-10","9","443","1","33","2.2","1.1"
"Wilkes","2020-06-11","70","513","0","33","2.2","1.1"
"Wilkes","2020-06-12","11","524","0","33","2.2","1.1"
"Wilkes","2020-06-13","3","527","0","33","2.2","1.1"
"Wilkes","2020-06-14","1","528","0","33","2.2","1.1"
"Wilkes","2020-06-15","9","537","1","34","3.8","1.9"
"Wilkes","2020-06-16","13","550","0","34","3.2","1.9"
"Wilkes","2020-06-17","7","557","0","34","1.6","1.9"
"Wilkes","2020-06-18","7","564","0","34","1.6","1.9"
"Wilkes","2020-06-19","7","571","0","34","1.6","1.9"
"Wilkes","2020-06-20","3","574","0","34","1.6","1.9"
"Wilkes","2020-06-21","2","576","1","35","8.7","5.5"
"Wilkes","2020-06-22","10","586","0","35","7.1","5.5"
"Wilkes","2020-06-23","13","599","0","35","7.1","5.2"
"Wilkes","2020-06-24","9","608","2","37","10.3","6"
"Wilkes","2020-06-25","46","654","0","37","10.3","6"
"Wilkes","2020-06-26","9","663","0","37","10.3","6"
"Wilkes","2020-06-27","3","666","0","37","10.3","6"
"Wilkes","2020-06-28","2","668","0","37","3.2","6"
"Wilkes","2020-06-29","14","682","2","39","5.2","6.2"
"Wilkes","2020-06-30","8","690","1","40","7","7.1"
"Wilkes","2020-07-01","51","741","3","43","4.7","7.5"
"Wilkes","2020-07-02","13","754","5","48","10.2","10.2"
"Wilkes","2020-07-03","3","757","0","48","10.2","10.2"
"Wilkes","2020-07-04","5","762","1","49","13","11.7"
"Wilkes","2020-07-05","11","773","3","52","16.9","10"
"Wilkes","2020-07-06","6","779","0","52","14.9","10"
"Wilkes","2020-07-07","10","789","1","53","14.5","10.8"
"Wilkes","2020-07-08","11","800","1","54","15","9.8"
"Wilkes","2020-07-09","7","807","2","56","13.6","11.9"
"Wilkes","2020-07-10","10","817","2","58","16.4","13.3"
"Wilkes","2020-07-11","12","829","4","62","18.3","15.7"
"Wilkes","2020-07-12","10","839","1","63","15.9","16.4"
"Wilkes","2020-07-13","9","848","2","65","19","17"
"Wilkes","2020-07-14","7","855","0","65","17.6","16.1"
"Wilkes","2020-07-15","7","862","1","66","18.3","16.7"
"Wilkes","2020-07-16","10","872","2","68","17.1","15.3"
"Wilkes","2020-07-17","4","876","0","68","14.3","15.3"
"Wilkes","2020-07-18","12","888","1","69","10.7","14.5"
"Wilkes","2020-07-19","5","893","0","69","9.3","12.6"
"Wilkes","2020-07-20","7","900","2","71","10.2","14.6"
"Wilkes","2020-07-21","7","907","1","72","12.2","14.9"
"Wilkes","2020-07-22","8","915","0","72","10.2","14.3"
"Wilkes","2020-07-23","8","923","1","73","9.1","13.1"
"Wilkes","2020-07-24","15","938","1","74","10.1","12.2"
"Wilkes","2020-07-25","7","945","1","75","10.9","10.8"
"Wilkes","2020-07-26","9","954","0","75","10.9","10.1"
"Wilkes","2020-07-27","10","964","0","75","6.8","8.5"
"Wilkes","2020-07-28","11","975","1","76","6.1","9.1"
"Wilkes","2020-07-29","54","1029","0","76","6.1","8.1"
"Wilkes","2020-07-30","6","1035","2","78","9.1","9.1"
"Wilkes","2020-07-31","6","1041","0","78","8.1","9.1"
"Wilkes","2020-08-01","9","1050","0","78","6.1","8.5"
"Wilkes","2020-08-02","7","1057","1","79","8.1","9.5"
"Wilkes","2020-08-03","11","1068","0","79","8.1","7.5"
"Wilkes","2020-08-04","5","1073","1","80","9.7","7.9"
"Wilkes","2020-08-05","64","1137","2","82","10.1","8.1"
"Wilkes","2020-08-06","9","1146","0","82","5.3","7.2"
"Wilkes","2020-08-07","1","1147","0","82","5.3","6.7"
"Wilkes","2020-08-08","5","1152","0","82","5.3","5.7"
"Wilkes","2020-08-09","4","1156","0","82","3.3","5.7"
"Wilkes","2020-08-10","9","1165","1","83","4.9","6.5"
"Wilkes","2020-08-11","8","1173","0","83","2","5.8"
"Wilkes","2020-08-12","77","1250","0","83","1.6","5.8"
"Wilkes","2020-08-13","12","1262","0","83","1.6","3.5"
"Wilkes","2020-08-14","12","1274","2","85","4","4.7"
"Wilkes","2020-08-15","9","1283","1","86","5.6","5.4"
"Wilkes","2020-08-16","46","1329","0","86","5.6","4.4"
"Wilkes","2020-08-17","9","1338","0","86","4","4.4"
"Wilkes","2020-08-18","6","1344","0","86","4","3"
"Wilkes","2020-08-19","31","1375","1","87","4.4","3"
"Wilkes","2020-08-20","4","1379","1","88","8","4.8"
"Wilkes","2020-08-21","5","1384","2","90","11.3","7.7"
"Wilkes","2020-08-22","2","1386","0","90","9.7","7.7"
"Wilkes","2020-08-23","6","1392","0","90","9.7","7.7"
"Wilkes","2020-08-24","12","1404","0","90","9.7","6.9"
"Wilkes","2020-08-25","5","1409","0","90","9.7","6.9"
"Wilkes","2020-08-26","28","1437","3","93","10.8","7.6"
"Wilkes","2020-08-27","10","1447","1","94","8.7","8.3"
"Wilkes","2020-08-28","10","1457","2","96","5.8","8.6"
"Wilkes","2020-08-29","9","1466","0","96","5.8","7.8"
"Wilkes","2020-08-30","8","1474","0","96","5.8","7.8"
"Wilkes","2020-08-31","8","1482","0","96","5.8","7.8"
"Wilkes","2020-09-01","41","1523","1","97","6.2","8"
"Wilkes","2020-09-02","32","1555","2","99","5.5","8.2"
"Wilkes","2020-09-03","16","1571","1","100","5","6.8"
"Wilkes","2020-09-04","16","1587","2","102","3.9","4.9"
"Wilkes","2020-09-05","12","1599","0","102","3.9","4.9"
"Wilkes","2020-09-06","1","1600","0","102","3.9","4.9"
"Wilkes","2020-09-07","3","1603","0","102","3.9","4.9"
"Wilkes","2020-09-08","13","1616","1","103","4.7","5.4"
"Wilkes","2020-09-09","38","1654","2","105","4.5","5"
"Wilkes","2020-09-10","8","1662","0","105","3.6","4.3"
"Wilkes","2020-09-11","10","1672","1","106","3.3","3.6"
"Wilkes","2020-09-12","10","1682","1","107","4.7","4.3"
"Wilkes","2020-09-13","4","1686","0","107","4.7","4.3"
"Wilkes","2020-09-14","12","1698","0","107","4.7","4.3"
"Wilkes","2020-09-15","13","1711","0","107","3.6","4.1"
"Wilkes","2020-09-16","20","1731","0","107","2.9","3.7"
"Wilkes","2020-09-17","8","1739","0","107","2.9","3.2"
"Wilkes","2020-09-18","8","1747","1","108","3.2","3.2"
"Wilkes","2020-09-19","6","1753","0","108","1.8","3.2"
"Wilkes","2020-09-20","3","1756","0","108","1.8","3.2"
"Wilkes","2020-09-21","8","1764","0","108","1.8","3.2"
"Wilkes","2020-09-22","5","1769","1","109","4.6","4.1"
"Wilkes","2020-09-23","23","1792","1","110","5.3","4.1"
"Wilkes","2020-09-24","6","1798","1","111","7.6","5.3"
"Wilkes","2020-09-25","9","1807","0","111","5.9","4.5"
"Wilkes","2020-09-26","13","1820","1","112","7","4.4"
"Wilkes","2020-09-27","4","1824","0","112","7","4.4"
"Wilkes","2020-09-28","9","1833","0","112","7","4.4"
"Wilkes","2020-09-29","8","1841","0","112","4.1","4.4"
"Wilkes","2020-09-30","26","1867","0","112","3.5","4.4"
"Wilkes","2020-10-01","6","1873","0","112","1.1","4.4"
"Wilkes","2020-10-02","10","1883","0","112","1.1","3.5"
"Wilkes","2020-10-03","11","1894","1","113","1.3","4.1"
"Wilkes","2020-10-04","12","1906","1","114","2.5","4.7"
"Wilkes","2020-10-05","7","1913","1","115","4.5","5.7"
"Wilkes","2020-10-06","2","1915","0","115","4.5","4.3"
"Wilkes","2020-10-07","17","1932","2","117","6.2","4.8"
"Wilkes","2020-10-08","19","1951","0","117","6.2","3.7"
"Wilkes","2020-10-09","7","1958","0","117","6.2","3.7"
"Wilkes","2020-10-10","10","1968","0","117","4.9","3.1"
"Wilkes","2020-10-11","11","1979","0","117","3.7","3.1"
"Wilkes","2020-10-12","8","1987","0","117","1.7","3.1"
"Wilkes","2020-10-13","9","1996","1","118","3.3","3.9"
"Wilkes","2020-10-14","20","2016","0","118","1.6","3.9"
"Wilkes","2020-10-15","11","2027","2","120","4.2","5.2"
"Wilkes","2020-10-16","13","2040","2","122","6.4","6.3"
"Wilkes","2020-10-17","6","2046","0","122","6.4","5.6"
"Wilkes","2020-10-18","10","2056","1","123","7.8","5.8"
"Wilkes","2020-10-19","12","2068","0","123","7.8","4.7"
"Wilkes","2020-10-20","11","2079","0","123","6.2","4.7"
"Wilkes","2020-10-21","29","2108","2","125","7.2","4.4"
"Wilkes","2020-10-22","9","2117","3","128","9.4","6.8"
"Wilkes","2020-10-23","19","2136","2","130","8.7","7.5"
"Wilkes","2020-10-24","12","2148","3","133","12.3","9.3"
"Wilkes","2020-10-25","8","2156","1","134","12.6","10.2"
"Wilkes","2020-10-26","19","2175","0","134","12.6","10.2"
"Wilkes","2020-10-27","25","2200","7","141","16.6","11.4"
"Wilkes","2020-10-28","89","2289","9","150","17.1","12.1"
"Wilkes","2020-10-29","15","2304","3","153","15.2","12.3"
"Wilkes","2020-10-30","18","2322","2","155","15.2","12"
"Wilkes","2020-10-31","9","2331","1","156","13.3","12.8"
"Wilkes","2020-11-01","12","2343","2","158","13.9","13.2"
"Wilkes","2020-11-02","15","2358","1","159","14.8","13.7"
"Wilkes","2020-11-03","11","2369","3","162","14.7","15.7"
"Wilkes","2020-11-04","49","2418","5","167","14.7","15.9"
"Wilkes","2020-11-05","17","2435","0","167","11.9","13.5"
"Wilkes","2020-11-06","24","2459","4","171","12.7","14"
"Wilkes","2020-11-07","13","2472","2","173","13.3","13.3"
"Wilkes","2020-11-08","10","2482","1","174","12.3","13.1"
"Wilkes","2020-11-09","7","2489","2","176","15.4","15.1"
"Wilkes","2020-11-10","21","2510","6","182","15.6","15.2"
"Wilkes","2020-11-11","37","2547","2","184","14.9","14.8"
"Wilkes","2020-11-12","8","2555","1","185","16.7","14.3"
"Wilkes","2020-11-13","16","2571","3","188","17","14.8"
"Wilkes","2020-11-14","14","2585","3","191","17.9","15.6"
"Wilkes","2020-11-15","11","2596","1","192","17.8","15"
"Wilkes","2020-11-16","8","2604","3","195","19","17.2"
"Wilkes","2020-11-17","10","2614","1","196","16.4","16"
"Wilkes","2020-11-18","47","2661","2","198","16.2","15.6"
"Wilkes","2020-11-19","12","2673","2","200","16.8","16.8"
"Wilkes","2020-11-20","10","2683","0","200","14.1","15.6"
"Wilkes","2020-11-21","9","2692","0","200","11.1","14.5"
"Wilkes","2020-11-22","3","2695","0","200","9.8","13.8"
"Wilkes","2020-11-23","11","2706","3","203","8.3","13.7"
"Wilkes","2020-11-24","14","2720","2","205","8.9","12.7"
"Wilkes","2020-11-25","44","2764","6","211","10.3","13.2"
"Wilkes","2020-11-26","6","2770","1","212","10.3","13.5"
"Wilkes","2020-11-27","10","2780","2","214","13.1","13.6"
"Wilkes","2020-11-28","4","2784","0","214","13.1","12.1"
"Wilkes","2020-11-29","7","2791","3","217","19.2","14.5"
"Wilkes","2020-11-30","10","2801","1","218","16.8","12.5"
"Wilkes","2020-12-01","8","2809","2","220","18.3","13.6"
"Wilkes","2020-12-02","41","2850","7","227","18.8","14.5"
"Wilkes","2020-12-03","8","2858","1","228","18.2","14.2"
"Wilkes","2020-12-04","18","2876","4","232","18.5","15.8"
"Wilkes","2020-12-05","7","2883","2","234","22.6","17.9"
"Wilkes","2020-12-06","3","2886","1","235","21.2","20.2"
"Wilkes","2020-12-07","20","2906","5","240","23.4","20.1"
"Wilkes","2020-12-08","12","2918","1","241","21","19.7"
"Wilkes","2020-12-09","36","2954","3","244","19.8","19.3"
"Wilkes","2020-12-10","12","2966","1","245","19.2","18.7"
"Wilkes","2020-12-11","23","2989","2","247","17.2","17.9"
"Wilkes","2020-12-12","7","2996","2","249","17.2","19.9"
"Wilkes","2020-12-13","4","3000","3","252","23.2","22.2"
"Wilkes","2020-12-14","13","3013","1","253","20.7","22"
"Wilkes","2020-12-15","27","3040","7","260","23.2","22.1"
"Wilkes","2020-12-16","76","3116","14","274","24.7","22.2"
"Wilkes","2020-12-17","13","3129","2","276","25.7","22.4"
"Wilkes","2020-12-18","15","3144","2","278","26.3","21.8"
"Wilkes","2020-12-19","15","3159","6","284","28","22.6"
"Wilkes","2020-12-20","10","3169","0","284","17.3","20.2"
"Wilkes","2020-12-21","14","3183","2","286","18.2","19.5"
"Wilkes","2020-12-22","25","3208","3","289","16.2","19.7"
"Wilkes","2020-12-23","64","3272","8","297","15.4","20"
"Wilkes","2020-12-24","8","3280","1","298","14.9","20.3"
"Wilkes","2020-12-25","0","3280","0","298","13","19.7"
"Wilkes","2020-12-26","7","3287","1","299","9.4","18.7"
"Wilkes","2020-12-27","6","3293","2","301","14.1","15.7"
"Wilkes","2020-12-28","15","3308","2","303","14","16.1"
"Wilkes","2020-12-29","31","3339","2","305","13.2","14.7"
"Wilkes","2020-12-30","46","3385","12","317","15.1","15.2"
"Wilkes","2020-12-31","29","3414","9","326","17.8","16.4"
"Wilkes","2021-01-01","3","3417","0","326","17.8","15.4"
"Wilkes","2021-01-02","10","3427","2","328","18.6","14"
"Wilkes","2021-01-03","7","3434","2","330","17.9","16"
"Wilkes","2021-01-04","14","3448","4","334","20.1","17"
"Wilkes","2021-01-05","44","3492","13","347","23.4","18.3"
"Wilkes","2021-01-06","114","3606","22","369","22.4","18.8"
"Wilkes","2021-01-07","11","3617","2","371","20.6","19.2"
"Wilkes","2021-01-08","18","3635","4","375","23.8","20.8"
"Wilkes","2021-01-09","15","3650","2","377","22.8","20.7"
"Wilkes","2021-01-10","18","3668","7","384","24.3","21.1"
"Wilkes","2021-01-11","12","3680","3","387","23.8","21.9"
"Wilkes","2021-01-12","24","3704","7","394","23.7","23.6"
"Wilkes","2021-01-13","32","3736","12","406","26.3","24.4"
"Wilkes","2021-01-14","14","3750","3","409","26.8","23.7"
"Wilkes","2021-01-15","27","3777","8","417","27.8","25.8"
"Wilkes","2021-01-16","20","3797","10","427","33.1","28"
"Wilkes","2021-01-17","14","3811","2","429","29.6","26.9"
"Wilkes","2021-01-18","16","3827","4","433","29.6","26.7"
"Wilkes","2021-01-19","14","3841","4","437","29.5","26.6"
"Wilkes","2021-01-20","19","3860","3","440","26.4","26.4"
"Wilkes","2021-01-21","30","3890","7","447","26.7","26.7"
"Wilkes","2021-01-22","19","3909","9","456","29.2","28.5"
"Wilkes","2021-01-23","10","3919","3","459","26.3","29.7"
"Wilkes","2021-01-24","5","3924","0","459","24.3","26.9"
"Wilkes","2021-01-25","6","3930","0","459","20.7","25.1"
"Wilkes","2021-01-26","0","3930","0","459","16.6","23.1"
"Wilkes","2021-01-27","0","3930","0","459","14.4","20.4"
"Wilkinson","2020-02-01","0","0","0","0",".","."
"Wilkinson","2020-02-02","0","0","0","0",".","."
"Wilkinson","2020-02-03","0","0","0","0",".","."
"Wilkinson","2020-02-04","0","0","0","0",".","."
"Wilkinson","2020-02-05","0","0","0","0",".","."
"Wilkinson","2020-02-06","0","0","0","0",".","."
"Wilkinson","2020-02-07","0","0","0","0","0","."
"Wilkinson","2020-02-08","0","0","0","0","0","."
"Wilkinson","2020-02-09","0","0","0","0","0","."
"Wilkinson","2020-02-10","0","0","0","0","0","."
"Wilkinson","2020-02-11","0","0","0","0","0","."
"Wilkinson","2020-02-12","0","0","0","0","0","."
"Wilkinson","2020-02-13","0","0","0","0","0","."
"Wilkinson","2020-02-14","0","0","0","0","0","0"
"Wilkinson","2020-02-15","0","0","0","0","0","0"
"Wilkinson","2020-02-16","0","0","0","0","0","0"
"Wilkinson","2020-02-17","0","0","0","0","0","0"
"Wilkinson","2020-02-18","0","0","0","0","0","0"
"Wilkinson","2020-02-19","0","0","0","0","0","0"
"Wilkinson","2020-02-20","0","0","0","0","0","0"
"Wilkinson","2020-02-21","0","0","0","0","0","0"
"Wilkinson","2020-02-22","0","0","0","0","0","0"
"Wilkinson","2020-02-23","0","0","0","0","0","0"
"Wilkinson","2020-02-24","0","0","0","0","0","0"
"Wilkinson","2020-02-25","0","0","0","0","0","0"
"Wilkinson","2020-02-26","0","0","0","0","0","0"
"Wilkinson","2020-02-27","0","0","0","0","0","0"
"Wilkinson","2020-02-28","0","0","0","0","0","0"
"Wilkinson","2020-02-29","0","0","0","0","0","0"
"Wilkinson","2020-03-01","0","0","0","0","0","0"
"Wilkinson","2020-03-02","0","0","0","0","0","0"
"Wilkinson","2020-03-03","0","0","0","0","0","0"
"Wilkinson","2020-03-04","0","0","0","0","0","0"
"Wilkinson","2020-03-05","0","0","0","0","0","0"
"Wilkinson","2020-03-06","0","0","0","0","0","0"
"Wilkinson","2020-03-07","0","0","0","0","0","0"
"Wilkinson","2020-03-08","0","0","0","0","0","0"
"Wilkinson","2020-03-09","0","0","0","0","0","0"
"Wilkinson","2020-03-10","0","0","0","0","0","0"
"Wilkinson","2020-03-11","1","1","0","0","0","0"
"Wilkinson","2020-03-12","0","1","0","0","0","0"
"Wilkinson","2020-03-13","0","1","0","0","0","0"
"Wilkinson","2020-03-14","0","1","0","0","0","0"
"Wilkinson","2020-03-15","2","3","1","1","7.1","3.6"
"Wilkinson","2020-03-16","29","32","6","7","10.1","5"
"Wilkinson","2020-03-17","28","60","0","7","10.1","5"
"Wilkinson","2020-03-18","30","90","5","12","12.5","6.2"
"Wilkinson","2020-03-19","22","112","4","16","15.1","7.5"
"Wilkinson","2020-03-20","14","126","0","16","15.1","7.5"
"Wilkinson","2020-03-21","9","135","0","16","15.1","7.5"
"Wilkinson","2020-03-22","0","135","0","16","7.9","7.5"
"Wilkinson","2020-03-23","5","140","0","16","5","7.5"
"Wilkinson","2020-03-24","2","142","0","16","5","7.5"
"Wilkinson","2020-03-25","2","144","1","17","9.7","11.1"
"Wilkinson","2020-03-26","5","149","0","17","7.1","11.1"
"Wilkinson","2020-03-27","5","154","2","19","12.9","14"
"Wilkinson","2020-03-28","1","155","0","19","12.9","14"
"Wilkinson","2020-03-29","0","155","0","19","12.9","10.4"
"Wilkinson","2020-03-30","2","157","1","20","20","12.5"
"Wilkinson","2020-03-31","5","162","1","21","22.9","13.9"
"Wilkinson","2020-04-01","7","169","0","21","15.7","12.7"
"Wilkinson","2020-04-02","4","173","0","21","15.7","11.4"
"Wilkinson","2020-04-03","3","176","0","21","10","11.4"
"Wilkinson","2020-04-04","5","181","3","24","18.6","15.7"
"Wilkinson","2020-04-05","1","182","1","25","32.9","22.9"
"Wilkinson","2020-04-06","2","184","2","27","40","30"
"Wilkinson","2020-04-07","8","192","0","27","37.1","30"
"Wilkinson","2020-04-08","8","200","3","30","42.5","29.1"
"Wilkinson","2020-04-09","6","206","0","30","42.5","29.1"
"Wilkinson","2020-04-10","5","211","1","31","45.4","27.7"
"Wilkinson","2020-04-11","1","212","0","31","36.8","27.7"
"Wilkinson","2020-04-12","3","215","0","31","22.5","27.7"
"Wilkinson","2020-04-13","14","229","2","33","10.3","25.1"
"Wilkinson","2020-04-14","14","243","11","44","21.5","29.3"
"Wilkinson","2020-04-15","5","248","1","45","19","30.7"
"Wilkinson","2020-04-16","8","256","2","47","22.6","32.5"
"Wilkinson","2020-04-17","4","260","2","49","26.8","36.1"
"Wilkinson","2020-04-18","1","261","0","49","26.8","31.8"
"Wilkinson","2020-04-19","1","262","0","49","26.8","24.7"
"Wilkinson","2020-04-20","92","354","9","58","26.2","18.2"
"Wilkinson","2020-04-21","136","490","21","79","17.2","19.3"
"Wilkinson","2020-04-22","88","578","4","83","15","17"
"Wilkinson","2020-04-23","49","627","7","90","13.4","18"
"Wilkinson","2020-04-24","85","712","12","102","8.3","17.6"
"Wilkinson","2020-04-25","27","739","0","102","8.3","17.6"
"Wilkinson","2020-04-26","0","739","0","102","8.3","17.6"
"Wilkinson","2020-04-27","100","839","5","107","7.6","16.9"
"Wilkinson","2020-04-28","82","921","4","111","6.1","11.6"
"Wilkinson","2020-04-29","30","951","3","114","6.9","10.9"
"Wilkinson","2020-04-30","48","999","11","125","8.1","10.8"
"Wilkinson","2020-05-01","11","1010","3","128","10","9.2"
"Wilkinson","2020-05-02","19","1029","1","129","10.8","9.5"
"Wilkinson","2020-05-03","3","1032","0","129","10.8","9.5"
"Wilkinson","2020-05-04","494","1526","10","139","10.3","9"
"Wilkinson","2020-05-05","62","1588","3","142","10.3","8.2"
"Wilkinson","2020-05-06","99","1687","3","145","9.3","8.1"
"Wilkinson","2020-05-07","106","1793","2","147","6.3","7.2"
"Wilkinson","2020-05-08","111","1904","1","148","2.6","6.3"
"Wilkinson","2020-05-09","71","1975","3","151","2.4","6.6"
"Wilkinson","2020-05-10","16","1991","0","151","2.4","6.6"
"Wilkinson","2020-05-11","154","2145","6","157","2.7","6.5"
"Wilkinson","2020-05-12","259","2404","9","166","2.5","6.4"
"Wilkinson","2020-05-13","273","2677","4","170","2.3","5.8"
"Wilkinson","2020-05-14","164","2841","7","177","2.6","4.5"
"Wilkinson","2020-05-15","126","2967","10","187","3.6","3.1"
"Wilkinson","2020-05-16","17","2984","0","187","3","2.7"
"Wilkinson","2020-05-17","5","2989","0","187","3","2.7"
"Wilkinson","2020-05-18","84","3073","6","193","3.5","3.1"
"Wilkinson","2020-05-19","146","3219","1","194","3.1","2.8"
"Wilkinson","2020-05-20","18","3237","0","194","2.9","2.6"
"Wilkinson","2020-05-21","66","3303","3","197","2.9","2.8"
"Wilkinson","2020-05-22","37","3340","6","203","4.1","3.8"
"Wilkinson","2020-05-23","18","3358","3","206","6.5","4.7"
"Wilkinson","2020-05-24","10","3368","0","206","6.5","4.7"
"Wilkinson","2020-05-25","14","3382","2","208","7.5","5.5"
"Wilkinson","2020-05-26","106","3488","14","222","9.3","6.2"
"Wilkinson","2020-05-27","50","3538","2","224","9.8","6.4"
"Wilkinson","2020-05-28","179","3717","2","226","9.4","6.1"
"Wilkinson","2020-05-29","29","3746","0","226","7","5.6"
"Wilkinson","2020-05-30","150","3896","5","231","5.1","5.8"
"Wilkinson","2020-05-31","13","3909","1","232","6.2","6.3"
"Wilkinson","2020-06-01","165","4074","9","241","5","6.2"
"Wilkinson","2020-06-02","27","4101","0","241","3.1","6.2"
"Wilkinson","2020-06-03","103","4204","11","252","4","6.9"
"Wilkinson","2020-06-04","34","4238","1","253","4.3","6.8"
"Wilkinson","2020-06-05","84","4322","2","255","4.6","5.8"
"Wilkinson","2020-06-06","2","4324","0","255","4.2","4.6"
"Wilkinson","2020-06-07","52","4376","5","260","4.4","5.3"
"Wilkinson","2020-06-08","86","4462","10","270","5.3","5.1"
"Wilkinson","2020-06-09","52","4514","5","275","6.7","4.9"
"Wilkinson","2020-06-10","130","4644","8","283","6","5"
"Wilkinson","2020-06-11","67","4711","18","301","9.5","6.9"
"Wilkinson","2020-06-12","114","4825","17","318","11.3","7.9"
"Wilkinson","2020-06-13","117","4942","14","332","13","8.6"
"Wilkinson","2020-06-14","0","4942","0","332","11.6","8"
"Wilkinson","2020-06-15","144","5086","14","346","11.3","8.3"
"Wilkinson","2020-06-16","99","5185","5","351","10.7","8.7"
"Wilkinson","2020-06-17","182","5367","27","378","11.9","9"
"Wilkinson","2020-06-18","41","5408","2","380","8.8","9.1"
"Wilkinson","2020-06-19","152","5560","13","393","7.9","9.6"
"Wilkinson","2020-06-20","1","5561","0","393","6.1","9.6"
"Wilkinson","2020-06-21","66","5627","3","396","6.8","9.2"
"Wilkinson","2020-06-22","214","5841","23","419","6.9","9.1"
"Wilkinson","2020-06-23","262","6103","22","441","7.4","9"
"Wilkinson","2020-06-24","203","6306","12","453","6.1","9"
"Wilkinson","2020-06-25","325","6631","48","501","7.6","8.2"
"Wilkinson","2020-06-26","270","6901","21","522","7.4","7.7"
"Wilkinson","2020-06-27","93","6994","13","535","9.4","7.8"
"Wilkinson","2020-06-28","2","6996","0","535","8.8","7.8"
"Wilkinson","2020-06-29","252","7248","25","560","8.7","7.8"
"Wilkinson","2020-06-30","492","7740","45","605","8.8","8.1"
"Wilkinson","2020-07-01","235","7975","23","628","9.3","7.7"
"Wilkinson","2020-07-02","378","8353","50","678","9.1","8.3"
"Wilkinson","2020-07-03","8","8361","1","679","9.8","8.6"
"Wilkinson","2020-07-04","112","8473","9","688","8.9","9.2"
"Wilkinson","2020-07-05","2","8475","2","690","23.2","16"
"Wilkinson","2020-07-06","344","8819","35","725","23.3","16"
"Wilkinson","2020-07-07","288","9107","26","751","23.3","16"
"Wilkinson","2020-07-08","205","9312","13","764","22.8","16"
"Wilkinson","2020-07-09","147","9459","12","776","22","15.6"
"Wilkinson","2020-07-10","438","9897","50","826","21.9","15.8"
"Wilkinson","2020-07-11","69","9966","2","828","21.1","15"
"Wilkinson","2020-07-12","1","9967","0","828","6.9","15"
"Wilkinson","2020-07-13","319","10286","35","863","7","15.1"
"Wilkinson","2020-07-14","402","10688","24","887","6.5","14.9"
"Wilkinson","2020-07-15","378","11066","41","928","7.2","15"
"Wilkinson","2020-07-16","164","11230","12","940","7.1","14.5"
"Wilkinson","2020-07-17","303","11533","20","960","6.4","14.1"
"Wilkinson","2020-07-18","114","11647","7","967","6.8","14"
"Wilkinson","2020-07-19","6","11653","3","970","14","10.4"
"Wilkinson","2020-07-20","313","11966","12","982","13","10"
"Wilkinson","2020-07-21","244","12210","11","993","12.7","9.6"
"Wilkinson","2020-07-22","414","12624","34","1027","12.4","9.8"
"Wilkinson","2020-07-23","122","12746","8","1035","12.3","9.7"
"Wilkinson","2020-07-24","354","13100","16","1051","12","9.2"
"Wilkinson","2020-07-25","94","13194","7","1058","12.2","9.5"
"Wilkinson","2020-07-26","10","13204","2","1060","7.9","10.9"
"Wilkinson","2020-07-27","343","13547","18","1078","8.1","10.5"
"Wilkinson","2020-07-28","270","13817","14","1092","8.2","10.5"
"Wilkinson","2020-07-29","408","14225","34","1126","8.2","10.3"
"Wilkinson","2020-07-30","121","14346","6","1132","8","10.1"
"Wilkinson","2020-07-31","376","14722","30","1162","8.5","10.2"
"Wilkinson","2020-08-01","153","14875","9","1171","8.2","10.2"
"Wilkinson","2020-08-02","6","14881","1","1172","7.8","7.8"
"Wilkinson","2020-08-03","352","15233","40","1212","8.6","8.3"
"Wilkinson","2020-08-04","211","15444","11","1223","8.6","8.4"
"Wilkinson","2020-08-05","484","15928","58","1281","9.1","8.7"
"Wilkinson","2020-08-06","131","16059","10","1291","9.5","8.7"
"Wilkinson","2020-08-07","532","16591","44","1335","9.6","9"
"Wilkinson","2020-08-08","95","16686","15","1350","11","9.6"
"Wilkinson","2020-08-09","32","16718","3","1353","9.9","8.8"
"Wilkinson","2020-08-10","275","16993","43","1396","10.6","9.6"
"Wilkinson","2020-08-11","326","17319","17","1413","10.6","9.6"
"Wilkinson","2020-08-12","401","17720","18","1431","9.5","9.3"
"Wilkinson","2020-08-13","148","17868","14","1445","9.7","9.6"
"Wilkinson","2020-08-14","491","18359","31","1476","9.5","9.5"
"Wilkinson","2020-08-15","8","18367","1","1477","9","10"
"Wilkinson","2020-08-16","160","18527","9","1486","8.5","9.2"
"Wilkinson","2020-08-17","9","18536","1","1487","7.8","9.2"
"Wilkinson","2020-08-18","181","18717","3","1490","7.3","8.9"
"Wilkinson","2020-08-19","361","19078","33","1523","8","8.7"
"Wilkinson","2020-08-20","110","19188","12","1535","8.2","9"
"Wilkinson","2020-08-21","465","19653","37","1572","8.4","8.9"
"Wilkinson","2020-08-22","145","19798","19","1591","8.5","8.7"
"Wilkinson","2020-08-23","37","19835","2","1593","8.5","8.5"
"Wilkinson","2020-08-24","326","20161","65","1658","9.7","8.8"
"Wilkinson","2020-08-25","204","20365","14","1672","10.5","8.9"
"Wilkinson","2020-08-26","413","20778","114","1786","13.1","10.5"
"Wilkinson","2020-08-27","69","20847","1","1787","11.8","10"
"Wilkinson","2020-08-28","450","21297","107","1894","14","11.2"
"Wilkinson","2020-08-29","183","21480","54","1948","16.4","12.4"
"Wilkinson","2020-08-30","13","21493","0","1948","15.6","12"
"Wilkinson","2020-08-31","349","21842","36","1984","14.2","12"
"Wilkinson","2020-09-01","194","22036","6","1990","13.7","12.1"
"Wilkinson","2020-09-02","672","22708","75","2065","11.3","12.2"
"Wilkinson","2020-09-03","274","22982","12","2077","11.7","11.8"
"Wilkinson","2020-09-04","671","23653","58","2135","9.6","11.8"
"Wilkinson","2020-09-05","449","24102","45","2180","6.8","11.6"
"Wilkinson","2020-09-06","22","24124","1","2181","7.5","11.5"
"Wilkinson","2020-09-07","250","24374","24","2205","7.3","10.8"
"Wilkinson","2020-09-08","375","24749","23","2228","7.8","10.7"
"Wilkinson","2020-09-09","640","25389","44","2272","7.2","9.3"
"Wilkinson","2020-09-10","211","25600","7","2279","7","9.4"
"Wilkinson","2020-09-11","595","26195","40","2319","6.7","8.2"
"Wilkinson","2020-09-12","248","26443","18","2337","6.4","6.6"
"Wilkinson","2020-09-13","0","26443","0","2337","5.7","6.6"
"Wilkinson","2020-09-14","471","26914","21","2358","5","6.2"
"Wilkinson","2020-09-15","297","27211","8","2366","4.5","6.1"
"Wilkinson","2020-09-16","464","27675","11","2377","3.8","5.5"
"Wilkinson","2020-09-17","25","27700","1","2378","3.9","5.5"
"Wilkinson","2020-09-18","629","28329","24","2402","3.5","5.1"
"Wilkinson","2020-09-19","128","28457","11","2413","3.7","5"
"Wilkinson","2020-09-20","5","28462","0","2413","3.7","4.7"
"Wilkinson","2020-09-21","320","28782","22","2435","4","4.5"
"Wilkinson","2020-09-22","241","29023","11","2446","4.3","4.4"
"Wilkinson","2020-09-23","396","29419","14","2460","4.5","4.2"
"Wilkinson","2020-09-24","154","29573","6","2466","4.5","4.2"
"Wilkinson","2020-09-25","384","29957","17","2483","4.6","4"
"Wilkinson","2020-09-26","161","30118","6","2489","3.9","3.8"
"Wilkinson","2020-09-27","9","30127","2","2491","7","5.4"
"Wilkinson","2020-09-28","295","30422","16","2507","6.8","5.4"
"Wilkinson","2020-09-29","273","30695","20","2527","7.2","5.8"
"Wilkinson","2020-09-30","330","31025","21","2548","7.6","6.1"
"Wilkinson","2020-10-01","181","31206","7","2555","7.6","6"
"Wilkinson","2020-10-02","471","31677","24","2579","7.7","6.1"
"Wilkinson","2020-10-03","219","31896","10","2589","7.8","5.8"
"Wilkinson","2020-10-04","7","31903","1","2590","6.7","6.9"
"Wilkinson","2020-10-05","318","32221","22","2612","6.9","6.9"
"Wilkinson","2020-10-06","374","32595","9","2621","6.2","6.7"
"Wilkinson","2020-10-07","384","32979","14","2635","5.8","6.7"
"Wilkinson","2020-10-08","266","33245","30","2665","6.9","7.3"
"Wilkinson","2020-10-09","544","33789","28","2693","6.9","7.3"
"Wilkinson","2020-10-10","171","33960","17","2710","7.7","7.7"
"Wilkinson","2020-10-11","2","33962","0","2710","5.6","6.2"
"Wilkinson","2020-10-12","115","34077","6","2716","5.4","6.1"
"Wilkinson","2020-10-13","468","34545","28","2744","5.9","6.1"
"Wilkinson","2020-10-14","334","34879","11","2755","5.8","5.8"
"Wilkinson","2020-10-15","328","35207","14","2769","4.8","5.9"
"Wilkinson","2020-10-16","615","35822","44","2813","5.1","6"
"Wilkinson","2020-10-17","194","36016","12","2825","4.6","6.1"
"Wilkinson","2020-10-18","7","36023","1","2826","6.6","6.1"
"Wilkinson","2020-10-19","429","36452","26","2852","6.7","6.1"
"Wilkinson","2020-10-20","473","36925","21","2873","6.5","6.2"
"Wilkinson","2020-10-21","441","37366","33","2906","7.1","6.5"
"Wilkinson","2020-10-22","443","37809","34","2940","7.6","6.2"
"Wilkinson","2020-10-23","622","38431","47","2987","7.7","6.4"
"Wilkinson","2020-10-24","189","38620","12","2999","7.7","6.1"
"Wilkinson","2020-10-25","10","38630","0","2999","5.7","6.1"
"Wilkinson","2020-10-26","487","39117","46","3045","6.1","6.4"
"Wilkinson","2020-10-27","398","39515","15","3060","6","6.3"
"Wilkinson","2020-10-28","428","39943","20","3080","5.6","6.4"
"Wilkinson","2020-10-29","88","40031","3","3083","5","6.3"
"Wilkinson","2020-10-30","622","40653","35","3118","4.8","6.2"
"Wilkinson","2020-10-31","83","40736","4","3122","4.5","6.1"
"Wilkinson","2020-11-01","7","40743","0","3122","4.5","5.1"
"Wilkinson","2020-11-02","390","41133","29","3151","4.2","5.2"
"Wilkinson","2020-11-03","125","41258","8","3159","4.6","5.3"
"Wilkinson","2020-11-04","416","41674","23","3182","4.7","5.2"
"Wilkinson","2020-11-05","219","41893","10","3192","4.9","5"
"Wilkinson","2020-11-06","516","42409","35","3227","5.1","4.9"
"Wilkinson","2020-11-07","209","42618","10","3237","5.1","4.8"
"Wilkinson","2020-11-08","4","42622","0","3237","5.1","4.8"
"Wilkinson","2020-11-09","401","43023","39","3276","5.4","4.8"
"Wilkinson","2020-11-10","543","43566","42","3318","5.6","5.1"
"Wilkinson","2020-11-11","219","43785","10","3328","5.5","5.1"
"Wilkinson","2020-11-12","392","44177","29","3357","5.9","5.4"
"Wilkinson","2020-11-13","913","45090","58","3415","5.8","5.4"
"Wilkinson","2020-11-14","327","45417","22","3437","6.1","5.6"
"Wilkinson","2020-11-15","2","45419","0","3437","6.1","5.6"
"Wilkinson","2020-11-16","678","46097","61","3498","6","5.7"
"Wilkinson","2020-11-17","480","46577","33","3531","5.8","5.7"
"Wilkinson","2020-11-18","656","47233","35","3566","6","5.7"
"Wilkinson","2020-11-19","437","47670","24","3590","5.7","5.8"
"Wilkinson","2020-11-20","990","48660","48","3638","5.5","5.6"
"Wilkinson","2020-11-21","504","49164","10","3648","4.8","5.4"
"Wilkinson","2020-11-22","8","49172","0","3648","4.8","5.4"
"Wilkinson","2020-11-23","1028","50200","56","3704","4.3","5.1"
"Wilkinson","2020-11-24","842","51042","51","3755","4.2","5"
"Wilkinson","2020-11-25","507","51549","35","3790","4.4","5.2"
"Wilkinson","2020-11-26","3","51552","0","3790","3.6","4.6"
"Wilkinson","2020-11-27","16","51568","2","3792","4.7","5.1"
"Wilkinson","2020-11-28","280","51848","20","3812","5.4","5.1"
"Wilkinson","2020-11-29","3","51851","1","3813","10.2","7.5"
"Wilkinson","2020-11-30","136","51987","8","3821","10.3","7.3"
"Wilkinson","2020-12-01","46","52033","11","3832","12.8","8.5"
"Wilkinson","2020-12-02","155","52188","8","3840","12.6","8.5"
"Wilkinson","2020-12-03","109","52297","9","3849","13.7","8.7"
"Wilkinson","2020-12-04","476","52773","55","3904","13.6","9.2"
"Wilkinson","2020-12-05","9","52782","1","3905","14.2","9.8"
"Wilkinson","2020-12-06","6","52788","4","3909","18.9","14.6"
"Wilkinson","2020-12-07","165","52953","10","3919","19","14.6"
"Wilkinson","2020-12-08","115","53068","8","3927","16.5","14.7"
"Wilkinson","2020-12-09","262","53330","22","3949","17","14.8"
"Wilkinson","2020-12-10","73","53403","4","3953","16.6","15.2"
"Wilkinson","2020-12-11","257","53660","23","3976","16.2","14.9"
"Wilkinson","2020-12-12","35","53695","3","3979","15.9","15"
"Wilkinson","2020-12-13","5","53700","1","3980","9.2","14.1"
"Wilkinson","2020-12-14","236","53936","31","4011","10.2","14.6"
"Wilkinson","2020-12-15","198","54134","20","4031","10.7","13.6"
"Wilkinson","2020-12-16","292","54426","25","4056","10.7","13.8"
"Wilkinson","2020-12-17","106","54532","6","4062","10.7","13.7"
"Wilkinson","2020-12-18","730","55262","109","4171","11.6","13.9"
"Wilkinson","2020-12-19","33","55295","4","4175","12.1","14"
"Wilkinson","2020-12-20","7","55302","1","4176","11.3","10.2"
"Wilkinson","2020-12-21","261","55563","26","4202","10.8","10.5"
"Wilkinson","2020-12-22","252","55815","19","4221","10.4","10.5"
"Wilkinson","2020-12-23","405","56220","35","4256","10.4","10.6"
"Wilkinson","2020-12-24","17","56237","5","4261","13.8","12.3"
"Wilkinson","2020-12-25","9","56246","2","4263","14.9","13.2"
"Wilkinson","2020-12-26","175","56421","30","4293","15.6","13.8"
"Wilkinson","2020-12-27","12","56433","5","4298","19.5","15.4"
"Wilkinson","2020-12-28","234","56667","34","4332","20.2","15.5"
"Wilkinson","2020-12-29","272","56939","42","4374","21.3","15.9"
"Wilkinson","2020-12-30","341","57280","41","4415","21.8","16.1"
"Wilkinson","2020-12-31","134","57414","19","4434","19.6","16.7"
"Wilkinson","2021-01-01","8","57422","1","4435","18.2","16.5"
"Wilkinson","2021-01-02","170","57592","38","4473","19","17.3"
"Wilkinson","2021-01-03","15","57607","3","4476","15.9","17.7"
"Wilkinson","2021-01-04","373","57980","70","4546","16.5","18.3"
"Wilkinson","2021-01-05","565","58545","50","4596","15.5","18.4"
"Wilkinson","2021-01-06","402","58947","44","4640","15.4","18.6"
"Wilkinson","2021-01-07","187","59134","19","4659","14.8","17.2"
"Wilkinson","2021-01-08","462","59596","47","4706","14.5","16.3"
"Wilkinson","2021-01-09","22","59618","3","4709","13.2","16.1"
"Wilkinson","2021-01-10","17","59635","5","4714","14.6","15.2"
"Wilkinson","2021-01-11","125","59760","19","4733","14.1","15.3"
"Wilkinson","2021-01-12","211","59971","24","4757","14.4","15"
"Wilkinson","2021-01-13","48","60019","11","4768","16.1","15.7"
"Wilkinson","2021-01-14","132","60151","16","4784","16.4","15.6"
"Wilkinson","2021-01-15","167","60318","20","4804","16.7","15.6"
"Wilkinson","2021-01-16","16","60334","3","4807","17.4","15.3"
"Wilkinson","2021-01-17","7","60341","2","4809","17.3","15.9"
"Wilkinson","2021-01-18","144","60485","14","4823","16.5","15.3"
"Wilkinson","2021-01-19","142","60627","18","4841","16.7","15.5"
"Wilkinson","2021-01-20","69","60696","7","4848","14.9","15.5"
"Wilkinson","2021-01-21","21","60717","3","4851","15.2","15.8"
"Wilkinson","2021-01-22","117","60834","8","4859","14.4","15.5"
"Wilkinson","2021-01-23","12","60846","1","4860","12.9","15.2"
"Wilkinson","2021-01-24","8","60854","2","4862","12.4","14.9"
"Wilkinson","2021-01-25","6","60860","0","4862","11","13.8"
"Wilkinson","2021-01-26","3","60863","0","4862","9.2","13"
"Wilkinson","2021-01-27","0","60863","0","4862","7.8","11.3"
"Worth","2020-02-01","0","0","0","0",".","."
"Worth","2020-02-02","0","0","0","0",".","."
"Worth","2020-02-03","0","0","0","0",".","."
"Worth","2020-02-04","0","0","0","0",".","."
"Worth","2020-02-05","0","0","0","0",".","."
"Worth","2020-02-06","0","0","0","0",".","."
"Worth","2020-02-07","0","0","0","0","0","."
"Worth","2020-02-08","0","0","0","0","0","."
"Worth","2020-02-09","0","0","0","0","0","."
"Worth","2020-02-10","0","0","0","0","0","."
"Worth","2020-02-11","0","0","0","0","0","."
"Worth","2020-02-12","0","0","0","0","0","."
"Worth","2020-02-13","0","0","0","0","0","."
"Worth","2020-02-14","0","0","0","0","0","0"
"Worth","2020-02-15","0","0","0","0","0","0"
"Worth","2020-02-16","0","0","0","0","0","0"
"Worth","2020-02-17","0","0","0","0","0","0"
"Worth","2020-02-18","0","0","0","0","0","0"
"Worth","2020-02-19","0","0","0","0","0","0"
"Worth","2020-02-20","0","0","0","0","0","0"
"Worth","2020-02-21","0","0","0","0","0","0"
"Worth","2020-02-22","0","0","0","0","0","0"
"Worth","2020-02-23","0","0","0","0","0","0"
"Worth","2020-02-24","0","0","0","0","0","0"
"Worth","2020-02-25","0","0","0","0","0","0"
"Worth","2020-02-26","0","0","0","0","0","0"
"Worth","2020-02-27","0","0","0","0","0","0"
"Worth","2020-02-28","0","0","0","0","0","0"
"Worth","2020-02-29","0","0","0","0","0","0"
"Worth","2020-03-01","0","0","0","0","0","0"
"Worth","2020-03-02","0","0","0","0","0","0"
"Worth","2020-03-03","0","0","0","0","0","0"
"Worth","2020-03-04","0","0","0","0","0","0"
"Worth","2020-03-05","0","0","0","0","0","0"
"Worth","2020-03-06","0","0","0","0","0","0"
"Worth","2020-03-07","0","0","0","0","0","0"
"Worth","2020-03-08","0","0","0","0","0","0"
"Worth","2020-03-09","0","0","0","0","0","0"
"Worth","2020-03-10","0","0","0","0","0","0"
"Worth","2020-03-11","1","1","0","0","0","0"
"Worth","2020-03-12","4","5","0","0","0","0"
"Worth","2020-03-13","4","9","1","1","3.6","1.8"
"Worth","2020-03-14","2","11","0","1","3.6","1.8"
"Worth","2020-03-15","1","12","1","2","17.9","8.9"
"Worth","2020-03-16","7","19","0","2","17.9","8.9"
"Worth","2020-03-17","13","32","3","5","21.2","10.6"
"Worth","2020-03-18","8","40","3","8","26.5","13.3"
"Worth","2020-03-19","14","54","3","11","29.6","14.8"
"Worth","2020-03-20","13","67","1","12","27.1","15.3"
"Worth","2020-03-21","3","70","1","13","31.9","17.7"
"Worth","2020-03-22","5","75","3","16","26.1","22"
"Worth","2020-03-23","17","92","6","22","31.2","24.5"
"Worth","2020-03-24","31","123","2","24","28.8","25"
"Worth","2020-03-25","21","144","4","28","26.2","26.3"
"Worth","2020-03-26","17","161","2","30","24.8","27.2"
"Worth","2020-03-27","8","169","1","31","25.5","26.3"
"Worth","2020-03-28","8","177","2","33","24.3","28.1"
"Worth","2020-03-29","9","186","3","36","20.5","23.3"
"Worth","2020-03-30","15","201","5","41","20.2","25.7"
"Worth","2020-03-31","10","211","6","47","27.9","28.3"
"Worth","2020-04-01","16","227","8","55","32.3","29.2"
"Worth","2020-04-02","21","248","7","62","35.4","30.1"
"Worth","2020-04-03","21","269","4","66","36.3","30.9"
"Worth","2020-04-04","5","274","3","69","41.3","32.8"
"Worth","2020-04-05","6","280","1","70","38.9","29.7"
"Worth","2020-04-06","25","305","2","72","35.3","27.7"
"Worth","2020-04-07","22","327","4","76","29.3","28.6"
"Worth","2020-04-08","15","342","1","77","23.1","27.7"
"Worth","2020-04-09","12","354","4","81","23.1","29.2"
"Worth","2020-04-10","12","366","1","82","21.6","28.9"
"Worth","2020-04-11","19","385","2","84","14.5","27.9"
"Worth","2020-04-12","3","388","0","84","12.1","25.5"
"Worth","2020-04-13","41","429","4","88","12.4","23.8"
"Worth","2020-04-14","26","455","4","92","12","20.7"
"Worth","2020-04-15","21","476","4","96","13.8","18.4"
"Worth","2020-04-16","14","490","1","97","10","16.6"
"Worth","2020-04-17","21","511","0","97","8.8","15.2"
"Worth","2020-04-18","11","522","2","99","9.9","12.2"
"Worth","2020-04-19","3","525","2","101","19.5","15.8"
"Worth","2020-04-20","14","539","2","103","20.1","16.3"
"Worth","2020-04-21","19","558","1","104","18.7","15.3"
"Worth","2020-04-22","24","582","4","108","18.3","16"
"Worth","2020-04-23","16","598","0","108","17.3","13.7"
"Worth","2020-04-24","13","611","1","109","18.4","13.6"
"Worth","2020-04-25","14","625","0","109","15.8","12.9"
"Worth","2020-04-26","7","632","1","110","8.3","13.9"
"Worth","2020-04-27","23","655","4","114","8.8","14.4"
"Worth","2020-04-28","30","685","7","121","11.3","15"
"Worth","2020-04-29","27","712","4","125","11.1","14.7"
"Worth","2020-04-30","40","752","8","133","13.9","15.6"
"Worth","2020-05-01","39","791","3","136","13.9","16.2"
"Worth","2020-05-02","13","804","0","136","13.9","14.9"
"Worth","2020-05-03","3","807","1","137","16.7","12.5"
"Worth","2020-05-04","14","821","0","137","14.2","11.5"
"Worth","2020-05-05","20","841","2","139","12.3","11.8"
"Worth","2020-05-06","21","862","3","142","12.2","11.6"
"Worth","2020-05-07","5","867","2","144","15","14.5"
"Worth","2020-05-08","13","880","3","147","17.2","15.6"
"Worth","2020-05-09","6","886","2","149","22","18"
"Worth","2020-05-10","2","888","0","149","17.2","16.9"
"Worth","2020-05-11","22","910","4","153","19.8","17"
"Worth","2020-05-12","19","929","2","155","19.9","16.1"
"Worth","2020-05-13","36","965","3","158","19.1","15.6"
"Worth","2020-05-14","36","1001","2","160","14.1","14.6"
"Worth","2020-05-15","9","1010","2","162","14","15.6"
"Worth","2020-05-16","6","1016","0","162","9.3","15.6"
"Worth","2020-05-17","3","1019","1","163","14","15.6"
"Worth","2020-05-18","27","1046","3","166","13","16.4"
"Worth","2020-05-19","23","1069","3","169","13.4","16.6"
"Worth","2020-05-20","22","1091","2","171","13.5","16.3"
"Worth","2020-05-21","37","1128","3","174","13.8","14"
"Worth","2020-05-22","44","1172","2","176","11.3","12.7"
"Worth","2020-05-23","11","1183","1","177","12.6","10.9"
"Worth","2020-05-24","10","1193","1","178","9.3","11.7"
"Worth","2020-05-25","10","1203","1","179","9.1","11.1"
"Worth","2020-05-26","52","1255","1","180","7.5","10.5"
"Worth","2020-05-27","36","1291","2","182","7","10.3"
"Worth","2020-05-28","104","1395","7","189","6.8","10.3"
"Worth","2020-05-29","35","1430","3","192","7.4","9.4"
"Worth","2020-05-30","14","1444","3","195","9.2","10.9"
"Worth","2020-05-31","17","1461","1","196","8.6","8.9"
"Worth","2020-06-01","49","1510","1","197","7.4","8.3"
"Worth","2020-06-02","31","1541","1","198","7.6","7.6"
"Worth","2020-06-03","28","1569","1","199","7.4","7.2"
"Worth","2020-06-04","127","1696","6","205","7.1","6.9"
"Worth","2020-06-05","35","1731","0","205","5.8","6.6"
"Worth","2020-06-06","16","1747","2","207","4.6","6.9"
"Worth","2020-06-07","26","1773","1","208","4.3","6.4"
"Worth","2020-06-08","34","1807","3","211","5.2","6.3"
"Worth","2020-06-09","35","1842","2","213","5.6","6.6"
"Worth","2020-06-10","20","1862","4","217","7.9","7.6"
"Worth","2020-06-11","98","1960","11","228","8.9","8"
"Worth","2020-06-12","26","1986","3","231","10.5","8.2"
"Worth","2020-06-13","6","1992","2","233","13.5","9"
"Worth","2020-06-14","12","2004","0","233","12.9","8.6"
"Worth","2020-06-15","26","2030","3","236","13.3","9.3"
"Worth","2020-06-16","30","2060","3","239","13.9","9.8"
"Worth","2020-06-17","26","2086","1","240","11.6","9.8"
"Worth","2020-06-18","92","2178","11","251","11.7","10.3"
"Worth","2020-06-19","33","2211","5","256","12.3","11.4"
"Worth","2020-06-20","19","2230","2","258","9","11.2"
"Worth","2020-06-21","18","2248","3","261","11.4","12.2"
"Worth","2020-06-22","54","2302","2","263","10.3","11.8"
"Worth","2020-06-23","28","2330","1","264","9.3","11.6"
"Worth","2020-06-24","26","2356","0","264","8.8","10.2"
"Worth","2020-06-25","85","2441","14","278","9.4","10.6"
"Worth","2020-06-26","26","2467","0","278","7.3","9.8"
"Worth","2020-06-27","9","2476","2","280","8.9","9"
"Worth","2020-06-28","9","2485","1","281","8.2","9.8"
"Worth","2020-06-29","50","2535","4","285","8.8","9.5"
"Worth","2020-06-30","34","2569","2","287","9.1","9.2"
"Worth","2020-07-01","26","2595","4","291","11.3","10"
"Worth","2020-07-02","107","2702","5","296","9.6","9.5"
"Worth","2020-07-03","13","2715","3","299","12.9","10.1"
"Worth","2020-07-04","5","2720","1","300","12.6","10.8"
"Worth","2020-07-05","17","2737","1","301","11.8","10"
"Worth","2020-07-06","41","2778","6","307","12.8","10.8"
"Worth","2020-07-07","30","2808","5","312","14.3","11.7"
"Worth","2020-07-08","34","2842","2","314","13","12.1"
"Worth","2020-07-09","174","3016","7","321","12.9","11.2"
"Worth","2020-07-10","23","3039","2","323","10.8","11.9"
"Worth","2020-07-11","14","3053","0","323","8","10.3"
"Worth","2020-07-12","13","3066","0","323","7.1","9.5"
"Worth","2020-07-13","34","3100","4","327","6.7","9.8"
"Worth","2020-07-14","44","3144","3","330","5.3","9.8"
"Worth","2020-07-15","49","3193","6","336","6.2","9.6"
"Worth","2020-07-16","159","3352","4","340","6","9.4"
"Worth","2020-07-17","48","3400","4","344","6","8.4"
"Worth","2020-07-18","14","3414","2","346","8","8"
"Worth","2020-07-19","9","3423","2","348","11.2","9.1"
"Worth","2020-07-20","50","3473","4","352","10.6","8.7"
"Worth","2020-07-21","26","3499","2","354","10.8","8"
"Worth","2020-07-22","34","3533","3","357","10.3","8.2"
"Worth","2020-07-23","135","3668","8","365","10.8","8.4"
"Worth","2020-07-24","30","3698","5","370","11.9","8.9"
"Worth","2020-07-25","19","3717","2","372","11.4","9.7"
"Worth","2020-07-26","13","3730","2","374","10.4","10.8"
"Worth","2020-07-27","45","3775","13","387","13.4","12"
"Worth","2020-07-28","48","3823","5","392","13.8","12.3"
"Worth","2020-07-29","37","3860","4","396","14.1","12.2"
"Worth","2020-07-30","117","3977","6","402","14","12.4"
"Worth","2020-07-31","36","4013","6","408","14","13"
"Worth","2020-08-01","21","4034","0","408","12.5","11.9"
"Worth","2020-08-02","12","4046","1","409","11.5","10.9"
"Worth","2020-08-03","39","4085","8","417","10.3","11.8"
"Worth","2020-08-04","32","4117","1","418","9.2","11.5"
"Worth","2020-08-05","66","4183","6","424","9","11.5"
"Worth","2020-08-06","94","4277","3","427","8.7","11.3"
"Worth","2020-08-07","55","4332","4","431","7.4","10.7"
"Worth","2020-08-08","17","4349","3","434","9.9","11.2"
"Worth","2020-08-09","19","4368","2","436","10.2","10.8"
"Worth","2020-08-10","39","4407","4","440","8.7","9.5"
"Worth","2020-08-11","35","4442","2","442","9.1","9.2"
"Worth","2020-08-12","46","4488","4","446","9","9"
"Worth","2020-08-13","84","4572","5","451","9.4","9.1"
"Worth","2020-08-14","25","4597","1","452","9","8.2"
"Worth","2020-08-15","56","4653","1","453","6.7","8.3"
"Worth","2020-08-16","10","4663","0","453","5.2","7.7"
"Worth","2020-08-17","43","4706","4","457","5.1","6.9"
"Worth","2020-08-18","39","4745","3","460","5.3","7.2"
"Worth","2020-08-19","49","4794","4","464","5.3","7.2"
"Worth","2020-08-20","77","4871","7","471","5.7","7.6"
"Worth","2020-08-21","33","4904","0","471","5.1","7.1"
"Worth","2020-08-22","83","4987","0","471","4.9","5.8"
"Worth","2020-08-23","7","4994","1","472","6.9","6.1"
"Worth","2020-08-24","20","5014","5","477","9.2","7.1"
"Worth","2020-08-25","63","5077","5","482","9.2","7.3"
"Worth","2020-08-26","27","5104","2","484","9.1","7.2"
"Worth","2020-08-27","63","5167","4","488","8.7","7.2"
"Worth","2020-08-28","38","5205","2","490","9.5","7.3"
"Worth","2020-08-29","67","5272","0","490","9.5","7.2"
"Worth","2020-08-30","11","5283","0","490","7.4","7.2"
"Worth","2020-08-31","43","5326","4","494","5.2","7.2"
"Worth","2020-09-01","46","5372","0","494","4","6.6"
"Worth","2020-09-02","44","5416","1","495","3.3","6.2"
"Worth","2020-09-03","53","5469","1","496","2.7","5.7"
"Worth","2020-09-04","99","5568","2","498","2.2","5.8"
"Worth","2020-09-05","38","5606","1","499","2.6","6"
"Worth","2020-09-06","20","5626","1","500","3.3","5.4"
"Worth","2020-09-07","18","5644","0","500","2","3.6"
"Worth","2020-09-08","48","5692","4","504","3.2","3.6"
"Worth","2020-09-09","31","5723","0","504","2.8","3.1"
"Worth","2020-09-10","25","5748","2","506","3.7","3.2"
"Worth","2020-09-11","28","5776","1","507","3.9","3.1"
"Worth","2020-09-12","7","5783","0","507","3.6","3.1"
"Worth","2020-09-13","10","5793","0","507","2.8","3.1"
"Worth","2020-09-14","50","5843","1","508","3.1","2.6"
"Worth","2020-09-15","32","5875","2","510","2.8","3"
"Worth","2020-09-16","23","5898","3","513","4.7","3.8"
"Worth","2020-09-17","58","5956","3","516","4.3","4"
"Worth","2020-09-18","23","5979","1","517","4.4","4.2"
"Worth","2020-09-19","11","5990","2","519","7","5.3"
"Worth","2020-09-20","9","5999","1","520","8.6","5.7"
"Worth","2020-09-21","38","6037","3","523","9.4","6.3"
"Worth","2020-09-22","41","6078","6","529","10.6","6.7"
"Worth","2020-09-23","47","6125","1","530","9.1","6.9"
"Worth","2020-09-24","57","6182","3","533","9.1","6.7"
"Worth","2020-09-25","46","6228","2","535","9.1","6.7"
"Worth","2020-09-26","15","6243","1","536","7.4","7.2"
"Worth","2020-09-27","13","6256","1","537","6.9","7.8"
"Worth","2020-09-28","41","6297","2","539","6.5","8"
"Worth","2020-09-29","32","6329","2","541","5.3","8"
"Worth","2020-09-30","28","6357","5","546","7.6","8.3"
"Worth","2020-10-01","52","6409","2","548","7.4","8.2"
"Worth","2020-10-02","55","6464","6","554","8.3","8.7"
"Worth","2020-10-03","47","6511","5","559","8.9","8.2"
"Worth","2020-10-04","18","6529","1","560","8.6","7.8"
"Worth","2020-10-05","60","6589","6","566","9.3","7.9"
"Worth","2020-10-06","56","6645","6","572","9.9","7.6"
"Worth","2020-10-07","56","6701","5","577","8.7","8.1"
"Worth","2020-10-08","67","6768","3","580","8.7","8.1"
"Worth","2020-10-09","82","6850","2","582","7.5","7.9"
"Worth","2020-10-10","14","6864","2","584","8.1","8.5"
"Worth","2020-10-11","38","6902","2","586","8","8.3"
"Worth","2020-10-12","43","6945","6","592","8.6","8.9"
"Worth","2020-10-13","28","6973","1","593","7.6","8.7"
"Worth","2020-10-14","40","7013","4","597","7.7","8.2"
"Worth","2020-10-15","82","7095","2","599","7.4","8.1"
"Worth","2020-10-16","67","7162","4","603","7.9","7.7"
"Worth","2020-10-17","54","7216","2","605","6.4","7.2"
"Worth","2020-10-18","49","7265","8","613","8","8"
"Worth","2020-10-19","53","7318","1","614","6.3","7.4"
"Worth","2020-10-20","29","7347","0","614","5.8","6.7"
"Worth","2020-10-21","36","7383","1","615","4.7","6.2"
"Worth","2020-10-22","32","7415","0","615","4.4","5.9"
"Worth","2020-10-23","45","7460","2","617","4.2","6"
"Worth","2020-10-24","6","7466","0","617","3.6","5"
"Worth","2020-10-25","4","7470","1","618","4.9","6.4"
"Worth","2020-10-26","45","7515","3","621","5.6","5.9"
"Worth","2020-10-27","30","7545","2","623","6.5","6.1"
"Worth","2020-10-28","43","7588","0","623","6.1","5.4"
"Worth","2020-10-29","66","7654","1","624","6.3","5.4"
"Worth","2020-10-30","33","7687","1","625","6.1","5.1"
"Worth","2020-10-31","18","7705","1","626","6.9","5.3"
"Worth","2020-11-01","11","7716","0","626","3.3","4.1"
"Worth","2020-11-02","24","7740","1","627","3","4.3"
"Worth","2020-11-03","42","7782","3","630","3.1","4.8"
"Worth","2020-11-04","23","7805","0","630","3.1","4.6"
"Worth","2020-11-05","27","7832","2","632","3.9","5.1"
"Worth","2020-11-06","19","7851","1","633","4.2","5.2"
"Worth","2020-11-07","8","7859","1","634","5.2","6.1"
"Worth","2020-11-08","9","7868","0","634","5.2","4.3"
"Worth","2020-11-09","29","7897","0","634","4.6","3.8"
"Worth","2020-11-10","29","7926","1","635","4.1","3.6"
"Worth","2020-11-11","40","7966","4","639","5.5","4.3"
"Worth","2020-11-12","56","8022","5","644","5.7","4.8"
"Worth","2020-11-13","27","8049","1","645","5.5","4.9"
"Worth","2020-11-14","16","8065","0","645","3.7","4.5"
"Worth","2020-11-15","14","8079","1","646","4.7","5"
"Worth","2020-11-16","30","8109","2","648","5.7","5.2"
"Worth","2020-11-17","33","8142","0","648","5.2","4.6"
"Worth","2020-11-18","36","8178","1","649","4.2","4.8"
"Worth","2020-11-19","31","8209","1","650","3.4","4.5"
"Worth","2020-11-20","31","8240","0","650","2.8","4.2"
"Worth","2020-11-21","14","8254","2","652","4.9","4.3"
"Worth","2020-11-22","18","8272","2","654","5.4","5.1"
"Worth","2020-11-23","48","8320","7","661","6.6","6.1"
"Worth","2020-11-24","37","8357","5","666","8.5","6.9"
"Worth","2020-11-25","43","8400","1","667","8.4","6.3"
"Worth","2020-11-26","14","8414","0","667","8","5.7"
"Worth","2020-11-27","15","8429","2","669","9.9","6.4"
"Worth","2020-11-28","20","8449","5","674","11.4","8.1"
"Worth","2020-11-29","19","8468","3","677","12.1","8.8"
"Worth","2020-11-30","66","8534","8","685","11.7","9.1"
"Worth","2020-12-01","51","8585","6","691","11.5","10"
"Worth","2020-12-02","43","8628","4","695","12.5","10.5"
"Worth","2020-12-03","42","8670","4","699","13.8","10.9"
"Worth","2020-12-04","46","8716","3","702","12.9","11.4"
"Worth","2020-12-05","11","8727","3","705","13.2","12.3"
"Worth","2020-12-06","17","8744","4","709","14.3","13.2"
"Worth","2020-12-07","38","8782","1","710","12.9","12.3"
"Worth","2020-12-08","46","8828","6","716","13.1","12.3"
"Worth","2020-12-09","67","8895","12","728","14.3","13.4"
"Worth","2020-12-10","50","8945","9","737","15.6","14.7"
"Worth","2020-12-11","58","9003","7","744","16.4","14.6"
"Worth","2020-12-12","22","9025","5","749","15.7","14.4"
"Worth","2020-12-13","18","9043","7","756","17.9","16.1"
"Worth","2020-12-14","62","9105","9","765","19.6","16.3"
"Worth","2020-12-15","58","9163","13","778","20.9","17"
"Worth","2020-12-16","50","9213","5","783","19.8","17.1"
"Worth","2020-12-17","45","9258","13","796","21.4","18.5"
"Worth","2020-12-18","39","9297","8","804","22.6","19.5"
"Worth","2020-12-19","25","9322","4","808","21.6","18.7"
"Worth","2020-12-20","30","9352","10","818","20.8","19.4"
"Worth","2020-12-21","56","9408","16","834","22.8","21.2"
"Worth","2020-12-22","43","9451","7","841","21.9","21.4"
"Worth","2020-12-23","45","9496","9","850","23.4","21.6"
"Worth","2020-12-24","26","9522","7","857","23.1","22.2"
"Worth","2020-12-25","9","9531","6","863","29.7","26.1"
"Worth","2020-12-26","22","9553","6","869","31.3","26.4"
"Worth","2020-12-27","21","9574","8","877","32","26.4"
"Worth","2020-12-28","55","9629","13","890","31.3","27"
"Worth","2020-12-29","73","9702","15","905","31.9","26.9"
"Worth","2020-12-30","97","9799","21","926","32.1","27.7"
"Worth","2020-12-31","58","9857","8","934","30.2","26.7"
"Worth","2021-01-01","12","9869","4","938","25.5","27.6"
"Worth","2021-01-02","29","9898","8","946","25.5","28.4"
"Worth","2021-01-03","31","9929","11","957","25.1","28.6"
"Worth","2021-01-04","83","10012","27","984","26.4","28.8"
"Worth","2021-01-05","45","10057","10","994","26.7","29.3"
"Worth","2021-01-06","57","10114","19","1013","28.3","30.2"
"Worth","2021-01-07","61","10175","9","1022","28.5","29.4"
"Worth","2021-01-08","42","10217","12","1034","27.8","26.6"
"Worth","2021-01-09","24","10241","12","1046","31","28.3"
"Worth","2021-01-10","17","10258","5","1051","30.1","27.6"
"Worth","2021-01-11","62","10320","13","1064","28.5","27.4"
"Worth","2021-01-12","53","10373","14","1078","29.1","27.9"
"Worth","2021-01-13","53","10426","12","1090","27.5","27.9"
"Worth","2021-01-14","55","10481","7","1097","27.2","27.9"
"Worth","2021-01-15","39","10520","8","1105","26.1","26.9"
"Worth","2021-01-16","19","10539","4","1109","22","26.5"
"Worth","2021-01-17","14","10553","3","1112","20.8","25.5"
"Worth","2021-01-18","33","10586","7","1119","20.9","24.7"
"Worth","2021-01-19","32","10618","6","1125","19.8","24.4"
"Worth","2021-01-20","44","10662","6","1131","18.5","23"
"Worth","2021-01-21","33","10695","7","1138","19.7","23.5"
"Worth","2021-01-22","40","10735","9","1147","20","23"
"Worth","2021-01-23","9","10744","1","1148","18.6","20.3"
"Worth","2021-01-24","15","10759","2","1150","17.4","19.1"
"Worth","2021-01-25","9","10768","1","1151","16","18.4"
"Worth","2021-01-26","7","10775","3","1154","19.4","19.6"
"Worth","2021-01-27","0","10775","0","1154","17.4","18"
